Source Port,Destination Port,NAT Source Port,NAT Destination Port,Bytes,Bytes Sent,Bytes Received,Packets,Elapsed Time (sec),pkts_sent,pkts_received
6338,10,28024,9,199,94,105,2,30,1,1
2744,1244,12254,924,879,126,753,2,31,1,1
10220,26,22745,16,13990,9102,4888,28,15,16,12
9728,2627,19934,2037,1275,300,975,6,1200,3,3
6830,10,8016,9,202,83,119,2,30,1,1
8263,26,23128,16,130,70,60,3,5,2,1
15027,10,18384,9,177,94,83,2,30,1,1
10061,26,15018,16,9571,2966,6605,52,35,29,23
8526,10,28587,9,412,122,290,4,45,2,2
21950,10,19836,9,336,110,226,2,30,1,1
15582,10,11577,9,1435,98,1337,4,34,2,2
4695,26,27394,16,10042,3117,6925,28,47,16,12
9068,15,9304,11,1647,508,1139,8,138,5,3
8781,10,21546,9,199,102,97,2,30,1,1
11768,26,22235,16,4982,3414,1568,19,362,9,10
15107,26,18632,16,266757,6935,259822,274,19,97,177
8407,10,4488,9,199,102,97,2,29,1,1
15513,10,12198,9,200,102,98,2,30,1,1
9806,26,2740,16,4606,3263,1343,19,304,10,9
4626,26,20964,16,10637,4761,5876,30,145,17,13
13484,26,21276,16,9515,2231,7284,25,22,14,11
12372,26,10478,16,127391,26326,101065,179,172,76,103
13928,10,15786,9,193,102,91,2,29,1,1
20845,26,10695,16,4490,1234,3256,20,122,9,11
10719,2437,15041,1896,66,66,0,1,5,1,0
11094,26,28581,16,9003,2598,6405,33,345,15,18
22147,10,24382,9,198,102,96,2,30,1,1
13015,26,16589,16,499,425,74,4,0,3,1
18538,2819,14285,2188,70,70,0,1,5,1,0
12465,26,28070,16,2005,1100,905,16,17,9,7
18161,26,28357,16,10192,5090,5102,43,15,24,19
11204,2165,1045,1672,160,70,90,2,8,1,1
14785,10,5440,9,194,94,100,2,30,1,1
21785,10,9583,9,297,102,195,4,48,2,2
20470,183,27992,121,4213,2429,1784,18,32,9,9
15812,26,24725,16,36865,3692,33173,61,47,30,31
9,18,24474,13,184,94,90,2,29,1,1
20266,26,14389,16,178,118,60,2,15,1,1
11126,2857,27622,2216,70,70,0,1,5,1,0
12478,26,523,16,2005,1100,905,16,17,9,7
3249,10,13898,9,404,259,145,3,33,2,1
3557,10,14962,9,336,231,105,3,30,2,1
12392,1340,20677,1015,684,432,252,10,16,6,4
10287,10,19308,9,236,86,150,2,30,1,1
2744,1238,2192,918,881,126,755,2,30,1,1
15705,10,9416,9,165,86,79,2,31,1,1
22665,10,19093,9,226,110,116,2,29,1,1
14461,26,14401,16,9333,2019,7314,41,255,19,22
4520,26,22980,16,16921,7469,9452,40,138,19,21
16313,26,3042,16,981499,39775,941724,1109,291,439,670
22667,26,12776,16,92279,4799,87480,107,16,43,64
4008,26,24219,16,1473,988,485,12,26,7,5
8870,15,13472,11,217502,6597,210905,211,109,62,149
18433,15,17675,11,1243,769,474,9,123,6,3
14627,10,7689,9,195,102,93,2,30,1,1
16021,1122,28761,826,166,166,0,1,1200,1,0
15233,26,13236,16,8007,1987,6020,20,15,11,9
0,0,0,0,124,64,60,2,0,1,1
9056,10,7003,9,525,110,415,4,43,2,2
2744,67,10553,50,903,126,777,2,29,1,1
18784,26,26971,16,2406,1218,1188,21,16,11,10
18731,26,26942,16,1092,645,447,10,34,6,4
21306,10,17244,9,180,94,86,2,30,1,1
12577,2632,6564,2042,70,70,0,2,8,2,0
20996,943,25539,695,502,380,122,7,19,5,2
12022,26,23520,16,7271,2540,4731,32,20,18,14
9888,15,11554,11,2977,680,2297,11,161,6,5
21627,10,20195,9,247,94,153,2,30,1,1
9817,26,27523,16,14723,2606,12117,54,19,22,32
14691,10,27019,9,764,99,665,2,31,1,1
12555,3138,19675,2436,672,306,366,11,14,5,6
5027,26,24610,16,910,358,552,14,47,6,8
15651,10,25114,9,755,94,661,2,31,1,1
15368,10,25037,9,192,98,94,2,0,1,1
9731,15,22599,11,378,192,186,7,20,4,3
8712,10,25443,9,208,106,102,2,31,1,1
9528,26,27031,16,7723,2591,5132,23,49,12,11
8288,26,24540,16,5150,853,4297,16,27,9,7
10853,706,23293,504,66,66,0,2,9,2,0
4835,1672,9631,1280,132,132,0,3,1199,3,0
15862,26,6438,16,1574,1089,485,13,15,8,5
14098,10,15399,9,198,110,88,2,30,1,1
22442,10,24016,9,177,94,83,2,30,1,1
22308,10,6827,9,210,102,108,2,30,1,1
21474,10,17874,9,215,102,113,2,30,1,1
22666,10,22204,9,209,110,99,2,30,1,1
2050,10,8077,9,194,87,107,2,30,1,1
15162,10,13956,9,177,94,83,2,31,1,1
14222,10,4524,9,753,96,657,2,31,1,1
12127,26,4435,16,27650,12347,15303,47,53,24,23
14878,10,23553,9,166,86,80,2,30,1,1
1210,26,5670,16,7563,1536,6027,26,316,14,12
12500,26,27620,16,2955,864,2091,11,119,5,6
13958,10,13702,9,167,86,81,2,31,1,1
18516,1115,7541,820,70,70,0,1,5,1,0
12603,26,23523,16,499,425,74,4,0,3,1
9800,15,7163,11,318,192,126,6,25,4,2
11980,26,18951,16,161938,137946,23992,412,384,227,185
7060,10,20744,9,168,78,90,2,30,1,1
22090,10,10229,9,309,110,199,2,30,1,1
532,247,0,0,3562,1936,1626,48,195,24,24
21631,10,10983,9,198,102,96,2,30,1,1
10982,2603,8598,2020,70,70,0,1,5,1,0
9722,15,15034,11,367162,17367,349795,470,143,214,256
8578,10,19794,9,761,102,659,2,29,1,1
9077,10,2299,9,216,110,106,2,30,1,1
15492,10,9053,9,177,94,83,2,29,1,1
8562,10,10294,9,170,87,83,2,30,1,1
9145,10,19345,9,360,102,258,2,30,1,1
14790,10,3752,9,206,105,101,2,30,1,1
14663,10,9898,9,196,102,94,2,31,1,1
5828,15,12157,11,19112,2192,16920,46,90,23,23
2744,1239,13428,919,876,126,750,2,30,1,1
10052,26,24478,16,6273,1375,4898,18,127,9,9
14686,10,9718,9,256,93,163,2,31,1,1
13500,26,9814,16,130,70,60,3,4,2,1
11193,26,1608,16,4187,773,3414,16,30,9,7
14325,10,17230,9,186,95,91,2,31,1,1
22033,10,9076,9,193,102,91,2,30,1,1
18567,10,0,0,340,90,250,2,31,1,1
9097,10,5661,9,186,102,84,2,30,1,1
1001,26,2333,16,4458,1022,3436,16,26,9,7
2744,1238,17309,918,886,126,760,2,31,1,1
2839,295,11688,190,2163,676,1487,14,15,7,7
21348,10,9818,9,199,102,97,2,30,1,1
1219,1891,23424,1444,481,150,331,2,1200,1,1
8724,26,20994,16,12704,3459,9245,50,1336,18,32
17287,26,20562,16,6414,1614,4800,24,17,13,11
10595,10,26816,9,168,78,90,2,30,1,1
16134,15,25464,11,3164,815,2349,12,144,6,6
17298,26,24805,16,6306,1780,4526,28,33,14,14
13725,10,4171,9,170,87,83,2,31,1,1
14381,10,24245,9,199,102,97,2,30,1,1
8894,26,15596,16,5037,1135,3902,16,18,9,7
9066,26,15868,16,109400,8787,100613,159,81,78,81
19317,26,16605,16,8360,1781,6579,23,77,12,11
8664,10,14268,9,211,102,109,2,30,1,1
14946,10,5813,9,199,102,97,2,30,1,1
19535,15,5856,11,7712,4248,3464,23,51,12,11
10863,2410,27791,1875,70,70,0,1,5,1,0
12696,26,7765,16,495,421,74,4,0,3,1
10804,15,9147,11,240,120,120,5,27,3,2
13862,10,23065,9,179,94,85,2,30,1,1
15064,26,6953,16,2673671,30446,2643225,2145,125,234,1911
17990,26,16749,16,10017,3031,6986,30,45,17,13
17721,26,23745,16,6713,3052,3661,49,5974,15,34
18531,10,9336,9,78,78,0,1,30,1,0
21954,26,13254,16,25423484,377367,25046117,21027,1082,2865,18162
14284,10,21222,9,212,108,104,2,31,1,1
9744,15,23598,11,1658,1247,411,8,15,5,3
14947,26,13585,16,3715,1791,1924,23,203,12,11
965,26,766,16,6132,767,5365,17,26,9,8
20470,10,9045,9,102,102,0,1,30,1,0
636,1478,28051,1125,150,150,0,1,1200,1,0
6471,26,18418,16,2940,1721,1219,17,361,9,8
9866,15,14294,11,1546,1109,437,7,15,5,2
14357,3196,16761,2478,70,70,0,2,8,2,0
9667,10,7173,9,199,102,97,2,30,1,1
10801,15,14865,11,76066,3663,72403,92,24,40,52
5771,26,11774,16,19403,4043,15360,36,48,19,17
17779,10,16123,9,273,94,179,2,30,1,1
12030,15,2919,11,9602,814,8788,19,129,10,9
6543,26,13597,16,836939,25380,811559,864,64,302,562
8210,2627,21194,2037,460,150,310,2,1200,1,1
14212,10,11851,9,177,94,83,2,30,1,1
21654,10,12143,9,291,94,197,2,30,1,1
9186,10,8092,9,182,94,88,2,30,1,1
11655,26,15038,16,69951,4941,65010,95,351,45,50
15219,26,25593,16,7862,1873,5989,20,15,11,9
3246,26,13867,16,25033,2433,22600,42,25,21,21
15508,10,16690,9,179,94,85,2,30,1,1
11652,26,9482,16,26235,2216,24019,39,318,17,22
8215,26,22478,16,10129,5016,5113,18,120,9,9
17687,26,8736,16,9943,1882,8061,32,33,15,17
15875,10,22022,9,418,88,330,4,41,2,2
636,627,9730,434,502,150,352,2,1200,1,1
4573,10,16044,9,237,91,146,2,31,1,1
636,1692,6575,1294,509,150,359,2,1200,1,1
11033,15,9165,11,16479,1820,14659,31,26,17,14
8907,10,7194,9,177,94,83,2,30,1,1
10446,166,22447,114,156,156,0,3,8,3,0
1560,10,5586,9,194,87,107,2,30,1,1
9333,15,26673,11,2149,1165,984,15,77,8,7
7409,10,20041,9,216,90,126,2,30,1,1
8495,10,20366,9,748,94,654,2,30,1,1
15187,10,10446,9,274,87,187,4,31,2,2
4740,26,4537,16,3338,2337,1001,18,45,11,7
12609,26,12099,16,499,425,74,4,0,3,1
22506,10,3020,9,166,86,80,2,30,1,1
13026,26,2304,16,499,425,74,4,0,3,1
12373,954,16691,704,70,70,0,2,7,2,0
22168,10,12397,9,196,102,94,2,30,1,1
17032,26,4288,16,1038,502,536,16,33,8,8
17169,26,3054,16,4052,2588,1464,18,16,9,9
11005,535,12649,355,66,66,0,1,5,1,0
8584,1238,11080,918,78,78,0,1,30,1,0
9004,10,20504,9,463,87,376,4,38,2,2
22494,10,18661,9,246,102,144,2,30,1,1
14417,10,21665,9,177,94,83,2,30,1,1
7693,26,1320,16,4531,3268,1263,23,27,13,10
21496,10,15811,9,194,99,95,2,30,1,1
22568,26,1402,16,4864,2496,2368,33,121,17,16
16444,188,9378,123,312,140,172,4,30,2,2
12718,2864,13065,2223,70,70,0,1,5,1,0
7603,15,14775,11,2068,1371,697,13,83,7,6
8530,10,4969,9,208,106,102,2,30,1,1
15559,10,28320,9,177,94,83,2,30,1,1
489,10,15134,9,86,86,0,1,30,1,0
8599,10,2082,9,167,86,81,2,29,1,1
4714,10,16000,9,168,78,90,2,30,1,1
8911,10,28407,9,1472,98,1374,4,54,2,2
21526,10,5956,9,255,102,153,2,30,1,1
8402,10,2175,9,164,86,78,2,31,1,1
14950,10,26274,9,193,102,91,2,29,1,1
22409,10,16010,9,193,102,91,2,30,1,1
7158,26,2944,16,2754,1394,1360,22,36,11,11
15074,10,18000,9,193,102,91,2,30,1,1
6786,15,16540,11,282,60,222,5,12,2,3
9725,10,9249,9,177,94,83,2,30,1,1
5667,26,7522,16,280,140,140,5,130,3,2
14642,10,23825,9,761,100,661,2,30,1,1
6154,15,22525,11,1556,1236,320,10,15,5,5
10039,26,4865,16,124,64,60,2,15,1,1
22676,10,25103,9,210,110,100,2,30,1,1
16157,26,1299,16,3858,1277,2581,12,120,6,6
14932,10,23370,9,195,102,93,2,33,1,1
14015,10,8147,9,1428,103,1325,4,32,2,2
10891,1097,1382,805,70,70,0,1,5,1,0
9027,26,23165,16,7280,1441,5839,17,89,9,8
22153,10,3349,9,199,102,97,2,30,1,1
12571,26,27479,16,499,425,74,4,0,3,1
18536,26,21712,16,5888,1175,4713,19,76,11,8
15822,26,5163,16,9633,4368,5265,32,71,18,14
15891,10,22496,9,184,94,90,2,29,1,1
11519,15,20555,11,1152,712,440,10,15,5,5
22429,10,20815,9,195,102,93,2,30,1,1
4663,26,19043,16,499,425,74,4,0,3,1
21982,26,15157,16,5066,2558,2508,26,127,13,13
15598,10,1040,9,168,86,82,2,31,1,1
12902,26,14233,16,1050267,44816,1005451,1276,177,580,696
13841,26,18107,16,907774,32911,874863,898,460,195,703
11070,10,22769,9,251,98,153,2,31,1,1
4515,15,15949,11,2971,1509,1462,10,15,6,4
14295,908,22961,672,70,70,0,2,8,2,0
14538,26,14485,16,5433,3275,2158,16,135,8,8
9166,10,4781,9,196,102,94,2,31,1,1
12709,781,16759,567,70,70,0,1,4,1,0
10941,656,25227,458,70,70,0,2,8,2,0
14332,10,4638,9,260,102,158,2,30,1,1
15610,10,7489,9,240,86,154,2,30,1,1
9228,10,19856,9,764,102,662,2,29,1,1
9622,26,28878,16,36345,2308,34037,52,83,23,29
14481,10,6061,9,325,98,227,4,40,2,2
8674,10,5462,9,199,102,97,2,30,1,1
12003,365,5305,234,758,320,438,11,17,6,5
21395,26,20480,16,3767437,87322,3680115,3675,52,1230,2445
3701,26,29029,16,15358,11148,4210,93,423,51,42
12646,1853,8539,1413,70,70,0,1,4,1,0
13929,10,264,9,268,95,173,4,45,2,2
18946,26,3231,16,11464,5499,5965,54,15,29,25
17060,26,16108,16,5927,794,5133,17,25,8,9
13237,26,21663,16,6732,2308,4424,21,141,9,12
14246,2274,24631,1761,70,70,0,2,8,2,0
15511,10,17756,9,198,101,97,2,30,1,1
6953,26,18564,16,2750,1891,859,17,25,10,7
10993,997,18655,734,70,70,0,1,5,1,0
2567,10,10786,9,233,90,143,2,32,1,1
56,1328,18222,1003,132,70,62,2,29,1,1
2744,1240,25217,920,900,126,774,2,30,1,1
18418,26,13022,16,5341,2434,2907,19,135,9,10
8834,10,26547,9,200,94,106,2,29,1,1
12016,26,3651,16,5604,2738,2866,20,325,10,10
15379,1652,16866,1269,70,70,0,2,8,2,0
22197,10,7053,9,183,94,89,2,31,1,1
15221,15,22380,11,234,234,0,4,12,4,0
8697,26,25690,16,8107,2474,5633,24,25,12,12
21450,10,7653,9,194,102,92,2,31,1,1
10218,26,4374,16,9429,1978,7451,27,46,14,13
14606,26,23352,16,45632,2078,43554,58,120,22,36
15746,10,21927,9,784,94,690,2,30,1,1
11012,26,24069,16,9010,2779,6231,30,361,15,15
3270,26,29016,16,438124,21529,416595,481,398,138,343
11712,26,9731,16,1581,924,657,15,125,7,8
8961,26,9579,16,7243,777,6466,17,126,8,9
13686,26,8157,16,8965,3021,5944,39,360,22,17
8730,10,20327,9,186,95,91,2,31,1,1
13710,15,24220,11,2959,1505,1454,10,16,6,4
15203,26,5444,16,8240,3521,4719,25,18,15,10
22658,10,15644,9,308,110,198,2,30,1,1
15169,10,12691,9,788,108,680,2,30,1,1
13730,10,247,9,174,89,85,2,31,1,1
11810,15,23183,11,1916,1467,449,10,19,6,4
16021,2811,3426,2181,726,726,0,12,1200,12,0
18033,15,5005,11,5755,3943,1812,24,31,13,11
15445,10,11646,9,198,86,112,2,30,1,1
7787,26,16401,16,9297,2727,6570,27,80,15,12
8831,15,1790,11,2237,508,1729,10,125,6,4
8521,26,25018,16,4379,2565,1814,24,81,11,13
12421,405,20711,263,372,186,186,6,15,3,3
15331,26,367,16,7565,2187,5378,27,24,15,12
15138,10,3273,9,726,85,641,2,30,1,1
19994,10,3724,9,268,86,182,2,30,1,1
4321,26,6422,16,83203,3599,79604,101,138,41,60
2744,1239,8298,919,903,126,777,2,31,1,1
13693,26,28622,16,10961,2666,8295,35,237,16,19
532,247,0,0,3354,1792,1562,46,194,23,23
10004,15,21806,11,54441,4387,50054,75,140,37,38
9615,15,22352,11,1658,1247,411,8,15,5,3
0,0,0,0,480,244,236,4,0,2,2
11717,26,1663,16,9032,2673,6359,30,142,16,14
19812,26,4888,16,134,60,74,3,4,2,1
13711,10,10955,9,211,110,101,2,30,1,1
19481,26,27357,16,4748,1841,2907,19,26,11,8
12292,26,23436,16,2511,1465,1046,21,102,10,11
5619,26,9279,16,7283,2384,4899,25,361,12,13
22278,10,19634,9,821,102,719,2,30,1,1
15322,2125,642,1639,66,66,0,1,5,1,0
13752,10,239,9,197,102,95,2,30,1,1
8612,10,301,9,403,142,261,2,30,1,1
10913,734,25911,526,316,136,180,6,6,3,3
7548,10,20213,9,213,87,126,2,30,1,1
20566,26,19604,16,304,86,218,2,30,1,1
15972,10,23056,9,186,95,91,2,30,1,1
935,26,1268,16,5043,432,4611,12,16,6,6
3941,26,25620,16,3242,1248,1994,26,362,7,19
9003,10,8779,9,315,102,213,2,30,1,1
15928,26,745,16,5619,927,4692,17,15,10,7
15219,26,2689,16,12924,3689,9235,31,82,17,14
8811,15,5104,11,318,192,126,6,41,4,2
20875,10,0,0,174,77,97,2,30,1,1
22319,10,24794,9,232,102,130,2,29,1,1
12522,968,22094,716,70,70,0,1,4,1,0
7354,10,1425,9,199,94,105,2,30,1,1
10933,1793,17646,1368,70,70,0,1,5,1,0
10828,1839,3008,1400,70,70,0,1,5,1,0
173,10,12993,9,210,78,132,2,29,1,1
17061,26,19895,16,318,192,126,6,26,4,2
9493,26,27723,16,1385,868,517,12,30,6,6
8519,26,22522,16,10055,1184,8871,21,76,9,12
6762,234,15244,149,2276,1356,920,15,3601,7,8
14323,10,20264,9,209,102,107,2,30,1,1
12744,42,24518,25,70,70,0,1,4,1,0
13095,26,29150,16,5661,1444,4217,19,135,11,8
2011,10,7851,9,227,89,138,2,31,1,1
15192,183,24997,121,3425,1470,1955,16,17,8,8
15224,26,20197,16,4628,1035,3593,19,25,11,8
5279,233,6110,148,4113,1213,2900,22,713,12,10
13355,15,24009,11,12385,1831,10554,20,20,9,11
19201,26,6403,16,3169,979,2190,14,135,7,7
9003,26,19273,16,7021,1767,5254,26,224,13,13
20492,10,22074,9,384,166,218,2,29,1,1
18872,26,21335,16,9660,2402,7258,27,46,15,12
12402,1964,19945,1500,70,70,0,2,8,2,0
15799,10,23356,9,184,86,98,2,29,1,1
12686,26,27577,16,499,425,74,4,0,3,1
8977,10,15503,9,1411,98,1313,4,52,2,2
20766,1485,15584,1129,70,70,0,1,4,1,0
8584,1280,9096,960,238,78,160,2,30,1,1
10764,3040,17433,2364,70,70,0,2,8,2,0
836,10,3490,9,832,106,726,2,30,1,1
13116,26,11888,16,7329,3011,4318,30,127,14,16
16605,26,28500,16,810,340,470,13,34,6,7
3893,15,15872,11,1534,996,538,10,35,6,4
15906,10,0,0,222,86,136,2,30,1,1
15663,10,19605,9,198,102,96,2,30,1,1
20932,26,24296,16,6485,1871,4614,27,140,14,13
15878,10,10493,9,498,204,294,6,29,3,3
9839,15,6936,11,1426,865,561,9,15,5,4
6760,26,21744,16,10506,2984,7522,30,15,17,13
13912,10,19719,9,168,78,90,2,29,1,1
7257,26,20426,16,7092,1883,5209,21,21,12,9
4599,26,3231,16,8641,955,7686,19,259,8,11
15497,10,20369,9,177,94,83,2,30,1,1
2744,1239,28499,919,880,126,754,2,30,1,1
14021,10,10346,9,194,102,92,2,30,1,1
8822,26,1715,16,182624,7130,175494,212,132,77,135
14091,10,26695,9,202,103,99,2,31,1,1
10327,440,17670,282,870,330,540,12,1298,6,6
11123,26,21275,16,3687037,41923,3645114,3002,34,534,2468
22392,10,8353,9,176,90,86,2,31,1,1
17985,26,27356,16,9024,1533,7491,25,110,11,14
18410,10,26765,9,241,98,143,2,30,1,1
8909,10,293,9,210,94,116,2,30,1,1
14903,10,23560,9,183,94,89,2,30,1,1
612,5,2457,5,66,66,0,1,5,1,0
1168,2008,7103,1538,148,86,62,2,29,1,1
13907,10,15943,9,177,94,83,2,30,1,1
11126,26,5660,16,4747,3601,1146,18,15,10,8
12545,26,4470,16,499,425,74,4,0,3,1
15220,26,20332,16,7914,1925,5989,20,15,11,9
16951,255,25970,160,66,66,0,1,4,1,0
22657,26,13909,16,421329,12430,408899,433,16,152,281
22512,10,12949,9,285,103,182,4,44,2,2
22321,10,13949,9,167,86,81,2,30,1,1
4447,26,14040,16,2907,1637,1270,20,364,11,9
22420,10,27512,9,811,94,717,2,30,1,1
12352,350,21160,223,1495,843,652,10,30,5,5
8058,26,20970,16,4621,1714,2907,19,26,11,8
22239,10,16890,9,214,102,112,2,29,1,1
18009,26,20500,16,6196,746,5450,17,28,8,9
15237,26,26804,16,1233,730,503,12,25,7,5
15141,10,14743,9,164,86,78,2,30,1,1
16248,676,27281,475,130,70,60,2,6,1,1
13860,10,18161,9,711,87,624,2,31,1,1
16951,255,25970,160,66,66,0,1,4,1,0
15098,10,23388,9,177,94,83,2,31,1,1
8326,10,2088,9,195,86,109,2,30,1,1
17211,26,24497,16,5168,700,4468,16,16,7,9
22509,10,28395,9,780,93,687,2,30,1,1
17156,26,19338,16,4552,2750,1802,27,95,15,12
19301,26,27257,16,4529,1622,2907,19,27,11,8
9637,26,15477,16,2147464,35144,2112320,1951,72,540,1411
22011,10,22585,9,199,102,97,2,30,1,1
8842,10,3553,9,200,94,106,2,30,1,1
5716,26,5216,16,89724,81316,8408,148,404,69,79
18002,26,16193,16,1537,934,603,14,33,7,7
16021,2627,8122,2037,740725,699740,40985,1031,1411,616,415
9136,10,24272,9,216,110,106,2,30,1,1
15315,26,25058,16,41851,2810,39041,66,45,31,35
7829,26,1434,16,6496,3631,2865,71,606,39,32
3432,15,14244,11,424,198,226,7,141,4,3
13047,26,10192,16,499,425,74,4,0,3,1
14156,10,17624,9,210,102,108,2,30,1,1
1637,26,17929,16,4118,2905,1213,27,87,16,11
14947,26,25043,16,7234,4345,2889,27,235,15,12
8992,26,21844,16,5863,1580,4283,17,15,9,8
9625,26,12329,16,16160,13969,2191,42,80,23,19
10584,26,10153,16,322,262,60,2,4,1,1
15898,10,17463,9,296,97,199,4,41,2,2
5642,15,18285,11,2128,798,1330,14,46,7,7
9100,10,5159,9,754,94,660,2,30,1,1
14616,10,19967,9,178,94,84,2,30,1,1
8584,10,820,9,165,86,79,2,30,1,1
8522,10,26002,9,193,102,91,2,29,1,1
9063,295,21718,190,758568,17631,740937,772,17,269,503
9113,10,6415,9,193,102,91,2,30,1,1
6714,295,18952,190,3174,1617,1557,17,18,9,8
4779,26,22929,16,5544,2626,2918,28,145,15,13
14613,10,9188,9,200,102,98,2,30,1,1
15994,10,11127,9,340,110,230,2,29,1,1
13688,26,5469,16,7969,4870,3099,36,360,20,16
20535,10,7799,9,70,70,0,1,30,1,0
10957,3171,24216,2457,70,70,0,2,8,2,0
18083,26,28566,16,7693,1284,6409,24,81,12,12
9616,15,28170,11,12222,3865,8357,23,22,11,12
15913,10,18635,9,780,93,687,2,30,1,1
9726,10,6076,9,216,110,106,2,30,1,1
21797,26,24512,16,272081,11032,261049,304,139,107,197
9477,10,5170,9,193,102,91,2,29,1,1
0,0,0,0,320,320,0,5,0,5,0
12841,26,19498,16,4249,724,3525,13,15,7,6
8733,26,24355,16,6408,2531,3877,21,15,11,10
12055,1957,28366,1494,70,70,0,1,5,1,0
6098,26,26041,16,33072,3479,29593,71,98,38,33
20990,10,28313,9,198,90,108,2,30,1,1
14247,10,20157,9,183,94,89,2,30,1,1
2744,2559,6832,1988,877,126,751,2,30,1,1
16021,2577,20282,1999,538,166,372,2,1199,1,1
6203,15,22237,11,1323,335,988,10,15,5,5
14531,26,10335,16,4348,1536,2812,14,121,6,8
9118,10,17258,9,211,102,109,2,31,1,1
15729,10,11633,9,195,102,93,2,30,1,1
8203,15,13012,11,1834,1520,314,14,15,9,5
16734,26,18424,16,5571,1518,4053,22,614,13,9
3315,26,14053,16,18895,2061,16834,34,17,18,16
2744,1314,17720,991,890,126,764,2,30,1,1
18918,10,27045,9,180,82,98,2,29,1,1
20507,26,6768,16,6869,3059,3810,30,123,15,15
8584,1448,24242,1101,280,78,202,2,30,1,1
22580,10,822,9,215,102,113,2,30,1,1
15962,10,3269,9,194,102,92,2,31,1,1
8508,10,18464,9,198,101,97,2,30,1,1
16667,26,7294,16,12494,5331,7163,48,122,21,27
18058,8,26584,8,1656,677,979,21,16,10,11
14334,10,9901,9,209,110,99,2,30,1,1
6017,26,20468,16,2913,1752,1161,15,15,9,6
10805,2955,16355,2292,66,66,0,1,5,1,0
15348,10,23385,9,183,94,89,2,29,1,1
16143,26,26933,16,4327,674,3653,14,25,8,6
8675,26,8098,16,4091,1015,3076,15,27,8,7
12856,26,665,16,7653,1188,6465,21,16,12,9
3011,10,17655,9,220,78,142,2,30,1,1
22218,10,21533,9,330,94,236,4,55,2,2
2744,554,3487,370,898,126,772,2,31,1,1
8584,1238,17595,918,242,78,164,2,30,1,1
18001,15,19646,11,130,70,60,2,15,1,1
16613,26,27198,16,5086,3296,1790,36,56,18,18
19203,26,18024,16,248071,7320,240751,269,268,89,180
8852,10,24490,9,183,94,89,2,30,1,1
17481,26,2747,16,7192,2002,5190,24,360,11,13
8797,10,16311,9,184,102,82,2,30,1,1
14019,10,19390,9,738,86,652,2,31,1,1
8439,10,736,9,198,102,96,2,29,1,1
8741,15,18923,11,318,192,126,6,43,4,2
14375,10,26275,9,188,96,92,2,31,1,1
15413,10,17131,9,177,94,83,2,30,1,1
11342,26,1669,16,454059,23387,430672,602,76,275,327
12585,26,25157,16,499,425,74,4,0,3,1
2724,1240,16571,920,422,164,258,6,30,3,3
4482,26,28120,16,7768,3071,4697,23,17,12,11
3273,10,13969,9,414,268,146,3,33,2,1
9290,10,4934,9,768,99,669,2,30,1,1
14523,10,8165,9,177,94,83,2,30,1,1
15923,10,28186,9,745,93,652,2,31,1,1
19544,15,20421,11,134,60,74,3,4,2,1
7124,10,19602,9,235,90,145,2,33,1,1
15920,10,1157,9,193,102,91,2,30,1,1
225,10,5370,9,826,826,0,8,44,8,0
10824,2756,7447,2137,70,70,0,1,5,1,0
13045,15,24858,11,506,292,214,8,16,5,3
14010,10,17818,9,271,93,178,4,43,2,2
6874,26,10571,16,14780,11289,3491,59,219,32,27
22705,10,6776,9,209,110,99,2,31,1,1
21368,3250,12071,2519,66,66,0,2,7,2,0
16281,26,5963,16,6321,3341,2980,19,135,9,10
8991,26,4675,16,6105,852,5253,17,77,9,8
22692,10,12307,9,177,94,83,2,30,1,1
10493,15,27735,11,1675,539,1136,8,178,5,3
14710,10,13475,9,194,86,108,2,30,1,1
17494,15,26272,11,101244,15308,85936,165,15,53,112
4504,15,26581,11,1597,783,814,10,15,5,5
10838,2365,14619,1839,70,70,0,1,4,1,0
4607,26,24405,16,2885,1732,1153,16,256,9,7
3657,15,902,11,2137,1258,879,11,150,6,5
10066,15,23220,11,10213447,100765,10112682,8215,121,1412,6803
19411,26,27813,16,17161,1619,15542,18,143,4,14
13904,26,2378,16,1786,172,1614,7,120,3,4
17616,10,18777,9,168,78,90,2,30,1,1
13712,10,18797,9,216,110,106,2,31,1,1
9523,26,1872,16,6748,1843,4905,21,29,11,10
21338,1882,9460,1437,70,70,0,1,4,1,0
12357,1065,21432,784,1950,957,993,17,17,10,7
15690,10,17841,9,195,102,93,2,30,1,1
15709,10,1306,9,166,86,80,2,31,1,1
21349,10,1214,9,202,103,99,2,31,1,1
5853,26,3766,16,6423,744,5679,16,16,9,7
8768,10,232,9,178,94,84,2,30,1,1
852,26,7474,16,5655,934,4721,16,130,8,8
12730,1066,16368,785,70,70,0,1,4,1,0
22012,10,26614,9,178,94,84,2,29,1,1
18510,1811,25680,1381,70,70,0,1,5,1,0
9446,15,17474,11,7979,802,7177,17,39,8,9
21864,10,21896,9,188,96,92,2,30,1,1
20547,26,23368,16,384,166,218,2,29,1,1
9527,26,8787,16,452,386,66,4,1,3,1
2524,10,10576,9,371,237,134,3,33,2,1
21424,10,15135,9,194,102,92,2,29,1,1
8831,10,27191,9,361,118,243,4,33,2,2
17463,15,22713,11,1658,1344,314,10,15,5,5
15700,10,15667,9,279,96,183,4,31,2,2
9146,10,6503,9,322,94,228,4,49,2,2
4393,10,0,0,138,69,69,2,30,1,1
4083,26,17065,16,5007,3053,1954,24,394,8,16
13138,26,5522,16,15334,4707,10627,28,24,14,14
12041,26,19303,16,16706,6162,10544,39,29,19,20
19163,26,20832,16,12708,2798,9910,36,258,13,23
17629,10,26366,9,235,90,145,2,33,1,1
14808,10,25642,9,177,94,83,2,30,1,1
12424,2449,4852,1902,70,70,0,1,5,1,0
11230,2129,42,1642,70,70,0,1,5,1,0
22067,10,15843,9,196,102,94,2,31,1,1
15566,10,10299,9,184,102,82,2,29,1,1
20423,40,23198,23,9376,4359,5017,86,19,44,42
11260,2431,20140,1892,136,136,0,3,14,3,0
12945,10,19796,9,168,78,90,2,30,1,1
4483,15,17176,11,130,70,60,2,15,1,1
8698,26,21542,16,20488,16649,3839,30,24,18,12
12125,26,16802,16,41247,1363,39884,51,37,13,38
14371,15,2527,11,5146,3694,1452,20,249,10,10
8517,15,7093,11,2485,529,1956,12,17,6,6
20628,234,27074,149,3535,1973,1562,36,3961,18,18
8728,26,25969,16,9908,4692,5216,30,92,16,14
22557,10,8926,9,178,94,84,2,29,1,1
8490,10,17709,9,196,102,94,2,31,1,1
11677,26,29134,16,168753,7954,160799,212,26,95,117
8685,26,8438,16,7086,1913,5173,29,270,16,13
8830,15,8109,11,7561,3181,4380,16,41,8,8
15929,10,8695,9,177,94,83,2,30,1,1
14178,10,10531,9,194,99,95,2,30,1,1
22545,10,28182,9,321,102,219,2,29,1,1
15011,10,14955,9,458,188,270,6,30,3,3
9964,26,13025,16,252960,10277,242683,301,209,119,182
12326,26,3535,16,3182,1568,1614,8,121,4,4
14315,10,26164,9,186,95,91,2,31,1,1
14672,15,24740,11,23248,1600,21648,35,31,17,18
22674,10,8648,9,718,94,624,2,30,1,1
17496,234,899,149,7054,2076,4978,32,5115,11,21
636,2818,9935,2187,509,150,359,2,1199,1,1
14166,10,25296,9,199,102,97,2,30,1,1
22686,26,11371,16,392197,11800,380397,406,16,143,263
8991,15,23912,11,6311,4340,1971,20,186,12,8
17147,26,21088,16,5167,700,4467,16,15,7,9
22009,10,25983,9,179,94,85,2,29,1,1
14011,10,20522,9,164,86,78,2,31,1,1
10699,26,5051,16,30210,2106,28104,46,201,17,29
14691,26,26990,16,5616,3106,2510,22,223,13,9
12134,15,27774,11,2071,1305,766,10,256,6,4
21459,10,3982,9,262,126,136,2,30,1,1
22604,10,29136,9,266,110,156,2,30,1,1
19242,26,27881,16,39067,7713,31354,74,247,29,45
3133,2331,840,1815,330,330,0,6,3609,6,0
14782,10,18600,9,177,94,83,2,30,1,1
21537,10,6514,9,170,87,83,2,30,1,1
11277,2516,13186,1955,316,136,180,6,6,3,3
11667,295,23105,190,2163,676,1487,14,15,7,7
7488,26,14798,16,8246,1739,6507,21,17,11,10
12484,757,22897,545,70,70,0,1,5,1,0
22096,10,5405,9,184,94,90,2,31,1,1
11122,15,19197,11,426,240,186,8,25,5,3
18299,26,24031,16,9079,3570,5509,68,152,34,34
16011,26,11011,16,9124,5296,3828,54,120,29,25
22710,26,3163,16,92427,4519,87908,105,15,39,66
11103,15,20004,11,482,300,182,9,26,6,3
15909,10,15080,9,196,102,94,2,30,1,1
8033,10,20935,9,628,82,546,2,30,1,1
9624,26,22769,16,14848,6716,8132,32,30,17,15
19371,26,7186,16,104543,5227,99316,130,47,57,73
14676,26,7429,16,1786,172,1614,7,120,3,4
15954,26,23277,16,1056,569,487,10,24,6,4
22642,10,3799,9,194,102,92,2,31,1,1
4024,10,25624,9,168,78,90,2,30,1,1
10636,26,10251,16,25546,5284,20262,48,149,26,22
8539,10,16082,9,216,110,106,2,30,1,1
16422,26,12470,16,7842,2164,5678,48,5441,20,28
13148,183,23894,121,4365,2581,1784,20,32,11,9
1581,10,5705,9,244,98,146,2,34,1,1
3360,26,7613,16,6749,1593,5156,23,123,12,11
11016,2109,13887,1625,70,70,0,1,5,1,0
10462,26,3549,16,130,70,60,2,4,1,1
14029,10,3119,9,195,102,93,2,30,1,1
15136,10,915,9,199,102,97,2,30,1,1
5107,26,23031,16,90091,3481,86610,95,15,31,64
8099,10,21015,9,229,89,140,2,30,1,1
13740,10,8237,9,183,94,89,2,31,1,1
21989,10,13445,9,195,102,93,2,29,1,1
17158,26,17857,16,318,192,126,6,26,4,2
8925,10,23809,9,164,84,80,2,31,1,1
11864,15,20083,11,156378,5406,150972,165,383,60,105
10070,10,28684,9,209,81,128,2,30,1,1
4766,26,27507,16,190013,14784,175229,238,206,101,137
20409,40,22637,23,9108,4045,5063,84,72,39,45
21093,2682,23139,2082,70,70,0,1,4,1,0
5950,26,19762,16,280,140,140,5,131,3,2
6756,26,2556,16,6259,1816,4443,30,2615,16,14
14091,10,26742,9,168,86,82,2,33,1,1
22186,10,18839,9,198,94,104,2,30,1,1
14246,2274,24914,1761,70,70,0,1,5,1,0
9235,15,12295,11,26128,9214,16914,81,512,40,41
9723,10,9871,9,179,94,85,2,30,1,1
18498,26,18526,16,38888447,473172,38415275,31568,128,5708,25860
15857,10,8909,9,184,94,90,2,30,1,1
13700,10,8503,9,300,102,198,4,40,2,2
21399,10,11480,9,294,93,201,4,42,2,2
1227,15,4060,11,7548,1586,5962,18,21,8,10
15559,15,7555,11,214,140,74,4,35,3,1
6939,15,19331,11,2898,1485,1413,10,15,6,4
15604,26,8879,16,2963,797,2166,10,120,5,5
17851,26,3306,16,7310,967,6343,18,25,10,8
20992,18,24508,13,184,94,90,2,29,1,1
12919,26,7893,16,4013,2840,1173,23,27,13,10
2949,10,12081,9,216,90,126,2,31,1,1
13723,10,8105,9,195,102,93,2,31,1,1
2744,1238,28011,918,897,126,771,2,31,1,1
15357,10,27006,9,227,94,133,2,29,1,1
16318,26,6855,16,6214,1733,4481,13,121,6,7
8392,10,13856,9,295,101,194,4,49,2,2
18279,15,8408,11,70,70,0,2,8,2,0
17097,26,11125,16,3311,1069,2242,13,135,6,7
13401,26,20144,16,4417,2187,2230,16,135,8,8
9471,15,7290,11,7979,802,7177,17,47,8,9
20125,26,18821,16,14786,3978,10808,32,26,15,17
9006,26,1315,16,6212,1823,4389,16,75,9,7
13845,26,1253,16,18132,8636,9496,40,176,23,17
15686,10,1128,9,216,110,106,2,30,1,1
15536,10,15624,9,199,102,97,2,30,1,1
9982,15,20937,11,1213557,27203,1186354,1120,133,327,793
14775,26,14658,16,5415,1730,3685,20,120,9,11
13697,10,24837,9,274,110,164,2,30,1,1
5307,10,16892,9,215,80,135,2,32,1,1
16636,10,0,0,266,85,181,2,30,1,1
14283,10,24356,9,304,110,194,4,34,2,2
5147,26,4409,16,560,280,280,9,27,5,4
6399,15,26151,11,1114,534,580,12,16,7,5
2116,10,8418,9,225,90,135,2,30,1,1
18749,26,8327,16,5737,1929,3808,19,201,11,8
17114,26,29088,16,6508,4230,2278,22,16,12,10
17874,10,28742,9,571,166,405,2,29,1,1
19307,10,10096,9,225,78,147,2,30,1,1
15136,10,7409,9,199,102,97,2,30,1,1
14886,10,28317,9,177,94,83,2,29,1,1
15681,10,3177,9,209,102,107,2,31,1,1
6147,232,14787,147,2380,1500,880,24,130,13,11
14910,10,26612,9,199,102,97,2,30,1,1
13798,10,11811,9,176,90,86,2,30,1,1
8663,26,1174,16,8816,4876,3940,23,31,12,11
21869,10,17544,9,265,94,171,2,30,1,1
9979,26,24016,16,6337,1378,4959,19,135,9,10
14804,10,10198,9,216,110,106,2,30,1,1
6313,15,3405,11,696,413,283,7,15,5,2
7698,15,22113,11,1122,682,440,11,15,6,5
9001,10,6707,9,214,110,104,2,30,1,1
11997,2219,11520,1720,70,70,0,1,5,1,0
21767,26,3889,16,3182,1568,1614,8,120,4,4
13746,10,11227,9,754,94,660,2,31,1,1
11578,15,26626,11,1141,529,612,10,18,6,4
11166,2158,22220,1666,70,70,0,2,8,2,0
9789,26,2008,16,1514,852,662,16,86,9,7
15951,10,6055,9,262,88,174,4,59,2,2
22213,1276,28416,956,735,462,273,2,30,1,1
9733,15,22060,11,1714,1014,700,11,21,6,5
10081,26,22255,16,4453,1546,2907,19,29,11,8
1119,26,18824,16,3614,434,3180,11,15,6,5
22198,10,18868,9,198,102,96,2,30,1,1
5518,10,28969,9,168,78,90,2,30,1,1
10967,1892,15754,1445,70,70,0,2,8,2,0
22481,10,7500,9,758,96,662,2,31,1,1
7045,26,6789,16,4093,2830,1263,21,24,11,10
1867,26,7075,16,6311,1229,5082,18,16,8,10
14038,10,17339,9,168,86,82,2,31,1,1
12611,10,6498,9,168,78,90,2,30,1,1
18446,770,3574,557,564,318,246,9,18,5,4
13616,10,6499,9,194,102,92,2,30,1,1
17045,26,20716,16,14654,9694,4960,36,17,19,17
22636,10,5160,9,254,102,152,2,30,1,1
3741,26,10780,16,6402,1595,4807,23,316,12,11
15452,10,10338,9,168,86,82,2,31,1,1
17951,26,12406,16,93467,4007,89460,107,22,33,74
15671,10,9811,9,214,94,120,2,29,1,1
21499,10,2320,9,215,102,113,2,30,1,1
7923,26,28263,16,9842,2224,7618,20,122,10,10
10561,26,24398,16,213140,10321,202819,260,33,108,152
14633,10,24822,9,815,95,720,2,31,1,1
22488,10,27291,9,190,97,93,2,31,1,1
21278,10,18988,9,186,95,91,2,30,1,1
9667,10,5095,9,168,86,82,2,29,1,1
13675,10,11100,9,94,94,0,1,30,1,0
8686,10,52,9,209,110,99,2,30,1,1
2744,1241,12023,921,895,126,769,2,31,1,1
5477,18,20380,13,184,94,90,2,30,1,1
9728,2982,18867,2316,161,161,0,1,1200,1,0
14372,10,3680,9,199,102,97,2,29,1,1
4405,26,24745,16,13119,3359,9760,39,120,19,20
5155,26,12473,16,8057,2726,5331,27,239,13,14
4480,10,15890,9,234,93,141,2,31,1,1
2420,10,10009,9,825,99,726,2,30,1,1
8752,10,10439,9,212,94,118,2,29,1,1
10026,15,26108,11,5900,751,5149,15,130,7,8
12383,1683,14251,1288,618,432,186,9,17,6,3
20766,1485,19938,1129,738,318,420,12,163,5,7
14521,10,15285,9,211,110,101,2,30,1,1
8977,10,4497,9,166,86,80,2,30,1,1
14919,10,2743,9,268,89,179,4,44,2,2
18536,405,1820,263,70,70,0,1,5,1,0
11123,15,28961,11,366,240,126,7,26,5,2
13705,10,19136,9,167,86,81,2,31,1,1
22061,10,11533,9,772,103,669,2,30,1,1
14492,2891,23981,2245,481,150,331,2,1200,1,1
15126,10,28547,9,183,94,89,2,31,1,1
22458,10,12227,9,184,94,90,2,30,1,1
13857,10,15568,9,183,94,89,2,30,1,1
4410,26,15942,16,1798,1223,575,13,26,8,5
13802,10,20439,9,256,87,169,4,36,2,2
14634,10,28944,9,177,94,83,2,30,1,1
15236,10,841,9,288,93,195,4,32,2,2
17094,26,19554,16,20298,11977,8321,85,139,45,40
10044,26,12224,16,8527,2387,6140,21,31,11,10
14312,10,24130,9,193,102,91,2,31,1,1
9157,10,21193,9,212,102,110,2,30,1,1
15207,15,10521,11,234,234,0,4,12,4,0
21803,10,12095,9,380,110,270,2,30,1,1
10755,1601,20168,1225,70,70,0,1,5,1,0
11384,10,22937,9,229,89,140,2,31,1,1
18583,26,19647,16,45001,3799,41202,74,331,35,39
18472,2250,28826,1742,70,70,0,1,5,1,0
8821,15,4329,11,6485767,147003,6338764,6221,320,2024,4197
8401,10,5729,9,177,94,83,2,30,1,1
21577,10,20071,9,273,90,183,4,32,2,2
15953,10,27074,9,177,94,83,2,30,1,1
9065,26,874,16,4949,1047,3902,22,33,11,11
14255,1194,7543,883,70,70,0,1,5,1,0
18485,3141,19596,2437,341,215,126,5,16,3,2
14216,10,8079,9,168,86,82,2,30,1,1
11520,26,27584,16,153,93,60,2,5,1,1
17875,26,5576,16,11663,1141,10522,30,41,14,16
7146,15,11944,11,6087687,127446,5960241,5920,28,1981,3939
6466,26,22711,16,25223,13115,12108,63,116,33,30
21556,10,10904,9,268,84,184,4,42,2,2
9281,26,19222,16,9798,3571,6227,43,143,23,20
21971,10,4161,9,260,86,174,2,30,1,1
8845,15,11144,11,7256,1682,5574,14,40,6,8
9521,10,10426,9,753,94,659,2,30,1,1
8472,10,18210,9,177,94,83,2,30,1,1
9119,15,28261,11,9810,819,8991,19,15,9,10
6535,26,22412,16,5960402,99613,5860789,5017,133,952,4065
21730,10,22809,9,337,110,227,2,29,1,1
14087,26,356,16,4275,2479,1796,22,316,11,11
13869,10,23941,9,168,86,82,2,31,1,1
8687,15,7162,11,1653,831,822,13,93,7,6
14224,10,21383,9,177,94,83,2,30,1,1
21336,10,14413,9,258,110,148,2,30,1,1
14430,10,14013,9,183,94,89,2,30,1,1
9411,2494,22628,1941,480,149,331,2,1200,1,1
9433,26,22399,16,14559,2721,11838,31,16,17,14
18248,15,17990,11,6017,5209,808,12,30,7,5
9075,15,1045,11,1519,787,732,10,110,6,4
7643,15,26185,11,662,600,62,12,495,11,1
7322,26,27829,16,2267946,70852,2197094,2429,316,859,1570
8454,10,9021,9,405,90,315,4,59,2,2
21540,10,24537,9,215,94,121,2,30,1,1
4294,26,19723,16,7139,1751,5388,32,1372,10,22
13825,15,24290,11,374,240,134,7,15,5,2
15105,10,0,0,206,83,123,2,31,1,1
22320,10,2355,9,253,87,166,4,31,2,2
22407,10,9891,9,183,94,89,2,30,1,1
6330,26,13240,16,10127,4193,5934,30,24,17,13
15456,10,4963,9,87,87,0,2,60,2,0
14397,10,15076,9,166,85,81,2,30,1,1
12521,1534,28796,1168,70,70,0,2,8,2,0
21419,10,2377,9,301,108,193,4,49,2,2
13711,10,12080,9,188,80,108,2,31,1,1
20836,26,20106,16,3182,1568,1614,8,120,4,4
12475,2186,222,1691,492,306,186,8,15,5,3
8872,10,7268,9,296,102,194,4,42,2,2
15644,10,11765,9,259,78,181,2,30,1,1
11085,926,17297,684,316,136,180,6,7,3,3
15841,10,22431,9,214,110,104,2,30,1,1
12173,26,1973,16,4579,2245,2334,12,122,6,6
14980,10,279,9,196,102,94,2,30,1,1
10472,26,974,16,1444,723,721,15,121,8,7
16988,26,23159,16,165763,5072,160691,181,120,61,120
21938,10,13850,9,181,98,83,2,31,1,1
9433,10,20688,9,177,94,83,2,30,1,1
15325,10,20430,9,711,87,624,2,30,1,1
9628,15,23540,11,318,192,126,6,26,4,2
12045,2648,28703,2056,546,306,240,9,142,5,4
10819,15,27720,11,28433,1668,26765,39,20,18,21
15848,10,3743,9,178,94,84,2,30,1,1
2137,10,8548,9,240,98,142,2,29,1,1
7914,10,10042,9,168,78,90,2,30,1,1
15677,10,3022,9,215,102,113,2,30,1,1
8401,10,7328,9,167,86,81,2,30,1,1
22533,10,4211,9,226,102,124,2,30,1,1
9036,15,24161,11,31938,3363,28575,38,88,15,23
22069,10,8297,9,199,102,97,2,30,1,1
8940,26,15248,16,26623,5756,20867,42,126,18,24
2702,15,6812,11,2894,1095,1799,15,131,8,7
15699,10,1203,9,177,94,83,2,30,1,1
4993,26,10698,16,9483,2964,6519,23,17,13,10
1014,26,23915,16,3345,432,2913,11,15,6,5
18813,1989,23934,1519,316,136,180,6,6,3,3
14878,10,23285,9,164,84,80,2,31,1,1
21631,10,22145,9,198,102,96,2,31,1,1
12654,276,817,174,70,70,0,2,7,2,0
6250,1984,20663,1514,211,89,122,4,29,2,2
8355,352,3522,225,1788,1016,772,15,15,8,7
22571,10,3959,9,180,94,86,2,30,1,1
19110,26,27153,16,4575,1668,2907,19,27,11,8
9635,26,5306,16,11995,3850,8145,44,120,23,21
14080,26,23665,16,12806,2828,9978,55,2983,24,31
9177,10,25254,9,258,102,156,2,30,1,1
17141,26,9033,16,18238,3980,14258,61,152,27,34
8869,10,27602,9,228,110,118,2,30,1,1
11178,15,11761,11,366,240,126,7,33,5,2
8632,10,28436,9,324,103,221,4,46,2,2
10546,26,17993,16,1177,624,553,12,16,7,5
15965,10,28013,9,168,86,82,2,30,1,1
22231,10,5780,9,184,94,90,2,31,1,1
12026,26,29139,16,3028365,2245986,782379,11999,627,7647,4352
15236,10,423,9,900,110,790,2,30,1,1
15719,10,25803,9,458,188,270,6,30,3,3
19166,26,16382,16,1786,172,1614,7,120,3,4
21512,10,22389,9,170,87,83,2,31,1,1
19543,15,2408,11,1840,1242,598,11,16,6,5
6415,26,3338,16,10049,2289,7760,35,27,19,16
16036,26,19040,16,1786,172,1614,7,121,3,4
15486,10,13260,9,193,102,91,2,29,1,1
3155,10,16566,9,197,78,119,2,30,1,1
14218,10,21587,9,177,94,83,2,29,1,1
14361,10,15139,9,170,87,83,2,31,1,1
22600,10,11016,9,753,93,660,2,31,1,1
7414,15,9521,11,3574,1669,1905,17,186,10,7
8992,26,27175,16,5523,3016,2507,36,75,20,16
18369,26,6051,16,3982,2461,1521,28,144,14,14
3512,26,16916,16,6829,1261,5568,21,197,11,10
15405,10,25615,9,190,97,93,2,31,1,1
14226,10,27947,9,186,102,84,2,30,1,1
775,10,21209,9,86,86,0,1,30,1,0
13879,26,5940,16,10226,3230,6996,28,47,16,12
9014,26,2670,16,7371,1564,5807,18,89,9,9
14614,10,12034,9,197,102,95,2,33,1,1
5765,26,13933,16,646,292,354,10,41,5,5
11130,26,5936,16,7711,1717,5994,26,361,13,13
5618,26,19397,16,4945,1401,3544,21,25,11,10
9597,15,19357,11,5978,3592,2386,15,34,8,7
15160,10,4769,9,214,102,112,2,30,1,1
15284,26,23765,16,8007,1987,6020,20,15,11,9
15270,10,17051,9,93,93,0,1,30,1,0
9791,26,943,16,3201,1812,1389,15,19,9,6
15132,26,17472,16,8908,1849,7059,31,105,17,14
22409,26,8376,16,7525,3267,4258,36,120,17,19
15053,15,546,11,36057,2080,33977,45,134,19,26
4688,26,20495,16,6277,1868,4409,22,45,13,9
8864,15,1110,11,140258,1720,138538,117,52,18,99
14520,10,28340,9,183,94,89,2,31,1,1
8826,10,24932,9,193,102,91,2,31,1,1
13986,10,17505,9,184,80,104,2,30,1,1
10767,2798,21049,2171,316,136,180,6,5,3,3
8573,15,11736,11,2408,1466,942,10,124,6,4
13721,26,5829,16,1146,360,786,20,75,7,13
10966,814,876,594,70,70,0,2,8,2,0
9664,15,5844,11,1615,793,822,13,91,7,6
3470,15,13101,11,3429,1679,1750,14,22,8,6
12473,2627,18253,2037,70,70,0,1,4,1,0
22286,10,7952,9,177,94,83,2,30,1,1
4835,361,3391,232,1577,594,983,20,1740,10,10
814,10,3443,9,203,82,121,2,30,1,1
12148,26,2553,16,5513,929,4584,20,360,10,10
15192,26,16358,16,5325,1074,4251,18,25,10,8
14969,10,17061,9,173,94,79,2,30,1,1
18330,15,19263,11,3348,2437,911,12,150,7,5
20470,10,8662,9,202,202,0,3,46,3,0
7910,10,10399,9,198,93,105,2,31,1,1
14616,10,23696,9,178,94,84,2,30,1,1
11444,26,3458,16,6650,950,5700,18,75,9,9
8338,10,28008,9,301,102,199,2,30,1,1
11037,1876,6237,1432,70,70,0,2,8,2,0
13656,26,13465,16,469783,461079,8704,444,167,329,115
7511,26,21847,16,6492,1764,4728,56,996,20,36
6977,15,7136,11,120,120,0,3,122,3,0
18462,23,0,0,18789,5169,13620,54,30,27,27
8348,153,22960,108,66,66,0,1,5,1,0
9181,26,9740,16,56408,47400,9008,88,138,49,39
12960,295,23785,190,3370,1595,1775,16,15,9,7
15056,10,26020,9,200,102,98,2,31,1,1
3479,10,14338,9,400,257,143,3,32,2,1
15706,10,7388,9,184,94,90,2,30,1,1
20384,10,15887,9,248,78,170,2,30,1,1
4292,26,1517,16,4041,2623,1418,22,94,12,10
21439,10,8291,9,209,110,99,2,30,1,1
19991,26,27691,16,1210,637,573,14,51,7,7
19320,15,24058,11,214,140,74,4,41,3,1
21799,26,27852,16,9157,2109,7048,27,32,15,12
21211,2229,28612,1728,66,66,0,2,7,2,0
21554,10,14380,9,199,94,105,2,30,1,1
5913,26,18800,16,14659,5023,9636,46,400,14,32
14100,10,14425,9,216,110,106,2,29,1,1
21533,10,1876,9,197,102,95,2,32,1,1
21093,2682,20434,2082,66,66,0,2,8,2,0
4084,26,15072,16,237,177,60,3,5,2,1
11502,26,3708,16,4463,1215,3248,16,121,8,8
2744,1238,6629,918,879,126,753,2,29,1,1
14515,10,12040,9,177,94,83,2,30,1,1
8835,10,12826,9,197,94,103,2,30,1,1
5531,26,6326,16,7787,2370,5417,23,242,11,12
10900,2033,4257,1561,70,70,0,2,8,2,0
22190,10,27713,9,754,94,660,2,30,1,1
14315,2421,5844,1883,164,70,94,2,5,1,1
15082,26,6624,16,4467051,102279,4364772,4340,46,1452,2888
8424,10,17810,9,166,86,80,2,30,1,1
2744,1350,8864,1023,913,126,787,2,31,1,1
12923,15,16422,11,78,78,0,1,5,1,0
5468,26,4521,16,10186,3128,7058,26,16,13,13
10997,539,23499,357,70,70,0,1,4,1,0
3241,26,13838,16,34885,6636,28249,74,51,38,36
22222,10,12266,9,183,94,89,2,31,1,1
12552,15,4684,11,2424,529,1895,11,75,6,5
7036,26,15091,16,9345,2224,7121,40,112,22,18
15548,10,6915,9,413,170,243,6,31,3,3
8680,10,22225,9,780,93,687,2,30,1,1
11126,26,6292,16,283,163,120,4,15,2,2
22506,10,8368,9,802,288,514,8,75,4,4
14455,10,10551,9,180,94,86,2,30,1,1
8459,26,7584,16,80199,66182,14017,134,163,87,47
4579,26,3262,16,7814,2339,5475,26,316,12,14
8437,10,20190,9,322,110,212,4,30,2,2
12149,10,4223,9,199,94,105,2,30,1,1
12932,26,12792,16,661695,28430,633265,779,118,335,444
9728,405,14242,263,1237,369,868,6,1199,3,3
9554,26,2887,16,14049,602,13447,19,35,6,13
22546,10,10320,9,177,94,83,2,30,1,1
22374,10,20572,9,760,97,663,2,31,1,1
2537,10,27727,9,827,91,736,4,29,2,2
15111,10,14334,9,276,94,182,2,30,1,1
15198,10,7742,9,771,101,670,2,30,1,1
7976,26,20340,16,4015,1813,2202,17,256,9,8
9469,26,4856,16,13002,1895,11107,31,202,17,14
11069,1915,13897,1461,66,66,0,1,5,1,0
9218,10,13945,9,718,94,624,2,30,1,1
5961,26,22856,16,3396,1964,1432,16,361,8,8
2226,10,9080,9,247,98,149,2,33,1,1
13324,26,10799,16,11307,7633,3674,25,163,18,7
9085,10,16419,9,212,108,104,2,31,1,1
933,26,19822,16,4943,429,4514,12,15,6,6
12377,10,23154,9,329,102,227,2,30,1,1
21364,10,10456,9,188,96,92,2,31,1,1
3797,10,14831,9,220,90,130,2,30,1,1
22019,10,19755,9,216,102,114,2,30,1,1
22166,10,3428,9,94,94,0,1,30,1,0
2744,1238,24203,918,1624,126,1498,4,31,2,2
8780,10,10452,9,380,110,270,2,29,1,1
5654,15,118,11,3566,1637,1929,18,81,11,7
13516,26,26492,16,678,280,398,11,26,5,6
5682,15,17458,11,1917,1468,449,10,20,6,4
6238,26,18313,16,3414,1979,1435,22,69,11,11
15845,10,5302,9,177,94,83,2,30,1,1
15302,10,10952,9,762,101,661,2,31,1,1
20451,10,21449,9,209,102,107,2,30,1,1
9087,10,3305,9,702,194,508,6,67,3,3
7006,26,10976,16,1053,566,487,10,47,6,4
21789,10,19440,9,168,86,82,2,31,1,1
21468,10,5036,9,211,102,109,2,30,1,1
15485,10,3739,9,198,101,97,2,31,1,1
14501,10,13265,9,177,94,83,2,29,1,1
15196,10,2973,9,760,96,664,2,31,1,1
16082,295,25426,190,3502,1935,1567,15,15,8,7
10100,15,18018,11,1094437,6233,1088204,817,36,92,725
15308,10,422,9,177,94,83,2,30,1,1
8801,10,16558,9,210,110,100,2,29,1,1
8865,10,9953,9,202,103,99,2,31,1,1
21210,10,6302,9,195,94,101,2,30,1,1
13662,26,2280,16,7679,2605,5074,26,45,15,11
14998,10,22445,9,199,102,97,2,30,1,1
4308,26,28791,16,8611,2046,6565,31,394,10,21
12377,381,5818,245,546,306,240,9,143,5,4
21158,1715,15960,1310,70,70,0,1,4,1,0
13654,26,25297,16,16063,2691,13372,38,38,18,20
13845,26,15875,16,4086,1248,2838,24,140,11,13
8180,26,22716,16,769074,31261,737813,876,165,356,520
16139,15,25469,11,36471,5174,31297,57,38,23,34
10953,516,16458,340,70,70,0,2,8,2,0
5717,10,17532,9,228,90,138,2,30,1,1
11151,3008,7047,2339,70,70,0,2,8,2,0
5953,26,3512,16,3135,1968,1167,22,72,12,10
22567,10,20494,9,184,94,90,2,29,1,1
20669,26,15579,16,3749,2597,1152,25,134,15,10
13641,26,24185,16,3154,2012,1142,16,18,10,6
13290,26,4333,16,2936,1546,1390,17,70,10,7
3465,8,14309,8,7825,2062,5763,36,17,17,19
2744,1240,28143,920,917,126,791,2,30,1,1
14301,10,14677,9,179,94,85,2,31,1,1
8804,10,2424,9,210,110,100,2,30,1,1
21961,10,12353,9,350,118,232,2,29,1,1
21940,10,12349,9,168,86,82,2,32,1,1
11303,26,22877,16,6679,2408,4271,23,20,10,13
14387,10,15130,9,182,94,88,2,31,1,1
22233,10,14943,9,587,104,483,4,40,2,2
6382,10,18525,9,847,110,737,2,30,1,1
9829,15,12772,11,60374,30984,29390,250,175,123,127
6841,234,18251,149,10823,1636,9187,32,591,11,21
183,10,10801,9,210,78,132,2,30,1,1
14502,10,20037,9,711,87,624,2,30,1,1
15073,10,17568,9,199,102,97,2,30,1,1
15159,10,23484,9,170,87,83,2,31,1,1
16000,10,9252,9,170,87,83,2,30,1,1
19249,26,12812,16,5589,2260,3329,36,217,17,19
14005,10,20009,9,195,102,93,2,31,1,1
22460,10,27886,9,216,110,106,2,30,1,1
9080,10,23340,9,118,118,0,1,30,1,0
21948,10,9341,9,184,94,90,2,31,1,1
22389,10,22361,9,521,90,431,4,43,2,2
8616,26,25758,16,8411,2042,6369,25,251,13,12
8950,26,2189,16,7805,1949,5856,22,126,12,10
15230,26,17379,16,8058,2038,6020,20,15,11,9
12126,15,3122,11,194,128,66,4,55,3,1
13555,26,8024,16,4364,2141,2223,15,137,7,8
18456,26,7674,16,3371,2029,1342,16,360,8,8
22386,10,5142,9,381,89,292,4,43,2,2
5568,15,17276,11,424,198,226,7,142,4,3
14236,10,4990,9,195,102,93,2,30,1,1
14939,10,29014,9,210,110,100,2,33,1,1
8210,2351,21194,1833,334,158,176,2,1200,1,1
15021,10,13053,9,167,86,81,2,30,1,1
7824,26,22958,16,4019,1462,2557,21,120,11,10
11007,855,1941,630,70,70,0,1,5,1,0
6757,26,5362,16,442,250,192,8,25,5,3
3390,26,4492,16,1067,650,417,10,35,6,4
16768,26,23791,16,17470103,920642,16549461,18410,181,6438,11972
2744,1243,25376,923,890,126,764,2,30,1,1
12654,26,2468,16,499,425,74,4,0,3,1
1599,15,5762,11,3182,2082,1100,18,86,10,8
22357,10,13457,9,184,86,98,2,29,1,1
12666,26,13556,16,499,425,74,4,0,3,1
649,10,2567,9,197,90,107,2,30,1,1
15044,26,22983,16,6081,844,5237,17,15,9,8
15089,10,8276,9,200,102,98,2,31,1,1
8645,10,24673,9,213,94,119,2,29,1,1
22154,10,24873,9,803,390,413,9,71,5,4
8833,10,28994,9,183,94,89,2,30,1,1
11784,26,4540,16,15730,2196,13534,32,436,17,15
19994,26,27694,16,1210,637,573,14,51,7,7
7364,26,20559,16,9815,5382,4433,51,237,20,31
21904,10,16250,9,182,93,89,2,31,1,1
16008,10,25389,9,203,82,121,2,30,1,1
14868,10,16622,9,177,94,83,2,31,1,1
21699,10,24886,9,251,94,157,2,29,1,1
4471,26,8507,16,7474,1298,6176,25,81,11,14
13974,26,22775,16,209596,37190,172406,378,79,184,194
8521,10,27492,9,196,102,94,2,30,1,1
15428,26,20209,16,7092,1795,5297,25,32,14,11
11241,2907,4549,2256,70,70,0,1,4,1,0
8889,26,7205,16,11181,3795,7386,50,20,23,27
5930,10,17868,9,217,87,130,2,30,1,1
2744,1238,27687,918,1006,252,754,4,32,3,1
12123,26,8179,16,21571,8604,12967,38,34,19,19
1159,26,9588,16,8370,2798,5572,31,315,15,16
15952,10,13172,9,183,94,89,2,30,1,1
8156,15,21119,11,1916,1467,449,10,20,6,4
17866,10,11429,9,304,86,218,2,29,1,1
22553,10,1961,9,764,102,662,2,30,1,1
8964,10,26249,9,192,98,94,2,31,1,1
10965,26,3293,16,2780,1797,983,21,35,11,10
9728,530,22570,351,1356,300,1056,6,1200,3,3
13405,10,24039,9,832,106,726,2,30,1,1
4465,26,5372,16,490,210,280,8,131,4,4
12750,42,19613,25,70,70,0,1,4,1,0
22505,10,3672,9,182,94,88,2,30,1,1
10096,26,2385,16,612314,25589,586725,676,127,234,442
1114,26,23999,16,318,192,126,6,34,4,2
12566,1187,7445,876,70,70,0,2,8,2,0
15740,10,4818,9,325,94,231,2,30,1,1
18506,2574,6617,1996,258,70,188,4,8,2,2
7816,26,9274,16,162,102,60,2,5,1,1
13884,10,2883,9,168,86,82,2,31,1,1
8405,346,21385,220,378,180,198,7,53,4,3
17999,26,2752,16,1813,1004,809,16,28,8,8
14542,10,6663,9,202,103,99,2,31,1,1
13720,10,11133,9,815,95,720,2,31,1,1
15851,10,988,9,760,97,663,2,31,1,1
4371,26,521,16,10985,3186,7799,29,204,14,15
7920,26,17146,16,1132,596,536,17,28,9,8
9833,15,22117,11,450,246,204,8,25,5,3
21103,26,28368,16,4651,1744,2907,19,30,11,8
5500,26,16201,16,7656,4286,3370,38,86,19,19
16128,15,2283,11,486,280,206,8,25,5,3
15556,15,13086,11,214,140,74,4,35,3,1
8953,10,8143,9,193,102,91,2,30,1,1
11144,3251,5281,2520,70,70,0,2,8,2,0
9109,15,5101,11,4215,620,3595,14,15,7,7
9686,10,5016,9,782,110,672,2,30,1,1
14782,10,23936,9,177,94,83,2,30,1,1
18540,1505,11945,1145,1303,903,400,12,16,7,5
11025,2560,12592,1989,70,70,0,1,5,1,0
12025,15,8966,11,2959,610,2349,12,15,6,6
2744,1236,9718,916,869,126,743,2,30,1,1
1055,26,19599,16,8693,2545,6148,26,34,13,13
14924,26,18389,16,1463,988,475,12,27,7,5
8210,1216,21194,899,513,152,361,2,1200,1,1
8186,26,4807,16,131514,7190,124324,183,53,72,111
15702,10,10908,9,181,86,95,2,30,1,1
18934,26,19255,16,4621,3079,1542,24,52,13,11
17363,10,26189,9,235,90,145,2,32,1,1
10289,10,26713,9,86,86,0,1,30,1,0
1806,740,10951,531,308,128,180,6,30,3,3
15316,10,1929,9,370,94,276,2,30,1,1
9736,26,7671,16,1304,878,426,12,96,7,5
8840,26,27629,16,8656,2060,6596,20,57,10,10
22399,10,1508,9,177,94,83,2,30,1,1
16528,1820,4711,1387,204,64,140,4,11,2,2
11609,15,23074,11,1950,1338,612,11,14,5,6
636,1563,22159,1194,509,150,359,2,1199,1,1
9132,10,18878,9,751,94,657,2,30,1,1
894,15,5683,11,54219,1884,52335,61,37,23,38
8954,10,19455,9,196,100,96,2,30,1,1
8897,26,3996,16,4484,1063,3421,15,25,7,8
7860,26,1872,16,1056,569,487,10,38,6,4
5392,15,1337,11,1184,524,660,7,78,4,3
18097,26,18530,16,1571,660,911,13,18,7,6
9096,10,7892,9,237,86,151,2,30,1,1
13277,15,10055,11,50436663,1205750,49230913,49415,198,16827,32588
4930,26,12171,16,33229,5348,27881,55,125,26,29
6703,26,27074,16,5719,1339,4380,19,361,9,10
15767,10,5696,9,190,97,93,2,30,1,1
18452,15,29004,11,2499,531,1968,11,125,6,5
14976,10,8569,9,170,87,83,2,31,1,1
9380,10,18224,9,748,94,654,2,30,1,1
10221,233,975,148,4968,1304,3664,26,1190,13,13
8923,10,10357,9,212,94,118,2,29,1,1
21683,10,15652,9,199,102,97,2,30,1,1
12463,26,3557,16,24190,18242,5948,43,330,25,18
14543,10,672,9,180,92,88,2,30,1,1
13783,10,5613,9,214,110,104,2,30,1,1
9667,26,4732,16,1579,988,591,13,45,7,6
18304,26,28020,16,8297,1280,7017,15,135,7,8
14423,10,18492,9,222,102,120,2,30,1,1
19627,15,22006,11,3373,591,2782,11,45,6,5
22399,10,8615,9,164,86,78,2,30,1,1
952,26,5955,16,4942,429,4513,12,15,6,6
12501,26,13218,16,8267,1779,6488,23,150,13,10
21757,10,28224,9,199,102,97,2,30,1,1
15122,10,110,9,177,94,83,2,30,1,1
15526,26,9585,16,66324,17448,48876,86,331,39,47
21226,1372,10657,1043,504,382,122,8,15,6,2
8378,701,22556,499,70,70,0,2,8,2,0
2635,15,11087,11,642,338,304,10,32,6,4
5589,234,8816,149,19172,3089,16083,43,3601,20,23
15941,10,19676,9,752,93,659,2,31,1,1
22255,10,370,9,211,94,117,2,31,1,1
22514,10,25898,9,167,86,81,2,29,1,1
636,325,14916,208,509,150,359,2,1199,1,1
4429,10,17627,9,168,78,90,2,30,1,1
14366,26,1787,16,47102,3841,43261,59,121,25,34
4835,332,14177,213,460,150,310,2,1199,1,1
18554,502,6674,330,70,70,0,2,8,2,0
15165,10,5798,9,166,86,80,2,30,1,1
7155,26,18382,16,2719,1454,1265,22,34,12,10
12608,26,1140,16,499,425,74,4,0,3,1
2744,1384,12868,1053,1660,126,1534,4,30,2,2
13682,26,22907,16,6791,1415,5376,19,51,12,7
3133,2306,22501,1790,330,330,0,6,3609,6,0
22257,26,3596,16,3283,1019,2264,10,120,5,5
15351,843,26225,621,70,70,0,1,5,1,0
14587,10,26935,9,193,102,91,2,30,1,1
19833,26,25129,16,3466,821,2645,11,121,5,6
21776,10,28175,9,889,404,485,10,30,5,5
12556,280,17550,177,70,70,0,2,7,2,0
12018,1430,11958,1085,70,70,0,2,9,2,0
9027,349,4169,222,78,78,0,1,4,1,0
805,26,3334,16,19994,4745,15249,47,82,21,26
10936,802,28837,584,70,70,0,2,8,2,0
7887,26,22987,16,502,250,252,9,32,5,4
22236,10,14583,9,193,102,91,2,29,1,1
15683,15,17937,11,5774,783,4991,17,75,10,7
5555,26,9389,16,10012,3016,6996,40,133,19,21
22038,10,22134,9,166,86,80,2,30,1,1
14208,10,1555,9,195,102,93,2,31,1,1
20307,26,4741,16,3370,1226,2144,13,135,6,7
8547,10,28677,9,199,102,97,2,30,1,1
15548,10,14331,9,197,102,95,2,30,1,1
21883,10,7102,9,387,102,285,2,29,1,1
3812,26,21817,16,16164,3053,13111,31,18,16,15
2724,1240,7189,920,172,86,86,2,29,1,1
13282,26,14805,16,6202,3033,3169,28,167,13,15
5187,26,16737,16,115031,5628,109403,143,104,55,88
21701,10,690,9,177,94,83,2,30,1,1
14192,10,17107,9,194,102,92,2,30,1,1
15777,233,12230,148,9687,5105,4582,30,298,16,14
3703,15,3946,11,2243,1115,1128,14,152,7,7
9670,15,22830,11,259593,12828,246765,308,156,118,190
21368,10,24473,9,213,94,119,2,30,1,1
182,10,14010,9,210,78,132,2,30,1,1
9236,15,18421,11,804,380,424,9,15,5,4
15109,26,7320,16,8381,2848,5533,26,572,14,12
5024,26,6330,16,5846879,177697,5669182,6043,41,2261,3782
18111,26,12623,16,6438,2599,3839,21,144,10,11
22283,10,27166,9,172,94,78,2,30,1,1
14932,10,5600,9,306,99,207,2,31,1,1
15822,10,6182,9,200,102,98,2,30,1,1
6688,26,10236,16,6389,1439,4950,22,18,11,11
11127,26,7021,16,7246,3017,4229,21,15,11,10
15341,10,14604,9,204,104,100,2,30,1,1
14930,10,12262,9,216,110,106,2,31,1,1
4521,15,5440,11,1658,1344,314,10,16,5,5
14666,10,20334,9,208,106,102,2,30,1,1
22421,10,11851,9,196,86,110,2,30,1,1
21799,10,1620,9,413,170,243,6,30,3,3
987,26,25195,16,9051,3480,5571,31,23,17,14
5047,15,1263,11,996,507,489,10,200,5,5
6546,26,18582,16,1583877,43930,1539947,1405,93,297,1108
10484,15,22468,11,7610,2737,4873,23,26,12,11
11477,10,23864,9,302,78,224,2,29,1,1
15707,10,24651,9,178,94,84,2,30,1,1
4805,15,13076,11,991,483,508,9,181,5,4
8572,26,18007,16,7808,2879,4929,36,186,19,17
13665,10,6429,9,760,96,664,2,31,1,1
21267,10,15536,9,195,102,93,2,30,1,1
18396,26,16282,16,5413,3344,2069,32,87,16,16
8370,10,14641,9,195,102,93,2,30,1,1
18779,1989,17723,1519,316,136,180,6,6,3,3
2443,10,10120,9,233,90,143,2,33,1,1
14177,10,404,9,339,94,245,2,30,1,1
9728,1214,15389,898,166,166,0,1,1200,1,0
4850,2504,6172,1947,156,156,0,3,8,3,0
8718,10,10696,9,194,102,92,2,30,1,1
22349,10,803,9,210,110,100,2,29,1,1
8464,15,27694,11,16249,1328,14921,28,45,14,14
9461,10,7440,9,816,102,714,2,30,1,1
4651,26,7270,16,499,425,74,4,0,3,1
21880,10,16313,9,755,93,662,2,31,1,1
12999,26,16180,16,499,425,74,4,0,3,1
21248,10,15999,9,200,102,98,2,30,1,1
4835,217,14659,140,3957,2324,1633,51,1720,29,22
14504,15,24642,11,1917,1468,449,10,20,6,4
9719,10,18170,9,184,94,90,2,30,1,1
18923,26,27048,16,4886,1530,3356,17,17,10,7
14266,1600,27137,1224,564,318,246,9,15,5,4
15326,10,7150,9,752,93,659,2,30,1,1
2744,1283,12898,962,893,126,767,2,30,1,1
15025,26,16877,16,15813,5998,9815,30,120,14,16
22082,10,13391,9,195,94,101,2,30,1,1
14247,10,28522,9,183,94,89,2,30,1,1
8327,2035,7576,1563,854,150,704,4,1201,2,2
13617,10,4408,9,210,110,100,2,30,1,1
12050,26,26835,16,9458,4646,4812,26,25,14,12
10853,706,181,504,70,70,0,1,5,1,0
69,10,58,9,196,88,108,2,30,1,1
14266,10,28046,9,168,86,82,2,30,1,1
10008,26,24559,16,1786,172,1614,7,120,3,4
19536,26,19051,16,16358,3103,13255,39,19,19,20
3748,26,2838,16,1701,1048,653,15,39,8,7
15132,10,21994,9,184,94,90,2,30,1,1
9814,26,12509,16,11940,3585,8355,43,16,24,19
16017,15,15580,11,234,234,0,4,11,4,0
12650,26,23623,16,7656,4622,3034,24,139,12,12
14347,26,1759,16,2936,343,2593,12,120,5,7
12170,15,10967,11,124,64,60,3,5,2,1
22053,10,2678,9,174,89,85,2,30,1,1
6896,26,172,16,7092,1495,5597,22,31,12,10
15375,1,20103,1,70,70,0,1,5,1,0
8614,26,17784,16,186882,17018,169864,206,29,84,122
8788,26,16507,16,11139,3031,8108,30,176,14,16
16021,924,21682,682,528,528,0,9,1200,9,0
22551,10,7892,9,193,102,91,2,31,1,1
8324,10,18212,9,184,94,90,2,29,1,1
9322,10,5039,9,211,78,133,2,30,1,1
4964,26,26957,16,499,425,74,4,0,3,1
14499,10,24620,9,166,86,80,2,30,1,1
2887,26,17518,16,5456,1388,4068,17,15,9,8
9513,10,7387,9,166,86,80,2,29,1,1
15181,183,24992,121,4130,2105,2025,18,16,9,9
12683,26,13763,16,499,425,74,4,0,3,1
11014,2793,1889,2167,70,70,0,2,8,2,0
258,10,666,9,371,237,134,3,34,2,1
8730,10,25301,9,168,78,90,2,30,1,1
10835,26,26682,16,6339,1901,4438,16,120,8,8
22105,10,21778,9,252,102,150,2,29,1,1
790,368,9596,236,66,66,0,1,30,1,0
8463,15,16823,11,1515,481,1034,11,15,6,5
8576,10,28988,9,172,88,84,2,31,1,1
9003,26,16959,16,17843,13076,4767,27,134,17,10
3842,26,24908,16,15321,1796,13525,26,326,11,15
21468,10,15934,9,193,102,91,2,31,1,1
12406,1790,2057,1366,70,70,0,1,5,1,0
8210,2393,21194,1860,158,158,0,1,1200,1,0
10954,1353,23375,1026,70,70,0,1,5,1,0
14537,10,4742,9,711,87,624,2,30,1,1
13692,26,16616,16,30239,8906,21333,61,32,34,27
8777,10,19232,9,184,94,90,2,30,1,1
12050,1458,2309,1111,70,70,0,2,7,2,0
8906,10,14987,9,167,86,81,2,30,1,1
6297,26,16159,16,7747,1737,6010,27,316,13,14
15129,10,8324,9,701,88,613,2,30,1,1
7087,26,5121,16,3607,2257,1350,22,19,12,10
16021,731,25269,523,924,924,0,15,1200,15,0
13002,26,16231,16,499,425,74,4,0,3,1
5606,1991,10747,1521,148,86,62,2,30,1,1
22281,15,28947,11,169702,10513,159189,187,23,72,115
12149,26,28767,16,6136,1916,4220,28,15,16,12
10327,129,10664,97,870,330,540,12,1316,6,6
4185,26,4580,16,3870,1743,2127,13,120,6,7
10942,2260,2727,1750,1345,679,666,9,30,5,4
9966,26,21678,16,7298,2661,4637,21,17,11,10
21751,10,17930,9,211,102,109,2,30,1,1
5504,26,923,16,2042,1022,1020,17,80,9,8
21493,26,19705,16,2227,1018,1209,17,16,8,9
15469,15,13875,11,2684,2550,134,7,16,5,2
14600,10,23043,9,199,102,97,2,30,1,1
5120,26,4851,16,1185199,19993,1165206,1088,16,289,799
22602,10,14814,9,354,102,252,2,30,1,1
11099,15,13114,11,362,240,122,7,25,5,2
10875,15,20225,11,502,310,192,9,31,6,3
18954,26,20135,16,17149,2543,14606,40,46,22,18
18756,1989,20243,1519,316,136,180,6,6,3,3
13645,10,18610,9,253,87,166,4,29,2,2
10155,26,16853,16,14697,3801,10896,52,120,24,28
14659,15,21542,11,1151,711,440,10,15,5,5
2744,1238,28974,918,883,126,757,2,30,1,1
15212,10,20035,9,199,102,97,2,30,1,1
8340,10,20602,9,234,94,140,2,30,1,1
18643,15,19021,11,130,70,60,2,15,1,1
14670,10,24528,9,186,95,91,2,31,1,1
9118,10,20732,9,228,110,118,2,30,1,1
11639,15,23865,11,8280,5678,2602,25,111,14,11
21722,10,8870,9,290,102,188,2,30,1,1
21803,10,17216,9,184,94,90,2,30,1,1
8584,1240,6253,920,252,78,174,2,30,1,1
22236,10,13901,9,186,95,91,2,30,1,1
14613,10,25228,9,183,102,81,2,29,1,1
12436,1079,17280,792,70,70,0,2,7,2,0
22013,10,8167,9,763,102,661,2,29,1,1
13586,26,13031,16,7148,1924,5224,35,364,19,16
14451,10,28762,9,183,94,89,2,30,1,1
6769,18,8788,13,184,94,90,2,30,1,1
14571,10,16841,9,186,95,91,2,31,1,1
12538,355,26972,228,70,70,0,1,5,1,0
17927,10,26517,9,228,97,131,2,30,1,1
9157,10,1043,9,211,102,109,2,30,1,1
8792,26,16371,16,8266,1963,6303,28,175,14,14
14042,10,16062,9,199,102,97,2,30,1,1
9631,15,10758,11,378,192,186,7,21,4,3
16363,26,17637,16,1851,1212,639,18,177,11,7
13927,10,2005,9,754,94,660,2,31,1,1
14004,10,29030,9,79,79,0,2,35,2,0
11107,15,15424,11,366,240,126,7,26,5,2
8828,26,16886,16,2690,1342,1348,23,19,12,11
5776,341,16129,217,195,71,124,4,58,2,2
13652,10,11654,9,198,102,96,2,31,1,1
8595,10,7889,9,204,104,100,2,31,1,1
16377,15,6900,11,6457,1210,5247,14,17,8,6
14886,10,5550,9,170,87,83,2,30,1,1
11269,26,24663,16,6564,3283,3281,19,140,10,9
15871,10,645,9,195,102,93,2,31,1,1
5812,10,6716,9,168,78,90,2,30,1,1
7996,10,20876,9,197,90,107,2,30,1,1
11962,26,7679,16,13074,8472,4602,31,135,16,15
14439,10,22420,9,177,94,83,2,30,1,1
18595,15,26857,11,84558,3469,81089,94,16,34,60
3991,10,22230,9,164,78,86,2,30,1,1
14923,26,13912,16,49417,5511,43906,108,439,54,54
22516,10,12585,9,816,102,714,2,30,1,1
8420,10,16630,9,727,86,641,2,29,1,1
22338,10,17691,9,167,86,81,2,31,1,1
8017,26,9511,16,20124,12085,8039,54,385,29,25
13919,10,6491,9,711,87,624,2,30,1,1
21198,2950,17029,2289,70,70,0,1,5,1,0
7371,26,12240,16,13018,2021,10997,34,95,14,20
4074,26,8911,16,15162,8505,6657,55,197,29,26
12030,26,17624,16,8349,1987,6362,23,30,12,11
10932,2862,15320,2221,316,136,180,6,5,3,3
22378,10,3662,9,778,103,675,2,30,1,1
4621,26,16121,16,4673,1766,2907,19,26,11,8
15342,10,26065,9,177,94,83,2,30,1,1
19395,26,2947,16,15255,2304,12951,30,31,13,17
12002,1417,21090,1078,70,70,0,1,5,1,0
22592,10,25541,9,235,102,133,2,29,1,1
11208,26,3097,16,414,140,274,7,26,3,4
15518,26,4980,16,7818,2136,5682,31,322,14,17
1731,331,27503,212,858,858,0,14,1200,14,0
21770,10,12453,9,94,94,0,1,30,1,0
9038,26,21388,16,15358,8278,7080,47,19,24,23
11171,26,7237,16,15637,4217,11420,42,83,19,23
18198,26,10815,16,572,280,292,9,16,5,4
4130,15,15338,11,201552,13184,188368,245,30,111,134
14354,1588,5578,1218,70,70,0,2,8,2,0
16579,104,25753,81,60,60,0,2,5,2,0
22444,10,16145,9,183,94,89,2,30,1,1
12630,26,15535,16,499,425,74,4,0,3,1
8462,26,3746,16,4179,2599,1580,27,75,13,14
9044,10,2038,9,194,102,92,2,30,1,1
8468,10,11342,9,353,118,235,2,31,1,1
14428,10,23328,9,200,102,98,2,30,1,1
4928,26,16445,16,4782,1875,2907,19,29,11,8
21986,10,24614,9,212,108,104,2,31,1,1
7538,15,19672,11,540,540,0,10,194,10,0
11470,26,19960,16,6270,1368,4902,22,15,12,10
13875,10,26775,9,720,94,626,2,30,1,1
8673,10,29058,9,177,94,83,2,30,1,1
9130,10,15663,9,182,102,80,2,30,1,1
9608,15,9396,11,8453,2011,6442,17,21,8,9
4677,26,13735,16,21234,9602,11632,48,70,28,20
9033,26,20448,16,7910,1967,5943,30,55,15,15
14775,10,5139,9,183,102,81,2,29,1,1
21546,10,922,9,183,94,89,2,31,1,1
14320,26,24545,16,7516,1498,6018,25,79,11,14
18505,2530,17846,1966,624,318,306,10,15,5,5
4716,10,16190,9,245,106,139,2,29,1,1
12738,541,4362,359,70,70,0,2,7,2,0
6435,10,20684,9,199,94,105,2,30,1,1
11983,26,15156,16,7676,1577,6099,28,395,9,19
6110,26,4554,16,22648,14673,7975,96,245,45,51
15048,10,8718,9,196,100,96,2,31,1,1
8804,10,11955,9,331,88,243,4,32,2,2
22048,10,22152,9,291,86,205,2,30,1,1
8957,10,2261,9,777,87,690,2,30,1,1
14969,10,8587,9,275,95,180,4,44,2,2
8378,15,19176,11,8971,1094,7877,17,15,7,10
17612,26,2486,16,2946,1812,1134,16,15,8,8
1110,26,11322,16,318,192,126,6,34,4,2
5875,26,1761,16,1848,1139,709,14,579,8,6
13471,26,22461,16,9501,1502,7999,24,29,13,11
15229,10,20661,9,102,102,0,1,30,1,0
12138,26,7274,16,3292049,87705,3204344,3470,232,1188,2282
18639,26,26888,16,4572,1665,2907,19,27,11,8
8684,10,28992,9,167,86,81,2,30,1,1
11120,15,27235,11,2774,703,2071,12,22,7,5
12504,15,9931,11,3741,3008,733,16,15,10,6
8794,10,23914,9,168,86,82,2,30,1,1
14857,10,15629,9,102,102,0,1,30,1,0
21318,10,18380,9,198,94,104,2,30,1,1
19278,26,11894,16,32082,12801,19281,62,150,25,37
12105,26,7852,16,26702,3270,23432,40,136,16,24
13656,26,20348,16,6953,2447,4506,26,37,15,11
6518,26,10131,16,10030,3002,7028,24,16,13,11
14690,10,24022,9,177,94,83,2,30,1,1
14862,10,27608,9,177,94,83,2,29,1,1
15027,10,26913,9,177,94,83,2,29,1,1
8443,15,1587,11,254,128,126,5,16,3,2
13878,10,1713,9,177,94,83,2,30,1,1
7116,26,15689,16,1699,1038,661,16,276,9,7
1380,26,4738,16,19187,5127,14060,38,22,23,15
8379,10,14593,9,1188,94,1094,2,29,1,1
3770,26,19654,16,8363,1573,6790,24,49,14,10
14117,10,22868,9,793,101,692,2,31,1,1
18898,26,8453,16,34862,6364,28498,64,54,31,33
12691,1082,11110,794,320,140,180,6,5,3,3
8668,10,15029,9,179,86,93,2,29,1,1
0,0,0,0,480,244,236,4,0,2,2
16733,18,16163,13,184,94,90,2,30,1,1
15538,10,16934,9,183,94,89,2,30,1,1
8364,10,11558,9,751,95,656,2,30,1,1
5396,26,2821,16,6517,2048,4469,21,90,12,9
18450,1571,10205,1202,320,140,180,6,7,3,3
15848,26,3851,16,2685,1353,1332,17,19,10,7
11407,26,28528,16,13978,8842,5136,46,52,26,20
20586,295,28064,190,4067,1750,2317,16,15,9,7
15369,26,6714,16,8073,2053,6020,20,15,11,9
9192,10,24996,9,323,110,213,2,29,1,1
15482,26,16723,16,31860,21778,10082,84,190,42,42
9386,10,11226,9,183,94,89,2,30,1,1
2091,10,8264,9,832,106,726,2,30,1,1
14091,10,4917,9,168,86,82,2,32,1,1
22548,10,20228,9,592,105,487,4,50,2,2
14148,10,27787,9,211,102,109,2,30,1,1
14054,10,27769,9,198,102,96,2,32,1,1
13968,10,17166,9,210,102,108,2,29,1,1
11584,10,0,0,418,154,264,4,33,2,2
900,26,11880,16,6128,763,5365,17,29,9,8
21023,1441,8988,1095,70,70,0,1,4,1,0
9141,10,16055,9,212,94,118,2,30,1,1
14518,10,21458,9,184,94,90,2,30,1,1
9204,10,15129,9,738,86,652,2,29,1,1
11138,934,2056,688,70,70,0,2,8,2,0
13698,10,4311,9,196,102,94,2,31,1,1
8584,1238,16769,918,78,78,0,1,29,1,0
17053,26,24699,16,5167,700,4467,16,14,7,9
10803,15,28338,11,40993,2984,38009,57,24,28,29
15762,10,20477,9,184,94,90,2,30,1,1
4965,15,9422,11,1818,1504,314,13,16,8,5
8879,10,19335,9,177,94,83,2,30,1,1
13142,26,11000,16,12260,3870,8390,52,283,27,25
22716,10,25620,9,194,94,100,2,30,1,1
8347,10,11715,9,359,118,241,2,30,1,1
12590,1315,6573,992,70,70,0,1,4,1,0
12854,26,16826,16,7653,1188,6465,21,16,12,9
15212,10,7683,9,214,110,104,2,30,1,1
18731,10,15494,9,260,86,174,2,30,1,1
8513,15,21442,11,450,246,204,8,142,5,3
14124,10,19055,9,185,102,83,2,30,1,1
15227,10,4420,9,177,94,83,2,30,1,1
15832,10,383,9,186,95,91,2,31,1,1
22571,10,12011,9,180,94,86,2,30,1,1
15514,26,14241,16,4581,2831,1750,29,96,15,14
3947,10,15057,9,86,86,0,1,30,1,0
15352,26,8814,16,8654,2150,6504,20,16,11,9
8504,10,22590,9,258,126,132,2,30,1,1
15564,15,11714,11,1638,1324,314,10,15,5,5
11050,15,25553,11,426,240,186,8,24,5,3
22461,10,11189,9,356,88,268,4,55,2,2
15396,10,26628,9,199,102,97,2,30,1,1
11992,26,12883,16,7149,1719,5430,18,326,9,9
14325,664,2014,465,564,318,246,9,15,5,4
9008,10,27554,9,368,118,250,2,30,1,1
17545,10,699,9,199,94,105,2,30,1,1
9058,26,18846,16,5597,1462,4135,21,86,11,10
14994,10,25813,9,174,89,85,2,31,1,1
14179,10,3768,9,209,110,99,2,30,1,1
12291,264,24570,165,245,245,0,2,30,2,0
18060,26,28955,16,8677,2714,5963,21,114,13,8
10964,26,12619,16,550,310,240,10,35,6,4
18011,26,4512,16,343,163,180,6,15,3,3
9341,10,22501,9,754,94,660,2,30,1,1
14954,10,12433,9,200,102,98,2,31,1,1
21870,26,8795,16,3433,1192,2241,13,136,6,7
22584,26,25391,16,5121,936,4185,17,27,9,8
15418,3221,23329,2498,70,70,0,1,5,1,0
8911,26,23990,16,4043,1781,2262,19,128,11,8
9439,26,27472,16,12677,3097,9580,37,26,19,18
22722,10,15255,9,277,134,143,2,30,1,1
14735,10,21142,9,277,134,143,2,30,1,1
16021,291,2112,187,132,132,0,3,1199,3,0
14600,10,3142,9,199,102,97,2,29,1,1
16351,26,2252,16,9256443,112898,9143545,7609,178,1428,6181
14379,345,27969,219,70,70,0,2,8,2,0
10737,1494,7055,1135,70,70,0,1,5,1,0
15169,10,6859,9,167,86,81,2,30,1,1
9728,2627,20527,2037,1275,300,975,6,1200,3,3
21904,10,27212,9,183,94,89,2,31,1,1
8531,10,27323,9,182,94,88,2,30,1,1
14752,10,25801,9,195,102,93,2,31,1,1
2744,1240,20840,920,1616,126,1490,4,30,2,2
22209,1258,27201,938,3287,2072,1215,12,30,6,6
15834,233,19655,148,4339,1521,2818,23,3002,14,9
9075,10,1156,9,200,94,106,2,30,1,1
3923,26,2254,16,33823,28233,5590,84,102,47,37
21575,10,14511,9,198,101,97,2,30,1,1
9054,26,1249,16,6370237,150385,6219852,6047,138,1688,4359
21028,2814,16500,2184,1233,902,331,12,17,8,4
11332,26,21779,16,1574859,55851,1519008,1758,185,656,1102
1024,26,15977,16,3616,429,3187,11,15,6,5
17225,26,17022,16,5167,700,4467,16,15,7,9
21632,26,11190,16,4017,978,3039,14,53,8,6
20552,26,28180,16,304,86,218,2,30,1,1
12128,26,9488,16,982624,22331,960293,976,137,293,683
2744,1238,19401,918,939,126,813,2,30,1,1
10920,1521,4798,1159,70,70,0,1,5,1,0
15248,10,5638,9,186,95,91,2,31,1,1
9848,15,21051,11,1082,896,186,18,214,15,3
8999,26,1645,16,10066,4676,5390,27,123,15,12
9521,10,3763,9,167,78,89,2,30,1,1
14458,26,7907,16,7034,2039,4995,37,255,18,19
15137,10,6299,9,216,110,106,2,30,1,1
15002,10,25922,9,168,86,82,2,30,1,1
11857,26,26968,16,9564,2054,7510,42,114,20,22
22623,15,20103,11,486,240,246,9,28,5,4
21729,10,14631,9,280,97,183,4,59,2,2
13613,10,12010,9,211,110,101,2,30,1,1
19510,26,20777,16,5943,1991,3952,23,17,14,9
2481,10,18586,9,168,78,90,2,30,1,1
14199,10,10432,9,168,86,82,2,29,1,1
14358,10,6471,9,196,102,94,2,30,1,1
10794,26,22648,16,4632,1725,2907,19,27,11,8
8678,10,10992,9,195,102,93,2,30,1,1
15232,26,15990,16,1342,918,424,10,25,6,4
22268,10,8768,9,324,97,227,4,52,2,2
3046,10,27599,9,300,94,206,2,30,1,1
936,15,3289,11,2819,541,2278,12,31,6,6
9645,15,25959,11,318,192,126,6,25,4,2
9019,26,28868,16,28887,9850,19037,96,60,41,55
12786,37,2560,22,70,70,0,1,5,1,0
13825,10,28437,9,194,102,92,2,30,1,1
16021,2627,2329,2037,493,166,327,2,1200,1,1
11801,26,4495,16,12876,2739,10137,44,118,21,23
9696,10,24962,9,710,89,621,2,30,1,1
875,26,9709,16,4400,433,3967,12,15,6,6
156,10,362,9,832,106,726,2,29,1,1
15313,15,24562,11,1462,703,759,8,16,5,3
14655,10,18768,9,740,93,647,2,31,1,1
21443,10,6656,9,210,94,116,2,30,1,1
12752,26,18456,16,499,425,74,4,0,3,1
9718,26,28010,16,7352,1023,6329,19,16,11,8
9243,15,5279,11,2173,616,1557,10,15,6,4
9235,15,13284,11,1052,612,440,10,15,5,5
20398,40,13339,23,10457,4879,5578,98,186,50,48
16317,26,2754,16,215996,13055,202941,265,127,96,169
8444,10,2067,9,199,86,113,2,29,1,1
14332,10,18186,9,193,102,91,2,30,1,1
14445,15,6052,11,1281,398,883,16,393,4,12
17210,26,25612,16,27575,18478,9097,64,22,36,28
15057,10,12141,9,775,103,672,2,30,1,1
12316,15,28763,11,1360,540,820,20,187,10,10
5608,26,1986,16,3910,2223,1687,24,3676,8,16
6250,2018,11524,1548,148,86,62,2,30,1,1
14651,10,27556,9,178,94,84,2,30,1,1
18544,161,7534,111,320,140,180,6,7,3,3
22392,1302,20831,980,278,71,207,2,30,1,1
18878,26,3825,16,4479,788,3691,17,25,9,8
13741,10,24451,9,193,102,91,2,30,1,1
16045,26,25404,16,4546,1639,2907,19,27,11,8
8729,10,25196,9,199,94,105,2,29,1,1
13599,26,14114,16,7118,2618,4500,21,30,12,9
12903,26,7648,16,6673,1531,5142,22,341,10,12
10368,545,8272,362,70,70,0,2,8,2,0
14265,10,10369,9,202,103,99,2,31,1,1
8479,10,11561,9,772,102,670,2,30,1,1
2951,10,5293,9,236,86,150,2,30,1,1
14268,10,22167,9,742,88,654,2,31,1,1
4080,15,4799,11,1566,684,882,10,15,5,5
18409,15,15563,11,2124,1158,966,13,87,7,6
8584,1238,9318,918,243,78,165,2,31,1,1
21550,10,20232,9,199,94,105,2,30,1,1
18484,281,10595,178,70,70,0,1,5,1,0
1040,26,10027,16,3613,433,3180,11,15,6,5
11266,688,11129,487,70,70,0,1,5,1,0
22157,10,20692,9,292,126,166,2,29,1,1
15340,10,5715,9,188,96,92,2,31,1,1
22162,10,282,9,183,94,89,2,30,1,1
636,1887,20905,1441,509,150,359,2,1199,1,1
11553,26,2708,16,3523,518,3005,12,15,6,6
10357,10,6516,9,259,86,173,2,30,1,1
22404,10,1849,9,216,110,106,2,30,1,1
7017,26,17705,16,2134,1397,737,18,1162,10,8
17732,10,26424,9,229,89,140,2,31,1,1
6464,26,28181,16,4664,962,3702,15,120,7,8
10924,1190,3098,879,70,70,0,1,5,1,0
9831,26,2847,16,1199,618,581,13,29,6,7
11020,2114,202,1630,66,66,0,1,5,1,0
5758,26,2306,16,1093,662,431,10,41,6,4
9974,10,3271,9,70,70,0,1,30,1,0
17297,26,23513,16,10196,6897,3299,39,121,20,19
8327,287,9061,184,311,311,0,3,1200,3,0
19622,26,22792,16,3109,812,2297,13,136,6,7
8345,10,4630,9,822,102,720,2,29,1,1
12662,26,4849,16,499,425,74,4,0,3,1
22570,26,16106,16,76625,63648,12977,139,83,79,60
612,189,2457,124,60,60,0,1,5,1,0
13680,10,17214,9,164,86,78,2,29,1,1
4045,26,12532,16,1633,1038,595,14,34,8,6
17049,26,9531,16,6246,4267,1979,21,16,11,10
13418,10,21564,9,168,78,90,2,30,1,1
13862,10,26383,9,711,87,624,2,30,1,1
17896,26,16600,16,142,142,0,1,5,1,0
9239,233,14716,148,10876,5991,4885,39,93,22,17
4468,26,26352,16,15329,7087,8242,108,310,61,47
2744,1324,22456,1000,893,126,767,2,30,1,1
14790,10,18249,9,211,110,101,2,30,1,1
21738,10,16237,9,209,102,107,2,30,1,1
9530,15,11143,11,6718,3126,3592,16,77,8,8
7632,26,17996,16,3998,1986,2012,20,255,10,10
21916,10,26926,9,183,94,89,2,30,1,1
12155,26,5678,16,12822,4426,8396,42,18,24,18
21331,10,3903,9,265,91,174,4,37,2,2
15507,10,6684,9,216,110,106,2,29,1,1
22571,10,4764,9,176,90,86,2,31,1,1
7123,15,19600,11,2895,1484,1411,10,15,6,4
13389,26,27245,16,3648,1080,2568,18,135,8,10
5684,107,17459,83,156,156,0,3,8,3,0
22392,1304,17951,982,252,78,174,2,29,1,1
8598,10,17656,9,338,118,220,2,29,1,1
4207,26,15464,16,261234,32183,229051,326,212,153,173
14303,2514,11336,1954,504,318,186,8,16,5,3
15238,10,4283,9,181,94,87,2,33,1,1
6151,26,11699,16,26109,3251,22858,60,256,31,29
12390,26,24053,16,7330,2295,5035,19,135,9,10
21246,26,6041,16,22930,2512,20418,37,75,17,20
14621,10,4996,9,195,102,93,2,31,1,1
7370,26,3069,16,137024,6442,130582,171,109,61,110
14814,10,18993,9,183,94,89,2,30,1,1
8584,1240,15063,920,78,78,0,1,30,1,0
14213,2448,20128,1901,70,70,0,2,8,2,0
3133,2303,1689,1787,330,330,0,6,3609,6,0
6392,26,24424,16,13859,3232,10627,50,256,21,29
9163,10,1749,9,178,91,87,2,31,1,1
21125,291,14032,187,70,70,0,1,5,1,0
14219,10,17029,9,195,102,93,2,31,1,1
12834,10,16398,9,294,86,208,2,30,1,1
14682,10,14514,9,807,94,713,2,29,1,1
16021,1591,22539,1219,166,166,0,1,1199,1,0
14508,10,21257,9,168,86,82,2,30,1,1
14932,10,3605,9,190,97,93,2,30,1,1
18941,26,26110,16,1373,712,661,14,18,8,6
7670,26,23095,16,8394,3155,5239,28,271,16,12
20004,26,7336,16,9125,2616,6509,30,76,14,16
14217,10,5048,9,177,94,83,2,30,1,1
12592,26,8971,16,499,425,74,4,0,3,1
2744,1296,11286,974,890,126,764,2,30,1,1
9422,26,23550,16,9984,2917,7067,49,102,28,21
11097,2383,25010,1851,70,70,0,1,5,1,0
8833,10,16787,9,261,94,167,2,30,1,1
21947,10,4914,9,466,108,358,4,45,2,2
6999,1838,2235,1399,150,150,0,1,1200,1,0
636,293,27408,188,150,150,0,1,1200,1,0
15421,10,9841,9,192,98,94,2,31,1,1
22686,10,11347,9,197,102,95,2,30,1,1
9042,10,28530,9,327,102,225,2,30,1,1
21550,10,4237,9,387,94,293,4,51,2,2
18113,26,8838,16,10021,3035,6986,30,46,17,13
9748,26,21681,16,7470,2479,4991,20,135,9,11
22649,15,29117,11,48356,4069,44287,55,48,19,36
9118,26,27269,16,25995,13597,12398,53,186,28,25
12393,1066,322,785,70,70,0,2,8,2,0
7850,1664,0,0,106,106,0,1,60,1,0
21856,10,11217,9,753,93,660,2,30,1,1
6250,1986,13071,1516,143,81,62,2,31,1,1
15166,10,19284,9,305,94,211,2,30,1,1
8869,10,9674,9,288,102,186,2,31,1,1
21360,26,28489,16,140818,8751,132067,156,168,57,99
11019,1436,17444,1090,258,70,188,4,8,2,2
11079,26,7468,16,7710,2476,5234,18,135,8,10
9584,10,23124,9,458,188,270,6,29,3,3
15238,26,4143,16,8057,2037,6020,20,15,11,9
3703,26,7520,16,2450,1451,999,19,315,10,9
10520,166,22493,114,156,156,0,3,8,3,0
21414,10,26727,9,184,94,90,2,31,1,1
4711,26,1594,16,8493,2314,6179,33,16,18,15
16490,15,26904,11,130,70,60,2,15,1,1
6483,26,2588,16,4909,1007,3902,14,35,8,6
14456,10,22417,9,177,94,83,2,30,1,1
21324,10,18832,9,209,110,99,2,29,1,1
17819,26,29095,16,6129,3123,3006,12,120,7,5
8584,1238,28177,918,244,78,166,2,30,1,1
10023,15,28616,11,136656,9764,126892,162,140,70,92
8331,26,19911,16,7292,950,6342,19,75,9,10
21721,10,2187,9,183,94,89,2,30,1,1
15485,10,1111,9,199,102,97,2,30,1,1
4160,26,8118,16,6982,1728,5254,23,27,13,10
14303,10,20574,9,198,102,96,2,30,1,1
22161,10,9980,9,208,106,102,2,31,1,1
9110,15,19539,11,31517,1203,30314,38,15,15,23
20496,10,21983,9,384,166,218,2,29,1,1
8688,15,24574,11,6908,1652,5256,26,225,12,14
9017,15,12781,11,15055,6439,8616,26,89,14,12
15556,10,27650,9,221,94,127,2,29,1,1
9266,10,13506,9,174,89,85,2,30,1,1
16021,826,12596,606,870,330,540,12,1496,6,6
21007,1138,1351,839,504,382,122,8,16,6,2
5499,26,27391,16,6128,3746,2382,48,46,25,23
7418,330,10584,211,1440,956,484,15,35,8,7
6490,26,2284,16,7098,2628,4470,20,16,12,8
8560,26,17237,16,6211,1869,4342,18,181,8,10
20285,15,26970,11,1516,481,1035,11,15,6,5
15334,2826,1520,2193,70,70,0,2,8,2,0
6999,280,1171,177,324,150,174,2,1201,1,1
15379,1652,25220,1269,70,70,0,1,5,1,0
12492,1188,9638,877,612,306,306,10,15,5,5
9181,15,4666,11,827,687,140,6,32,4,2
225,10,18623,9,204,118,86,2,30,1,1
16934,10,11659,9,218,78,140,2,31,1,1
21635,10,9663,9,179,94,85,2,30,1,1
21843,10,24790,9,193,102,91,2,30,1,1
15605,10,7021,9,166,86,80,2,31,1,1
9728,614,22175,423,166,166,0,1,1200,1,0
13817,10,10941,9,762,97,665,2,31,1,1
6321,10,18117,9,168,78,90,2,30,1,1
18065,26,28494,16,19201,1566,17635,34,16,16,18
9081,10,7711,9,209,110,99,2,30,1,1
15679,10,25632,9,788,108,680,2,30,1,1
1731,2929,28911,2273,481,150,331,2,1200,1,1
13935,10,24633,9,243,94,149,2,31,1,1
9415,26,16194,16,8272,2455,5817,29,391,10,19
22386,10,19324,9,718,94,624,2,31,1,1
15388,1842,14423,1403,70,70,0,1,5,1,0
8792,10,17146,9,969,86,883,2,30,1,1
10940,3070,28593,2385,70,70,0,2,8,2,0
8601,26,12142,16,8602,1050,7552,16,120,7,9
20546,10,22422,9,304,86,218,2,30,1,1
21115,891,9257,659,70,70,0,1,4,1,0
15164,10,12247,9,194,99,95,2,30,1,1
12381,1705,24650,1302,70,70,0,2,7,2,0
16042,26,22639,16,2435128,54736,2380392,2151,346,331,1820
8499,26,27771,16,27727,1971,25756,51,80,21,30
904,26,11406,16,6059,773,5286,17,29,9,8
8956,10,14914,9,195,102,93,2,30,1,1
9008,10,48,9,762,98,664,2,31,1,1
11003,232,23635,147,9184,4142,5042,72,53,40,32
15342,10,13738,9,177,94,83,2,30,1,1
12630,973,27380,719,70,70,0,2,8,2,0
4694,26,6373,16,499,425,74,4,0,3,1
16021,557,14625,373,5728,4818,910,87,4485,74,13
532,247,0,0,3354,1792,1562,46,194,23,23
22627,10,15138,9,332,98,234,3,58,2,1
6344,26,22902,16,3238,2021,1217,16,16,8,8
7377,15,6205,11,70,70,0,2,5,2,0
15326,26,348,16,8059,2039,6020,20,15,11,9
10657,26,19826,16,5964,1007,4957,18,16,11,7
14192,26,24476,16,4628,1721,2907,19,30,11,8
21952,10,10063,9,178,94,84,2,30,1,1
532,247,0,0,3354,1792,1562,46,194,23,23
13916,10,4447,9,168,86,82,2,31,1,1
3507,10,14382,9,197,90,107,2,30,1,1
8636,26,21860,16,2772,1777,995,16,124,9,7
18651,26,24532,16,6180,926,5254,18,36,10,8
815,26,17233,16,42890,30849,12041,214,420,106,108
15067,10,15164,9,178,94,84,2,29,1,1
9964,26,6076,16,6601,1120,5481,17,116,9,8
16826,26,14436,16,6100,1233,4867,21,17,11,10
11253,533,19543,353,70,70,0,1,5,1,0
8738,26,12926,16,7538,4953,2585,21,54,12,9
14209,10,2289,9,167,86,81,2,30,1,1
15055,10,7585,9,386,101,285,4,31,2,2
9159,10,12950,9,197,102,95,2,33,1,1
11137,495,3984,325,70,70,0,1,4,1,0
5517,26,20126,16,315567,15410,300157,404,46,189,215
13620,10,13524,9,254,87,167,4,31,2,2
9832,15,22116,11,167293,8028,159265,186,26,68,118
15925,10,19521,9,167,86,81,2,29,1,1
5087,26,9368,16,498,210,288,8,26,4,4
20583,26,18737,16,3695,2713,982,21,82,12,9
2261,10,9287,9,237,91,146,2,32,1,1
2744,1626,16640,1248,928,126,802,2,31,1,1
18075,26,20983,16,200862,57949,142913,361,24,172,189
12147,26,21579,16,26995,3729,23266,40,137,16,24
14114,10,24987,9,177,94,83,2,30,1,1
15400,760,13854,548,164,70,94,2,7,1,1
8469,10,27283,9,234,94,140,2,30,1,1
14820,10,5840,9,268,94,174,2,30,1,1
8933,10,20515,9,185,102,83,2,30,1,1
9115,15,21745,11,24361943,451235,23910708,22804,63,6533,16271
15511,430,27888,280,86,86,0,1,30,1,0
13916,10,26191,9,168,86,82,2,29,1,1
12622,2153,1242,1662,70,70,0,1,5,1,0
13984,10,29054,9,177,94,83,2,29,1,1
18307,26,880,16,1868,1229,639,18,151,11,7
10757,42,24060,25,66,66,0,1,5,1,0
15277,10,21481,9,168,78,90,2,30,1,1
16001,11,26754,10,70,70,0,1,5,1,0
20649,10,28101,9,262,106,156,2,32,1,1
12028,679,28977,478,70,70,0,1,4,1,0
8792,26,1188,16,35474,2800,32674,56,135,27,29
15421,26,11044,16,9370,3805,5565,43,181,21,22
15502,10,6068,9,177,94,83,2,30,1,1
9170,15,26459,11,2087,1159,928,10,86,6,4
22197,10,3558,9,183,94,89,2,30,1,1
9090,10,4295,9,266,110,156,2,30,1,1
13863,10,9107,9,189,102,87,2,30,1,1
14922,10,19358,9,198,102,96,2,30,1,1
9436,10,4567,9,211,110,101,2,30,1,1
4822,26,10511,16,6123,860,5263,18,361,9,9
15255,349,7635,222,78,78,0,1,4,1,0
18195,26,23811,16,268,120,148,5,10,3,2
13609,26,8463,16,10265,1831,8434,34,319,17,17
10827,1498,17106,1139,70,70,0,2,8,2,0
13638,15,24836,11,2487,680,1807,9,17,6,3
15184,26,13427,16,7982,1962,6020,20,15,11,9
14325,10,22654,9,193,102,91,2,30,1,1
22428,10,22305,9,267,93,174,4,46,2,2
3725,26,14546,16,223826,45909,177917,356,44,176,180
15255,26,23444,16,7889,1900,5989,20,15,11,9
22703,10,22530,9,177,94,83,2,30,1,1
14257,10,9348,9,168,86,82,2,30,1,1
7398,26,24193,16,16666,4851,11815,58,150,27,31
4696,10,16175,9,209,98,111,2,30,1,1
9632,26,9577,16,9765,2106,7659,27,83,14,13
8397,10,20245,9,168,86,82,2,30,1,1
10956,2988,15562,2322,70,70,0,2,8,2,0
17743,15,2447,11,1052,612,440,10,15,5,5
10981,3266,14427,2529,70,70,0,1,5,1,0
532,247,0,0,3562,1936,1626,48,194,24,24
20514,10,8699,9,512,166,346,2,29,1,1
13652,10,10240,9,168,78,90,2,30,1,1
10856,3007,20511,2338,70,70,0,1,4,1,0
17910,26,19452,16,41635,3977,37658,63,121,25,38
9711,26,11617,16,198,120,78,4,15,3,1
14224,10,13460,9,194,102,92,2,30,1,1
1806,740,15114,531,426,186,240,8,30,4,4
4794,26,11336,16,30620,20855,9765,91,112,45,46
15011,10,6918,9,195,102,93,2,30,1,1
6191,15,17453,11,1056,682,374,10,15,6,4
1858,10,7025,9,235,90,145,2,32,1,1
10327,1645,21371,1264,528,528,0,9,1200,9,0
15345,10,28137,9,208,106,102,2,30,1,1
14887,10,23812,9,184,94,90,2,31,1,1
14316,1691,20465,1293,70,70,0,2,8,2,0
8755,15,14298,11,314,128,186,6,26,3,3
19199,26,19933,16,4076,1378,2698,14,136,7,7
14505,26,7475,16,6176,908,5268,17,15,8,9
9052,10,16948,9,198,102,96,2,30,1,1
15871,26,6043,16,134,60,74,3,6,2,1
10938,1913,2103,1459,316,136,180,6,6,3,3
19548,26,221,16,2484,330,2154,12,135,5,7
2724,1240,7994,920,422,164,258,6,29,3,3
14245,844,10361,622,320,140,180,6,7,3,3
13951,10,24335,9,298,101,197,4,31,2,2
22695,10,6322,9,197,102,95,2,30,1,1
21687,10,26508,9,93,93,0,1,30,1,0
18440,26,14656,16,8678,2974,5704,50,123,27,23
12644,1101,22982,808,70,70,0,2,7,2,0
14413,10,16942,9,177,94,83,2,30,1,1
8642,10,14860,9,764,102,662,2,30,1,1
12728,26,16601,16,499,425,74,4,0,3,1
9431,26,4046,16,18009,7378,10631,58,62,33,25
8584,1240,19603,920,259,78,181,2,31,1,1
18889,26,13441,16,887,542,345,11,15,6,5
12059,940,19110,692,70,70,0,2,8,2,0
11831,26,2751,16,5583,1390,4193,19,15,9,10
15974,10,19698,9,165,86,79,2,30,1,1
15538,10,12846,9,182,93,89,2,31,1,1
10493,15,22475,11,42247,4067,38180,58,25,23,35
12656,2131,12936,1644,552,306,246,9,16,5,4
14103,10,19798,9,177,94,83,2,30,1,1
8972,10,0,0,218,77,141,2,30,1,1
8446,15,4968,11,254,128,126,5,15,3,2
5978,26,642,16,4500,2769,1731,29,80,14,15
13014,26,12871,16,7498,2799,4699,24,17,13,11
11082,15,5613,11,2308,1541,767,11,18,7,4
15515,26,24221,16,8172,2656,5516,29,330,15,14
9183,15,12490,11,814,674,140,6,28,4,2
9688,26,5883,16,11083,4570,6513,24,35,13,11
17909,26,14388,16,12836,2016,10820,48,361,20,28
8833,10,28989,9,448,184,264,6,30,3,3
6127,26,8554,16,181961,40579,141382,247,238,101,146
15472,26,12602,16,29904,3111,26793,68,164,35,33
22464,10,18038,9,216,110,106,2,31,1,1
12099,15,2839,11,1726,940,786,8,51,5,3
21118,644,29068,448,66,66,0,2,8,2,0
18927,26,20708,16,3642,606,3036,13,119,6,7
12527,2633,1789,2043,70,70,0,1,5,1,0
22392,1362,19321,1034,78,78,0,1,29,1,0
9136,15,28570,11,95065,52092,42973,148,259,77,71
15235,10,14957,9,183,94,89,2,30,1,1
15162,10,2874,9,754,94,660,2,31,1,1
6726,26,28894,16,130,70,60,2,14,1,1
964,15,5269,11,844,778,66,6,15,5,1
22108,10,28990,9,199,102,97,2,30,1,1
14873,10,12857,9,183,94,89,2,30,1,1
9036,26,13801,16,4595,1038,3557,19,54,11,8
8492,26,11236,16,5749,3401,2348,29,76,15,14
17145,26,22571,16,22402,14820,7582,52,20,29,23
12628,1,3162,1,70,70,0,2,8,2,0
2270,10,9324,9,233,91,142,2,31,1,1
12173,15,19278,11,6995,783,6212,14,317,7,7
15663,10,22139,9,177,94,83,2,29,1,1
15809,10,23554,9,183,94,89,2,30,1,1
20490,26,27781,16,303,85,218,2,31,1,1
8613,10,23264,9,168,78,90,2,30,1,1
9610,10,12094,9,199,102,97,2,30,1,1
3983,26,5949,16,9488,4114,5374,27,363,14,13
13617,10,13089,9,210,110,100,2,30,1,1
2744,1241,11085,921,1634,126,1508,4,30,2,2
3066,693,25923,492,10190,4774,5416,64,1490,32,32
9214,10,9650,9,789,102,687,2,30,1,1
14682,10,25920,9,271,88,183,4,38,2,2
21515,10,10570,9,211,78,133,2,30,1,1
4241,10,18631,9,164,78,86,2,31,1,1
19927,26,27651,16,28126,3114,25012,50,77,22,28
7665,10,4504,9,168,78,90,2,29,1,1
15024,10,4943,9,711,87,624,2,30,1,1
12641,2435,17465,1894,320,140,180,6,6,3,3
20680,26,5927,16,1433,734,699,18,125,10,8
15327,26,11586,16,11771,2624,9147,50,20,25,25
15770,10,25273,9,628,82,546,2,30,1,1
20567,10,17011,9,384,166,218,2,30,1,1
865,234,2342,149,6138,1256,4882,22,58,11,11
2744,1238,24941,918,892,126,766,2,30,1,1
9437,26,27426,16,11617,4358,7259,48,86,26,22
10217,26,14622,16,11482,3696,7786,28,62,15,13
15350,10,12122,9,170,87,83,2,30,1,1
11855,15,10705,11,2043,1331,712,13,17,7,6
22379,10,28876,9,183,94,89,2,29,1,1
9843,26,17482,16,9382,3057,6325,35,1220,17,18
13648,10,27864,9,209,110,99,2,30,1,1
10897,2446,14527,1899,258,70,188,4,8,2,2
18906,26,8677,16,924886,40519,884367,1075,65,442,633
11936,26,823,16,3039,1089,1950,9,120,5,4
8350,26,21440,16,473744,13158,460586,495,20,183,312
8241,26,7041,16,16227,2037,14190,40,109,19,21
19438,10,1279,9,183,86,97,2,30,1,1
4837,15,19590,11,1572,755,817,11,15,6,5
17880,10,18798,9,401,86,315,2,30,1,1
16432,10,25662,9,194,87,107,2,31,1,1
8667,15,9867,11,183116,16652,166464,279,486,59,220
15920,10,13968,9,178,94,84,2,30,1,1
15596,26,13007,16,10514,2031,8483,28,149,12,16
14456,10,14240,9,177,94,83,2,30,1,1
7117,26,7993,16,1629,968,661,15,275,8,7
8513,10,11861,9,212,102,110,2,30,1,1
22245,10,3709,9,199,102,97,2,29,1,1
15614,10,8373,9,166,86,80,2,31,1,1
9544,26,12380,16,1124,594,530,12,26,6,6
22655,10,3845,9,298,102,196,4,39,2,2
1678,10,6052,9,229,98,131,2,30,1,1
8233,26,8328,16,8143,3033,5110,26,18,14,12
14498,26,13624,16,161,101,60,2,5,1,1
21230,10,13336,9,200,102,98,2,30,1,1
21838,10,25638,9,146,75,71,2,31,1,1
21897,10,21737,9,228,94,134,2,30,1,1
12051,3062,2240,2377,70,70,0,1,5,1,0
12488,3138,127,2436,2395,1145,1250,13,16,6,7
22701,10,26698,9,744,95,649,2,31,1,1
9572,26,13671,16,9844,4554,5290,24,92,13,11
2744,1238,12651,918,1634,126,1508,4,30,2,2
12717,1597,28816,1223,320,140,180,6,7,3,3
11914,26,19399,16,13938,3220,10718,44,93,21,23
3303,26,3842,16,7623,3362,4261,26,31,14,12
18857,26,7397,16,126,60,66,3,4,2,1
14794,10,28742,9,168,86,82,2,29,1,1
4873,26,28321,16,27679,15839,11840,75,103,39,36
2782,26,21788,16,9046,1414,7632,25,84,10,15
21478,10,28544,9,220,100,120,2,30,1,1
9318,10,15765,9,211,78,133,2,30,1,1
11206,26,9522,16,8048,1360,6688,24,23,12,12
5806,373,17679,241,156,156,0,3,8,3,0
9236,26,24502,16,1786,172,1614,7,0,3,4
22449,10,15757,9,277,98,179,4,36,2,2
21372,10,9853,9,308,91,217,4,56,2,2
7968,26,8607,16,83558,8567,74991,180,171,92,88
7341,10,11433,9,164,78,86,2,30,1,1
8395,10,2744,9,193,102,91,2,30,1,1
22150,10,7632,9,210,102,108,2,30,1,1
12705,26,11853,16,499,425,74,4,1,3,1
2724,1240,9357,920,422,164,258,6,30,3,3
12379,2064,5674,1590,320,140,180,6,6,3,3
6319,26,8666,16,8932,2039,6893,23,24,12,11
22550,10,6261,9,176,90,86,2,30,1,1
12749,26,19721,16,499,425,74,4,0,3,1
19711,26,3989,16,5214,2561,2653,14,136,7,7
1806,739,19548,530,182,62,120,4,30,2,2
20963,10,4043,9,286,78,208,2,30,1,1
4742,26,3210,16,3354,2353,1001,18,45,11,7
4800,26,6037,16,10281,2251,8030,25,17,14,11
15159,10,14525,9,177,94,83,2,29,1,1
21926,10,22384,9,458,188,270,6,29,3,3
8767,10,21143,9,762,97,665,2,30,1,1
21597,10,6088,9,568,192,376,6,71,3,3
10888,2245,8698,1738,66,66,0,1,5,1,0
22446,10,2532,9,446,106,340,4,47,2,2
5452,26,13874,16,2828,1800,1028,27,184,15,12
22053,10,14073,9,200,102,98,2,29,1,1
9444,15,20899,11,166956,16834,150122,187,161,72,115
14476,10,11425,9,192,98,94,2,30,1,1
9719,10,2117,9,766,102,664,2,30,1,1
9783,26,12269,16,15714,2748,12966,58,21,23,35
2744,1248,26038,928,1634,126,1508,4,31,2,2
14021,10,16327,9,188,96,92,2,31,1,1
7275,15,20616,11,154671,9533,145138,227,38,121,106
21380,10,12330,9,300,102,198,2,30,1,1
8732,15,17133,11,10134,1142,8992,24,46,12,12
8758,10,14157,9,177,94,83,2,30,1,1
3404,26,18740,16,19341,4612,14729,38,21,19,19
17997,26,17267,16,8305,2325,5980,24,46,13,11
15308,10,2081,9,177,94,83,2,29,1,1
13751,10,218,9,178,94,84,2,30,1,1
8986,10,1257,9,265,94,171,2,30,1,1
5617,10,8175,9,205,86,119,2,29,1,1
11646,26,21570,16,39551,4663,34888,60,357,27,33
4189,26,15436,16,4398,1491,2907,19,26,11,8
7856,10,24390,9,168,78,90,2,30,1,1
15074,10,27003,9,186,95,91,2,30,1,1
18512,1371,19247,1042,70,70,0,2,8,2,0
14248,964,9949,712,70,70,0,2,8,2,0
18030,26,24633,16,10302,3853,6449,27,61,16,11
18005,26,16845,16,9919,4495,5424,53,118,30,23
8990,10,25047,9,168,86,82,2,30,1,1
11298,26,22872,16,1615,941,674,15,20,7,8
9099,15,12686,11,1130,613,517,11,15,6,5
15441,10,2372,9,194,102,92,2,30,1,1
8407,10,8193,9,330,101,229,4,47,2,2
9385,10,22015,9,438,180,258,6,30,3,3
14285,1854,14239,1414,70,70,0,2,8,2,0
21492,10,20976,9,193,94,99,2,30,1,1
7885,26,25482,16,11793,7188,4605,34,128,17,17
16387,26,15777,16,10457,4216,6241,70,194,31,39
14179,10,13176,9,202,103,99,2,31,1,1
10868,1426,24383,1082,70,70,0,2,7,2,0
15509,10,169,9,244,94,150,2,30,1,1
9451,10,9988,9,814,110,704,2,30,1,1
20776,10,28192,9,198,90,108,2,30,1,1
4349,171,15713,117,138,78,60,2,5,1,1
21261,10,4733,9,199,102,97,2,30,1,1
11081,1443,24909,1097,70,70,0,2,8,2,0
16481,15,7901,11,708,384,324,12,23,7,5
14233,10,26509,9,198,102,96,2,33,1,1
12561,26,3673,16,499,425,74,4,0,3,1
15266,26,12372,16,7862,1873,5989,20,15,11,9
14332,10,21099,9,186,95,91,2,31,1,1
9411,1160,11321,856,1766,1332,434,22,1200,15,7
13793,26,28932,16,13231,6169,7062,38,120,19,19
2653,15,11119,11,57276,6978,50298,77,30,34,43
21625,10,8962,9,211,94,117,2,30,1,1
10893,1012,7772,746,70,70,0,2,7,2,0
20537,26,3126,16,448,166,282,2,30,1,1
9568,26,22075,16,5713,1079,4634,15,26,8,7
15632,15,21535,11,864,507,357,8,38,5,3
21729,10,2035,9,353,101,252,4,54,2,2
2046,1399,18168,1062,480,149,331,2,1200,1,1
8347,15,26463,11,6158,654,5504,15,16,8,7
15633,10,2274,9,193,102,91,2,29,1,1
8922,10,230,9,264,89,175,4,48,2,2
9607,15,4334,11,287874,13215,274659,346,204,136,210
4385,26,9362,16,86101,7312,78789,145,128,63,82
12971,26,1854,16,10945,2478,8467,39,18,19,20
6250,2021,27421,1551,273,73,200,4,29,2,2
5282,26,28711,16,6818,1800,5018,30,271,16,14
8774,10,20188,9,177,94,83,2,30,1,1
19803,26,27529,16,53531,5139,48392,75,47,34,41
1497,183,5291,121,3424,1710,1714,16,33,8,8
9065,10,2944,9,272,122,150,2,30,1,1
21066,183,28347,121,3444,1730,1714,16,33,8,8
22578,10,10316,9,272,122,150,2,30,1,1
8690,26,23037,16,52864,3584,49280,86,95,39,47
6250,1146,24851,846,138,70,68,2,30,1,1
17947,26,24017,16,13306,9499,3807,32,23,17,15
12020,26,23292,16,3121,1764,1357,19,181,10,9
21241,10,548,9,373,171,202,5,40,3,2
8181,26,28732,16,316457,19287,297170,382,80,157,225
6813,10,27903,9,220,78,142,2,30,1,1
12004,26,14130,16,15277,10027,5250,36,46,21,15
3028,10,12566,9,197,76,121,2,30,1,1
9007,10,8891,9,193,102,91,2,30,1,1
9671,10,28745,9,969,86,883,2,30,1,1
8757,15,11550,11,314,128,186,6,27,3,3
9623,26,28940,16,25979,7217,18762,36,16,19,17
15913,26,3345,16,7644,3087,4557,26,46,15,11
11321,15,1434,11,1061,574,487,13,256,7,6
15803,26,28109,16,360050,17258,342792,432,68,185,247
8977,10,8869,9,164,84,80,2,31,1,1
22658,10,14762,9,195,102,93,2,29,1,1
17704,15,10075,11,3835,1767,2068,21,187,12,9
22134,10,5249,9,255,102,153,2,30,1,1
5985,26,24104,16,1062197,37438,1024759,1129,31,416,713
15368,10,5060,9,196,102,94,2,30,1,1
9565,10,8124,9,762,98,664,2,30,1,1
17036,26,11941,16,7978,1143,6835,19,26,9,10
5755,18,17692,13,184,94,90,2,30,1,1
8587,26,9614,16,301494,6917,294577,306,48,101,205
17910,26,11629,16,840,456,384,14,25,8,6
6440,26,19409,16,6813,2515,4298,30,58,16,14
18965,26,6947,16,4548,2858,1690,42,111,22,20
3190,10,13507,9,200,90,110,2,30,1,1
9065,10,11771,9,349,108,241,4,35,2,2
8210,3183,21194,2469,765,296,469,4,1200,2,2
4967,15,23464,11,409,289,120,5,15,3,2
22628,10,16413,9,195,102,93,2,29,1,1
15480,10,4422,9,193,102,91,2,31,1,1
13692,26,10844,16,11429,4904,6525,33,156,18,15
4431,26,10600,16,7251,5852,1399,34,75,18,16
15673,10,16284,9,193,102,91,2,30,1,1
19357,15,28810,11,17320,9430,7890,67,93,35,32
13947,10,19438,9,177,94,83,2,31,1,1
15137,26,21445,16,26334,2210,24124,49,66,22,27
8622,10,1307,9,199,102,97,2,30,1,1
21832,10,2408,9,258,102,156,2,30,1,1
17105,26,16887,16,9030,2311,6719,24,362,13,11
14172,26,2936,16,11550,3336,8214,52,130,25,27
3421,10,14220,9,231,88,143,2,32,1,1
18816,1989,22095,1519,316,136,180,6,6,3,3
20368,26,27931,16,3743,1654,2089,10,120,5,5
15029,10,28373,9,177,94,83,2,30,1,1
17465,10,13001,9,181,86,95,2,30,1,1
21922,10,17389,9,193,102,91,2,29,1,1
19472,10,27345,9,257,101,156,2,33,1,1
13868,10,5393,9,181,94,87,2,29,1,1
14363,10,5663,9,198,101,97,2,31,1,1
22037,18,3427,13,184,94,90,2,31,1,1
12751,43,1589,26,70,70,0,1,4,1,0
15513,10,21799,9,200,102,98,2,30,1,1
12814,2689,2166,2088,70,70,0,1,5,1,0
17097,26,7412,16,5167,700,4467,16,15,7,9
21216,2627,1855,2037,312,132,180,6,7,3,3
11108,26,5226,16,9757,2051,7706,34,256,15,19
21885,10,3121,9,195,102,93,2,30,1,1
21366,10,27686,9,178,94,84,2,30,1,1
2744,1239,25294,919,1784,252,1532,5,31,3,2
22404,10,1833,9,288,94,194,2,30,1,1
15075,26,7670,16,1343,763,580,14,26,8,6
9840,15,1274,11,55872,28838,27034,234,175,117,117
16951,255,25970,160,156,62,94,2,10,1,1
20008,26,12028,16,13709,1675,12034,25,31,11,14
18440,26,21271,16,8588,2020,6568,20,76,10,10
8808,26,13115,16,17163,6197,10966,44,43,22,22
21102,2687,14496,2086,66,66,0,2,8,2,0
15832,10,13709,9,177,94,83,2,31,1,1
21818,10,4827,9,193,102,91,2,29,1,1
18362,15,12413,11,1463,865,598,11,144,6,5
12322,354,18528,227,1745,1091,654,10,31,5,5
11282,26,22865,16,221672,9306,212366,249,21,97,152
21017,1010,1295,744,696,508,188,10,16,7,3
5102,26,16096,16,13929,2854,11075,43,128,22,21
8433,10,4665,9,330,97,233,4,33,2,2
11239,26,7483,16,502469,15202,487267,580,97,193,387
15623,26,25205,16,4616,1709,2907,19,28,11,8
12616,1874,11399,1430,70,70,0,2,7,2,0
13156,26,6509,16,5642,3872,1770,32,81,17,15
9001,26,27070,16,9634,2232,7402,24,123,12,12
18200,26,10444,16,268,120,148,5,10,3,2
5744,26,22,16,1969,1195,774,18,122,11,7
21833,10,19714,9,429,109,320,4,37,2,2
5481,26,19897,16,6283,1439,4844,25,316,13,12
8674,26,8286,16,13719,5017,8702,40,283,20,20
8584,1239,12758,919,78,78,0,1,30,1,0
4847,2504,14016,1947,156,156,0,3,8,3,0
3847,10,6135,9,199,94,105,2,30,1,1
9983,15,16300,11,1218354,26709,1191645,1128,133,332,796
14537,10,17995,9,720,94,626,2,29,1,1
15596,10,19915,9,179,94,85,2,31,1,1
17141,26,27988,16,5168,700,4468,16,15,7,9
11238,15,22436,11,372,246,126,6,28,4,2
22456,10,21247,9,193,102,91,2,30,1,1
14109,10,28435,9,186,102,84,2,30,1,1
21925,10,27384,9,338,110,228,2,30,1,1
16610,26,22088,16,15327,8305,7022,49,137,24,25
15462,10,15309,9,177,94,83,2,30,1,1
22220,10,9885,9,152,78,74,2,30,1,1
14432,10,4635,9,183,94,89,2,29,1,1
20241,26,22292,16,6179,3326,2853,26,186,12,14
10101,190,11820,125,258,107,151,2,31,1,1
10016,26,22219,16,187790,7733,180057,229,128,90,139
6076,26,29122,16,9028,5092,3936,36,257,12,24
9805,26,5484,16,298067,6719,291348,307,17,98,209
18399,26,3835,16,1853,1214,639,18,77,11,7
15046,10,17575,9,1421,97,1324,4,55,2,2
11152,2162,3718,1670,70,70,0,2,8,2,0
21556,10,28860,9,166,86,80,2,29,1,1
2744,212,4443,137,881,126,755,2,30,1,1
7774,26,6788,16,7613,2230,5383,22,360,11,11
14597,10,2371,9,183,94,89,2,30,1,1
12806,823,7486,603,320,140,180,6,7,3,3
15798,26,20060,16,1167125,49170,1117955,1459,92,635,824
653,10,2583,9,186,83,103,2,30,1,1
12732,1182,13241,872,552,306,246,9,15,5,4
15257,10,16191,9,168,86,82,2,30,1,1
6126,26,355,16,6511,1866,4645,21,17,12,9
12137,26,23345,16,1588,817,771,20,121,10,10
9108,10,25846,9,334,90,244,4,38,2,2
7055,26,12667,16,130,70,60,3,5,2,1
11009,2854,15231,2214,70,70,0,2,7,2,0
9270,18,14180,13,184,94,90,2,30,1,1
10104,15,25041,11,1095845,7641,1088204,839,35,114,725
8724,15,19519,11,39679,7315,32364,45,24,17,28
11088,15,5755,11,362,240,122,7,25,5,2
18403,298,26759,193,3322,2027,1295,16,16,9,7
2441,10,10118,9,825,99,726,2,30,1,1
17347,26,25251,16,25840,18434,7406,45,171,26,19
6249,26,28173,16,9164,2473,6691,22,17,13,9
8605,10,17686,9,197,102,95,2,30,1,1
9211,26,8821,16,7912,3269,4643,23,96,12,11
1337,2012,7079,1542,156,94,62,2,30,1,1
8789,10,14650,9,790,110,680,2,29,1,1
8906,10,8556,9,793,101,692,2,31,1,1
13627,10,27378,9,711,87,624,2,30,1,1
11991,26,6789,16,27964,15805,12159,204,904,120,84
7231,15,22967,11,1213,471,742,10,255,6,4
15199,10,28468,9,199,102,97,2,30,1,1
5606,232,6961,147,5097,2196,2901,36,25,18,18
1731,3137,20271,2435,127653507,122661116,4992391,161030,2162,82907,78123
5918,10,17850,9,247,98,149,2,31,1,1
15337,10,18549,9,168,86,82,2,30,1,1
14873,10,28205,9,210,110,100,2,30,1,1
4611,26,12945,16,17764,5080,12684,46,121,22,24
4338,171,15691,117,138,78,60,2,5,1,1
9576,232,11998,147,28281,9813,18468,196,608,100,96
9558,15,21022,11,1657,1246,411,8,15,5,3
9935,26,2931,16,18444,12288,6156,36,149,20,16
21827,10,7818,9,222,94,128,2,29,1,1
9,18,17430,13,184,94,90,2,30,1,1
12509,3016,10378,2344,70,70,0,2,7,2,0
14737,10,19978,9,177,94,83,2,30,1,1
13977,26,1671,16,2552065,30474,2521591,2074,129,236,1838
11201,26,22822,16,154883,8710,146173,182,23,69,113
7990,10,4488,9,168,78,90,2,30,1,1
19804,26,8806,16,134,60,74,3,5,2,1
11217,1900,11608,1453,70,70,0,1,4,1,0
15182,26,33,16,7862,1873,5989,20,15,11,9
22491,10,4212,9,165,86,79,2,30,1,1
16680,26,9015,16,3878,1156,2722,14,136,7,7
11571,26,16113,16,24091,7349,16742,75,162,36,39
22261,10,28935,9,240,98,142,2,30,1,1
14386,10,6805,9,177,94,83,2,30,1,1
9009,10,15374,9,168,86,82,2,30,1,1
22613,10,3246,9,448,84,364,4,54,2,2
8667,10,22030,9,229,110,119,2,30,1,1
18217,26,17162,16,350,210,140,6,25,4,2
4149,26,14604,16,9276,1884,7392,23,32,13,10
17923,26,20182,16,35140,3700,31440,67,76,30,37
18488,3068,7113,2383,1728,1031,697,14,17,8,6
7058,26,25468,16,4499,2807,1692,24,95,13,11
15290,10,1988,9,1384,88,1296,4,32,2,2
13851,10,15646,9,166,85,81,2,31,1,1
12453,1893,24095,1446,70,70,0,1,5,1,0
15544,10,20613,9,195,102,93,2,30,1,1
18626,26,2018,16,8728,4031,4697,23,17,12,11
15375,26,2163,16,8337,2820,5517,19,30,10,9
12015,478,4402,312,954,454,500,14,21,8,6
13898,10,6191,9,212,102,110,2,30,1,1
16021,235,6131,150,453,251,202,4,1200,2,2
3293,26,23514,16,14739,1296,13443,30,306,9,21
11024,1162,13108,858,70,70,0,2,8,2,0
15581,18,27068,13,184,94,90,2,30,1,1
15214,26,2264,16,10138,2213,7925,27,30,16,11
16021,2392,17373,1859,152,152,0,2,1200,2,0
6666,10,7850,9,168,78,90,2,29,1,1
21806,26,3933,16,7069,1210,5859,13,120,6,7
15164,10,16473,9,305,99,206,4,49,2,2
15334,2826,17248,2193,66,66,0,1,5,1,0
2886,26,16616,16,6305,2124,4181,20,16,10,10
6730,26,8029,16,4824,671,4153,13,29,7,6
13634,26,23505,16,1541965,48559,1493406,1663,51,623,1040
6496,26,17728,16,3067,1817,1250,18,15,8,10
21618,26,2986,16,6205,1316,4889,27,301,14,13
10995,15,15384,11,106904,5958,100946,139,66,62,77
8585,10,12289,9,252,102,150,2,30,1,1
3709,26,9598,16,8152,3395,4757,27,18,15,12
10967,15,13805,11,37552,16143,21409,54,28,26,28
22158,10,17424,9,202,95,107,2,31,1,1
9504,15,6764,11,318,192,126,6,28,4,2
17229,26,28296,16,6160,4121,2039,22,17,11,11
18493,26,21365,16,5696,1143,4553,23,119,12,11
17048,26,13607,16,5167,700,4467,16,15,7,9
6489,26,6924,16,3067,1817,1250,18,16,8,10
8537,26,14100,16,5782,1008,4774,17,1,8,9
22036,10,1989,9,243,94,149,2,30,1,1
14678,10,9734,9,168,86,82,2,30,1,1
15325,26,17015,16,8006,1986,6020,20,15,11,9
7426,26,20867,16,15670,12575,3095,51,37,30,21
15243,10,24140,9,177,94,83,2,29,1,1
7352,10,19282,9,164,78,86,2,31,1,1
8896,26,27789,16,400810,14719,386091,506,39,164,342
3299,232,27894,147,8702,4668,4034,92,626,50,42
22642,10,27566,9,194,102,92,2,30,1,1
4296,26,28229,16,6485,1692,4793,23,170,13,10
12579,10,18927,9,168,78,90,2,30,1,1
18515,3144,27238,2438,70,70,0,2,8,2,0
636,281,27289,178,238,118,120,2,1199,1,1
14229,10,26047,9,177,94,83,2,30,1,1
6990,26,7042,16,6152,420,5732,13,120,6,7
8448,10,26102,9,345,110,235,2,29,1,1
14760,10,8872,9,210,110,100,2,30,1,1
15643,10,1346,9,99,99,0,1,31,1,0
17734,26,20835,16,4815,2461,2354,47,58,26,21
8158,15,16963,11,956,541,415,11,315,6,5
8412,10,28789,9,195,102,93,2,30,1,1
22210,10,14223,9,178,94,84,2,29,1,1
3558,26,24602,16,6987,2005,4982,18,16,9,9
3059,10,12778,9,197,90,107,2,30,1,1
14935,26,7482,16,3775,1791,1984,24,203,12,12
12595,26,3183,16,499,425,74,4,0,3,1
22532,10,10249,9,193,102,91,2,30,1,1
15055,10,23907,9,199,102,97,2,30,1,1
9277,26,16995,16,29425,9485,19940,54,35,27,27
14454,10,7360,9,184,94,90,2,30,1,1
4748,26,16210,16,4592,1685,2907,19,29,11,8
3987,15,26365,11,1614,1300,314,10,15,5,5
9854,26,19741,16,1786,172,1614,7,120,3,4
21339,1442,15365,1096,66,66,0,2,8,2,0
1164,15,27814,11,1142,636,506,10,45,6,4
16829,10,6746,9,235,95,140,2,31,1,1
14890,10,28721,9,168,78,90,2,30,1,1
1223,15,4033,11,450,246,204,8,25,5,3
6814,26,12463,16,8746,2844,5902,26,315,13,13
3523,10,14410,9,257,101,156,2,33,1,1
2744,1280,5395,960,926,126,800,2,31,1,1
8709,10,23153,9,200,102,98,2,30,1,1
8504,10,1711,9,303,97,206,4,56,2,2
8890,10,12737,9,470,131,339,4,32,2,2
4602,26,10273,16,4809,818,3991,15,15,8,7
15063,15,25286,11,46400,3639,42761,59,135,25,34
13735,10,5575,9,755,93,662,2,31,1,1
22191,10,1069,9,200,102,98,2,30,1,1
21417,10,26220,9,177,94,83,2,30,1,1
16998,26,4538,16,6889,4719,2170,25,330,14,11
13633,26,13684,16,643217,29500,613717,787,53,338,449
8556,10,10328,9,204,104,100,2,31,1,1
8728,26,26575,16,3380,346,3034,12,120,5,7
3768,26,19857,16,8363,1573,6790,24,49,14,10
15466,10,2890,9,177,94,83,2,30,1,1
8781,10,9985,9,199,102,97,2,30,1,1
12713,26,20234,16,499,425,74,4,1,3,1
19804,26,7309,16,13499,2333,11166,24,137,10,14
14365,10,1632,9,309,94,215,2,30,1,1
18562,2250,19847,1742,70,70,0,2,8,2,0
9852,15,6346,11,3114,1695,1419,15,196,11,4
14455,10,2768,9,176,90,86,2,31,1,1
19906,26,27631,16,4497,1590,2907,19,29,11,8
11157,2225,27121,1724,70,70,0,1,5,1,0
16058,15,8589,11,1377,881,496,12,48,7,5
13851,10,22046,9,167,86,81,2,30,1,1
10133,10,6394,9,194,94,100,2,30,1,1
15816,10,18836,9,199,102,97,2,30,1,1
4723,10,16195,9,832,106,726,2,30,1,1
2088,10,8243,9,235,90,145,2,32,1,1
14561,10,28336,9,197,102,95,2,31,1,1
2744,1239,10090,919,1696,126,1570,4,31,2,2
15175,15,13699,11,234,234,0,4,12,4,0
16156,26,7540,16,4751,909,3842,15,16,9,6
16764,10,11766,9,199,94,105,2,31,1,1
21967,10,2638,9,338,110,228,2,30,1,1
12618,280,6496,177,70,70,0,1,5,1,0
8721,10,10271,9,193,102,91,2,30,1,1
20902,26,12506,16,2773,1570,1203,22,275,11,11
15478,10,27095,9,239,110,129,2,30,1,1
15060,26,23389,16,10788,6521,4267,61,134,31,30
15579,15,26009,11,214,140,74,4,30,3,1
17809,10,5230,9,195,94,101,2,30,1,1
19254,26,25367,16,4401,1654,2747,10,120,5,5
13627,10,20217,9,178,91,87,2,31,1,1
14522,10,27322,9,184,94,90,2,30,1,1
5335,15,2069,11,78,78,0,1,5,1,0
22515,10,26479,9,235,94,141,2,30,1,1
8666,26,4509,16,16888,2692,14196,42,150,22,20
22444,10,15168,9,179,94,85,2,30,1,1
8958,10,25889,9,339,110,229,2,30,1,1
10361,3205,23013,2485,70,70,0,2,8,2,0
2624,10,11050,9,231,90,141,2,30,1,1
15921,10,18583,9,177,94,83,2,29,1,1
21251,10,26416,9,358,94,264,4,45,2,2
14496,10,24861,9,181,94,87,2,31,1,1
8047,26,24388,16,4800,3396,1404,19,60,10,9
18574,280,14482,177,320,140,180,6,6,3,3
11866,26,28899,16,9257,2079,7178,39,113,19,20
6741,26,1682,16,560,280,280,9,26,5,4
14502,10,19033,9,193,102,91,2,30,1,1
18809,26,7107,16,796772,27151,769621,878,137,302,576
21491,10,15721,9,266,110,156,2,31,1,1
18260,10,15651,9,225,110,115,2,30,1,1
20282,26,17740,16,12539,6472,6067,81,406,37,44
14152,10,27113,9,194,102,92,2,29,1,1
9128,10,3550,9,760,97,663,2,30,1,1
22610,10,19617,9,199,102,97,2,30,1,1
8013,26,7394,16,502,222,280,8,28,4,4
15048,10,17966,9,198,102,96,2,30,1,1
7735,26,27884,16,70,70,0,1,5,1,0
21816,15,28710,11,123115,6863,116252,160,29,76,84
1185,26,21477,16,12579,1722,10857,29,171,12,17
21332,2615,27883,2027,66,66,0,2,8,2,0
8584,1296,21513,974,245,78,167,2,30,1,1
5044,26,3140,16,6260,1587,4673,21,191,12,9
9086,10,7668,9,583,105,478,4,42,2,2
21213,10,11414,9,179,94,85,2,30,1,1
15211,26,6919,16,8865,1819,7046,24,30,14,10
8371,26,17460,16,1786,172,1614,7,120,3,4
21894,10,10059,9,353,118,235,2,30,1,1
6589,26,19811,16,7123,1331,5792,22,81,11,11
12741,2231,16577,1730,1686,890,796,10,15,6,4
15280,10,7245,9,168,78,90,2,30,1,1
13890,10,23804,9,186,102,84,2,30,1,1
5166,15,18762,11,540,540,0,10,186,10,0
14905,15,24866,11,27189,4515,22674,34,23,14,20
6286,26,24855,16,12516,2906,9610,41,427,17,24
9844,15,8568,11,55825,28792,27033,234,174,117,117
8941,10,24211,9,399,93,306,4,41,2,2
15980,10,3259,9,210,102,108,2,30,1,1
15188,26,2500,16,6016,1284,4732,18,984,8,10
17743,10,9823,9,164,78,86,2,30,1,1
9999,26,3898,16,2782,1480,1302,17,15,9,8
20960,10,19417,9,278,94,184,2,30,1,1
14679,10,17,9,199,102,97,2,31,1,1
13800,10,1825,9,184,94,90,2,30,1,1
15832,10,25500,9,199,102,97,2,30,1,1
6410,15,22787,11,1346,842,504,13,123,8,5
18958,26,10653,16,2080,1376,704,17,30,9,8
18482,10,26802,9,217,87,130,2,30,1,1
13636,10,28149,9,282,96,186,4,48,2,2
15567,10,13667,9,177,94,83,2,30,1,1
17929,26,13554,16,4586,955,3631,17,28,9,8
15830,26,15006,16,10926,3915,7011,50,33,28,22
6407,26,5995,16,162,102,60,2,4,1,1
21153,2222,23670,1721,70,70,0,1,5,1,0
11150,2146,29062,1658,70,70,0,2,8,2,0
9069,10,10501,9,180,94,86,2,30,1,1
4263,26,25114,16,1269784,41489,1228295,1339,37,478,861
7611,26,3603,16,9801,3049,6752,29,20,15,14
5897,26,3556,16,9161,2210,6951,23,187,11,12
22366,10,21979,9,328,102,226,2,30,1,1
11093,338,24369,215,70,70,0,2,8,2,0
15823,26,25910,16,10174,2163,8011,25,81,14,11
8622,10,16803,9,198,101,97,2,31,1,1
11144,3251,15466,2520,70,70,0,1,5,1,0
10474,26,15711,16,202,70,132,3,11,1,2
9149,10,27897,9,227,102,125,2,29,1,1
13955,10,1914,9,196,102,94,2,31,1,1
8670,10,1242,9,198,94,104,2,30,1,1
15186,15,20070,11,4296,2076,2220,31,128,15,16
13159,15,9617,11,1466,729,737,12,16,7,5
21222,15,6488,11,314,192,122,6,15,4,2
9451,26,23942,16,9889,2800,7089,28,82,17,11
6250,1984,5432,1514,148,86,62,2,29,1,1
18042,26,2941,16,8852,1428,7424,22,199,11,11
15993,10,25396,9,193,102,91,2,30,1,1
10965,1924,15660,1468,70,70,0,1,5,1,0
4835,3174,4472,2460,2118,858,1260,28,1283,14,14
8511,26,22376,16,272627,89686,182941,461,149,220,241
15001,10,16838,9,195,102,93,2,30,1,1
8335,10,10603,9,196,102,94,2,30,1,1
10868,26,18427,16,9329,3898,5431,21,39,12,9
14714,26,1373,16,144290,9387,134903,217,42,110,107
4835,969,29128,717,481,150,331,2,1199,1,1
12090,26,22490,16,3655,2344,1311,18,17,9,9
8927,10,5744,9,183,94,89,2,30,1,1
8536,10,14209,9,232,110,122,2,30,1,1
7479,26,19659,16,8106,4839,3267,61,449,32,29
8579,10,22961,9,231,110,121,2,30,1,1
15571,26,25174,16,4577,1670,2907,19,26,11,8
18485,26,22676,16,7274,1925,5349,24,138,12,12
22715,10,7030,9,198,101,97,2,31,1,1
6747,26,7541,16,10494,2409,8085,21,137,9,12
15366,10,18737,9,250,87,163,4,58,2,2
9052,26,4995,16,1072526,64733,1007793,1501,232,690,811
8007,26,3619,16,537031,23421,513610,622,43,258,364
15075,10,9613,9,214,110,104,2,30,1,1
13342,26,28930,16,9948,2463,7485,41,27,22,19
21247,10,6141,9,283,97,186,4,36,2,2
15427,26,20571,16,8215,2882,5333,32,90,16,16
12712,1128,5699,832,70,70,0,1,5,1,0
22442,10,18946,9,170,87,83,2,30,1,1
17487,26,24092,16,12632,3678,8954,42,27,23,19
16575,26,1956,16,9521,5450,4071,30,120,15,15
9147,10,9272,9,206,105,101,2,31,1,1
17007,15,23225,11,4175,3452,723,14,15,7,7
17185,26,17181,16,354,294,60,2,15,1,1
2046,602,1025,413,460,150,310,2,1200,1,1
14857,10,27834,9,816,102,714,2,30,1,1
12260,2577,17376,1999,7546,4168,3378,37,53,24,13
22392,1292,1011,970,230,78,152,2,30,1,1
3133,2302,1726,1786,330,330,0,6,3609,6,0
17118,26,4423,16,1413,876,537,12,25,6,6
21678,10,9059,9,257,94,163,2,30,1,1
13825,10,14057,9,183,94,89,2,30,1,1
9081,26,25000,16,5899,732,5167,16,41,8,8
21718,10,4082,9,192,98,94,2,31,1,1
22555,10,46,9,181,94,87,2,31,1,1
6286,26,17275,16,10424,3393,7031,31,274,16,15
7103,26,24258,16,4000,1726,2274,13,135,6,7
12476,2959,1400,2296,70,70,0,2,8,2,0
2898,10,11877,9,176,78,98,2,30,1,1
15323,15,18769,11,194,128,66,4,25,3,1
7412,26,11228,16,15090,9197,5893,33,97,19,14
7927,26,5782,16,143399,8522,134877,208,153,101,107
14786,10,12849,9,214,110,104,2,29,1,1
15191,26,23938,16,8033,2013,6020,20,15,11,9
7625,26,7871,16,10876,3774,7102,12,145,5,7
11465,26,15167,16,7787,3056,4731,19,87,10,9
9621,26,26729,16,130,70,60,2,15,1,1
6655,26,26721,16,31194,5024,26170,44,121,18,26
2744,1350,3170,1023,913,126,787,2,31,1,1
2724,1240,9204,920,422,164,258,6,30,3,3
8044,26,26163,16,4138,2416,1722,31,80,16,15
16716,10,6579,9,331,86,245,2,30,1,1
14181,10,28939,9,180,94,86,2,30,1,1
17206,26,11469,16,2896,1492,1404,17,17,9,8
11450,1687,22970,1290,66,66,0,1,5,1,0
18554,502,19726,330,70,70,0,1,5,1,0
11317,15,22892,11,1914,1302,612,11,14,5,6
6473,10,11607,9,168,78,90,2,29,1,1
12047,789,11204,574,70,70,0,2,8,2,0
1261,10,4167,9,220,90,130,2,30,1,1
14854,10,2417,9,245,102,143,2,30,1,1
18563,2058,7044,1584,70,70,0,1,5,1,0
14735,10,17507,9,713,94,619,4,54,2,2
11213,26,6201,16,69339,4124,65215,96,22,45,51
10327,3248,17992,2517,330,330,0,6,1200,6,0
13863,10,12156,9,189,102,87,2,30,1,1
14299,817,2847,597,422,140,282,6,15,3,3
3502,26,24240,16,10558,2530,8028,25,186,14,11
12999,26,16830,16,1786,172,1614,7,120,3,4
4851,2504,13728,1947,156,156,0,3,8,3,0
16423,15,10989,11,3524,1945,1579,32,131,17,15
18060,8,26586,8,1721,681,1040,22,17,10,12
13397,26,6478,16,3704,1428,2276,14,135,7,7
15281,26,14005,16,8057,2037,6020,20,15,11,9
13932,10,20480,9,192,98,94,2,31,1,1
1118,26,14951,16,3910,370,3540,16,34,5,11
13733,10,2003,9,330,86,244,2,30,1,1
18311,15,11348,11,1176,701,475,9,150,6,3
13904,10,21179,9,177,94,83,2,30,1,1
5322,26,7654,16,21690,2882,18808,59,197,30,29
17499,10,26282,9,825,99,726,2,30,1,1
236,10,600,9,225,90,135,2,30,1,1
12425,10,25596,9,231,94,137,2,30,1,1
7833,26,27425,16,8785,2057,6728,31,396,10,21
8648,15,21510,11,2444,1148,1296,14,48,7,7
17386,10,26206,9,203,82,121,2,30,1,1
13722,26,20007,16,5611,3720,1891,28,54,16,12
10972,26,24130,16,2646,1322,1324,28,36,15,13
12816,1281,1234,961,320,140,180,6,7,3,3
21798,26,28272,16,25404,2462,22942,47,32,25,22
13445,26,24066,16,4737,2854,1883,25,117,13,12
14938,10,22847,9,172,88,84,2,30,1,1
21276,10,17582,9,676,192,484,6,84,3,3
15285,10,23794,9,355,97,258,4,60,2,2
3327,26,22263,16,88895,4807,84088,104,136,37,67
15972,11,5266,10,70,70,0,1,4,1,0
15890,10,7459,9,342,110,232,2,30,1,1
15253,26,24913,16,7889,1900,5989,20,15,11,9
11266,688,24891,487,70,70,0,2,5,2,0
15337,1144,17724,844,70,70,0,1,5,1,0
15637,10,9023,9,183,94,89,2,31,1,1
8947,10,8931,9,194,102,92,2,30,1,1
15798,10,11138,9,224,102,122,2,30,1,1
15997,10,3844,9,177,94,83,2,29,1,1
6721,26,19714,16,9842,2961,6881,31,19,16,15
9058,15,11269,11,1409,735,674,12,17,5,7
15699,10,22717,9,202,103,99,2,31,1,1
6541,26,10543,16,72183,3193,68990,89,20,34,55
17124,10,20680,9,358,96,262,4,50,2,2
6823,10,3817,9,168,78,90,2,30,1,1
14402,10,4768,9,216,110,106,2,29,1,1
8584,1238,770,918,243,78,165,2,30,1,1
15412,10,1680,9,195,102,93,2,29,1,1
9777,26,25021,16,6673,1791,4882,22,72,12,10
21957,10,11675,9,403,142,261,2,30,1,1
19310,15,11686,11,28257,2893,25364,64,138,30,34
0,0,0,0,480,244,236,4,0,2,2
15898,10,12315,9,184,94,90,2,31,1,1
15010,26,26662,16,55149,7806,47343,134,108,61,73
13884,10,26962,9,168,86,82,2,29,1,1
11112,665,10407,466,70,70,0,1,4,1,0
22022,10,1191,9,343,92,251,4,50,2,2
15113,10,3881,9,202,103,99,2,31,1,1
22491,10,16150,9,168,86,82,2,30,1,1
14515,10,286,9,170,87,83,2,30,1,1
5001,26,5425,16,18512,3109,15403,45,48,22,23
1043,26,13057,16,5693,499,5194,14,15,7,7
22440,10,24244,9,200,102,98,2,31,1,1
15936,26,10921,16,7211,823,6388,16,15,10,6
16021,405,9991,263,1577,594,983,20,1616,10,10
13776,10,26900,9,253,87,166,4,44,2,2
20099,26,14816,16,4203,2748,1455,18,33,10,8
15012,10,970,9,177,94,83,2,30,1,1
9855,26,16089,16,2952,1548,1404,18,16,9,9
21868,10,1730,9,260,102,158,2,30,1,1
15411,1,6628,1,130,70,60,2,5,1,1
9431,15,24915,11,4064,607,3457,12,45,6,6
16502,15,2002,11,7453,2953,4500,19,21,10,9
9679,10,28970,9,210,110,100,2,29,1,1
8978,26,6560,16,10103,3140,6963,29,126,16,13
13624,26,27955,16,251620,16028,235592,353,371,159,194
8584,1628,25653,1250,78,78,0,1,30,1,0
22222,10,16774,9,182,93,89,2,30,1,1
14851,10,28312,9,177,94,83,2,30,1,1
13854,26,10081,16,7224,114,7110,9,122,2,7
18296,15,19109,11,17981,13577,4404,41,151,26,15
8812,15,14205,11,318,192,126,6,42,4,2
13022,26,12844,16,8327,4890,3437,23,316,12,11
13738,15,4926,11,306,180,126,6,85,4,2
532,247,0,0,3562,1936,1626,48,194,24,24
14558,233,1118,148,10038,5272,4766,36,196,20,16
8801,15,18917,11,318,192,126,6,42,4,2
9047,10,1915,9,177,94,83,2,29,1,1
5606,2007,4959,1537,143,81,62,2,30,1,1
14689,10,3298,9,771,101,670,2,31,1,1
12697,1046,17410,770,492,306,186,8,15,5,3
6221,26,8916,16,4622,926,3696,18,255,10,8
8642,15,22741,11,5000,4058,942,15,15,8,7
18861,26,8268,16,18385,7771,10614,47,48,27,20
12635,1044,20076,768,164,70,94,2,6,1,1
15923,10,15507,9,711,87,624,2,31,1,1
12153,26,1384,16,41321,1491,39830,52,41,15,37
13870,10,2153,9,209,110,99,2,30,1,1
14072,26,26973,16,684908,25994,658914,762,141,263,499
1731,1899,17807,1452,481,150,331,2,1200,1,1
19239,26,17963,16,42437,8035,34402,79,247,30,49
7044,26,29103,16,4792,3072,1720,31,80,16,15
11200,26,2520,16,11716,7393,4323,47,146,21,26
532,247,0,0,3354,1792,1562,46,194,23,23
22099,10,21352,9,199,102,97,2,29,1,1
14465,26,24406,16,505207,16025,489182,464,139,97,367
21855,10,5119,9,184,102,82,2,31,1,1
13629,26,6526,16,441892,86941,354951,716,73,343,373
9678,10,11644,9,168,86,82,2,30,1,1
22619,10,2796,9,731,85,646,2,31,1,1
14248,964,18155,712,70,70,0,1,5,1,0
14499,10,15371,9,339,98,241,4,47,2,2
18726,26,13142,16,66716,4091,62625,98,278,43,55
13673,10,11565,9,299,110,189,4,31,2,2
7258,15,19781,11,1243,530,713,10,20,5,5
14261,10,12969,9,195,102,93,2,30,1,1
8568,10,7622,9,214,110,104,2,30,1,1
10969,1716,18545,1311,70,70,0,2,8,2,0
15194,15,26465,11,234,234,0,4,12,4,0
18099,26,24726,16,3047,1277,1770,16,144,8,8
19388,26,23349,16,15584,2626,12958,34,37,18,16
14076,10,5028,9,738,86,652,2,30,1,1
21329,10,2664,9,186,95,91,2,31,1,1
4631,26,15439,16,14826,7220,7606,53,94,29,24
9607,15,3665,11,1718,1247,471,9,15,5,4
8967,10,1836,9,755,93,662,2,31,1,1
13958,10,11069,9,167,86,81,2,29,1,1
21547,10,21783,9,199,102,97,2,30,1,1
13790,10,19034,9,889,404,485,10,30,5,5
4041,234,10934,149,8648,2111,6537,40,7038,21,19
16845,183,25904,121,3428,1714,1714,16,31,8,8
9094,26,10311,16,16631,7072,9559,50,134,29,21
15086,15,15128,11,318,192,126,6,30,4,2
16788,10,2779,9,245,118,127,2,29,1,1
14443,10,4114,9,324,126,198,2,30,1,1
21710,10,3924,9,184,94,90,2,30,1,1
11103,733,28093,525,70,70,0,1,5,1,0
14310,1600,21901,1224,3529,1769,1760,11,15,6,5
14153,10,15037,9,701,88,613,2,30,1,1
12290,26,26333,16,7941,2678,5263,25,122,12,13
22474,10,8316,9,196,102,94,2,30,1,1
8933,10,9316,9,177,94,83,2,31,1,1
6854,26,15820,16,7746,2015,5731,29,15,16,13
9596,15,17771,11,318,192,126,6,29,4,2
15219,10,1101,9,199,94,105,2,30,1,1
21407,10,8560,9,381,102,279,4,42,2,2
2744,1246,28717,926,875,126,749,2,31,1,1
10606,26,23526,16,3051,990,2061,14,135,7,7
2744,1240,26797,920,1644,126,1518,4,30,2,2
17603,26,13523,16,3298,2132,1166,16,15,8,8
9436,26,17827,16,6662,3336,3326,37,142,17,20
16649,15,14050,11,2444,2444,0,3,191,3,0
14091,10,6898,9,168,78,90,2,30,1,1
14348,2641,1908,2049,70,70,0,1,5,1,0
15735,10,8102,9,216,110,106,2,31,1,1
21534,10,20687,9,324,90,234,4,35,2,2
14456,10,3093,9,170,87,83,2,31,1,1
21258,10,4453,9,212,108,104,2,31,1,1
14301,10,14132,9,174,89,85,2,31,1,1
22638,10,12704,9,330,105,225,4,37,2,2
14949,10,8088,9,711,87,624,2,30,1,1
7011,10,27913,9,212,78,134,2,30,1,1
14672,10,25075,9,199,102,97,2,30,1,1
17904,26,27309,16,20036,2088,17948,51,334,21,30
19967,26,5346,16,4755,1142,3613,15,273,8,7
14562,26,12039,16,24272,12428,11844,70,213,32,38
10207,15,19580,11,6240,4510,1730,40,131,22,18
20772,26,22410,16,2649,330,2319,12,134,5,7
7519,10,20177,9,404,259,145,3,32,2,1
21300,10,25312,9,179,94,85,2,30,1,1
10246,15,8032,11,366,240,126,7,21,5,2
12160,26,23441,16,34908,2650,32258,52,45,23,29
8969,10,12820,9,209,102,107,2,30,1,1
21584,10,22975,9,193,102,91,2,31,1,1
13044,26,17356,16,499,425,74,4,0,3,1
15264,10,1542,9,177,91,86,3,38,2,1
21762,10,25162,9,183,94,89,2,29,1,1
18546,2662,23172,2069,320,140,180,6,8,3,3
19384,26,26638,16,14558,2653,11905,33,27,18,15
20013,26,13287,16,1592,965,627,15,20,7,8
17263,26,25548,16,9225,1878,7347,28,21,14,14
8952,26,18012,16,10079,2855,7224,23,126,12,11
21399,15,14557,11,1517,481,1036,11,15,6,5
8297,15,28315,11,1739,740,999,17,235,5,12
15344,10,11911,9,182,93,89,2,30,1,1
21737,10,3010,9,374,101,273,4,42,2,2
15571,15,6740,11,214,140,74,4,35,3,1
532,247,0,0,3354,1792,1562,46,193,23,23
5372,26,10265,16,6420,1513,4907,25,26,14,11
22267,10,25155,9,197,94,103,2,29,1,1
15561,15,2016,11,214,140,74,4,35,3,1
10831,1670,11592,1278,70,70,0,2,8,2,0
21729,10,4735,9,199,102,97,2,30,1,1
14463,10,28264,9,177,94,83,2,30,1,1
14164,10,24710,9,182,93,89,2,31,1,1
14914,10,11747,9,209,110,99,2,30,1,1
8997,26,10751,16,8589,2871,5718,26,46,14,12
8728,10,19790,9,380,90,290,4,48,2,2
17431,15,5779,11,1399,762,637,10,76,6,4
3706,10,14684,9,404,259,145,3,32,2,1
7944,26,10704,16,52038,3333,48705,74,157,30,44
9520,10,18277,9,819,102,717,2,30,1,1
15891,10,3976,9,184,94,90,2,30,1,1
22418,10,16567,9,194,102,92,2,31,1,1
14552,10,20353,9,194,99,95,2,31,1,1
11088,363,2733,233,66,66,0,1,5,1,0
4844,26,845,16,9566,2592,6974,29,134,16,13
10552,15,18317,11,1515,481,1034,11,15,6,5
13673,10,26434,9,299,110,189,4,31,2,2
11408,26,23472,16,100194,6406,93788,171,24,85,86
10587,26,10277,16,957715,36759,920956,1075,161,378,697
13830,10,26368,9,183,94,89,2,30,1,1
18390,15,2553,11,3697,2062,1635,16,61,9,7
8134,10,21081,9,197,90,107,2,30,1,1
8136,26,19663,16,9336,1153,8183,27,34,14,13
20499,26,17628,16,304,86,218,2,30,1,1
15514,10,19150,9,196,102,94,2,30,1,1
2744,1256,2900,936,891,126,765,2,30,1,1
10707,360,10047,231,346,214,132,3,29,1,2
7015,26,126,16,7775,2973,4802,36,57,19,17
21843,10,1177,9,186,95,91,2,30,1,1
13948,10,21815,9,1415,101,1314,4,51,2,2
9481,26,2176,16,8814,1579,7235,24,41,12,12
16547,26,8474,16,14197,9283,4914,28,122,15,13
2724,1240,15985,920,422,164,258,6,30,3,3
22138,10,18712,9,192,98,94,2,40,1,1
19339,26,14891,16,97211,3043,94168,109,121,37,72
17877,26,17635,16,13342,1221,12121,33,41,15,18
8584,1238,10324,918,270,78,192,2,30,1,1
22359,10,3670,9,613,200,413,6,59,3,3
18494,26,33,16,3260,1646,1614,9,120,5,4
4774,10,9469,9,164,78,86,2,30,1,1
8853,10,10261,9,775,103,672,2,31,1,1
13294,26,23964,16,150554,18764,131790,192,117,95,97
520,10,1891,9,213,79,134,2,33,1,1
13378,280,12119,177,658,412,246,9,15,5,4
8414,10,27351,9,817,102,715,2,30,1,1
14947,10,20313,9,754,94,660,2,31,1,1
6141,26,787,16,26974,22004,4970,80,216,42,38
10327,2536,9106,1972,870,330,540,12,1316,6,6
17055,26,2597,16,4827,2244,2583,16,135,8,8
15495,10,28649,9,168,86,82,2,30,1,1
5066,26,2380,16,32864,2590,30274,41,82,14,27
16021,3022,26925,2350,594,594,0,10,1200,10,0
2052,10,21364,9,183,78,105,2,30,1,1
10072,26,4261,16,6888,1774,5114,25,210,14,11
22484,10,7779,9,180,94,86,2,31,1,1
21195,1603,5396,1227,70,70,0,1,4,1,0
15987,10,23918,9,181,94,87,2,30,1,1
22593,10,14122,9,297,110,187,2,30,1,1
16178,15,4225,11,1151,711,440,10,15,5,5
402,10,1256,9,235,90,145,2,33,1,1
8554,10,18981,9,323,102,221,2,30,1,1
19224,26,27818,16,3320,2053,1267,27,318,14,13
14850,10,29089,9,199,94,105,2,30,1,1
14885,26,24859,16,4378,1471,2907,19,30,11,8
15386,26,6589,16,8020,2000,6020,20,15,11,9
8635,26,22078,16,6416,1302,5114,20,119,10,10
15334,26,4140,16,8058,2038,6020,20,15,11,9
16021,2673,20882,2079,528,528,0,9,1200,9,0
3328,26,27767,16,11008,4624,6384,36,322,19,17
8841,255,21610,160,124,60,64,2,5,1,1
15038,10,12935,9,209,110,99,2,30,1,1
10079,15,29020,11,5427472,61630,5365842,4509,79,894,3615
14635,26,28032,16,1775,169,1606,7,120,3,4
18404,15,12617,11,9406,1913,7493,14,16,7,7
5095,26,7687,16,94827,3328,91499,97,16,30,67
11635,26,15971,16,10384,4563,5821,34,436,17,17
21145,10,13008,9,578,286,292,9,15,5,4
4835,405,4667,263,402,132,270,6,1208,3,3
9728,579,28151,391,166,166,0,1,1200,1,0
15469,10,25973,9,177,94,83,2,30,1,1
7608,26,17959,16,7389,1786,5603,26,211,14,12
7160,26,23034,16,2312,1382,930,19,26,11,8
11043,15,20560,11,27271,12050,15221,45,38,24,21
8378,26,25726,16,9739,3414,6325,59,928,30,29
8584,1509,24971,1148,260,78,182,2,30,1,1
2744,88,26028,68,859,126,733,2,29,1,1
2841,10,11697,9,832,106,726,2,30,1,1
12787,311,27250,203,70,70,0,2,8,2,0
18682,10,13147,9,337,86,251,2,29,1,1
585,10,12462,9,229,86,143,2,30,1,1
556,10,2077,9,197,90,107,2,30,1,1
15845,10,217,9,354,94,260,2,30,1,1
14430,10,18087,9,183,94,89,2,30,1,1
22577,10,10918,9,1160,392,768,10,66,5,5
14295,908,27404,672,70,70,0,1,5,1,0
8417,10,17239,9,225,110,115,2,29,1,1
17541,10,2943,9,211,78,133,2,30,1,1
21581,10,12983,9,196,102,94,2,29,1,1
6538,26,24576,16,3245691,49693,3195998,2856,38,666,2190
1006,26,16658,16,4618,840,3778,16,26,9,7
8787,10,26236,9,287,93,194,4,56,2,2
13041,26,4937,16,499,425,74,4,0,3,1
8664,26,28933,16,5394,2785,2609,14,134,7,7
19925,26,27649,16,187597,6822,180775,203,92,67,136
16021,666,26479,467,132,132,0,3,1199,3,0
20585,10,6066,9,578,286,292,9,15,5,4
9609,15,22607,11,3688274,86827,3601447,3622,32,1228,2394
4289,15,23777,11,78,78,0,1,5,1,0
9111,10,15841,9,264,102,162,2,30,1,1
14851,10,28663,9,170,87,83,2,31,1,1
22191,10,22692,9,180,94,86,2,30,1,1
11289,1139,22234,840,70,70,0,2,8,2,0
15361,26,5640,16,5698,906,4792,19,27,11,8
8365,26,9534,16,533813,25885,507928,678,50,308,370
22262,10,28936,9,235,90,145,2,31,1,1
8939,15,7839,11,70,70,0,2,8,2,0
5015,26,14899,16,2378,1126,1252,14,978,7,7
637,211,25168,136,600,600,0,5,1200,5,0
17767,23,0,0,11212,5520,5692,58,30,29,29
22207,1255,3547,935,1761,924,837,6,30,3,3
11697,26,14155,16,14001,2908,11093,35,150,18,17
15663,10,21591,9,443,182,261,6,29,3,3
17880,26,12298,16,382,164,218,2,31,1,1
12044,1368,24714,1039,70,70,0,1,5,1,0
6250,1987,27632,1517,148,86,62,2,30,1,1
14671,10,18120,9,186,95,91,2,31,1,1
15811,26,9889,16,6000,1578,4422,22,36,12,10
11860,26,6435,16,9381,3074,6307,47,114,24,23
12030,26,11036,16,6401,1225,5176,18,324,9,9
21720,10,25534,9,168,86,82,2,30,1,1
15939,10,9631,9,184,94,90,2,29,1,1
20244,10,27848,9,216,90,126,2,30,1,1
8488,10,16471,9,184,94,90,2,29,1,1
3396,26,14250,16,1067,650,417,10,31,6,4
14122,10,1604,9,732,89,643,2,30,1,1
5669,26,16200,16,2975,719,2256,14,136,7,7
14914,10,27265,9,193,102,91,2,31,1,1
22321,10,10247,9,193,102,91,2,29,1,1
15584,15,16251,11,214,140,74,4,30,3,1
21126,1258,26900,938,1592,1386,206,6,31,4,2
8641,15,23491,11,1548,847,701,10,16,5,5
9437,15,25105,11,442,250,192,8,45,5,3
15247,10,11979,9,198,101,97,2,31,1,1
15800,10,28678,9,165,86,79,2,31,1,1
21332,10,25471,9,383,94,289,2,30,1,1
19168,26,22100,16,1786,172,1614,7,120,3,4
7996,26,3814,16,10240,2295,7945,38,121,20,18
5431,10,20253,9,168,78,90,2,30,1,1
21348,10,22343,9,361,86,275,2,30,1,1
13658,10,28150,9,270,102,168,2,30,1,1
14557,10,14322,9,311,108,203,4,42,2,2
14611,26,20110,16,130,70,60,3,4,2,1
8541,10,11167,9,307,102,205,4,35,2,2
21188,1832,13136,1394,66,66,0,2,7,2,0
17791,15,26076,11,1139,609,530,10,34,6,4
9053,10,1303,9,310,99,211,4,40,2,2
19391,26,5957,16,580643,7944,572699,475,41,86,389
22474,10,17462,9,167,86,81,2,30,1,1
5819,26,8801,16,4093,1595,2498,23,15,12,11
21444,10,4068,9,180,94,86,2,31,1,1
13127,26,5514,16,10015,6047,3968,22,122,12,10
8345,153,17473,108,70,70,0,1,5,1,0
22705,26,15158,16,451899,13130,438769,463,16,162,301
4835,490,3328,322,132,132,0,3,1200,3,0
6696,10,18918,9,209,77,132,2,34,1,1
21957,10,18791,9,241,110,131,2,30,1,1
10670,15,22580,11,699944,13137,686807,676,20,195,481
16021,286,7456,183,471,269,202,4,1199,2,2
14356,10,16921,9,190,97,93,2,31,1,1
7929,15,24832,11,1151,711,440,10,15,5,5
12583,26,28798,16,495,421,74,4,1,3,1
15056,10,12523,9,177,94,83,2,29,1,1
14970,10,4700,9,774,101,673,2,31,1,1
16768,26,28440,16,15705,3421,12284,53,360,23,30
21342,10,23093,9,329,94,235,2,29,1,1
4373,10,15762,9,237,93,144,2,30,1,1
8615,26,12983,16,1574,921,653,14,15,7,7
8326,10,20943,9,213,102,111,2,29,1,1
2724,1240,1358,920,422,164,258,6,29,3,3
9461,10,16968,9,193,102,91,2,30,1,1
22220,10,4642,9,152,78,74,2,30,1,1
15340,10,11837,9,194,102,92,2,30,1,1
21906,10,27046,9,178,94,84,2,30,1,1
9667,26,23526,16,6676,1074,5602,22,84,12,10
7572,26,13124,16,3680,1777,1903,18,34,8,10
0,0,0,0,244,244,0,2,0,2,0
15625,10,16438,9,164,78,86,2,30,1,1
12264,26,23417,16,4582,1675,2907,19,29,11,8
18907,26,7695,16,333062,18123,314939,420,88,182,238
9,18,1951,13,184,94,90,2,29,1,1
3926,26,6243,16,7222,1768,5454,22,81,13,9
10903,892,25932,660,70,70,0,2,7,2,0
16122,10,13455,9,165,78,87,2,30,1,1
2192,10,8884,9,225,90,135,2,29,1,1
17872,15,17886,11,1352,848,504,13,83,8,5
21104,1933,17954,1476,66,66,0,1,5,1,0
20079,26,15635,16,4651,3116,1535,19,44,10,9
14001,10,6351,9,228,110,118,2,30,1,1
7521,10,3398,9,209,86,123,2,30,1,1
12391,26,9886,16,7268,3166,4102,19,136,10,9
21815,10,27762,9,821,102,719,2,30,1,1
13717,233,3677,148,4336,1518,2818,23,3002,14,9
22579,10,24295,9,764,99,665,2,31,1,1
7894,234,7981,149,2852,2143,709,16,121,8,8
5735,234,26214,149,234,174,60,2,4,1,1
5665,15,14969,11,1603,1179,424,10,124,6,4
8943,10,26717,9,272,84,188,4,60,2,2
15925,10,2227,9,701,88,613,2,30,1,1
15306,10,5174,9,165,86,79,2,30,1,1
9071,10,12399,9,308,92,216,2,30,1,1
14209,10,6601,9,167,86,81,2,30,1,1
11001,15,5331,11,60753,2612,58141,76,46,34,42
9696,10,16772,9,164,78,86,2,30,1,1
18460,2167,18501,1673,70,70,0,1,5,1,0
15520,26,8176,16,5601,1203,4398,14,60,9,5
15642,10,26,9,190,97,93,2,31,1,1
8256,26,20625,16,15944,6988,8956,135,324,72,63
21750,10,3532,9,216,110,106,2,30,1,1
22370,10,8684,9,219,94,125,2,30,1,1
8375,10,9420,9,578,286,292,9,15,5,4
4186,26,8921,16,4665045,113088,4551957,4511,421,1285,3226
21318,10,25933,9,200,102,98,2,31,1,1
8372,10,1244,9,720,94,626,2,30,1,1
15300,26,3001,16,6481,972,5509,17,52,10,7
15858,10,17667,9,177,94,83,2,29,1,1
17842,26,17337,16,304,86,218,2,30,1,1
19304,26,20917,16,7839,1726,6113,21,77,11,10
14516,10,16888,9,754,94,660,2,30,1,1
15327,2204,8088,1707,70,70,0,1,5,1,0
4879,26,3990,16,2465,1356,1109,18,180,8,10
8933,10,8420,9,177,94,83,2,29,1,1
18899,26,2169,16,9387,2961,6426,38,18,23,15
14767,26,3943,16,1312,651,661,13,185,7,6
16008,10,23652,9,776,102,674,2,30,1,1
21971,10,15303,9,193,102,91,2,30,1,1
14253,26,14263,16,96323,4044,92279,113,139,44,69
15328,26,6777,16,8058,2038,6020,20,15,11,9
14527,10,17361,9,177,94,83,2,30,1,1
22596,10,6270,9,210,102,108,2,30,1,1
4722,26,22742,16,23266,18300,4966,56,27,33,23
17596,26,18878,16,6489,2731,3758,19,16,10,9
10589,10,1019,9,78,78,0,1,30,1,0
21670,10,2293,9,182,86,96,2,29,1,1
18247,26,16446,16,8198,2252,5946,29,318,14,15
14805,234,27205,149,2495,1477,1018,17,3600,8,9
9535,15,10749,11,2837,582,2255,12,17,7,5
10106,15,10797,11,1111949,11633,1100316,906,37,173,733
6559,15,12788,11,1638,1324,314,10,15,5,5
7430,26,20509,16,40877,5947,34930,81,56,39,42
19259,183,27227,121,3488,1774,1714,17,33,9,8
14475,10,3575,9,1410,93,1317,4,59,2,2
13878,10,5096,9,177,94,83,2,29,1,1
11095,2665,11063,2072,70,70,0,2,7,2,0
12535,1009,8348,743,2044,1143,901,19,16,9,10
22525,10,24530,9,94,94,0,1,30,1,0
18434,26,17565,16,7202,2596,4606,24,83,12,12
16418,234,27837,149,2655,1540,1115,19,3601,9,10
21574,10,28135,9,193,102,91,2,29,1,1
17267,26,20530,16,2702,1593,1109,21,23,11,10
15565,15,3699,11,214,140,74,4,35,3,1
14006,10,22202,9,760,97,663,2,31,1,1
15357,2502,20406,1946,70,70,0,2,8,2,0
8082,26,21696,16,20838,2211,18627,40,14,20,20
22141,10,3379,9,168,86,82,2,31,1,1
12159,26,13027,16,6894,1556,5338,23,3601,13,10
8322,26,15097,16,8941,1776,7165,22,136,12,10
22035,10,19301,9,180,94,86,2,30,1,1
18759,923,13036,681,70,70,0,1,5,1,0
0,0,0,0,600,306,294,6,0,3,3
10934,2660,27795,2067,70,70,0,2,8,2,0
5606,2006,23833,1536,245,182,63,2,30,1,1
15700,10,2767,9,711,87,624,2,30,1,1
9090,15,3074,11,1126,609,517,11,15,6,5
22116,10,25421,9,210,110,100,2,30,1,1
15533,10,15714,9,196,102,94,2,30,1,1
8595,10,1034,9,199,102,97,2,29,1,1
16021,2507,18027,1949,132,132,0,3,1199,3,0
10499,26,12440,16,396,66,330,7,17,2,5
15235,10,17579,9,183,94,89,2,30,1,1
22033,10,9261,9,195,102,93,2,29,1,1
7453,26,18649,16,4392,1781,2611,21,20,12,9
17618,26,12177,16,2288,1131,1157,25,119,12,13
13110,1239,1072,919,924,924,0,3,30,3,0
9160,10,3329,9,183,94,89,2,30,1,1
8381,26,1453,16,17273,11238,6035,73,919,36,37
4709,26,8221,16,10000,2634,7366,28,46,16,12
22333,10,11314,9,188,96,92,2,31,1,1
14782,10,4972,9,282,87,195,4,45,2,2
15796,234,28838,149,16135,7514,8621,173,9115,72,101
5059,26,25623,16,19092095,654744,18437351,24079,407,8531,15548
14064,26,7662,16,9255,2064,7191,43,78,18,25
6554,26,6985,16,8954,2755,6199,23,143,10,13
5081,26,17847,16,2535,1177,1358,16,28,7,9
9411,571,16844,385,402,132,270,6,1209,3,3
13886,10,20538,9,193,102,91,2,30,1,1
14402,10,10126,9,168,78,90,2,30,1,1
11005,26,28236,16,35746,4732,31014,68,67,33,35
10209,10,0,0,325,75,250,2,30,1,1
16140,15,25470,11,11536,3264,8272,29,37,15,14
14990,10,18248,9,184,94,90,2,31,1,1
15342,10,7363,9,170,87,83,2,31,1,1
12063,2083,2373,1605,70,70,0,2,8,2,0
14549,10,25265,9,193,102,91,2,31,1,1
21325,47,6350,30,70,70,0,1,5,1,0
21087,26,13817,16,4407024,140001,4267023,4628,124,1546,3082
13964,10,21869,9,210,110,100,2,30,1,1
16021,479,730,313,132,132,0,3,1199,3,0
18980,26,18813,16,7231,2305,4926,32,40,18,14
15885,10,5297,9,1427,101,1326,4,48,2,2
15215,15,24008,11,234,234,0,4,11,4,0
10817,15,18360,11,26626,1555,25071,36,20,16,20
12140,26,8188,16,5025,973,4052,19,66,10,9
22392,1352,5799,1025,240,78,162,2,29,1,1
16005,15,89,11,4508,2978,1530,13,15,6,7
6250,2002,14830,1532,1188,567,621,6,31,3,3
21912,10,24551,9,193,102,91,2,30,1,1
21796,10,10322,9,194,102,92,2,30,1,1
0,0,0,0,480,244,236,4,0,2,2
15862,10,14344,9,177,94,83,2,30,1,1
15412,10,19028,9,176,90,86,2,31,1,1
15014,15,2902,11,17248,1619,15629,26,25,11,15
17002,15,18871,11,12499310,161518,12337792,10496,70,2325,8171
7895,26,27868,16,6234,4369,1865,25,316,12,13
12824,26,11285,16,6734,2264,4470,19,16,11,8
9759,15,20954,11,190675,79205,111470,237,41,104,133
9500,10,12999,9,180,94,86,2,30,1,1
8484,10,27420,9,194,102,92,2,30,1,1
11012,2893,22597,2246,70,70,0,1,5,1,0
10877,10,21662,9,164,78,86,2,31,1,1
14339,10,10889,9,177,94,83,2,29,1,1
15739,10,8567,9,179,94,85,2,29,1,1
20486,26,25148,16,3707,1245,2462,11,119,6,5
11002,15,12063,11,7001170,112187,6888983,6101,29,1546,4555
8210,598,21194,409,460,150,310,2,1200,1,1
21516,10,6202,9,260,86,174,2,30,1,1
15519,26,16591,16,10408,4790,5618,34,322,16,18
21439,10,3401,9,209,110,99,2,30,1,1
12871,10,6486,9,224,86,138,2,29,1,1
21403,10,9234,9,194,94,100,2,31,1,1
8584,1238,1799,918,265,78,187,2,31,1,1
2224,26,9078,16,13003,1226,11777,25,19,12,13
18877,26,10221,16,10707,2969,7738,32,47,18,14
8843,10,27263,9,373,126,247,2,29,1,1
4566,26,13518,16,1364815,60410,1304405,1401,901,341,1060
20116,10,14227,9,303,303,0,4,47,4,0
5860,232,7854,147,107717,16808,90909,301,618,148,153
15697,10,12877,9,190,97,93,2,30,1,1
22687,26,615,16,92290,4799,87491,107,16,43,64
8684,10,28125,9,186,95,91,2,30,1,1
21124,1536,3090,1170,312,132,180,6,7,3,3
22624,15,23630,11,486,240,246,9,28,5,4
14246,10,15769,9,199,94,105,2,30,1,1
8721,26,14624,16,740109,22948,717161,800,54,311,489
19503,10,27372,9,235,90,145,2,33,1,1
15329,10,29009,9,183,94,89,2,30,1,1
10925,787,22968,572,70,70,0,2,8,2,0
16021,349,3995,222,3281,894,2387,14,1200,7,7
5524,26,19109,16,6922156,117604,6804552,6122,50,1519,4603
22422,10,16722,9,197,94,103,2,29,1,1
8369,1545,19656,1177,70,70,0,2,8,2,0
12594,1153,4931,851,70,70,0,2,8,2,0
12562,26,12118,16,70,70,0,1,5,1,0
22283,10,908,9,278,100,178,4,31,2,2
18827,26,26995,16,1386,751,635,15,182,8,7
3934,10,15042,9,225,106,119,2,30,1,1
8556,10,24848,9,210,110,100,2,30,1,1
8449,10,7793,9,197,94,103,2,30,1,1
21971,10,9644,9,193,102,91,2,30,1,1
8836,26,7752,16,16957,6203,10754,30,52,14,16
7560,26,23418,16,13699,2575,11124,30,135,15,15
7958,15,27295,11,2917,870,2047,14,16,8,6
21742,10,12039,9,382,102,280,2,29,1,1
2744,1233,11849,913,887,126,761,2,31,1,1
8887,26,22889,16,4588,843,3745,14,52,7,7
8463,26,13777,16,50454,5259,45195,52,105,17,35
8188,26,16018,16,7868,2194,5674,26,36,13,13
2744,1238,21295,918,1610,126,1484,4,30,2,2
6772,15,20336,11,130,70,60,2,15,1,1
15607,26,3168,16,30645,2719,27926,60,153,25,35
8993,26,18671,16,7284,1353,5931,26,186,14,12
3305,26,26902,16,13056,4233,8823,27,121,12,15
10848,2209,26685,1711,156,66,90,2,5,1,1
13961,10,28095,9,193,102,91,2,30,1,1
15460,10,7848,9,177,94,83,2,31,1,1
770,26,3131,16,1474,697,777,18,82,8,10
8943,26,18433,16,35152,27056,8096,56,104,31,25
17194,26,15482,16,5168,700,4468,16,15,7,9
6337,26,9507,16,68806,2442,66364,71,215,19,52
21836,10,25946,9,211,110,101,2,31,1,1
14415,10,22971,9,199,102,97,2,29,1,1
6942,26,15842,16,20062,11233,8829,48,94,29,19
5158,10,16692,9,371,237,134,3,32,2,1
12114,26,3558,16,6597,1798,4799,28,80,12,16
21579,10,4924,9,174,89,85,2,30,1,1
12542,2627,24583,2037,70,70,0,1,5,1,0
1237,10,4096,9,213,87,126,2,30,1,1
8999,10,1366,9,250,86,164,4,30,2,2
17186,676,9765,475,138,78,60,2,5,1,1
14417,10,22233,9,177,94,83,2,30,1,1
18448,3036,2177,2361,70,70,0,1,5,1,0
2744,1242,12013,922,880,126,754,2,30,1,1
0,0,0,0,244,244,0,2,0,2,0
5629,15,20256,11,1195,763,432,10,32,6,4
21904,10,14986,9,190,97,93,2,31,1,1
21995,10,701,9,633,231,402,6,47,3,3
13907,10,7874,9,177,94,83,2,29,1,1
9723,10,24375,9,174,89,85,2,31,1,1
16167,15,25496,11,104868,1493,103375,90,31,17,73
18054,10,17595,9,168,78,90,2,31,1,1
2937,10,12039,9,235,90,145,2,33,1,1
637,413,6796,268,654,150,504,3,1200,1,2
15641,10,20641,9,274,110,164,2,31,1,1
14940,26,866,16,3734,1750,1984,24,203,12,12
8712,10,1928,9,212,110,102,2,30,1,1
14709,10,25597,9,194,102,92,2,30,1,1
16890,15,9825,11,884,529,355,10,255,6,4
21901,10,5417,9,183,94,89,2,29,1,1
11920,15,23236,11,181759,5146,176613,216,25,77,139
9999,26,11311,16,6351,1370,4981,18,131,9,9
12546,3021,14409,2349,258,70,188,4,8,2,2
11183,572,17336,386,316,136,180,6,6,3,3
8836,26,7112,16,98424,28850,69574,508,2054,274,234
9842,15,18497,11,54871,28320,26551,231,174,116,115
9520,26,28698,16,7738,879,6859,19,27,10,9
21517,10,15680,9,211,78,133,2,29,1,1
8160,26,25125,16,6799,4474,2325,38,85,20,18
15135,10,23712,9,177,94,83,2,30,1,1
14996,15,28851,11,38188,688,37500,35,104,7,28
8770,10,23810,9,179,94,85,2,29,1,1
8298,10,20095,9,238,94,144,2,30,1,1
21392,10,28507,9,209,77,132,2,32,1,1
22573,10,10431,9,301,108,193,4,54,2,2
8124,26,20502,16,160,69,91,2,121,1,1
10699,2307,25886,1791,1201,577,624,8,30,4,4
20682,26,1973,16,9042,4612,4430,31,175,17,14
13470,26,7698,16,12150,2950,9200,35,341,17,18
16630,26,13527,16,10209,2530,7679,33,223,17,16
5253,26,11023,16,8554,2353,6201,29,138,14,15
6855,26,27900,16,92044,19483,72561,147,186,55,92
9523,10,21746,9,197,102,95,2,29,1,1
22190,10,4269,9,194,102,92,2,30,1,1
13674,26,22229,16,670633,656612,14021,657,146,465,192
3133,2324,22736,1808,396,396,0,7,3616,7,0
12122,26,14933,16,6059,1040,5019,20,58,11,9
18285,15,8913,11,5141,3706,1435,17,151,10,7
21384,10,12863,9,225,102,123,2,30,1,1
16359,15,26455,11,32460,9354,23106,67,71,40,27
12577,2632,18509,2042,70,70,0,1,5,1,0
7654,26,3870,16,1312,651,661,13,184,7,6
16055,26,3321,16,5150,3987,1163,18,38,11,7
18910,26,26422,16,11543,5375,6168,45,47,24,21
3499,26,14969,16,5698,1585,4113,23,1108,13,10
8584,554,4760,370,249,71,178,2,30,1,1
14532,10,5342,9,184,94,90,2,29,1,1
14091,10,22555,9,168,86,82,2,33,1,1
15681,10,19758,9,366,102,264,4,46,2,2
15008,10,2815,9,762,98,664,2,31,1,1
9104,26,21739,16,13342,2357,10985,25,18,14,11
8584,1239,17390,919,71,71,0,1,30,1,0
14414,10,11225,9,770,101,669,2,30,1,1
9404,26,25268,16,7975,1974,6001,31,210,15,16
14753,10,4457,9,199,94,105,2,30,1,1
3692,15,9377,11,2443,1794,649,11,76,6,5
13686,10,0,0,288,79,209,2,31,1,1
12477,26,2211,16,8473,1099,7374,20,18,9,11
21637,10,17914,9,258,110,148,2,30,1,1
5929,26,6190,16,4997074,153969,4843105,5249,343,1861,3388
13666,26,20476,16,3388,2236,1152,28,904,16,12
8730,10,16911,9,193,102,91,2,30,1,1
3916,15,8239,11,71843,2833,69010,83,15,36,47
10702,26,16553,16,1203,703,500,14,38,8,6
802,10,3310,9,213,87,126,2,30,1,1
8157,26,16685,16,6388,964,5424,21,255,11,10
5114,26,5384,16,1264333,25315,1239018,1197,16,355,842
9440,26,23952,16,9999,2316,7683,30,26,15,15
16560,10,25738,9,825,99,726,2,30,1,1
21847,10,5434,9,410,102,308,2,29,1,1
2795,10,11508,9,398,255,143,3,33,2,1
15190,10,16799,9,177,94,83,2,29,1,1
22536,10,19729,9,328,99,229,4,45,2,2
19379,26,28371,16,4624,1191,3433,23,75,14,9
16444,188,27282,123,60483,25857,34626,136,47,63,73
3423,10,5158,9,199,94,105,2,29,1,1
14355,10,22428,9,190,97,93,2,30,1,1
9750,15,13143,11,83795,22317,61478,117,43,52,65
11317,26,15062,16,21680,2897,18783,35,120,15,20
22675,10,27497,9,216,102,114,2,30,1,1
19620,26,4976,16,6244,1855,4389,16,75,9,7
10552,26,17977,16,7211,823,6388,16,15,10,6
12309,26,7390,16,144165,6110,138055,170,31,67,103
8926,10,19606,9,183,94,89,2,29,1,1
7179,26,23556,16,1312,651,661,13,185,7,6
8643,10,19067,9,168,78,90,2,30,1,1
12937,26,23769,16,186718,24971,161747,253,84,127,126
12994,26,2119,16,2895,1646,1249,17,16,8,9
19351,15,1284,11,4671,2593,2078,15,85,9,6
22377,10,9768,9,214,110,104,2,30,1,1
8960,26,10562,16,7307,841,6466,18,126,9,9
13975,10,9277,9,294,106,188,4,55,2,2
8035,26,20939,16,4627,1720,2907,18,26,10,8
8577,10,7289,9,195,102,93,2,31,1,1
11253,533,15797,353,70,70,0,2,9,2,0
14146,10,10004,9,216,94,122,2,30,1,1
11099,26,25838,16,8593,2221,6372,31,232,17,14
15768,10,20201,9,183,94,89,2,31,1,1
4448,26,28217,16,10922,2532,8390,27,28,13,14
16122,26,6969,16,9109,2044,7065,25,22,14,11
4033,26,22101,16,3730,2455,1275,18,256,10,8
15738,10,18787,9,178,94,84,2,30,1,1
11826,26,19007,16,7148,2358,4790,40,116,18,22
1084,26,1786,16,4717,2929,1788,23,26,13,10
5695,26,28478,16,6517,1812,4705,21,255,11,10
9552,295,21959,190,3132,815,2317,14,18,7,7
12050,1458,24809,1111,70,70,0,1,5,1,0
21761,10,1960,9,264,110,154,2,30,1,1
13637,10,15385,9,728,102,626,2,30,1,1
11382,15,17075,11,78,78,0,1,5,1,0
10981,26,15138,16,3854,1151,2703,20,135,10,10
18494,2704,7466,2100,70,70,0,1,5,1,0
9497,26,1897,16,130,70,60,3,4,2,1
5948,10,17898,9,244,98,146,2,34,1,1
9,18,21250,13,184,94,90,2,29,1,1
15745,10,15492,9,272,94,178,2,29,1,1
9491,26,2498,16,1385,868,517,12,30,6,6
13646,10,5136,9,190,97,93,2,31,1,1
7531,26,11253,16,127147,41867,85280,198,240,91,107
4854,2504,28292,1947,156,156,0,3,8,3,0
9161,15,8403,11,2863,604,2259,11,15,6,5
14247,10,4298,9,182,93,89,2,31,1,1
10052,26,24890,16,3440,2371,1069,17,96,10,7
10053,26,17328,16,9516,1896,7620,21,127,11,10
11239,1851,27386,1411,136,136,0,3,14,3,0
11008,15,5501,11,24474,2101,22373,38,48,19,19
15831,26,19065,16,11536,2572,8964,41,33,24,17
2744,1067,18145,786,890,126,764,3,32,2,1
22568,10,24564,9,207,86,121,2,30,1,1
15259,26,23283,16,7907,1918,5989,20,15,11,9
9084,26,22480,16,10526,811,9715,20,135,8,12
16658,26,26776,16,4220,2048,2172,11,122,6,5
9521,10,26137,9,214,110,104,2,30,1,1
21795,10,21089,9,226,110,116,2,30,1,1
14317,1866,9013,1424,70,70,0,2,8,2,0
9728,280,7812,177,502,150,352,2,1200,1,1
3516,15,21172,11,1265,473,792,8,15,5,3
17119,26,9211,16,5168,700,4468,16,14,7,9
9022,15,22392,11,1539,674,865,11,89,6,5
15207,10,11237,9,200,94,106,2,29,1,1
21942,10,18624,9,195,102,93,2,31,1,1
14758,10,8596,9,461,94,367,2,30,1,1
14788,26,24799,16,27729,5508,22221,60,18,31,29
12600,26,19285,16,499,425,74,4,0,3,1
19965,26,8321,16,1638,776,862,22,120,11,11
15896,10,26004,9,248,94,154,2,30,1,1
22512,10,12205,9,285,103,182,4,43,2,2
8721,10,16229,9,199,102,97,2,30,1,1
17232,10,9000,9,168,78,90,2,31,1,1
15292,10,20088,9,178,94,84,2,31,1,1
11269,77,6990,59,256,136,120,5,5,3,2
15178,10,7122,9,179,94,85,2,30,1,1
8667,26,3520,16,15456,2581,12875,28,31,10,18
9236,10,24791,9,261,97,164,4,44,2,2
15178,10,10107,9,179,94,85,2,30,1,1
19978,10,19969,9,387,94,293,2,30,1,1
12824,2761,16812,2140,70,70,0,1,5,1,0
11954,104,23257,81,60,60,0,1,5,1,0
12486,354,26328,227,2104,1209,895,15,16,7,8
18160,26,4624,16,14085,1879,12206,27,141,12,15
1004,26,10956,16,4082,958,3124,14,26,8,6
15650,10,3909,9,239,94,145,2,30,1,1
9964,15,17825,11,35970,11674,24296,108,265,55,53
16021,2170,13644,1676,594,594,0,10,1199,10,0
769,15,3126,11,1670,1044,626,15,84,8,7
11908,26,4268,16,13028,4115,8913,45,95,23,22
11005,26,6086,16,29510,15378,14132,76,216,35,41
3852,15,4328,11,9105,1930,7175,18,16,9,9
10813,550,3188,366,316,136,180,6,6,3,3
14409,10,28703,9,193,102,91,2,29,1,1
12058,2248,9720,1740,1078,518,560,16,21,9,7
8729,10,17774,9,200,102,98,2,29,1,1
6102,15,20068,11,1056,362,694,10,49,6,4
22108,10,4770,9,198,101,97,2,30,1,1
8340,10,11671,9,214,110,104,2,30,1,1
7045,10,19474,9,198,90,108,2,30,1,1
18055,15,1222,11,1221,339,882,9,16,5,4
18822,1989,10520,1519,316,136,180,6,5,3,3
15891,10,12652,9,204,104,100,2,31,1,1
12701,2712,6704,2106,70,70,0,2,8,2,0
10707,26,22600,16,4539,1632,2907,19,27,11,8
22685,10,21933,9,183,94,89,2,30,1,1
11202,309,9070,202,70,70,0,1,5,1,0
9411,1612,26660,1234,1488,930,558,21,1200,12,9
15223,26,1614,16,7080,2136,4944,18,121,8,10
15061,15,16342,11,82266,4947,77319,94,136,37,57
4720,26,25147,16,10517,2926,7591,29,20,16,13
10822,15,8893,11,3840,2265,1575,16,47,10,6
9728,528,27933,350,2118,900,1218,14,4232,7,7
3902,10,14989,9,233,90,143,2,33,1,1
6189,26,7028,16,11459,2165,9294,29,259,11,18
22052,10,17736,9,167,86,81,2,31,1,1
5614,26,15071,16,5448,989,4459,22,84,10,12
12055,1957,11759,1494,70,70,0,2,8,2,0
8760,10,25315,9,301,102,199,2,30,1,1
17048,15,26021,11,6516,564,5952,16,25,7,9
568,10,2128,9,220,90,130,2,30,1,1
16746,26,12337,16,13272,2360,10912,37,208,19,18
5364,10,23354,9,224,78,146,2,30,1,1
4069,26,15252,16,7201,1167,6034,16,131,8,8
14592,10,8002,9,738,86,652,2,30,1,1
12643,812,16904,592,70,70,0,1,5,1,0
10818,26,9259,16,3679,1712,1967,14,135,7,7
9142,10,20450,9,774,101,673,2,31,1,1
11233,42,23188,25,136,136,0,3,14,3,0
0,0,0,0,600,306,294,6,0,3,3
9599,10,9550,9,756,95,661,2,30,1,1
6377,26,28257,16,4813,970,3843,12,135,6,6
21740,10,23589,9,388,134,254,2,30,1,1
13825,10,8674,9,194,102,92,2,35,1,1
19924,26,27648,16,41941,3388,38553,67,77,26,41
15082,10,9334,9,198,102,96,2,33,1,1
12052,26,12109,16,12979,4609,8370,27,25,15,12
9026,10,17556,9,180,94,86,2,30,1,1
15712,10,18207,9,166,86,80,2,29,1,1
9556,15,11147,11,1524,341,1183,11,36,4,7
13657,10,5755,9,192,98,94,2,31,1,1
8865,10,23306,9,209,110,99,2,30,1,1
8534,10,13039,9,389,94,295,4,55,2,2
2378,10,9796,9,245,98,147,2,30,1,1
9031,10,28071,9,177,94,83,2,30,1,1
21579,10,17626,9,179,94,85,2,29,1,1
15268,26,19243,16,3886,2545,1341,18,18,10,8
6514,10,7091,9,168,78,90,2,29,1,1
1243,15,4109,11,6705,702,6003,13,16,6,7
3654,15,8132,11,1298,473,825,16,392,5,11
12092,26,11629,16,3656,2345,1311,18,17,9,9
5022,10,16572,9,231,88,143,2,34,1,1
11504,15,5983,11,3290,2776,514,12,15,7,5
8618,26,23450,16,13184,2507,10677,27,64,14,13
10937,15,4065,11,9189,3144,6045,19,28,11,8
15328,1890,6085,1443,156,66,90,2,5,1,1
6041,26,22430,16,16032,13508,2524,37,36,19,18
11073,15,2006,11,1484,805,679,11,25,7,4
8970,10,11309,9,296,102,194,2,30,1,1
10838,26,22664,16,1466,856,610,13,27,6,7
15624,10,5725,9,211,102,109,2,30,1,1
10071,26,12368,16,134,60,74,3,5,2,1
13974,10,2763,9,199,102,97,2,30,1,1
18400,232,18971,147,32653,15160,17493,307,506,160,147
3133,2321,7387,1805,330,330,0,6,3610,6,0
13200,26,10390,16,9398,2027,7371,33,270,14,19
9450,10,3278,9,209,110,99,2,30,1,1
21946,10,1239,9,216,102,114,2,30,1,1
15245,26,4568,16,8006,1986,6020,20,15,11,9
14374,10,20764,9,199,94,105,2,29,1,1
12249,26,7271,16,4814,1207,3607,17,75,10,7
17848,10,857,9,303,85,218,2,30,1,1
3731,26,12303,16,7002,1252,5750,28,258,15,13
8764,10,6387,9,214,102,112,2,30,1,1
8335,10,4369,9,192,98,94,2,31,1,1
22557,10,8264,9,192,98,94,2,30,1,1
22111,10,28491,9,487,201,286,6,39,3,3
22087,10,18158,9,324,94,230,2,30,1,1
14662,10,6808,9,744,89,655,2,31,1,1
16128,15,25458,11,110070,5374,104696,112,156,36,76
812,15,17067,11,4999,1313,3686,36,667,8,28
3217,10,13692,9,233,90,143,2,32,1,1
3717,10,14693,9,240,98,142,2,30,1,1
9241,10,18359,9,774,101,673,2,30,1,1
8856,10,20148,9,198,94,104,2,30,1,1
8612,26,25618,16,1280822,27768,1253054,1241,40,365,876
16021,288,4239,185,520,166,354,2,1199,1,1
22661,10,22334,9,209,110,99,2,30,1,1
5363,26,15239,16,32732,6260,26472,69,217,34,35
8931,10,5301,9,194,102,92,2,31,1,1
15344,10,22549,9,183,94,89,2,31,1,1
2724,1240,21105,920,422,164,258,6,30,3,3
14877,26,16365,16,162,102,60,2,5,1,1
10070,26,8001,16,37198,29093,8105,64,17,34,30
22682,26,19753,16,438968,12780,426188,449,16,157,292
3086,10,12914,9,197,90,107,2,30,1,1
17837,183,26476,121,3331,1442,1889,15,17,8,7
11147,960,1030,708,70,70,0,1,5,1,0
15229,10,15704,9,209,110,99,2,30,1,1
22061,26,15544,16,13583,4157,9426,26,120,11,15
21361,26,6951,16,3289,1031,2258,13,121,6,7
14897,10,784,9,182,93,89,2,30,1,1
9423,26,5150,16,3937,1191,2746,20,163,9,11
21456,26,28535,16,18608,1844,16764,31,16,16,15
7736,26,8227,16,5995,1092,4903,22,72,12,10
9008,10,13095,9,755,102,653,2,30,1,1
6310,15,23339,11,2169,1419,750,10,15,6,4
14948,10,13531,9,194,102,92,2,30,1,1
15162,10,23843,9,177,94,83,2,30,1,1
11843,26,28612,16,5584,1390,4194,19,14,9,10
16718,10,21188,9,320,94,226,2,30,1,1
16021,915,16241,676,132,132,0,3,1200,3,0
20061,26,1472,16,79513,7480,72033,106,122,39,67
8711,26,25842,16,7189,1694,5495,31,131,14,17
7821,10,10587,9,167,78,89,2,30,1,1
3867,26,22397,16,18452,11429,7023,39,64,23,16
14010,10,15607,9,199,102,97,2,30,1,1
13735,26,10553,16,8944,4006,4938,31,16,18,13
12307,26,5376,16,25555,2220,23335,44,30,20,24
21797,10,16790,9,199,102,97,2,30,1,1
22180,10,27889,9,767,102,665,2,30,1,1
12821,2034,3531,1562,70,70,0,1,4,1,0
16235,10,11063,9,237,86,151,2,30,1,1
15144,10,2557,9,365,105,260,4,47,2,2
7438,26,25811,16,52438,4244,48194,77,23,37,40
21329,10,28720,9,276,94,182,4,55,2,2
8339,10,5636,9,305,94,211,2,30,1,1
12054,855,17366,630,444,192,252,8,17,4,4
18699,18,16565,13,184,94,90,2,30,1,1
10825,26,16451,16,4209,2221,1988,25,157,12,13
11666,15,11429,11,2255,997,1258,16,152,8,8
19378,10,0,0,314,93,221,2,30,1,1
15216,10,22892,9,453,186,267,6,30,3,3
12735,26,23392,16,499,425,74,4,0,3,1
21241,2646,28521,2054,504,382,122,8,16,6,2
8682,10,22640,9,182,93,89,2,30,1,1
6981,26,19095,16,9700,2137,7563,21,16,12,9
13890,10,10142,9,184,102,82,2,30,1,1
22388,1285,25587,964,268,78,190,2,30,1,1
6569,26,20915,16,6102,782,5320,17,67,8,9
18952,26,27067,16,70839,5466,65373,98,19,47,51
10901,26,1647,16,554,310,244,10,30,6,4
926,26,936,16,5731,495,5236,14,15,7,7
12704,10,7884,9,168,78,90,2,30,1,1
14946,26,10873,16,3734,1750,1984,24,203,12,12
8401,346,21381,220,2604,848,1756,13,136,7,6
11098,15,24035,11,362,240,122,7,25,5,2
14906,10,9127,9,168,94,74,2,30,1,1
15913,10,27001,9,198,101,97,2,30,1,1
12631,10,7846,9,102,102,0,1,30,1,0
22276,10,2326,9,336,111,225,4,29,2,2
9506,15,6396,11,3907,880,3027,11,15,5,6
20923,26,1133,16,7339,2638,4701,33,167,18,15
8497,26,25386,16,137414,6004,131410,170,80,59,111
17612,26,8031,16,7222,1633,5589,24,201,13,11
15561,10,12474,9,216,110,106,2,30,1,1
6473,10,15928,9,241,78,163,2,30,1,1
5416,26,27755,16,70,70,0,1,5,1,0
17186,26,13226,16,3404,2124,1280,18,135,10,8
18149,26,10144,16,2314,1232,1082,15,141,8,7
22063,10,1378,9,289,110,179,2,30,1,1
15329,10,23867,9,182,93,89,2,31,1,1
9877,15,27939,11,3498,2696,802,9,26,5,4
11909,15,4951,11,1988,742,1246,10,334,6,4
22126,10,14126,9,194,102,92,2,30,1,1
15343,26,24354,16,7889,1900,5989,20,16,11,9
636,36,6816,21,268,150,118,2,1199,1,1
15570,10,19344,9,168,86,82,2,30,1,1
22549,10,15499,9,199,102,97,2,30,1,1
11986,26,9382,16,7014,1719,5295,18,326,9,9
8999,10,1717,9,146,75,71,2,30,1,1
14608,10,14088,9,196,94,102,2,30,1,1
21324,2257,23942,1747,70,70,0,1,4,1,0
9748,26,22070,16,4716,1809,2907,19,30,11,8
4380,26,16544,16,712,374,338,11,26,6,5
971,26,10753,16,6327,833,5494,19,26,10,9
14647,10,1406,9,186,95,91,2,31,1,1
14312,10,0,0,219,86,133,2,29,1,1
15227,10,3866,9,177,94,83,2,30,1,1
15421,10,18824,9,196,102,94,2,30,1,1
15997,26,23342,16,9774,3034,6740,29,19,14,15
7402,26,12072,16,190,70,120,4,15,2,2
14230,1011,5692,745,504,318,186,8,15,5,3
8584,1238,24460,918,244,78,166,2,30,1,1
10614,26,19980,16,400,70,330,6,25,1,5
18193,26,21286,16,9766,3290,6476,40,57,20,20
7068,10,19506,9,213,79,134,2,32,1,1
21970,183,28793,121,3413,1458,1955,16,18,8,8
14443,15,41,11,1052,612,440,10,16,5,5
16958,26,27519,16,7509,1262,6247,22,16,12,10
8653,10,2476,9,182,93,89,2,30,1,1
16922,10,25950,9,217,82,135,2,32,1,1
9403,183,21884,121,3473,1518,1955,17,18,9,8
21578,10,7817,9,195,102,93,2,30,1,1
5674,26,15045,16,12022,2731,9291,53,20,26,27
21659,10,1165,9,193,102,91,2,30,1,1
5865,26,11895,16,108842,88940,19902,313,255,159,154
8938,10,26924,9,178,91,87,2,30,1,1
5750,26,17596,16,4380,1473,2907,19,26,11,8
9629,26,9439,16,6028,2012,4016,25,16,14,11
21350,44,6914,27,66,66,0,2,7,2,0
8595,26,14378,16,8861,3484,5377,19,120,9,10
8604,26,24878,16,13740,5392,8348,35,134,18,17
8680,10,23227,9,749,94,655,2,30,1,1
14611,10,26800,9,178,94,84,2,29,1,1
14810,10,13187,9,177,94,83,2,29,1,1
14713,10,24764,9,233,91,142,2,30,1,1
15307,26,9827,16,7855,1866,5989,20,15,11,9
4138,26,15361,16,4378,1471,2907,19,27,11,8
8605,10,27929,9,194,99,95,2,31,1,1
14541,10,18044,9,294,118,176,2,29,1,1
11507,15,24957,11,3951,3437,514,13,15,8,5
1310,10,4386,9,216,90,126,2,30,1,1
18298,15,14059,11,17923,13519,4404,41,151,26,15
15195,10,18875,9,762,98,664,2,30,1,1
4660,26,9018,16,11777,4005,7772,35,44,15,20
21008,3033,5802,2358,504,382,122,8,15,6,2
9687,26,4546,16,11275,4454,6821,24,36,13,11
2744,1238,4450,918,881,126,755,2,30,1,1
15988,10,25378,9,247,98,149,2,34,1,1
20418,40,8646,23,134,60,74,3,11,2,1
16111,26,11527,16,39421,4980,34441,57,144,23,34
21313,10,27626,9,183,94,89,2,29,1,1
9545,26,28081,16,256,136,120,5,9,3,2
8425,10,3579,9,228,102,126,2,30,1,1
4765,26,26240,16,16925,11562,5363,36,363,19,17
8935,26,306,16,13455,1982,11473,29,31,16,13
22414,10,2270,9,196,102,94,2,31,1,1
5659,26,5300,16,130,70,60,3,5,2,1
3515,26,22367,16,4610,918,3692,15,135,7,8
22337,10,15287,9,168,86,82,2,30,1,1
12165,15,23357,11,42664,1998,40666,53,27,20,33
21808,10,13525,9,193,102,91,2,31,1,1
5624,26,6100,16,70,70,0,1,5,1,0
15942,10,18214,9,177,94,83,2,30,1,1
22589,10,28550,9,214,110,104,2,30,1,1
1680,26,6095,16,214215,11945,202270,260,94,110,150
12822,2925,564,2270,70,70,0,1,5,1,0
15304,10,25050,9,229,89,140,2,31,1,1
14685,10,1017,9,172,94,78,2,29,1,1
7952,26,20821,16,4564,1657,2907,19,27,11,8
12343,26,23902,16,3155,2234,921,15,16,8,7
14531,10,28681,9,177,94,83,2,29,1,1
22420,10,18399,9,245,94,151,2,30,1,1
18140,26,15236,16,17161,1619,15542,18,151,4,14
1029,26,26686,16,4702,674,4028,15,15,8,7
8590,10,13764,9,100,100,0,1,0,1,0
14746,10,2401,9,742,88,654,2,31,1,1
14974,10,26540,9,197,94,103,2,30,1,1
13868,10,28075,9,181,94,87,2,29,1,1
17166,26,15040,16,5166,700,4466,16,15,7,9
15362,26,2702,16,7877,1888,5989,20,15,11,9
15405,10,10581,9,195,102,93,2,29,1,1
15391,10,19430,9,754,94,660,2,31,1,1
8948,26,27961,16,70,70,0,1,5,1,0
7137,26,11558,16,26444,2671,23773,52,363,25,27
15297,15,28162,11,41658,23230,18428,114,798,66,48
9050,295,21710,190,1236,676,560,13,15,7,6
3455,10,8236,9,168,78,90,2,29,1,1
12311,26,12751,16,30688,2660,28028,51,31,23,28
18820,26,12365,16,7983,4398,3585,17,121,8,9
18633,10,8389,9,181,86,95,2,30,1,1
8354,153,23271,108,70,70,0,1,5,1,0
6347,26,2491,16,10221,3259,6962,36,120,18,18
11244,1325,28344,1001,70,70,0,1,5,1,0
6167,234,29145,149,3467,1977,1490,29,3742,14,15
12640,10,11686,9,260,86,174,2,30,1,1
5606,1986,24089,1516,140,78,62,2,31,1,1
14820,10,9357,9,779,86,693,2,30,1,1
14286,26,24526,16,26504,10384,16120,58,48,37,21
17174,26,4984,16,10630,6981,3649,31,17,17,14
4152,26,25742,16,5196,1875,3321,45,5922,12,33
14047,10,23216,9,212,102,110,2,30,1,1
8985,18,21669,13,184,94,90,2,30,1,1
4939,26,21290,16,448,78,370,6,25,1,5
13775,10,7470,9,193,102,91,2,30,1,1
225,10,12696,9,204,118,86,2,31,1,1
5193,26,16743,16,36313,5931,30382,72,108,36,36
7105,26,19567,16,5329,2082,3247,22,40,13,9
6250,2013,9912,1543,588,86,502,2,30,1,1
11021,2920,27143,2266,316,136,180,6,7,3,3
14250,10,24503,9,235,98,137,2,30,1,1
21396,26,28695,16,1411,852,559,13,24,7,6
7073,26,20136,16,6084,1723,4361,23,201,13,10
8365,10,7797,9,164,78,86,2,31,1,1
9150,10,16270,9,312,93,219,4,37,2,2
2347,10,9671,9,235,90,145,2,33,1,1
12446,559,1731,375,70,70,0,1,5,1,0
8953,10,19615,9,196,94,102,2,30,1,1
9085,26,25129,16,11831,1466,10365,24,135,11,13
4462,26,3161,16,280,140,140,5,130,3,2
17286,26,2360,16,3049,1857,1192,20,21,9,11
8956,10,3257,9,229,110,119,2,30,1,1
10866,1878,6272,1434,70,70,0,2,7,2,0
10895,662,11313,463,70,70,0,2,7,2,0
10940,3070,18472,2385,66,66,0,1,5,1,0
4834,26,13121,16,10229,2777,7452,30,361,15,15
9194,10,23581,9,178,91,87,2,31,1,1
10255,26,22348,16,261206,9686,251520,308,128,121,187
10840,26,22666,16,1536,856,680,14,27,6,8
14599,15,18151,11,57401,3150,54251,84,109,43,41
10327,2249,4498,1741,481,150,331,2,1200,1,1
14078,26,24419,16,4423,1516,2907,19,30,11,8
636,1849,20463,1409,502,150,352,2,1199,1,1
14955,10,3853,9,212,102,110,2,30,1,1
21631,10,20565,9,196,100,96,2,30,1,1
13627,10,21726,9,811,94,717,2,29,1,1
14316,10,12581,9,183,94,89,2,31,1,1
12812,1189,20558,878,70,70,0,1,4,1,0
17597,26,26126,16,3010,1892,1118,16,15,8,8
16320,26,23080,16,15844,1691,14153,18,138,5,13
9058,26,8094,16,7418,2721,4697,23,20,12,11
5970,26,12625,16,13059,5161,7898,34,84,19,15
22019,10,23882,9,182,93,89,2,30,1,1
8385,10,5022,9,195,102,93,2,31,1,1
15186,10,5063,9,177,94,83,2,29,1,1
8484,10,2915,9,657,187,470,6,72,3,3
15320,10,21782,9,900,110,790,2,30,1,1
0,0,0,0,244,244,0,2,0,2,0
15139,10,25035,9,177,94,83,2,30,1,1
8508,26,17636,16,484,210,274,8,135,4,4
11037,15,18128,11,83736,4405,79331,114,19,48,66
4120,10,21185,9,199,94,105,2,30,1,1
22412,10,16276,9,166,86,80,2,31,1,1
10720,10,14584,9,198,86,112,2,30,1,1
9322,10,15192,9,223,78,145,2,30,1,1
16021,280,27867,177,150,150,0,1,1200,1,0
3792,10,14818,9,197,90,107,2,30,1,1
21813,26,21219,16,9150,2109,7041,27,32,15,12
517,6,1882,6,66,66,0,1,4,1,0
14935,10,19166,9,182,102,80,2,29,1,1
12998,26,6652,16,499,425,74,4,0,3,1
2843,15,11705,11,12281469,369857,11911612,13837,31,5536,8301
7040,26,11584,16,46323,1563,44760,49,30,15,34
9867,26,28306,16,3171,1369,1802,9,120,5,4
12801,727,22653,520,70,70,0,1,4,1,0
9588,15,1005,11,378,192,186,7,19,4,3
15197,26,22190,16,8302,3583,4719,24,17,14,10
14924,10,11529,9,733,93,640,2,31,1,1
8586,10,10970,9,364,102,262,2,30,1,1
21038,2044,816,1571,70,70,0,1,5,1,0
21815,10,17409,9,210,110,100,2,30,1,1
11057,2541,9892,1975,70,70,0,1,4,1,0
12134,26,11131,16,7705,2005,5700,26,120,13,13
14301,2807,22999,2178,316,190,126,5,15,3,2
16141,26,18191,16,2614,1689,925,18,20,10,8
14474,10,11678,9,182,102,80,2,30,1,1
4835,2805,7070,2176,158,158,0,1,1200,1,0
18355,10,10684,9,199,94,105,2,29,1,1
11195,26,7945,16,289596,9131,280465,283,48,85,198
12366,26,17605,16,130,70,60,2,14,1,1
1695,26,6173,16,21083,3108,17975,45,80,24,21
9062,10,16395,9,184,94,90,2,31,1,1
751,7,3034,7,130,66,64,2,5,1,1
15966,26,8943,16,7435,2697,4738,23,30,13,10
991,26,9280,16,3837,488,3349,15,15,7,8
22428,10,12204,9,200,102,98,2,30,1,1
9639,10,20425,9,195,102,93,2,30,1,1
19714,26,10020,16,3663,1097,2566,13,136,6,7
4726,26,5312,16,32391,21443,10948,69,47,41,28
13810,10,28902,9,177,94,83,2,30,1,1
6776,10,19049,9,197,76,121,2,30,1,1
21652,10,11593,9,250,102,148,2,30,1,1
9237,10,24557,9,177,94,83,2,29,1,1
12122,26,23334,16,4114,2535,1579,25,139,13,12
9142,10,23935,9,760,97,663,2,31,1,1
15358,26,11982,16,7904,1915,5989,20,16,11,9
12742,2831,1447,2198,70,70,0,2,8,2,0
2744,1240,17372,920,891,126,765,2,30,1,1
15812,26,23494,16,4769,2622,2147,14,135,7,7
17258,15,23804,11,1674,1360,314,11,15,6,5
11170,2714,20078,2108,70,70,0,1,5,1,0
878,15,8169,11,326320,11951,314369,346,36,122,224
14129,15,5882,11,188544,9826,178718,241,32,113,128
22056,10,9934,9,338,110,228,2,30,1,1
532,247,0,0,3562,1936,1626,48,193,24,24
12634,26,21128,16,499,425,74,4,0,3,1
11589,26,21058,16,8993,5205,3788,48,167,25,23
9824,26,15545,16,2993,866,2127,10,120,5,5
16109,26,1029,16,707158,36853,670305,902,148,310,592
11717,26,14538,16,8160,2216,5944,22,38,14,8
7446,1180,23742,870,134,64,70,2,10,1,1
11336,233,1926,148,6070,1779,4291,17,3600,8,9
22614,26,6695,16,5854,1796,4058,21,142,10,11
8315,26,13987,16,2595,1230,1365,18,16,9,9
8424,10,19021,9,579,181,398,6,84,3,3
15679,10,19436,9,728,102,626,2,30,1,1
18178,26,1967,16,1000,557,443,11,141,6,5
8584,1238,3025,918,295,78,217,2,31,1,1
8174,26,19162,16,232,172,60,3,5,2,1
15612,10,19257,9,174,89,85,2,31,1,1
15851,26,15522,16,5614,733,4881,16,15,9,7
14905,10,7928,9,209,110,99,2,29,1,1
19995,26,13216,16,21361086,218978,21142108,16512,170,2203,14309
8874,26,934,16,7772,2563,5209,18,121,9,9
21284,10,26420,9,402,125,277,4,37,2,2
20542,10,15425,9,384,166,218,2,30,1,1
22599,10,21618,9,817,98,719,2,30,1,1
9353,10,9643,9,166,86,80,2,30,1,1
12437,1554,15975,1185,320,140,180,6,6,3,3
3437,15,25869,11,9105,1930,7175,18,16,9,9
8801,10,26458,9,210,110,100,2,30,1,1
6337,26,23280,16,3857,2757,1100,27,22,14,13
8823,26,986,16,6181,833,5348,19,52,9,10
11007,26,2036,16,2497,1528,969,22,46,13,9
3463,26,21317,16,146684,25233,121451,183,189,75,108
22538,10,11037,9,782,105,677,2,31,1,1
13645,26,28745,16,15109,5866,9243,71,362,29,42
9741,26,13165,16,8031,1915,6116,24,17,12,12
14087,10,4287,9,193,102,91,2,29,1,1
14397,10,9411,9,177,94,83,2,30,1,1
9684,15,23415,11,2175,1539,636,13,27,8,5
21990,26,28803,16,4507,1600,2907,19,31,11,8
13048,26,16168,16,499,425,74,4,0,3,1
16021,2371,13024,1844,527,166,361,2,1200,1,1
9534,15,21312,11,360,180,180,7,26,4,3
9091,15,15220,11,1126,609,517,11,15,6,5
576,10,18077,9,323,94,229,2,30,1,1
11696,10,0,0,641,87,554,2,30,1,1
9084,15,22299,11,3649288,78688,3570600,2923,179,528,2395
3083,10,12893,9,235,90,145,2,33,1,1
8383,10,13479,9,789,110,679,2,29,1,1
11231,26,1144,16,5681,1441,4240,21,51,11,10
12608,882,18160,651,70,70,0,2,8,2,0
22258,10,18032,9,184,94,90,2,29,1,1
7981,26,20531,16,138,78,60,2,5,1,1
14457,26,26589,16,39628,2279,37349,63,255,23,40
14111,10,9584,9,784,94,690,2,30,1,1
15535,15,21457,11,8730,5681,3049,21,31,12,9
15869,26,1641,16,134,60,74,3,5,2,1
9077,10,21066,9,493,94,399,4,40,2,2
2744,1240,23362,920,900,126,774,2,31,1,1
3897,232,4548,147,8140,2222,5918,42,201,22,20
22217,10,28055,9,994,86,908,2,30,1,1
21469,10,17032,9,327,88,239,4,52,2,2
15958,26,4213,16,6649,1556,5093,23,21,13,10
14726,10,7263,9,238,87,151,2,30,1,1
11343,26,27007,16,295493,16052,279441,394,68,186,208
15524,26,10726,16,4679,2071,2608,14,135,7,7
21913,10,20841,9,214,102,112,2,29,1,1
15368,671,3925,472,264,70,194,4,19,1,3
21035,291,12234,187,70,70,0,1,5,1,0
3291,26,25411,16,3166,936,2230,18,120,9,9
14008,10,9699,9,711,87,624,2,30,1,1
17112,26,9323,16,5167,700,4467,16,15,7,9
22080,10,15081,9,184,86,98,2,30,1,1
21574,10,769,9,193,102,91,2,30,1,1
15211,10,8009,9,302,86,216,2,30,1,1
5143,232,9039,147,6262,2015,4247,35,48,17,18
11406,26,19920,16,227267,18022,209245,424,38,239,185
21526,10,11296,9,180,94,86,2,35,1,1
18374,26,7316,16,130,70,60,3,5,2,1
22159,10,9796,9,275,96,179,4,41,2,2
4737,26,9986,16,3226,2225,1001,18,46,11,7
22002,10,24569,9,186,95,91,2,31,1,1
21175,2620,19304,2031,312,132,180,6,7,3,3
12349,26,23477,16,960,539,421,9,35,5,4
11998,296,6699,191,512,326,186,9,22,6,3
9728,2628,15546,2038,475,150,325,2,1200,1,1
16477,26,12659,16,8075,4109,3966,42,91,19,23
14715,26,10975,16,551795,18805,532990,603,43,220,383
10343,26,26939,16,8083,2502,5581,40,16,22,18
8373,547,13835,364,70,70,0,2,8,2,0
6214,26,18914,16,10165,2433,7732,19,49,10,9
22607,26,12815,16,3219,2242,977,19,25,9,10
22007,15,19549,11,2107,1131,976,13,97,7,6
22258,10,22296,9,184,94,90,2,30,1,1
16447,26,2754,16,3182,1568,1614,8,120,4,4
8735,10,7260,9,213,94,119,2,30,1,1
8378,10,15375,9,484,100,384,4,56,2,2
22634,10,9966,9,172,94,78,2,30,1,1
3133,2343,16136,1827,462,462,0,8,3632,8,0
21661,10,23622,9,211,94,117,2,30,1,1
21403,10,21890,9,606,182,424,6,71,3,3
16618,26,25779,16,4381,1474,2907,19,29,11,8
15701,26,26495,16,70379,4205,66174,101,403,51,50
22662,26,22425,16,91831,4379,87452,101,15,37,64
9454,10,23045,9,816,102,714,2,29,1,1
15595,26,8657,16,4228,1470,2758,19,131,9,10
5521,26,18743,16,10727,3308,7419,33,503,15,18
7269,10,19795,9,507,129,378,2,30,1,1
15037,10,20597,9,196,102,94,2,30,1,1
6250,2007,1117,1537,148,86,62,2,29,1,1
22444,10,3675,9,179,94,85,2,29,1,1
15814,15,13859,11,1369,495,874,12,361,6,6
6383,26,16372,16,10114,3154,6960,27,20,16,11
15953,10,10310,9,183,94,89,2,30,1,1
8409,10,22705,9,183,94,89,2,30,1,1
22009,10,5344,9,299,101,198,4,34,2,2
20273,26,20476,16,5718309,117049,5601260,5287,155,1390,3897
11175,15,21934,11,366,240,126,7,32,5,2
8932,26,9066,16,12026,1450,10576,27,127,12,15
5874,26,17790,16,4713,1806,2907,19,30,11,8
11472,26,1512,16,12863,8410,4453,22,31,13,9
11148,1669,14450,1277,70,70,0,1,5,1,0
22218,10,10475,9,180,86,94,2,30,1,1
6890,18,4526,13,184,94,90,2,30,1,1
15588,15,10145,11,214,140,74,4,31,3,1
4835,1059,26986,779,537,158,379,2,1199,1,1
9506,10,14215,9,214,110,104,2,29,1,1
11931,26,12234,16,2399,1799,600,15,120,10,5
2744,1238,20010,918,875,126,749,2,30,1,1
2766,10,11425,9,208,94,114,2,30,1,1
17794,26,14489,16,5433,925,4508,19,360,10,9
14464,26,17637,16,6881,2073,4808,37,255,18,19
13036,26,9440,16,499,425,74,4,0,3,1
12724,2482,27017,1930,70,70,0,2,7,2,0
10844,2835,12400,2201,70,70,0,1,4,1,0
14181,10,12369,9,176,90,86,2,30,1,1
18148,26,14115,16,3190,1599,1591,17,142,9,8
8413,26,4564,16,29705,9203,20502,41,18,21,20
2863,2008,10923,1538,140,78,62,2,30,1,1
12858,26,21685,16,7653,1188,6465,21,16,12,9
4168,26,27588,16,9667,4709,4958,27,88,14,13
10250,15,5332,11,366,240,126,7,21,5,2
16501,26,25701,16,4682,1775,2907,19,29,11,8
14158,15,5438,11,20513,1960,18553,39,21,18,21
5125,26,21376,16,130,70,60,2,14,1,1
18823,1989,15269,1519,316,136,180,6,6,3,3
19562,26,4237,16,168812,5693,163119,186,21,68,118
14025,10,26728,9,170,87,83,2,31,1,1
7102,10,19564,9,236,108,128,2,31,1,1
21777,10,15995,9,762,97,665,2,30,1,1
13703,234,4201,149,9193,2770,6423,51,5193,28,23
8568,26,26583,16,7965,4044,3921,63,464,30,33
901,26,10287,16,16023,3677,12346,42,37,21,21
8348,26,3825,16,50097,3666,46431,79,256,36,43
17025,26,10490,16,9279,5062,4217,56,259,25,31
11224,26,16510,16,12374,1090,11284,27,15,13,14
22498,10,16252,9,190,97,93,2,30,1,1
17995,26,2591,16,1576,973,603,14,28,7,7
10825,3058,12170,2374,70,70,0,1,5,1,0
6985,10,12653,9,179,86,93,2,29,1,1
11016,26,23066,16,7567,3038,4529,35,15,21,14
16318,15,25591,11,2106,1657,449,10,20,6,4
22719,10,702,9,102,102,0,1,30,1,0
20144,18,9123,13,184,94,90,2,31,1,1
22562,10,241,9,199,102,97,2,30,1,1
15229,10,26268,9,202,103,99,2,31,1,1
19326,26,764,16,1401,940,461,11,28,7,4
15422,10,25859,9,252,102,150,2,30,1,1
17891,26,7126,16,846,420,426,15,29,8,7
13511,26,10325,16,6296,1556,4740,22,16,12,10
13829,10,22823,9,177,94,83,2,30,1,1
14222,10,12197,9,168,78,90,2,30,1,1
11667,26,10889,16,8040,2587,5453,39,16,23,16
5004,26,16543,16,33734,3007,30727,53,90,29,24
15735,10,18232,9,216,110,106,2,31,1,1
14301,10,17790,9,179,94,85,2,30,1,1
14292,10,19479,9,190,97,93,2,30,1,1
17601,26,21309,16,10726,4848,5878,79,588,40,39
9127,10,12932,9,279,96,183,4,58,2,2
21254,15,15238,11,314,192,122,6,15,4,2
8628,10,4110,9,86,86,0,1,30,1,0
8369,10,26127,9,295,86,209,2,30,1,1
9588,10,11488,9,256,93,163,2,31,1,1
15888,10,12732,9,172,94,78,2,30,1,1
7793,26,21278,16,8263,2100,6163,34,255,16,18
22702,10,15084,9,190,97,93,2,31,1,1
5559,15,4636,11,1112,534,578,12,16,7,5
14375,10,25530,9,194,102,92,2,31,1,1
15016,10,3873,9,749,94,655,2,30,1,1
12676,676,409,475,130,70,60,2,5,1,1
10366,2447,26378,1900,70,70,0,2,8,2,0
1064,26,122,16,6100,777,5323,17,25,9,8
14013,10,17342,9,222,102,120,2,30,1,1
12122,26,17494,16,47830,23388,24442,74,51,37,37
18860,26,4879,16,8201,2795,5406,43,18,26,17
8942,10,24744,9,180,92,88,2,30,1,1
9354,15,6220,11,4020,1978,2042,16,66,9,7
22335,10,11632,9,213,102,111,2,30,1,1
8613,10,10529,9,248,102,146,2,29,1,1
9722,26,5091,16,13595,7140,6455,39,116,24,15
19954,26,8371,16,18482489,568378,17914111,19386,214,6466,12920
22034,738,25590,529,556,256,300,10,30,5,5
21383,10,17975,9,296,126,170,2,30,1,1
16249,676,19746,475,130,70,60,2,5,1,1
7772,26,17718,16,6318,1025,5293,17,35,9,8
15618,10,13616,9,198,94,104,2,31,1,1
21945,10,24113,9,196,102,94,2,30,1,1
19211,26,27206,16,5014,1722,3292,17,18,10,7
5090,26,27167,16,7031,1824,5207,23,60,12,11
15186,15,3430,11,1114,534,580,12,16,7,5
10101,190,19306,125,409,107,302,4,30,2,2
14071,10,7135,9,1335,87,1248,4,38,2,2
21817,10,5300,9,167,86,81,2,30,1,1
6717,26,11853,16,6017,1285,4732,18,984,8,10
8379,10,16360,9,183,94,89,2,29,1,1
14183,26,27886,16,6639,3918,2721,16,135,8,8
2744,1238,13243,918,939,126,813,2,30,1,1
8700,10,7203,9,315,84,231,4,40,2,2
14402,10,23087,9,216,110,106,2,30,1,1
12560,26,16816,16,11338,7078,4260,19,16,12,7
10261,26,15271,16,4332,1907,2425,18,136,8,10
9199,10,29051,9,195,102,93,2,31,1,1
10839,26,22665,16,1466,856,610,13,27,6,7
13700,15,4057,11,2775,1332,1443,12,34,7,5
12031,26,22997,16,37389,3972,33417,69,133,32,37
14000,10,17145,9,195,102,93,2,30,1,1
13991,10,22226,9,311,86,225,4,55,2,2
17852,26,28018,16,7310,967,6343,18,25,10,8
10641,26,6257,16,2911,2062,849,14,134,8,6
9030,26,2473,16,7128,865,6263,19,87,9,10
7542,10,11772,9,168,78,90,2,30,1,1
22617,15,12140,11,65980,5156,60824,86,23,39,47
9419,10,11448,9,718,94,624,2,30,1,1
7614,26,20309,16,22215,2460,19755,39,198,15,24
15853,10,4865,9,200,102,98,2,31,1,1
21315,10,1411,9,321,102,219,2,30,1,1
15816,10,12239,9,167,86,81,2,29,1,1
6583,26,13413,16,6392,1099,5293,18,33,10,8
13697,15,8832,11,306,180,126,6,34,4,2
21977,10,14020,9,186,102,84,2,30,1,1
8370,10,11049,9,240,94,146,2,29,1,1
16292,26,8069,16,37181,32491,4690,93,81,54,39
22093,10,20345,9,164,84,80,2,30,1,1
12157,26,7303,16,22541,2143,20398,38,322,16,22
9792,15,24487,11,132,132,0,2,8,2,0
15866,10,3280,9,197,102,95,2,30,1,1
15287,10,20612,9,177,94,83,2,30,1,1
7402,26,16725,16,67265,57889,9376,174,102,98,76
8090,349,8131,222,234,234,0,4,11,4,0
1569,26,7185,16,7356,1014,6342,20,75,10,10
11092,3063,9385,2378,70,70,0,1,5,1,0
13622,10,18739,9,199,102,97,2,30,1,1
18498,15,5622,11,5518,527,4991,13,75,6,7
12130,26,5026,16,6058,1038,5020,20,69,11,9
10880,534,27134,354,316,136,180,6,7,3,3
9605,26,5419,16,78333,12774,65559,140,128,59,81
10669,15,26396,11,378,192,186,7,39,4,3
21400,10,11341,9,199,102,97,2,30,1,1
22575,10,15131,9,197,102,95,2,33,1,1
14212,10,16581,9,177,94,83,2,29,1,1
15645,10,17982,9,443,182,261,6,31,3,3
8604,26,24777,16,180,60,120,4,15,2,2
4657,26,27416,16,499,425,74,4,0,3,1
21683,10,937,9,199,102,97,2,30,1,1
20506,10,14935,9,304,86,218,2,30,1,1
15933,26,17586,16,7211,823,6388,16,15,10,6
20160,26,17884,16,54095,6413,47682,151,450,61,90
921,26,23143,16,6331,837,5494,19,28,10,9
11295,1570,15040,1201,70,70,0,2,7,2,0
11406,26,26204,16,10506,2063,8443,31,46,17,14
19263,26,8089,16,7653,1226,6427,24,18,14,10
14716,10,11195,9,338,110,228,2,30,1,1
20574,26,13022,16,8848,3081,5767,56,335,26,30
20925,26,24896,16,123421,11745,111676,267,125,108,159
15186,10,26507,9,181,94,87,2,31,1,1
22060,10,7092,9,802,104,698,2,31,1,1
15981,26,14333,16,130,70,60,2,15,1,1
7540,26,20204,16,30701,1538,29163,40,16,14,26
21398,26,25069,16,1411,852,559,13,25,7,6
6069,26,5831,16,4636,792,3844,16,15,8,8
18903,305,8082,199,2875,449,2426,12,16,7,5
15026,10,26186,9,758,96,662,2,31,1,1
22595,10,20592,9,334,226,108,3,29,2,1
17164,26,5739,16,5167,700,4467,16,15,7,9
3283,26,14930,16,23467,16522,6945,51,161,29,22
9784,26,2804,16,1533,950,583,14,85,8,6
22052,10,27985,9,167,86,81,2,30,1,1
22286,10,20966,9,339,110,229,2,29,1,1
22126,10,11588,9,183,94,89,2,30,1,1
8684,15,27927,11,11011,7675,3336,21,26,11,10
9797,15,14139,11,124643,7017,117626,163,21,75,88
17588,26,473,16,105190,30835,74355,372,589,169,203
14288,2131,27265,1644,1717,1129,588,17,25,10,7
5830,26,21669,16,8705,3570,5135,35,100,20,15
8493,10,27865,9,193,102,91,2,30,1,1
19999,26,10268,16,3244,1630,1614,8,120,4,4
14681,10,20292,9,186,102,84,2,29,1,1
9456,26,446,16,133674,20935,112739,206,350,105,101
9187,10,16519,9,164,84,80,2,31,1,1
636,280,12898,177,238,118,120,2,1199,1,1
21293,10,21981,9,183,94,89,2,30,1,1
7367,15,517,11,2684,2550,134,7,17,5,2
11042,26,2079,16,126,60,66,3,10,2,1
13740,10,11178,9,183,94,89,2,30,1,1
10494,26,4563,16,194,70,124,3,11,1,2
13936,10,6227,9,274,94,180,2,30,1,1
12481,26,12533,16,2090,1100,990,17,119,9,8
6003,26,24437,16,234,234,0,4,12,4,0
4537,10,15991,9,216,90,126,2,30,1,1
10680,15,24973,11,378,192,186,7,38,4,3
14000,10,9102,9,195,102,93,2,29,1,1
8496,10,3414,9,258,102,156,2,30,1,1
8980,10,1039,9,789,110,679,2,31,1,1
8508,26,2449,16,6882,1788,5094,15,16,9,6
19319,26,15505,16,1119,589,530,12,28,6,6
15622,10,4343,9,354,90,264,4,50,2,2
11185,15,23118,11,366,240,126,7,32,5,2
22264,10,6879,9,168,94,74,2,30,1,1
12065,3004,26215,2335,70,70,0,2,8,2,0
7066,26,4195,16,33865,6559,27306,67,67,34,33
11331,15,22902,11,450,246,204,8,29,5,3
15139,10,15189,9,177,94,83,2,29,1,1
18466,26,956,16,5567,1589,3978,20,80,11,9
22447,10,5917,9,1579,94,1485,4,36,2,2
3783,15,14783,11,22098,1602,20496,24,57,6,18
1731,2139,17495,1652,1367,664,703,16,1200,9,7
8110,15,21037,11,19738,890,18848,25,20,9,16
6088,26,16245,16,34237,22442,11795,86,131,41,45
12988,26,28211,16,9283,2154,7129,22,15,12,10
13747,10,12003,9,194,102,92,2,30,1,1
4968,10,24839,9,168,78,90,2,30,1,1
12591,10,23362,9,578,286,292,9,16,5,4
5020,10,16570,9,214,82,132,2,32,1,1
10850,2748,22327,2129,66,66,0,2,8,2,0
14492,2132,8384,1645,481,150,331,2,1200,1,1
15690,10,27504,9,193,102,91,2,31,1,1
6021,26,21274,16,9488,2196,7292,25,26,14,11
9537,15,10691,11,366,180,186,7,26,4,3
12628,1,18417,1,70,70,0,1,5,1,0
6999,1533,7463,1167,150,150,0,1,1200,1,0
21683,10,15641,9,359,134,225,2,30,1,1
1647,26,8376,16,2629,1470,1159,18,15,8,10
8691,15,2835,11,454,262,192,8,38,5,3
8786,26,11608,16,13241,2865,10376,60,242,26,34
532,247,0,0,3354,1792,1562,46,194,23,23
14017,10,12807,9,256,93,163,2,31,1,1
2641,15,11094,11,490,264,226,8,32,5,3
13627,10,5745,9,181,94,87,2,30,1,1
20413,40,21416,23,9285,4057,5228,80,45,39,41
8915,10,456,9,200,102,98,2,30,1,1
19324,26,25727,16,9504,3379,6125,28,77,15,13
6175,26,8855,16,377544,10569,366975,414,221,152,262
16021,2052,15468,1578,132,132,0,3,1199,3,0
10992,26,26911,16,8600,1735,6865,27,25,14,13
14168,10,6096,9,195,102,93,2,30,1,1
17865,26,24751,16,1991,1190,801,21,32,11,10
15137,10,25258,9,183,94,89,2,30,1,1
15529,10,12169,9,182,93,89,2,30,1,1
11498,15,18019,11,3224,2776,448,11,15,7,4
8414,10,2910,9,478,196,282,6,63,3,3
21232,10,15390,9,289,102,187,2,30,1,1
21631,26,14425,16,4838,1059,3779,16,54,8,8
13504,26,23294,16,16366,4160,12206,41,55,20,21
12711,26,6517,16,7797,1807,5990,15,135,7,8
16133,15,25289,11,1526,972,554,10,75,6,4
10888,2245,28697,1738,70,70,0,2,8,2,0
18388,26,2848,16,1743,1164,579,16,25,10,6
14349,10,10990,9,177,94,83,2,30,1,1
11262,1757,14866,1342,70,70,0,1,5,1,0
8953,10,17509,9,258,110,148,2,29,1,1
15526,10,6446,9,421,78,343,2,31,1,1
14668,10,2964,9,152,78,74,2,30,1,1
14238,10,25578,9,181,94,87,2,30,1,1
636,2865,7567,2224,226,118,108,2,1199,1,1
21989,10,26209,9,212,108,104,2,31,1,1
11043,1761,23210,1346,70,70,0,2,9,2,0
3779,26,12919,16,62652,30891,31761,158,381,67,91
9062,15,1906,11,1550,1157,393,8,86,5,3
12940,26,7430,16,170665,9296,161369,227,116,102,125
8392,10,9471,9,295,101,194,4,48,2,2
11107,2645,3229,2053,70,70,0,1,4,1,0
5885,26,24928,16,8805,1938,6867,21,17,12,9
13672,10,22084,9,179,94,85,2,30,1,1
10948,2086,23817,1608,70,70,0,2,8,2,0
8942,10,18940,9,182,94,88,2,29,1,1
12184,26,2419,16,5601,1187,4414,24,80,13,11
5006,15,16546,11,555104,4582,550522,446,20,60,386
15827,10,28699,9,200,102,98,2,30,1,1
14792,10,21232,9,749,94,655,2,30,1,1
16021,1,26355,1,132,132,0,3,1199,3,0
9908,15,22158,11,30767,854,29913,38,15,13,25
21545,10,23545,9,181,94,87,2,30,1,1
8641,10,24911,9,196,102,94,2,30,1,1
8479,10,3242,9,216,94,122,2,29,1,1
4767,26,419,16,6470,1931,4539,27,32,14,13
22374,10,18067,9,752,110,642,2,30,1,1
15050,10,24160,9,167,86,81,2,30,1,1
8910,10,14282,9,193,102,91,2,30,1,1
11068,15,11546,11,366,240,126,7,25,5,2
2585,15,10895,11,1798,540,1258,10,15,6,4
22594,10,4785,9,199,102,97,2,31,1,1
17867,26,14819,16,304,86,218,2,29,1,1
15891,10,6029,9,210,110,100,2,30,1,1
20599,15,25198,11,18055,904,17151,22,15,7,15
6068,26,16215,16,4570,792,3778,15,15,8,7
7725,26,16304,16,1053,566,487,10,43,6,4
5922,26,17396,16,7661,1115,6546,19,35,10,9
22272,10,19279,9,338,110,228,2,30,1,1
22420,10,2632,9,184,94,90,2,29,1,1
13720,10,7750,9,176,90,86,2,31,1,1
15331,10,20160,9,166,85,81,2,31,1,1
8654,10,24808,9,194,102,92,2,31,1,1
15663,10,22674,9,177,94,83,2,30,1,1
14547,10,5477,9,177,94,83,2,30,1,1
6024,15,9081,11,6003,691,5312,13,16,7,6
2797,15,13529,11,3943,1809,2134,21,82,11,10
16000,26,27684,16,7975,1742,6233,24,81,14,10
14854,10,28940,9,193,102,91,2,30,1,1
14804,10,1732,9,216,110,106,2,30,1,1
15524,10,13317,9,168,86,82,2,29,1,1
9153,10,5992,9,778,103,675,2,30,1,1
5792,10,17652,9,200,90,110,2,30,1,1
15197,10,13566,9,214,110,104,2,30,1,1
13804,10,18387,9,239,102,137,2,30,1,1
13557,26,21936,16,4600,2214,2386,13,134,7,6
3478,26,13259,16,9737,3353,6384,27,32,13,14
11969,26,3424,16,96850,6037,90813,150,177,55,95
22671,26,10155,16,92212,4799,87413,107,16,43,64
15820,10,4839,9,167,86,81,2,30,1,1
17878,10,21138,9,384,166,218,2,29,1,1
15358,10,2630,9,193,102,91,2,30,1,1
14776,10,15881,9,198,102,96,2,30,1,1
22487,10,2530,9,181,94,87,2,29,1,1
11583,15,24980,11,2820,1466,1354,20,534,11,9
6537,26,21715,16,1563663,41030,1522633,1538,40,479,1059
15087,10,11388,9,1164,93,1071,2,30,1,1
14155,10,20379,9,413,170,243,6,30,3,3
15162,10,2695,9,177,94,83,2,30,1,1
13489,26,1338,16,9612,4324,5288,31,400,11,20
12674,676,9763,475,130,70,60,2,6,1,1
20276,26,20773,16,87797,47766,40031,754,453,303,451
11226,1156,8183,853,316,136,180,6,6,3,3
16021,1742,9142,1330,1914,1914,0,30,1766,30,0
22018,10,25710,9,184,94,90,2,30,1,1
4275,10,23742,9,200,86,114,2,30,1,1
15416,10,23897,9,177,94,83,2,29,1,1
14407,10,18763,9,245,94,151,2,29,1,1
10791,886,10545,655,70,70,0,1,5,1,0
19843,26,28277,16,4655,1649,3006,10,120,5,5
15905,26,9357,16,6250,1312,4938,23,315,12,11
8541,10,11130,9,199,94,105,2,30,1,1
14517,10,12816,9,264,110,154,2,30,1,1
12040,1747,20099,1334,698,320,378,10,17,6,4
16370,26,4550,16,7332,3746,3586,37,176,19,18
5335,15,27831,11,234,234,0,4,12,4,0
12175,15,3088,11,2881,1001,1880,12,52,7,5
8748,10,12537,9,168,78,90,2,30,1,1
21296,10,26141,9,267,94,173,2,30,1,1
12305,26,16153,16,10416,3195,7221,32,46,18,14
5762,15,2322,11,1155,781,374,10,16,6,4
9693,10,8907,9,199,94,105,2,30,1,1
4735,26,10563,16,3354,2353,1001,18,45,11,7
8985,10,14721,9,193,102,91,2,30,1,1
13671,26,13836,16,7627,2734,4893,26,16,15,11
15854,10,23130,9,242,102,140,2,30,1,1
19524,15,16514,11,4004,1513,2491,20,47,10,10
8813,15,20929,11,318,192,126,6,42,4,2
8442,295,21415,190,2163,676,1487,14,15,7,7
12398,10,23501,9,229,98,131,2,30,1,1
15206,15,8049,11,234,234,0,4,12,4,0
21348,10,16273,9,520,211,309,6,39,3,3
12639,280,15112,177,70,70,0,2,7,2,0
8705,10,19373,9,170,87,83,2,31,1,1
12084,26,20875,16,1462,965,497,13,18,7,6
15098,10,5735,9,757,98,659,2,30,1,1
15863,10,6190,9,177,94,83,2,31,1,1
9728,2878,3341,2236,1377,300,1077,6,1200,3,3
15849,26,16295,16,18591,5839,12752,78,18,44,34
9793,26,6970,16,15295,1755,13540,31,77,15,16
4258,26,19891,16,7768,3776,3992,21,132,11,10
2744,1245,15132,925,1654,126,1528,4,31,2,2
9728,2402,7196,1868,300,300,0,3,1200,3,0
16358,26,452,16,3981,1811,2170,26,177,14,12
17589,26,19579,16,1664,914,750,15,275,7,8
10943,26,22648,16,190,70,120,4,15,2,2
8732,26,29101,16,1394,540,854,24,36,10,14
12491,1541,5542,1174,744,618,126,10,28,8,2
14487,10,24500,9,177,94,83,2,30,1,1
969,26,26645,16,6135,770,5365,17,26,9,8
8602,26,22560,16,784271,38715,745556,1017,183,465,552
2961,15,12159,11,21270,2178,19092,35,29,15,20
16449,15,1679,11,10247,3696,6551,32,33,16,16
15273,26,7990,16,106055,8460,97595,168,26,79,89
22344,10,8273,9,216,110,106,2,31,1,1
8330,1798,20887,1371,5990,5698,292,17,51,14,3
4874,26,28367,16,911697,74083,837614,1247,343,459,788
13038,26,8746,16,499,425,74,4,0,3,1
2863,1981,25894,1511,144,82,62,2,31,1,1
10235,15,11106,11,5040,3914,1126,19,32,12,7
8656,26,25831,16,1627,884,743,12,27,6,6
636,287,7700,184,221,111,110,2,1200,1,1
21528,10,24639,9,679,179,500,6,69,3,3
4389,26,1601,16,21563,17259,4304,70,78,37,33
636,1918,11551,1464,221,111,110,2,1200,1,1
21255,1136,20651,837,70,70,0,1,5,1,0
15954,10,4193,9,770,102,668,2,31,1,1
3393,26,18926,16,7375,4769,2606,24,16,14,10
15060,15,23594,11,180583,6825,173758,188,136,68,120
15240,10,6151,9,223,86,137,2,30,1,1
22455,10,29022,9,176,78,98,2,30,1,1
21202,1089,2315,799,312,132,180,6,7,3,3
8611,26,9186,16,462587,17396,445191,527,130,198,329
11657,10,6333,9,164,78,86,2,30,1,1
11203,2242,2399,1735,156,66,90,2,5,1,1
13652,10,13945,9,195,102,93,2,29,1,1
18555,2825,25252,2192,320,140,180,6,7,3,3
22400,10,5776,9,177,86,91,2,30,1,1
7149,26,12621,16,9284,2430,6854,25,82,14,11
15003,10,9086,9,177,94,83,2,30,1,1
2744,1238,25792,918,901,126,775,2,30,1,1
13842,26,41,16,13568,2119,11449,35,316,17,18
636,280,1180,177,237,118,119,2,1200,1,1
14861,10,12311,9,177,94,83,2,29,1,1
5079,26,4664,16,1468,893,575,15,62,8,7
2744,1248,11589,928,895,126,769,2,30,1,1
13094,26,8332,16,13053,5216,7837,25,135,11,14
9844,15,3059,11,142,142,0,1,5,1,0
22167,10,4469,9,761,100,661,2,0,1,1
21213,3169,2023,2455,436,254,182,7,15,4,3
22273,10,25690,9,209,110,99,2,30,1,1
14686,10,7062,9,774,101,673,2,30,1,1
4387,26,17881,16,996,526,470,15,30,8,7
9403,10,5512,9,199,102,97,2,30,1,1
11118,26,5462,16,16165,3877,12288,53,186,25,28
20222,10,27833,9,414,268,146,3,32,2,1
14469,10,23986,9,195,102,93,2,30,1,1
5816,26,5513,16,12685,7319,5366,36,398,15,21
6936,10,19319,9,229,98,131,2,29,1,1
7594,15,20281,11,27124,1455,25669,41,15,20,21
4366,26,15747,16,4568,1661,2907,19,29,11,8
11008,15,11312,11,4612,3409,1203,14,25,9,5
15500,10,12055,9,183,94,89,2,29,1,1
17054,10,0,0,627,80,547,2,30,1,1
8584,1238,22391,918,274,78,196,2,30,1,1
7006,26,5853,16,1625,1038,587,14,27,8,6
12588,2627,8130,2037,70,70,0,1,5,1,0
8427,10,9776,9,199,86,113,2,30,1,1
9728,746,11284,537,1356,300,1056,6,1200,3,3
2637,15,11089,11,642,338,304,10,32,6,4
6094,10,18094,9,243,104,139,2,30,1,1
6103,232,11693,147,3823,1878,1945,39,309,22,17
14912,10,3891,9,271,95,176,4,48,2,2
12295,18,14531,13,184,94,90,2,30,1,1
12414,1136,13787,837,70,70,0,2,7,2,0
22392,10,8972,9,734,94,640,2,29,1,1
2863,1982,9310,1512,148,86,62,2,30,1,1
8519,10,22516,9,216,102,114,2,29,1,1
8806,26,24579,16,2809,1729,1080,18,80,10,8
8727,10,16902,9,754,94,660,2,30,1,1
17881,26,17538,16,304,86,218,2,30,1,1
15586,15,18892,11,5696,703,4993,14,75,8,6
636,3048,16633,2369,509,150,359,2,1199,1,1
13840,10,23228,9,190,97,93,2,31,1,1
13686,232,28393,147,138,64,74,3,5,2,1
22676,10,18047,9,210,110,100,2,29,1,1
10948,15,22762,11,426,240,186,8,29,5,3
12706,26,24922,16,499,425,74,4,1,3,1
15017,183,24919,121,3425,1470,1955,16,17,8,8
21877,10,19954,9,193,94,99,2,30,1,1
15413,10,7637,9,177,94,83,2,29,1,1
9363,15,21859,11,1723391,21750,1701641,1450,16,326,1124
15173,15,628,11,234,234,0,4,12,4,0
22529,10,24325,9,200,102,98,2,30,1,1
15585,15,5849,11,214,140,74,4,31,3,1
22251,10,10855,9,182,93,89,2,31,1,1
8960,10,5111,9,197,102,95,2,30,1,1
9411,1841,812,1402,490,150,340,2,1200,1,1
21985,10,8702,9,194,102,92,2,31,1,1
15239,26,9084,16,8005,1985,6020,20,15,11,9
21495,10,836,9,257,126,131,2,29,1,1
22429,10,22148,9,193,102,91,2,31,1,1
16332,329,25603,210,216,156,60,4,8,3,1
4030,26,5943,16,9592,2361,7231,25,15,14,11
11115,15,21630,11,360,240,120,7,25,5,2
20549,26,11231,16,304,86,218,2,31,1,1
6873,26,8581,16,5624,2556,3068,29,80,15,14
8900,10,9033,9,216,110,106,2,30,1,1
8584,1271,18342,951,272,78,194,2,30,1,1
9172,10,12640,9,186,95,91,2,30,1,1
4260,10,15570,9,197,90,107,2,30,1,1
9176,10,23975,9,208,106,102,2,30,1,1
6402,26,22741,16,25721,8999,16722,38,121,18,20
15341,26,5935,16,10137,4019,6118,42,8169,24,18
7635,676,7337,475,130,70,60,2,5,1,1
14174,183,24466,121,3657,1638,2019,20,18,11,9
966,26,120,16,6331,837,5494,19,26,10,9
13144,26,7673,16,23766,10707,13059,80,42,41,39
15615,10,24111,9,177,94,83,2,31,1,1
12780,2749,4679,2130,70,70,0,2,8,2,0
9592,26,11764,16,10382,3262,7120,30,142,16,14
6690,26,27372,16,1201,707,494,12,26,7,5
21573,10,22293,9,183,94,89,2,30,1,1
15329,661,18841,462,66,66,0,1,5,1,0
17095,26,12293,16,19700,12992,6708,44,18,23,21
361,10,1096,9,222,90,132,2,30,1,1
2289,10,9401,9,213,82,131,2,30,1,1
18603,10,2440,9,211,78,133,2,30,1,1
21814,26,27619,16,24682,1935,22747,36,19,17,19
16457,15,8924,11,48253,13664,34589,66,75,25,41
5142,26,13281,16,958865,18695,940170,908,16,266,642
8931,26,1903,16,11588,4383,7205,39,46,22,17
12046,1740,1142,1328,698,320,378,10,16,6,4
6250,1981,1070,1511,241,178,63,2,31,1,1
21415,10,3756,9,174,89,85,2,31,1,1
18586,26,26853,16,1088,641,447,10,26,6,4
15374,10,1305,9,353,94,259,2,30,1,1
11863,26,6001,16,15659,3294,12365,60,114,25,35
22147,10,4819,9,186,95,91,2,31,1,1
13557,26,25625,16,5541,3309,2232,19,61,11,8
7778,26,2992,16,16114,7882,8232,37,104,15,22
14088,10,27996,9,751,95,656,2,30,1,1
17960,10,11913,9,239,102,137,2,30,1,1
14574,10,26584,9,184,94,90,2,29,1,1
12617,26,12417,16,495,421,74,4,0,3,1
9808,26,28463,16,7767,1421,6346,20,15,8,12
21556,10,11698,9,164,84,80,2,31,1,1
18922,10,9206,9,268,86,182,2,30,1,1
18974,26,10536,16,134,60,74,3,6,2,1
8678,26,13554,16,7626,1741,5885,35,256,17,18
22523,10,23584,9,723,102,621,2,30,1,1
2172,1197,3120,885,480,149,331,2,1200,1,1
14254,3196,9899,2478,70,70,0,1,5,1,0
14363,10,11841,9,184,94,90,2,30,1,1
9302,26,5593,16,9915,1833,8082,22,46,13,9
19609,26,20167,16,12526,7202,5324,28,99,15,13
13682,26,24678,16,6015,3964,2051,32,361,18,14
12737,26,23702,16,499,425,74,4,0,3,1
8827,10,27957,9,344,102,242,2,30,1,1
8712,26,18641,16,1346,918,428,10,23,6,4
13606,234,5766,149,12140,3028,9112,54,4653,28,26
14369,10,18069,9,186,95,91,2,31,1,1
8818,15,17844,11,1854,945,909,13,106,7,6
13871,10,21256,9,822,102,720,2,30,1,1
18858,26,6931,16,10447,2417,8030,26,16,15,11
9078,10,16910,9,815,95,720,2,30,1,1
17149,26,27369,16,36920,24591,12329,80,24,47,33
21397,10,28510,9,220,90,130,2,30,1,1
11205,62,17007,45,70,70,0,2,8,2,0
5486,26,8714,16,3025,1958,1067,26,49,14,12
8444,15,24358,11,254,128,126,5,16,3,2
14228,10,24820,9,168,78,90,2,30,1,1
15732,10,5345,9,298,102,196,4,36,2,2
21866,10,21604,9,199,102,97,2,31,1,1
1056,26,2504,16,6094,771,5323,17,26,9,8
8195,10,7121,9,168,78,90,2,30,1,1
4914,26,16415,16,36902,3203,33699,57,90,31,26
15703,10,21433,9,177,94,83,2,30,1,1
14010,10,24384,9,216,90,126,2,30,1,1
9728,280,11020,177,502,150,352,2,1200,1,1
14463,10,16649,9,177,94,83,2,30,1,1
22696,10,19181,9,199,102,97,2,30,1,1
13647,26,22053,16,38985,4250,34735,58,19,27,31
21643,10,2541,9,226,102,124,2,30,1,1
14525,10,20551,9,86,86,0,1,30,1,0
16209,26,11382,16,10855,1786,9069,32,180,15,17
13690,10,2893,9,177,94,83,2,30,1,1
8902,26,10791,16,8028,1787,6241,32,28,17,15
7576,26,12419,16,4589,2090,2499,15,120,7,8
3133,2298,2813,1782,330,330,0,6,3609,6,0
14078,10,8342,9,216,110,106,2,31,1,1
12414,1136,25580,837,70,70,0,1,4,1,0
11223,1615,13341,1237,70,70,0,2,8,2,0
2310,26,9498,16,4518,1665,2853,19,25,11,8
5606,2018,23203,1548,152,90,62,2,31,1,1
11017,1056,17880,777,70,70,0,1,5,1,0
7292,26,4637,16,57543,2347,55196,68,16,26,42
10482,26,27244,16,9345,3051,6294,22,15,13,9
9182,10,28042,9,350,91,259,4,41,2,2
15301,10,25982,9,223,102,121,2,30,1,1
12619,1136,20015,837,70,70,0,1,5,1,0
10407,26,19974,16,6021,1981,4040,21,15,9,12
12532,10,23568,9,262,82,180,2,29,1,1
5486,26,20350,16,2863801,103667,2760134,3193,182,1240,1953
15091,10,18698,9,184,86,98,2,30,1,1
9007,10,18760,9,193,102,91,2,30,1,1
10806,659,27967,460,70,70,0,1,5,1,0
15637,10,25264,9,182,93,89,2,30,1,1
22312,10,18268,9,193,102,91,2,30,1,1
8831,10,6752,9,168,86,82,2,32,1,1
11914,26,12961,16,4073,2039,2034,14,135,7,7
8372,10,15861,9,194,102,92,2,30,1,1
15989,26,25918,16,11243,4236,7007,47,15,22,25
4745,233,17832,148,220,220,0,3,6,3,0
3133,2330,1222,1814,330,330,0,6,3609,6,0
8693,10,14374,9,173,94,79,2,30,1,1
8564,15,4837,11,3651,2020,1631,16,65,9,7
3133,2322,21070,1806,330,330,0,6,3610,6,0
13794,10,20520,9,181,94,87,2,30,1,1
15107,10,26812,9,711,87,624,2,31,1,1
21824,10,3135,9,305,94,211,4,60,2,2
14529,10,20082,9,177,94,83,2,31,1,1
3810,10,502,9,271,102,169,2,30,1,1
15187,10,20001,9,184,94,90,2,29,1,1
11826,26,4141,16,5583,1390,4193,19,14,9,10
11257,1344,10091,1019,316,136,180,6,9,3,3
8676,10,2368,9,329,118,211,2,29,1,1
8704,10,26494,9,754,94,660,2,30,1,1
21586,10,4956,9,195,102,93,2,30,1,1
8343,10,7116,9,264,110,154,2,30,1,1
8586,10,949,9,170,87,83,2,31,1,1
13664,10,15308,9,195,102,93,2,29,1,1
4071,26,15256,16,5413,2166,3247,22,39,13,9
15374,26,14699,16,5057,880,4177,16,70,8,8
20512,10,21692,9,303,85,218,2,31,1,1
22264,10,11013,9,199,102,97,2,29,1,1
21930,10,21624,9,213,102,111,2,29,1,1
14277,2118,25397,1632,70,70,0,1,5,1,0
21290,2044,2957,1571,70,70,0,1,5,1,0
10931,26,19159,16,6215,948,5267,18,15,9,9
14375,10,23301,9,194,102,92,2,31,1,1
2570,10,10796,9,231,88,143,2,33,1,1
22303,10,5822,9,718,94,624,2,30,1,1
2126,10,8488,9,217,90,127,2,30,1,1
12899,26,2609,16,55394,4535,50859,91,170,47,44
12605,723,23052,516,70,70,0,2,7,2,0
19260,26,18231,16,7653,1226,6427,24,18,14,10
3362,15,27761,11,1638,1324,314,10,14,5,5
21720,10,24423,9,168,86,82,2,31,1,1
12788,2123,24988,1637,1396,719,677,15,15,8,7
11479,10,27932,9,289,86,203,2,30,1,1
15796,10,28802,9,193,102,91,2,31,1,1
532,247,0,0,3354,1792,1562,46,193,23,23
3133,2339,13197,1823,396,396,0,7,3616,7,0
3545,26,5108,16,15400,12233,3167,75,995,38,37
4032,26,2675,16,53756,46525,7231,82,275,51,31
1097,26,15136,16,6092,775,5317,17,28,9,8
19367,26,2665,16,198481,12339,186142,247,64,112,135
15370,10,16132,9,776,102,674,2,30,1,1
998,26,21367,16,3616,429,3187,11,16,6,5
11097,2383,5046,1851,70,70,0,2,8,2,0
9222,10,23677,9,173,94,79,2,30,1,1
15756,10,10614,9,183,94,89,2,30,1,1
9278,26,12026,16,130,70,60,2,15,1,1
8480,10,21622,9,199,102,97,2,30,1,1
12140,26,9272,16,24116,2677,21439,42,323,17,25
14003,10,4494,9,214,110,104,2,29,1,1
14454,10,14035,9,184,94,90,2,31,1,1
21513,10,28197,9,381,101,280,4,43,2,2
12756,26,25351,16,499,425,74,4,0,3,1
18387,26,8056,16,1743,1164,579,16,25,10,6
1175,26,23420,16,1497912,26236,1471676,1321,121,299,1022
13929,10,9205,9,268,95,173,4,45,2,2
18789,1989,12280,1519,316,136,180,6,5,3,3
18295,15,15821,11,21108,15948,5160,47,151,30,17
11801,233,13940,148,12302,5509,6793,43,1061,16,27
19325,26,18689,16,7288,1763,5525,22,77,12,10
14760,10,11545,9,210,110,100,2,29,1,1
10802,26,8319,16,2320,327,1993,11,135,5,6
535,10,1987,9,227,89,138,2,30,1,1
2744,1291,23830,969,871,126,745,2,29,1,1
18543,2022,2066,1552,70,70,0,2,8,2,0
13886,10,15628,9,816,102,714,2,30,1,1
12734,26,26767,16,6375,1019,5356,21,16,11,10
19573,26,234,16,3743,1654,2089,10,121,5,5
14520,10,18487,9,183,94,89,2,30,1,1
16021,1416,15801,1077,1386,1386,0,22,1610,22,0
8397,10,13664,9,195,94,101,2,30,1,1
13855,10,14299,9,196,102,94,2,33,1,1
15242,10,9838,9,168,86,82,2,31,1,1
21962,10,3667,9,269,110,159,2,30,1,1
14356,10,22951,9,195,102,93,2,30,1,1
1183,26,10088,16,6061,1884,4177,27,16,15,12
7800,26,21862,16,3930,392,3538,9,15,4,5
21892,10,28086,9,91,91,0,1,30,1,0
15401,10,25194,9,94,94,0,1,29,1,0
10101,190,24180,125,409,107,302,4,29,2,2
8458,26,27665,16,18607,4906,13701,47,255,20,27
7607,15,10919,11,2074,1375,699,13,83,7,6
4985,26,12948,16,9876,1976,7900,27,27,13,14
13651,26,26234,16,10817,4402,6415,31,23,17,14
17044,26,11432,16,2576,1549,1027,15,15,7,8
7086,15,7393,11,1748,716,1032,19,409,6,13
14743,10,191,9,179,94,85,2,30,1,1
8455,10,20967,9,322,102,220,2,30,1,1
15832,10,9228,9,199,102,97,2,31,1,1
5852,26,4018,16,1053,566,487,10,31,6,4
11198,26,6161,16,73105,13398,59707,220,374,108,112
5188,26,16738,16,226465,10306,216159,292,104,135,157
16461,15,25828,11,14922,10566,4356,39,75,20,19
15620,10,22757,9,755,93,662,2,31,1,1
22606,26,5100,16,2494,1643,851,17,26,9,8
15702,10,5176,9,816,102,714,2,30,1,1
21328,1898,4823,1451,312,132,180,6,6,3,3
15065,10,13747,9,194,102,92,2,30,1,1
8853,10,5077,9,194,99,95,2,31,1,1
18038,15,2459,11,582,138,444,9,25,3,6
22085,10,10207,9,730,102,628,2,29,1,1
22215,10,9797,9,323,94,229,2,30,1,1
8531,10,6251,9,182,94,88,2,30,1,1
15378,10,16021,9,183,94,89,2,29,1,1
11800,15,3719,11,5694,2514,3180,36,118,19,17
11191,916,16004,677,70,70,0,1,4,1,0
2483,10,10406,9,217,87,130,2,31,1,1
4275,15,1302,11,1368,920,448,12,20,7,5
5482,26,15941,16,7967,2261,5706,18,121,8,10
17762,10,13828,9,320,94,226,2,30,1,1
10681,26,11315,16,6400,1830,4570,26,316,13,13
14805,10,23972,9,177,94,83,2,30,1,1
20557,26,22697,16,571,166,405,2,30,1,1
20665,26,2886,16,1373,734,639,17,155,10,7
5041,26,23720,16,4108,1272,2836,11,121,5,6
9853,15,17293,11,1658,1247,411,8,15,5,3
14277,2118,17915,1632,70,70,0,2,8,2,0
8128,26,19636,16,778,358,420,12,43,6,6
17614,10,28115,9,224,78,146,2,30,1,1
9411,1116,19456,821,330,330,0,6,1200,6,0
17094,232,27240,147,47445,16812,30633,144,870,65,79
10003,26,20516,16,9241,2001,7240,24,28,14,10
7132,15,19620,11,18685,7141,11544,33,28,17,16
9513,10,20673,9,166,86,80,2,30,1,1
14859,10,280,9,167,86,81,2,30,1,1
19988,26,3065,16,6383,2838,3545,17,135,9,8
780,2024,2054,1553,133,64,69,3,30,2,1
14922,10,8550,9,780,104,676,2,30,1,1
15543,26,735,16,20635942,626393,20009549,21680,138,6969,14711
7257,26,11762,16,6410,1610,4800,24,17,13,11
14031,10,24396,9,197,76,121,2,30,1,1
8709,10,1871,9,200,102,98,2,30,1,1
7026,26,18525,16,10194,2176,8018,25,186,14,11
10549,26,23829,16,1610,1073,537,14,15,8,6
1169,26,28117,16,14565,3464,11101,59,151,31,28
6731,26,11913,16,11422,2361,9061,26,505,10,16
14933,10,7465,9,177,94,83,2,30,1,1
18315,15,3057,11,1493,737,756,11,150,6,5
21669,10,8331,9,194,94,100,2,30,1,1
8812,10,22360,9,353,118,235,2,30,1,1
21194,1132,514,834,630,508,122,9,15,7,2
8584,1240,10236,920,258,78,180,2,29,1,1
10910,852,14913,627,70,70,0,1,5,1,0
12152,26,6539,16,14269,5761,8508,43,18,23,20
19455,26,2416,16,19544,8237,11307,29,121,13,16
14858,10,17457,9,195,102,93,2,30,1,1
8480,10,2517,9,295,101,194,4,31,2,2
15669,10,27571,9,761,100,661,2,31,1,1
9728,3103,27945,2411,166,166,0,1,1199,1,0
21643,26,8452,16,3182,1568,1614,8,120,4,4
15910,26,16189,16,150,150,0,1,5,1,0
9837,15,24018,11,4465,3390,1075,14,30,8,6
14349,10,18051,9,177,94,83,2,30,1,1
14912,10,21001,9,271,95,176,4,47,2,2
13618,26,7631,16,24232,10141,14091,74,76,39,35
15600,10,26466,9,177,94,83,2,31,1,1
5520,26,3334,16,2186,1319,867,23,20,13,10
21403,10,13291,9,193,102,91,2,31,1,1
10480,26,26595,16,13049,4849,8200,31,31,15,16
15935,10,703,9,756,95,661,2,31,1,1
7107,26,13641,16,6196,1417,4779,21,665,11,10
15920,10,28268,9,193,102,91,2,30,1,1
8467,234,20230,149,12589,6479,6110,172,4146,86,86
8868,15,8454,11,2014,1216,798,13,130,8,5
2744,1242,7217,922,873,126,747,2,30,1,1
14767,10,1579,9,188,96,92,2,30,1,1
15075,10,16287,9,177,94,83,2,30,1,1
1806,740,22442,531,122,62,60,2,29,1,1
21597,10,22514,9,286,102,184,4,45,2,2
21256,10,23716,9,200,102,98,2,33,1,1
10798,3120,6185,2422,66,66,0,1,5,1,0
11665,15,24488,11,13372,7598,5774,29,555,18,11
10790,1817,18968,1386,70,70,0,2,8,2,0
14944,10,26773,9,269,94,175,2,30,1,1
14923,10,12105,9,213,102,111,2,29,1,1
15766,26,1721,16,1798,1223,575,13,28,8,5
12750,42,22935,25,70,70,0,2,8,2,0
22563,10,12394,9,198,102,96,2,30,1,1
9460,15,8622,11,1030,310,720,11,56,6,5
6339,26,13167,16,1093,606,487,11,15,7,4
20575,10,2573,9,222,86,136,2,30,1,1
10927,2923,21343,2268,70,70,0,2,8,2,0
16800,10,0,0,360,160,200,4,49,2,2
12456,49,20894,32,130,70,60,2,6,1,1
16021,60,1592,43,402,132,270,6,1209,3,3
13590,26,16046,16,84306,6712,77594,156,236,58,98
12180,26,19833,16,4028,2584,1444,18,80,10,8
18511,26,10665,16,17060,10614,6446,52,132,25,27
9814,15,553,11,1658,1247,411,8,15,5,3
9555,15,28972,11,1657,1246,411,8,15,5,3
0,0,0,0,124,64,60,2,0,1,1
16240,26,5652,16,15625,4662,10963,25,123,11,14
9266,10,12913,9,969,86,883,2,30,1,1
9245,10,7819,9,816,102,714,2,30,1,1
15663,10,9501,9,196,100,96,2,31,1,1
18501,10,28694,9,78,78,0,1,30,1,0
10047,15,11790,11,10548172,142265,10405907,9105,134,1982,7123
9022,26,6741,16,2027955,75406,1952549,2104,60,564,1540
14847,10,7936,9,167,86,81,2,30,1,1
13706,10,18497,9,198,102,96,2,30,1,1
15880,10,11672,9,194,102,92,2,30,1,1
9003,26,5854,16,5026,973,4053,19,72,10,9
13884,26,24045,16,6165,1407,4758,21,45,12,9
8532,26,3235,16,3598,1145,2453,15,120,7,8
9427,10,1493,9,767,102,665,2,30,1,1
1846,10,6994,9,197,90,107,2,30,1,1
10352,26,3390,16,9600,4628,4972,41,16,24,17
9728,2498,6335,1944,889,161,728,3,1200,2,1
3801,10,14840,9,414,268,146,3,33,2,1
11032,15,3184,11,7480,4670,2810,47,324,30,17
15591,10,1345,9,209,110,99,2,30,1,1
16321,26,19780,16,9767,2606,7161,23,120,11,12
3317,26,19365,16,4648,1885,2763,20,95,10,10
13838,10,102,9,760,97,663,2,31,1,1
18518,3258,27863,2524,624,318,306,10,16,5,5
10192,26,22311,16,1210,637,573,14,25,7,7
8873,26,19467,16,593578,18531,575047,531,210,128,403
10399,26,18546,16,3565,640,2925,16,153,7,9
14085,10,9972,9,184,94,90,2,29,1,1
15903,26,12061,16,72170,4208,67962,102,186,48,54
14883,10,6931,9,173,94,79,2,29,1,1
7747,676,23134,475,130,70,60,2,5,1,1
9813,10,3598,9,578,286,292,9,16,5,4
16753,26,23001,16,12779517,343310,12436207,12837,162,4589,8248
5844,15,17744,11,12386,2651,9735,24,126,12,12
22484,10,3898,9,176,90,86,2,31,1,1
22162,10,24380,9,183,94,89,2,30,1,1
9453,26,20279,16,44311,4535,39776,55,121,21,34
8367,1889,4918,1442,70,70,0,1,5,1,0
8819,15,20742,11,2815,1605,1210,17,166,9,8
12066,382,11939,246,70,70,0,2,9,2,0
18893,26,20310,16,9959,2430,7529,27,46,16,11
21864,10,8660,9,810,108,702,2,30,1,1
9675,15,7513,11,1704,799,905,11,83,6,5
4595,26,17629,16,26069,12062,14007,46,123,21,25
22412,10,18802,9,585,206,379,6,79,3,3
5366,15,2097,11,234,234,0,4,12,4,0
9652,26,19014,16,5938,1012,4926,20,77,11,9
13921,10,25771,9,177,94,83,2,30,1,1
8823,10,9700,9,198,94,104,2,30,1,1
17302,10,26147,9,832,106,726,2,29,1,1
2744,1241,2490,921,888,126,762,2,30,1,1
8672,10,4908,9,200,102,98,2,30,1,1
3146,10,13188,9,216,82,134,2,32,1,1
8834,26,9766,16,7978,2204,5774,20,58,10,10
116,15,217,11,6377,703,5674,13,15,6,7
8053,676,29090,475,130,70,60,2,5,1,1
7581,26,1476,16,2945,779,2166,10,121,5,5
16836,26,16056,16,10026,5706,4320,20,120,10,10
16021,950,20420,701,726,726,0,12,1200,12,0
14505,10,14178,9,267,94,173,4,56,2,2
9140,10,19219,9,245,110,135,2,30,1,1
6211,26,6505,16,7071,1908,5163,29,944,14,15
5817,26,27259,16,9794,2178,7616,26,48,16,10
13637,26,18239,16,865636,22536,843100,903,50,309,594
14960,10,7374,9,94,94,0,1,29,1,0
15484,10,16955,9,177,94,83,2,30,1,1
11841,26,28266,16,13165,3626,9539,56,115,30,26
18479,2870,23781,2229,70,70,0,1,5,1,0
17703,26,22320,16,3351,841,2510,13,136,6,7
21366,26,21770,16,3258,1197,2061,14,136,7,7
14611,10,23666,9,177,94,83,2,30,1,1
18777,923,24094,681,70,70,0,2,8,2,0
11096,3056,10386,2373,70,70,0,2,8,2,0
18607,10,10353,9,199,94,105,2,29,1,1
2744,1233,12417,913,883,126,757,2,30,1,1
16138,26,9913,16,2614,1689,925,18,21,10,8
13866,10,20864,9,193,102,91,2,31,1,1
19643,26,27456,16,18398,2360,16038,39,75,17,22
7596,18,4321,13,184,94,90,2,30,1,1
6923,15,28781,11,3577,1983,1594,18,153,9,9
8798,295,21586,190,1236,676,560,13,15,7,6
17195,26,21238,16,13440,8354,5086,39,20,20,19
10493,26,26896,16,194,70,124,3,11,1,2
3196,10,13591,9,237,91,146,2,33,1,1
5303,15,17463,11,1052,612,440,10,15,5,5
18478,2058,20052,1584,70,70,0,1,5,1,0
13680,26,15167,16,17336,5332,12004,33,121,18,15
8940,10,21719,9,225,110,115,2,30,1,1
15479,10,21011,9,167,86,81,2,29,1,1
14050,10,26562,9,216,110,106,2,31,1,1
9062,26,16745,16,8191,2343,5848,33,394,11,22
17853,26,21091,16,1312,651,661,13,184,7,6
734,26,2965,16,1474,697,777,18,82,8,10
6558,26,22007,16,9093,4719,4374,52,310,24,28
15764,10,15382,9,183,94,89,2,30,1,1
6837,26,7941,16,7491,1930,5561,26,263,14,12
12778,424,23446,276,492,306,186,8,15,5,3
22236,10,12434,9,193,102,91,2,31,1,1
15583,10,11026,9,199,102,97,2,30,1,1
9790,15,12697,11,1328,917,411,10,25,6,4
17631,10,15088,9,489,114,375,2,31,1,1
12959,26,6177,16,2227,1018,1209,17,16,8,9
21665,10,9128,9,362,94,268,2,30,1,1
9144,10,3676,9,168,94,74,2,31,1,1
16377,26,8689,16,4823,708,4115,19,240,6,13
14432,10,15095,9,183,94,89,2,29,1,1
14536,10,26818,9,184,94,90,2,30,1,1
15624,10,5746,9,173,94,79,2,29,1,1
14747,10,14589,9,291,94,197,2,29,1,1
3586,15,24729,11,1988,1072,916,12,515,7,5
14834,10,25574,9,200,102,98,2,31,1,1
4839,26,13696,16,3149,1829,1320,22,315,12,10
2231,10,9111,9,197,90,107,2,30,1,1
11270,26,22855,16,1615,941,674,15,21,7,8
8227,10,0,0,86,86,0,1,30,1,0
20935,26,22359,16,8062,2186,5876,29,136,15,14
15762,10,23849,9,293,94,199,4,43,2,2
10871,26,17971,16,1686,984,702,15,32,8,7
18467,1884,17107,1438,258,70,188,4,8,2,2
15767,10,269,9,195,102,93,2,29,1,1
21219,10,28017,9,385,110,275,2,30,1,1
8775,10,19420,9,754,94,660,2,30,1,1
21682,10,26166,9,184,94,90,2,30,1,1
22618,26,13662,16,14205,1527,12678,13,147,2,11
8736,26,6470,16,8058,1806,6252,22,15,12,10
9872,26,13751,16,10440,3521,6919,42,119,20,22
551,10,2058,9,229,90,139,2,30,1,1
12280,26,407,16,7208,2237,4971,26,32,16,10
15358,10,19426,9,193,102,91,2,30,1,1
8327,2657,17155,2064,868,150,718,4,1200,2,2
14305,10,26440,9,177,94,83,2,30,1,1
22687,10,25381,9,209,110,99,2,30,1,1
13652,10,7181,9,711,87,624,2,30,1,1
4854,26,4449,16,1652,817,835,17,186,9,8
15322,10,10170,9,172,94,78,2,30,1,1
8543,10,23495,9,209,110,99,2,30,1,1
22685,10,18442,9,96,96,0,1,31,1,0
4121,26,16929,16,560,280,280,9,28,5,4
2177,10,8782,9,194,87,107,2,30,1,1
10986,26,20452,16,8256,3157,5099,28,46,16,12
9071,26,4083,16,3787,2434,1353,29,72,16,13
20831,26,14370,16,7934,1372,6562,25,63,12,13
6430,26,14434,16,883886,26396,857490,947,444,340,607
484,10,1769,9,235,90,145,2,33,1,1
8944,10,6230,9,255,102,153,2,29,1,1
21355,26,4756,16,75064,64938,10126,147,277,71,76
21481,10,16277,9,264,102,162,2,30,1,1
4539,26,16183,16,9621,7389,2232,33,256,14,19
5478,26,28724,16,6903,1273,5630,25,255,13,12
13741,10,25945,9,193,102,91,2,30,1,1
20396,40,6239,23,8883,4621,4262,76,191,47,29
15485,10,1764,9,199,102,97,2,29,1,1
20679,26,15407,16,5725,3290,2435,34,125,19,15
7795,26,6028,16,7057,2186,4871,25,316,13,12
3829,26,13205,16,13175,2432,10743,52,3587,23,29
16021,979,16804,725,2182,798,1384,19,1199,10,9
2046,637,14876,442,491,150,341,2,1200,1,1
5062,26,29003,16,469799,14616,455183,474,129,155,319
18190,15,8495,11,18480,7940,10540,48,71,27,21
11225,26,18189,16,3470,1776,1694,20,48,10,10
21779,10,19075,9,273,86,187,2,30,1,1
9689,26,5584,16,10127,1872,8255,26,27,13,13
7504,6,20158,6,7922,3413,4509,55,38,26,29
22318,10,12897,9,202,103,99,2,31,1,1
13370,26,22391,16,6440,3492,2948,19,135,9,10
15036,10,20445,9,731,91,640,2,31,1,1
1870,10,7088,9,240,98,142,2,29,1,1
9168,26,4001,16,8745,2603,6142,19,15,11,8
8324,10,24044,9,184,94,90,2,30,1,1
16665,10,9785,9,168,78,90,2,30,1,1
14361,10,20136,9,463,128,335,4,41,2,2
21824,10,10394,9,167,86,81,2,29,1,1
16137,15,25467,11,4373,2985,1388,21,37,11,10
7921,26,13541,16,71624,60795,10829,194,131,110,84
17842,26,4259,16,70,70,0,2,5,2,0
14481,10,14611,9,807,94,713,2,30,1,1
2152,10,8639,9,245,98,147,2,30,1,1
7724,26,20451,16,4604,1697,2907,19,29,11,8
15282,26,25915,16,40263,17490,22773,75,403,35,40
430,10,1389,9,216,90,126,2,29,1,1
12618,280,9624,177,70,70,0,2,8,2,0
9634,26,18697,16,1353,903,450,12,78,7,5
7782,26,14465,16,3541,616,2925,19,165,8,11
3750,15,19912,11,2913,633,2280,15,15,8,7
12708,10,12476,9,86,86,0,1,30,1,0
19619,26,13144,16,7439,1156,6283,19,75,11,8
15858,26,353,16,5614,733,4881,16,15,9,7
21676,10,15418,9,177,94,83,2,31,1,1
18988,26,2702,16,13145,6129,7016,37,34,19,18
16246,676,11916,475,130,70,60,2,6,1,1
5723,10,17543,9,262,107,155,2,30,1,1
8135,26,795,16,56258,45661,10597,165,244,88,77
9342,10,17831,9,182,102,80,2,29,1,1
12818,26,2700,16,4957,1627,3330,17,120,8,9
16362,26,27618,16,9802,5628,4174,56,225,29,27
22478,10,11456,9,216,94,122,2,30,1,1
17047,26,8655,16,5167,700,4467,16,15,7,9
15967,10,15149,9,196,102,94,2,30,1,1
13854,10,5989,9,177,94,83,2,30,1,1
15622,10,26158,9,711,87,624,2,30,1,1
1021,26,1565,16,5198,504,4694,13,15,7,6
14846,10,17431,9,177,94,83,2,29,1,1
2744,1566,22489,1197,889,126,763,3,31,2,1
19814,26,7650,16,7989,4098,3891,34,136,15,19
9164,10,5198,9,216,110,106,2,31,1,1
21703,10,627,9,183,94,89,2,29,1,1
11423,15,28888,11,1630,918,712,12,16,7,5
21548,10,1469,9,196,102,94,2,30,1,1
4239,26,898,16,22856,2980,19876,43,116,19,24
1009,26,14224,16,3649,424,3225,12,15,6,6
18852,10,20275,9,168,78,90,2,30,1,1
21579,10,3117,9,179,94,85,2,30,1,1
18520,770,11668,557,1948,891,1057,16,18,8,8
22250,10,1007,9,200,94,106,2,29,1,1
4717,26,1691,16,11442,3116,8326,32,46,19,13
3618,10,14561,9,250,108,142,2,30,1,1
21934,10,24694,9,294,134,160,2,30,1,1
10104,10,11774,9,199,94,105,2,30,1,1
12800,589,18112,400,70,70,0,2,8,2,0
9399,10,22773,9,167,86,81,2,29,1,1
8856,10,13342,9,216,110,106,2,30,1,1
8852,10,9637,9,183,94,89,2,30,1,1
15869,10,6225,9,212,110,102,2,29,1,1
18119,26,12818,16,495428,22440,472988,692,106,316,376
21058,2627,21902,2037,70,70,0,1,4,1,0
9592,26,7969,16,1346,918,428,10,35,6,4
14823,15,24817,11,44817,885,43932,46,15,13,33
8632,10,28171,9,807,94,713,2,30,1,1
6999,2113,4828,1629,502,150,352,2,1200,1,1
12728,1945,13049,1483,70,70,0,2,8,2,0
14274,10,23977,9,182,93,89,2,30,1,1
14918,10,4903,9,196,102,94,2,30,1,1
18087,10,6184,9,186,86,100,2,30,1,1
14668,10,8871,9,214,102,112,2,30,1,1
22685,10,17924,9,280,96,184,4,34,2,2
18792,1989,575,1519,316,136,180,6,6,3,3
11014,15,1806,11,48285,2659,45626,65,15,32,33
15186,26,19586,16,7983,1963,6020,20,15,11,9
18437,15,26782,11,118413,7486,110927,151,33,70,81
8814,26,26094,16,11011,4522,6489,35,45,17,18
14721,10,6715,9,774,101,673,2,31,1,1
13631,10,7891,9,275,93,182,4,32,2,2
22275,10,834,9,214,110,104,2,30,1,1
1668,15,6019,11,3197,2167,1030,17,72,10,7
9722,18,28228,13,184,94,90,2,30,1,1
8456,10,18741,9,177,94,83,2,30,1,1
11194,26,24164,16,4187,773,3414,16,30,9,7
9195,10,28300,9,533,184,349,6,76,3,3
9290,10,24385,9,748,106,642,2,30,1,1
294,26,821,16,28717,3437,25280,45,23,23,22
17288,26,17298,16,4989,1014,3975,16,27,9,7
18351,26,12386,16,7576,1897,5679,23,136,13,10
15612,10,1371,9,810,108,702,2,31,1,1
14524,10,8952,9,212,102,110,2,30,1,1
18477,15,20150,11,5124,3499,1625,14,121,8,6
7157,26,25786,16,2504,1442,1062,22,29,12,10
8376,2666,17464,2073,70,70,0,2,8,2,0
15500,15,2363,11,214,140,74,4,35,3,1
8475,10,8359,9,190,97,93,2,30,1,1
861,10,3554,9,178,82,96,2,30,1,1
16021,2888,19419,2243,330,330,0,6,1199,6,0
22290,10,18747,9,183,94,89,2,30,1,1
15340,123,816,93,70,70,0,1,5,1,0
22647,10,13332,9,364,102,262,2,29,1,1
19359,26,25029,16,130792,4916,125876,161,89,69,92
21920,10,27066,9,766,102,664,2,30,1,1
9209,26,6023,16,4612,947,3665,18,85,10,8
22506,10,28328,9,164,84,80,2,31,1,1
12248,26,21743,16,4814,1207,3607,17,75,10,7
9123,26,8982,16,102240,4349,97891,128,136,46,82
9,18,15436,13,184,94,90,2,30,1,1
18538,2819,8727,2188,70,70,0,2,8,2,0
21537,10,1481,9,177,94,83,2,30,1,1
21186,842,14433,620,70,70,0,1,4,1,0
18733,26,16377,16,12258,1451,10807,27,360,13,14
15559,10,8687,9,259,87,172,4,37,2,2
4941,26,17241,16,448,78,370,6,25,1,5
6959,26,13210,16,7228,3478,3750,37,164,17,20
21559,10,21942,9,253,87,166,4,31,2,2
12838,26,9707,16,4253,726,3527,13,15,7,6
22446,10,8561,9,208,106,102,2,30,1,1
2744,1248,19490,928,893,126,767,2,30,1,1
14228,15,2075,11,70,70,0,1,5,1,0
17489,26,12466,16,8442,1134,7308,23,15,13,10
12526,405,20287,263,70,70,0,2,7,2,0
14248,10,5805,9,170,87,83,2,30,1,1
3754,15,7796,11,6260,696,5564,17,16,9,8
20494,26,23358,16,512,166,346,2,30,1,1
6979,26,21702,16,12834,7868,4966,60,463,38,22
15546,26,19184,16,7481,2264,5217,22,135,10,12
12021,26,7954,16,10705,5303,5402,36,650,16,20
8210,280,21194,177,494,152,342,2,1200,1,1
15452,26,25123,16,27657,5506,22151,58,46,30,28
8552,10,3040,9,214,102,112,2,30,1,1
21811,10,17279,9,214,110,104,2,30,1,1
22392,1238,10852,918,281,78,203,2,30,1,1
8348,15,15916,11,6158,654,5504,15,16,8,7
15948,26,26018,16,12347,6378,5969,39,208,20,19
21645,10,6949,9,231,102,129,2,30,1,1
12903,26,20708,16,1173681,52597,1121084,1428,177,642,786
4990,15,6930,11,4535,1637,2898,23,2899,14,9
13679,10,18281,9,183,94,89,2,30,1,1
994,26,16731,16,4216,771,3445,16,26,9,7
5403,26,4263,16,345779,9537,336242,359,26,123,236
15385,26,22991,16,8072,2052,6020,20,16,11,9
14936,10,13130,9,184,94,90,2,31,1,1
14899,10,27758,9,733,93,640,2,31,1,1
2712,26,16297,16,6701,2064,4637,19,19,9,10
15128,10,20472,9,195,102,93,2,29,1,1
13921,15,18540,11,1594,1280,314,10,15,5,5
13925,10,27703,9,94,94,0,1,30,1,0
12752,26,23672,16,4447,1540,2907,19,30,11,8
21869,10,700,9,307,94,213,2,30,1,1
9382,10,13743,9,768,99,669,2,30,1,1
18398,26,7012,16,7506,4789,2717,28,130,16,12
6077,15,7581,11,738,70,668,12,394,2,10
21298,10,2690,9,402,97,305,4,31,2,2
8510,10,8946,9,209,110,99,2,30,1,1
15573,10,2390,9,194,102,92,2,30,1,1
9919,26,26506,16,16067,4838,11229,43,121,21,22
12644,1101,12171,808,70,70,0,1,4,1,0
15177,10,8800,9,197,102,95,2,30,1,1
16985,26,10039,16,22576,10533,12043,61,200,35,26
9809,26,12765,16,22544,1481,21063,31,16,9,22
9098,10,7596,9,478,107,371,4,39,2,2
10512,26,8249,16,6936,1761,5175,17,16,11,6
10808,3078,14105,2391,70,70,0,1,5,1,0
17646,26,21633,16,7333,1933,5400,27,16,15,12
8795,10,15446,9,196,100,96,2,31,1,1
12403,1502,26341,1142,492,306,186,8,16,5,3
16440,26,3274,16,315701,12378,303323,358,137,129,229
16300,15,27976,11,104397,8436,95961,122,21,49,73
15166,10,11514,9,760,97,663,2,30,1,1
8829,10,5113,9,190,97,93,2,31,1,1
11244,26,26604,16,10898,3170,7728,33,331,14,19
14230,26,6258,16,7360,2298,5062,22,255,12,10
14925,10,23963,9,177,94,83,2,30,1,1
7986,234,20057,149,10096,2251,7845,41,3747,16,25
8808,15,13843,11,312,192,120,6,41,4,2
22387,10,24133,9,164,84,80,2,31,1,1
19014,15,18531,11,9483,767,8716,18,14,10,8
8541,10,15526,9,193,102,91,2,30,1,1
9776,26,20635,16,4158,1021,3137,15,26,8,7
22660,26,13697,16,92569,4939,87630,111,15,45,66
6093,10,18093,9,213,87,126,2,30,1,1
8650,15,3926,11,3333,672,2661,12,15,7,5
6316,26,23517,16,4887,895,3992,16,29,9,7
9540,15,23083,11,487,180,307,6,26,4,2
6185,26,12456,16,5361,973,4388,18,15,10,8
4022,26,9636,16,11083,4080,7003,38,40,14,24
13723,10,3473,9,190,97,93,2,31,1,1
13420,26,4206,16,5612,1051,4561,20,16,11,9
0,0,0,0,480,244,236,4,0,2,2
11038,2523,7862,1960,70,70,0,1,5,1,0
3275,10,13980,9,227,88,139,2,30,1,1
12310,26,9775,16,88210,4564,83646,115,46,50,65
14873,10,1028,9,200,102,98,2,30,1,1
8584,1238,3141,918,252,78,174,2,29,1,1
14280,26,25826,16,6672,2258,4414,19,16,10,9
6458,26,3057,16,10692,4532,6160,31,134,16,15
15887,26,21086,16,36551,3569,32982,57,46,28,29
8957,10,20735,9,226,94,132,2,30,1,1
4357,171,15728,117,138,78,60,2,6,1,1
10962,1815,13335,1384,70,70,0,2,8,2,0
10915,3239,28458,2510,70,70,0,2,8,2,0
6184,10,8616,9,168,78,90,2,30,1,1
14452,10,4921,9,182,93,89,2,31,1,1
12639,280,4282,177,70,70,0,1,4,1,0
17998,26,2145,16,1401,864,537,12,28,6,6
4101,15,17287,11,1638,1324,314,10,15,5,5
4838,26,11256,16,15668921,169545,15499376,12539,161,1284,11255
18263,26,7533,16,3915,1934,1981,14,122,7,7
11791,26,23174,16,5045,2187,2858,16,136,8,8
14205,10,28775,9,198,101,97,2,31,1,1
7989,232,15002,147,49279,23110,26169,459,384,239,220
11683,26,17654,16,104383,5038,99345,135,25,62,73
2863,1992,20191,1522,148,86,62,2,30,1,1
9728,2750,18302,2131,1356,300,1056,6,1201,3,3
15242,10,24682,9,199,102,97,2,29,1,1
9501,15,18626,11,764,698,66,6,15,5,1
5602,26,27373,16,24750,1845,22905,39,171,17,22
14013,10,12956,9,214,110,104,2,30,1,1
15869,10,12855,9,212,110,102,2,31,1,1
8977,10,21203,9,392,101,291,4,39,2,2
5265,26,10189,16,6747,2827,3920,19,399,11,8
4664,26,197,16,499,425,74,4,0,3,1
11192,26,8331,16,1461,924,537,13,31,7,6
9639,10,25019,9,195,102,93,2,30,1,1
3595,6,14510,6,5468,1991,3477,27,34,15,12
17197,26,9249,16,5167,700,4467,16,14,7,9
14519,10,5381,9,389,110,279,2,30,1,1
15172,26,21969,16,10135129,248530,9886599,9808,64,3124,6684
16818,234,8461,149,2855,1780,1075,20,3600,10,10
22254,10,16483,9,339,105,234,4,53,2,2
9164,10,25001,9,216,102,114,2,29,1,1
10981,15,10205,11,1265,642,623,12,45,7,5
13198,26,24352,16,9970,3706,6264,44,272,21,23
16021,2968,25180,2304,1572,664,908,14,1200,9,5
0,0,0,0,200,102,98,2,0,1,1
9864,26,21457,16,5828,1439,4389,16,75,9,7
10020,15,27093,11,538995,15959,523036,552,140,201,351
8423,26,12847,16,10619,3257,7362,29,361,13,16
15222,26,19827,16,8059,2039,6020,20,15,11,9
13779,1263,3814,943,1798,1386,412,8,29,4,4
22533,10,462,9,313,110,203,4,32,2,2
12384,26,14928,16,2385,1462,923,18,200,10,8
11985,26,2503,16,6726,3603,3123,34,80,17,17
2742,15,11354,11,256062,8754,247308,297,18,124,173
11188,199,23408,131,70,70,0,1,5,1,0
2112,10,3036,9,223,78,145,2,29,1,1
15159,10,26117,9,177,94,83,2,31,1,1
22202,26,28905,16,9107,1499,7608,20,75,11,9
21102,2687,19307,2086,66,66,0,1,5,1,0
17805,26,22879,16,11549,6152,5397,28,156,16,12
12633,10,10067,9,213,78,135,2,30,1,1
11044,955,119,705,70,70,0,2,8,2,0
12636,2442,17170,1897,70,70,0,2,7,2,0
11434,26,25140,16,70,70,0,1,4,1,0
15133,10,21706,9,214,110,104,2,29,1,1
19795,26,14447,16,134,60,74,3,5,2,1
5117,26,213,16,1188751,17817,1170934,1053,16,255,798
993,26,20270,16,4216,771,3445,16,26,9,7
15606,10,9189,9,216,110,106,2,30,1,1
15210,26,24830,16,8654,2150,6504,20,15,11,9
22225,10,25410,9,193,102,91,2,30,1,1
3227,10,13765,9,823,98,725,2,30,1,1
6704,26,6497,16,27525,2389,25136,47,27,22,25
6405,10,2612,9,168,78,90,2,30,1,1
3798,26,24672,16,3521,516,3005,12,15,6,6
8200,26,5408,16,6770,2047,4723,26,16,14,12
8851,15,4922,11,1548,847,701,10,16,5,5
8910,15,15571,11,2455,475,1980,9,81,5,4
851,26,24387,16,7769,3958,3811,17,121,9,8
10695,26,26285,16,11558,3964,7594,37,17,15,22
2744,1238,9236,918,1654,126,1528,4,30,2,2
10817,1781,13890,1359,70,70,0,2,8,2,0
22297,15,28956,11,18499242,314733,18184509,19253,37,4700,14553
5118,26,9791,16,16959,8920,8039,46,33,24,22
14532,10,1963,9,807,94,713,2,29,1,1
8876,26,25533,16,9772,1954,7818,23,130,12,11
12617,3156,24910,2446,70,70,0,1,4,1,0
8384,10,15585,9,209,110,99,2,30,1,1
15732,10,20754,9,200,102,98,2,30,1,1
8584,1238,5172,918,227,78,149,2,30,1,1
15910,26,13871,16,150,150,0,1,5,1,0
15838,10,5868,9,178,94,84,2,30,1,1
14696,10,3788,9,177,94,83,2,30,1,1
22014,26,16978,16,16199,7657,8542,58,127,28,30
6050,26,27468,16,7292,1489,5803,21,187,11,10
19320,26,21820,16,9380,3315,6065,26,93,14,12
8321,10,2627,9,763,204,559,6,40,3,3
20089,26,2982,16,8698,3272,5426,22,26,11,11
11001,946,3895,698,70,70,0,2,8,2,0
15305,10,12743,9,170,87,83,2,31,1,1
12721,512,10017,337,320,140,180,6,5,3,3
22042,10,1812,9,195,102,93,2,29,1,1
11416,26,1182,16,14050,4805,9245,30,158,17,13
10955,15,24391,11,51645,3868,47777,67,28,30,37
10816,1882,12468,1437,70,70,0,1,5,1,0
13035,26,12054,16,4665,2167,2498,23,16,12,11
2744,1238,27300,918,868,126,742,3,31,2,1
10204,26,15873,16,11749,5336,6413,32,153,18,14
9665,15,225,11,454,262,192,8,25,5,3
15187,10,9863,9,172,88,84,2,31,1,1
21217,668,2234,469,312,190,122,5,16,3,2
9023,15,13277,11,1529,677,852,11,89,6,5
15804,26,17481,16,93673,74276,19397,194,67,111,83
14786,10,10323,9,498,204,294,6,31,3,3
7027,15,23179,11,1602,1282,320,10,15,5,5
15908,10,14601,9,184,94,90,2,30,1,1
2724,1240,16272,920,422,164,258,6,30,3,3
10821,2879,180,2237,70,70,0,2,8,2,0
5105,26,8283,16,380978,8857,372121,373,16,115,258
13870,10,582,9,182,94,88,2,30,1,1
2047,10,8050,9,198,89,109,2,31,1,1
15188,26,19674,16,4378,1140,3238,14,26,9,5
6931,26,19505,16,6834,3797,3037,48,97,23,25
7932,10,20782,9,243,94,149,2,32,1,1
13804,26,2912,16,7963,2657,5306,29,333,13,16
19035,15,27114,11,16824,810,16014,22,15,8,14
11569,26,9683,16,2860,258,2602,9,121,4,5
22076,10,16818,9,211,110,101,2,30,1,1
14997,10,7832,9,183,94,89,2,30,1,1
13798,10,24796,9,177,94,83,2,30,1,1
636,2067,18040,1593,150,150,0,1,1200,1,0
15394,1857,2975,1416,70,70,0,1,5,1,0
15764,10,5616,9,183,94,89,2,30,1,1
903,26,6709,16,15550,1508,14042,28,19,13,15
9606,15,25729,11,4603,2152,2451,14,22,8,6
9310,10,15172,9,178,94,84,2,29,1,1
20417,40,14628,23,8324,3635,4689,76,53,35,41
18030,15,6427,11,2287,1534,753,11,16,6,5
14077,10,21357,9,752,93,659,2,31,1,1
15928,10,17529,9,728,96,632,2,30,1,1
4559,26,7439,16,4514,1928,2586,17,240,8,9
21198,2950,10238,2289,66,66,0,2,7,2,0
14887,10,21400,9,184,94,90,2,30,1,1
18117,26,26250,16,117023,8825,108198,138,143,49,89
5135,15,14149,11,190,70,120,4,17,2,2
17187,26,10804,16,5167,700,4467,16,15,7,9
21642,10,4947,9,183,94,89,2,31,1,1
18786,26,26973,16,13423,1386,12037,33,17,14,19
14657,10,18572,9,164,86,78,2,29,1,1
22092,10,20953,9,356,118,238,2,30,1,1
10026,15,7588,11,53024,5569,47455,72,140,35,37
21600,10,23289,9,193,102,91,2,29,1,1
8943,10,21411,9,168,78,90,2,31,1,1
9427,233,12268,148,208,60,148,4,11,2,2
18423,26,27798,16,5212,1101,4111,22,123,12,10
8961,10,19450,9,263,94,169,2,30,1,1
6087,26,13084,16,174542,9281,165261,227,78,104,123
12459,37,731,22,70,70,0,1,5,1,0
21315,1366,14945,1038,66,66,0,2,8,2,0
6547,26,15411,16,1139403,49178,1090225,1155,108,353,802
9403,10,22174,9,199,102,97,2,29,1,1
8238,26,29007,16,87648,6895,80753,131,364,66,65
22090,10,24970,9,183,94,89,2,29,1,1
17026,10,26649,9,247,102,145,2,30,1,1
22432,10,2525,9,448,130,318,4,44,2,2
9034,10,26327,9,194,102,92,2,30,1,1
8368,10,15065,9,200,102,98,2,30,1,1
12809,872,25563,643,70,70,0,1,5,1,0
6820,15,19129,11,457843,10253,447590,452,26,152,300
12050,26,13111,16,2731,1895,836,18,28,10,8
9803,15,19064,11,24433,3378,21055,31,21,12,19
5168,26,7965,16,584,370,214,9,25,6,3
12677,26,870,16,499,425,74,4,0,3,1
4830,15,6853,11,1372,868,504,13,35,8,5
17243,26,5011,16,5166,700,4466,16,15,7,9
22626,15,17400,11,11239,7307,3932,19,25,10,9
6438,26,5750,16,11377,7703,3674,26,161,19,7
8451,10,24598,9,185,102,83,2,30,1,1
10099,15,27511,11,11340,3061,8279,31,115,12,19
14555,10,15449,9,760,97,663,2,30,1,1
21224,10,19118,9,196,94,102,2,30,1,1
16388,15,21709,11,6527,1210,5317,15,18,8,7
8584,1560,26017,1191,235,78,157,2,30,1,1
17083,26,25118,16,5166,700,4466,16,15,7,9
15789,10,3194,9,198,102,96,2,30,1,1
8481,26,27043,16,8599,4862,3737,47,195,26,21
9096,10,24499,9,195,102,93,2,30,1,1
15389,2889,11731,2244,70,70,0,1,5,1,0
17955,26,21997,16,1427,726,701,17,46,8,9
7360,15,27118,11,111564,6775,104789,160,85,86,74
13640,26,16925,16,5684,3042,2642,32,46,18,14
8316,26,17265,16,130,70,60,3,5,2,1
19919,26,27643,16,296688,57600,239088,332,96,141,191
5215,26,21116,16,20511,4206,16305,24,134,7,17
15134,26,739,16,7702,2155,5547,19,39,11,8
14961,15,8661,11,1466,729,737,12,16,7,5
21346,10,20290,9,194,102,92,2,29,1,1
11101,15,15104,11,1284,780,504,12,360,7,5
4440,15,1509,11,11216,2684,8532,28,163,11,17
16084,26,22247,16,34428,22220,12208,84,122,41,43
10831,1670,5519,1278,70,70,0,1,5,1,0
10216,26,13960,16,7250,2813,4437,21,62,12,9
17189,26,27162,16,3956,2519,1437,18,80,10,8
14192,10,8578,9,290,118,172,2,30,1,1
14306,2705,9414,2101,70,70,0,1,5,1,0
8920,15,992,11,1793,634,1159,11,15,6,5
16773,183,25866,121,4624,1524,3100,17,17,9,8
13782,10,7226,9,443,182,261,6,31,3,3
10327,2547,270,1979,791,266,525,8,1200,4,4
18431,26,6158,16,10483,4072,6411,20,26,9,11
21488,10,24446,9,211,102,109,2,30,1,1
22015,10,26495,9,168,86,82,2,31,1,1
15478,15,5700,11,78,78,0,2,8,2,0
234,183,592,121,4145,1976,2169,22,19,13,9
19569,26,4144,16,9854,2716,7138,36,49,20,16
7290,15,10993,11,52352,11192,41160,90,476,44,46
11080,26,27905,16,9896,3586,6310,27,134,13,14
7700,15,8861,11,1114,534,580,12,15,7,5
967,26,9485,16,6132,767,5365,17,26,9,8
21694,183,28644,121,4350,2261,2089,21,18,11,10
13621,15,24028,11,1848,851,997,10,515,6,4
2786,26,13190,16,16040,2126,13914,40,50,21,19
8802,10,1867,9,790,110,680,2,30,1,1
15412,10,11689,9,195,102,93,2,32,1,1
15815,10,14415,9,215,102,113,2,30,1,1
8387,153,16425,108,70,70,0,1,5,1,0
18480,26,10244,16,8590,1987,6603,23,86,12,11
9445,26,24908,16,86,86,0,1,4,1,0
8531,10,5313,9,307,307,0,4,60,4,0
14621,10,13922,9,190,97,93,2,31,1,1
8878,10,12767,9,178,94,84,2,29,1,1
15593,10,21455,9,738,86,652,2,31,1,1
13992,10,28206,9,214,110,104,2,30,1,1
14877,26,15665,16,10839,2145,8694,32,140,14,18
14856,10,4737,9,711,87,624,2,31,1,1
7796,26,8701,16,350,210,140,6,75,4,2
10739,2047,12564,1574,66,66,0,1,5,1,0
21183,2111,22153,1627,2980,1647,1333,16,31,10,6
11145,448,3620,287,70,70,0,2,8,2,0
16894,183,25937,121,5387,1909,3478,22,21,10,12
22696,10,9168,9,167,86,81,2,29,1,1
8909,26,28332,16,157156,3872,153284,160,128,48,112
8791,26,25493,16,4252,726,3526,13,16,7,6
8394,26,21376,16,155471,20626,134845,193,95,92,101
17082,26,8230,16,5397,3496,1901,20,16,10,10
21812,10,10450,9,202,103,99,2,30,1,1
15526,26,9288,16,7245,1282,5963,16,135,7,9
15005,10,21344,9,184,94,90,2,30,1,1
4541,26,21733,16,2394,1365,1029,18,275,9,9
12049,15,15486,11,1213,725,488,10,323,6,4
14409,10,24597,9,247,98,149,2,32,1,1
18519,2989,3859,2323,1307,786,521,15,16,8,7
14831,15,24825,11,101354,1343,100011,89,15,19,70
667,10,2642,9,197,90,107,2,30,1,1
3089,10,24940,9,223,86,137,2,30,1,1
10830,3195,15847,2477,70,70,0,2,8,2,0
13397,26,13086,16,72676,12694,59982,144,127,64,80
10327,280,18897,177,479,150,329,2,1200,1,1
14186,10,5265,9,302,78,224,2,30,1,1
5814,26,5994,16,4435,2949,1486,25,80,14,11
7305,15,863,11,1638,1324,314,10,15,5,5
9030,26,6820,16,6058,1038,5020,20,56,11,9
6014,26,1144,16,4168,2503,1665,20,255,11,9
21724,10,23852,9,356,98,258,4,35,2,2
8831,10,19682,9,197,102,95,2,30,1,1
15252,10,22278,9,286,103,183,4,49,2,2
16306,26,17643,16,6161,925,5236,18,28,10,8
214,295,487,190,2227,676,1551,15,14,7,8
13131,26,4821,16,8863,3511,5352,20,120,9,11
12473,26,12043,16,123122,115571,7551,161,23,93,68
6522,10,14657,9,168,78,90,2,30,1,1
989,26,5929,16,3944,902,3042,14,26,8,6
4884,305,19084,199,350,210,140,6,15,4,2
11110,426,793,277,70,70,0,2,7,2,0
8461,10,11110,9,723,102,621,2,30,1,1
13709,26,26907,16,14492,3190,11302,34,16,19,15
14832,10,28648,9,762,101,661,2,30,1,1
13288,15,6160,11,4096,3455,641,13,15,8,5
12337,234,13329,149,7188,2098,5090,38,113,22,16
14514,10,3540,9,178,91,87,2,31,1,1
14821,26,13327,16,9920,3980,5940,24,40,12,12
8581,10,1528,9,194,102,92,2,30,1,1
19531,26,22125,16,12203,3519,8684,65,18,35,30
22634,10,8713,9,164,86,78,2,30,1,1
10299,10,2535,9,312,78,234,2,30,1,1
22317,10,7955,9,355,96,259,4,38,2,2
8917,10,21265,9,232,92,140,2,30,1,1
13488,15,3199,11,8957,4075,4882,32,416,17,15
15810,10,25833,9,199,102,97,2,30,1,1
17184,676,10850,475,138,78,60,2,5,1,1
4082,26,20526,16,6419,995,5424,21,360,11,10
4451,26,9783,16,6351,4202,2149,35,94,18,17
15924,10,22538,9,177,94,83,2,29,1,1
21815,10,2126,9,198,102,96,2,30,1,1
2744,66,16359,49,855,126,729,2,30,1,1
8532,10,16805,9,195,102,93,2,30,1,1
5976,26,25901,16,3356,2158,1198,21,82,11,10
19820,26,8075,16,2902,1562,1340,22,46,12,10
14978,10,27545,9,179,94,85,2,30,1,1
5450,26,16399,16,7522,2433,5089,16,120,8,8
8462,10,4484,9,280,96,184,4,36,2,2
19705,15,25309,11,2418,495,1923,11,125,6,5
6239,26,18314,16,2052,1187,865,21,76,11,10
8797,15,7581,11,1446,914,532,8,16,5,3
15439,703,25460,501,70,70,0,1,5,1,0
21670,10,9844,9,289,134,155,2,30,1,1
15815,10,9483,9,821,102,719,2,30,1,1
4320,26,15659,16,4373,1466,2907,19,29,11,8
14014,10,2709,9,199,102,97,2,31,1,1
11024,26,10907,16,330,190,140,6,15,4,2
13051,26,4432,16,499,425,74,4,0,3,1
379,10,1152,9,231,90,141,2,30,1,1
14911,10,8279,9,214,102,112,2,31,1,1
12573,26,15074,16,499,425,74,4,0,3,1
12274,26,3460,16,9193,6294,2899,27,121,14,13
10621,26,12573,16,9080,2186,6894,27,108,14,13
15136,10,16120,9,172,94,78,2,29,1,1
3036,10,12610,9,235,90,145,2,33,1,1
9429,10,13576,9,767,102,665,2,29,1,1
8373,10,18079,9,301,89,212,4,48,2,2
22231,10,21075,9,184,94,90,2,30,1,1
15065,10,10522,9,788,108,680,2,31,1,1
9036,10,21701,9,218,90,128,2,29,1,1
12792,1732,15506,1322,552,306,246,9,15,5,4
15849,10,25046,9,170,87,83,2,31,1,1
18797,1356,20997,1029,70,70,0,1,5,1,0
15110,26,6489,16,306579,19447,287132,335,105,129,206
14220,26,7385,16,8049,1560,6489,19,150,9,10
4641,738,6937,529,556,256,300,10,30,5,5
15227,10,9961,9,821,102,719,2,30,1,1
18476,2185,288,1690,70,70,0,1,5,1,0
9025,10,25032,9,198,102,96,2,31,1,1
15231,26,10401,16,1342,918,424,10,25,6,4
14621,10,12407,9,195,102,93,2,30,1,1
8345,10,11342,9,199,102,97,2,29,1,1
11827,26,4544,16,326078,45627,280451,737,116,252,485
9103,10,15090,9,231,102,129,2,29,1,1
21948,10,24423,9,214,110,104,2,30,1,1
14067,26,27829,16,805321,15163,790158,752,171,204,548
17410,26,28909,16,26615,22329,4286,52,272,30,22
14332,10,17760,9,752,93,659,2,30,1,1
21279,10,12112,9,241,102,139,2,30,1,1
15986,10,13916,9,200,102,98,2,30,1,1
7967,26,24194,16,16187,11705,4482,33,159,19,14
21159,280,18310,177,66,66,0,2,7,2,0
21813,10,1949,9,426,89,337,4,58,2,2
9757,15,16002,11,21942,2323,19619,28,21,11,17
12851,26,6772,16,13330,3836,9494,53,255,29,24
22033,10,823,9,186,95,91,2,30,1,1
21803,26,28148,16,29112,2866,26246,53,31,28,25
12184,15,40,11,12660,7492,5168,27,274,14,13
15752,10,18410,9,177,94,83,2,30,1,1
21582,10,18043,9,210,110,100,2,30,1,1
7229,349,28751,222,78,78,0,1,4,1,0
14944,26,27127,16,3734,1750,1984,24,203,12,12
21394,10,5886,9,259,102,157,2,30,1,1
15616,10,1868,9,177,94,83,2,29,1,1
20207,183,27822,121,3504,1790,1714,17,34,9,8
10580,26,12353,16,898,460,438,12,39,5,7
22489,10,1164,9,195,102,93,2,30,1,1
15570,10,19808,9,168,86,82,2,30,1,1
5984,26,10746,16,6004,1688,4316,22,29,13,9
21140,759,15428,547,66,66,0,2,8,2,0
21310,1441,25526,1095,66,66,0,2,8,2,0
19410,26,51,16,13977,5303,8674,48,152,20,28
18275,15,18662,11,70,70,0,2,8,2,0
8879,10,24535,9,734,94,640,2,30,1,1
8775,15,22165,11,318,192,126,6,41,4,2
12553,26,4108,16,33323,3349,29974,45,123,18,27
8733,10,26101,9,244,94,150,2,29,1,1
15703,10,25871,9,177,94,83,2,29,1,1
21389,10,3151,9,251,102,149,2,30,1,1
8533,26,12615,16,5777400,184445,5592955,6224,332,2268,3956
14889,10,17787,9,228,94,134,2,30,1,1
8325,26,1282,16,23613,13099,10514,79,1341,36,43
6765,232,6204,147,3007,1354,1653,28,83,15,13
8293,26,16053,16,98965,16634,82331,187,30,82,105
9705,10,14749,9,763,102,661,2,30,1,1
15498,15,21035,11,214,140,74,4,25,3,1
14297,10,1567,9,784,94,690,2,30,1,1
2046,2280,3057,1765,469,150,319,2,1200,1,1
17906,26,13469,16,5520,1212,4308,18,28,9,9
18447,26,1036,16,4315,928,3387,16,15,10,6
8335,26,5296,16,17765,1565,16200,29,16,12,17
14350,10,8141,9,226,110,116,2,30,1,1
5807,26,7850,16,7183,1824,5359,27,316,14,13
17547,15,26314,11,107776,4213,103563,177,16,60,117
1630,26,6897,16,4649,2928,1721,40,415,21,19
2912,26,26289,16,8456,3501,4955,20,90,11,9
18559,26,26840,16,12727,948,11779,21,30,10,11
14630,10,16240,9,181,94,87,2,31,1,1
3417,26,6360,16,1067,650,417,10,73,6,4
6462,10,27005,9,198,93,105,2,30,1,1
8912,10,12550,9,185,102,83,2,30,1,1
14256,604,8225,415,634,388,246,10,18,6,4
385,15,1137,11,6919,1220,5699,20,104,12,8
12526,880,23564,649,70,70,0,1,30,1,0
3542,26,17146,16,16265,3132,13133,54,276,26,28
18451,15,7973,11,214,140,74,4,15,3,1
16021,3011,10905,2341,330,330,0,6,1200,6,0
9106,10,18407,9,177,94,83,2,31,1,1
10882,864,11850,638,136,136,0,3,13,3,0
14828,10,13093,9,180,94,86,2,31,1,1
1529,146,5453,103,124,60,64,2,5,1,1
10518,10,22491,9,256,114,142,2,30,1,1
13609,10,25369,9,170,87,83,2,30,1,1
14050,10,3808,9,216,110,106,2,31,1,1
9959,26,26182,16,6133,1655,4478,12,121,5,7
14221,10,17183,9,288,288,0,4,47,4,0
14811,234,13386,149,2531,1513,1018,17,3601,8,9
4769,15,25266,11,1090,609,481,13,329,7,6
21950,10,28418,9,319,97,222,4,31,2,2
11997,2219,28430,1720,70,70,0,2,8,2,0
8435,10,1801,9,353,118,235,2,30,1,1
13916,10,9762,9,168,86,82,2,30,1,1
14241,10,25562,9,177,94,83,2,30,1,1
8800,26,26939,16,20860,1618,19242,35,122,15,20
9258,10,20707,9,216,110,106,2,30,1,1
22489,10,4303,9,385,106,279,4,33,2,2
13719,10,8044,9,711,87,624,2,30,1,1
6477,15,3711,11,1195,401,794,9,16,5,4
11157,15,3855,11,2412,1750,662,13,36,9,4
10985,15,25556,11,366,240,126,7,27,5,2
16314,329,25587,210,138,78,60,2,5,1,1
15464,10,9140,9,200,94,106,2,30,1,1
19240,26,28112,16,34919,6979,27940,68,247,27,41
8460,233,9292,148,202,142,60,2,15,1,1
15671,10,3150,9,760,97,663,2,31,1,1
5612,26,1815,16,5254,927,4327,20,84,9,11
5806,26,21914,16,8138,2333,5805,26,106,14,12
18357,15,19017,11,1462,864,598,11,144,6,5
10054,26,8833,16,6180,1241,4939,18,982,8,10
5180,15,14003,11,1150,613,537,10,16,6,4
13222,26,23928,16,324001,46592,277409,409,177,203,206
19998,26,3309,16,4019,2219,1800,33,186,17,16
17599,26,5492,16,2866,1684,1182,16,15,8,8
19565,26,27162,16,148467,8298,140169,192,17,93,99
10959,2721,2717,2115,70,70,0,2,8,2,0
18730,10,23555,9,291,86,205,2,29,1,1
19716,183,27505,121,3347,1458,1889,15,18,8,7
12036,26,17755,16,29874004,955051,28918953,31844,303,10580,21264
8595,10,15600,9,210,110,100,2,30,1,1
21910,10,1864,9,376,95,281,4,36,2,2
14660,10,11356,9,224,102,122,2,30,1,1
14922,10,18363,9,198,102,96,2,30,1,1
15866,10,4561,9,194,99,95,2,30,1,1
13645,26,259,16,20604,3530,17074,40,19,21,19
7280,26,10314,16,1625,1038,587,14,26,8,6
2025,10,7929,9,213,87,126,2,31,1,1
14232,10,19246,9,758,93,665,2,31,1,1
8544,26,2197,16,6350,1550,4800,23,19,12,11
19673,26,27062,16,3776,1446,2330,20,153,9,11
15614,10,1862,9,166,86,80,2,31,1,1
13984,10,27823,9,177,94,83,2,31,1,1
14707,10,22040,9,168,94,74,2,30,1,1
86,10,107,9,216,82,134,2,32,1,1
11168,26,22808,16,80933,20860,60073,121,324,66,55
8490,10,4885,9,790,110,680,2,30,1,1
9722,15,12555,11,1791,900,891,14,79,7,7
15387,26,19036,16,11568,9158,2410,42,80,23,19
10655,26,2074,16,3894,863,3031,15,16,9,6
8490,10,26794,9,210,110,100,2,31,1,1
14233,10,2418,9,195,102,93,2,30,1,1
12162,26,27778,16,17169,6566,10603,52,37,24,28
8584,1240,8118,920,78,78,0,1,30,1,0
9065,10,21720,9,194,87,107,2,30,1,1
7208,26,14207,16,11989,7908,4081,61,120,31,30
22402,10,6501,9,215,94,121,2,30,1,1
6250,2021,6626,1551,148,86,62,2,30,1,1
21269,10,8242,9,270,94,176,2,30,1,1
17169,26,16771,16,4657,2146,2511,14,135,7,7
20681,26,26208,16,5248,2550,2698,21,178,10,11
10878,1405,10770,1068,70,70,0,2,9,2,0
17845,10,23686,9,304,86,218,2,30,1,1
8723,10,27480,9,1298,100,1198,4,32,2,2
21252,10,10041,9,193,102,91,2,29,1,1
3835,26,24392,16,70,70,0,1,4,1,0
8522,10,19650,9,184,102,82,2,30,1,1
3891,10,5198,9,199,94,105,2,30,1,1
5126,26,872,16,4478,1133,3345,13,27,8,5
11131,26,25127,16,5706850,104758,5602092,5170,41,1379,3791
22440,10,20501,9,198,102,96,2,29,1,1
7848,26,21278,16,6214,1733,4481,13,120,6,7
17770,26,28009,16,5837,1982,3855,19,18,11,8
10855,1161,13574,857,66,66,0,1,5,1,0
8645,26,26070,16,4591,2492,2099,20,113,11,9
10792,26,17401,16,5048,2345,2703,13,121,7,6
20833,26,11522,16,502,250,252,9,63,5,4
22210,10,28910,9,230,90,140,2,30,1,1
15896,26,20812,16,1495,768,727,16,26,9,7
11212,3083,28243,2395,70,70,0,2,8,2,0
14084,10,9303,9,194,102,92,2,29,1,1
4835,43,18266,26,158,158,0,1,1200,1,0
13700,10,11499,9,300,102,198,4,39,2,2
13713,15,11014,11,306,180,126,6,26,4,2
20668,26,16169,16,1373,734,639,17,125,10,7
21756,10,14566,9,184,94,90,2,31,1,1
22654,10,7711,9,293,102,191,2,29,1,1
1648,26,11978,16,2601,1455,1146,18,15,8,10
16021,291,12332,187,528,528,0,9,1199,9,0
22014,10,26890,9,166,86,80,2,30,1,1
9639,10,24395,9,166,86,80,2,30,1,1
15653,10,6670,9,711,87,624,2,30,1,1
10807,3178,10389,2464,316,136,180,6,6,3,3
7325,26,3326,16,1277649,37293,1240356,1337,303,459,878
5191,26,16741,16,90303,5838,84465,140,103,68,72
17303,26,3273,16,9619,6442,3177,33,122,15,18
4077,10,26736,9,168,78,90,2,29,1,1
8353,10,12021,9,821,102,719,2,30,1,1
15097,10,12020,9,167,86,81,2,30,1,1
4656,26,11271,16,30365,21942,8423,58,50,32,26
15845,26,6603,16,7427,2084,5343,24,361,12,12
16959,26,15359,16,7701,2215,5486,28,373,14,14
22337,10,358,9,168,86,82,2,29,1,1
8824,26,20249,16,11880,2839,9041,30,48,16,14
16202,26,15284,16,13034,3324,9710,35,120,15,20
22652,10,9590,9,177,94,83,2,30,1,1
4859,26,18732,16,6900,4387,2513,37,98,19,18
11139,15,15260,11,422,240,182,8,26,5,3
7922,15,20774,11,1435,1293,142,5,15,3,2
14808,10,26880,9,177,94,83,2,30,1,1
14347,600,831,411,70,70,0,1,5,1,0
10992,15,16973,11,422,240,182,8,25,5,3
15010,10,27993,9,170,87,83,2,30,1,1
21095,2430,5012,1891,66,66,0,2,8,2,0
20929,26,10459,16,19134,2422,16712,49,120,22,27
2792,26,11502,16,1251,722,529,11,147,6,5
20276,26,10046,16,11195,2218,8977,36,80,18,18
10888,26,22696,16,12505,3792,8713,48,255,24,24
14652,10,684,9,249,102,147,2,29,1,1
12081,15,13123,11,814,335,479,10,15,5,5
8455,26,11287,16,7332,2907,4425,50,122,22,28
15536,10,25113,9,198,101,97,2,31,1,1
9018,15,13941,11,14603,5117,9486,24,89,12,12
22149,10,1266,9,360,118,242,2,30,1,1
20595,2399,5910,1866,574,448,126,10,25,8,2
10829,2976,16441,2310,316,136,180,6,6,3,3
9415,26,17319,16,7543,2533,5010,26,55,14,12
9562,10,5903,9,177,94,83,2,30,1,1
9100,10,16811,9,216,110,106,2,29,1,1
17289,26,21297,16,8826,2860,5966,21,9,10,11
15177,15,3657,11,234,234,0,4,11,4,0
532,247,0,0,3498,1872,1626,48,204,24,24
217,10,500,9,235,90,145,2,34,1,1
9622,15,22002,11,28032,3868,24164,47,24,23,24
6097,26,14113,16,6617,1705,4912,24,331,11,13
21493,10,8129,9,196,94,102,2,30,1,1
8922,10,11823,9,264,89,175,4,47,2,2
2744,1239,18140,919,882,126,756,2,30,1,1
5262,26,22193,16,828718,43410,785308,1071,347,479,592
7113,26,21536,16,15153,8118,7035,45,271,22,23
21369,42,4660,25,66,66,0,2,8,2,0
12635,10,4659,9,224,86,138,2,30,1,1
6824,26,27033,16,3327,1940,1387,19,22,10,9
22325,10,20503,9,568,188,380,6,60,3,3
9719,10,8846,9,184,94,90,2,30,1,1
12040,10,12385,9,168,78,90,2,31,1,1
16329,26,15027,16,11893,6064,5829,29,92,15,14
13958,10,12438,9,215,102,113,2,30,1,1
10809,183,8845,121,62242217,4119315,58122902,123738,4772,43917,79821
9191,10,8696,9,264,110,154,2,30,1,1
17962,26,14887,16,10260,1360,8900,22,18,7,15
11830,26,5312,16,5581,1388,4193,19,15,9,10
1209,15,8614,11,130,70,60,2,15,1,1
5859,26,20108,16,1248874,30382,1218492,1261,111,425,836
10468,26,10116,16,22626,10213,12413,35,57,20,15
9546,346,21953,220,378,180,198,7,78,4,3
8687,10,957,9,183,94,89,2,30,1,1
6467,26,14343,16,138,78,60,2,4,1,1
12613,696,7305,495,70,70,0,1,4,1,0
2744,1240,21708,920,877,126,751,2,31,1,1
4304,10,15637,9,268,114,154,2,30,1,1
9190,10,1427,9,395,99,296,4,57,2,2
724,15,2898,11,1845,523,1322,10,15,6,4
636,359,13496,230,150,150,0,1,1200,1,0
5260,26,27033,16,24631,1902,22729,37,215,17,20
18580,15,8945,11,1915,797,1118,8,16,5,3
9709,26,23065,16,1313,876,437,11,27,6,5
7642,26,3907,16,416,210,206,7,32,4,3
15390,26,23583,16,7903,1914,5989,20,15,11,9
15018,10,9457,9,177,94,83,2,29,1,1
3444,10,24184,9,79268,76966,2302,936,88,923,13
6683,10,28853,9,271,102,169,2,30,1,1
17642,10,26372,9,213,87,126,2,30,1,1
11258,2552,7071,1983,230,136,94,4,14,3,1
15373,26,26720,16,8073,2053,6020,20,15,11,9
9564,15,15648,11,5048,4344,704,11,26,6,5
9603,10,17247,9,811,94,717,2,30,1,1
10283,26,19561,16,1472,965,507,13,20,7,6
10899,1157,26014,854,70,70,0,2,8,2,0
6225,18,11757,13,184,94,90,2,30,1,1
9093,10,25360,9,212,108,104,2,31,1,1
8739,10,14163,9,738,86,652,2,30,1,1
9173,15,10437,11,186,64,122,4,29,2,2
22351,10,29052,9,335,102,233,2,30,1,1
12147,26,14778,16,5916,1774,4142,25,15,14,11
13630,26,6299,16,10335,2317,8018,24,188,13,11
8617,10,28821,9,211,102,109,2,30,1,1
15242,10,15345,9,168,86,82,2,29,1,1
22006,10,5558,9,226,102,124,2,30,1,1
14316,10,16536,9,183,94,89,2,29,1,1
15531,10,17498,9,193,102,91,2,30,1,1
6781,233,17341,148,5096,1030,4066,25,1751,9,16
22027,10,21141,9,278,102,176,2,31,1,1
14625,10,12366,9,711,87,624,2,30,1,1
9425,26,24893,16,1786,172,1614,7,119,3,4
15144,234,15647,149,2387,1435,952,16,3600,8,8
21379,10,23869,9,288,101,187,4,58,2,2
2849,10,11733,9,213,87,126,2,31,1,1
14603,26,8224,16,5323,2482,2841,31,19,15,16
14514,10,3346,9,181,94,87,2,31,1,1
19184,26,20823,16,2680,255,2425,9,120,4,5
3744,26,24947,16,773546,29906,743640,881,1166,350,531
4666,26,1953,16,15901,7016,8885,37,49,22,15
9525,26,21541,16,316,136,180,6,6,3,3
1947,10,15299,9,215,94,121,2,30,1,1
22151,10,1505,9,199,94,105,2,29,1,1
15199,15,5106,11,234,234,0,4,12,4,0
13708,15,23856,11,67750,4451,63299,78,60,32,46
11185,15,18426,11,1056,682,374,10,15,6,4
15111,10,20416,9,177,94,83,2,29,1,1
8305,26,8776,16,6319,877,5442,23,396,8,15
14135,10,6216,9,194,102,92,2,30,1,1
13152,15,25841,11,3623,1718,1905,17,186,10,7
12678,676,16991,475,130,70,60,2,5,1,1
6779,15,19066,11,18510,706,17804,22,16,6,16
5436,15,17069,11,419378,16035,403343,506,132,226,280
13962,26,8087,16,229587,8510,221077,245,121,82,163
337,183,991,121,3790,1685,2105,18,17,10,8
13616,10,26793,9,194,102,92,2,29,1,1
15972,10,23296,9,193,102,91,2,29,1,1
9942,26,14063,16,207859,77557,130302,849,753,312,537
22013,10,8185,9,526,197,329,6,49,3,3
2813,10,11556,9,244,98,146,2,32,1,1
6790,26,16806,16,4614,853,3761,16,127,9,7
8159,15,3462,11,1114,534,580,12,15,7,5
4180,26,26730,16,6406,1614,4792,24,17,13,11
15829,10,1054,9,373,107,266,4,45,2,2
8601,10,19708,9,720,94,626,2,30,1,1
13190,26,16334,16,3350,1804,1546,19,255,10,9
15384,10,15219,9,178,94,84,2,30,1,1
13817,10,9073,9,198,101,97,2,31,1,1
22707,26,3497,16,92157,4519,87638,105,15,39,66
15642,10,14727,9,193,102,91,2,30,1,1
17610,26,23241,16,10642,3654,6988,26,125,14,12
6032,676,10658,475,130,70,60,2,6,1,1
14289,2534,3612,1970,70,70,0,2,8,2,0
22073,10,25521,9,196,102,94,2,30,1,1
17174,26,9421,16,4738,1023,3715,18,66,10,8
15957,10,24549,9,179,94,85,2,31,1,1
9186,10,16885,9,174,89,85,2,30,1,1
20605,10,8603,9,234,234,0,4,47,4,0
17651,26,7634,16,3726,688,3038,14,119,7,7
12012,26,10495,16,23067,5901,17166,43,73,21,22
1096,26,18025,16,7461,1448,6013,22,35,11,11
21214,26,21807,16,6822,3370,3452,21,135,10,11
12483,1404,11999,1067,70,70,0,1,5,1,0
20485,26,13120,16,304,86,218,2,30,1,1
532,247,0,0,3354,1792,1562,46,193,23,23
15318,10,20257,9,209,110,99,2,30,1,1
9668,10,27692,9,193,102,91,2,30,1,1
18355,10,15183,9,213,86,127,2,30,1,1
13883,10,12272,9,193,102,91,2,30,1,1
11240,702,23592,500,70,70,0,1,5,1,0
4616,23,0,0,6435,2535,3900,22,30,11,11
15863,10,10546,9,177,94,83,2,29,1,1
16442,26,8910,16,140109,5229,134880,159,46,59,100
18170,15,3815,11,31418,1784,29634,37,126,14,23
20927,26,27065,16,10576,3685,6891,46,92,24,22
22379,10,8152,9,299,99,200,4,45,2,2
4167,26,23017,16,13480,8545,4935,35,94,19,16
11063,1885,27248,1439,70,70,0,2,8,2,0
449,188,28021,123,338,110,228,2,299,1,1
15501,10,14367,9,172,88,84,2,30,1,1
13614,10,2978,9,448,184,264,6,30,3,3
21129,630,10903,436,70,70,0,1,4,1,0
8401,10,26425,9,177,94,83,2,30,1,1
14968,10,7239,9,183,94,89,2,30,1,1
9050,10,10762,9,275,94,181,2,30,1,1
17156,26,6730,16,4005,1421,2584,14,136,7,7
21684,10,3769,9,270,110,160,2,30,1,1
16428,26,11434,16,8366,2018,6348,32,104,17,15
8386,2613,1103,2025,624,318,306,10,15,5,5
5873,26,25285,16,9152383,160511,8991872,8428,252,2261,6167
8011,26,16464,16,6426,1858,4568,22,16,12,10
532,247,0,0,3498,1872,1626,48,200,24,24
18695,26,25536,16,8175,3047,5128,26,165,12,14
15939,10,4038,9,184,94,90,2,29,1,1
14075,26,17079,16,6686,923,5763,19,15,11,8
13938,10,28869,9,199,102,97,2,29,1,1
563,15,2109,11,138678,5557,133121,152,16,58,94
2744,1245,4326,925,890,126,764,2,31,1,1
5746,234,3838,149,4065,2585,1480,28,40,14,14
7314,10,19882,9,229,90,139,2,30,1,1
11094,15,21657,11,2125,709,1416,11,16,5,6
14850,10,827,9,184,94,90,2,30,1,1
10876,15,8870,11,366,240,126,7,31,5,2
14447,10,28452,9,168,86,82,2,30,1,1
15779,10,23395,9,184,102,82,2,30,1,1
16132,15,25462,11,40484,2008,38476,47,145,17,30
21506,10,3083,9,198,101,97,2,31,1,1
3308,26,2958,16,9262,2792,6470,53,616,28,25
10719,18,3730,13,184,94,90,2,29,1,1
21776,10,5169,9,182,93,89,2,31,1,1
4676,26,2100,16,499,425,74,4,0,3,1
14018,10,15452,9,289,97,192,4,45,2,2
7639,676,11863,475,130,70,60,2,5,1,1
18533,910,15229,673,70,70,0,2,8,2,0
8818,15,28270,11,372,192,180,7,42,4,3
5280,26,10148,16,8286,2195,6091,24,256,12,12
15574,10,22553,9,177,94,83,2,31,1,1
16509,8,9983,8,1370,496,874,16,16,8,8
18286,10,22505,9,205,86,119,2,30,1,1
15571,10,7766,9,711,87,624,2,30,1,1
9563,15,17667,11,3664,1440,2224,12,23,6,6
10843,26,7710,16,130,70,60,3,5,2,1
14209,10,2247,9,166,85,81,2,30,1,1
14250,1650,7052,1267,70,70,0,1,5,1,0
4565,26,614,16,3950,2949,1001,26,69,15,11
12451,2643,3052,2051,70,70,0,2,8,2,0
14630,10,11849,9,183,94,89,2,30,1,1
11354,26,2827,16,134,60,74,3,10,2,1
2744,1293,28153,971,889,126,763,2,30,1,1
6371,232,2564,147,420,156,264,7,18,3,4
7232,10,6571,9,199,94,105,2,30,1,1
2744,1238,207,918,883,126,757,2,30,1,1
15600,10,8364,9,198,94,104,2,30,1,1
22663,26,14550,16,355358,10960,344398,369,16,131,238
12715,26,11543,16,499,425,74,4,1,3,1
8200,15,6623,11,130,70,60,2,15,1,1
16021,1432,17426,1087,1660,677,983,20,1595,10,10
11018,26,19993,16,10492,3167,7325,40,15,24,16
20672,26,5009,16,7124,3843,3281,42,126,20,22
7733,26,5412,16,7669,3355,4314,33,38,19,14
13982,10,27549,9,212,110,102,2,30,1,1
11929,26,25460,16,9246,1808,7438,35,92,17,18
8396,353,9363,226,2049,1276,773,15,15,8,7
16021,1538,7843,1172,481,150,331,2,1199,1,1
7574,234,17612,149,9263,549,8714,17,3638,5,12
15069,10,808,9,165,86,79,2,30,1,1
9549,346,21956,220,3985,2010,1975,17,51,10,7
13884,10,11677,9,168,86,82,2,31,1,1
14327,10,1260,9,271,103,168,4,59,2,2
854,15,1376,11,639,279,360,8,121,4,4
2639,15,11091,11,642,338,304,10,33,6,4
6250,2010,15155,1540,1346,662,684,8,32,4,4
18135,15,26621,11,12881,767,12114,21,21,9,12
9096,10,18742,9,195,102,93,2,30,1,1
22524,10,15787,9,193,102,91,2,30,1,1
8713,26,4000,16,6180,1249,4931,14,20,8,6
15753,10,17449,9,229,110,119,2,30,1,1
5644,26,22393,16,8296,3123,5173,40,132,14,26
10908,445,3014,285,66,66,0,1,5,1,0
3133,2305,8502,1789,330,330,0,6,3609,6,0
1416,26,4909,16,6981,948,6033,17,27,10,7
20594,26,12736,16,4994,379,4615,9,15,4,5
22684,10,6694,9,209,110,99,2,30,1,1
5969,10,6381,9,359,86,273,2,30,1,1
5525,10,27688,9,168,78,90,2,30,1,1
18458,288,7720,185,70,70,0,1,5,1,0
14356,10,7425,9,195,102,93,2,29,1,1
5203,26,25199,16,83444,15305,68139,121,148,51,70
4870,26,10184,16,9486,2668,6818,26,81,14,12
18453,2900,23797,2252,70,70,0,1,5,1,0
6071,26,1780,16,11570,3005,8565,43,255,20,23
8598,234,26530,149,10635,3087,7548,41,3661,22,19
918,15,12722,11,318,192,126,6,29,4,2
22577,10,10514,9,194,99,95,2,30,1,1
21948,26,6690,16,61890,2830,59060,73,120,27,46
18845,26,18684,16,1157,817,340,10,26,5,5
15447,10,16112,9,184,94,90,2,30,1,1
1489,10,5264,9,216,82,134,2,32,1,1
15264,10,9214,9,738,86,652,2,30,1,1
15322,26,997,16,19030,7323,11707,51,122,23,28
10416,295,22431,190,3132,815,2317,14,16,7,7
21442,10,5592,9,197,102,95,2,29,1,1
10964,26,17222,16,9735,2891,6844,36,82,17,19
1457,10,5103,9,235,90,145,2,32,1,1
9,18,9549,13,184,94,90,2,29,1,1
7048,26,13687,16,306066,33556,272510,414,196,162,252
16129,15,28559,11,2769,1396,1373,11,29,7,4
10487,26,928,16,15947,5526,10421,38,622,16,22
7868,10,20045,9,168,78,90,2,29,1,1
22067,10,24486,9,167,86,81,2,30,1,1
9,18,18197,13,184,94,90,2,30,1,1
2046,2627,3270,2037,459,149,310,2,1200,1,1
8249,26,11500,16,10338,3346,6992,27,19,15,12
9701,15,3826,11,318,192,126,6,26,4,2
15055,10,14873,9,198,101,97,2,31,1,1
13693,26,11477,16,8209,2789,5420,24,42,14,10
9633,26,19715,16,1268,638,630,12,17,7,5
12807,591,13892,402,70,70,0,1,4,1,0
13726,10,2968,9,177,94,83,2,30,1,1
15194,26,5643,16,7982,1962,6020,20,15,11,9
8740,10,4842,9,337,110,227,2,30,1,1
17004,26,415,16,15202,6356,8846,40,119,22,18
17591,26,17053,16,5817,1995,3822,19,16,10,9
21605,10,13191,9,225,102,123,2,29,1,1
21306,1926,25013,1470,66,66,0,2,7,2,0
636,2692,23659,2091,228,118,110,2,1199,1,1
14014,10,7147,9,199,102,97,2,30,1,1
8577,10,1995,9,764,99,665,2,31,1,1
15201,10,7114,9,224,102,122,2,30,1,1
20696,10,28130,9,197,90,107,2,30,1,1
15310,15,28186,11,194,128,66,4,25,3,1
18204,10,0,0,216,84,132,2,30,1,1
12483,26,24503,16,3201,1057,2144,13,135,6,7
21210,26,23610,16,14647,2365,12282,22,136,10,12
22020,10,5942,9,178,94,84,2,30,1,1
10027,15,25167,11,9046,1139,7907,20,255,11,9
12509,3016,8329,2344,70,70,0,1,5,1,0
15586,10,21821,9,178,94,84,2,29,1,1
18790,923,14715,681,70,70,0,2,8,2,0
8800,10,25232,9,718,94,624,2,30,1,1
22575,10,18048,9,197,102,95,2,30,1,1
14243,622,6875,429,70,70,0,1,5,1,0
1503,10,5326,9,224,88,136,2,30,1,1
14335,1226,18029,906,320,140,180,6,6,3,3
9411,3115,14249,2419,132,132,0,3,1201,3,0
10998,26,6004,16,122815,48545,74270,164,95,76,88
7598,26,7828,16,565251,13665,551586,542,30,173,369
4940,26,4746,16,600,156,444,8,25,2,6
14550,10,6271,9,168,86,82,2,30,1,1
16489,15,25695,11,21684,903,20781,30,41,12,18
9829,15,2582,11,63891,26626,37265,86,34,39,47
1891,183,7179,121,4695,2520,2175,22,19,13,9
15438,10,4840,9,177,94,83,2,31,1,1
14492,2882,10974,2238,481,150,331,2,1200,1,1
8372,10,7973,9,194,102,92,2,31,1,1
14528,10,10318,9,184,94,90,2,30,1,1
22515,10,12083,9,395,102,293,2,30,1,1
18870,26,20741,16,14519,9445,5074,35,15,20,15
14527,10,25911,9,371,109,262,4,59,2,2
1003,26,2823,16,4458,1022,3436,16,26,9,7
20600,15,238,11,18032,904,17128,22,15,7,15
10525,26,22709,16,194,70,124,3,11,1,2
5335,15,23724,11,78,78,0,1,5,1,0
10498,26,19534,16,42419,28515,13904,108,246,53,55
3290,26,7688,16,76969,3534,73435,97,34,40,57
4222,26,12639,16,6131,1384,4747,27,50,15,12
8720,26,7530,16,7540,1840,5700,18,15,10,8
11106,1401,12352,1064,66,66,0,1,5,1,0
15138,10,27266,9,183,94,89,2,30,1,1
13972,10,15573,9,199,102,97,2,30,1,1
8439,10,2953,9,196,100,96,2,30,1,1
11267,765,2977,553,70,70,0,1,5,1,0
10989,2119,25622,1633,70,70,0,2,8,2,0
14696,10,2480,9,216,110,106,2,30,1,1
2156,10,8657,9,233,90,143,2,32,1,1
5100,26,17210,16,379440,8281,371159,362,16,106,256
9081,26,16403,16,7645,2967,4678,23,15,13,10
9716,15,20059,11,62,62,0,1,5,1,0
12740,10,24085,9,270,168,102,3,30,2,1
10700,1178,18642,869,9415,9415,0,11,30,11,0
15305,10,11835,9,177,94,83,2,30,1,1
12632,1,5171,1,70,70,0,2,7,2,0
2744,1238,7496,918,888,126,762,3,32,2,1
13024,26,16444,16,499,425,74,4,0,3,1
12639,10,16936,9,213,78,135,2,30,1,1
4896,26,5502,16,281978,16098,265880,405,67,204,201
3311,10,8435,9,199,94,105,2,30,1,1
14607,10,3447,9,177,94,83,2,31,1,1
13768,10,26936,9,756,95,661,2,31,1,1
14722,26,7151,16,6103,2710,3393,58,212,28,30
21205,1208,25333,894,66,66,0,2,8,2,0
8896,26,17311,16,3233,1141,2092,14,135,7,7
15120,26,14377,16,8659,1687,6972,30,55,16,14
10976,26,13293,16,2666,1542,1124,17,17,9,8
2744,212,5345,137,881,126,755,2,30,1,1
16007,26,25914,16,19175423,168230,19007193,15129,313,2298,12831
21538,10,22615,9,211,94,117,2,30,1,1
2744,1238,941,918,878,126,752,2,30,1,1
22508,10,24748,9,216,110,106,2,30,1,1
4375,26,22289,16,5814771,76275,5738496,4959,154,976,3983
3576,15,22707,11,1248,660,588,8,15,4,4
21642,10,5437,9,183,94,89,2,31,1,1
15943,10,3811,9,186,95,91,2,31,1,1
9411,3060,11493,2376,481,150,331,2,1200,1,1
22368,10,28552,9,177,94,83,2,30,1,1
5541,10,17220,9,235,90,145,2,32,1,1
16366,26,15732,16,6394,3923,2471,42,176,22,20
16490,10,25696,9,237,91,146,2,32,1,1
8368,820,3899,600,70,70,0,2,8,2,0
11154,500,21218,328,66,66,0,1,5,1,0
19844,26,2738,16,3262,256,3006,9,121,4,5
18652,232,16957,147,5564,2206,3358,50,310,20,30
5906,26,21278,16,78,78,0,1,5,1,0
7784,15,9065,11,75931,3459,72472,97,43,38,59
4697,26,3555,16,702409,17257,685152,698,32,233,465
12020,458,10479,296,320,140,180,6,5,3,3
7918,26,9376,16,190,70,120,4,14,2,2
10922,2376,14922,1848,70,70,0,2,8,2,0
5978,26,27253,16,680618,28384,652234,828,84,356,472
20551,10,2024,9,304,86,218,2,30,1,1
8365,3236,18280,2507,70,70,0,2,8,2,0
11023,15,25025,11,482,300,182,9,25,6,3
4586,26,27757,16,11389,4837,6552,27,120,13,14
15673,10,9529,9,186,95,91,2,30,1,1
13121,26,327,16,172701,6397,166304,202,246,72,130
15728,10,23046,9,177,94,83,2,30,1,1
19484,10,21807,9,246,246,0,4,47,4,0
3973,26,6964,16,10848,4083,6765,37,16,21,16
7478,10,1549,9,164,78,86,2,31,1,1
4265,26,3277,16,6043,1568,4475,11,119,4,7
8379,10,539,9,183,94,89,2,30,1,1
13613,10,24262,9,211,110,101,2,31,1,1
14265,10,4982,9,209,110,99,2,30,1,1
15174,26,15876,16,348780,9144,339636,358,32,123,235
7132,10,19620,9,213,79,134,2,32,1,1
14900,10,24863,9,216,82,134,2,32,1,1
14722,10,18036,9,167,86,81,2,30,1,1
15734,10,14533,9,196,102,94,2,31,1,1
11196,2957,8300,2294,66,66,0,1,5,1,0
15556,10,12164,9,424,108,316,4,55,2,2
11192,681,14440,480,70,70,0,2,7,2,0
15352,10,14821,9,210,94,116,2,30,1,1
14564,10,23241,9,184,94,90,2,30,1,1
19849,26,3635,16,1864,250,1614,8,120,4,4
6659,26,7576,16,10274,3806,6468,26,413,14,12
10855,15,6371,11,540,540,0,10,194,10,0
12656,26,23195,16,499,425,74,4,0,3,1
8615,10,4988,9,216,110,106,2,30,1,1
8724,10,16563,9,193,102,91,2,29,1,1
172,10,27937,9,210,78,132,2,30,1,1
12302,26,7415,16,5931,1750,4181,24,48,14,10
12640,26,8977,16,499,425,74,4,0,3,1
14367,345,12495,219,70,70,0,2,7,2,0
21842,10,19215,9,179,94,85,2,30,1,1
22685,10,365,9,198,94,104,2,31,1,1
21278,10,8612,9,193,102,91,2,31,1,1
8210,1313,21194,990,150,150,0,1,1200,1,0
14850,10,10871,9,184,94,90,2,29,1,1
16189,234,18940,149,2391,1434,957,16,3601,8,8
15070,10,1473,9,212,102,110,2,30,1,1
6006,10,21918,9,199,94,105,2,30,1,1
21659,10,18653,9,193,102,91,2,30,1,1
10825,15,3701,11,3955,2325,1630,18,47,11,7
21358,3185,9085,2471,66,66,0,2,8,2,0
13152,26,7828,16,11828,2811,9017,31,76,16,15
13820,10,254,9,774,101,673,2,0,1,1
15070,26,15487,16,3715,1659,2056,35,188,18,17
4957,15,17468,11,543,469,74,6,16,5,1
8876,10,384,9,183,102,81,2,30,1,1
20666,26,21810,16,4882,2412,2470,32,155,16,16
13896,26,19124,16,1271,918,353,9,15,6,3
22392,1238,4495,918,275,78,197,2,29,1,1
8667,10,19979,9,343,92,251,4,32,2,2
15003,10,19930,9,177,94,83,2,29,1,1
16459,15,27540,11,2362,1608,754,22,80,12,10
22394,10,9100,9,196,94,102,2,29,1,1
8990,10,13101,9,336,110,226,2,31,1,1
17666,15,28986,11,1114,534,580,12,16,7,5
4949,26,12494,16,6978,1169,5809,22,163,12,10
21565,10,4133,9,308,94,214,2,30,1,1
15000,10,14131,9,177,94,83,2,29,1,1
532,247,0,0,3562,1936,1626,48,196,24,24
12034,3012,17334,2342,70,70,0,1,5,1,0
9641,15,883,11,19946,10573,9373,29,25,14,15
9149,26,658,16,10737,3664,7073,20,137,10,10
21962,10,9461,9,285,94,191,2,31,1,1
7288,15,4784,11,48495,10969,37526,83,477,39,44
7943,26,28144,16,172,172,0,2,4,2,0
8207,26,5651,16,8192,2071,6121,23,361,10,13
21213,10,10754,9,179,94,85,2,31,1,1
5213,15,16770,11,8429,1098,7331,16,20,8,8
10931,708,8742,506,316,136,180,6,6,3,3
12000,395,13453,256,70,70,0,2,8,2,0
10824,15,12465,11,5480,3236,2244,19,47,12,7
5361,26,21256,16,6417,1255,5162,24,360,12,12
15450,10,24481,9,711,87,624,2,31,1,1
10314,26,28728,16,12171,2763,9408,53,17,30,23
9644,10,10604,9,166,86,80,2,30,1,1
15500,10,25234,9,183,94,89,2,30,1,1
4825,15,4442,11,214,140,74,4,15,3,1
5648,26,354,16,7128,1336,5792,22,83,11,11
12385,1700,10511,1299,70,70,0,1,5,1,0
22619,10,28978,9,516,86,430,4,32,2,2
21265,2163,18303,1671,66,66,0,2,7,2,0
21967,26,2382,16,6372,1582,4790,32,195,15,17
8584,1238,24859,918,258,71,187,2,30,1,1
15840,26,20255,16,7792,2318,5474,38,27,22,16
22380,10,14012,9,256,93,163,2,31,1,1
8746,10,9017,9,192,98,94,2,30,1,1
22495,10,26811,9,177,94,83,2,30,1,1
16951,255,25970,160,66,66,0,1,4,1,0
8697,15,25586,11,78,78,0,1,5,1,0
12962,26,22924,16,3334,331,3003,10,120,5,5
12032,2435,22437,1894,698,320,378,10,17,6,4
4278,26,19544,16,2930,1614,1316,16,249,9,7
22190,10,4718,9,254,102,152,2,30,1,1
4225,26,23624,16,812,440,372,14,25,8,6
6159,26,16125,16,14271,2106,12165,42,227,17,25
14932,10,819,9,195,102,93,2,30,1,1
9773,26,4167,16,1048,1048,0,9,17,9,0
8839,10,22635,9,421,88,333,4,39,2,2
19641,26,27454,16,21703,2433,19270,44,76,18,26
2457,183,10206,121,3910,1805,2105,20,18,12,8
22414,10,15073,9,192,98,94,2,31,1,1
18791,1989,20131,1519,316,136,180,6,7,3,3
10030,26,1562,16,8480,2236,6244,27,81,15,12
12733,26,6325,16,499,425,74,4,0,3,1
6980,26,12665,16,3181,1647,1534,18,31,10,8
6867,15,14350,11,26085,2508,23577,52,38,29,23
8289,15,11535,11,1105,624,481,13,316,7,6
12550,15,28698,11,2499,531,1968,11,75,6,5
14859,10,17931,9,193,102,91,2,30,1,1
19640,26,27453,16,220115,6038,214077,231,76,78,153
22528,10,22072,9,216,102,114,2,30,1,1
13749,10,16737,9,474,200,274,6,43,3,3
13740,10,52,9,183,94,89,2,31,1,1
22424,10,20326,9,197,102,95,2,30,1,1
17623,10,11258,9,218,78,140,2,29,1,1
14757,10,23815,9,193,102,91,2,29,1,1
13020,26,1626,16,10323,2834,7489,44,256,21,23
4170,26,18031,16,4310,1640,2670,22,159,10,12
9584,10,18945,9,216,110,106,2,30,1,1
18892,26,7745,16,7454,3131,4323,23,46,13,10
15896,26,28459,16,1778020,204978,1573042,2589,987,1006,1583
5894,26,4593,16,234,234,0,4,11,4,0
5290,26,22573,16,3221,2218,1003,16,15,8,8
10405,26,20855,16,6250,1422,4828,20,17,10,10
22069,10,7963,9,198,101,97,2,31,1,1
18535,392,14595,254,199,75,124,4,59,2,2
7734,26,22729,16,2011,1238,773,16,330,9,7
15075,10,11392,9,177,94,83,2,30,1,1
14636,26,13815,16,3250,1058,2192,13,136,6,7
22162,10,4101,9,765,102,663,2,30,1,1
18953,26,852,16,1547,960,587,14,17,8,6
9409,10,25117,9,164,86,78,2,29,1,1
7135,10,4135,9,198,93,105,2,30,1,1
21813,10,14799,9,179,94,85,2,30,1,1
8584,1238,27650,918,258,78,180,2,30,1,1
14561,10,6950,9,194,99,95,2,31,1,1
9728,1716,15829,1311,509,150,359,2,1200,1,1
22100,10,23259,9,209,110,99,2,30,1,1
13932,26,2765,16,15679,1532,14147,16,139,3,13
4653,26,19620,16,11226,3029,8197,36,55,18,18
9239,26,1734,16,15595,3264,12331,26,35,14,12
12700,10,23646,9,197,90,107,2,30,1,1
6591,26,17507,16,9624,2231,7393,24,22,14,10
16849,26,26666,16,1640,831,809,18,43,10,8
21399,10,1415,9,183,94,89,2,30,1,1
21998,10,15060,9,445,86,359,2,29,1,1
17510,18,22850,13,184,94,90,2,30,1,1
13960,10,5285,9,239,102,137,2,30,1,1
6250,2009,1738,1539,146,84,62,2,31,1,1
22200,10,5490,9,167,86,81,2,30,1,1
21449,10,6896,9,176,90,86,2,31,1,1
15819,10,5252,9,180,94,86,2,30,1,1
14484,10,4795,9,198,110,88,2,29,1,1
16134,10,18126,9,168,78,90,2,30,1,1
15204,10,10535,9,183,94,89,2,30,1,1
3412,10,2772,9,86,86,0,1,30,1,0
8510,10,13985,9,202,103,99,2,31,1,1
18136,10,16037,9,312,82,230,2,31,1,1
10128,26,25483,16,6765,1108,5657,17,18,10,7
11109,15,27304,11,366,240,126,7,25,5,2
22312,10,10772,9,772,102,670,2,30,1,1
21094,3076,1564,2389,70,70,0,1,5,1,0
10872,1334,21794,1009,70,70,0,1,5,1,0
18631,26,3351,16,27150,3104,24046,55,157,24,31
21389,10,0,0,200,90,110,2,30,1,1
21836,10,289,9,211,110,101,2,30,1,1
10899,26,26632,16,4435,1290,3145,17,31,9,8
9153,26,1590,16,300,168,132,4,6,2,2
15434,1575,20192,1205,70,70,0,1,5,1,0
21700,10,12595,9,196,102,94,2,30,1,1
22462,10,439,9,738,86,652,2,30,1,1
507,1807,17126,1377,179518,128,179390,173,37,3,170
5494,26,19382,16,2211,1181,1030,23,40,11,12
21260,26,2042,16,5237,2844,2393,14,135,7,7
12642,26,19086,16,499,425,74,4,0,3,1
7516,26,1531,16,22641,10532,12109,62,200,35,27
13220,26,19706,16,4227,1086,3141,15,29,8,7
9479,15,23400,11,442,250,192,8,47,5,3
6999,280,20065,177,150,150,0,1,1200,1,0
2744,1238,11528,918,887,126,761,2,30,1,1
9722,15,23401,11,1114,534,580,12,16,7,5
15702,26,17157,16,2162,1317,845,16,25,9,7
10703,10,22598,9,200,90,110,2,30,1,1
6258,26,5392,16,13090,9437,3653,43,188,14,29
5956,15,13717,11,1484,877,607,11,34,6,5
20204,26,15317,16,32504,1730,30774,44,122,17,27
21226,10,23086,9,216,110,106,2,31,1,1
15129,10,3192,9,199,102,97,2,30,1,1
7650,26,11767,16,622,70,552,10,180,2,8
15162,10,7330,9,177,94,83,2,29,1,1
17925,26,16945,16,36149,11297,24852,56,29,25,31
15042,10,11892,9,368,118,250,2,30,1,1
14895,10,4399,9,190,97,93,2,31,1,1
12209,26,2336,16,23215,18990,4225,44,405,24,20
8365,10,23537,9,308,118,190,2,30,1,1
7773,233,719,148,4269,1451,2818,22,3002,13,9
14258,10,4743,9,197,102,95,2,30,1,1
9548,15,3226,11,4242,3615,627,15,32,8,7
9093,10,9413,9,214,110,104,2,29,1,1
3295,26,12143,16,160821,7879,152942,201,141,88,113
782,7,3190,7,66,66,0,1,4,1,0
15807,26,13054,16,345315,16365,328950,459,36,206,253
8536,10,1228,9,182,93,89,2,31,1,1
18414,26,19059,16,5242,861,4381,17,16,9,8
22126,10,11674,9,182,93,89,2,31,1,1
9381,10,13112,9,775,102,673,2,30,1,1
18798,26,24860,16,5964,3582,2382,17,136,8,9
18447,3218,17513,2495,504,318,186,8,16,5,3
9031,10,2643,9,177,94,83,2,29,1,1
21756,10,23632,9,235,102,133,2,30,1,1
17236,26,6369,16,10014,6664,3350,28,17,14,14
7077,15,10438,11,1892,1014,878,10,21,6,4
13492,15,3325,11,448,78,370,6,24,1,5
14442,10,28836,9,192,98,94,2,30,1,1
2744,1621,13358,1243,873,126,747,2,30,1,1
14222,10,9468,9,167,86,81,2,30,1,1
8210,384,21194,247,152,152,0,1,1200,1,0
22205,26,13640,16,3547,1351,2196,17,135,8,9
1031,26,3324,16,4462,500,3962,13,15,7,6
11054,15,19274,11,422,240,182,8,25,5,3
10903,892,9187,660,70,70,0,1,5,1,0
14722,10,25960,9,167,86,81,2,29,1,1
22704,26,855,16,419763,12080,407683,429,16,147,282
9166,26,19876,16,25358,6778,18580,31,16,13,18
22442,10,25926,9,378,99,279,4,45,2,2
13831,26,18820,16,6389,1163,5226,19,25,11,8
14431,26,13171,16,62,62,0,1,4,1,0
8584,1233,15011,913,256,78,178,2,30,1,1
8706,10,18544,9,754,94,660,2,31,1,1
15137,10,7873,9,216,110,106,2,30,1,1
9410,26,11053,16,25435,5293,20142,104,138,54,50
14754,10,4127,9,624,188,436,6,60,3,3
19363,26,11210,16,18168,2973,15195,46,88,21,25
22305,10,28454,9,198,101,97,2,31,1,1
14022,26,2613,16,11771,2624,9147,50,20,25,25
9025,10,18245,9,198,102,96,2,30,1,1
8588,10,21476,9,247,98,149,2,32,1,1
13705,10,25068,9,167,86,81,2,30,1,1
22197,10,12760,9,180,94,86,2,30,1,1
16974,10,7128,9,167,78,89,2,29,1,1
21073,26,14075,16,9693,2010,7683,18,130,9,9
13711,15,10305,11,306,180,126,6,26,4,2
4995,26,16554,16,33344,25806,7538,105,130,56,49
14476,10,13511,9,196,102,94,2,30,1,1
14224,10,8078,9,177,94,83,2,30,1,1
13203,26,24113,16,18802,3386,15416,54,293,28,26
21244,10,20207,9,190,97,93,2,31,1,1
15256,26,24888,16,8654,2150,6504,20,15,11,9
21461,10,29077,9,262,94,168,2,30,1,1
21651,10,832,9,193,102,91,2,29,1,1
7982,26,5233,16,198,78,120,4,6,2,2
22682,10,20963,9,266,110,156,2,30,1,1
2744,1052,15242,775,881,126,755,2,29,1,1
6250,1992,16328,1522,205,83,122,4,30,2,2
14409,10,9029,9,170,87,83,2,30,1,1
11206,809,11610,589,70,70,0,2,8,2,0
15809,10,16209,9,183,94,89,2,30,1,1
2700,26,22634,16,21055,15996,5059,39,22,22,17
14737,10,18588,9,195,94,101,2,30,1,1
11119,753,9047,541,70,70,0,2,9,2,0
5118,26,4105,16,90177,3481,86696,96,15,31,65
13131,26,11158,16,12594,5098,7496,32,35,17,15
10329,305,12018,199,416,210,206,7,16,4,3
2046,2063,11215,1589,491,150,341,2,1200,1,1
7955,26,1861,16,12403,2139,10264,38,22,19,19
8584,1239,11402,919,231,71,160,2,30,1,1
14301,10,14624,9,179,94,85,2,31,1,1
13677,26,11349,16,8527,2218,6309,30,26,17,13
15303,10,17521,9,744,95,649,2,31,1,1
21208,10,12947,9,196,94,102,2,30,1,1
10159,15,14058,11,134,60,74,3,4,2,1
17905,26,17398,16,134688,7027,127661,166,37,64,102
8880,10,8263,9,490,101,389,4,45,2,2
16021,2577,18690,1999,9414,7249,2165,91,3838,76,15
16169,15,25498,11,35197,3040,32157,40,32,14,26
22418,10,27091,9,193,102,91,2,31,1,1
17495,15,26274,11,109128,4773,104355,197,15,68,129
4671,234,3228,149,5509,2203,3306,22,3600,10,12
15057,26,16227,16,3041,1995,1046,17,16,8,9
8408,346,21388,220,12477,3635,8842,23,55,13,10
8718,10,17418,9,760,97,663,2,31,1,1
2744,69,12355,52,873,126,747,2,30,1,1
15558,26,1750,16,2281,1126,1155,25,120,12,13
22162,10,9446,9,182,93,89,2,31,1,1
21374,10,4867,9,227,110,117,2,30,1,1
15193,15,20090,11,234,234,0,4,12,4,0
14441,10,8119,9,194,102,92,2,30,1,1
11668,15,26068,11,1029,567,462,10,17,6,4
4062,7,15241,7,124,60,64,2,5,1,1
22178,10,22596,9,458,188,270,6,31,3,3
15370,26,27652,16,8021,2001,6020,20,15,11,9
17853,26,27046,16,512,166,346,2,29,1,1
15062,10,17111,9,214,110,104,2,30,1,1
10785,1109,23216,814,136,136,0,3,13,3,0
7786,26,17425,16,6318,1025,5293,17,33,9,8
13697,26,14806,16,37068,4085,32983,66,48,33,33
19457,10,27333,9,235,90,145,2,33,1,1
4067,26,15250,16,4378,1471,2907,19,28,11,8
15013,10,2497,9,701,88,613,2,31,1,1
21370,26,28497,16,17046,2620,14426,42,159,19,23
1709,10,27574,9,215,86,129,2,30,1,1
21256,26,4707,16,1270998,514773,756225,3073,2384,1413,1660
5908,26,25146,16,2080,1126,954,17,150,10,7
4777,26,26831,16,134,60,74,3,5,2,1
22576,10,3741,9,227,110,117,2,30,1,1
22558,10,29076,9,244,98,146,2,33,1,1
7571,15,7757,11,4294,1112,3182,15,199,4,11
15314,26,9579,16,795,795,0,2,169,2,0
15164,10,18082,9,197,102,95,2,29,1,1
22183,1249,6471,929,1012,462,550,4,30,2,2
9133,10,13436,9,199,102,97,2,30,1,1
14021,10,7980,9,94,94,0,1,30,1,0
14100,10,3171,9,193,102,91,2,30,1,1
5881,26,24779,16,8949,1938,7011,21,17,12,9
10834,1512,2453,1151,70,70,0,2,8,2,0
12051,3062,10864,2377,70,70,0,2,8,2,0
17868,26,22677,16,2633,1179,1454,20,74,8,12
7588,26,20268,16,4603,1696,2907,19,30,11,8
2744,1242,19284,922,880,126,754,2,30,1,1
10081,15,4525,11,942,527,415,11,342,6,5
9641,26,4320,16,1642025,26957,1615068,1478,17,406,1072
2744,1238,14387,918,876,126,750,2,30,1,1
16804,26,25454,16,170342,10231,160111,264,136,130,134
9483,26,27361,16,6441,1651,4790,22,53,12,10
12737,26,1267,16,10781,3635,7146,27,221,15,12
16053,295,25408,190,3562,1995,1567,16,15,9,7
17051,26,4856,16,10505,6856,3649,29,16,15,14
8625,26,3700,16,39932,34025,5907,52,21,34,18
21165,10,28395,9,247,98,149,2,32,1,1
8671,26,9213,16,3182,1568,1614,8,120,4,4
6834,26,10876,16,35920,26656,9264,60,128,30,30
10503,26,15106,16,322,66,256,6,16,2,4
17044,10,11390,9,368,86,282,2,30,1,1
18120,26,16102,16,346221,14712,331509,474,107,211,263
21964,10,4891,9,172,94,78,2,30,1,1
14316,10,12393,9,184,94,90,2,31,1,1
10584,26,26536,16,122,62,60,2,16,1,1
13879,10,6390,9,215,102,113,2,30,1,1
21803,26,1379,16,4158,2117,2041,11,120,6,5
15978,15,17310,11,10454,4931,5523,21,30,10,11
9723,26,15931,16,2707,1383,1324,29,36,16,13
15462,10,10163,9,177,94,83,2,30,1,1
15878,10,25470,9,199,102,97,2,30,1,1
15224,26,20986,16,3469,1006,2463,15,121,7,8
19161,26,12390,16,3135,1603,1532,22,632,7,15
636,1704,22958,1301,509,150,359,2,1200,1,1
13927,26,24654,16,2964,1657,1307,18,47,9,9
21245,10,47,9,214,102,112,2,30,1,1
22026,10,13182,9,182,102,80,2,30,1,1
10180,15,27090,11,4632,2660,1972,49,193,26,23
15107,15,24958,11,1915,1466,449,10,20,6,4
7196,15,8382,11,2259,1830,429,11,150,6,5
15110,10,2797,9,199,102,97,2,29,1,1
5606,2008,19975,1538,148,86,62,2,30,1,1
8584,1238,13679,918,260,78,182,2,30,1,1
19547,15,21537,11,134,60,74,3,5,2,1
8776,15,24322,11,378,192,186,7,41,4,3
13883,10,22531,9,259,87,172,4,56,2,2
7245,26,26706,16,3974,2015,1959,21,345,10,11
6495,26,19469,16,3149,1899,1250,19,15,9,10
9485,10,17852,9,181,94,87,2,29,1,1
21235,10,0,0,219,81,138,2,30,1,1
10062,26,5911,16,1786,172,1614,7,121,3,4
17651,10,19535,9,184,86,98,2,29,1,1
12639,188,9810,123,3736,1944,1792,58,91,29,29
14935,10,22576,9,200,94,106,2,30,1,1
12406,1790,28910,1366,70,70,0,2,7,2,0
5355,26,6119,16,89229,6918,82311,131,33,63,68
15208,26,16610,16,7889,1900,5989,20,15,11,9
12506,2577,27374,1999,736,490,246,8,17,4,4
21081,291,14154,187,66,66,0,2,8,2,0
9768,26,8,16,12712,3662,9050,32,140,17,15
3539,26,21356,16,17406,8237,9169,53,165,21,32
1192,26,23685,16,12677,10470,2207,42,80,23,19
9059,26,27553,16,493316,12157,481159,470,94,122,348
22491,10,6408,9,710,89,621,2,30,1,1
10349,26,27840,16,5747,1892,3855,19,16,11,8
15176,10,20258,9,177,94,83,2,30,1,1
8402,346,21382,220,2600,844,1756,13,136,7,6
6379,10,3970,9,86,86,0,1,30,1,0
18012,26,22839,16,13657,5248,8409,33,171,17,16
12634,1959,11257,1496,70,70,0,1,5,1,0
9490,26,2590,16,1385,868,517,12,30,6,6
10795,2703,11248,2099,70,70,0,2,7,2,0
12385,26,29067,16,20948,4141,16807,76,616,37,39
22534,10,8166,9,200,102,98,2,29,1,1
17096,26,19386,16,14463,9503,4960,34,17,17,17
15909,10,12077,9,193,102,91,2,30,1,1
15633,10,23947,9,177,94,83,2,30,1,1
3857,10,19080,9,339,94,245,2,30,1,1
15378,10,968,9,429,93,336,4,44,2,2
2246,10,9203,9,172,76,96,2,31,1,1
15087,10,18125,9,747,90,657,2,31,1,1
4653,26,27848,16,214,140,74,4,15,3,1
15001,10,17806,9,199,102,97,2,30,1,1
9117,10,19572,9,214,110,104,2,30,1,1
9381,10,28067,9,720,94,626,2,30,1,1
7487,26,20133,16,5337,2090,3247,22,39,13,9
21526,10,7801,9,180,94,86,2,31,1,1
22258,10,5698,9,199,102,97,2,29,1,1
12068,566,11934,380,70,70,0,2,7,2,0
14732,10,18525,9,259,86,173,2,30,1,1
3229,10,13774,9,194,87,107,2,30,1,1
8089,10,25329,9,198,93,105,2,30,1,1
21659,10,25132,9,182,93,89,2,31,1,1
1147,10,3857,9,230,91,139,2,30,1,1
6078,10,0,0,82,82,0,1,30,1,0
18406,15,6108,11,2005,1094,911,11,87,6,5
14080,10,6074,9,194,102,92,2,30,1,1
9264,10,25060,9,296,94,202,2,30,1,1
9194,10,17262,9,181,94,87,2,30,1,1
14547,26,8925,16,3363,797,2566,14,135,7,7
8130,26,6045,16,49428,2702,46726,70,136,30,40
7679,26,11124,16,4957,3488,1469,25,51,15,10
5553,26,20910,16,21785,5577,16208,35,362,16,19
21425,10,10845,9,183,94,89,2,30,1,1
169,15,12438,11,214,140,74,4,15,3,1
12345,183,23474,121,3549,1594,1955,18,18,10,8
10109,26,5191,16,3964,1908,2056,23,94,13,10
9769,26,10313,16,9588,1204,8384,29,93,15,14
18286,26,24539,16,126490514,2726981,123763533,123275,553,41466,81809
9728,1966,26763,1502,161,161,0,1,1200,1,0
14824,15,24818,11,44756,824,43932,45,15,12,33
12151,26,19259,16,7608,1340,6268,27,53,13,14
14912,10,21573,9,199,102,97,2,30,1,1
9344,183,21848,121,3473,1518,1955,17,19,9,8
14847,10,19546,9,166,85,81,2,31,1,1
6388,26,16823,16,4353,687,3666,14,25,8,6
10738,986,16408,727,70,70,0,1,5,1,0
19530,26,7433,16,126,60,66,3,10,2,1
16104,26,5178,16,21267,5407,15860,36,361,17,19
8377,26,8086,16,9530,2183,7347,45,256,21,24
15580,10,9225,9,182,93,89,2,31,1,1
15132,10,16937,9,762,97,665,2,30,1,1
8543,10,6336,9,391,134,257,2,30,1,1
17610,26,20314,16,2834,1700,1134,16,15,8,8
8359,10,7526,9,747,93,654,2,30,1,1
8728,15,5952,11,318,192,126,6,45,4,2
22349,10,10276,9,210,110,100,2,30,1,1
22695,26,1901,16,92243,4519,87724,105,16,39,66
8429,10,26677,9,168,86,82,2,30,1,1
8462,10,27150,9,164,86,78,2,29,1,1
9036,10,6318,9,216,94,122,2,30,1,1
3500,26,19298,16,24214,18131,6083,81,118,44,37
373,10,1136,9,832,106,726,2,30,1,1
1520,10,5390,9,823,98,725,2,30,1,1
18443,2821,23621,2189,70,70,0,2,8,2,0
8584,1238,29147,918,287,78,209,2,30,1,1
14493,10,24181,9,760,97,663,2,31,1,1
10226,15,27405,11,6504,3994,2510,26,47,14,12
21329,10,3104,9,276,94,182,4,56,2,2
2744,1238,18619,918,1758,252,1506,5,32,3,2
12418,1082,25022,794,320,140,180,6,5,3,3
12747,2286,6429,1771,70,70,0,1,4,1,0
11774,26,18773,16,5495,1303,4192,17,15,9,8
3066,2995,11259,2329,14172,5733,8439,79,1531,37,42
6940,26,8796,16,5715,1536,4179,24,16,13,11
11130,15,994,11,30068,3203,26865,43,35,19,24
17148,26,9627,16,1362,627,735,14,81,7,7
8350,10,10034,9,209,110,99,2,31,1,1
22181,1261,7211,941,741,462,279,2,30,1,1
15937,26,13584,16,5553,927,4626,16,15,10,6
14804,10,32,9,216,110,106,2,30,1,1
22694,26,5275,16,458741,13270,445471,469,16,164,305
8319,10,7115,9,307,105,202,4,31,2,2
22321,10,28053,9,301,95,206,4,36,2,2
11868,234,6907,149,1410,933,477,11,3600,6,5
21388,26,4551,16,14057427,329652,13727775,13768,110,4655,9113
3039,10,12633,9,213,87,126,2,31,1,1
13676,26,5222,16,14634,1801,12833,28,46,14,14
9097,10,2571,9,178,94,84,2,31,1,1
20562,10,283,9,512,166,346,2,30,1,1
13728,10,15442,9,181,94,87,2,30,1,1
15336,26,12221,16,8057,2037,6020,20,15,11,9
15273,15,9987,11,176644,9435,167209,266,65,104,162
14247,26,22286,16,13144,7075,6069,33,161,16,17
21719,10,1276,9,168,86,82,2,30,1,1
17217,15,25081,11,4107,3453,654,13,16,7,6
16951,255,25970,160,66,66,0,1,4,1,0
8195,15,21166,11,630,264,366,10,44,5,5
225,10,330,9,204,118,86,2,31,1,1
8584,1238,22870,918,266,78,188,2,30,1,1
14592,10,4177,9,711,87,624,2,30,1,1
2768,10,11431,9,398,255,143,3,34,2,1
14897,10,7803,9,733,86,647,2,31,1,1
1076,26,25392,16,5699,505,5194,14,15,7,7
10857,26,20392,16,11946,8904,3042,42,42,26,16
3589,26,1006,16,3191,1047,2144,13,135,6,7
14510,10,10596,9,757,102,655,2,30,1,1
7669,232,19692,147,12521,2892,9629,64,356,27,37
14292,10,23204,9,711,87,624,2,31,1,1
15235,26,5110,16,1579,988,591,13,25,7,6
15102,26,6121,16,344632,9074,335558,354,121,122,232
17665,10,26385,9,211,80,131,2,30,1,1
14189,10,15502,9,166,86,80,2,30,1,1
15227,10,5192,9,198,102,96,2,30,1,1
14366,26,12461,16,10875114,348643,10526471,11702,194,3853,7849
4712,26,22463,16,4883,1327,3556,18,135,9,9
6570,10,18771,9,237,91,146,2,32,1,1
14308,1085,13878,796,70,70,0,1,5,1,0
8401,10,27907,9,167,86,81,2,29,1,1
15193,26,19165,16,22938,14436,8502,43,41,23,20
22356,10,18840,9,170,87,83,2,30,1,1
15203,26,3409,16,6654,3821,2833,60,3037,30,30
22131,10,12258,9,199,102,97,2,29,1,1
19356,15,24167,11,366,180,186,7,93,4,3
2572,10,13272,9,404,261,143,3,30,2,1
15750,10,5619,9,78,78,0,1,30,1,0
15301,26,23953,16,4221,666,3555,13,15,7,6
15290,26,26827,16,8005,1985,6020,20,15,11,9
8365,3236,24684,2507,70,70,0,1,5,1,0
9028,10,10721,9,186,95,91,2,31,1,1
1012,26,16369,16,5687,499,5188,14,16,7,7
2744,1238,4780,918,885,126,759,2,30,1,1
4786,10,16281,9,222,90,132,2,30,1,1
10821,15,8921,11,1934,1083,851,9,15,5,4
16528,26,6122,16,9138,4704,4434,24,315,13,11
22718,10,2524,9,198,102,96,2,29,1,1
22204,10,21989,9,748,95,653,2,30,1,1
21293,10,26502,9,184,94,90,2,31,1,1
13133,26,26574,16,15567,5964,9603,27,21,14,13
11671,26,16933,16,257777,12962,244815,347,41,162,185
10762,2770,16414,2149,70,70,0,1,5,1,0
21464,10,23272,9,193,102,91,2,30,1,1
15402,10,24791,9,195,102,93,2,30,1,1
9590,15,1751,11,318,192,126,6,27,4,2
14337,1474,20921,1122,70,70,0,1,5,1,0
10731,15,18735,11,30853,2456,28397,48,78,25,23
13695,15,5201,11,486,240,246,9,35,5,4
15197,10,4394,9,214,110,104,2,30,1,1
2080,10,8212,9,404,259,145,3,32,2,1
13065,26,28752,16,29945,19086,10859,98,736,50,48
21805,26,27157,16,24686,1935,22751,36,16,17,19
15303,10,15123,9,164,84,80,2,31,1,1
14696,10,18942,9,701,88,613,2,30,1,1
22042,10,919,9,195,102,93,2,30,1,1
21726,10,9832,9,280,118,162,2,30,1,1
9995,15,20632,11,5874,744,5130,14,131,7,7
2775,26,1074,16,19477,14323,5154,45,309,22,23
11109,42,14537,25,70,70,0,2,8,2,0
21598,10,16924,9,499,94,405,2,29,1,1
22392,1238,20036,918,267,78,189,2,30,1,1
636,287,5757,184,228,118,110,2,1199,1,1
14332,10,18686,9,177,94,83,2,30,1,1
225,10,13793,9,204,118,86,2,30,1,1
13826,10,28573,9,780,93,687,2,31,1,1
8835,26,25309,16,6911,897,6014,22,28,10,12
7133,26,11519,16,130,70,60,3,5,2,1
17377,26,22406,16,4209,2056,2153,50,277,24,26
15524,10,10453,9,168,86,82,2,29,1,1
3133,2345,499,1829,330,330,0,6,3609,6,0
11290,2670,13622,2076,70,70,0,2,8,2,0
21590,26,11028,16,10099,4296,5803,30,124,13,17
19574,26,1893,16,8123,5308,2815,18,134,9,9
20807,26,5115,16,15135,12791,2344,43,81,22,21
21885,10,26814,9,195,102,93,2,29,1,1
7209,15,24183,11,138,78,60,2,5,1,1
10097,26,23947,16,13683,6075,7608,58,5113,23,35
3456,15,14276,11,1753,833,920,10,20,6,4
10576,216,22526,139,156,156,0,3,8,3,0
6250,1980,19786,1510,156,94,62,2,30,1,1
19989,26,27689,16,2882,1622,1260,20,86,10,10
9104,15,20274,11,1130,613,517,11,15,6,5
12375,10,2566,9,164,78,86,2,30,1,1
6270,26,3496,16,7593,2146,5447,21,10,12,9
22708,10,11507,9,321,102,219,2,30,1,1
10921,1062,14218,781,70,70,0,2,8,2,0
16951,255,25970,160,62,62,0,1,5,1,0
22466,10,5027,9,395,107,288,4,46,2,2
18270,15,24489,11,2589,1231,1358,9,28,5,4
17399,26,7867,16,6857,1727,5130,23,316,13,10
14013,10,20691,9,214,110,104,2,30,1,1
14715,10,24766,9,237,91,146,2,33,1,1
8562,10,7590,9,177,94,83,2,29,1,1
9004,26,21681,16,4645,1738,2907,19,30,11,8
22093,10,13398,9,166,86,80,2,30,1,1
15551,15,28316,11,214,140,74,4,35,3,1
10607,26,27877,16,400,70,330,7,17,2,5
481,10,1744,9,247,98,149,2,34,1,1
8545,10,24739,9,268,94,174,2,30,1,1
20557,10,23737,9,86,86,0,1,30,1,0
16186,10,20066,9,70,70,0,1,30,1,0
9116,10,21200,9,195,102,93,2,30,1,1
3408,26,26416,16,14176,1843,12333,30,201,16,14
18464,1463,12275,1114,70,70,0,2,8,2,0
7558,15,14190,11,1518,954,564,14,320,8,6
15005,10,3288,9,184,94,90,2,30,1,1
3399,26,25193,16,8340,2896,5444,28,16,16,12
15437,26,3793,16,7819,1662,6157,20,76,11,9
12114,26,9999,16,6659,1215,5444,17,15,9,8
4886,26,16393,16,247172,58810,188362,325,90,174,151
15439,10,28914,9,200,102,98,2,31,1,1
13796,10,28548,9,711,87,624,2,30,1,1
8944,26,24982,16,10105,1951,8154,24,126,13,11
15755,10,7252,9,195,102,93,2,30,1,1
13802,10,20995,9,256,87,169,4,37,2,2
18460,2167,4925,1673,70,70,0,2,8,2,0
8584,1238,17671,918,250,78,172,2,30,1,1
8791,10,28640,9,251,102,149,2,30,1,1
11048,15,26625,11,4988,2667,2321,15,38,10,5
11185,3201,27494,2482,70,70,0,1,5,1,0
15832,10,9343,9,193,102,91,2,30,1,1
2995,10,12314,9,231,90,141,2,31,1,1
15605,10,23270,9,166,86,80,2,29,1,1
10784,78,24519,60,70,70,0,2,7,2,0
8560,26,17414,16,7129,1853,5276,27,316,13,14
8665,26,1923,16,8848,4908,3940,23,42,12,11
14905,10,0,0,629,73,556,2,30,1,1
14941,10,22211,9,814,110,704,2,30,1,1
21464,10,11682,9,193,102,91,2,30,1,1
13652,10,15295,9,174,89,85,2,31,1,1
21651,10,3569,9,199,102,97,2,31,1,1
14025,10,1733,9,720,94,626,2,30,1,1
14679,10,6007,9,199,102,97,2,31,1,1
13773,10,28552,9,196,100,96,2,31,1,1
8805,26,27556,16,5776,1079,4697,15,53,8,7
10767,10,1100,9,231,78,153,2,30,1,1
20315,26,20630,16,6676,2316,4360,34,318,16,18
18905,26,24624,16,622058,33681,588377,765,65,327,438
15877,10,7304,9,802,104,698,2,30,1,1
4644,26,20470,16,9845,2815,7030,26,37,15,11
13909,10,19235,9,177,94,83,2,30,1,1
8787,26,26433,16,14888,3555,11333,58,256,23,35
14399,10,10033,9,269,110,159,2,30,1,1
22628,10,2602,9,173,94,79,2,30,1,1
22023,10,14358,9,728,96,632,2,30,1,1
7648,26,22199,16,118,118,0,1,30,1,0
9584,10,17012,9,216,110,106,2,30,1,1
22323,10,24329,9,542,100,442,4,51,2,2
2744,1295,14432,973,872,126,746,2,30,1,1
8678,10,15500,9,195,102,93,2,30,1,1
13614,26,194,16,17670,2044,15626,53,316,21,32
11711,10,16710,9,338,94,244,2,30,1,1
5211,15,16766,11,20984,1380,19604,34,15,18,16
636,2413,16871,1878,150,150,0,2,1200,2,0
22245,10,13148,9,209,94,115,2,30,1,1
8498,10,28910,9,180,92,88,2,31,1,1
15350,412,13528,267,8223,3066,5157,30,33,15,15
11921,26,2332,16,3183,2180,1003,16,15,8,8
4743,26,21226,16,24415,3924,20491,45,48,22,23
12019,1912,17994,1458,70,70,0,1,5,1,0
8424,10,28919,9,164,84,80,2,30,1,1
2144,10,8584,9,217,82,135,2,32,1,1
2744,1627,508,1249,883,126,757,2,30,1,1
9088,10,8201,9,718,94,624,2,30,1,1
10959,2721,12114,2115,70,70,0,1,5,1,0
9091,15,2233,11,1141,636,505,10,45,6,4
13639,15,19315,11,2452,680,1772,9,17,6,3
18824,1989,28411,1519,316,136,180,6,6,3,3
15239,10,27670,9,774,101,673,2,31,1,1
15332,26,20489,16,6205,986,5219,16,25,10,6
21424,10,11690,9,194,102,92,2,31,1,1
8493,10,24845,9,765,102,663,2,30,1,1
14178,10,533,9,197,102,95,2,29,1,1
20181,10,11516,9,343,168,175,3,30,2,1
18112,26,29092,16,145369,7769,137600,224,21,106,118
21317,10,7098,9,226,102,124,2,29,1,1
6458,26,1399,16,7821,3237,4584,39,149,19,20
19326,15,3317,11,214,140,74,4,41,3,1
11252,513,28465,338,70,70,0,2,8,2,0
13965,10,11813,9,177,94,83,2,30,1,1
11818,15,7326,11,1659,653,1006,10,16,6,4
13984,10,4507,9,396,102,294,2,30,1,1
13205,15,6475,11,95298,61941,33357,182,929,95,87
15248,26,9960,16,6693,1072,5621,18,26,10,8
21799,10,22767,9,258,102,156,2,30,1,1
21616,10,8820,9,193,94,99,2,31,1,1
20387,10,24946,9,205,86,119,2,29,1,1
9025,10,20093,9,261,94,167,2,30,1,1
10683,15,18329,11,1965,1402,563,13,16,7,6
17114,26,22168,16,1549485,41822,1507663,1612,179,520,1092
4745,26,21151,16,3338,2337,1001,18,45,11,7
6462,26,16308,16,134,60,74,3,5,2,1
21803,10,2762,9,184,94,90,2,31,1,1
22357,10,18894,9,168,86,82,2,31,1,1
10548,26,22303,16,29265,2836,26429,47,16,21,26
5689,26,21239,16,3635,2114,1521,22,515,13,9
3638,10,14600,9,217,87,130,2,30,1,1
14372,10,8619,9,199,102,97,2,30,1,1
8437,10,11792,9,216,110,106,2,31,1,1
6572,6,18774,6,8157,3445,4712,59,43,28,31
10970,15,16028,11,366,240,126,7,27,5,2
2724,1240,19681,920,422,164,258,6,30,3,3
7085,26,1257,16,7912,2739,5173,26,516,14,12
21391,10,21780,9,184,94,90,2,31,1,1
21738,10,27904,9,477,87,390,4,37,2,2
14950,10,3184,9,186,95,91,2,31,1,1
21630,10,12484,9,186,95,91,2,31,1,1
5981,26,8484,16,1251209,30056,1221153,1238,85,386,852
17374,26,19395,16,7066,1861,5205,32,1262,17,15
6063,26,18462,16,153,93,60,2,5,1,1
13736,10,10433,9,325,110,215,4,44,2,2
16689,26,25827,16,4661,1754,2907,19,26,11,8
14164,10,17248,9,183,94,89,2,30,1,1
11195,15,15047,11,1945,1002,943,11,19,7,4
21427,10,3978,9,323,90,233,4,48,2,2
11190,26,10890,16,956,420,536,15,26,7,8
13907,10,23132,9,183,94,89,2,30,1,1
14241,10,68,9,177,94,83,2,30,1,1
12363,1427,23124,1083,320,140,180,6,7,3,3
15931,10,25908,9,216,102,114,2,30,1,1
15492,10,11211,9,170,87,83,2,30,1,1
15545,10,11846,9,177,94,83,2,30,1,1
10486,15,22470,11,11369,3404,7965,28,26,14,14
21478,10,156,9,183,94,89,2,30,1,1
9337,26,2159,16,6350,1071,5279,18,42,10,8
11106,15,809,11,366,240,126,7,26,5,2
9728,827,12994,607,161,161,0,2,1199,2,0
14384,10,20284,9,170,87,83,2,30,1,1
14409,10,10723,9,816,102,714,2,29,1,1
22161,10,11458,9,744,89,655,2,30,1,1
15539,15,26791,11,214,140,74,4,30,3,1
13799,26,20440,16,5897,1982,3915,20,18,11,9
636,280,16615,177,502,150,352,2,1199,1,1
15586,15,14175,11,526,304,222,8,30,5,3
14222,10,6441,9,202,83,119,2,31,1,1
8329,10,18205,9,182,93,89,2,30,1,1
14352,2296,2391,1780,70,70,0,1,5,1,0
636,1976,25811,1508,228,118,110,2,1199,1,1
21114,2595,28613,2014,70,70,0,1,4,1,0
17110,26,26210,16,5167,700,4467,16,15,7,9
11936,26,17399,16,249145,4184,244961,218,107,40,178
12579,26,15288,16,499,425,74,4,0,3,1
6095,26,9248,16,7474,2385,5089,15,121,7,8
11050,1395,19805,1061,70,70,0,2,9,2,0
2265,26,9301,16,6899,3403,3496,27,76,16,11
5606,1995,17100,1525,140,78,62,2,30,1,1
16232,26,27749,16,54944,4374,50570,88,361,44,44
8837,10,722,9,166,86,80,2,31,1,1
11184,219,2296,141,66,66,0,1,5,1,0
8965,10,9522,9,182,93,89,2,31,1,1
13868,10,1341,9,181,94,87,2,30,1,1
11341,10,25707,9,86,86,0,1,30,1,0
14482,10,5987,9,168,78,90,2,30,1,1
21547,10,12244,9,199,102,97,2,30,1,1
14387,10,23535,9,180,92,88,2,31,1,1
17704,15,12055,11,1895,755,1140,11,14,6,5
20608,26,3778,16,4994,379,4615,9,15,4,5
15388,10,16993,9,711,87,624,2,30,1,1
14062,232,10079,147,9151,4417,4734,84,77,44,40
14573,26,9133,16,4455,798,3657,17,136,7,10
13610,10,5975,9,194,102,92,2,31,1,1
11179,15,17921,11,1638,1324,314,10,15,5,5
9360,115,4058,88,70,70,0,1,5,1,0
14814,10,29105,9,194,102,92,2,29,1,1
10327,3264,10176,2528,870,330,540,12,1573,6,6
8874,10,2062,9,172,88,84,2,31,1,1
12111,26,18534,16,4531,974,3557,18,65,10,8
22001,15,11303,11,82972,2084,80888,85,98,26,59
15932,10,1081,9,198,102,96,2,30,1,1
19731,26,27514,16,4378,1471,2907,19,30,11,8
15766,10,12716,9,292,85,207,4,50,2,2
16806,26,25341,16,18290,3012,15278,46,136,24,22
17104,26,2140,16,5167,700,4467,16,15,7,9
22368,10,11816,9,783,96,687,2,31,1,1
9009,10,14119,9,194,102,92,2,30,1,1
11138,934,1606,688,66,66,0,1,5,1,0
532,247,0,0,3354,1792,1562,46,194,23,23
21531,10,28245,9,626,190,436,6,60,3,3
14217,26,1297,16,7894,1557,6337,20,150,9,11
11870,15,9210,11,1600,581,1019,10,15,6,4
4412,26,21961,16,1798,1223,575,13,26,8,5
12703,405,4527,263,70,70,0,2,7,2,0
6164,26,22007,16,70,70,0,1,5,1,0
22111,10,9732,9,487,201,286,6,37,3,3
13640,10,4475,9,212,108,104,2,31,1,1
8765,10,867,9,732,86,646,2,29,1,1
8597,10,17005,9,817,102,715,2,30,1,1
12810,26,23691,16,4380,1473,2907,19,29,11,8
20067,26,26795,16,4650,3116,1534,19,44,10,9
15429,779,11501,565,70,70,0,1,5,1,0
18085,26,8058,16,1527,940,587,14,21,8,6
14373,10,7507,9,302,84,218,4,46,2,2
20597,1743,450,1331,316,190,126,5,15,3,2
8584,1238,4080,918,78,78,0,1,30,1,0
14256,10,2133,9,821,102,719,2,30,1,1
10040,15,16023,11,14077960,171956,13906004,11755,133,2437,9318
16188,26,19889,16,5111,2193,2918,19,120,9,10
8713,10,16801,9,193,102,91,2,30,1,1
5685,26,23298,16,17360,5578,11782,71,281,39,32
11999,15,8307,11,8176,1443,6733,20,15,10,10
15850,26,29098,16,7057,2815,4242,37,18,21,16
11719,10,25048,9,196,94,102,2,30,1,1
8582,26,26794,16,625995,31468,594527,722,199,256,466
21578,10,12921,9,195,102,93,2,31,1,1
18548,405,27421,263,70,70,0,2,8,2,0
9728,280,4912,177,166,166,0,1,1200,1,0
15076,15,14229,11,174021,11443,162578,197,63,81,116
5699,15,10983,11,2543,691,1852,13,17,8,5
11225,26,4517,16,13948,1150,12798,29,15,14,15
19545,26,7142,16,7485,1962,5523,27,95,13,14
20931,26,10307,16,11746,3874,7872,44,141,22,22
10320,26,9271,16,6333,2018,4315,25,17,15,10
21329,10,13995,9,276,94,182,4,54,2,2
8320,10,13917,9,214,102,112,2,29,1,1
4864,15,16368,11,37629,3025,34604,51,24,22,29
9240,26,1859,16,11958,2983,8975,28,48,15,13
4679,26,13468,16,34423,3999,30424,52,46,24,28
9677,15,5660,11,3672,1976,1696,12,26,7,5
17030,26,25739,16,5110,950,4160,21,48,10,11
9155,10,27876,9,257,102,155,2,29,1,1
9028,10,21630,9,193,102,91,2,29,1,1
17153,26,8470,16,155516,6298,149218,174,107,49,125
8404,10,20858,9,216,110,106,2,30,1,1
22189,10,4531,9,198,102,96,2,30,1,1
14700,10,8221,9,210,110,100,2,30,1,1
2744,1238,21162,918,894,126,768,2,30,1,1
8657,26,11977,16,1627,884,743,12,27,6,6
10327,3236,5071,2507,3564,3564,0,55,4073,55,0
21806,26,2434,16,8503,1969,6534,24,32,13,11
11123,2057,12546,1583,160,70,90,2,5,1,1
9217,1241,16718,921,468,390,78,5,29,4,1
11159,2843,14747,2207,66,66,0,1,5,1,0
15712,10,27242,9,166,86,80,2,31,1,1
10797,15,26404,11,2169,1263,906,13,75,8,5
22616,10,8818,9,473,94,379,4,36,2,2
12387,2577,10556,1999,320,140,180,6,6,3,3
8160,10,21239,9,368,80,288,4,30,2,2
1057,26,13207,16,3299,441,2858,11,15,6,5
5289,15,2986,11,1712,1324,388,11,16,5,6
5298,10,20110,9,489,94,395,2,30,1,1
18771,1989,12939,1519,316,136,180,6,6,3,3
18951,26,25248,16,13342,9687,3655,53,17,28,25
22611,26,17582,16,3213,2242,971,19,25,9,10
8584,1240,14910,920,255,71,184,2,31,1,1
1048,26,14287,16,5689,501,5188,14,15,7,7
22693,10,5693,9,216,94,122,2,30,1,1
9095,10,7974,9,190,97,93,2,31,1,1
15202,26,17998,16,4499,947,3552,14,25,8,6
14697,10,16525,9,194,102,92,2,31,1,1
5536,15,17208,11,424,198,226,7,142,4,3
11604,26,18573,16,283768,16167,267601,384,116,148,236
12853,26,19905,16,17529,8138,9391,39,31,17,22
4282,26,1418,16,7295,1830,5465,23,316,13,10
11158,988,20368,729,70,70,0,2,8,2,0
15353,26,6707,16,8654,2150,6504,20,15,11,9
7970,26,19820,16,5272,1535,3737,17,35,12,5
7386,26,21150,16,172,172,0,2,5,2,0
14398,10,21559,9,283,98,185,4,51,2,2
17510,15,26288,11,181627,17128,164499,277,15,79,198
19822,26,16098,16,2826,1618,1208,21,45,12,9
8494,26,8873,16,116686,4968,111718,116,53,31,85
6720,15,15586,11,138,78,60,2,4,1,1
15121,26,18136,16,39717,3740,35977,76,53,39,37
12017,26,21736,16,68982,15774,53208,113,45,42,71
13766,10,21931,9,313,110,203,4,35,2,2
1219,2766,9437,2145,479,150,329,2,1200,1,1
10884,626,24189,433,136,136,0,3,13,3,0
3820,26,22783,16,6453,2318,4135,32,84,16,16
8647,15,12974,11,11436,5021,6415,38,126,20,18
15346,10,21846,9,166,86,80,2,30,1,1
3761,10,26276,9,226,78,148,2,30,1,1
12022,1423,15311,1081,70,70,0,1,5,1,0
5694,10,17476,9,203,82,121,2,30,1,1
15057,15,340,11,460182,11717,448465,462,135,162,300
18277,26,10274,16,5858,1511,4347,20,21,11,9
14926,10,24497,9,167,86,81,2,30,1,1
12560,26,10123,16,499,425,74,4,0,3,1
22251,10,11101,9,183,94,89,2,29,1,1
14647,10,24230,9,193,102,91,2,31,1,1
12559,26,7342,16,499,425,74,4,0,3,1
15460,10,6170,9,312,94,218,2,30,1,1
3066,815,23997,595,11116,4642,6474,64,1457,30,34
1787,10,28561,9,223,78,145,2,30,1,1
1922,10,7367,9,216,90,126,2,30,1,1
14640,10,4907,9,177,94,83,2,30,1,1
3505,26,5003,16,163835,28514,135321,310,153,162,148
21403,10,733,9,193,102,91,2,30,1,1
14487,10,7480,9,177,94,83,2,30,1,1
1566,183,5625,121,3910,1805,2105,20,19,12,8
16297,15,2191,11,1013,566,447,8,162,5,3
8695,10,9897,9,211,94,117,2,30,1,1
8343,10,21884,9,528,178,350,6,43,3,3
20676,26,8145,16,1373,734,639,17,96,10,7
11343,26,22911,16,6727,762,5965,15,26,8,7
10651,10,23394,9,207,86,121,2,30,1,1
21197,2895,21688,2248,66,66,0,2,7,2,0
8506,26,13502,16,208,70,138,4,25,2,2
10923,3203,4434,2483,70,70,0,2,8,2,0
22566,26,23605,16,2458316,102393,2355923,2942,241,1261,1681
4835,2627,7216,2037,848,252,596,4,1199,2,2
13787,10,14753,9,173,94,79,2,30,1,1
16021,1014,26001,748,559,198,361,5,1200,4,1
18273,26,25905,16,8894,1633,7261,18,16,9,9
225,10,25368,9,204,118,86,2,31,1,1
9507,10,4471,9,214,110,104,2,30,1,1
15016,10,9055,9,731,91,640,2,31,1,1
21912,10,13411,9,199,102,97,2,30,1,1
22650,26,4566,16,396698,11870,384828,409,16,144,265
10678,10,7274,9,195,78,117,2,30,1,1
22208,10,10807,9,166,86,80,2,30,1,1
9249,10,203,9,172,94,78,2,31,1,1
17098,26,20130,16,5167,700,4467,16,15,7,9
6787,10,22305,9,199,94,105,2,30,1,1
14607,10,17495,9,170,87,83,2,31,1,1
15749,10,19056,9,186,95,91,2,30,1,1
13660,26,19076,16,2900,2007,893,20,36,12,8
8482,26,24426,16,160961,7302,153659,171,87,49,122
9511,26,18886,16,1630,916,714,12,25,7,5
17892,26,18165,16,4951,711,4240,15,29,8,7
2744,1324,10576,1000,893,126,767,2,30,1,1
4905,26,3401,16,717020,36766,680254,939,60,449,490
12986,26,11789,16,5037,2002,3035,14,120,7,7
9753,26,12549,16,1738,1061,677,18,94,10,8
6250,2004,25986,1534,140,78,62,2,31,1,1
22462,15,18122,11,7440,4032,3408,48,629,25,23
9419,26,28007,16,13363,4645,8718,54,241,32,22
8104,10,9199,9,198,93,105,2,30,1,1
15285,10,17321,9,195,102,93,2,31,1,1
22409,10,2832,9,816,102,714,2,30,1,1
18750,26,10735,16,5518,1221,4297,16,90,10,6
14871,26,13851,16,185763,7360,178403,201,120,68,133
12831,2110,18290,1626,70,70,0,2,7,2,0
7439,26,18742,16,648083,28117,619966,751,30,323,428
18468,3245,24528,2514,70,70,0,1,5,1,0
21859,26,3404,16,8701,3408,5293,48,256,22,26
9576,15,12341,11,318,192,126,6,27,4,2
22488,10,27576,9,247,118,129,2,30,1,1
13329,15,10393,11,1113,534,579,12,16,7,5
10039,15,22262,11,16037318,218904,15818414,13595,136,2976,10619
21652,10,3003,9,251,110,141,2,30,1,1
4901,26,28934,16,191454,11241,180213,262,42,128,134
10796,2455,13712,1907,70,70,0,1,5,1,0
13728,10,11571,9,168,78,90,2,30,1,1
9154,26,18802,16,622,210,412,10,21,4,6
14571,10,2949,9,193,102,91,2,30,1,1
5606,1982,8857,1512,156,94,62,2,30,1,1
14873,10,7427,9,210,110,100,2,30,1,1
13728,10,12616,9,178,91,87,2,30,1,1
2741,26,18928,16,7343,2586,4757,23,19,11,12
13878,10,23156,9,177,94,83,2,30,1,1
207,295,478,190,754151,15395,738756,762,16,239,523
18471,2844,3297,2208,70,70,0,1,5,1,0
9646,26,26341,16,11323,3376,7947,29,77,16,13
9685,10,5736,9,458,188,270,6,30,3,3
21790,10,19691,9,807,94,713,2,30,1,1
8918,10,19987,9,180,92,88,2,31,1,1
14743,10,4919,9,174,89,85,2,30,1,1
8705,26,16377,16,5106,1861,3245,21,143,10,11
15079,15,1807,11,300370,14101,286269,313,63,116,197
4191,26,2614,16,6250,1312,4938,23,28,12,11
15361,26,9599,16,7929,1940,5989,20,16,11,9
10944,963,26390,711,256,136,120,5,8,3,2
22234,10,20715,9,179,94,85,2,30,1,1
15988,10,10867,9,193,102,91,2,30,1,1
17023,26,4617,16,24079,11282,12797,44,17,22,22
5856,26,13141,16,37711,4074,33637,69,32,31,38
13702,26,27427,16,12799,3662,9137,40,50,22,18
13700,26,3431,16,23425,10763,12662,57,48,31,26
12017,1488,10164,1130,314,128,186,6,18,3,3
15327,10,17803,9,183,94,89,2,30,1,1
14806,10,23401,9,183,94,89,2,30,1,1
17903,26,2955,16,170002,17069,152933,229,48,118,111
13678,10,6660,9,179,94,85,2,30,1,1
16160,26,21873,16,16277,3466,12811,46,1801,22,24
22149,10,9331,9,182,93,89,2,31,1,1
6739,15,8713,11,2025,805,1220,12,46,7,5
22206,10,13663,9,199,102,97,2,30,1,1
14818,10,5278,9,165,86,79,2,30,1,1
4782,26,28987,16,5577,1977,3600,29,56,16,13
9553,26,11766,16,5386,4374,1012,18,34,11,7
17940,26,19442,16,306,180,126,6,29,4,2
532,247,0,0,3498,1872,1626,48,200,24,24
17063,10,26023,9,228,90,138,2,29,1,1
13897,10,21545,9,212,110,102,2,30,1,1
21281,10,7196,9,796,105,691,4,59,2,2
14978,10,4416,9,179,94,85,2,30,1,1
12727,26,16990,16,499,425,74,4,0,3,1
15439,10,11909,9,200,102,98,2,30,1,1
5251,26,22205,16,70,70,0,1,5,1,0
15242,10,15292,9,199,102,97,2,29,1,1
21718,10,15632,9,322,95,227,4,39,2,2
12494,2428,8423,1889,70,70,0,2,7,2,0
12662,866,8040,640,70,70,0,1,4,1,0
18867,26,8749,16,24452,12758,11694,39,129,23,16
18566,26,22423,16,1875,1165,710,13,28,7,6
18508,959,18906,707,70,70,0,2,8,2,0
17202,233,8608,148,308,86,222,4,13,1,3
13932,10,2011,9,196,102,94,2,30,1,1
17551,10,26318,9,215,90,125,2,30,1,1
12033,26,9129,16,4962,887,4075,15,28,9,6
9622,15,22002,11,2086,1637,449,10,19,6,4
6519,15,18694,11,26540,1137,25403,36,136,15,21
15492,10,9724,9,193,102,91,2,30,1,1
12124,26,652,16,11111,1014,10097,24,37,10,14
8610,10,11582,9,199,94,105,2,30,1,1
11679,26,10119,16,69884,4367,65517,96,26,44,52
7921,10,20773,9,228,97,131,2,30,1,1
18807,26,26102,16,5037,1343,3694,18,45,11,7
20105,26,4281,16,38402253,1191239,37211014,39088,243,12126,26962
8988,10,10593,9,502,103,399,4,51,2,2
14334,10,3887,9,258,102,156,2,30,1,1
10032,15,14042,11,14423569,189925,14233644,12194,135,2586,9608
7389,26,5060,16,124567,6787,117780,175,263,82,93
9551,15,23832,11,1388,917,471,11,26,6,5
15054,15,13173,11,5342,1304,4038,14,134,8,6
22034,10,25271,9,347,91,256,4,56,2,2
22369,10,17721,9,211,102,109,2,30,1,1
8898,26,18190,16,27125,14251,12874,99,23,57,42
6250,2001,17741,1531,717,551,166,4,31,2,2
13370,26,24015,16,103968,5475,98493,141,18,63,78
14303,10,4113,9,195,102,93,2,30,1,1
14982,26,5533,16,1710,976,734,16,81,8,8
19442,10,7275,9,211,78,133,2,30,1,1
8875,10,21325,9,466,93,373,4,50,2,2
13667,10,14317,9,821,102,719,2,30,1,1
14944,153,560,108,1222,747,475,10,25,5,5
9040,10,18025,9,199,102,97,2,30,1,1
17650,15,1247,11,1594,1280,314,10,15,5,5
15592,10,4896,9,186,95,91,2,30,1,1
21740,10,13682,9,214,102,112,2,30,1,1
20500,10,24235,9,304,86,218,2,30,1,1
12738,541,16692,359,70,70,0,1,4,1,0
9731,26,22407,16,1198,716,482,12,98,7,5
14384,10,19528,9,177,94,83,2,30,1,1
14453,10,13804,9,177,94,83,2,30,1,1
19786,15,15236,11,3466,665,2801,14,16,7,7
5495,26,6331,16,2642442,95056,2547386,2730,3629,999,1731
16408,26,25648,16,27787,5566,22221,60,47,31,29
8493,10,24993,9,193,102,91,2,31,1,1
12546,15,23463,11,1398,590,808,9,111,6,3
12490,725,16739,518,70,70,0,1,5,1,0
13897,10,27843,9,208,106,102,2,31,1,1
2769,10,11433,9,821,97,724,2,30,1,1
19366,26,8427,16,114674,4457,110217,127,48,46,81
17996,15,26551,11,55739,967,54772,53,15,13,40
9654,10,2294,9,734,94,640,2,30,1,1
21211,2229,13316,1728,70,70,0,1,5,1,0
8763,15,18289,11,130,70,60,2,15,1,1
11203,26,22824,16,201007,10015,190992,239,22,100,139
15528,10,479,9,182,93,89,2,31,1,1
15847,10,5655,9,178,94,84,2,30,1,1
8465,10,23442,9,230,102,128,2,30,1,1
19449,15,27330,11,12301,1642,10659,20,20,9,11
11757,26,13664,16,207289,9233,198056,234,136,83,151
21875,10,3858,9,215,94,121,2,30,1,1
1102,26,20730,16,3642,421,3221,12,16,6,6
14945,26,2220,16,3775,1791,1984,24,203,12,12
13975,10,4752,9,294,106,188,4,56,2,2
22536,10,4894,9,184,94,90,2,30,1,1
9965,15,21201,11,35970,11674,24296,108,265,55,53
9033,15,15961,11,2125,1041,1084,11,87,6,5
15308,26,1343,16,7941,1952,5989,20,15,11,9
14721,10,1946,9,177,94,83,2,30,1,1
9728,2627,18148,2037,475,150,325,2,1200,1,1
15019,10,27560,9,212,102,110,2,30,1,1
17508,15,26286,11,108786,4563,104223,192,16,65,127
9171,10,18788,9,216,110,106,2,30,1,1
8584,1052,24071,775,288,78,210,2,30,1,1
2227,10,9087,9,242,98,144,2,30,1,1
15136,26,20169,16,84111,3300,80811,104,54,41,63
14381,10,17009,9,177,94,83,2,30,1,1
14492,2736,15962,2122,481,150,331,2,1200,1,1
11109,26,18198,16,4735,3589,1146,18,15,10,8
8938,10,22559,9,531,188,343,6,58,3,3
22051,10,24930,9,216,110,106,2,30,1,1
1051,26,16137,16,5691,503,5188,14,15,7,7
2724,1240,7558,920,422,164,258,6,31,3,3
11719,26,9108,16,1550,834,716,19,141,10,9
8128,15,28848,11,811,671,140,6,22,4,2
14757,10,14018,9,193,102,91,2,31,1,1
5319,15,18851,11,1655,1341,314,10,16,5,5
14175,10,336,9,821,102,719,2,30,1,1
22589,10,27432,9,212,108,104,2,30,1,1
7096,15,1407,11,1808,636,1172,16,16,8,8
13839,10,11466,9,177,94,83,2,30,1,1
21859,10,1982,9,193,102,91,2,30,1,1
942,26,11254,16,318,192,126,6,18,4,2
22713,10,26543,9,183,94,89,2,30,1,1
18277,26,26976,16,8958,1697,7261,18,15,9,9
15465,10,1145,9,198,101,97,2,31,1,1
17310,26,16209,16,1786,172,1614,7,120,3,4
2877,26,9634,16,6388,1112,5276,18,75,9,9
9756,26,3531,16,6782,3367,3415,25,139,15,10
7896,26,21985,16,7761,2376,5385,24,256,12,12
21810,10,9911,9,199,102,97,2,30,1,1
14859,10,5541,9,193,102,91,2,31,1,1
16390,26,40,16,6520,1550,4970,19,54,11,8
4835,728,24628,521,5892,3784,2108,81,3115,47,34
14834,15,24828,11,101179,1296,99883,88,15,18,70
5933,10,17872,9,244,98,146,2,32,1,1
7972,15,20847,11,1920,1471,449,10,19,6,4
11538,26,24232,16,8594,1042,7552,16,120,7,9
8703,15,5648,11,5514,3156,2358,21,66,15,6
10854,2711,18110,2105,70,70,0,1,5,1,0
15845,10,27751,9,770,101,669,2,30,1,1
7307,26,20532,16,2227,1018,1209,17,15,8,9
8605,10,24704,9,197,102,95,2,31,1,1
15537,10,7036,9,267,87,180,4,53,2,2
3133,2291,17865,1776,462,462,0,8,3632,8,0
14829,10,98,9,226,94,132,2,29,1,1
9061,10,9552,9,384,94,290,2,30,1,1
22195,10,9352,9,177,94,83,2,30,1,1
13639,10,12764,9,177,94,83,2,30,1,1
5606,2017,23603,1547,585,86,499,2,30,1,1
9464,10,29137,9,194,102,92,2,30,1,1
21702,10,5990,9,179,94,85,2,29,1,1
8204,26,10462,16,6254,1075,5179,22,34,10,12
22496,10,3600,9,195,102,93,2,31,1,1
3936,26,13145,16,4988930,161289,4827641,5384,290,1964,3420
6340,26,8951,16,6131,1399,4732,20,979,10,10
8867,10,10428,9,197,102,95,2,30,1,1
18868,15,9163,11,10629,1104,9525,23,46,12,11
8792,10,25192,9,226,110,116,2,30,1,1
18010,10,13231,9,312,78,234,2,29,1,1
10749,619,3578,427,66,66,0,1,5,1,0
13480,26,24093,16,18160,6539,11621,37,19,22,15
13698,10,3642,9,192,98,94,2,30,1,1
12028,26,6356,16,6760,1346,5414,18,325,9,9
14837,10,20619,9,767,102,665,2,30,1,1
10934,2660,21887,2067,70,70,0,1,5,1,0
19516,26,28654,16,6353,1520,4833,20,17,12,8
10470,26,21756,16,394,70,324,7,31,2,5
8954,10,11141,9,302,97,205,4,43,2,2
21437,10,1309,9,211,102,109,2,29,1,1
21242,454,4010,292,66,66,0,2,8,2,0
3066,10,12809,9,238,95,143,2,30,1,1
22539,10,8033,9,183,94,89,2,30,1,1
10950,1595,12092,1222,70,70,0,1,5,1,0
9772,15,20387,11,1658,1247,411,8,14,5,3
21423,10,13547,9,213,94,119,2,30,1,1
10891,1097,3804,805,70,70,0,2,7,2,0
4835,3124,19277,2426,1548,265,1283,4,1201,2,2
15422,26,26405,16,35160,6404,28756,82,196,31,51
16598,26,26334,16,12391,6068,6323,52,133,24,28
22541,10,801,9,177,94,83,2,30,1,1
3652,15,11423,11,3643,1738,1905,17,187,10,7
22272,10,20129,9,198,102,96,2,30,1,1
22012,10,13021,9,182,93,89,2,30,1,1
9917,10,5076,9,199,94,105,2,30,1,1
8584,1239,14733,919,263,78,185,2,29,1,1
2744,1618,6193,1240,864,126,738,2,31,1,1
15736,10,21339,9,210,94,116,2,30,1,1
12491,15,29120,11,2162,1608,554,10,34,6,4
22218,10,2632,9,165,86,79,2,30,1,1
9544,26,17349,16,316,136,180,6,6,3,3
15792,683,9696,482,1269359015,948477220,320881795,1036116,9283,747520,288596
15927,291,18211,187,70,70,0,2,8,2,0
3805,10,14848,9,213,87,126,2,30,1,1
14214,792,3334,576,70,70,0,1,5,1,0
15538,10,11308,9,183,94,89,2,30,1,1
18852,26,14229,16,6513,1863,4650,28,255,15,13
19304,15,28353,11,201243,14555,186688,357,158,145,212
12648,2885,16972,2240,70,70,0,2,7,2,0
12736,26,7351,16,499,425,74,4,0,3,1
18078,26,28702,16,7971,2647,5324,38,15,24,14
18041,15,23757,11,1281,399,882,10,16,6,4
14215,1577,3116,1207,320,140,180,6,6,3,3
15135,10,23831,9,711,87,624,2,31,1,1
886,15,21553,11,318,192,126,6,30,4,2
22610,10,1462,9,295,101,194,4,31,2,2
19309,15,13808,11,22368,2947,19421,53,137,24,29
11358,15,22923,11,1928,1339,589,12,48,6,6
8323,10,21484,9,195,102,93,2,30,1,1
8755,10,8803,9,198,94,104,2,30,1,1
22153,10,14909,9,295,101,194,4,31,2,2
11053,15,24484,11,366,240,126,7,24,5,2
9079,10,20590,9,225,102,123,2,30,1,1
20324,26,9581,16,17411,8921,8490,98,291,41,57
6295,26,9095,16,3927,1425,2502,18,121,8,10
15674,10,16186,9,168,86,82,2,31,1,1
9034,10,8980,9,188,96,92,2,31,1,1
15145,26,4985,16,340595,9013,331582,345,80,119,226
14788,10,22049,9,184,102,82,2,30,1,1
14643,10,7369,9,179,94,85,2,31,1,1
9181,183,21772,121,3428,1714,1714,16,34,8,8
10885,26,12644,16,11894,2661,9233,32,32,18,14
6250,26,4106,16,64,64,0,1,31,1,0
22352,10,28372,9,194,102,92,2,31,1,1
9416,26,1065,16,868,514,354,13,18,8,5
22463,183,29025,121,4213,2429,1784,18,31,9,9
21941,10,26994,9,202,103,99,2,31,1,1
21360,10,17678,9,195,94,101,2,31,1,1
4713,26,20870,16,9658,2602,7056,32,66,14,18
13150,26,19181,16,11876,2769,9107,30,77,15,15
10917,749,9397,538,70,70,0,2,8,2,0
21139,15,28385,11,555419,4827,550592,451,21,64,387
2724,1240,7648,920,422,164,258,6,30,3,3
22356,10,860,9,763,102,661,2,30,1,1
21660,10,6077,9,228,102,126,2,30,1,1
1337,1981,26347,1511,209,85,124,4,34,2,2
2744,1241,20538,921,891,126,765,2,31,1,1
18501,786,23618,571,70,70,0,2,8,2,0
21940,10,27606,9,289,134,155,2,30,1,1
15761,10,19259,9,165,86,79,2,30,1,1
21225,405,14137,263,66,66,0,2,8,2,0
9598,15,13881,11,4185,3618,567,14,34,8,6
4056,10,15232,9,235,98,137,2,30,1,1
9512,15,20242,11,318,192,126,6,28,4,2
10114,26,5193,16,8007,3336,4671,19,78,11,8
4654,26,21684,16,499,425,74,4,0,3,1
13758,10,10669,9,184,94,90,2,30,1,1
8453,10,17344,9,184,94,90,2,31,1,1
21059,26,12740,16,3263,1643,1620,9,119,5,4
8584,1455,11281,1108,236,78,158,2,30,1,1
11132,903,13282,667,66,66,0,1,5,1,0
174,10,8439,9,260,86,174,2,30,1,1
15171,10,13567,9,350,94,256,2,30,1,1
4235,26,15526,16,170890,13800,157090,246,97,123,123
15286,10,3469,9,209,110,99,2,30,1,1
17511,10,15918,9,359,86,273,2,30,1,1
14111,10,12084,9,757,102,655,2,29,1,1
22179,10,21289,9,184,94,90,2,31,1,1
5441,26,13749,16,70,70,0,1,5,1,0
14645,15,10616,11,1515,481,1034,11,16,6,5
18775,10,25287,9,199,94,105,2,30,1,1
13870,10,18639,9,182,94,88,2,30,1,1
22116,10,1345,9,210,110,100,2,30,1,1
9728,416,373,271,498,150,348,4,2396,2,2
1405,26,4846,16,6981,948,6033,17,27,10,7
8594,10,9890,9,200,94,106,2,30,1,1
833,26,24377,16,7308,864,6444,26,394,9,17
12735,1829,20481,1392,70,70,0,1,4,1,0
3752,10,14732,9,235,90,145,2,32,1,1
21935,10,20540,9,353,118,235,2,30,1,1
13816,10,11702,9,250,94,156,2,30,1,1
636,287,13437,184,221,111,110,2,1200,1,1
9108,15,21743,11,220279,13007,207272,266,22,115,151
12018,1430,23146,1085,70,70,0,1,4,1,0
18468,26,27023,16,6570,1988,4582,19,57,10,9
1702,10,6234,9,217,82,135,2,31,1,1
14264,26,12303,16,13506,5979,7527,39,127,20,19
15322,26,27150,16,8059,2039,6020,20,16,11,9
13254,26,21139,16,8318,2068,6250,32,270,16,16
18551,2713,4598,2107,70,70,0,1,5,1,0
11350,26,22918,16,960,539,421,9,52,5,4
13782,10,15541,9,184,102,82,2,31,1,1
13870,10,14133,9,209,110,99,2,30,1,1
16602,26,24653,16,11141,2777,8364,33,58,14,19
9103,10,15596,9,384,103,281,4,50,2,2
15286,10,13470,9,202,103,99,2,31,1,1
16154,295,25484,190,2343,856,1487,17,16,10,7
21389,26,3420,16,1411,852,559,13,24,7,6
16003,26,27555,16,7847,1377,6470,27,15,12,15
9668,15,26115,11,102242,12176,90066,149,156,68,81
15330,10,11318,9,184,94,90,2,31,1,1
9607,15,28133,11,214,140,74,4,15,3,1
14099,10,28753,9,214,110,104,2,29,1,1
8917,15,20999,11,1876,998,878,12,15,7,5
11131,15,14824,11,55117,3792,51325,69,36,29,40
9823,15,8928,11,132,132,0,2,8,2,0
1927,10,7391,9,213,87,126,2,30,1,1
19491,26,27366,16,4702,1795,2907,19,28,11,8
20380,26,5719,16,3049,988,2061,14,135,7,7
6697,10,18919,9,295,90,205,2,30,1,1
15702,10,13715,9,166,86,80,2,30,1,1
8730,26,21779,16,180388,3938,176450,145,161,20,125
1059,26,640,16,5693,499,5194,14,15,7,7
8327,2627,4047,2037,800,150,650,4,1200,2,2
1211,26,635,16,5415,864,4551,19,360,9,10
5878,26,15350,16,78535,3648,74887,94,30,41,53
3066,2918,26402,2265,2746,1487,1259,21,2495,14,7
4293,26,3218,16,1209,709,500,14,28,8,6
22367,10,17448,9,265,102,163,2,29,1,1
8683,15,5981,11,6123,3105,3018,16,38,8,8
14544,10,17178,9,196,102,94,2,31,1,1
8166,26,21837,16,9681,2243,7438,35,24,18,17
10892,15,3876,11,6106,5420,686,13,30,7,6
16000,10,15251,9,177,94,83,2,29,1,1
8516,15,6701,11,2391,532,1859,11,76,6,5
8080,26,3535,16,2272788,106549,2166239,2492,190,850,1642
6477,26,9755,16,7725,1980,5745,25,20,14,11
17656,26,18188,16,4697,923,3774,13,120,6,7
11398,26,12733,16,1253628,61672,1191956,1875,220,939,936
15580,10,7898,9,183,94,89,2,31,1,1
8689,10,7998,9,314,93,221,4,43,2,2
14001,26,24378,16,5458,2211,3247,22,39,13,9
15503,10,4536,9,297,94,203,2,30,1,1
13355,26,13102,16,182017,6621,175396,189,181,55,134
21651,10,15264,9,186,95,91,2,31,1,1
12813,2065,21799,1591,1946,1019,927,10,15,6,4
8582,10,13307,9,177,94,83,2,31,1,1
9733,10,13304,9,177,94,83,2,29,1,1
22147,10,6308,9,193,102,91,2,31,1,1
15235,26,28020,16,8006,1986,6020,20,15,11,9
21762,10,5465,9,754,94,660,2,30,1,1
4762,10,16233,9,235,90,145,2,32,1,1
22057,10,18351,9,212,110,102,2,30,1,1
21921,10,9321,9,289,82,207,4,46,2,2
8579,26,2787,16,44505,6962,37543,64,48,21,43
15582,15,4959,11,214,140,74,4,30,3,1
16118,26,23378,16,915797,52405,863392,1231,269,604,627
13900,26,7693,16,13275,3587,9688,38,27,20,18
8838,15,6167,11,3749,2453,1296,15,41,9,6
15625,10,23122,9,241,94,147,2,29,1,1
6876,10,7949,9,212,78,134,2,30,1,1
8464,10,19188,9,183,94,89,2,30,1,1
9210,26,12467,16,6887,2473,4414,20,15,11,9
9284,15,11651,11,20575,11455,9120,92,966,47,45
22542,10,12990,9,772,103,669,2,31,1,1
9661,15,28215,11,5997,1327,4670,18,157,10,8
10390,15,11542,11,5912,5182,730,15,23,9,6
4129,15,15337,11,141193,10612,130581,165,30,69,96
15240,26,25322,16,1299,730,569,13,25,7,6
5547,15,17849,11,2387,930,1457,14,16,7,7
14199,10,24442,9,341,134,207,2,30,1,1
15580,237,26246,151,7194101,1949033,5245068,50585,1008,24913,25672
11031,567,5544,381,66,66,0,1,5,1,0
7551,15,20218,11,34504,2526,31978,45,156,16,29
9160,10,1013,9,458,188,270,6,31,3,3
8977,10,1637,9,166,86,80,2,30,1,1
21547,10,10109,9,198,101,97,2,30,1,1
22045,10,13117,9,508,102,406,2,30,1,1
4559,26,20317,16,232,172,60,3,5,2,1
4377,10,15767,9,234,93,141,2,30,1,1
15190,26,13150,16,7982,1962,6020,20,15,11,9
21561,10,8868,9,598,196,402,6,71,3,3
621,10,2495,9,247,98,149,2,32,1,1
15263,10,22786,9,196,102,94,2,31,1,1
12707,26,25916,16,499,425,74,4,1,3,1
10904,2171,11067,1677,66,66,0,1,5,1,0
13502,183,24109,121,3409,1454,1955,16,16,8,8
8839,233,22772,148,4266,1448,2818,22,3088,13,9
15360,26,7587,16,288525,15601,272924,383,33,193,190
10522,26,27657,16,7269,1978,5291,28,39,14,14
10648,26,26918,16,5677,918,4759,18,15,10,8
7345,18,8067,13,184,94,90,2,30,1,1
9580,26,4143,16,18959,3307,15652,33,19,16,17
14074,26,7227,16,6622,859,5763,18,15,10,8
22142,10,28766,9,186,95,91,2,31,1,1
6178,26,28288,16,22106,5214,16892,23,128,9,14
11911,15,23227,11,378,180,198,7,17,4,3
15986,10,5897,9,200,102,98,2,29,1,1
14966,10,21774,9,249,85,164,4,56,2,2
20306,26,18757,16,52223,3318,48905,75,321,30,45
212,298,483,193,3342,1983,1359,16,15,8,8
5846,15,17746,11,2791,1259,1532,13,125,7,6
8689,10,4289,9,728,96,632,2,30,1,1
8235,10,6935,9,168,78,90,2,30,1,1
16923,10,19806,9,198,86,112,2,30,1,1
14948,10,4966,9,900,110,790,2,29,1,1
9361,115,1316,88,70,70,0,1,4,1,0
22570,26,24936,16,4514,2844,1670,29,84,14,15
22129,10,141,9,243,94,149,2,30,1,1
6921,26,1612,16,546,280,266,9,26,5,4
17068,3,26027,3,66,66,0,1,30,1,0
6321,26,26473,16,6795,2090,4705,27,21,15,12
636,1192,29114,881,219,118,101,2,1199,1,1
5833,26,563,16,6237,1811,4426,22,22,12,10
8586,26,4314,16,4932,1046,3886,21,173,10,11
7929,26,1705,16,130090,7064,123026,184,200,92,92
22214,1263,12916,943,1749,924,825,6,31,3,3
9727,10,12774,9,783,96,687,2,30,1,1
11160,51,22986,34,66,66,0,1,5,1,0
891,15,3509,11,318,192,126,6,29,4,2
6503,26,2610,16,3197,1931,1266,19,15,9,10
8782,26,25493,16,7238,2601,4637,20,17,10,10
14951,26,20183,16,3715,1791,1924,23,203,12,11
14274,10,2710,9,216,94,122,2,30,1,1
2744,1563,23975,1194,886,126,760,2,31,1,1
14210,10,6418,9,168,86,82,2,30,1,1
10684,15,3454,11,2681,1044,1637,22,255,12,10
10408,26,24589,16,2019,1219,800,15,17,8,7
8666,26,16336,16,1197,620,577,13,27,6,7
2744,1238,22728,918,879,126,753,2,30,1,1
3359,6,14123,6,7930,3351,4579,56,38,27,29
6725,15,27889,11,2005,715,1290,8,15,5,3
14333,10,25524,9,202,103,99,2,31,1,1
18796,1989,28496,1519,316,136,180,6,5,3,3
22420,10,3352,9,178,94,84,2,29,1,1
22269,10,13516,9,299,103,196,4,33,2,2
3751,15,2920,11,6260,696,5564,17,15,9,8
9817,15,4974,11,20265,5748,14517,34,23,16,18
9383,26,6693,16,4954,1768,3186,18,143,9,9
10980,803,26940,585,66,66,0,1,5,1,0
22320,10,12241,9,196,102,94,2,30,1,1
8896,10,25723,9,767,102,665,2,30,1,1
21526,10,11417,9,168,86,82,2,30,1,1
12146,26,8642,16,7422,1563,5859,32,53,15,17
11542,15,23035,11,10947,876,10071,21,142,9,12
7429,26,20064,16,4754,1847,2907,19,26,11,8
22205,10,7446,9,216,102,114,2,30,1,1
8913,10,27624,9,355,102,253,2,30,1,1
8701,10,12301,9,771,102,669,2,30,1,1
12669,26,10844,16,499,425,74,4,0,3,1
2957,10,23423,9,278,86,192,2,30,1,1
18506,2574,23838,1996,164,70,94,2,5,1,1
9692,15,9670,11,378,192,186,7,21,4,3
6678,10,15520,9,199,94,105,2,30,1,1
14987,26,15814,16,17704,1456,16248,25,123,11,14
15078,15,22275,11,177736,11174,166562,198,63,77,121
15300,26,4182,16,7889,1900,5989,20,15,11,9
8584,26,6033,16,318,192,126,6,16,4,2
11050,1395,27435,1061,70,70,0,1,5,1,0
9730,15,20928,11,6718,3126,3592,16,78,8,8
1121,26,2271,16,6146,709,5437,18,29,8,10
2744,1449,6090,1102,1652,126,1526,4,31,2,2
9822,15,17413,11,300,174,126,5,15,3,2
9747,15,22069,11,1706,1006,700,11,21,6,5
22605,10,24881,9,216,102,114,2,30,1,1
16021,1593,11114,1221,726,726,0,12,1199,12,0
21223,10,29119,9,214,102,112,2,30,1,1
14374,10,10110,9,258,102,156,2,30,1,1
13258,15,7278,11,254,128,126,5,16,3,2
4880,26,9068,16,2697,1520,1177,21,182,10,11
8965,10,21660,9,235,90,145,2,33,1,1
15381,2387,10472,1854,3060,1569,1491,12,17,7,5
6927,6,19302,6,5130,2103,3027,28,21,16,12
16555,10,21136,9,578,286,292,9,15,5,4
9832,232,7231,147,622,284,338,10,29,5,5
14442,10,17693,9,168,86,82,2,30,1,1
11172,26,3030,16,9911,2041,7870,34,120,17,17
16021,2203,23182,1706,402,132,270,6,1209,3,3
8946,10,2810,9,182,93,89,2,31,1,1
11105,1886,25938,1440,70,70,0,2,8,2,0
14327,10,12931,9,271,103,168,4,59,2,2
11011,15,20692,11,48165,2605,45560,63,15,31,32
15388,10,3916,9,516,136,380,4,40,2,2
8916,26,3399,16,7370,1474,5896,19,128,10,9
13753,10,20793,9,195,102,93,2,30,1,1
4506,15,12512,11,946,531,415,11,296,6,5
9008,10,8021,9,734,102,632,2,30,1,1
13825,10,728,9,178,94,84,2,31,1,1
12684,773,11673,560,940,502,438,14,18,7,7
21022,2466,7757,1917,70,70,0,1,4,1,0
9055,10,2400,9,375,126,249,2,30,1,1
13217,26,13470,16,128477,6347,122130,155,276,56,99
20309,26,23579,16,30902,6307,24595,86,269,36,50
12119,26,23331,16,1462,916,546,13,34,7,6
9828,15,10058,11,57576,29602,27974,239,175,118,121
8686,10,3091,9,209,110,99,2,29,1,1
14520,10,11265,9,183,94,89,2,30,1,1
10229,15,3476,11,366,240,126,7,21,5,2
20774,26,22177,16,11344,5681,5663,34,3601,20,14
21937,10,22820,9,178,94,84,2,29,1,1
13694,10,17653,9,762,98,664,2,31,1,1
15589,10,5447,9,266,110,156,2,30,1,1
8372,15,22141,11,890,411,479,11,15,6,5
13316,15,16396,11,2091,823,1268,12,45,7,5
16505,15,7059,11,318,192,126,6,20,4,2
8983,10,16243,9,86,86,0,1,30,1,0
5469,26,2650,16,450036,17745,432291,541,217,241,300
12086,26,25761,16,1462,965,497,13,18,7,6
18368,26,5691,16,3928,2467,1461,27,144,14,13
13705,26,12856,16,6975,1243,5732,29,254,14,15
18983,26,4427,16,7592,2966,4626,26,15,15,11
13752,10,20533,9,197,102,95,2,30,1,1
9487,15,21627,11,22233,10123,12110,37,28,16,21
14722,10,3338,9,166,85,81,2,31,1,1
2744,1241,19291,921,882,126,756,2,30,1,1
10670,15,21419,11,318,192,126,6,39,4,2
21085,843,9195,621,70,70,0,1,5,1,0
2724,1240,13092,920,422,164,258,6,29,3,3
6113,233,21659,148,5169,1103,4066,26,214,10,16
9194,10,15447,9,386,134,252,2,30,1,1
18477,2691,28716,2090,70,70,0,2,8,2,0
8812,10,1852,9,199,102,97,2,30,1,1
11299,194,27798,128,316,136,180,6,6,3,3
22179,1268,1770,948,1020,462,558,4,29,2,2
8210,2627,21194,2037,479,152,327,2,1200,1,1
18476,26,8218,16,9398,2320,7078,24,77,13,11
15374,26,20507,16,8021,2001,6020,20,15,11,9
11804,26,7101,16,41925,30922,11003,68,186,38,30
4052,15,6827,11,120,60,60,3,3600,2,1
21545,10,3342,9,181,94,87,2,31,1,1
14606,10,17900,9,774,101,673,2,30,1,1
14728,10,17086,9,93,93,0,1,30,1,0
5898,26,1403,16,234,234,0,4,11,4,0
15254,26,1544,16,7941,1952,5989,20,15,11,9
11729,10,3494,9,350,210,140,6,14,4,2
4395,10,24106,9,224,78,146,2,31,1,1
21539,10,19329,9,214,110,104,2,30,1,1
14986,10,25827,9,216,102,114,2,29,1,1
18310,26,11687,16,7990,1730,6260,25,151,13,12
22589,10,28491,9,811,94,717,2,29,1,1
16499,15,13213,11,2742,1116,1626,11,20,6,5
5834,10,14128,9,164,78,86,2,30,1,1
9728,2801,5969,2174,868,150,718,4,1200,2,2
2603,15,10968,11,7372,954,6418,17,18,9,8
3495,26,26510,16,9490,1158,8332,24,257,13,11
14206,2296,28850,1780,70,70,0,1,5,1,0
9235,26,25892,16,9920,5013,4907,41,15,25,16
9411,2032,15571,1560,2118,858,1260,28,1274,14,14
7899,10,20739,9,248,106,142,2,30,1,1
18780,1989,14467,1519,316,136,180,6,6,3,3
11095,26,18775,16,7851,2487,5364,35,383,16,19
15853,10,25708,9,200,102,98,2,29,1,1
15318,10,18581,9,816,97,719,2,30,1,1
15832,10,25306,9,217,86,131,2,30,1,1
16021,2651,17335,2059,3214,1260,1954,33,1371,17,16
13693,26,16282,16,19775,1890,17885,40,80,17,23
15567,10,15395,9,177,94,83,2,30,1,1
9007,10,13503,9,186,95,91,2,31,1,1
9681,15,14887,11,4186,3559,627,15,31,8,7
15248,10,12582,9,193,102,91,2,30,1,1
17094,26,27714,16,5166,700,4466,16,15,7,9
17605,26,650,16,7775,3174,4601,25,16,11,14
10843,3204,19449,2484,66,66,0,1,5,1,0
15824,26,11008,16,126,60,66,3,6,2,1
8121,26,21057,16,4566,1659,2907,19,27,11,8
9411,850,17511,625,7282,4118,3164,57,1696,35,22
21801,26,7518,16,9155,2109,7046,27,31,15,12
2744,1240,11717,920,890,126,764,2,30,1,1
22167,26,16780,16,2279,1129,1150,25,120,12,13
2744,1238,19888,918,886,126,760,2,30,1,1
14460,10,3094,9,177,94,83,2,30,1,1
2744,64,16740,47,822,126,696,2,30,1,1
14479,10,9198,9,177,94,83,2,30,1,1
22246,10,11132,9,210,110,100,2,29,1,1
15523,10,654,9,183,94,89,2,30,1,1
21780,10,27664,9,221,94,127,2,29,1,1
2744,1569,15118,1200,884,126,758,2,31,1,1
13704,26,23973,16,126,60,66,3,5,2,1
15191,15,6274,11,234,234,0,4,12,4,0
14603,10,4322,9,168,86,82,2,30,1,1
13212,26,6620,16,6275,3787,2488,17,147,8,9
8417,10,27756,9,298,87,211,4,48,2,2
14272,10,24247,9,184,94,90,2,30,1,1
16098,26,25991,16,10044,2134,7910,42,34,23,19
8965,10,7302,9,87,87,0,1,30,1,0
14922,10,5960,9,196,100,96,2,31,1,1
8458,10,15208,9,212,102,110,2,29,1,1
17226,26,27251,16,5329,3428,1901,20,16,10,10
22619,10,6222,9,195,102,93,2,29,1,1
11203,2242,28163,1735,258,70,188,4,9,2,2
9873,10,22136,9,228,97,131,2,30,1,1
22231,10,3437,9,184,94,90,2,31,1,1
9060,10,26117,9,772,102,670,2,30,1,1
22320,10,15108,9,192,98,94,2,30,1,1
9549,10,15337,9,200,102,98,2,30,1,1
21228,10,22963,9,366,102,264,4,60,2,2
11078,2218,27207,1719,258,70,188,4,8,2,2
12762,2121,189,1635,70,70,0,1,4,1,0
1172,26,7392,16,3876,2012,1864,21,315,10,11
13698,10,20507,9,168,78,90,2,30,1,1
7965,26,6190,16,130,70,60,2,15,1,1
16340,26,27202,16,448344,11729,436615,474,157,128,346
18497,502,21605,330,70,70,0,2,8,2,0
14492,10,6721,9,164,84,80,2,30,1,1
9052,10,291,9,198,102,96,2,29,1,1
6932,26,27284,16,122708,5797,116911,169,132,75,94
9004,26,3733,16,58656,12994,45662,148,71,64,84
13891,10,27154,9,209,110,99,2,29,1,1
20832,26,28223,16,4506,1599,2907,19,28,11,8
13622,10,26394,9,199,102,97,2,30,1,1
14243,10,17634,9,225,110,115,2,30,1,1
15749,10,705,9,744,89,655,2,30,1,1
9728,3209,18015,2489,166,166,0,1,1199,1,0
15997,10,6803,9,177,94,83,2,29,1,1
14357,10,17942,9,256,96,160,4,41,2,2
4109,26,22449,16,13428,5815,7613,42,995,22,20
16100,26,5274,16,3586,1074,2512,17,137,8,9
18568,2887,14737,2242,70,70,0,2,8,2,0
14596,10,5190,9,821,102,719,2,30,1,1
12425,540,11569,358,492,306,186,8,15,5,3
21218,2183,14207,1688,246,66,180,4,7,2,2
8983,10,27707,9,751,94,657,2,30,1,1
8173,15,6260,11,3588672,75353,3513319,3500,154,1175,2325
15498,10,11216,9,275,110,165,2,29,1,1
22002,10,24871,9,203,86,117,2,29,1,1
11256,2485,27353,1933,70,70,0,1,5,1,0
5529,26,21991,16,5229,1002,4227,21,16,11,10
9789,10,18983,9,256,93,163,2,31,1,1
11060,26,18976,16,9090,1914,7176,24,25,13,11
2730,26,3212,16,7487,2728,4759,25,19,13,12
15577,15,1986,11,214,140,74,4,30,3,1
9290,10,17439,9,733,86,647,2,31,1,1
12672,2871,27999,2230,70,70,0,1,4,1,0
0,0,0,0,244,244,0,2,0,2,0
8277,10,21279,9,262,106,156,2,32,1,1
7323,26,7023,16,814431,31637,782794,913,315,346,567
22279,10,4498,9,93,93,0,2,60,2,0
9481,15,21920,11,2143,676,1467,12,25,7,5
14228,15,4485,11,70,70,0,2,8,2,0
14224,10,16039,9,188,96,92,2,31,1,1
4236,26,5960,16,1439,878,561,15,17,10,5
18490,15,3077,11,186,64,122,4,28,2,2
8423,10,20487,9,177,94,83,2,30,1,1
14663,10,12313,9,196,102,94,2,31,1,1
15815,10,4906,9,757,98,659,2,31,1,1
15822,10,12545,9,200,102,98,2,31,1,1
6517,26,8999,16,10100,3072,7028,25,16,14,11
22565,10,26615,9,261,102,159,2,30,1,1
22700,26,27841,16,430254,12640,417614,442,16,155,287
15548,10,23515,9,194,99,95,2,30,1,1
13710,26,13096,16,5233,3384,1849,21,62,11,10
22634,15,12463,11,366,180,186,7,28,4,3
140,15,302,11,101959,5508,96451,111,95,41,70
15615,10,15312,9,197,102,95,2,30,1,1
10768,2412,12006,1877,70,70,0,2,8,2,0
589,8,2279,8,130,66,64,2,5,1,1
20933,26,4928,16,36819,3967,32852,59,152,30,29
1394,10,4793,9,220,90,130,2,30,1,1
22246,10,5835,9,243,94,149,2,30,1,1
5437,10,10781,9,168,78,90,2,30,1,1
14856,26,10232,16,10226,4435,5791,50,256,24,26
10,20,24123,14,96,96,0,2,31,2,0
21635,10,14598,9,174,89,85,2,30,1,1
18978,26,25877,16,12163,4876,7287,35,50,20,15
14409,10,18571,9,200,102,98,2,30,1,1
12557,26,21019,16,318,192,126,6,15,4,2
15847,10,20863,9,758,93,665,2,30,1,1
16021,2577,26837,1999,5231,5231,0,79,5173,79,0
17190,10,26087,9,198,90,108,2,30,1,1
9665,26,3871,16,11880,1972,9908,29,78,15,14
21218,10,202,9,183,94,89,2,29,1,1
21402,10,25817,9,177,94,83,2,30,1,1
11119,26,25130,16,4408,801,3607,16,34,8,8
8888,10,17490,9,200,102,98,2,31,1,1
19759,15,27534,11,11822,1162,10660,22,20,11,11
4869,26,6198,16,9528,2738,6790,27,81,15,12
22639,26,14706,16,3224,2373,851,17,23,9,8
15383,26,13492,16,7981,1961,6020,20,15,11,9
8947,10,6053,9,194,102,92,2,30,1,1
11089,2408,21840,1873,70,70,0,2,8,2,0
17859,10,18369,9,304,86,218,2,30,1,1
3133,2290,9972,1775,462,462,0,8,3632,8,0
15664,26,895,16,3578432,133577,3444855,4291,426,1634,2657
22616,10,1379,9,402,142,260,2,30,1,1
14957,10,19838,9,196,100,96,2,30,1,1
22305,10,16698,9,199,102,97,2,29,1,1
16147,15,25478,11,126266,7980,118286,126,25,37,89
14862,10,4782,9,170,87,83,2,30,1,1
4449,15,22354,11,1584,1130,454,15,39,10,5
18292,15,12058,11,21163,16003,5160,47,151,30,17
10973,15,19004,11,306,120,186,6,27,3,3
8516,15,9904,11,185645,6753,178892,213,81,89,124
20483,26,11221,16,304,86,218,2,29,1,1
8656,10,22302,9,246,94,152,2,30,1,1
21876,10,25165,9,184,94,90,2,30,1,1
20251,26,12000,16,7023,2352,4671,18,75,10,8
22675,26,17281,16,375786,11380,364406,388,16,137,251
9648,10,5496,9,168,86,82,2,31,1,1
8906,10,27023,9,341,85,256,4,42,2,2
10753,474,18975,308,70,70,0,2,8,2,0
12135,26,23343,16,1419,788,631,15,121,8,7
9092,10,21732,9,229,90,139,2,30,1,1
13560,26,12250,16,9829,2313,7516,37,25,19,18
15656,10,9576,9,239,94,145,2,29,1,1
12802,281,2546,178,70,70,0,1,5,1,0
13741,10,9034,9,177,94,83,2,30,1,1
21230,10,974,9,348,102,246,4,39,2,2
12807,591,16486,402,70,70,0,2,7,2,0
14250,1650,28255,1267,70,70,0,2,8,2,0
22379,10,15160,9,511,195,316,6,56,3,3
4860,305,19559,199,4615,664,3951,15,15,9,6
2744,1239,20577,919,882,126,756,2,30,1,1
4799,26,21638,16,7051,5086,1965,32,100,18,14
16383,15,5348,11,6510,1210,5300,15,18,8,7
7346,26,19939,16,1494,898,596,12,142,6,6
8450,10,3234,9,251,102,149,2,30,1,1
8584,1239,5837,919,236,71,165,2,30,1,1
22171,10,28895,9,398,255,143,3,33,2,1
8584,1238,11273,918,248,78,170,2,30,1,1
10828,26,22658,16,14904,6448,8456,33,30,18,15
15469,10,8099,9,256,87,169,2,30,1,1
14263,10,24432,9,177,94,83,2,29,1,1
7770,26,15411,16,7201,3870,3331,33,315,17,16
13812,10,9285,9,177,94,83,2,30,1,1
9718,15,12150,11,318,192,126,6,25,4,2
21513,10,470,9,199,102,97,2,30,1,1
22407,26,18701,16,1786,172,1614,7,120,3,4
21947,10,15844,9,212,108,104,2,30,1,1
18131,26,6974,16,2845,1765,1080,15,142,8,7
13855,10,2852,9,196,102,94,2,33,1,1
10869,1303,10959,981,70,70,0,2,7,2,0
18445,3144,7677,2438,70,70,0,2,8,2,0
14233,10,3485,9,711,87,624,2,30,1,1
15233,10,8614,9,177,94,83,2,29,1,1
8337,26,9648,16,7743,1601,6142,18,16,10,8
15313,10,16703,9,821,102,719,2,30,1,1
10916,1794,4285,1369,70,70,0,2,8,2,0
8373,10,18602,9,179,94,85,2,31,1,1
9993,183,22206,121,4241,2521,1720,18,32,10,8
8763,10,28457,9,216,102,114,2,30,1,1
6250,2008,25144,1538,208,86,122,4,29,2,2
8452,10,20871,9,168,78,90,2,30,1,1
4424,26,21114,16,416,210,206,7,29,4,3
9763,15,13794,11,499,192,307,6,26,4,2
21479,10,14502,9,193,102,91,2,30,1,1
637,287,8240,184,492,150,342,2,1200,1,1
10907,607,19583,418,66,66,0,1,5,1,0
14292,10,16075,9,195,102,93,2,30,1,1
8767,10,13011,9,178,94,84,2,30,1,1
9242,15,19621,11,38045,26409,11636,105,476,68,37
1765,341,24693,217,274,150,124,4,60,2,2
7281,26,25984,16,1925,1120,805,16,25,9,7
6250,1988,24889,1518,148,86,62,2,29,1,1
13952,10,3990,9,190,97,93,2,30,1,1
21229,10,26288,9,190,97,93,2,31,1,1
15196,10,12746,9,177,94,83,2,31,1,1
14996,10,2625,9,389,126,263,2,30,1,1
4835,1786,13951,1364,481,150,331,2,1199,1,1
21331,10,20860,9,501,94,407,4,52,2,2
13726,10,25748,9,168,86,82,2,30,1,1
8869,15,11484,11,71256,962,70294,63,52,11,52
8415,10,220,9,301,90,211,4,46,2,2
13825,26,2442,16,5839,1984,3855,19,18,11,8
16294,26,25571,16,4378,1471,2907,19,26,11,8
13487,26,3823,16,6668,1926,4742,20,15,11,9
14209,3223,12366,2500,316,190,126,5,15,3,2
8729,15,23884,11,1515,481,1034,11,15,6,5
9274,26,4041,16,125395,8711,116684,178,143,83,95
9161,10,18499,9,209,110,99,2,29,1,1
17420,10,1159,9,320,94,226,2,30,1,1
14283,10,1451,9,524,214,310,6,57,3,3
21322,10,15337,9,259,110,149,2,29,1,1
2724,1240,10422,920,168,82,86,2,30,1,1
6387,26,1702,16,8820,2996,5824,27,95,14,13
14868,10,2868,9,177,94,83,2,30,1,1
21091,2493,16320,1940,66,66,0,2,7,2,0
15066,15,7159,11,64702,3709,60993,76,135,30,46
12605,26,10101,16,16482,9312,7170,39,141,19,20
13631,26,20215,16,322265,12756,309509,409,270,173,236
225,10,193,9,204,118,86,2,30,1,1
13305,15,18052,11,2091,799,1292,10,15,6,4
18900,10,12414,9,168,78,90,2,31,1,1
4028,26,15193,16,5172,1925,3247,22,39,13,9
18903,26,26477,16,847673,42767,804906,1045,89,441,604
18455,73,22884,56,70,70,0,2,8,2,0
13636,10,24445,9,282,96,186,4,48,2,2
17725,26,167,16,2582500,86854,2495646,2678,84,986,1692
3066,2630,11721,2040,502,150,352,2,1200,1,1
13383,26,12571,16,40096,3155,36941,50,135,19,31
19785,15,28968,11,10924,548,10376,17,48,6,11
8468,26,2059,16,6550,1836,4714,25,46,15,10
2744,1236,16298,916,869,126,743,2,30,1,1
7565,10,20241,9,832,106,726,2,30,1,1
9600,15,14121,11,4473,3398,1075,14,34,8,6
10096,15,29114,11,1439,697,742,12,35,6,6
636,1760,18213,1345,228,118,110,2,1199,1,1
22312,10,7270,9,354,94,260,2,29,1,1
6991,26,3606,16,7570,1955,5615,24,1179,12,12
22009,10,10356,9,740,93,647,2,31,1,1
14185,10,10208,9,194,102,92,2,30,1,1
8253,26,10382,16,12753,6074,6679,44,88,23,21
8486,10,1255,9,198,101,97,2,30,1,1
22433,234,23111,149,4149,2263,1886,46,708,23,23
21568,10,11180,9,202,103,99,2,31,1,1
17939,26,25504,16,7284,1079,6205,29,53,13,16
12168,26,9542,16,36459,6736,29723,54,29,24,30
3396,26,1155,16,35991,3996,31995,58,17,26,32
14539,10,6865,9,760,97,663,2,30,1,1
6261,26,22907,16,10723,2046,8677,29,116,10,19
12921,26,973,16,190,70,120,4,15,2,2
21965,10,8862,9,204,96,108,2,0,1,1
9660,10,25798,9,168,86,82,2,30,1,1
6610,26,10445,16,6919,1449,5470,21,186,12,9
7441,26,10026,16,172,172,0,2,5,2,0
14200,10,9196,9,70,70,0,1,29,1,0
2816,26,6200,16,11716,1007,10709,42,383,11,31
17583,15,26341,11,1915,1466,449,10,19,6,4
10679,15,25179,11,318,192,126,6,38,4,2
18463,2887,7345,2242,70,70,0,1,5,1,0
14992,10,14093,9,338,110,228,2,30,1,1
1219,2498,27966,1944,481,150,331,2,1201,1,1
1854,10,7009,9,217,87,130,2,30,1,1
14915,10,13422,9,209,110,99,2,30,1,1
15093,10,15824,9,177,94,83,2,30,1,1
6250,2000,17245,1530,148,86,62,2,31,1,1
22383,10,14192,9,751,95,656,2,30,1,1
13766,10,24144,9,758,96,662,2,31,1,1
14161,15,26906,11,3334,2314,1020,19,39,11,8
22294,10,28347,9,230,110,120,2,30,1,1
14761,10,28262,9,198,102,96,2,30,1,1
22392,1298,3742,976,234,78,156,2,30,1,1
15263,10,16447,9,192,98,94,2,30,1,1
21271,10,27919,9,199,102,97,2,30,1,1
2063,295,8123,190,3610,2043,1567,16,15,9,7
10510,15,21525,11,214,140,74,4,15,3,1
14136,10,24315,9,200,102,98,2,30,1,1
2343,10,9647,9,194,87,107,2,31,1,1
18525,2434,14754,1893,70,70,0,2,8,2,0
4785,26,28619,16,424,210,214,7,131,4,3
8409,10,2705,9,166,85,81,2,31,1,1
21360,10,3987,9,351,102,249,4,43,2,2
12288,10,14006,9,261,261,0,4,47,4,0
5972,26,9655,16,13890,5926,7964,36,84,20,16
21368,10,3367,9,225,110,115,2,30,1,1
16951,255,25970,160,62,62,0,1,5,1,0
6645,15,3310,11,2277,1521,756,16,16,10,6
1743,10,27457,9,464,287,177,3,30,2,1
15345,2708,22770,2104,70,70,0,2,8,2,0
11983,26,5308,16,97276,2756,94520,96,96,21,75
14508,10,14886,9,168,86,82,2,30,1,1
16361,10,19279,9,174,81,93,2,30,1,1
18366,26,1128,16,7515,2022,5493,21,144,11,10
14122,10,16876,9,195,102,93,2,30,1,1
12483,1404,21078,1067,70,70,0,2,8,2,0
15090,10,7225,9,166,86,80,2,30,1,1
2744,67,24588,50,903,126,777,2,30,1,1
9327,10,24339,9,196,102,94,2,30,1,1
13611,10,15662,9,99,99,0,1,30,1,0
6408,26,18884,16,3508,2120,1388,20,241,10,10
14118,10,6830,9,822,102,720,2,30,1,1
21737,10,8027,9,198,101,97,2,31,1,1
21911,10,20517,9,184,94,90,2,30,1,1
22418,10,10649,9,833,290,543,8,88,4,4
19313,15,26350,11,31954,2972,28982,71,138,36,35
22013,10,18558,9,184,94,90,2,31,1,1
15537,10,19656,9,267,87,180,4,54,2,2
8451,10,13892,9,245,102,143,2,29,1,1
15941,26,25473,16,1054,567,487,10,38,6,4
7501,26,12588,16,4900,904,3996,16,97,9,7
10742,2717,27696,2111,70,70,0,1,5,1,0
15148,10,9158,9,177,94,83,2,29,1,1
11242,2619,2592,2030,70,70,0,2,6,2,0
12245,10,25963,9,242,78,164,2,29,1,1
21757,10,13552,9,198,101,97,2,31,1,1
15828,10,25760,9,288,94,194,2,30,1,1
4534,26,18896,16,9631,4184,5447,33,271,17,16
9808,26,14497,16,9666,1682,7984,25,16,13,12
8381,10,28740,9,227,102,125,2,30,1,1
9373,15,18999,11,9659,1454,8205,28,278,13,15
17856,10,7767,9,382,164,218,2,31,1,1
14010,10,2951,9,271,93,178,4,43,2,2
18289,15,8659,11,8317,6126,2191,23,151,14,9
10823,545,10652,362,70,70,0,1,5,1,0
5444,10,28550,9,168,78,90,2,30,1,1
6187,15,3331,11,8370,1025,7345,18,80,10,8
21749,10,28624,9,231,86,145,2,30,1,1
9189,10,19026,9,536,120,416,4,59,2,2
14451,10,17733,9,184,94,90,2,30,1,1
9737,15,10252,11,2365,1068,1297,13,79,7,6
7702,26,1037,16,3304,2161,1143,21,16,11,10
8772,10,7399,9,258,110,148,2,30,1,1
14896,10,9601,9,198,102,96,2,30,1,1
8693,10,18430,9,268,94,174,2,29,1,1
14716,10,7119,9,207,86,121,2,30,1,1
9659,15,25976,11,7871,1409,6462,17,75,7,10
3183,10,13482,9,197,90,107,2,30,1,1
14949,10,8015,9,817,98,719,2,30,1,1
21417,10,20092,9,177,94,83,2,30,1,1
4768,26,7317,16,138037,13843,124194,197,206,94,103
8674,26,15166,16,4151,1015,3136,16,27,8,8
5778,15,5513,11,31286,2032,29254,50,30,26,24
15047,10,28219,9,177,94,83,2,31,1,1
22721,10,8203,9,819,102,717,2,30,1,1
6428,10,22629,9,308,118,190,2,30,1,1
13544,26,27725,16,9238,3472,5766,43,75,24,19
8794,10,2534,9,168,86,82,2,31,1,1
21914,10,27796,9,182,93,89,2,31,1,1
14732,10,12804,9,284,94,190,2,29,1,1
14743,15,19578,11,1286,403,883,16,400,4,12
14728,10,2683,9,167,86,81,2,30,1,1
11306,26,22880,16,1880,941,939,17,21,7,10
4730,26,14637,16,12531,5566,6965,34,46,20,14
6206,10,18250,9,227,88,139,2,31,1,1
1337,1981,2076,1511,356,170,186,6,53,3,3
13908,10,1709,9,193,102,91,2,30,1,1
13863,10,6583,9,744,89,655,2,31,1,1
19625,15,4291,11,4268,653,3615,13,45,7,6
16503,15,4858,11,5171,3018,2153,16,30,8,8
10094,26,4616,16,8949,1200,7749,21,85,10,11
11196,2957,6000,2294,70,70,0,2,8,2,0
21369,26,28496,16,5647,2402,3245,26,159,14,12
10951,15,20307,11,35092,3319,31773,48,31,21,27
8829,10,1615,9,195,102,93,2,29,1,1
12357,10,9906,9,168,78,90,2,30,1,1
15750,10,6952,9,179,94,85,2,30,1,1
12908,26,742,16,2637658,83234,2554424,2794,140,929,1865
22426,10,7951,9,79,79,0,2,34,2,0
10632,26,21532,16,10614,5312,5302,25,91,14,11
10844,2835,5263,2201,70,70,0,2,7,2,0
8786,10,6291,9,211,110,101,2,30,1,1
16021,2066,10000,1592,2128,875,1253,26,1980,13,13
11363,26,27952,16,7847,2985,4862,30,337,16,14
10841,962,6580,710,66,66,0,1,5,1,0
22705,10,8822,9,209,110,99,2,30,1,1
6622,26,3398,16,6886,1291,5595,27,285,15,12
7683,26,20119,16,2809,1884,925,19,26,11,8
11051,1576,26026,1206,70,70,0,2,8,2,0
13501,26,20798,16,12861,6761,6100,34,164,20,14
15889,26,28516,16,2687,1728,959,23,15,12,11
18384,26,6862,16,1743,1164,579,16,25,10,6
13716,10,5684,9,733,86,647,2,31,1,1
8387,153,16958,108,70,70,0,2,8,2,0
10313,26,13014,16,12274,2677,9597,51,17,29,22
14937,10,463,9,758,96,662,2,31,1,1
14100,10,8984,9,216,110,106,2,30,1,1
15171,10,22122,9,199,102,97,2,30,1,1
4348,26,14623,16,8674,2101,6573,25,15,13,12
7567,10,26556,9,168,78,90,2,30,1,1
8649,10,27099,9,319,94,225,2,29,1,1
17238,26,12071,16,6403,4065,2338,22,16,11,11
8912,26,695,16,54014,2565,51449,65,128,24,41
22462,10,22541,9,198,94,104,2,29,1,1
12224,15,1147,11,1712,913,799,12,273,7,5
14841,10,20164,9,531,90,441,4,41,2,2
13635,26,22425,16,36008,2548,33460,55,69,26,29
21662,10,16192,9,184,94,90,2,31,1,1
1172,2005,8731,1535,156,94,62,2,30,1,1
10472,26,28724,16,7842,1155,6687,19,105,10,9
2724,1240,13399,920,168,82,86,2,30,1,1
18647,10,0,0,344,94,250,2,29,1,1
15199,10,26629,9,328,87,241,4,52,2,2
21651,10,6712,9,783,197,586,6,70,3,3
14113,10,27535,9,183,94,89,2,30,1,1
13644,10,20181,9,166,86,80,2,31,1,1
9281,26,16596,16,15687,3764,11923,32,34,18,14
8236,10,21224,9,215,80,135,2,32,1,1
14456,10,8428,9,177,94,83,2,30,1,1
6250,26,2242,16,70,70,0,1,30,1,0
21343,10,28478,9,1184,83,1101,4,59,2,2
15385,10,12187,9,177,94,83,2,30,1,1
6082,10,0,0,86,86,0,1,30,1,0
14118,10,17006,9,199,102,97,2,30,1,1
18604,10,28269,9,211,78,133,2,30,1,1
1731,2637,18448,2046,481,150,331,2,1200,1,1
2455,10,10180,9,200,90,110,2,30,1,1
17343,26,10467,16,5464,3984,1480,35,221,20,15
7091,676,27224,475,130,70,60,2,5,1,1
3763,10,14747,9,253,99,154,2,32,1,1
20360,10,27923,9,235,90,145,2,32,1,1
21206,10,20648,9,388,134,254,2,30,1,1
10828,1839,4707,1400,70,70,0,2,8,2,0
6322,26,11343,16,7352,1592,5760,25,16,15,10
10789,2833,7837,2200,70,70,0,1,5,1,0
12774,2155,13338,1664,1973,1021,952,10,15,6,4
13757,26,2742,16,3411,887,2524,12,120,6,6
10849,3021,16689,2349,70,70,0,1,5,1,0
21602,10,20916,9,392,102,290,2,30,1,1
21824,10,28827,9,166,85,81,2,31,1,1
18844,232,27055,147,3848,1039,2809,37,662,11,26
12692,26,11289,16,499,425,74,4,0,3,1
9071,10,13211,9,363,98,265,4,54,2,2
15221,26,5105,16,7862,1873,5989,20,15,11,9
9116,15,19947,11,4023,620,3403,14,15,7,7
15197,10,17944,9,179,94,85,2,31,1,1
12596,3094,10281,2403,672,306,366,11,16,5,6
20283,26,3358,16,27905,17646,10259,131,308,73,58
5848,26,23840,16,4974,2311,2663,29,79,15,14
8832,15,5519,11,7270,3119,4151,14,41,7,7
2863,2010,28213,1540,140,78,62,2,30,1,1
12572,26,25809,16,499,425,74,4,0,3,1
7831,26,7153,16,7769,2586,5183,18,121,9,9
7252,10,12364,9,168,78,90,2,30,1,1
3858,26,25325,16,167,107,60,2,5,1,1
22085,10,27260,9,166,86,80,2,29,1,1
16384,15,10575,11,6453,1210,5243,14,24,8,6
14567,10,5915,9,177,94,83,2,30,1,1
9638,26,27898,16,5331564,43954,5287610,4171,80,672,3499
11682,26,26808,16,19919,2270,17649,38,26,21,17
2034,10,10981,9,236,86,150,2,29,1,1
10327,2718,7879,2112,1487,594,893,19,1571,10,9
14914,10,5598,9,202,103,99,2,31,1,1
4311,26,2867,16,9423,2105,7318,31,26,16,15
14272,2282,16536,1767,70,70,0,2,8,2,0
22338,10,12316,9,167,86,81,2,30,1,1
2640,15,11093,11,17147,1829,15318,28,17,15,13
15150,26,4334,16,6974,1513,5461,21,81,11,10
8757,10,15454,9,168,86,82,2,31,1,1
21848,10,17060,9,179,94,85,2,31,1,1
15122,10,1838,9,177,94,83,2,30,1,1
9155,26,26703,16,622,210,412,10,21,4,6
15501,10,4473,9,178,94,84,2,31,1,1
9052,10,23833,9,196,100,96,2,30,1,1
15586,10,26777,9,172,88,84,2,30,1,1
22020,10,839,9,172,88,84,2,30,1,1
8584,1240,28361,920,256,71,185,2,30,1,1
15793,10,5982,9,748,95,653,2,30,1,1
15917,10,12331,9,231,110,121,2,30,1,1
12461,58,8840,41,320,140,180,6,6,3,3
12921,15,6504,11,214,140,74,4,15,3,1
21265,2163,23148,1671,70,70,0,1,5,1,0
12768,26,11794,16,499,425,74,4,0,3,1
15292,10,1452,9,183,94,89,2,29,1,1
18221,26,13520,16,21278,12533,8745,57,183,36,21
22269,10,21826,9,297,101,196,4,33,2,2
10989,26,11635,16,2648,1797,851,19,23,11,8
21746,10,24600,9,244,118,126,2,30,1,1
14271,10,15802,9,183,94,89,2,30,1,1
22197,10,14669,9,183,94,89,2,30,1,1
7407,10,3040,9,199,94,105,2,30,1,1
17876,10,2657,9,211,78,133,2,30,1,1
2392,10,9878,9,338,225,113,3,30,2,1
9638,15,23000,11,18059,13615,4444,29,27,16,13
11862,26,25967,16,23572,2063,21509,46,114,20,26
5973,26,6679,16,3467,2269,1198,21,82,11,10
5111,26,7182,16,749731,23099,726632,823,16,326,497
6057,26,15796,16,40273,3243,37030,60,77,28,32
9148,10,4505,9,373,88,285,4,58,2,2
22163,10,20343,9,224,86,138,2,30,1,1
17908,26,18890,16,6603,1085,5518,23,28,11,12
6871,10,19212,9,233,91,142,2,30,1,1
12200,26,16930,16,30796,3050,27746,60,30,32,28
21447,10,1104,9,276,94,182,2,30,1,1
5510,15,9793,11,1056,682,374,10,15,6,4
14640,10,8518,9,177,94,83,2,29,1,1
3513,15,27808,11,1638,1324,314,10,16,5,5
0,0,0,0,124,64,60,2,0,1,1
13690,26,18150,16,10001,2547,7454,27,35,14,13
7686,10,20397,9,244,98,146,2,31,1,1
21704,10,1630,9,184,94,90,2,30,1,1
10745,26,15173,16,4175264,89546,4085718,4141,532,1111,3030
8309,10,4389,9,168,78,90,2,30,1,1
13337,26,19922,16,28386,15864,12522,59,471,31,28
8210,517,21194,341,152,152,0,1,1200,1,0
21063,2080,11421,1602,70,70,0,1,4,1,0
15091,26,17295,16,4989,1014,3975,16,32,9,7
19847,10,7556,9,239,102,137,2,30,1,1
2082,10,8220,9,235,90,145,2,32,1,1
11373,10,3015,9,186,78,108,2,29,1,1
2724,1240,5076,920,422,164,258,6,30,3,3
2724,1240,17405,920,422,164,258,6,30,3,3
14711,10,26751,9,167,86,81,2,30,1,1
9491,15,19053,11,1671,862,809,10,15,5,5
11880,26,8632,16,291803,6522,285281,284,113,58,226
16021,280,4325,177,132,132,0,3,1200,3,0
2744,1271,16774,951,921,126,795,2,30,1,1
13789,10,20906,9,744,89,655,2,30,1,1
22231,26,19866,16,5507,3397,2110,13,120,7,6
9834,15,8477,11,4805,3639,1166,16,31,9,7
11210,26,6310,16,11127,1324,9803,24,75,12,12
8734,10,13653,9,168,86,82,2,31,1,1
11466,26,7453,16,8788,2185,6603,15,134,7,8
18407,26,11503,16,36547,3840,32707,88,241,43,45
10572,26,10181,16,8517,2719,5798,24,360,12,12
21327,10,28255,9,275,102,173,2,30,1,1
15087,10,21680,9,1165,94,1071,2,30,1,1
8829,26,22979,16,8161,1929,6232,26,46,15,11
16924,10,1971,9,197,86,111,2,29,1,1
15334,10,18419,9,338,118,220,2,30,1,1
22420,10,2620,9,371,97,274,4,53,2,2
10400,26,17712,16,11191,4657,6534,32,129,14,18
12605,26,14261,16,499,425,74,4,0,3,1
10792,575,13434,389,70,70,0,1,5,1,0
9047,26,905,16,4960,1114,3846,21,51,12,9
15292,15,17343,11,3894448,104279,3790169,4041,97,1411,2630
8409,10,15874,9,183,94,89,2,30,1,1
16663,18,5321,13,184,94,90,2,30,1,1
4653,26,27677,16,97539,6936,90603,160,597,74,86
598,10,2361,9,229,90,139,2,30,1,1
12148,26,28261,16,27501,3878,23623,57,54,24,33
11126,15,16446,11,366,240,126,7,25,5,2
9019,15,20056,11,41720,6568,35152,47,89,17,30
6666,26,20862,16,13974,3774,10200,29,120,12,17
22054,10,23518,9,241,94,147,2,30,1,1
16436,15,27563,11,4402,2878,1524,29,105,15,14
19221,26,9314,16,44341,5858,38483,102,195,42,60
8341,10,3974,9,264,110,154,2,30,1,1
8888,10,28780,9,200,102,98,2,29,1,1
14912,10,17325,9,271,95,176,4,48,2,2
9992,26,11494,16,6886,1380,5506,19,132,9,10
3815,10,14864,9,244,98,146,2,33,1,1
2888,26,5073,16,5458,1390,4068,17,15,9,8
9512,10,28313,9,763,102,661,2,30,1,1
8437,10,18027,9,735,88,647,2,30,1,1
9200,10,10387,9,177,94,83,2,30,1,1
11659,26,8778,16,11732,4753,6979,41,397,17,24
11383,26,10354,16,33906,25094,8812,63,447,36,27
13627,10,20586,9,731,91,640,2,31,1,1
16452,15,23689,11,4065,2650,1415,25,75,13,12
22012,10,26080,9,88,88,0,1,30,1,0
8366,10,10500,9,193,102,91,2,30,1,1
18004,26,9562,16,1537,934,603,14,32,7,7
1910,10,7321,9,230,90,140,2,30,1,1
15927,26,2041,16,7211,823,6388,16,15,10,6
19328,26,14327,16,41274,18956,22318,90,171,43,47
13627,10,1063,9,308,102,206,2,30,1,1
5613,26,2246,16,2387,979,1408,15,36,6,9
12747,2286,22212,1771,70,70,0,2,7,2,0
13864,26,7054,16,17915,7421,10494,39,61,21,18
13753,10,2257,9,195,102,93,2,30,1,1
22358,26,15976,16,5753,3034,2719,52,281,25,27
2744,1453,4071,1106,888,126,762,3,31,2,1
14373,10,24141,9,216,110,106,2,30,1,1
3328,26,14787,16,130,70,60,3,4,2,1
6442,26,25160,16,11435,2668,8767,38,233,14,24
18288,15,23905,11,47483,13980,33503,69,151,35,34
9826,15,23166,11,5237,680,4557,12,170,6,6
12024,2126,16228,1640,70,70,0,1,5,1,0
21677,10,20120,9,168,86,82,2,30,1,1
6092,26,18172,16,10518,3356,7162,24,121,11,13
22109,10,4245,9,716,95,621,2,31,1,1
22327,10,17055,9,440,94,346,4,37,2,2
8718,10,26427,9,188,96,92,2,30,1,1
5442,15,17073,11,4774,553,4221,13,20,6,7
5236,26,7240,16,5819,1571,4248,26,58,14,12
10928,2589,3158,2008,70,70,0,1,5,1,0
13840,10,3877,9,195,102,93,2,31,1,1
8724,10,26492,9,186,95,91,2,30,1,1
12250,26,29030,16,5090,1692,3398,19,82,11,8
14430,10,8206,9,182,93,89,2,31,1,1
21231,10,23245,9,345,106,239,4,38,2,2
5502,26,1974,16,5829,1408,4421,21,188,11,10
21677,10,19821,9,168,86,82,2,30,1,1
18043,26,900,16,70,70,0,1,5,1,0
7189,15,22591,11,573,499,74,6,15,5,1
8366,10,14618,9,816,102,714,2,30,1,1
11155,2511,1044,1952,70,70,0,1,5,1,0
11067,2288,13658,1773,316,136,180,6,7,3,3
3299,15,3807,11,1542,831,711,7,15,5,2
22124,10,27366,9,202,103,99,2,31,1,1
14846,10,17520,9,177,94,83,2,31,1,1
10750,2624,15324,2034,70,70,0,1,5,1,0
21975,10,18982,9,193,102,91,2,30,1,1
11128,234,1160,149,3117,1602,1515,31,66,16,15
21897,10,27462,9,193,102,91,2,29,1,1
18474,2969,11555,2305,70,70,0,1,5,1,0
8774,15,21212,11,318,192,126,6,41,4,2
11033,15,4368,11,7464,4661,2803,47,323,30,17
14825,10,18638,9,241,94,147,2,30,1,1
11145,448,27978,287,66,66,0,1,5,1,0
14720,10,3282,9,168,86,82,2,31,1,1
19316,26,10128,16,7206,1897,5309,20,21,11,9
3133,2300,16081,1784,330,330,0,6,3609,6,0
16693,26,25829,16,7134,2478,4656,18,75,10,8
3643,26,21539,16,7037,1282,5755,21,30,11,10
532,247,0,0,3354,1792,1562,46,194,23,23
22066,10,25190,9,340,110,230,2,29,1,1
16125,26,11596,16,2614,1689,925,18,20,10,8
10463,26,5988,16,7788,2581,5207,39,70,19,20
9016,15,20834,11,8868,3774,5094,20,89,10,10
11499,15,28028,11,4297,3719,578,14,15,8,6
6250,2009,9082,1539,546,486,60,2,30,1,1
10997,539,21841,357,70,70,0,2,7,2,0
20448,26,5667,16,829275,26662,802613,884,129,295,589
4843,2504,20563,1947,156,156,0,3,7,3,0
15278,10,23436,9,199,102,97,2,30,1,1
4748,26,17393,16,16742,3383,13359,57,309,28,29
8530,10,25173,9,309,94,215,2,29,1,1
8771,15,9241,11,454,262,192,8,41,5,3
8491,10,10238,9,258,94,164,2,30,1,1
8940,10,1731,9,236,94,142,2,30,1,1
9815,15,7484,11,1658,1247,411,8,15,5,3
9694,26,22035,16,5642,2395,3247,22,38,13,9
5007,1392,19585,1059,1806,1806,0,22,224,22,0
15074,10,9056,9,164,86,78,2,30,1,1
22146,10,28859,9,197,102,95,2,30,1,1
12979,10,3175,9,210,94,116,2,30,1,1
18502,2429,17092,1890,70,70,0,1,5,1,0
3879,26,22271,16,4317,2189,2128,29,82,15,14
8547,10,22061,9,377,110,267,2,31,1,1
8898,15,1527,11,2052,711,1341,10,130,6,4
14831,10,18217,9,711,87,624,2,30,1,1
15223,10,19057,9,199,102,97,2,30,1,1
15734,10,24379,9,192,98,94,2,31,1,1
21627,26,28607,16,4592,1685,2907,19,29,11,8
6810,10,19115,9,182,81,101,2,30,1,1
8671,26,632,16,35158,5065,30093,53,42,18,35
10221,15,17191,11,2792,2073,719,15,30,9,6
6743,10,23175,9,199,94,105,2,30,1,1
22696,10,23543,9,199,102,97,2,30,1,1
4777,26,8320,16,1403708,31893,1371815,1301,162,292,1009
5644,10,17401,9,213,87,126,2,30,1,1
1731,2459,10052,1911,481,150,331,2,1199,1,1
9040,10,24116,9,199,102,97,2,30,1,1
14353,660,869,461,70,70,0,2,8,2,0
7045,26,24305,16,190,70,120,4,15,2,2
13792,26,10802,16,6918,2826,4092,26,21,16,10
22595,10,3599,9,198,110,88,2,30,1,1
781,2685,14718,2085,130,70,60,2,30,1,1
15084,10,15524,9,227,102,125,2,30,1,1
14178,10,19038,9,197,102,95,2,33,1,1
4339,26,23466,16,123782,10685,113097,157,180,65,92
19529,10,8132,9,256,94,162,2,30,1,1
18074,26,9456,16,7152,1299,5853,22,16,12,10
22555,10,13088,9,178,91,87,2,31,1,1
21407,10,15763,9,179,94,85,2,31,1,1
21837,10,7530,9,212,110,102,2,30,1,1
10688,15,15585,11,170875,6864,164011,255,35,93,162
14555,10,21070,9,177,94,83,2,30,1,1
16145,15,25476,11,349583,9149,340434,298,25,62,236
3825,232,20337,147,7064,2904,4160,68,88,33,35
8644,26,19750,16,4241,1161,3080,17,152,9,8
17208,26,3251,16,5166,700,4466,16,16,7,9
15783,10,15129,9,177,94,83,2,30,1,1
1731,1229,329,909,481,150,331,2,1200,1,1
8947,10,25666,9,188,96,92,2,30,1,1
8319,10,22460,9,206,105,101,2,31,1,1
22514,10,28355,9,283,103,180,4,54,2,2
12766,26,10054,16,495,421,74,4,0,3,1
13727,10,24401,9,770,101,669,2,0,1,1
8463,26,22464,16,7419,2173,5246,17,16,9,8
15875,26,21061,16,5612,733,4879,16,15,9,7
15395,10,7322,9,199,94,105,2,30,1,1
21609,10,16260,9,183,94,89,2,31,1,1
15435,10,28273,9,184,102,82,2,30,1,1
11026,26,1143,16,2648,1797,851,19,22,11,8
15186,10,3484,9,91,91,0,1,30,1,0
14828,10,21548,9,180,94,86,2,30,1,1
15384,10,18092,9,178,94,84,2,31,1,1
11449,26,18490,16,4550,1777,2773,17,135,8,9
9624,15,15456,11,318,192,126,6,25,4,2
3510,15,28514,11,3667,1654,2013,20,189,11,9
19199,26,5876,16,7424,3871,3553,26,160,12,14
3133,2329,13341,1813,330,330,0,6,3609,6,0
8368,15,26647,11,2986,825,2161,10,135,6,4
21459,26,28537,16,27723,5572,22151,59,46,31,28
8283,233,15736,148,139,139,0,1,5,1,0
7026,15,3765,11,1492,1050,442,7,15,5,2
21391,10,2078,9,184,94,90,2,31,1,1
12711,2177,13808,1682,70,70,0,1,5,1,0
19163,10,6724,9,261,261,0,4,47,4,0
18733,26,4021,16,10569,3485,7084,27,515,15,12
8291,26,10614,16,7683,1817,5866,42,3089,15,27
8640,10,24178,9,224,86,138,2,29,1,1
22230,10,20390,9,195,102,93,2,31,1,1
4116,26,11733,16,9736,4347,5389,23,361,11,12
3976,10,23125,9,168,78,90,2,30,1,1
9325,26,17920,16,161,101,60,2,5,1,1
9851,15,19199,11,16427,3830,12597,28,25,12,16
7193,15,12905,11,2873,753,2120,12,15,7,5
6623,26,9204,16,6817,1221,5596,26,285,14,12
13639,26,11840,16,23913,3495,20418,50,48,24,26
15357,10,14170,9,197,102,95,2,33,1,1
5102,26,19100,16,90810,3417,87393,94,16,30,64
10095,26,19247,16,7975,3304,4671,19,86,11,8
4999,26,782,16,46008,3750,42258,77,48,39,38
15045,15,22863,11,22601,1621,20980,35,142,18,17
2744,1238,12914,918,877,126,751,2,30,1,1
14077,26,23202,16,6622,859,5763,18,15,10,8
22341,10,9735,9,312,102,210,2,30,1,1
9133,10,23557,9,789,102,687,2,30,1,1
12707,3059,8081,2375,70,70,0,2,8,2,0
17008,15,17777,11,2542,1879,663,12,14,6,6
14938,26,19819,16,3674,1750,1924,23,203,12,11
9743,26,28283,16,11301,5604,5697,29,139,17,12
9108,15,13193,11,3695,550,3145,12,15,6,6
14303,10,18502,9,196,100,96,2,31,1,1
12033,1131,22260,833,698,320,378,10,16,6,4
4664,26,16159,16,1452,817,635,16,20,9,7
4907,10,16409,9,194,87,107,2,30,1,1
2033,26,11230,16,2227,1018,1209,17,15,8,9
9389,15,15433,11,2793,1071,1722,14,105,7,7
9430,26,18597,16,13168,2875,10293,48,99,27,21
21298,10,4293,9,339,118,221,2,29,1,1
10999,15,26483,11,366,240,126,7,25,5,2
15292,10,28304,9,178,94,84,2,30,1,1
10130,10,11073,9,183,86,97,2,30,1,1
10969,1716,6906,1311,70,70,0,1,5,1,0
19261,26,25807,16,7653,1226,6427,24,18,14,10
14237,10,2341,9,178,94,84,2,30,1,1
12660,320,4485,206,70,70,0,2,8,2,0
15346,26,6711,16,7941,1952,5989,20,15,11,9
21702,10,26705,9,329,94,235,4,31,2,2
22175,1258,6801,938,741,462,279,2,31,1,1
10034,15,10964,11,12578792,132594,12446198,10198,133,1845,8353
4004,26,21482,16,6550678,172191,6378487,6426,82,2117,4309
8930,26,20145,16,114197,7285,106912,177,77,85,92
335,10,978,9,244,98,146,2,31,1,1
12008,2912,2085,2261,70,70,0,2,8,2,0
15185,15,2591,11,1604,700,904,15,116,7,8
4346,171,15703,117,138,78,60,2,6,1,1
6150,232,7599,147,5709,2977,2732,62,621,31,31
14247,2154,12789,1663,422,140,282,6,16,3,3
22417,10,17836,9,292,94,198,2,30,1,1
14295,10,12775,9,305,126,179,2,30,1,1
9236,26,17506,16,7976,3333,4643,23,25,12,11
22368,10,8828,9,200,102,98,2,31,1,1
970,26,19221,16,6327,833,5494,19,26,10,9
14502,10,6459,9,193,102,91,2,29,1,1
16038,15,26453,11,1614,1300,314,10,15,5,5
16930,10,25955,9,244,98,146,2,32,1,1
22600,10,27656,9,200,94,106,2,30,1,1
22280,10,28868,9,338,110,228,2,29,1,1
12195,26,12953,16,12053,6627,5426,47,1043,26,21
9040,10,14183,9,199,102,97,2,30,1,1
21762,10,26689,9,183,94,89,2,30,1,1
15141,10,10175,9,164,86,78,2,30,1,1
2744,1236,25088,916,879,126,753,2,30,1,1
22489,10,1359,9,195,102,93,2,30,1,1
9514,26,9758,16,316,136,180,6,6,3,3
15476,10,22200,9,232,94,138,2,30,1,1
13830,10,18124,9,183,94,89,2,31,1,1
9201,295,21781,190,3050,1659,1391,16,15,9,7
13690,10,12752,9,733,93,640,2,31,1,1
18454,2404,4827,1870,164,70,94,2,5,1,1
10971,893,12179,661,70,70,0,2,8,2,0
8815,15,11223,11,378,192,186,7,41,4,3
22467,10,24515,9,273,134,139,2,30,1,1
14568,10,11460,9,216,102,114,2,29,1,1
14126,15,3910,11,204936,10932,194004,277,31,140,137
13722,10,25820,9,192,98,94,2,31,1,1
599,15,2366,11,326,186,140,6,29,4,2
14876,10,11276,9,177,94,83,2,30,1,1
12389,1013,2138,747,70,70,0,2,7,2,0
14091,10,4871,9,209,110,99,2,31,1,1
18493,2627,28298,2037,70,70,0,2,8,2,0
21098,15,26906,11,314,192,122,6,15,4,2
11828,26,12162,16,7573,1986,5587,40,115,19,21
22686,10,15228,9,194,99,95,2,31,1,1
5458,26,12351,16,10412,5123,5289,36,236,19,17
4237,26,14773,16,1147,660,487,11,17,7,4
636,280,6117,177,502,150,352,2,1200,1,1
4912,26,24961,16,11484,3842,7642,30,31,16,14
10996,15,24802,11,83302,3780,79522,105,66,47,58
14216,2539,8620,1973,504,318,186,8,15,5,3
17218,26,6896,16,5166,700,4466,16,16,7,9
9155,15,19862,11,2668,543,2125,12,28,6,6
15361,26,27261,16,238132,13988,224144,317,32,161,156
11030,470,926,305,70,70,0,2,8,2,0
7924,10,28928,9,199,94,105,2,30,1,1
3133,2323,27887,1807,330,330,0,6,3610,6,0
12789,18,13348,13,184,94,90,2,30,1,1
2744,1238,9322,918,879,126,753,2,30,1,1
5842,15,17742,11,18224,2763,15461,29,126,14,15
16604,233,18133,148,15152,5747,9405,46,56,20,26
10773,2029,9190,1557,136,136,0,3,14,3,0
18083,26,435,16,1467,880,587,13,21,7,6
10241,26,14266,16,6625,1673,4952,20,20,10,10
10032,15,18493,11,26867,2743,24124,45,140,23,22
22076,10,23359,9,211,110,101,2,30,1,1
7000,26,28641,16,13791,7866,5925,35,46,20,15
2744,1560,17205,1191,868,126,742,2,30,1,1
17232,26,5752,16,1413,876,537,12,28,6,6
5872,26,16636,16,6964782,246690,6718092,7203,184,2494,4709
17150,10,26071,9,231,90,141,2,29,1,1
21864,10,17028,9,194,102,92,2,31,1,1
21613,10,1287,9,194,94,100,2,30,1,1
9425,10,23816,9,749,94,655,2,29,1,1
8453,10,6996,9,184,94,90,2,31,1,1
11100,26,24413,16,8971,4228,4743,20,95,12,8
22264,10,18645,9,211,102,109,2,30,1,1
15826,10,17835,9,182,93,89,2,31,1,1
13981,10,19482,9,366,94,272,2,30,1,1
14456,26,28155,16,320,140,180,6,15,3,3
22333,10,23502,9,194,102,92,2,29,1,1
14366,10,16047,9,458,188,270,6,29,3,3
11219,10,22836,9,825,99,726,2,30,1,1
21714,26,13979,16,8965,3771,5194,33,124,14,19
8490,10,20568,9,196,102,94,2,29,1,1
19332,26,23270,16,4872,771,4101,17,28,8,9
15109,10,28936,9,164,86,78,2,29,1,1
13631,26,28952,16,263411,11905,251506,318,144,118,200
9147,10,22373,9,749,89,660,2,30,1,1
22509,15,4750,11,2430,531,1899,10,133,6,4
8584,1239,9537,919,254,71,183,2,30,1,1
8958,26,16131,16,9841,3185,6656,25,186,14,11
9353,26,25115,16,8415,3119,5296,26,73,9,17
10623,15,22045,11,3192,624,2568,10,155,5,5
21071,313,12463,204,66,66,0,2,7,2,0
14950,10,1052,9,168,86,82,2,30,1,1
4835,1,23316,1,330,330,0,6,1199,6,0
9784,15,26154,11,2374,936,1438,13,45,7,6
10063,15,26324,11,7978844,97517,7881327,6752,120,1393,5359
6139,26,25698,16,7118,2386,4732,18,133,10,8
21848,10,27231,9,438,89,349,4,44,2,2
15744,10,1921,9,199,94,105,2,29,1,1
21754,10,12782,9,198,102,96,2,31,1,1
18457,493,11862,323,7512,2276,5236,39,94,21,18
6833,10,19144,9,850,114,736,2,30,1,1
14627,10,1699,9,338,106,232,4,37,2,2
21897,10,3878,9,183,86,97,2,30,1,1
22640,10,9226,9,177,94,83,2,30,1,1
22561,10,26654,9,186,95,91,2,31,1,1
16512,15,4732,11,2708,1386,1322,23,75,12,11
14921,10,15346,9,280,78,202,2,30,1,1
2744,1241,17708,921,882,126,756,2,30,1,1
9792,15,3235,11,62,62,0,1,5,1,0
11698,26,6022,16,283,163,120,4,16,2,2
14089,10,3230,9,184,94,90,2,29,1,1
14806,10,24108,9,182,93,89,2,31,1,1
22329,10,26245,9,816,102,714,2,29,1,1
18563,26,15280,16,12006,3698,8308,23,15,13,10
9411,3164,12086,2452,330,330,0,6,1200,6,0
15172,15,27524,11,234,234,0,4,12,4,0
14501,10,7904,9,177,94,83,2,29,1,1
12652,26,7948,16,499,425,74,4,0,3,1
7175,26,21391,16,5291,3987,1304,19,255,11,8
14255,10,1657,9,193,102,91,2,30,1,1
11213,26,2395,16,3560269,64410,3495859,2930,132,383,2547
7444,26,17643,16,24465,3945,20520,39,18,18,21
10252,26,25179,16,9269,5449,3820,70,460,33,37
13037,26,1863,16,499,425,74,4,0,3,1
4017,26,24190,16,304294,8535,295759,302,132,90,212
6421,15,9366,11,2030,586,1444,10,30,6,4
15255,10,10218,9,711,87,624,2,30,1,1
11403,10,22944,9,212,98,114,2,30,1,1
6962,15,10682,11,4336,2408,1928,18,21,10,8
11292,647,7724,451,70,70,0,2,8,2,0
22674,10,25215,9,184,94,90,2,31,1,1
8210,1840,21194,1401,513,152,361,2,1200,1,1
9725,15,27354,11,2573,1859,714,9,47,5,4
8837,10,6506,9,166,86,80,2,29,1,1
13342,26,6389,16,19810,7047,12763,54,438,28,26
13615,10,21768,9,211,102,109,2,29,1,1
5476,10,11025,9,86,86,0,1,30,1,0
8663,10,16714,9,297,102,195,2,29,1,1
15168,26,26112,16,1165,662,503,11,25,6,5
6986,26,18580,16,3239,2220,1019,16,15,9,7
7908,15,20756,11,1904,1455,449,10,19,6,4
15490,10,12060,9,194,102,92,2,30,1,1
4649,26,2483,16,499,425,74,4,0,3,1
6250,2021,8135,1551,148,86,62,2,30,1,1
11221,26,17573,16,7018,1766,5252,23,19,13,10
14738,10,6255,9,177,94,83,2,30,1,1
9135,10,28334,9,198,102,96,2,30,1,1
8347,10,20587,9,402,102,300,2,30,1,1
15460,10,3084,9,250,87,163,4,57,2,2
16814,26,10974,16,111535,9830,101705,141,192,62,79
21806,10,28222,9,194,102,92,2,31,1,1
22484,10,6591,9,180,94,86,2,30,1,1
17973,26,18123,16,622,310,312,11,28,6,5
21659,10,15870,9,183,94,89,2,29,1,1
21932,10,1700,9,174,89,85,2,30,1,1
12657,3022,2463,2350,258,70,188,4,8,2,2
5083,26,23131,16,15266,12916,2350,42,81,24,18
5752,26,6002,16,1656,114,1542,5,120,2,3
15760,10,9449,9,770,102,668,2,31,1,1
11862,26,19457,16,3617,2035,1582,30,346,15,15
21591,10,5685,9,298,102,196,4,43,2,2
8889,26,28174,16,6780,710,6070,16,50,7,9
18539,1505,24320,1145,70,70,0,2,8,2,0
22397,10,4100,9,178,91,87,2,31,1,1
11600,26,6999,16,64748,15327,49421,87,273,39,48
2744,1243,18084,923,898,126,772,2,30,1,1
8462,10,21891,9,280,96,184,4,34,2,2
7178,15,28198,11,16713,1698,15015,31,32,17,14
15250,26,14215,16,7941,1952,5989,20,15,11,9
15760,10,21005,9,711,87,624,2,30,1,1
13727,26,15825,16,3143,2172,971,19,25,9,10
9805,15,6258,11,1658,1247,411,8,15,5,3
16021,603,3313,414,166,166,0,1,1199,1,0
16121,26,6241,16,7150,1958,5192,28,144,14,14
15845,10,17480,9,177,94,83,2,30,1,1
16546,10,16691,9,86,86,0,1,30,1,0
21274,26,28455,16,4673,1766,2907,19,29,11,8
7348,26,19941,16,1494,898,596,12,142,6,6
2744,1629,10883,1251,889,126,763,2,31,1,1
15697,10,21940,9,1425,97,1328,4,53,2,2
3613,23,0,0,18549,5061,13488,54,30,27,27
22649,10,11109,9,197,102,95,2,30,1,1
13957,26,10222,16,5692,1239,4453,23,16,13,10
14943,10,13197,9,195,102,93,2,29,1,1
7980,26,8530,16,138,78,60,2,4,1,1
9626,26,26832,16,7653,1188,6465,21,15,12,9
10024,26,17496,16,8057,1135,6922,19,129,9,10
12888,26,15908,16,1313,652,661,13,185,7,6
9305,15,2880,11,73454,5461,67993,74,79,22,52
10789,2833,26019,2200,70,70,0,2,8,2,0
21541,10,11692,9,193,102,91,2,30,1,1
5277,273,6243,172,922,428,494,10,15,5,5
13969,10,11822,9,194,102,92,2,29,1,1
14937,10,10183,9,184,102,82,2,30,1,1
13541,26,14500,16,424,210,214,7,131,4,3
10830,15,3033,11,2169,472,1697,10,77,6,4
15546,10,5092,9,186,95,91,2,31,1,1
21861,10,25628,9,231,110,121,2,30,1,1
9002,26,2249,16,8555,1821,6734,24,123,13,11
10059,15,28520,11,876,519,357,10,75,6,4
7374,26,7169,16,130,70,60,2,15,1,1
14263,1925,26896,1469,70,70,0,2,8,2,0
618,15,2482,11,326,186,140,6,29,4,2
1017,26,14419,16,3255,430,2825,11,15,6,5
18495,2772,9536,2151,701,455,246,8,15,4,4
8977,10,11282,9,193,102,91,2,31,1,1
3401,26,3002,16,89817,21083,68734,148,36,77,71
22640,10,29026,9,507,193,314,6,57,3,3
127,26,263,16,12030,1282,10748,23,17,9,14
22143,10,13944,9,174,89,85,2,31,1,1
8820,10,23249,9,214,110,104,2,30,1,1
12115,26,8544,16,5993,974,5019,19,59,10,9
9501,26,16725,16,1786,172,1614,7,121,3,4
6222,10,19833,9,199,94,105,2,30,1,1
14355,2198,1578,1702,70,70,0,2,8,2,0
8914,26,10362,16,7084,1703,5381,19,128,10,9
4861,26,4728,16,1851,1222,629,16,27,10,6
9331,15,21843,11,1473,920,553,9,137,6,3
2692,26,8935,16,22489,15918,6571,39,26,21,18
16492,15,13959,11,2339,1122,1217,11,20,6,5
9804,26,385,16,3845,1814,2031,19,38,11,8
12546,3021,18460,2349,164,70,94,2,8,1,1
9664,10,21204,9,183,94,89,2,30,1,1
14315,2421,5389,1883,258,70,188,4,8,2,2
15354,2168,25715,1674,70,70,0,2,8,2,0
2744,1302,24318,980,879,126,753,2,30,1,1
8774,10,28194,9,198,110,88,2,29,1,1
4744,10,16207,9,180,82,98,2,30,1,1
4649,18,1716,13,184,94,90,2,30,1,1
10932,26,6981,16,6155,888,5267,17,15,8,9
13169,15,364,11,1378,808,570,13,361,7,6
22290,10,8489,9,183,94,89,2,31,1,1
11041,15,10945,11,23580,10536,13044,36,39,18,18
14960,10,12662,9,166,86,80,2,31,1,1
4224,26,17332,16,48494,10293,38201,71,129,26,45
21430,10,24336,9,258,110,148,2,30,1,1
9049,295,21709,190,3132,815,2317,14,15,7,7
17290,26,28335,16,4979,1505,3474,21,40,11,10
22014,10,26007,9,768,99,669,2,31,1,1
21781,10,16045,9,495,127,368,4,33,2,2
15022,10,26691,9,168,86,82,2,30,1,1
14461,10,13905,9,265,86,179,4,58,2,2
9728,576,9565,390,161,161,0,2,1200,2,0
7483,15,21050,11,1447,468,979,9,181,5,4
8889,10,11181,9,209,110,99,2,30,1,1
11213,26,2209,16,10107,1324,8783,22,75,12,10
15996,10,15603,9,198,101,97,2,31,1,1
21960,10,8164,9,383,90,293,4,43,2,2
4523,26,3263,16,4578,2334,2244,21,16,12,9
13662,10,10697,9,762,98,664,2,30,1,1
2744,1239,11101,919,885,126,759,2,30,1,1
12742,2831,24953,2198,70,70,0,1,4,1,0
20466,401,19667,260,823,577,246,9,15,5,4
22019,15,23994,11,378,192,186,7,71,4,3
9728,3151,9266,2441,1275,300,975,6,1200,3,3
2990,10,18985,9,323,77,246,4,30,2,2
9503,15,5924,11,1770,961,809,10,15,5,5
19443,10,27328,9,213,79,134,2,33,1,1
8888,26,21369,16,28376,3058,25318,42,63,17,25
19430,26,27320,16,38146,3555,34591,57,16,28,29
14041,10,12145,9,711,87,624,2,30,1,1
8509,10,27448,9,402,118,284,2,30,1,1
11141,15,21521,11,1582,866,716,11,20,7,4
15986,10,1105,9,200,102,98,2,31,1,1
22480,10,4671,9,333,102,231,2,29,1,1
12647,26,23800,16,499,425,74,4,0,3,1
15247,10,28536,9,177,94,83,2,30,1,1
6808,232,25105,147,6329,3447,2882,67,841,34,33
10869,15,14711,11,3240,1194,2046,14,20,9,5
8867,15,7806,11,6132,634,5498,13,130,6,7
9688,10,19442,9,969,86,883,2,30,1,1
19155,10,21911,9,281,94,187,2,30,1,1
8210,2983,21194,2317,580,121,459,4,1199,2,2
4835,692,25684,491,481,150,331,2,1200,1,1
20867,10,28239,9,236,94,142,2,30,1,1
17138,26,13184,16,5167,700,4467,16,15,7,9
4577,26,16344,16,130,70,60,3,5,2,1
15289,26,17098,16,8057,2037,6020,20,15,11,9
12502,26,24722,16,7471,2800,4671,21,76,13,8
18849,26,19912,16,54975,32043,22932,71,319,40,31
2744,1199,15190,887,886,126,760,2,30,1,1
16175,15,15521,11,1530,1216,314,10,15,5,5
2744,1238,10167,918,882,126,756,3,31,2,1
21370,10,22498,9,269,110,159,2,30,1,1
8642,10,10217,9,402,118,284,2,29,1,1
6706,10,18935,9,240,98,142,2,29,1,1
22221,10,3046,9,758,102,656,2,29,1,1
8990,26,4023,16,15401,3011,12390,37,65,21,16
21831,10,7813,9,185,102,83,2,30,1,1
11022,1040,13233,764,70,70,0,1,4,1,0
8654,26,25974,16,90030,13137,76893,92,47,29,63
22723,10,29150,9,414,268,146,3,31,2,1
3668,26,5278,16,7946,2731,5215,27,18,15,12
22395,10,1497,9,172,88,84,2,30,1,1
6325,232,6827,147,2060,981,1079,21,15,11,10
4442,26,7984,16,6798,2901,3897,22,151,13,9
14173,10,8605,9,402,118,284,2,30,1,1
9067,10,7598,9,215,102,113,2,29,1,1
22275,10,19013,9,411,115,296,4,38,2,2
16283,10,25565,9,215,87,128,2,31,1,1
22599,10,27341,9,764,99,665,2,30,1,1
5401,26,14508,16,8447,3506,4941,28,333,15,13
1563,15,5603,11,724,366,358,11,142,6,5
8834,10,6022,9,214,102,112,2,29,1,1
9332,26,22619,16,6349,1071,5278,18,42,10,8
10792,15,17901,11,3945,2315,1630,18,74,11,7
12102,15,26760,11,18040,904,17136,22,15,7,15
11083,15,18747,11,27839,14036,13803,46,36,24,22
8704,10,19562,9,748,94,654,2,30,1,1
15845,10,17312,9,170,87,83,2,30,1,1
9996,26,7762,16,6663,1556,5107,21,132,10,11
3711,1392,20407,1059,1806,1806,0,22,224,22,0
22149,10,3991,9,182,93,89,2,31,1,1
13681,10,29037,9,343,86,257,4,58,2,2
14312,10,24917,9,193,102,91,2,30,1,1
9376,26,5614,16,6846,2479,4367,41,256,19,22
21280,10,97,9,183,94,89,2,30,1,1
5999,23,0,0,14381,5620,8761,50,30,25,25
14528,10,6457,9,184,94,90,2,31,1,1
1170,1988,8801,1518,253,190,63,2,30,1,1
8880,10,9072,9,767,102,665,2,30,1,1
9411,716,19335,511,858,858,0,14,1200,14,0
7332,8,15426,8,511,191,320,9,60,4,5
5156,18,4881,13,184,94,90,2,30,1,1
9444,10,16587,9,164,86,78,2,30,1,1
8357,15,525,11,6158,654,5504,15,15,8,7
14124,10,14005,9,193,102,91,2,29,1,1
16951,255,25970,160,66,66,0,1,4,1,0
22307,10,19487,9,749,94,655,2,30,1,1
8941,15,22144,11,254,128,126,5,16,3,2
14381,10,20919,9,177,94,83,2,29,1,1
15070,26,23628,16,6066,1016,5050,20,26,11,9
15128,10,24970,9,223,86,137,2,30,1,1
7271,18,19803,13,184,94,90,2,30,1,1
9096,26,13986,16,8428,1889,6539,25,16,13,12
15383,2780,16756,2157,70,70,0,1,5,1,0
16463,15,20866,11,318,192,126,6,21,4,2
14003,10,1813,9,214,110,104,2,29,1,1
9828,15,611,11,132,132,0,2,8,2,0
9771,26,23730,16,5427,3497,1930,23,141,13,10
141,15,303,11,424934,9929,415005,411,95,129,282
11241,15,9351,11,8559,5109,3450,23,160,12,11
14470,10,25855,9,816,97,719,2,30,1,1
9411,1934,2572,1477,481,150,331,2,1200,1,1
18317,26,27428,16,17829,9658,8171,92,150,46,46
8845,10,24156,9,166,86,80,2,30,1,1
14994,15,2049,11,38339,808,37531,37,104,9,28
11958,26,4372,16,8095,2586,5509,38,90,19,19
7774,26,3587,16,9503,5267,4236,56,218,31,25
12447,2752,8878,2133,70,70,0,1,4,1,0
11661,15,10117,11,9532,745,8787,18,113,9,9
19621,26,18905,16,4625,2292,2333,14,135,7,7
7711,26,12542,16,7187,2550,4637,20,18,10,10
2744,1244,18242,924,1708,126,1582,4,31,2,2
18894,26,17356,16,15081,6817,8264,31,34,14,17
12671,10,12079,9,260,86,174,2,30,1,1
4747,10,16208,9,197,90,107,2,30,1,1
15876,10,8594,9,180,94,86,2,29,1,1
21466,10,874,9,316,89,227,4,50,2,2
10236,15,11029,11,1952,1118,834,21,365,11,10
9087,15,11899,11,1126,609,517,11,15,6,5
13149,26,7821,16,10707,2548,8159,27,39,15,12
2573,10,10809,9,404,259,145,3,32,2,1
19524,10,23108,9,196,86,110,2,30,1,1
15800,26,21391,16,27444,3840,23604,58,161,28,30
18613,1392,14236,1059,1806,1806,0,22,224,22,0
17186,26,16990,16,3989,2585,1404,17,15,9,8
16419,26,25559,16,480591,8786,471805,442,46,102,340
2744,1623,22084,1245,885,126,759,2,31,1,1
15841,10,25347,9,165,86,79,2,30,1,1
15510,10,21557,9,181,94,87,2,33,1,1
15832,10,24840,9,177,94,83,2,30,1,1
17861,10,24196,9,448,166,282,2,30,1,1
5677,26,2452,16,5655,1614,4041,22,30,11,11
15501,10,22408,9,178,94,84,2,30,1,1
15919,10,16388,9,177,94,83,2,30,1,1
9009,10,7696,9,168,86,82,2,31,1,1
22680,10,14423,9,193,102,91,2,31,1,1
15244,26,27370,16,8058,2038,6020,20,15,11,9
8577,10,4207,9,195,102,93,2,31,1,1
21748,10,16827,9,437,88,349,4,41,2,2
8176,26,9464,16,4371,2036,2335,18,24,10,8
13710,10,17154,9,209,110,99,2,30,1,1
8408,10,9183,9,785,110,675,2,30,1,1
4411,26,9219,16,1799,1224,575,13,26,8,5
10795,2703,28916,2099,66,66,0,1,5,1,0
15012,10,20650,9,210,110,100,2,30,1,1
8495,26,20985,16,77821,4380,73441,82,53,23,59
636,280,20084,177,259,150,109,2,1201,1,1
5235,10,24297,9,198,93,105,2,31,1,1
8441,10,11336,9,560,199,361,6,82,3,3
19502,26,27371,16,18829,1995,16834,33,17,17,16
2520,10,12830,9,200,94,106,2,30,1,1
15126,10,23361,9,166,86,80,2,29,1,1
13921,10,10763,9,177,94,83,2,29,1,1
8881,26,1223,16,7681,1658,6023,21,130,11,10
14205,10,4899,9,199,102,97,2,30,1,1
13633,10,1644,9,102,102,0,1,59,1,0
8833,15,23163,11,1165,468,697,8,125,5,3
976,15,17731,11,318,192,126,6,26,4,2
20924,26,10067,16,3182,1568,1614,8,120,4,4
21786,10,4670,9,195,102,93,2,29,1,1
7966,26,20137,16,8301,2172,6129,25,255,12,13
6892,26,3952,16,2548,1565,983,20,330,11,9
3769,26,14484,16,8363,1573,6790,24,49,14,10
14262,10,4071,9,210,110,100,2,30,1,1
21069,2422,11061,1884,70,70,0,1,5,1,0
8584,1240,25325,920,262,78,184,2,30,1,1
13630,26,5398,16,8156,3281,4875,43,71,21,22
9844,15,15175,11,142,142,0,1,4,1,0
5677,26,9214,16,114,114,0,2,120,2,0
9728,1604,8130,1228,166,166,0,1,1199,1,0
14169,10,10802,9,249,94,155,2,31,1,1
7392,10,5029,9,168,78,90,2,30,1,1
13736,10,15296,9,216,110,106,2,30,1,1
17744,183,26433,121,3523,1714,1809,17,34,8,9
15065,10,1642,9,194,102,92,2,30,1,1
11615,26,22981,16,4797,2794,2003,20,271,11,9
22126,10,19623,9,188,96,92,2,30,1,1
4916,26,16417,16,4599,1692,2907,19,29,11,8
9703,10,1480,9,216,110,106,2,31,1,1
5365,26,11052,16,557795,16003,541792,528,76,139,389
16021,3052,16321,2370,12668,8506,4162,117,3745,74,43
15965,10,2521,9,168,86,82,2,31,1,1
14207,10,27636,9,178,94,84,2,30,1,1
6497,26,13275,16,3115,1849,1266,18,16,8,10
5137,26,13225,16,382972,9177,373795,378,16,120,258
3969,26,13671,16,3672,1259,2413,16,120,8,8
9760,26,27072,16,8643,1918,6725,21,26,11,10
13851,10,19662,9,167,86,81,2,29,1,1
12563,26,6710,16,499,425,74,4,0,3,1
10364,2423,1985,1885,70,70,0,2,8,2,0
5321,15,18548,11,740,452,288,11,17,7,4
4859,26,24256,16,6732,885,5847,24,368,7,17
22249,10,11411,9,256,88,168,4,32,2,2
14060,10,28846,9,177,94,83,2,30,1,1
11125,26,8590,16,325846,10609,315237,326,38,106,220
8963,10,24267,9,767,102,665,2,31,1,1
15546,26,18800,16,22953,5010,17943,38,123,14,24
21791,10,2173,9,209,110,99,2,30,1,1
11757,26,15507,16,14518,10453,4065,43,120,21,22
14333,10,16602,9,209,110,99,2,29,1,1
10757,42,14089,25,70,70,0,2,8,2,0
8733,26,4873,16,6260,3089,3171,27,142,13,14
10267,26,8844,16,54411,4588,49823,74,131,30,44
13809,10,1563,9,197,102,95,2,31,1,1
8254,26,10375,16,494,280,214,8,49,5,3
11071,15,7658,11,2901,1407,1494,15,38,9,6
10339,26,21868,16,9668,4698,4970,42,16,25,17
22103,10,24510,9,210,110,100,2,29,1,1
8697,10,16648,9,183,94,89,2,29,1,1
9728,2498,23350,1944,480,150,330,2,1200,1,1
3599,26,12103,16,2586,832,1754,14,15,7,7
8373,15,2043,11,57497,913,56584,52,75,11,41
22492,10,17964,9,944,205,739,6,45,3,3
11069,1915,13546,1461,70,70,0,2,7,2,0
8429,10,20189,9,168,86,82,2,30,1,1
3929,26,13943,16,6053,3586,2467,17,135,8,9
9234,26,28147,16,4701,2758,1943,41,93,22,19
11041,480,8679,314,70,70,0,2,7,2,0
14707,10,21363,9,179,94,85,2,31,1,1
15742,10,28995,9,733,93,640,2,31,1,1
21655,10,23405,9,199,94,105,2,29,1,1
17713,26,7280,16,6328,1536,4792,23,17,12,11
17907,26,18085,16,238429,14932,223497,314,48,159,155
2724,1240,19378,920,422,164,258,6,30,3,3
5931,26,17848,16,1743946,54876,1689070,1870,360,678,1192
18771,10,26963,9,198,90,108,2,30,1,1
10116,26,10403,16,3278,1962,1316,20,20,9,11
8363,26,23490,16,789207,20847,768360,812,23,294,518
15343,483,1051,316,70,70,0,1,5,1,0
7338,26,19928,16,4592,1685,2907,19,27,11,8
4162,26,166,16,6692,1642,5050,24,275,11,13
2744,1245,5058,925,1882,378,1504,6,31,4,2
17887,26,23407,16,9630,1304,8326,28,30,14,14
10327,2627,8668,2037,459,149,310,2,1200,1,1
12171,26,8215,16,13300,1695,11605,27,321,12,15
8714,26,16342,16,1346,918,428,10,22,6,4
14090,26,1241,16,3015948,160028,2855920,3852,218,1499,2353
6638,10,5559,9,168,78,90,2,30,1,1
22116,10,21648,9,777,87,690,2,31,1,1
6773,18,5041,13,184,94,90,2,30,1,1
15292,10,3960,9,183,94,89,2,30,1,1
948,26,8734,16,5510,901,4609,15,25,8,7
10557,26,204,16,584465,23057,561408,694,36,303,391
14472,10,27986,9,228,110,118,2,30,1,1
2691,26,21559,16,7407,2650,4757,24,20,12,12
14704,10,26666,9,298,92,206,4,41,2,2
21345,10,19661,9,337,89,248,4,38,2,2
15233,10,5038,9,229,94,135,2,30,1,1
18371,26,6780,16,2866,623,2243,13,136,6,7
6587,15,18789,11,232198,9152,223046,290,21,134,156
22112,10,6616,9,199,102,97,2,30,1,1
16021,239,29097,153,2411,1328,1083,19,1200,11,8
13950,10,24147,9,180,94,86,2,31,1,1
8612,15,21487,11,5724,3966,1758,25,38,14,11
14082,26,4306,16,1373295,46189,1327106,1448,31,527,921
2724,1240,23490,920,254,82,172,4,30,2,2
15762,10,16001,9,184,94,90,2,29,1,1
17016,15,26001,11,5140,4161,979,17,28,10,7
13654,10,15448,9,193,102,91,2,31,1,1
22258,10,26371,9,184,94,90,2,31,1,1
3970,232,22843,147,3376,1509,1867,32,83,16,16
22027,10,25243,9,215,102,113,2,30,1,1
11917,15,23233,11,265868,5026,260842,277,24,75,202
15333,26,9,16,8005,1985,6020,20,16,11,9
18455,73,21294,56,70,70,0,1,5,1,0
15749,10,15297,9,193,102,91,2,29,1,1
7617,26,23601,16,71073,4403,66670,99,116,41,58
5489,26,10783,16,1684,1031,653,16,92,9,7
13869,57,25656,40,1210,950,260,2,30,1,1
5678,26,14616,16,5630,3451,2179,39,67,20,19
7430,26,21716,16,36209,28887,7322,65,364,34,31
14238,10,16864,9,199,102,97,2,30,1,1
9021,26,15804,16,4221,1038,3183,19,59,11,8
14860,10,12726,9,200,102,98,2,30,1,1
15288,10,12783,9,226,110,116,2,30,1,1
2744,1867,10348,1425,892,126,766,2,30,1,1
15241,26,13299,16,1299,730,569,13,25,7,6
18470,26,20947,16,308771,8699,300072,322,30,112,210
9569,26,11693,16,4600,667,3933,14,17,7,7
15767,10,92,9,195,102,93,2,30,1,1
5248,10,4015,9,289,86,203,2,30,1,1
12646,1853,6301,1413,70,70,0,2,8,2,0
22203,10,28165,9,170,87,83,2,30,1,1
18939,26,9714,16,8264,4269,3995,17,31,9,8
15898,183,25338,121,3428,1714,1714,16,33,8,8
11308,41,22883,24,142,78,64,2,5,1,1
10870,1735,19138,1324,70,70,0,1,5,1,0
22402,10,28164,9,793,207,586,6,59,3,3
22392,1238,12680,918,295,78,217,2,30,1,1
22337,10,12072,9,443,98,345,4,57,2,2
3625,10,5572,9,168,78,90,2,30,1,1
11291,232,4006,147,5380,2214,3166,55,503,26,29
15997,10,2803,9,177,94,83,2,30,1,1
9212,10,7250,9,253,87,166,4,52,2,2
9780,10,13282,9,772,100,672,2,31,1,1
8795,10,26188,9,216,102,114,2,30,1,1
14643,10,25134,9,179,94,85,2,30,1,1
14303,10,14895,9,287,91,196,4,60,2,2
15271,10,10734,9,757,98,659,2,31,1,1
17876,26,7351,16,4114,2557,1557,22,418,9,13
3904,15,2263,11,1295,572,723,12,15,7,5
14060,10,2988,9,170,87,83,2,30,1,1
9530,26,26501,16,1346,918,428,10,26,6,4
287,10,801,9,229,94,135,2,30,1,1
8501,10,14581,9,194,102,92,2,30,1,1
7963,26,6631,16,10895,2151,8744,26,362,11,15
9120,15,4792,11,10819,819,10000,19,15,9,10
5090,676,8599,475,138,78,60,2,5,1,1
22460,10,22852,9,216,110,106,2,30,1,1
818,26,549,16,27459,19126,8333,67,402,30,37
9786,26,22707,16,10981,2295,8686,32,63,16,16
8584,1238,4493,918,240,78,162,2,30,1,1
3587,26,27503,16,9880,2011,7869,38,256,17,21
15229,10,9311,9,209,110,99,2,30,1,1
12004,26,12029,16,3796,1523,2273,20,135,10,10
14298,1514,7572,1153,70,70,0,2,8,2,0
15788,10,6738,9,168,86,82,2,31,1,1
20548,10,23959,9,571,166,405,2,29,1,1
10984,556,17915,372,70,70,0,1,5,1,0
2744,1570,19290,1201,871,126,745,2,31,1,1
18575,2396,19707,1863,320,140,180,6,7,3,3
11205,62,11398,45,70,70,0,1,5,1,0
15855,392,19751,254,2466,1350,1116,37,569,19,18
14216,10,7365,9,168,86,82,2,34,1,1
21575,10,20021,9,199,102,97,2,30,1,1
18394,15,8582,11,374,192,182,7,61,4,3
14376,10,9011,9,413,170,243,6,30,3,3
13269,26,3357,16,11460,2522,8938,19,122,9,10
11064,2487,16576,1934,66,66,0,1,5,1,0
18025,26,24598,16,3063,1068,1995,12,134,6,6
16204,10,25515,9,220,100,120,2,31,1,1
6217,26,10681,16,6345,1024,5321,21,361,11,10
21978,10,1350,9,287,102,185,2,30,1,1
14287,1879,20769,1435,70,70,0,2,8,2,0
4640,740,9662,531,130,70,60,2,30,1,1
4835,268,3727,168,38098,12284,25814,207,2433,100,107
12821,26,15932,16,2571,330,2241,12,135,5,7
15542,10,3110,9,754,94,660,2,31,1,1
225,10,21227,9,204,118,86,2,30,1,1
21417,10,24593,9,170,87,83,2,30,1,1
3450,10,14267,9,233,91,142,2,30,1,1
8692,10,11783,9,272,97,175,4,57,2,2
14297,3150,16181,2440,320,140,180,6,7,3,3
13929,10,7825,9,268,95,173,4,46,2,2
17244,26,21413,16,5168,700,4468,16,15,7,9
2744,1455,961,1108,890,126,764,2,31,1,1
8528,10,16066,9,184,94,90,2,29,1,1
10816,1882,16560,1437,70,70,0,2,8,2,0
12819,1427,19992,1083,320,140,180,6,7,3,3
8862,10,24014,9,172,88,84,2,30,1,1
9001,10,1664,9,180,94,86,2,29,1,1
21790,10,15451,9,184,94,90,2,29,1,1
8210,2296,21194,1780,513,152,361,2,1200,1,1
9285,26,6388,16,9199,2329,6870,30,133,17,13
13612,10,23766,9,1413,85,1328,4,47,2,2
16584,10,25757,9,241,98,143,2,30,1,1
15885,26,17204,16,134,60,74,3,4,2,1
14131,15,24439,11,1099,578,521,10,15,6,4
9228,10,1891,9,174,89,85,2,30,1,1
5313,26,1495,16,46879,2864,44015,74,179,34,40
22193,10,2756,9,195,102,93,2,30,1,1
8890,10,6726,9,183,94,89,2,30,1,1
13344,26,17234,16,6110,857,5253,17,16,9,8
12401,42,23651,25,70,70,0,2,8,2,0
15330,10,10256,9,184,94,90,2,30,1,1
1585,10,5712,9,220,90,130,2,30,1,1
22167,10,28354,9,210,110,100,2,30,1,1
11349,26,22917,16,11451,5432,6019,34,86,17,17
1684,10,6113,9,220,100,120,2,30,1,1
21321,10,154,9,1011,232,779,6,55,3,3
13885,10,16415,9,272,94,178,2,30,1,1
14492,1922,12190,1467,481,150,331,2,1200,1,1
15358,10,19192,9,193,102,91,2,30,1,1
9231,10,9466,9,779,86,693,2,30,1,1
22424,10,21201,9,758,93,665,2,30,1,1
18244,26,25093,16,8929,3204,5725,25,80,14,11
15953,10,4759,9,183,94,89,2,29,1,1
15431,2426,14385,1887,70,70,0,2,8,2,0
10915,3239,5015,2510,66,66,0,1,5,1,0
15186,26,28926,16,1473,868,605,10,25,6,4
8919,15,27794,11,32910,18450,14460,143,1647,75,68
14956,10,13693,9,216,110,106,2,31,1,1
15029,10,11160,9,170,87,83,2,30,1,1
17165,26,6470,16,10775,7126,3649,31,17,17,14
2744,1240,5937,920,882,126,756,2,31,1,1
22008,10,16896,9,810,108,702,2,31,1,1
14058,10,28198,9,168,78,90,2,30,1,1
8421,10,24314,9,265,110,155,2,30,1,1
4816,26,25130,16,11293,3979,7314,29,125,17,12
4781,15,6802,11,1702,1388,314,10,16,5,5
14730,10,1494,9,733,94,639,2,30,1,1
8821,26,4196,16,31956,13344,18612,64,65,36,28
8920,26,5122,16,17243,5482,11761,82,316,41,41
11034,15,3613,11,84657,4275,80382,105,19,45,60
16136,15,25466,11,4226,2910,1316,19,38,10,9
22193,10,24533,9,215,102,113,2,30,1,1
15553,10,18317,9,267,87,180,4,38,2,2
8755,10,6606,9,214,102,112,2,31,1,1
21155,811,6250,591,66,66,0,1,5,1,0
14191,10,11572,9,239,94,145,2,29,1,1
10254,15,22347,11,514,246,268,9,42,5,4
13382,26,6319,16,7070,1030,6040,19,33,11,8
10867,15,4449,11,242,120,122,5,31,3,2
21878,26,9150,16,317618,11688,305930,350,164,118,232
2172,998,15280,735,481,150,331,2,1199,1,1
8737,26,19571,16,3972,887,3085,13,31,6,7
18784,1989,10147,1519,316,136,180,6,6,3,3
8744,15,27366,11,25846,2486,23360,39,50,16,23
10988,2616,309,2028,70,70,0,1,4,1,0
14792,10,12819,9,916,86,830,2,30,1,1
4816,26,13426,16,416,210,206,7,26,4,3
1641,26,20679,16,2589,1443,1146,18,15,8,10
10971,15,8265,11,82496,3881,78615,104,61,47,57
9113,10,4944,9,193,102,91,2,29,1,1
22424,10,10014,9,994,86,908,2,31,1,1
5747,10,17582,9,200,90,110,2,30,1,1
10894,1916,16977,1462,1345,679,666,9,30,5,4
11407,26,4899,16,11463,850,10613,23,25,7,16
2744,1238,11642,918,880,126,754,2,30,1,1
14700,10,8531,9,194,99,95,2,31,1,1
8555,10,11636,9,215,102,113,2,30,1,1
20938,26,8678,16,164604,5676,158928,188,39,70,118
8956,15,21668,11,1769,1271,498,10,126,6,4
20816,10,0,0,206,95,111,2,30,1,1
14968,10,2693,9,182,93,89,2,31,1,1
13287,26,17187,16,9859,3252,6607,24,74,12,12
8705,10,21991,9,177,94,83,2,30,1,1
10091,10,0,0,229,85,144,2,29,1,1
9388,10,22633,9,184,102,82,2,30,1,1
15176,10,26884,9,168,78,90,2,30,1,1
14339,469,3953,304,564,318,246,9,18,5,4
21234,10,10497,9,352,102,250,2,29,1,1
8584,1249,10494,929,71,71,0,1,30,1,0
17201,26,9071,16,5168,700,4468,16,15,7,9
9588,26,13441,16,47752,21819,25933,119,704,59,60
14685,26,16148,16,7535,1003,6532,24,304,7,17
8210,3114,21194,2418,490,149,341,2,1200,1,1
13721,10,26553,9,178,94,84,2,30,1,1
5320,26,1846,16,70,70,0,1,4,1,0
15555,10,23913,9,177,94,83,2,29,1,1
15291,15,23450,11,3742344,115431,3626913,3995,79,1382,2613
14789,10,26243,9,227,110,117,2,30,1,1
9324,10,9422,9,211,78,133,2,30,1,1
21660,10,6523,9,221,94,127,2,30,1,1
22229,10,17658,9,198,94,104,2,30,1,1
21506,10,6604,9,344,94,250,2,30,1,1
15127,10,10713,9,225,102,123,2,30,1,1
13034,26,864,16,499,425,74,4,0,3,1
13989,10,1607,9,1497,108,1389,4,53,2,2
9608,15,21990,11,218570,13559,205011,291,22,146,145
5376,18,10732,13,184,94,90,2,30,1,1
4651,26,18551,16,214,140,74,4,15,3,1
14770,10,13373,9,200,102,98,2,30,1,1
15025,26,11142,16,8620,2018,6602,34,80,18,16
5134,26,17307,16,398925,9369,389556,391,16,123,268
14533,10,3052,9,177,94,83,2,30,1,1
1155,10,3939,9,370,238,132,3,32,2,1
15100,10,26078,9,322,134,188,2,30,1,1
9765,10,24057,9,256,93,163,2,31,1,1
12186,487,3299,320,1642,822,820,5,30,1,4
10090,232,15470,147,8318,2850,5468,54,255,27,27
9198,10,22081,9,353,118,235,2,31,1,1
198,10,468,9,233,90,143,2,32,1,1
21941,10,20594,9,209,110,99,2,30,1,1
7055,26,16908,16,10311,2186,8125,26,186,14,12
22682,26,10112,16,7975,423,7552,15,120,6,9
14678,10,21932,9,178,94,84,2,29,1,1
11615,15,23078,11,2011,1422,589,12,48,6,6
9448,26,23011,16,208,60,148,4,11,2,2
11897,10,26684,9,70,70,0,1,29,1,0
6701,26,22934,16,1201,707,494,12,35,7,5
10238,10,4531,9,168,78,90,2,30,1,1
11582,10,23057,9,231,88,143,2,32,1,1
8584,1238,21842,918,78,78,0,1,30,1,0
17992,26,19286,16,6622,2246,4376,21,46,12,9
21600,10,15270,9,321,109,212,4,47,2,2
8469,26,3159,16,3182,1568,1614,8,120,4,4
13196,26,28474,16,2878,1252,1626,16,361,9,7
18507,2396,2651,1863,320,140,180,6,7,3,3
21900,10,18671,9,213,94,119,2,30,1,1
14255,1194,18379,883,70,70,0,2,8,2,0
8740,26,17692,16,16191,13348,2843,30,55,17,13
8717,15,20878,11,1769,873,896,11,15,6,5
14063,10,10610,9,177,94,83,2,30,1,1
9388,26,27236,16,27900,6291,21609,46,515,23,23
2254,10,9254,9,288,83,205,2,30,1,1
12610,26,6312,16,499,425,74,4,0,3,1
9943,26,5351,16,98472,44922,53550,491,658,181,310
8409,10,1933,9,167,86,81,2,30,1,1
22464,10,9003,9,216,110,106,2,30,1,1
16152,26,24743,16,5177,3010,2167,37,83,17,20
15081,10,16196,9,578,286,292,9,15,5,4
4192,26,27788,16,2840032,64781,2775251,2709,292,769,1940
20511,26,4809,16,303,85,218,2,31,1,1
14672,10,15398,9,199,102,97,2,31,1,1
21631,10,18830,9,168,86,82,2,31,1,1
8085,232,1300,147,7786,1403,6383,44,434,15,29
10504,166,22482,114,156,156,0,3,8,3,0
21564,10,18943,9,181,86,95,2,30,1,1
8210,2627,21194,2037,485,158,327,2,1200,1,1
3699,10,16181,9,168,78,90,2,29,1,1
10306,26,9234,16,8075,2723,5352,42,117,24,18
2744,1246,8594,926,875,126,749,3,32,2,1
5264,26,26315,16,1268772,32833,1235939,1288,81,409,879
21581,10,12238,9,192,98,94,2,31,1,1
21811,10,6942,9,214,110,104,2,29,1,1
22666,10,20012,9,209,110,99,2,30,1,1
4888,10,12923,9,168,78,90,2,30,1,1
1731,280,18785,177,2310,2310,0,36,3136,36,0
8765,15,15391,11,312,192,120,6,41,4,2
13680,26,9905,16,11413,6823,4590,34,18,19,15
16418,26,21653,16,19190,13041,6149,64,389,33,31
15222,26,26053,16,1327,918,409,10,25,6,4
8025,26,11887,16,1947,688,1259,18,82,8,10
13715,15,7006,11,486,240,246,9,28,5,4
14821,15,24815,11,44752,820,43932,45,15,12,33
10935,3263,5626,2527,70,70,0,2,8,2,0
14545,10,19196,9,196,102,94,2,30,1,1
12037,1209,5862,895,70,70,0,2,8,2,0
983,26,23697,16,4275,760,3515,15,27,8,7
16365,26,28915,16,1856,1217,639,18,176,11,7
7668,10,1489,9,199,94,105,2,30,1,1
8799,10,4826,9,168,86,82,2,30,1,1
8825,15,23776,11,1937,885,1052,13,42,7,6
8697,15,3515,11,78,78,0,1,5,1,0
12026,2083,12290,1605,70,70,0,2,8,2,0
9099,10,21818,9,177,94,83,2,30,1,1
22449,10,23817,9,183,98,85,3,36,2,1
15346,10,2746,9,270,95,175,4,60,2,2
14574,10,1500,9,184,94,90,2,30,1,1
9660,26,19052,16,1575,771,804,16,47,9,7
8556,10,27491,9,210,110,100,2,30,1,1
16379,15,21196,11,12974,3246,9728,29,29,16,13
15727,10,3594,9,216,102,114,2,30,1,1
21751,10,18175,9,194,102,92,2,29,1,1
7082,26,14329,16,7298,2661,4637,21,18,11,10
13221,232,21428,147,9568,1982,7586,44,345,17,27
4437,26,15830,16,4401,1494,2907,19,27,11,8
10024,15,22343,11,256436,14131,242305,283,141,111,172
12798,1938,8415,1479,1450,761,689,14,15,8,6
12148,18,7229,13,184,94,90,2,31,1,1
14442,10,17622,9,196,102,94,2,30,1,1
21139,2472,13807,1922,70,70,0,1,4,1,0
11561,26,21580,16,2044,1024,1020,17,80,9,8
9105,10,25651,9,193,102,91,2,31,1,1
10332,26,12405,16,33489,19602,13887,98,43,51,47
12151,26,12041,16,4385,2869,1516,32,19,18,14
15378,10,26641,9,190,97,93,2,30,1,1
4226,10,27243,9,168,78,90,2,30,1,1
8675,26,4025,16,8248,2508,5740,31,271,13,18
996,26,27583,16,4216,771,3445,16,26,9,7
13802,10,11171,9,194,102,92,2,31,1,1
18462,18,11401,13,184,94,90,2,30,1,1
15218,26,13043,16,8167,1980,6187,22,80,12,10
16584,26,21069,16,6563,1656,4907,22,318,13,9
15820,10,27578,9,166,85,81,2,30,1,1
10279,26,20248,16,13777,1743,12034,26,31,12,14
11838,26,27584,16,5582,1388,4194,19,15,9,10
9521,26,17213,16,7738,879,6859,19,27,10,9
22333,26,22195,16,48029,4540,43489,91,120,40,51
14315,10,16390,9,193,102,91,2,30,1,1
12088,26,7953,16,1582,965,617,15,18,7,8
13751,10,14815,9,182,102,80,2,30,1,1
20400,40,22501,23,9385,3246,6139,53,118,31,22
16021,925,14741,683,150,150,0,1,1199,1,0
13802,10,20654,9,256,87,169,4,37,2,2
9318,15,1115,11,17387,9304,8083,30,56,19,11
12470,1640,28183,1260,70,70,0,1,4,1,0
18383,15,27248,11,194,128,66,4,25,3,1
11211,26,28635,16,7855,815,7040,21,15,9,12
12713,2667,9006,2074,70,70,0,2,8,2,0
13528,26,28641,16,7689,3574,4115,65,308,32,33
22630,10,4219,9,228,110,118,2,30,1,1
8682,10,8073,9,183,94,89,2,31,1,1
18636,26,26886,16,1315,786,529,12,36,7,5
2744,1455,23539,1108,890,126,764,2,31,1,1
15861,10,9247,9,292,110,182,2,30,1,1
22608,10,23667,9,183,94,89,2,30,1,1
14851,10,24470,9,177,94,83,2,31,1,1
12039,15,5453,11,2398,2024,374,12,15,6,6
12845,26,2947,16,4318,726,3592,14,16,7,7
14162,10,444,9,322,110,212,4,30,2,2
12708,26,27230,16,499,425,74,4,1,3,1
8584,1239,27683,919,261,78,183,2,30,1,1
9,18,27882,13,184,94,90,2,30,1,1
1643,26,6544,16,2569,1470,1099,17,15,8,9
8810,15,17288,11,318,192,126,6,41,4,2
12161,26,21828,16,5544,1703,3841,19,31,11,8
12010,2548,16680,1980,70,70,0,2,8,2,0
8730,15,21086,11,318,192,126,6,45,4,2
13461,26,26740,16,7136,5777,1359,22,200,13,9
15498,26,4265,16,33095,18485,14610,73,185,43,30
12012,1412,17555,1074,758,320,438,11,16,6,5
16130,26,8370,16,8154,1791,6363,21,187,11,10
15986,10,29028,9,177,94,83,2,30,1,1
21541,10,17192,9,337,110,227,2,29,1,1
21488,10,24033,9,245,94,151,2,30,1,1
6036,26,24812,16,8507,4462,4045,27,141,14,13
14789,10,6266,9,256,93,163,2,31,1,1
15196,10,28339,9,177,94,83,2,29,1,1
17233,26,4354,16,5167,700,4467,16,15,7,9
11064,15,5489,11,4185,3462,723,14,16,7,7
21932,26,28772,16,274,132,142,5,76,3,2
21407,10,21509,9,179,94,85,2,29,1,1
18131,26,648,16,4223,2828,1395,23,28,13,10
1619,10,5838,9,1415,689,726,3,31,2,1
9030,10,8177,9,225,110,115,2,30,1,1
22670,10,22503,9,168,86,82,2,31,1,1
9021,26,19306,16,18811,1868,16943,22,139,7,15
16878,10,17543,9,522,162,360,6,64,3,3
10485,10,26033,9,269,94,175,2,30,1,1
6120,26,1870,16,7014,1958,5056,31,18,19,12
16347,26,18504,16,7716,3991,3725,50,125,25,25
13758,10,13825,9,193,102,91,2,30,1,1
21063,18,28178,13,184,94,90,2,29,1,1
21343,10,24897,9,168,86,82,2,31,1,1
9694,10,25947,9,168,78,90,2,30,1,1
2744,1238,6391,918,881,126,755,2,30,1,1
22105,10,9830,9,772,102,670,2,30,1,1
21677,10,21288,9,168,86,82,2,30,1,1
6111,26,13809,16,1633,1010,623,14,2424,7,7
9184,183,21775,121,3347,1458,1889,15,18,8,7
21287,15,10483,11,314,192,122,6,15,4,2
7746,676,6892,475,130,70,60,2,5,1,1
10746,233,9395,148,4524,1489,3035,26,1327,15,11
13232,15,10671,11,17572,1518,16054,30,255,16,14
8733,233,4470,148,9705,5123,4582,29,74,15,14
15908,10,16085,9,184,94,90,2,31,1,1
21302,1227,369,907,70,70,0,1,4,1,0
21947,26,19828,16,5552,927,4625,16,15,10,6
9002,26,26359,16,6915,3106,3809,21,144,10,11
17068,26,26965,16,18568,12357,6211,43,18,24,19
22640,10,13604,9,177,94,83,2,30,1,1
12060,26,6109,16,3220,2010,1210,20,19,10,10
10928,26,495,16,7866,1549,6317,21,321,10,11
22040,10,26932,9,179,94,85,2,30,1,1
9009,10,20566,9,194,102,92,2,30,1,1
22083,10,18613,9,200,102,98,2,33,1,1
8346,26,10442,16,686176,17574,668602,702,18,252,450
12091,26,28886,16,3655,2344,1311,18,17,9,9
5814,373,17689,241,156,156,0,3,8,3,0
5204,26,22239,16,11019,4204,6815,23,49,13,10
11449,10,22969,9,231,88,143,2,33,1,1
8189,26,15027,16,5378,1423,3955,19,49,11,8
13961,10,1445,9,193,102,91,2,31,1,1
9030,26,17391,16,2937,717,2220,14,136,6,8
9732,15,22059,11,2765,1835,930,14,21,8,6
16359,26,14208,16,1792,1153,639,17,177,10,7
5094,26,3745,16,6887,1076,5811,22,50,12,10
13789,10,10197,9,184,94,90,2,30,1,1
1219,2816,24840,2186,468,149,319,2,1200,1,1
6002,7,17975,7,66,66,0,1,5,1,0
14221,10,18068,9,749,89,660,2,30,1,1
6817,10,10212,9,168,78,90,2,29,1,1
19066,26,14369,16,492,492,0,7,15,7,0
8617,26,16039,16,1855625,57182,1798443,1981,70,703,1278
4675,26,1676,16,62657,4444,58213,83,46,37,46
10861,15,14661,11,486,300,186,9,31,6,3
3965,26,4243,16,13057,1460,11597,28,255,14,14
14942,15,13857,11,9997,1306,8691,17,25,8,9
18146,15,10523,11,1327,839,488,10,142,6,4
12630,973,3222,719,70,70,0,1,5,1,0
22687,10,15497,9,202,103,99,2,31,1,1
22191,10,17665,9,274,88,186,4,35,2,2
17701,10,0,0,627,72,555,2,30,1,1
15303,10,6787,9,166,86,80,2,30,1,1
22430,10,25112,9,200,102,98,2,30,1,1
11212,3083,8914,2395,70,70,0,1,5,1,0
18063,26,17848,16,1953,1223,730,16,16,9,7
3355,10,14114,9,228,97,131,2,31,1,1
15492,26,20402,16,54568,32686,21882,69,161,40,29
9051,26,7661,16,977,590,387,10,87,6,4
9532,10,18777,9,94,94,0,1,29,1,0
14682,10,67,9,730,102,628,2,29,1,1
2724,1240,6856,920,168,82,86,2,30,1,1
11829,26,18470,16,6253,2132,4121,19,16,10,9
22211,10,17618,9,168,86,82,2,30,1,1
15495,10,25141,9,219,98,121,2,30,1,1
4975,676,18606,475,130,70,60,2,6,1,1
8535,26,23497,16,14412,3279,11133,33,19,17,16
17274,18,27658,13,184,94,90,2,30,1,1
16338,26,20321,16,1786,172,1614,7,120,3,4
17835,183,26474,121,4213,2429,1784,18,32,9,9
5312,10,16902,9,197,90,107,2,29,1,1
13151,26,551,16,11876,2769,9107,30,76,15,15
12559,26,26687,16,70,70,0,1,5,1,0
11129,1378,1330,1048,70,70,0,2,8,2,0
10227,15,2652,11,366,240,126,7,20,5,2
6705,10,4876,9,168,78,90,2,30,1,1
20598,15,15538,11,19934,920,19014,23,15,7,16
18161,26,13135,16,2227,1018,1209,17,16,8,9
14508,10,19894,9,184,94,90,2,31,1,1
22153,10,6259,9,199,102,97,2,30,1,1
10961,896,28923,662,70,70,0,2,8,2,0
7473,10,20117,9,237,91,146,2,32,1,1
14369,10,4425,9,193,102,91,2,31,1,1
22170,10,26774,9,197,102,95,2,30,1,1
22713,10,3519,9,386,122,264,4,52,2,2
22020,10,2221,9,177,94,83,2,29,1,1
13657,10,13358,9,196,102,94,2,30,1,1
8344,26,27076,16,654956,17062,637894,673,18,244,429
22196,10,22173,9,412,97,315,4,58,2,2
16464,15,17654,11,318,192,126,6,21,4,2
15314,15,21179,11,1462,703,759,8,16,5,3
11970,15,24713,11,1352,625,727,8,75,5,3
16021,763,6843,551,163,163,0,1,1200,1,0
3066,3168,4808,2454,11247,4773,6474,66,1454,32,34
10474,26,22321,16,63766,32148,31618,103,42,51,52
16515,15,12410,11,1854,735,1119,8,16,5,3
4393,10,0,0,139,70,69,2,30,1,1
4105,18,14959,13,184,94,90,2,30,1,1
3068,182,12822,120,146,60,86,2,30,1,1
3133,2336,19489,1820,462,462,0,8,3631,8,0
21720,10,9970,9,86,86,0,1,30,1,0
9854,15,4521,11,708,384,324,12,195,7,5
8341,10,26100,9,198,101,97,2,30,1,1
17870,26,13442,16,12150,1262,10888,29,41,13,16
14611,10,25707,9,178,94,84,2,30,1,1
14178,26,18441,16,12205,2036,10169,33,138,18,15
16021,2078,28634,1600,792,792,0,13,1199,13,0
17874,10,10009,9,211,78,133,2,29,1,1
9696,10,27390,9,757,102,655,2,30,1,1
12770,2832,14229,2199,492,306,186,8,15,5,3
10062,26,26491,16,9354,2370,6984,24,16,13,11
9843,15,10129,11,7292,3171,4121,19,21,11,8
20304,26,18916,16,7755,4481,3274,17,135,9,8
9552,346,21959,220,378,180,198,7,32,4,3
9706,26,11443,16,1313,876,437,11,27,6,5
8685,10,27660,9,264,94,170,2,30,1,1
5547,15,17238,11,2919,1492,1427,10,15,6,4
13817,10,1388,9,79,79,0,2,34,2,0
15074,15,8815,11,458684,19849,438835,488,66,185,303
10837,26,19389,16,3561,1098,2463,10,121,5,5
19048,10,27120,9,244,98,146,2,32,1,1
8371,2786,17978,2162,316,136,180,6,6,3,3
22099,10,11376,9,295,101,194,4,31,2,2
14322,10,27066,9,167,86,81,2,30,1,1
11976,26,24360,16,490914,83866,407048,1048,332,526,522
4368,26,6558,16,9329,3935,5394,30,405,17,13
21706,10,14044,9,342,97,245,4,42,2,2
7008,15,11819,11,1119,1045,74,7,14,6,1
18770,1989,6130,1519,316,136,180,6,6,3,3
8906,10,8599,9,166,85,81,2,30,1,1
10782,1544,5741,1176,70,70,0,1,5,1,0
7494,26,20717,16,350492,17722,332770,449,125,169,280
1488,10,5262,9,237,91,146,2,33,1,1
22188,10,7665,9,334,94,240,2,30,1,1
13988,10,7645,9,315,95,220,4,50,2,2
8350,10,12487,9,209,110,99,2,30,1,1
15062,10,18573,9,214,110,104,2,31,1,1
15402,10,7577,9,195,102,93,2,30,1,1
16343,10,0,0,627,80,547,2,29,1,1
15249,10,18870,9,182,93,89,2,31,1,1
7352,26,27804,16,2583,334,2249,7,90,3,4
11840,15,2158,11,234,234,0,4,11,4,0
17050,26,3865,16,3776,2372,1404,17,15,9,8
15132,10,2291,9,184,94,90,2,31,1,1
10041,15,8385,11,12826704,145724,12680980,10558,133,2024,8534
15946,10,12705,9,193,102,91,2,30,1,1
8486,10,23498,9,260,102,158,2,30,1,1
4752,26,1024,16,1134364,30994,1103370,1170,175,403,767
21417,10,1436,9,177,94,83,2,31,1,1
21611,10,6126,9,196,102,94,2,30,1,1
15971,10,7000,9,223,86,137,2,30,1,1
22088,10,22681,9,211,102,109,2,30,1,1
8596,26,21480,16,4377,1470,2907,19,30,11,8
5085,26,1413,16,9664,1703,7961,22,15,11,11
15354,2168,6248,1674,70,70,0,1,5,1,0
21268,970,2184,718,504,382,122,8,15,6,2
9726,15,27918,11,53959,2683,51276,69,16,30,39
11285,717,8299,512,70,70,0,2,8,2,0
11132,26,27992,16,343074,14649,328425,390,41,159,231
16657,10,0,0,633,83,550,2,30,1,1
9267,10,18252,9,198,110,88,2,30,1,1
6796,26,15053,16,202384,47621,154763,307,198,112,195
8317,26,11267,16,47589,17003,30586,283,238,128,155
22238,10,7764,9,182,93,89,2,30,1,1
8469,26,16840,16,454,262,192,8,27,5,3
22613,10,26374,9,208,94,114,2,30,1,1
9053,10,20909,9,197,102,95,2,31,1,1
847,10,3521,9,216,90,126,2,30,1,1
9758,15,26457,11,318,192,126,6,25,4,2
21428,10,11855,9,211,102,109,2,30,1,1
16255,15,25549,11,2934,1497,1437,10,16,6,4
8933,10,23180,9,727,86,641,2,30,1,1
14244,2157,5526,1665,70,70,0,1,5,1,0
12556,26,9309,16,7055,1261,5794,21,82,10,11
18481,1954,4242,1491,70,70,0,1,5,1,0
21589,10,7743,9,186,95,91,2,30,1,1
3764,255,14751,160,60,60,0,1,5,1,0
1603,26,5781,16,155070,7155,147915,186,81,74,112
22148,10,7610,9,749,94,655,2,29,1,1
10908,445,21069,285,70,70,0,2,8,2,0
16341,26,16909,16,2342,1341,1001,15,19,8,7
17235,26,28885,16,5167,700,4467,16,15,7,9
16021,2068,1254,1594,330,330,0,6,1200,6,0
4612,26,145,16,4403,2160,2243,14,136,7,7
2744,1559,28501,1190,876,126,750,2,31,1,1
15548,10,28931,9,197,102,95,2,31,1,1
8796,26,23988,16,7776,2266,5510,17,35,9,8
3475,15,14332,11,424,198,226,7,141,4,3
9874,1251,9201,931,269,78,191,2,31,1,1
9949,26,6734,16,10682,4653,6029,28,33,15,13
20542,26,25546,16,2523249,58976,2464273,2483,33,820,1663
15814,10,1692,9,173,94,79,2,30,1,1
16021,3106,12565,2413,479,150,329,2,1199,1,1
9577,10,28259,9,193,102,91,2,29,1,1
15901,26,26974,16,3872,1641,2231,14,125,6,8
14726,10,15249,9,199,94,105,2,29,1,1
12503,15,6844,11,149148,7515,141633,197,20,95,102
10825,3058,5061,2374,70,70,0,2,8,2,0
14770,10,6497,9,200,102,98,2,30,1,1
22443,10,26165,9,193,102,91,2,30,1,1
21418,10,18130,9,194,99,95,2,31,1,1
8896,26,20433,16,4484,1063,3421,15,10,7,8
17509,15,26287,11,108922,4633,104289,194,16,66,128
9062,10,13304,9,184,94,90,2,30,1,1
8755,26,17458,16,327575,8400,319175,334,316,113,221
7954,26,8963,16,9467,2741,6726,24,20,15,9
4874,26,28404,16,15799,7457,8342,42,98,22,20
20411,10,18200,9,214,76,138,2,30,1,1
9663,26,16204,16,7967,1647,6320,25,85,14,11
13839,10,19746,9,200,102,98,2,30,1,1
12772,965,23413,713,70,70,0,1,4,1,0
15122,26,10124,16,134,60,74,3,5,2,1
14312,10,4313,9,186,95,91,2,30,1,1
11237,26,9517,16,74711,8646,66065,150,89,70,80
3324,15,14072,11,6582,886,5696,15,16,7,8
15524,10,19354,9,168,86,82,2,29,1,1
21444,10,20576,9,438,130,308,4,35,2,2
8394,10,7515,9,179,94,85,2,31,1,1
9517,26,14594,16,5422,707,4715,16,25,8,8
15008,26,5333,16,227145,7409,219736,252,146,86,166
22168,10,5617,9,565,92,473,4,38,2,2
15223,10,21561,9,199,102,97,2,30,1,1
6257,26,22799,16,6673,2151,4522,27,125,13,14
10460,26,13827,16,322,262,60,2,5,1,1
539,10,2000,9,237,91,146,2,33,1,1
16058,26,13762,16,4265,2639,1626,34,31,16,18
8432,10,5162,9,181,94,87,2,31,1,1
22231,10,23177,9,289,102,187,2,30,1,1
18501,10,11760,9,154,154,0,3,46,3,0
11796,10,9394,9,339,94,245,2,30,1,1
10721,26,10113,16,9320,4615,4705,25,120,12,13
22263,10,24582,9,1426,98,1328,4,55,2,2
4806,26,27910,16,134,60,74,3,5,2,1
14753,10,489,9,194,102,92,2,30,1,1
14222,10,19248,9,752,93,659,2,31,1,1
8414,10,1423,9,194,102,92,2,31,1,1
9623,15,547,11,312,192,120,6,25,4,2
9770,26,9447,16,1604,987,617,16,93,9,7
6155,15,28107,11,1105,634,471,11,15,6,5
21929,10,20672,9,306,142,164,2,30,1,1
9956,26,19968,16,17161,1619,15542,18,153,4,14
18273,15,15153,11,70,70,0,2,8,2,0
18737,26,11603,16,31452,6667,24785,54,32,29,25
6409,26,20172,16,4268,2836,1432,25,19,13,12
11992,10,5639,9,70,70,0,1,30,1,0
4738,26,25460,16,4428,2241,2187,19,46,11,8
22610,10,26516,9,200,102,98,2,30,1,1
9795,15,15899,11,1555,1103,452,9,21,5,4
22021,26,24844,16,1671,1004,667,16,76,8,8
21518,10,23927,9,168,86,82,2,31,1,1
17974,26,4324,16,6066,833,5233,19,26,10,9
18358,15,19295,11,1462,864,598,11,144,6,5
12138,26,19263,16,11150,2012,9138,29,67,14,15
8743,26,14973,16,6947,833,6114,20,53,9,11
14755,10,989,9,226,110,116,2,30,1,1
9095,10,24237,9,195,102,93,2,30,1,1
12616,1874,16445,1430,70,70,0,1,4,1,0
11132,26,16681,16,6903,3076,3827,20,136,10,10
13155,26,23534,16,7402,1350,6052,24,16,13,11
19863,10,1735,9,298,102,196,2,30,1,1
14050,10,2621,9,779,86,693,2,30,1,1
18412,15,6233,11,10335,1617,8718,19,124,9,10
15339,26,27635,16,8006,1986,6020,20,16,11,9
12574,1013,26590,747,70,70,0,2,7,2,0
17850,26,1673,16,384,166,218,2,31,1,1
6515,26,9757,16,10102,3072,7030,25,16,14,11
12420,1078,20174,791,70,70,0,1,5,1,0
14166,10,10122,9,199,102,97,2,29,1,1
7421,18,6719,13,184,94,90,2,30,1,1
15458,10,15318,9,199,102,97,2,30,1,1
16789,26,20582,16,145249,142210,3039,143,185,106,37
18828,26,16859,16,740,222,518,11,3631,4,7
13057,10,23837,9,198,90,108,2,30,1,1
4835,3096,16956,2404,402,132,270,6,1208,3,3
8272,15,28443,11,121475,5644,115831,163,145,81,82
526,10,588,9,208,78,130,2,30,1,1
11399,26,3961,16,9680,2399,7281,47,136,27,20
18215,15,26659,11,23216,1806,21410,40,28,20,20
22392,1360,19926,1032,284,78,206,2,29,1,1
15141,26,21889,16,52157,3066,49091,65,80,26,39
14546,10,8824,9,177,94,83,2,30,1,1
22564,26,16734,16,3104883,106687,2998196,3406,190,1320,2086
22131,10,28327,9,822,102,720,2,29,1,1
14346,766,18511,554,70,70,0,2,8,2,0
8931,10,10171,9,194,102,92,2,31,1,1
1731,2577,23575,1999,490,149,341,2,1200,1,1
18247,26,24084,16,7639,2673,4966,36,255,17,19
4906,26,3035,16,85590,4656,80934,111,37,47,64
13780,10,24357,9,244,94,150,2,30,1,1
12143,26,14336,16,4498,916,3582,18,17,9,9
4683,26,21885,16,573,425,148,5,0,3,2
6054,26,7838,16,1478937,62961,1415976,1678,148,649,1029
2174,10,8760,9,1413,688,725,3,30,2,1
16809,10,26153,9,305,102,203,2,31,1,1
8584,1240,14354,920,71,71,0,1,30,1,0
7353,26,9122,16,6299,1424,4875,27,291,10,17
17158,26,21634,16,208,60,148,4,10,2,2
13975,10,3445,9,198,102,96,2,31,1,1
12143,26,20532,16,9949,4623,5326,45,150,23,22
14813,10,24004,9,221,102,119,2,30,1,1
16771,10,19276,9,240,76,164,2,31,1,1
22156,10,18203,9,228,94,134,2,30,1,1
14731,10,9869,9,199,102,97,2,31,1,1
11136,15,15094,11,422,240,182,8,26,5,3
2333,26,9611,16,5573,2434,3139,21,25,12,9
4746,26,29114,16,3226,2225,1001,18,47,11,7
4574,26,20468,16,6592,1735,4857,23,360,11,12
7880,26,12706,16,6790,1336,5454,20,187,11,9
22265,10,3130,9,211,94,117,2,30,1,1
14086,26,20025,16,480989,16896,464093,507,22,178,329
15897,10,18854,9,370,94,276,2,30,1,1
10916,1794,24453,1369,66,66,0,1,5,1,0
2938,10,22681,9,205,86,119,2,30,1,1
16324,10,25595,9,183,82,101,2,30,1,1
9085,10,25832,9,214,110,104,2,30,1,1
21651,10,26773,9,198,101,97,2,30,1,1
9801,26,3832,16,3339,2205,1134,21,38,13,8
13286,26,18164,16,7153,2581,4572,28,74,15,13
10881,2473,3435,1923,136,136,0,3,14,3,0
14243,622,6600,429,70,70,0,2,8,2,0
2744,1273,13738,953,908,126,782,2,30,1,1
18658,10,8686,9,199,94,105,2,30,1,1
22262,10,27573,9,197,94,103,2,30,1,1
15137,10,3403,9,183,94,89,2,29,1,1
11172,2809,21064,2179,66,66,0,1,5,1,0
9452,26,27479,16,1786,172,1614,7,120,3,4
9084,26,26573,16,6489,2137,4352,28,143,14,14
13898,26,18712,16,16179,1763,14416,38,46,17,21
7194,15,10525,11,2713,753,1960,12,15,7,5
8883,10,27473,9,781,94,687,2,30,1,1
15602,10,28083,9,246,94,152,2,30,1,1
14878,10,420,9,166,86,80,2,30,1,1
21931,10,2339,9,213,102,111,2,30,1,1
8583,10,13644,9,211,110,101,2,30,1,1
15529,10,27279,9,183,94,89,2,30,1,1
2724,1240,24413,920,422,164,258,6,29,3,3
9166,10,14447,9,192,98,94,2,31,1,1
3133,2316,9839,1800,66,66,0,1,3600,1,0
22146,10,22418,9,197,102,95,2,33,1,1
10962,1815,17317,1384,70,70,0,1,5,1,0
6767,10,15532,9,168,78,90,2,31,1,1
15913,26,1409,16,7802,4189,3613,22,136,11,11
10028,15,25024,11,11459959,142694,11317265,9719,135,1994,7725
18642,10,28503,9,78,78,0,1,29,1,0
18426,26,14606,16,2962,796,2166,10,120,5,5
6281,26,14286,16,1622,1137,485,11,26,7,4
14274,648,13041,452,70,70,0,1,5,1,0
15046,10,12893,9,180,94,86,2,30,1,1
17761,10,10065,9,417,78,339,2,30,1,1
6491,26,28043,16,3133,1883,1250,19,16,9,10
12729,879,6711,648,552,306,246,9,15,5,4
22343,10,3005,9,418,94,324,2,30,1,1
21581,10,23302,9,323,107,216,4,38,2,2
21577,10,23131,9,250,94,156,2,30,1,1
8768,10,19399,9,247,102,145,2,30,1,1
15404,10,25936,9,170,87,83,2,30,1,1
21612,10,6372,9,350,88,262,4,31,2,2
15679,10,7580,9,178,94,84,2,30,1,1
6510,15,6268,11,1102,545,557,10,16,6,4
12744,26,23834,16,495,421,74,4,0,3,1
15992,10,18889,9,733,85,648,2,30,1,1
8867,15,28240,11,70321,956,69365,62,52,11,51
21682,10,17856,9,184,94,90,2,31,1,1
6950,15,15333,11,3180,2317,863,12,11,7,5
8532,10,11481,9,195,102,93,2,29,1,1
14351,15,5142,11,70,70,0,2,8,2,0
12578,26,25968,16,499,425,74,4,0,3,1
2277,26,9349,16,5785,2575,3210,24,76,14,10
3220,10,28271,9,86,86,0,1,30,1,0
18162,26,26638,16,5610,2363,3247,22,40,13,9
3582,26,24301,16,4472,1666,2806,13,121,6,7
15020,15,10606,11,130,70,60,2,15,1,1
4783,26,12087,16,6226,4834,1392,17,125,11,6
2805,10,11544,9,214,82,132,2,32,1,1
11219,26,6801,16,36007,4328,31679,65,217,33,32
15583,10,20299,9,199,102,97,2,30,1,1
14822,10,714,9,399,97,302,4,59,2,2
22456,10,9043,9,178,94,84,2,30,1,1
22562,10,23655,9,356,101,255,4,55,2,2
10763,234,15171,149,6967,1929,5038,25,128,14,11
9474,15,11707,11,1550,728,822,13,47,7,6
21581,10,11112,9,196,102,94,2,30,1,1
8115,26,9712,16,10409,2670,7739,94,5805,17,77
22659,26,17414,16,372361,11310,361051,385,16,136,249
8348,153,23244,108,70,70,0,2,8,2,0
15681,15,12341,11,1049,679,370,8,16,5,3
13978,10,7087,9,184,94,90,2,30,1,1
15964,10,16235,9,195,102,93,2,30,1,1
17084,26,9281,16,5168,700,4468,16,15,7,9
16441,15,19268,11,5474,3658,1816,27,76,14,13
8373,10,19228,9,179,94,85,2,30,1,1
16455,15,21728,11,318,192,126,6,21,4,2
15631,10,11333,9,711,87,624,2,30,1,1
21366,10,10051,9,178,94,84,2,30,1,1
22005,10,17967,9,561,99,462,4,38,2,2
10835,687,2088,486,70,70,0,1,5,1,0
21370,10,28015,9,177,94,83,2,29,1,1
550,15,2052,11,104444,4047,100397,122,126,52,70
12104,26,24846,16,6983,1629,5354,17,15,9,8
20879,183,28247,121,3489,1534,1955,17,19,9,8
18725,26,21540,16,13618,5262,8356,54,101,26,28
22658,10,12674,9,195,102,93,2,31,1,1
15428,10,12887,9,167,86,81,2,29,1,1
14741,10,27422,9,258,110,148,2,30,1,1
14127,10,25858,9,760,96,664,2,31,1,1
16017,26,14284,16,7715,1772,5943,25,275,13,12
4835,2906,21111,2255,847,152,695,4,1201,2,2
14486,10,11068,9,181,94,87,2,29,1,1
13711,10,23647,9,211,110,101,2,30,1,1
1731,2627,20644,2037,459,149,310,2,1200,1,1
10784,295,22643,190,4727,2346,2381,19,16,12,7
14744,10,3971,9,194,102,92,2,30,1,1
16763,15,18187,11,3130,2290,840,15,135,8,7
13637,15,21735,11,27816,7362,20454,69,240,41,28
15820,10,727,9,167,86,81,2,29,1,1
21305,10,22284,9,293,134,159,2,30,1,1
12733,504,16285,332,70,70,0,2,8,2,0
15107,10,4268,9,378,94,284,2,30,1,1
22185,10,23282,9,214,110,104,2,30,1,1
7114,10,19586,9,237,91,146,2,33,1,1
11069,15,9502,11,4185,3462,723,14,15,7,7
2744,1238,14894,918,882,126,756,2,31,1,1
21015,1381,28756,1050,564,382,182,9,16,6,3
14754,10,19665,9,265,85,180,4,41,2,2
10488,15,22472,11,22364,4125,18239,41,26,19,22
22626,10,26571,9,196,94,102,2,29,1,1
8614,15,21488,11,3193,2163,1030,17,79,10,7
13555,26,24141,16,5573,2326,3247,22,40,13,9
22095,10,5874,9,180,94,86,2,30,1,1
3484,26,24226,16,9180,2197,6983,36,34,20,16
17132,26,27310,16,274798,9459,265339,343,201,136,207
8726,15,26608,11,318,192,126,6,45,4,2
13969,10,27526,9,194,102,92,2,31,1,1
22628,10,1437,9,165,86,79,2,30,1,1
9200,10,2130,9,170,87,83,2,31,1,1
15272,10,13495,9,196,100,96,2,31,1,1
3913,15,22580,11,350,210,140,6,30,4,2
20535,10,2492,9,303,85,218,2,30,1,1
12757,1790,13072,1366,70,70,0,2,8,2,0
503,1364,27499,1036,449555,320,449235,719,50,6,713
19833,26,26978,16,3182,1568,1614,8,121,4,4
22609,10,28589,9,211,102,109,2,30,1,1
3800,15,8479,11,6094,954,5140,15,3601,8,7
8802,10,6549,9,180,94,86,2,31,1,1
9038,10,27977,9,196,94,102,2,30,1,1
332,10,959,9,197,90,107,2,29,1,1
11696,26,5631,16,256711,14141,242570,367,96,152,215
12290,26,23434,16,2505,1460,1045,21,102,10,11
12823,1218,22746,901,70,70,0,2,7,2,0
1219,530,25466,351,491,150,341,2,1200,1,1
11424,26,22193,16,782,428,354,12,28,7,5
8255,26,12403,16,7437,2128,5309,22,33,13,9
11487,26,19154,16,163226,10147,153079,233,101,101,132
15533,10,9296,9,192,98,94,2,31,1,1
19964,26,7232,16,3644,610,3034,13,119,6,7
9836,26,4739,16,152,86,66,2,5,1,1
8657,26,27179,16,33157,17446,15711,66,135,38,28
9474,26,15097,16,12026,3494,8532,28,82,14,14
9721,15,7086,11,2350,896,1454,13,25,7,6
18815,1989,1843,1519,316,136,180,6,5,3,3
5482,10,17137,9,229,98,131,2,30,1,1
17924,26,14495,16,630054,19786,610268,711,381,261,450
21846,10,13508,9,389,102,287,4,33,2,2
18963,26,29008,16,1373,712,661,14,105,8,6
16017,15,7703,11,78,78,0,1,5,1,0
17875,26,22753,16,384,166,218,2,29,1,1
8659,15,1301,11,143422,12598,130824,226,487,52,174
10128,26,21230,16,33716,17750,15966,134,329,72,62
10090,15,15635,11,5730066,61301,5668765,4686,81,891,3795
4493,26,22898,16,90706,5324,85382,128,262,66,62
505,1755,21569,1340,23369,64,23305,65,31,2,63
9627,26,27444,16,12462,2612,9850,37,80,19,18
12266,26,11246,16,8437,4827,3610,50,180,25,25
2744,1239,7685,919,892,126,766,2,30,1,1
13878,10,19614,9,170,87,83,2,30,1,1
15070,10,345,9,94,94,0,1,30,1,0
8649,10,21108,9,178,94,84,2,30,1,1
13949,10,29151,9,194,94,100,2,30,1,1
8274,26,28541,16,46452,6817,39635,103,299,45,58
3402,26,13433,16,4838,2974,1864,21,17,13,8
14281,10,14875,9,199,102,97,2,30,1,1
8971,26,4695,16,37255,2202,35053,46,125,17,29
20605,10,3182,9,78,78,0,2,31,2,0
15020,10,15369,9,209,110,99,2,29,1,1
15974,26,25371,16,4736,1759,2977,20,26,11,9
18356,10,1781,9,78,78,0,1,30,1,0
13792,10,5584,9,316,94,222,2,29,1,1
4168,26,2029,16,5207,1058,4149,21,150,12,9
8584,1243,7847,923,246,71,175,2,31,1,1
14351,15,21093,11,70,70,0,1,5,1,0
18105,15,13630,11,1836,816,1020,12,143,7,5
15218,10,21124,9,195,102,93,2,30,1,1
15805,26,13802,16,1021056,38101,982955,1183,64,501,682
22157,10,4797,9,760,97,663,2,30,1,1
10897,2446,20486,1899,160,70,90,2,5,1,1
15097,15,18181,11,370,222,148,6,32,4,2
10873,2307,9896,1791,1261,637,624,9,30,5,4
21146,15,17354,11,4529,1221,3308,14,75,8,6
22558,26,1103,16,4319,2473,1846,24,85,10,14
5130,26,21675,16,1248170,26899,1221271,1212,16,382,830
11112,15,2315,11,4560,3934,626,11,29,6,5
14023,10,28556,9,822,102,720,2,30,1,1
6539,26,14765,16,2683108,71922,2611186,2467,150,623,1844
8576,10,6065,9,167,86,81,2,30,1,1
15909,10,3075,9,192,98,94,2,31,1,1
2298,26,9445,16,18172,3573,14599,39,26,20,19
16021,153,19984,108,124,124,0,3,1199,3,0
2744,1447,24675,1100,887,126,761,2,31,1,1
14490,10,18515,9,228,110,118,2,30,1,1
14984,10,18374,9,226,102,124,2,30,1,1
532,247,0,0,3562,1936,1626,48,194,24,24
15637,10,4736,9,183,94,89,2,30,1,1
7022,15,15973,11,918,461,457,9,16,6,3
15101,10,25337,9,168,86,82,2,30,1,1
6725,10,1444,9,168,78,90,2,30,1,1
8761,10,20578,9,180,94,86,2,30,1,1
14330,15,25051,11,70,70,0,2,8,2,0
16600,15,28708,11,12618,1038,11580,28,50,13,15
14999,26,1765,16,9876,5607,4269,66,122,35,31
18819,1989,16100,1519,316,136,180,6,5,3,3
21265,10,4620,9,351,103,248,4,46,2,2
13916,10,2260,9,168,86,82,2,30,1,1
4986,26,1757,16,564,292,272,9,26,5,4
13800,26,14930,16,2251,1098,1153,25,120,12,13
5643,15,6165,11,1049,975,74,6,15,5,1
15733,10,10664,9,214,102,112,2,30,1,1
11142,2737,16090,2123,316,136,180,6,6,3,3
7681,26,23652,16,8688,3211,5477,24,343,11,13
8879,15,11743,11,5029,1986,3043,16,130,8,8
14567,10,26750,9,170,87,83,2,31,1,1
13333,26,21673,16,4510,2210,2300,14,136,7,7
3284,10,14002,9,197,90,107,2,30,1,1
4858,26,29104,16,5474,2239,3235,31,80,14,17
15653,10,26546,9,228,102,126,2,29,1,1
22714,26,3684,16,92247,4799,87448,107,15,43,64
13688,26,17284,16,14671,2953,11718,31,31,17,14
6860,26,5204,16,7244,1861,5383,26,330,14,12
8770,15,8835,11,454,262,192,8,41,5,3
9411,865,14836,639,481,150,331,2,1200,1,1
15202,10,25818,9,193,102,91,2,29,1,1
2890,26,18891,16,5576,1388,4188,19,15,9,10
9089,15,21550,11,1126,609,517,11,15,6,5
12604,280,22452,177,1463,821,642,15,15,8,7
16021,2246,21691,1739,480,149,331,2,1200,1,1
11004,26,22507,16,11486,5080,6406,24,121,12,12
10103,15,16762,11,181877,8980,172897,207,22,87,120
10963,15,25266,11,717,651,66,7,15,6,1
14101,10,19010,9,216,94,122,2,30,1,1
6242,26,22747,16,16831,14003,2828,31,63,18,13
19805,26,14992,16,25511,1260,24251,34,121,13,21
12509,15,27486,11,1119,665,454,12,15,7,5
8551,10,11651,9,181,94,87,2,30,1,1
17943,10,5996,9,198,93,105,2,30,1,1
13610,10,26927,9,194,102,92,2,31,1,1
2744,1238,25540,918,1638,126,1512,4,30,2,2
4086,26,4384,16,6179,1242,4937,22,42,11,11
8773,10,5378,9,259,102,157,2,29,1,1
9595,15,11142,11,378,192,186,7,28,4,3
22636,10,13288,9,199,102,97,2,30,1,1
9187,10,10962,9,166,86,80,2,31,1,1
13664,10,313,9,245,94,151,2,29,1,1
11829,26,23892,16,31161,4934,26227,73,115,32,41
5845,15,17745,11,80261,4766,75495,91,126,35,56
21061,1852,11217,1412,504,382,122,8,16,6,2
13628,10,2151,9,212,102,110,2,30,1,1
19816,26,21211,16,9318,3002,6316,28,46,16,12
9135,10,7943,9,779,110,669,2,30,1,1
12416,1045,16745,769,70,70,0,2,8,2,0
14806,10,6705,9,183,94,89,2,29,1,1
14263,10,11407,9,170,87,83,2,30,1,1
18066,26,9093,16,1346200,44765,1301435,1428,128,479,949
13838,10,24630,9,178,94,84,2,30,1,1
4835,2693,12682,2092,1577,594,983,20,2766,10,10
2068,31,8146,19,60,60,0,1,5,1,0
532,247,0,0,3354,1792,1562,46,195,23,23
7410,10,16381,9,199,94,105,2,30,1,1
9062,10,9344,9,184,94,90,2,30,1,1
15842,26,16635,16,21198,9647,11551,97,20,52,45
10811,2206,12698,1708,70,70,0,2,8,2,0
8871,15,7946,11,2733,591,2142,11,45,6,5
2744,1238,16476,918,874,126,748,2,30,1,1
13900,10,9788,9,195,102,93,2,30,1,1
16504,26,4075,16,8242,1641,6601,22,360,12,10
13850,10,4939,9,263,94,169,2,30,1,1
13801,10,810,9,183,94,89,2,29,1,1
14487,10,24298,9,819,102,717,2,30,1,1
8841,10,23570,9,199,102,97,2,30,1,1
22395,10,10619,9,249,102,147,2,30,1,1
8364,10,5411,9,777,87,690,2,30,1,1
12585,859,20865,634,70,70,0,2,8,2,0
15952,26,13748,16,152,78,74,2,4,1,1
22529,10,3645,9,200,102,98,2,29,1,1
10974,15,11814,11,2120,1080,1040,17,55,10,7
14241,2902,22927,2253,504,318,186,8,15,5,3
14547,10,25852,9,179,94,85,2,30,1,1
13854,10,526,9,177,94,83,2,30,1,1
637,287,18824,184,221,111,110,2,1200,1,1
10001,15,9858,11,28291,3346,24945,46,144,25,21
18461,26,2224,16,8060,1868,6192,28,16,15,13
10947,15,10476,11,43399,5061,38338,55,29,24,31
15199,10,19817,9,170,87,83,2,30,1,1
21329,10,28778,9,276,94,182,4,55,2,2
16021,2671,23196,2077,1980,1980,0,31,2321,31,0
18708,26,26930,16,5667,1393,4274,19,16,9,10
7217,26,5912,16,5766,1575,4191,24,589,13,11
10875,15,22688,11,28037,2069,25968,40,26,16,24
21646,10,20827,9,658,186,472,6,51,3,3
3744,10,14722,9,235,90,145,2,33,1,1
20426,26,18263,16,52219,4148,48071,75,125,33,42
7666,26,7005,16,70,70,0,1,5,1,0
17105,15,1383,11,1702,1388,314,10,16,5,5
14331,624,24065,431,70,70,0,2,8,2,0
14556,26,14902,16,9274,5282,3992,42,186,22,20
9453,15,3189,11,1083,653,430,8,16,5,3
21452,26,28533,16,4561,1654,2907,19,28,11,8
15163,10,15987,9,184,94,90,2,30,1,1
12659,422,935,275,70,70,0,1,5,1,0
21747,10,2940,9,396,102,294,2,31,1,1
5092,26,18617,16,6525,1695,4830,19,51,8,11
17873,26,6174,16,448,166,282,2,30,1,1
9593,26,1932,16,7588,1850,5738,19,25,10,9
10072,26,11413,16,29500,27698,1802,51,17,29,22
1504,15,4650,11,4079,3203,876,12,97,8,4
9691,15,5845,11,378,192,186,7,21,4,3
19274,26,15923,16,31612,3374,28238,59,271,29,30
4405,26,20138,16,560,280,280,9,25,5,4
8736,26,23729,16,1013,492,521,10,30,4,6
15894,26,17648,16,1169,616,553,12,16,7,5
16878,10,6550,9,177,86,91,2,30,1,1
9487,15,16135,11,1192,658,534,11,41,6,5
8022,26,492,16,3889,1992,1897,19,255,10,9
13609,10,13769,9,177,94,83,2,30,1,1
9804,15,1924,11,875,327,548,9,15,5,4
15239,15,10119,11,1056,682,374,10,15,6,4
9747,26,1584,16,3443,2189,1254,23,72,13,10
6766,26,18235,16,3410,1249,2161,16,136,8,8
14455,10,6344,9,180,94,86,2,29,1,1
15226,15,13394,11,11855,7269,4586,28,115,15,13
14550,10,10374,9,168,86,82,2,30,1,1
5920,26,7067,16,7644,1098,6546,19,35,10,9
12160,26,8722,16,1544,1073,471,13,15,8,5
15279,10,15323,9,210,94,116,2,30,1,1
19967,26,7285,16,598,598,0,8,40,8,0
13683,26,25066,16,35270,2782,32488,48,51,22,26
4955,26,13599,16,9834,4297,5537,26,326,12,14
22068,10,19519,9,209,110,99,2,30,1,1
15200,10,20740,9,193,102,91,2,30,1,1
14451,10,14037,9,183,94,89,2,30,1,1
10992,42,7494,25,316,136,180,6,5,3,3
13318,26,18910,16,5670,3091,2579,16,121,8,8
15070,10,16878,9,177,94,83,2,30,1,1
18342,26,10161,16,1853,1214,639,18,87,11,7
13729,10,5828,9,183,94,89,2,30,1,1
15447,10,10471,9,184,94,90,2,30,1,1
21619,26,6390,16,4741,1306,3435,26,300,14,12
8210,1098,21194,806,513,152,361,2,1201,1,1
16288,26,8925,16,12877,5188,7689,27,130,12,15
16021,2238,23246,1733,883,288,595,4,1200,2,2
20014,26,16275,16,3942042,47512,3894530,3167,53,526,2641
4113,10,16730,9,168,78,90,2,30,1,1
8480,10,19788,9,199,102,97,2,30,1,1
9729,15,28442,11,1726,963,763,13,80,7,6
10990,26,11984,16,2648,1797,851,19,23,11,8
4120,26,627,16,5612,1251,4361,22,65,12,10
14144,10,1109,9,458,188,270,6,30,3,3
872,26,21568,16,4077,438,3639,12,15,6,6
9409,10,25918,9,771,102,669,2,30,1,1
14401,26,25693,16,6092,3093,2999,16,120,8,8
3626,10,14576,9,243,104,139,2,30,1,1
8228,10,21213,9,213,82,131,2,30,1,1
14847,10,22149,9,772,103,669,2,30,1,1
8600,10,10609,9,183,86,97,2,29,1,1
17876,26,12153,16,384,166,218,2,29,1,1
21824,10,27824,9,167,86,81,2,30,1,1
14149,10,28467,9,179,94,85,2,29,1,1
9092,10,6329,9,243,102,141,2,30,1,1
13991,10,22146,9,168,86,82,2,30,1,1
14760,10,7069,9,916,86,830,2,30,1,1
15569,10,23874,9,177,94,83,2,30,1,1
13764,10,27943,9,198,102,96,2,33,1,1
728,15,2911,11,110567,7016,103551,135,46,60,75
22392,1293,1585,971,254,78,176,2,29,1,1
18362,10,2580,9,227,86,141,2,30,1,1
12614,2978,5085,2312,320,140,180,6,7,3,3
225,10,5461,9,204,118,86,2,31,1,1
9117,15,3687,11,11209,819,10390,19,15,9,10
16021,94,2407,73,330,330,0,6,1200,6,0
9681,233,13614,148,12710,4688,8022,44,2961,19,25
3121,10,13076,9,194,87,107,2,30,1,1
22712,26,4734,16,92518,4869,87649,109,15,44,65
21577,10,26960,9,273,90,183,4,33,2,2
21806,10,14479,9,188,96,92,2,31,1,1
20909,26,21677,16,2467,1198,1269,22,186,11,11
21936,10,1976,9,195,102,93,2,29,1,1
11496,15,691,11,3224,2776,448,11,15,7,4
8744,26,21528,16,6947,833,6114,20,54,9,11
8504,10,22862,9,199,102,97,2,30,1,1
15009,26,2000,16,2274816,85295,2189521,2305,127,825,1480
21117,1323,20288,999,70,70,0,1,4,1,0
22702,10,21723,9,186,102,84,2,30,1,1
2744,1242,12113,922,1652,126,1526,4,31,2,2
8584,1239,18202,919,246,71,175,2,30,1,1
8590,10,23694,9,228,110,118,2,30,1,1
2744,1448,11592,1101,913,126,787,2,31,1,1
636,280,16316,177,238,118,120,2,1200,1,1
12316,26,24574,16,3166,2245,921,15,15,8,7
13843,10,23427,9,701,88,613,2,31,1,1
18642,10,6766,9,218,78,140,2,31,1,1
16474,10,25685,9,832,106,726,2,30,1,1
14700,10,9548,9,197,102,95,2,30,1,1
15354,10,2748,9,757,98,659,2,30,1,1
14881,10,5157,9,216,110,106,2,29,1,1
10843,26,8080,16,3182,1568,1614,8,121,4,4
4443,15,16274,11,1115,534,581,12,16,7,5
1190,26,5155,16,1832,1113,719,18,110,10,8
14767,10,27678,9,102,102,0,1,30,1,0
14219,10,27770,9,195,102,93,2,31,1,1
2744,1240,18229,920,891,126,765,2,30,1,1
18496,18,29013,13,184,94,90,2,29,1,1
16021,1091,20785,801,545,166,379,2,1199,1,1
10013,15,13664,11,128327,7366,120961,154,141,67,87
15648,183,25214,121,3407,1518,1889,16,17,9,7
825,26,4479,16,8106,1626,6480,31,341,11,20
8210,287,21194,184,480,149,331,2,1200,1,1
20118,26,14299,16,1326,876,450,11,32,6,5
12258,10,12634,9,164,78,86,2,31,1,1
14263,10,24636,9,177,94,83,2,30,1,1
9623,26,11972,16,1654,1011,643,16,82,9,7
21114,2595,3886,2014,66,66,0,2,8,2,0
6664,234,15576,149,2322,1296,1026,15,3600,6,9
9602,26,14582,16,44532,3294,41238,56,128,21,35
13363,26,4533,16,11955,1861,10094,30,172,14,16
15994,26,28290,16,7720,2815,4905,22,20,10,12
15513,10,15882,9,200,102,98,2,31,1,1
14451,10,8593,9,177,94,83,2,30,1,1
21704,15,28650,11,5570,699,4871,14,22,7,7
21533,10,9038,9,299,104,195,4,35,2,2
17148,26,420,16,5168,700,4468,16,15,7,9
6999,930,23296,685,150,150,0,1,1200,1,0
10196,587,15503,398,154976,25739,129237,605,387,321,284
21215,10,19536,9,202,103,99,2,30,1,1
21370,26,28383,16,9895,2094,7801,52,262,23,29
19305,15,11581,11,297783,19995,277788,543,158,229,314
21757,10,27277,9,199,102,97,2,30,1,1
15317,26,8133,16,1327,918,409,10,34,6,4
9743,15,1827,11,8601,6265,2336,18,26,10,8
19164,10,6678,9,177,94,83,2,29,1,1
14805,10,14990,9,177,94,83,2,29,1,1
10748,2812,16598,2182,70,70,0,2,8,2,0
18041,26,12981,16,10879,3057,7822,38,32,21,17
15707,377,25241,243,138,78,60,2,5,1,1
22057,10,7860,9,208,106,102,2,31,1,1
13810,10,6020,9,177,94,83,2,30,1,1
15583,10,28613,9,199,102,97,2,30,1,1
8407,10,7482,9,199,102,97,2,30,1,1
11468,26,13561,16,9326,1833,7493,24,131,12,12
16108,26,25441,16,164451,18310,146141,163,175,52,111
12737,2388,21829,1855,552,306,246,9,15,5,4
2724,1240,73,920,422,164,258,6,30,3,3
16362,26,24422,16,113115,8327,104788,184,177,77,107
14431,26,9773,16,180,180,0,4,11,4,0
15581,15,26297,11,214,140,74,4,31,3,1
4832,26,19579,16,7280,2250,5030,15,120,7,8
10606,26,20609,16,9451,3719,5732,45,76,25,20
21044,1823,3608,1390,70,70,0,1,4,1,0
9131,10,24695,9,303,100,203,4,40,2,2
11622,10,23084,9,233,91,142,2,31,1,1
13918,10,12448,9,167,86,81,2,30,1,1
8584,1241,1158,921,71,71,0,1,30,1,0
8582,26,26743,16,27484,4857,22627,42,46,15,27
14369,10,24619,9,193,102,91,2,30,1,1
8475,10,0,0,627,80,547,2,29,1,1
18981,26,25275,16,9029,2323,6706,31,16,17,14
22654,10,7363,9,755,102,653,2,29,1,1
19832,26,14173,16,1867,250,1617,8,120,4,4
3960,15,16059,11,1987,1329,658,10,136,6,4
11367,26,22040,16,10417,5338,5079,22,135,11,11
21924,10,14928,9,211,102,109,2,30,1,1
9273,15,27935,11,10094,1100,8994,20,33,10,10
7652,26,10227,16,70,70,0,1,5,1,0
7088,26,3731,16,190,70,120,4,15,2,2
13267,15,23951,11,1923,1474,449,10,20,6,4
22703,10,22201,9,170,87,83,2,30,1,1
13912,10,7477,9,168,86,82,2,31,1,1
9728,280,8863,177,161,161,0,1,1200,1,0
12708,2696,14072,2094,70,70,0,2,7,2,0
12496,801,20925,583,70,70,0,2,8,2,0
3615,15,15974,11,1151,711,440,10,15,5,5
6826,26,4215,16,12382,2688,9694,37,361,19,18
13888,26,26535,16,214,140,74,4,15,3,1
1827,10,6854,9,217,87,130,2,31,1,1
21164,260,17508,164,70,70,0,1,4,1,0
12314,1427,344,1083,877,577,300,10,143,5,5
12751,26,25373,16,1346,918,428,10,33,6,4
5097,26,24462,16,501559,13849,487710,527,15,193,334
14484,10,7597,9,177,94,83,2,30,1,1
11739,10,23321,9,578,286,292,9,15,5,4
17120,26,14002,16,5167,700,4467,16,15,7,9
15616,10,11765,9,170,87,83,2,30,1,1
10516,26,92,16,334,70,264,5,17,1,4
386,15,24604,11,6688,1208,5480,20,104,12,8
10540,233,26984,148,9801,5352,4449,28,473,16,12
730,15,2928,11,900,519,381,7,141,4,3
9610,10,10496,9,295,101,194,4,30,2,2
3992,15,14988,11,613,539,74,7,15,6,1
11174,15,6954,11,366,240,126,7,33,5,2
8933,10,1160,9,177,94,83,2,29,1,1
11506,15,21113,11,3224,2776,448,11,15,7,4
11928,26,20646,16,12081,2070,10011,33,620,12,21
9462,15,12898,11,5438,2832,2606,18,56,10,8
22420,10,18111,9,184,94,90,2,30,1,1
13839,10,3940,9,200,102,98,2,30,1,1
16021,3136,16068,2434,1188,1188,0,19,2338,19,0
15988,10,4210,9,193,102,91,2,31,1,1
21503,10,18073,9,180,94,86,2,30,1,1
0,0,0,0,244,244,0,2,0,2,0
21860,10,11316,9,224,94,130,2,30,1,1
2863,1996,18549,1526,148,86,62,2,30,1,1
9002,10,22781,9,183,94,89,2,31,1,1
22462,10,3166,9,256,88,168,4,35,2,2
8590,26,2445,16,77408,4295,73113,106,271,52,54
19303,15,27072,11,420720,29056,391664,771,159,325,446
6250,1989,14476,1519,148,86,62,2,31,1,1
19533,26,24099,16,9097,2123,6974,25,16,15,10
9105,10,14806,9,186,95,91,2,31,1,1
15350,961,8785,709,70,70,0,1,5,1,0
22349,10,13923,9,653,86,567,4,46,2,2
15126,10,18469,9,166,86,80,2,30,1,1
11130,2762,4179,2141,70,70,0,2,8,2,0
21828,10,4936,9,767,102,665,2,30,1,1
8991,10,26649,9,466,192,274,6,83,3,3
14597,10,13061,9,183,94,89,2,30,1,1
12422,1699,4414,1298,70,70,0,2,7,2,0
22043,10,12906,9,775,102,673,2,30,1,1
12693,26,13772,16,1966450,57437,1909013,1885,338,544,1341
879,15,2302,11,318,192,126,6,29,4,2
14182,10,16645,9,767,102,665,2,30,1,1
11650,26,28900,16,107997,3957,104040,135,80,51,84
22258,10,13838,9,204,104,100,2,31,1,1
22320,10,23318,9,177,94,83,2,29,1,1
9338,26,16799,16,6440,1603,4837,23,361,11,12
7424,234,7962,149,5239,1558,3681,27,4020,9,18
9774,26,20677,16,5013,968,4045,20,87,11,9
13657,10,17278,9,196,102,94,2,30,1,1
6385,10,6562,9,164,78,86,2,31,1,1
10842,686,3513,485,70,70,0,2,8,2,0
14682,10,8631,9,184,94,90,2,30,1,1
2744,1272,7746,952,915,126,789,2,30,1,1
13699,10,16777,9,747,92,655,2,30,1,1
2744,1290,3722,968,872,126,746,2,29,1,1
7207,26,26361,16,17237,2632,14605,34,420,18,16
12576,26,8338,16,499,425,74,4,0,3,1
6033,676,8920,475,130,70,60,2,5,1,1
2744,1238,6149,918,884,126,758,2,30,1,1
16273,10,23475,9,70,70,0,1,30,1,0
13740,10,24690,9,182,93,89,2,31,1,1
15695,10,22945,9,216,110,106,2,31,1,1
11989,1503,9729,1143,898,454,444,13,22,8,5
21952,10,25907,9,352,94,258,2,30,1,1
2744,1238,2901,918,919,126,793,2,30,1,1
6307,26,22048,16,2907,1719,1188,17,361,9,8
1049,26,17748,16,6090,773,5317,17,25,9,8
10910,341,944,217,172,94,78,2,29,1,1
13720,26,10582,16,12715,3716,8999,28,62,16,12
9847,15,28563,11,1082,896,186,18,214,15,3
11027,646,15616,450,130,70,60,2,5,1,1
17298,26,10505,16,4921,2525,2396,14,135,7,7
21365,26,21510,16,7360,2435,4925,19,135,9,10
999,26,12214,16,3922,552,3370,16,16,8,8
14237,10,1465,9,178,94,84,2,30,1,1
8076,26,21591,16,18198,13269,4929,47,324,20,27
17237,26,1556,16,6035,770,5265,18,15,8,10
9054,26,21652,16,2513598,90400,2423198,2658,280,896,1762
16021,2389,28773,1856,899,288,611,4,1199,2,2
11189,732,2903,524,70,70,0,2,8,2,0
10803,1087,3081,797,70,70,0,1,5,1,0
13659,10,23253,9,183,94,89,2,29,1,1
8828,10,13345,9,268,93,175,4,58,2,2
8816,10,6092,9,821,102,719,2,29,1,1
14731,10,21447,9,199,102,97,2,29,1,1
18512,15,9028,11,50477,10880,39597,69,16,33,36
4909,15,10050,11,111328,4904,106424,145,240,66,79
14559,10,27855,9,774,101,673,2,30,1,1
19321,15,14636,11,214,140,74,4,41,3,1
4571,10,16040,9,197,90,107,2,30,1,1
18553,1928,13650,1472,320,140,180,6,7,3,3
8906,10,25961,9,167,86,81,2,29,1,1
15552,10,18792,9,180,94,86,2,31,1,1
14963,10,17419,9,195,102,93,2,29,1,1
21306,10,10888,9,180,94,86,2,30,1,1
22206,10,7754,9,204,104,100,2,31,1,1
15568,10,7853,9,196,94,102,2,30,1,1
13377,10,24020,9,216,98,118,2,30,1,1
6138,26,23503,16,8579,2273,6306,17,136,8,9
4889,26,7917,16,350,210,140,6,15,4,2
16501,26,9546,16,1536,1089,447,11,56,7,4
12707,3059,15877,2375,70,70,0,1,5,1,0
15069,15,12912,11,37154,2381,34773,50,135,23,27
15175,26,15148,16,7941,1952,5989,20,15,11,9
15318,10,1737,9,209,110,99,2,30,1,1
21532,10,8007,9,256,102,154,2,30,1,1
13421,26,26895,16,5826,1199,4627,21,42,11,10
15397,10,25331,9,184,94,90,2,29,1,1
17135,26,18560,16,5166,700,4466,16,15,7,9
10798,15,2465,11,211684,9903,201781,247,27,109,138
21339,10,23083,9,257,94,163,2,30,1,1
8414,10,28611,9,776,283,493,8,82,4,4
14434,26,15439,16,9398,2478,6920,26,82,14,12
1731,2989,18552,2323,2227,1224,1003,20,1200,11,9
14300,2296,20903,1780,70,70,0,2,8,2,0
15190,26,11962,16,4425,2899,1526,24,34,14,10
17200,233,5316,148,160,86,74,2,6,1,1
4648,26,16003,16,1386,924,462,12,30,7,5
7408,10,20040,9,257,101,156,2,33,1,1
9086,26,2594,16,11466,1320,10146,22,135,10,12
10827,1498,11799,1139,70,70,0,1,5,1,0
9411,3224,13824,2501,970,598,372,14,1201,8,6
22649,10,350,9,177,94,83,2,30,1,1
2744,1562,27186,1193,878,126,752,2,31,1,1
8572,15,18604,11,2074,1309,765,10,124,6,4
15803,10,5156,9,752,93,659,2,31,1,1
15290,26,8247,16,1207531,28695,1178836,1184,46,400,784
1491,10,5268,9,233,90,143,2,32,1,1
15383,10,17734,9,90,90,0,1,30,1,0
18964,15,10965,11,912,472,440,8,15,3,5
13615,26,26136,16,1015861,30762,985099,1147,257,421,726
14094,10,10824,9,177,94,83,2,30,1,1
9196,10,8516,9,179,94,85,2,30,1,1
8584,1238,11105,918,280,71,209,2,31,1,1
15287,26,28128,16,8058,2038,6020,20,15,11,9
11186,839,13042,618,70,70,0,1,5,1,0
14792,10,6356,9,196,102,94,2,29,1,1
9733,26,12098,16,10257,6305,3952,31,134,19,12
9539,15,4756,11,487,180,307,6,26,4,2
11321,26,1959,16,3055,1931,1124,16,16,9,7
2,3233,1,2010,624666,17676,606990,671,14,267,404
17015,10,26000,9,197,76,121,2,30,1,1
15050,10,9481,9,177,94,83,2,30,1,1
15974,10,215,9,165,86,79,2,31,1,1
17975,26,22390,16,502,250,252,9,26,5,4
10786,2084,9813,1606,70,70,0,2,8,2,0
4274,10,15594,9,229,89,140,2,30,1,1
6264,26,15733,16,4181,998,3183,14,26,7,7
13649,10,25422,9,199,102,97,2,30,1,1
14119,26,10618,16,4496,2369,2127,15,136,7,8
22428,10,26988,9,267,93,174,4,47,2,2
5228,26,14550,16,7089,1290,5799,24,16,12,12
10218,15,12547,11,12300,4454,7846,26,30,13,13
6602,26,28672,16,130,70,60,2,15,1,1
11291,10,4137,9,195,94,101,2,29,1,1
9729,26,26813,16,1594,951,643,15,97,8,7
7743,676,22103,475,130,70,60,2,5,1,1
14292,2296,16302,1780,320,140,180,6,6,3,3
909,10,3589,9,237,91,146,2,33,1,1
9781,15,15793,11,175050,8089,166961,167,48,48,119
8444,10,1248,9,821,102,719,2,30,1,1
1424,10,4954,9,216,90,126,2,29,1,1
4859,26,27631,16,14337,3375,10962,47,121,23,24
22171,10,3518,9,209,110,99,2,30,1,1
22388,10,11196,9,453,186,267,6,30,3,3
14367,10,5608,9,228,110,118,2,30,1,1
3294,26,13559,16,1780845,46018,1734827,1751,141,546,1205
7616,15,9717,11,1137,679,458,10,15,6,4
9048,10,19477,9,232,110,122,2,30,1,1
15229,26,12305,16,18544,4402,14142,31,191,14,17
14268,2781,18482,2158,70,70,0,1,5,1,0
2515,10,10544,9,216,82,134,2,33,1,1
0,0,0,0,320,320,0,5,0,5,0
14257,10,21281,9,208,94,114,2,30,1,1
14900,10,11129,9,183,94,89,2,30,1,1
22533,10,16484,9,313,110,203,4,33,2,2
10162,15,26298,11,1514,480,1034,11,15,6,5
13142,26,5019,16,7723,2282,5441,22,255,11,11
18292,15,6901,11,4050,2838,1212,14,16,7,7
19075,1262,8398,942,1778,1386,392,8,30,4,4
8471,298,21426,193,6247,4138,2109,21,15,13,8
2744,1239,19310,919,898,126,772,3,31,2,1
22379,10,28820,9,299,103,196,4,51,2,2
17713,26,20664,16,3255,1089,2166,10,122,5,5
16124,15,25455,11,1165239,13055,1152184,977,149,193,784
15708,10,1866,9,199,102,97,2,29,1,1
8616,10,18398,9,330,118,212,2,30,1,1
21207,10,22044,9,260,102,158,2,31,1,1
13842,10,23024,9,711,87,624,2,30,1,1
14972,26,3364,16,13706,5958,7748,78,202,42,36
18486,26,16852,16,11488,7258,4230,47,122,27,20
14439,10,20423,9,177,94,83,2,30,1,1
21248,10,11077,9,200,102,98,2,30,1,1
13828,10,7336,9,199,102,97,2,30,1,1
8516,10,5873,9,183,94,89,2,30,1,1
15727,10,2892,9,498,204,294,6,30,3,3
22321,10,5760,9,167,86,81,2,30,1,1
6768,26,12522,16,2548,1257,1291,15,416,8,7
10027,26,24807,16,6354,1373,4981,18,129,9,9
19623,26,16318,16,214,140,74,4,15,3,1
16021,519,5928,343,353,166,187,2,1199,1,1
21591,26,26238,16,1786,172,1614,7,120,3,4
9771,26,6655,16,8256,1674,6582,31,75,15,16
12052,26,6645,16,7432,1694,5738,23,27,12,11
9766,10,3144,9,177,94,83,2,31,1,1
21559,10,25658,9,177,94,83,2,29,1,1
4972,676,8045,475,130,70,60,2,6,1,1
20563,10,4721,9,510,164,346,2,31,1,1
21203,1582,17983,1212,312,132,180,6,6,3,3
15455,10,9014,9,181,86,95,2,30,1,1
9247,26,21112,16,12446,2347,10099,44,190,23,21
9217,1241,2667,921,468,390,78,5,30,4,1
21270,26,28451,16,4597,1690,2907,19,28,11,8
9411,304,28701,198,1488,930,558,21,1200,12,9
8797,10,24877,9,198,102,96,2,30,1,1
22136,10,21299,9,292,126,166,2,30,1,1
15988,26,9554,16,26468,3325,23143,41,147,16,25
12536,2577,10461,1999,70,70,0,2,7,2,0
4701,26,19706,16,27993,2483,25510,51,48,25,26
13775,10,2785,9,177,94,83,2,30,1,1
13832,26,27675,16,7375,1549,5826,31,353,10,21
4911,26,4161,16,49386,4604,44782,82,32,43,39
8662,26,19871,16,15404,11220,4184,29,27,16,13
18624,26,19102,16,10385,4932,5453,21,135,9,12
17102,26,16303,16,8591,2275,6316,37,137,21,16
17299,26,28942,16,2608,1523,1085,19,15,10,9
9816,15,11848,11,1515,481,1034,11,16,6,5
8646,295,21508,190,3050,1659,1391,16,15,9,7
19526,26,6774,16,14462,3625,10837,31,63,16,15
13792,10,20751,9,209,102,107,2,30,1,1
636,280,14612,177,502,150,352,2,1200,1,1
10955,1429,18620,1084,70,70,0,2,8,2,0
21776,10,17021,9,183,94,89,2,31,1,1
11245,777,23247,563,136,136,0,3,12,3,0
8989,10,21801,9,198,94,104,2,30,1,1
8928,15,3477,11,2114,1182,932,10,127,6,4
16388,26,17710,16,17285,4005,13280,26,120,11,15
14913,26,27313,16,1786,172,1614,7,121,3,4
7427,26,12322,16,6685,4843,1842,29,17,18,11
1784,26,24174,16,7461,1034,6427,21,16,11,10
9435,26,12785,16,9571,2811,6760,45,87,24,21
15163,10,3134,9,184,94,90,2,31,1,1
8969,26,10279,16,5938,1521,4417,20,125,10,10
21842,10,26624,9,179,94,85,2,30,1,1
9731,15,22058,11,1711,1011,700,11,21,6,5
9577,26,4712,16,134,60,74,3,10,2,1
13691,26,8107,16,10640,3171,7469,28,45,15,13
4975,26,28594,16,434,226,208,7,28,4,3
8340,15,27977,11,254,128,126,5,15,3,2
3067,10,12811,9,235,90,145,2,33,1,1
11227,913,12728,675,70,70,0,2,7,2,0
8584,1283,23392,962,258,78,180,2,30,1,1
4835,2986,15277,2320,15544,7978,7566,132,3153,72,60
6079,26,25506,16,7036547,93047,6943500,5816,186,995,4821
15879,26,2774,16,8237,2784,5453,35,16,21,14
856,26,13658,16,11768028,275478,11492550,12305,77,4158,8147
18101,26,28804,16,10580,2487,8093,28,16,16,12
14248,10,2581,9,178,94,84,2,31,1,1
12027,1754,5605,1339,70,70,0,2,8,2,0
10844,26,17976,16,6133,1655,4478,12,120,5,7
13248,15,2408,11,2828,1710,1118,10,255,6,4
5352,26,24952,16,494,342,152,4,5,2,2
8682,10,18257,9,183,94,89,2,30,1,1
1098,26,5338,16,6100,777,5323,17,25,9,8
8205,26,26928,16,7298,2661,4637,21,19,11,10
21831,10,14530,9,184,94,90,2,30,1,1
12134,26,23342,16,1220,659,561,13,120,7,6
6047,15,18026,11,3571,2892,679,13,23,8,5
8925,10,23828,9,166,86,80,2,30,1,1
21496,10,7417,9,197,102,95,2,30,1,1
11001,15,24788,11,426,240,186,8,26,5,3
21828,10,11620,9,398,102,296,2,30,1,1
5385,26,23258,16,9590,3811,5779,20,122,10,10
15719,10,16702,9,173,94,79,2,30,1,1
15229,10,2847,9,306,306,0,4,47,4,0
22344,10,173,9,216,110,106,2,30,1,1
8463,10,17614,9,193,102,91,2,30,1,1
9475,26,10253,16,9585,2138,7447,26,82,13,13
21357,10,27461,9,329,102,227,2,30,1,1
22044,10,3538,9,200,94,106,2,30,1,1
15780,10,22486,9,177,94,83,2,30,1,1
9898,15,22151,11,450,246,204,8,25,5,3
5387,26,12492,16,3310,2291,1019,17,16,10,7
13910,10,7859,9,740,93,647,2,31,1,1
12726,26,17388,16,499,425,74,4,0,3,1
2744,1241,21331,921,879,126,753,2,30,1,1
4126,15,15334,11,336615,15190,321425,383,31,159,224
13751,10,6454,9,182,102,80,2,30,1,1
11069,15,16849,11,366,240,126,7,25,5,2
9283,15,2631,11,164773,6196,158577,200,135,83,117
15464,10,24646,9,226,110,116,2,30,1,1
11974,26,5686,16,16157,6478,9679,46,83,23,23
11181,10,22815,9,198,89,109,2,31,1,1
7959,26,20830,16,9159,1627,7532,19,150,11,8
8595,10,22582,9,199,102,97,2,29,1,1
15914,26,20514,16,126,60,66,3,11,2,1
5816,26,8228,16,9856,1973,7883,32,140,17,15
7306,26,10898,16,44232,11223,33009,97,460,50,47
10794,1656,2206,1273,70,70,0,1,5,1,0
21388,10,14304,9,294,134,160,2,30,1,1
13681,10,5921,9,177,94,83,2,29,1,1
7001,26,27061,16,4502,895,3607,15,25,9,6
9049,10,16407,9,377,94,283,2,30,1,1
21254,10,14471,9,618,111,507,4,30,2,2
5284,10,9626,9,168,78,90,2,30,1,1
17311,10,21056,9,179,86,93,2,30,1,1
21667,10,26670,9,180,94,86,2,29,1,1
10691,15,4178,11,318,192,126,6,37,4,2
22685,18,4351,13,184,94,90,2,30,1,1
6654,26,9738,16,4680,2835,1845,33,80,16,17
15819,10,19554,9,94,94,0,1,30,1,0
13980,26,24367,16,5593,2346,3247,22,39,13,9
14515,10,21120,9,177,94,83,2,30,1,1
13591,26,3718,16,11700,3386,8314,63,362,33,30
8739,26,6642,16,7332,2197,5135,18,135,8,10
14054,10,14760,9,198,102,96,2,33,1,1
21250,1381,8565,1050,564,382,182,9,15,6,3
13451,26,2929,16,84945,5052,79893,120,360,61,59
8259,26,21809,16,9519,4377,5142,33,354,17,16
14441,10,26606,9,194,102,92,2,31,1,1
14226,2089,2022,1610,70,70,0,1,5,1,0
4528,26,1930,16,4871,923,3948,19,360,10,9
6644,10,16225,9,199,94,105,2,30,1,1
11853,10,8014,9,168,78,90,2,30,1,1
13384,26,24755,16,1773,1038,735,17,278,9,8
2863,1991,18863,1521,253,190,63,2,30,1,1
9061,26,9678,16,33013,21249,11764,151,492,79,72
22141,10,6963,9,168,86,82,2,31,1,1
12445,1470,27874,1120,70,70,0,1,4,1,0
14565,26,27364,16,6058,1749,4309,22,200,13,9
22607,10,160,9,758,102,656,2,30,1,1
17176,15,26636,11,32098,2435,29663,47,75,24,23
17060,26,18152,16,45482,2178,43304,56,15,22,34
8386,15,17814,11,2010,664,1346,11,84,7,4
5246,26,15512,16,6699,4494,2205,27,29,14,13
10843,3204,22175,2484,70,70,0,2,8,2,0
17504,26,24711,16,242735602,5306961,237428641,238334,3604,81340,156994
12641,26,28214,16,499,425,74,4,0,3,1
11102,1166,10651,861,70,70,0,2,8,2,0
21559,10,1096,9,212,102,110,2,30,1,1
8709,15,5652,11,1548,847,701,10,15,5,5
12258,10,23411,9,832,106,726,2,30,1,1
8952,10,26152,9,752,110,642,2,30,1,1
5304,10,27596,9,168,78,90,2,29,1,1
15463,26,27159,16,6935,1415,5520,22,186,12,10
15501,10,4224,9,178,94,84,2,30,1,1
13664,10,18294,9,195,102,93,2,29,1,1
17870,26,25053,16,2233,1237,996,18,75,9,9
16511,26,25137,16,866223,30135,836088,916,138,300,616
15452,10,21418,9,168,86,82,2,31,1,1
21559,26,9514,16,3205,781,2424,17,135,8,9
15215,10,26845,9,733,93,640,2,31,1,1
2172,1665,20730,1274,481,150,331,2,1199,1,1
8350,10,20008,9,817,102,715,2,30,1,1
9055,15,20490,11,1376,946,430,8,86,5,3
8746,10,27712,9,196,102,94,2,30,1,1
18772,26,25636,16,61151,2474,58677,61,25,16,45
1803,26,9963,16,2227,1018,1209,17,16,8,9
7411,26,20533,16,979612,946319,33293,1091,25,690,401
12693,26,12193,16,3692,2154,1538,25,81,12,13
8598,10,8942,9,199,94,105,2,30,1,1
9623,26,14769,16,5491,2608,2883,17,122,8,9
8616,26,4310,16,5792,1511,4281,19,77,11,8
14841,10,16946,9,228,110,118,2,30,1,1
12007,1864,16676,1422,70,70,0,1,5,1,0
8528,10,22298,9,184,94,90,2,31,1,1
18990,26,25966,16,6043,1568,4475,11,120,4,7
8381,2980,8448,2314,70,70,0,1,5,1,0
18777,923,4831,681,70,70,0,1,5,1,0
14836,10,2266,9,215,102,113,2,30,1,1
6504,26,23871,16,3083,1817,1266,18,15,8,10
22618,10,506,9,238,94,144,2,30,1,1
7489,26,5756,16,8465,3202,5263,23,120,10,13
22023,295,28819,190,2269,815,1454,14,15,7,7
8706,26,3125,16,7454,2377,5077,33,130,15,18
21168,2508,28439,1950,66,66,0,1,5,1,0
18133,10,22769,9,86,86,0,1,30,1,0
22185,10,13196,9,214,110,104,2,30,1,1
8901,26,26619,16,378,256,122,7,18,5,2
17558,26,26323,16,4401,1494,2907,19,27,11,8
22161,10,11796,9,472,124,348,4,39,2,2
18052,15,164,11,1756,414,1342,12,15,6,6
1161,2055,13744,1581,292,158,134,2,30,1,1
11025,26,15602,16,9966,5049,4917,41,15,25,16
21505,10,28172,9,199,102,97,2,31,1,1
15032,10,25723,9,243,94,149,2,30,1,1
21842,10,4506,9,212,102,110,2,30,1,1
264,15,690,11,8395,700,7695,17,15,8,9
5499,10,17159,9,247,98,149,2,33,1,1
8656,10,2499,9,364,92,272,4,38,2,2
9222,26,19272,16,39888,5010,34878,60,104,32,28
11799,26,2886,16,26307,17595,8712,52,498,29,23
13597,15,22365,11,2513,567,1946,10,75,6,4
17524,15,26296,11,85989,14398,71591,143,15,40,103
17690,26,24088,16,8743,2676,6067,30,25,16,14
22244,10,24723,9,234,102,132,2,30,1,1
18989,26,4745,16,7583,2669,4914,31,17,16,15
1634,26,1253,16,5103,3164,1939,32,168,17,15
8982,10,15068,9,286,110,176,2,30,1,1
15816,26,29061,16,6439,1702,4737,21,68,13,8
15035,10,3503,9,195,102,93,2,30,1,1
8802,26,26070,16,9790,1841,7949,24,136,12,12
11569,26,26801,16,18341,14819,3522,59,1044,31,28
8646,10,21508,9,213,79,134,2,32,1,1
3998,349,8162,222,234,234,0,4,11,4,0
11232,26,25067,16,3036,818,2218,12,119,6,6
477,10,1703,9,203,82,121,2,30,1,1
15588,10,27411,9,279,94,185,2,30,1,1
4141,26,19923,16,9276,1884,7392,23,94,13,10
9708,26,17092,16,8182,1488,6694,23,133,13,10
13444,15,18647,11,6453,1316,5137,16,315,9,7
22158,10,19649,9,210,102,108,2,30,1,1
21700,10,243,9,196,102,94,2,30,1,1
18541,2757,24954,2138,70,70,0,1,5,1,0
13758,10,26958,9,184,94,90,2,29,1,1
17318,15,3151,11,4119,611,3508,12,18,4,8
16021,384,17053,247,469,150,319,2,1199,1,1
15907,10,7924,9,771,101,670,2,31,1,1
9181,26,23886,16,51055,17321,33734,147,612,77,70
17844,26,9144,16,304,86,218,2,31,1,1
10627,15,27781,11,2091,1098,993,21,300,11,10
15350,10,23654,9,177,94,83,2,30,1,1
7023,15,12552,11,1514,962,552,7,16,5,2
19032,10,27112,9,237,91,146,2,33,1,1
15133,26,4435,16,36053,3513,32540,54,96,25,29
11032,15,15462,11,546,300,246,10,24,6,4
14752,10,4075,9,94,94,0,1,30,1,0
22703,10,27396,9,291,98,193,4,33,2,2
8527,10,19486,9,263,102,161,2,29,1,1
15595,15,13053,11,77115,5003,72112,110,35,56,54
12141,26,14277,16,41435,6615,34820,85,193,46,39
8221,26,23168,16,3297,2327,970,22,51,11,11
11149,2512,7748,1953,258,70,188,4,8,2,2
6548,26,7605,16,1527,940,587,14,22,8,6
10038,15,11047,11,13949172,164502,13784670,11537,135,2287,9250
15674,10,19299,9,711,87,624,2,31,1,1
8750,15,19180,11,318,192,126,6,42,4,2
16367,15,19047,11,318,192,126,6,26,4,2
9812,15,12970,11,24370,5713,18657,37,26,17,20
21753,10,5981,9,195,102,93,2,29,1,1
14918,10,12565,9,178,94,84,2,30,1,1
8685,26,21535,16,15064,2611,12453,43,76,23,20
7842,26,26627,16,291717,11752,279965,319,137,123,196
5456,26,4953,16,101895,6430,95465,152,175,66,86
13799,10,15805,9,733,94,639,2,30,1,1
21667,10,4895,9,180,94,86,2,31,1,1
16021,280,22215,177,1806,726,1080,24,2426,12,12
2867,15,15886,11,3683,591,3092,11,45,6,5
21808,10,23393,9,186,95,91,2,31,1,1
22573,26,6356,16,15607,5238,10369,36,126,19,17
13955,10,10277,9,196,102,94,2,31,1,1
22659,10,8753,9,226,94,132,2,30,1,1
22704,10,7549,9,195,102,93,2,29,1,1
15249,10,7183,9,183,94,89,2,31,1,1
3527,10,16684,9,506,316,190,3,30,2,1
12452,42,8515,25,70,70,0,1,5,1,0
12311,26,16725,16,25079,5739,19340,39,337,18,21
8472,10,26169,9,177,94,83,2,29,1,1
9522,26,5780,16,7738,879,6859,19,27,10,9
15557,10,2626,9,199,102,97,2,29,1,1
8210,287,21194,184,502,158,344,2,1200,1,1
7498,26,15243,16,5117,3501,1616,29,80,15,14
22489,10,9881,9,190,97,93,2,31,1,1
16528,1820,23459,1387,204,64,140,4,11,2,2
3581,26,3466,16,6084,1842,4242,26,329,14,12
7607,10,20297,9,235,90,145,2,33,1,1
8746,10,26792,9,196,102,94,2,30,1,1
11012,15,20645,11,14487990,289826,14198164,13259,54,3839,9420
19811,26,12078,16,38455,5252,33203,71,60,41,30
14854,10,4487,9,193,102,91,2,30,1,1
9994,26,6124,16,9930,2085,7845,21,318,11,10
3716,10,25195,9,202,83,119,2,31,1,1
9582,10,19404,9,296,101,195,4,31,2,2
19334,26,2694,16,7896,1207,6689,20,26,10,10
15845,26,21944,16,840,420,420,14,39,7,7
8487,10,11968,9,185,102,83,2,30,1,1
15706,10,14882,9,184,94,90,2,31,1,1
13503,26,7195,16,70,70,0,1,4,1,0
22595,10,4647,9,182,94,88,2,30,1,1
14866,10,14182,9,228,110,118,2,30,1,1
17895,26,14426,16,6723,1014,5709,19,29,10,9
7510,26,16258,16,494,280,214,8,29,5,3
13675,26,19951,16,31237,2116,29121,57,195,24,33
3649,26,2587,16,5035,768,4267,14,15,8,6
5470,26,11843,16,45852,4123,41729,61,17,25,36
15647,10,27196,9,166,86,80,2,30,1,1
14508,10,12576,9,733,94,639,2,30,1,1
4171,26,3207,16,1092248,9101,1083147,860,195,111,749
12433,2026,19245,1555,70,70,0,1,4,1,0
2744,1453,198,1106,888,126,762,2,31,1,1
5760,26,7174,16,3287,2049,1238,12,32,7,5
9697,26,9628,16,1632,1023,609,16,133,9,7
21176,346,25350,220,1269,548,721,10,15,6,4
21802,26,6638,16,24918,2042,22876,40,16,19,21
14106,26,24429,16,4579,1672,2907,19,29,11,8
8957,10,2864,9,216,94,122,2,30,1,1
16819,26,3560,16,9972,2138,7834,39,130,19,20
8516,10,5146,9,405,110,295,4,38,2,2
15858,10,14222,9,170,87,83,2,31,1,1
17221,26,26103,16,4627,1720,2907,19,28,11,8
19309,26,5974,16,5020,860,4160,18,28,9,9
11477,26,26806,16,32975,9028,23947,39,15,18,21
22249,10,28797,9,749,94,655,2,30,1,1
3799,26,12642,16,3521,516,3005,12,15,6,6
9031,26,10010,16,7461,2841,4620,19,103,11,8
6864,10,902,9,168,78,90,2,30,1,1
15284,10,24218,9,211,102,109,2,30,1,1
15145,10,2088,9,181,94,87,2,32,1,1
4056,15,27604,11,841,715,126,5,15,3,2
8694,10,25434,9,177,94,83,2,30,1,1
18360,10,11400,9,224,94,130,2,30,1,1
15695,26,17850,16,6489,1065,5424,22,255,12,10
14522,10,1101,9,184,94,90,2,30,1,1
21218,10,3455,9,183,94,89,2,30,1,1
21982,10,3247,9,734,94,640,2,30,1,1
5912,26,3557,16,78,78,0,1,5,1,0
3504,26,11,16,8533,4446,4087,65,160,32,33
14381,10,15212,9,177,94,83,2,30,1,1
2875,26,9395,16,5515,1388,4127,18,15,9,9
20422,40,1426,23,9848,4639,5209,83,41,42,41
15097,10,13928,9,711,87,624,2,30,1,1
9711,26,21226,16,7367,1149,6218,18,26,9,9
8632,10,24963,9,202,103,99,2,31,1,1
8713,26,27282,16,7817,1780,6037,26,172,13,13
11035,1639,15422,1259,70,70,0,1,5,1,0
11044,15,10132,11,30427,2131,28296,66,32,25,41
8400,10,24903,9,196,102,94,2,29,1,1
15236,10,3034,9,297,102,195,4,33,2,2
22033,10,15902,9,193,102,91,2,29,1,1
21546,10,4315,9,182,93,89,2,31,1,1
21323,726,14842,519,66,66,0,2,8,2,0
9062,10,5570,9,184,94,90,2,30,1,1
22149,10,21315,9,94,94,0,1,30,1,0
11495,26,17243,16,5096,810,4286,15,15,8,7
21754,10,26211,9,196,100,96,2,30,1,1
21415,10,14124,9,179,94,85,2,30,1,1
12596,26,21014,16,499,425,74,4,0,3,1
9386,10,16873,9,183,94,89,2,30,1,1
22447,10,8998,9,182,102,80,2,30,1,1
12552,2253,19935,1744,320,140,180,6,5,3,3
1022,26,7408,16,3255,430,2825,11,15,6,5
13681,10,7710,9,168,86,82,2,30,1,1
15300,10,16078,9,176,90,86,3,55,2,1
8682,15,9037,11,1256,746,510,11,70,6,5
14115,10,21498,9,232,94,138,2,30,1,1
824,26,25333,16,4367,1108,3259,37,426,11,26
10541,26,27477,16,343,163,180,6,15,3,3
12655,791,10618,575,70,70,0,1,4,1,0
9044,15,9027,11,2087,1215,872,8,88,5,3
8735,10,11338,9,821,102,719,2,30,1,1
14299,10,10016,9,196,102,94,2,33,1,1
15352,2133,8807,1646,70,70,0,1,5,1,0
13400,26,6488,16,1786,172,1614,7,120,3,4
8655,10,9680,9,241,118,123,2,30,1,1
9060,26,18876,16,5996,976,5020,19,35,10,9
16670,26,8553,16,5619,1387,4232,18,205,10,8
10114,15,27264,11,613,539,74,7,15,6,1
13845,10,25731,9,212,108,104,2,30,1,1
16372,26,17764,16,240332,6623,233709,258,170,92,166
14603,10,27149,9,196,86,110,2,30,1,1
20878,10,28246,9,217,91,126,2,30,1,1
3366,26,6665,16,6648,1556,5092,23,29,13,10
9172,10,26161,9,359,95,264,4,46,2,2
623,10,2502,9,228,90,138,2,32,1,1
5152,26,7164,16,29887852,586245,29301607,27419,299,7975,19444
21976,10,12626,9,172,88,84,2,30,1,1
10109,26,14962,16,7959,3288,4671,19,97,11,8
15571,10,28797,9,177,94,83,2,30,1,1
6070,26,15523,16,4570,792,3778,15,15,8,7
16846,26,22424,16,5611,1560,4051,22,266,13,9
15983,10,19740,9,363,94,269,2,30,1,1
8267,676,25788,475,130,70,60,2,5,1,1
15662,10,14141,9,177,94,83,2,30,1,1
13693,10,8783,9,177,94,83,2,30,1,1
19896,26,10857,16,36473,7710,28763,63,124,27,36
4925,26,24436,16,10208,2219,7989,37,125,19,18
21190,1689,11526,1291,312,132,180,6,7,3,3
9464,10,18095,9,188,96,92,2,31,1,1
12716,2723,15326,2117,70,70,0,2,8,2,0
15235,10,24680,9,183,94,89,2,31,1,1
3603,15,16032,11,1152,712,440,10,15,5,5
15726,26,22621,16,522,78,444,8,22,2,6
15410,10,15938,9,170,87,83,2,31,1,1
5630,6,17379,6,66,66,0,1,5,1,0
6957,10,18941,9,199,94,105,2,30,1,1
4835,1582,2533,1212,1650,1650,0,26,1537,26,0
15085,15,26600,11,1583,712,871,10,136,6,4
18297,26,7816,16,4308,1658,2650,14,16,7,7
11120,26,2644,16,6383,5237,1146,19,16,11,8
15752,10,14878,9,170,87,83,2,31,1,1
5128,26,23612,16,90561,3481,87080,96,16,31,65
16802,26,4606,16,5771,3201,2570,22,161,10,12
15892,26,24737,16,56199,3856,52343,81,216,39,42
12289,26,23433,16,2503,1457,1046,21,102,10,11
14582,10,1811,9,939,678,261,2,30,1,1
532,247,0,0,3562,1936,1626,48,195,24,24
10848,15,28787,11,366,240,126,7,25,5,2
8996,10,10206,9,364,102,262,2,30,1,1
13949,26,181,16,4981,943,4038,20,360,10,10
16700,26,16217,16,4611,3176,1435,26,30,15,11
143,15,305,11,198357,5070,193287,197,95,63,134
17266,15,16420,11,1521,967,554,10,75,6,4
16229,26,29023,16,1019,644,375,10,37,6,4
17486,26,22421,16,8332,1024,7308,21,25,11,10
14284,10,12791,9,413,102,311,2,30,1,1
8584,1067,25010,786,244,71,173,2,30,1,1
11211,52,9605,35,70,70,0,2,8,2,0
4196,26,3492,16,70007,4677,65330,92,172,36,56
8518,10,11653,9,166,86,80,2,30,1,1
10327,2840,10139,2204,330,330,0,6,1200,6,0
9064,26,7922,16,52800,13228,39572,134,154,64,70
15286,26,20757,16,8005,1985,6020,20,15,11,9
19036,10,27115,9,257,106,151,2,30,1,1
11140,15,7758,11,422,240,182,8,26,5,3
6955,26,5887,16,3054,1741,1313,20,27,8,12
2744,1456,3070,1109,889,126,763,3,31,2,1
8493,10,6819,9,186,95,91,2,30,1,1
22422,10,3307,9,212,102,110,2,30,1,1
5133,26,15877,16,90166,3481,86685,96,15,31,65
22471,10,7961,9,295,101,194,4,32,2,2
11172,2809,21985,2179,70,70,0,2,8,2,0
17570,26,28357,16,59122,7352,51770,85,322,41,44
14810,26,10205,16,129824,16359,113465,185,459,79,106
10121,26,6120,16,49212,42366,6846,109,147,59,50
15068,15,4704,11,43084,3056,40028,60,135,27,33
15886,26,8673,16,7472,2014,5458,29,16,16,13
265,10,693,9,197,76,121,2,30,1,1
12674,26,27820,16,499,425,74,4,0,3,1
22440,10,29133,9,196,100,96,2,30,1,1
12867,26,12763,16,43295,8391,34904,66,49,32,34
1569,10,25207,9,200,94,106,2,31,1,1
8802,10,9051,9,176,90,86,2,31,1,1
9707,26,29126,16,1313,876,437,11,26,6,5
13502,26,3617,16,13069,6969,6100,37,164,23,14
17155,26,19748,16,5168,700,4468,16,14,7,9
3855,26,20794,16,7524,1903,5621,31,22,18,13
8903,26,21221,16,35419,29471,5948,42,31,27,15
13809,10,15329,9,194,99,95,2,31,1,1
11038,2523,3394,1960,70,70,0,2,8,2,0
15386,2212,13454,1713,3034,1547,1487,12,16,7,5
14891,26,5311,16,1622,1137,485,11,26,7,4
22721,10,2592,9,255,102,153,2,29,1,1
4808,10,13948,9,199,94,105,2,30,1,1
10845,1391,17863,1058,70,70,0,2,7,2,0
14788,10,6554,9,789,110,679,2,31,1,1
14252,10,27647,9,244,94,150,2,29,1,1
9767,26,28659,16,1350,773,577,15,107,8,7
18676,10,1304,9,179,86,93,2,29,1,1
1321,26,4413,16,6981,948,6033,17,27,10,7
8942,10,6288,9,289,92,197,4,31,2,2
8939,10,7017,9,199,94,105,2,30,1,1
15323,10,24282,9,184,94,90,2,30,1,1
9743,15,22065,11,4228,3295,933,17,19,9,8
13042,26,9355,16,499,425,74,4,0,3,1
3066,1341,28598,1016,502,150,352,2,1200,1,1
5952,26,14653,16,6292,1492,4800,22,17,11,11
11705,15,25647,11,432,240,192,8,101,5,3
2744,1562,8692,1193,878,126,752,2,31,1,1
4688,26,26629,16,499,425,74,4,0,3,1
2744,100,11154,77,864,126,738,2,30,1,1
21628,10,12255,9,273,94,179,2,30,1,1
22316,10,4901,9,754,191,563,6,51,3,3
14084,10,17791,9,194,102,92,2,30,1,1
22095,10,3481,9,246,94,152,2,30,1,1
9500,10,3033,9,176,90,86,2,31,1,1
5250,10,16821,9,222,90,132,2,30,1,1
17127,26,11622,16,5167,700,4467,16,15,7,9
10160,26,12738,16,7263,1830,5433,27,16,15,12
14998,10,11712,9,199,102,97,2,30,1,1
11107,2645,5452,2053,70,70,0,2,8,2,0
12025,640,7849,445,70,70,0,2,8,2,0
565,183,2120,121,3850,1745,2105,19,18,11,8
10783,678,23232,477,66,66,0,1,5,1,0
18148,10,21767,9,199,94,105,2,30,1,1
9941,26,17845,16,6893,1384,5509,19,140,9,10
13991,10,29012,9,168,86,82,2,30,1,1
9021,10,19330,9,165,86,79,2,29,1,1
15387,2531,1295,1967,3060,1569,1491,12,16,7,5
15536,10,3260,9,199,102,97,2,31,1,1
9081,10,12458,9,209,110,99,2,29,1,1
8689,15,13816,11,1399,826,573,11,38,6,5
11475,26,12445,16,13734,3206,10528,26,150,13,13
9809,26,847,16,2626,1638,988,19,83,11,8
15736,10,28917,9,755,94,661,2,30,1,1
13700,26,23003,16,3804,1099,2705,19,137,8,11
9841,15,23688,11,2525,1403,1122,22,272,12,10
15249,15,4989,11,156,156,0,3,8,3,0
8602,10,22494,9,765,102,663,2,30,1,1
18044,15,12359,11,1169137,23501,1145636,1104,22,344,760
15227,26,2647,16,8006,1986,6020,20,15,11,9
5740,10,2461,9,168,78,90,2,29,1,1
14914,10,21882,9,186,95,91,2,30,1,1
10077,15,22252,11,78911,2499,76412,88,26,32,56
14092,26,5364,16,1786,172,1614,7,120,3,4
15115,26,19731,16,7760,1599,6161,23,80,13,10
13412,15,28718,11,2001,1107,894,13,150,7,6
7552,15,20219,11,51574,3466,48108,63,156,23,40
18142,26,15266,16,1350,689,661,14,44,8,6
7850,1661,0,0,106,106,0,1,60,1,0
12668,2621,25724,2032,70,70,0,1,4,1,0
18461,26,11658,16,2847,1797,1050,24,85,13,11
14355,10,29049,9,711,87,624,2,31,1,1
17071,10,26028,9,226,106,120,2,30,1,1
15462,10,14564,9,177,94,83,2,30,1,1
8539,10,6970,9,210,110,100,2,30,1,1
3709,26,25772,16,4542,2358,2184,20,20,11,9
17544,15,26311,11,24437,12718,11719,41,15,16,25
12625,10,4954,9,167,78,89,2,31,1,1
9943,26,13187,16,6417,1376,5041,19,140,9,10
17064,26,1919,16,21960,14378,7582,49,18,26,23
8526,10,3291,9,216,110,106,2,30,1,1
12510,15,3413,11,950,502,448,12,15,7,5
7339,3047,19929,2368,60,60,0,1,5,1,0
12120,26,497,16,8906,1533,7373,32,58,16,16
9728,2653,25454,2060,1356,300,1056,6,1200,3,3
14237,26,6063,16,13039,4388,8651,93,1191,47,46
14745,10,15234,9,195,102,93,2,29,1,1
15182,26,11301,16,133596,5859,127737,148,120,51,97
18066,26,1467,16,48525,4928,43597,111,660,55,56
9891,26,19679,16,12166,8765,3401,52,561,25,27
13957,10,15749,9,711,87,624,2,31,1,1
2657,15,11123,11,13592,1419,12173,25,31,13,12
8708,15,25630,11,1012,531,481,8,25,5,3
7050,26,15621,16,7474,1946,5528,33,270,18,15
9444,26,22374,16,11984,6772,5212,52,222,30,22
2650,15,11117,11,160989,10162,150827,189,31,81,108
21659,10,12518,9,193,102,91,2,31,1,1
6678,15,23711,11,3714,1646,2068,18,186,9,9
18125,26,4039,16,8382,2454,5928,44,86,26,18
22575,10,1321,9,443,182,261,6,30,3,3
9064,26,16697,16,8417,1173,7244,18,86,9,9
1379,10,4730,9,194,87,107,2,30,1,1
15276,26,25205,16,8007,1987,6020,20,15,11,9
14956,10,13428,9,177,94,83,2,31,1,1
15515,10,4263,9,177,94,83,2,31,1,1
14210,10,2094,9,177,94,83,2,30,1,1
2634,15,11086,11,12599,1479,11120,28,16,15,13
21479,10,10000,9,193,102,91,2,30,1,1
8949,26,14522,16,10095,2871,7224,23,126,12,11
12447,2752,28089,2133,70,70,0,2,7,2,0
15007,15,13872,11,17247,1619,15628,26,25,11,15
21517,10,12348,9,244,94,150,2,30,1,1
14611,10,18322,9,172,88,84,2,30,1,1
7979,15,22282,11,4006,3572,434,14,15,7,7
13882,10,4960,9,819,102,717,2,29,1,1
14470,26,25523,16,4344,2189,2155,15,126,7,8
8592,10,6140,9,492,91,401,4,56,2,2
15998,10,26519,9,411,110,301,2,30,1,1
2744,1238,27026,918,881,126,755,2,30,1,1
9728,1410,8283,1072,509,150,359,2,1200,1,1
22210,1255,4261,935,735,462,273,2,29,1,1
9077,26,13621,16,5570,901,4669,16,27,8,8
21750,10,5627,9,216,110,106,2,30,1,1
6020,26,24911,16,16028,3246,12782,37,272,19,18
22345,10,20114,9,199,102,97,2,29,1,1
12368,238,23920,152,320,140,180,6,6,3,3
8692,10,15333,9,272,97,175,4,58,2,2
22294,10,12163,9,229,94,135,2,30,1,1
8527,26,4743,16,5782,1008,4774,17,16,8,9
14322,10,23738,9,166,85,81,2,31,1,1
22440,10,14802,9,198,102,96,2,30,1,1
18475,15,26488,11,958,543,415,11,315,6,5
16074,26,10756,16,232,172,60,3,5,2,1
8621,26,27989,16,12386,1821,10565,23,33,11,12
8646,10,25683,9,184,94,90,2,31,1,1
15337,10,15406,9,168,86,82,2,31,1,1
13685,232,16869,147,6192,3767,2425,53,64,29,24
15204,26,25245,16,7889,1900,5989,20,15,11,9
9367,10,5237,9,165,86,79,2,29,1,1
14441,10,11295,9,184,94,90,2,30,1,1
2744,1624,3053,1246,884,126,758,2,31,1,1
11935,26,18921,16,3473,881,2592,13,121,6,7
1179,26,5913,16,34551,3731,30820,54,112,23,31
10064,15,18276,11,11381441,121813,11259628,9309,119,1741,7568
17153,26,16699,16,59754,9493,50261,131,367,68,63
15043,10,24785,9,177,94,83,2,30,1,1
13663,71,5778,54,6562,1873,4689,25,16,15,10
13992,10,11261,9,212,108,104,2,31,1,1
22240,10,23197,9,785,110,675,2,30,1,1
13812,10,8184,9,177,94,83,2,30,1,1
11104,2956,3815,2293,70,70,0,1,5,1,0
14408,10,28854,9,330,94,236,4,48,2,2
17080,26,16736,16,8661,1687,6974,30,244,16,14
11341,26,22910,16,6926,828,6098,17,26,9,8
4112,26,9640,16,5315,2861,2454,16,135,8,8
13710,26,23218,16,8309,1561,6748,26,204,14,12
11089,2408,24197,1873,70,70,0,1,5,1,0
9325,26,22610,16,3756,1914,1842,19,361,9,10
8664,26,15854,16,267319,11446,255873,336,192,117,219
9611,10,16665,9,758,93,665,2,31,1,1
11009,15,17323,11,366,240,126,7,25,5,2
7987,26,19368,16,9194,1066,8128,21,27,12,9
9764,26,2122,16,1277,851,426,12,92,7,5
15469,10,8957,9,177,94,83,2,30,1,1
8490,10,3818,9,210,110,100,2,30,1,1
4529,26,18707,16,752907,69016,683891,1372,231,537,835
6404,10,20670,9,168,78,90,2,30,1,1
9164,10,17661,9,263,110,153,2,30,1,1
8734,26,25925,16,7180,4959,2221,34,81,18,16
16389,26,22282,16,4103,2950,1153,26,131,16,10
8413,10,28329,9,286,102,184,2,31,1,1
19345,26,12590,16,8052,1307,6745,27,125,16,11
17871,1239,6467,919,1718,1386,332,8,30,4,4
15733,183,25254,121,3428,1714,1714,16,33,8,8
15568,26,15151,16,8721,2518,6203,29,159,13,16
16309,26,25584,16,4669,1762,2907,19,30,11,8
14658,10,14257,9,200,94,106,2,30,1,1
7468,10,4126,9,199,94,105,2,30,1,1
15318,26,28508,16,8060,2040,6020,20,15,11,9
20513,26,20974,16,448,166,282,2,29,1,1
12632,26,3391,16,499,425,74,4,0,3,1
14471,10,12982,9,183,102,81,2,30,1,1
9740,10,23181,9,168,86,82,2,29,1,1
12120,26,10896,16,11825,4129,7696,39,40,21,18
8824,10,612,9,195,102,93,2,30,1,1
908,26,25238,16,5734,498,5236,14,15,7,7
12400,2952,18050,2290,492,306,186,8,15,5,3
15445,10,25782,9,745,93,652,2,30,1,1
3349,15,16655,11,1899,1172,727,17,284,10,7
15987,10,5086,9,181,94,87,2,29,1,1
13673,26,28627,16,13326,1847,11479,27,31,14,13
13811,10,6209,9,199,102,97,2,30,1,1
8460,10,10125,9,178,94,84,2,30,1,1
21258,3194,19757,2476,66,66,0,2,8,2,0
2744,1624,17660,1246,884,126,758,2,31,1,1
15891,10,18377,9,184,94,90,2,30,1,1
13633,10,12725,9,207,97,110,3,64,2,1
6798,26,10851,16,7476,2315,5161,18,135,8,10
2046,280,13251,177,490,149,341,2,1200,1,1
8752,26,23803,16,5879,870,5009,18,53,9,9
10941,26,22676,16,4456,2972,1484,38,211,20,18
11034,2849,2910,2211,70,70,0,1,5,1,0
9152,26,21760,16,1466,696,770,20,120,10,10
11724,26,5235,16,130,70,60,2,14,1,1
14428,10,552,9,200,102,98,2,30,1,1
10939,1668,25149,1276,70,70,0,1,5,1,0
15702,10,14605,9,166,86,80,2,29,1,1
15329,10,21879,9,209,110,99,2,30,1,1
15005,15,14147,11,17008,1379,15629,22,25,7,15
15181,26,23386,16,9679,1633,8046,25,20,14,11
17931,26,17702,16,1401,864,537,12,29,6,6
8684,10,23662,9,193,102,91,2,30,1,1
2744,1067,6167,786,890,126,764,2,30,1,1
2979,10,12271,9,197,90,107,2,29,1,1
13987,10,12210,9,744,89,655,2,30,1,1
13039,26,3240,16,499,425,74,4,0,3,1
15379,26,25168,16,8074,2054,6020,20,15,11,9
10995,2480,15834,1929,66,66,0,1,5,1,0
22125,10,5145,9,182,93,89,2,31,1,1
18367,26,13066,16,39850,4375,35475,73,80,31,42
21880,10,5583,9,241,94,147,2,30,1,1
11051,15,15429,11,422,240,182,8,25,5,3
5951,26,12402,16,7240,2035,5205,25,316,12,13
2744,1238,18811,918,882,126,756,2,30,1,1
2744,1301,6992,979,865,126,739,2,30,1,1
22634,10,13579,9,730,102,628,2,30,1,1
5550,10,17242,9,218,90,128,2,30,1,1
9490,15,9503,11,502,250,252,9,41,5,4
19376,26,26349,16,9479,3507,5972,24,16,12,12
15909,10,13115,9,711,87,624,2,31,1,1
11333,15,22904,11,450,246,204,8,29,5,3
2744,2557,5908,1987,887,126,761,2,31,1,1
15244,26,889,16,7458,4186,3272,24,102,14,10
17603,26,26353,16,4736,1829,2907,19,29,11,8
3,1862,2,1420,178,118,60,2,4,1,1
8412,10,9909,9,195,102,93,2,30,1,1
22045,10,2664,9,199,102,97,2,31,1,1
14233,10,24761,9,196,100,96,2,30,1,1
17551,15,26318,11,24437,12718,11719,41,15,16,25
14145,10,5637,9,184,94,90,2,30,1,1
9186,10,22656,9,179,94,85,2,30,1,1
10852,570,24061,384,136,136,0,3,14,3,0
12649,26,1754,16,499,425,74,4,0,3,1
18496,26,17514,16,7113,3977,3136,23,136,12,11
19296,26,28976,16,33774,1880,31894,58,195,19,39
10507,26,3457,16,202,70,132,3,11,1,2
22566,10,5810,9,196,94,102,2,31,1,1
10955,26,2771,16,16797,8530,8267,53,82,30,23
14994,10,6927,9,740,93,647,2,30,1,1
14346,1248,16505,928,1778,1386,392,8,30,4,4
16507,8,14703,8,540,256,284,9,30,5,4
8522,10,26954,9,193,102,91,2,30,1,1
22489,10,15982,9,195,102,93,2,30,1,1
14142,10,4324,9,578,286,292,9,15,5,4
4719,26,8497,16,69348,4180,65168,86,45,37,49
15099,10,26200,9,310,126,184,2,30,1,1
22216,10,790,9,239,94,145,2,30,1,1
18247,10,2980,9,258,94,164,2,30,1,1
9728,280,20933,177,161,161,0,1,1200,1,0
15243,26,1285,16,8005,1985,6020,20,15,11,9
20545,26,13129,16,304,86,218,2,30,1,1
20491,26,2903,16,571,166,405,2,29,1,1
9375,26,14843,16,1775,169,1606,7,120,3,4
5369,234,7344,149,3505,2006,1499,30,3744,15,15
6118,10,28899,9,168,78,90,2,31,1,1
21113,135,26295,99,70,70,0,1,4,1,0
11063,26,5207,16,9609,3239,6370,25,143,12,13
7242,26,12961,16,1784491,72960,1711531,1872,113,687,1185
16075,26,10198,16,130,70,60,3,5,2,1
8376,2666,6106,2073,66,66,0,1,5,1,0
14954,10,28140,9,200,102,98,2,30,1,1
8518,10,7791,9,212,102,110,2,30,1,1
15568,10,26992,9,167,86,81,2,30,1,1
9125,10,27510,9,322,110,212,4,31,2,2
11789,26,26343,16,392514,41757,350757,626,118,209,417
5588,26,17308,16,1092,575,517,10,145,5,5
4500,10,15920,9,259,104,155,2,30,1,1
13694,26,20125,16,62,62,0,1,4,1,0
14984,26,14792,16,6202,1212,4990,27,1197,8,19
15227,15,16610,11,234,234,0,4,12,4,0
20372,26,8677,16,4777,2262,2515,10,122,5,5
8994,26,18960,16,3026,1775,1251,23,74,14,9
6606,10,18810,9,314,98,216,2,30,1,1
4333,26,7431,16,3549,899,2650,13,120,6,7
13807,10,15819,9,197,94,103,2,30,1,1
6250,2015,7057,1545,141,79,62,2,30,1,1
11086,15,28847,11,4562,3936,626,11,28,6,5
18791,26,6062,16,29739,1164,28575,40,120,15,25
15124,10,11929,9,199,102,97,2,31,1,1
13964,10,685,9,210,110,100,2,30,1,1
18479,26,4694,16,4953,1111,3842,22,104,12,10
22048,10,28830,9,288,83,205,2,30,1,1
22705,10,15440,9,305,89,216,4,41,2,2
12704,26,13375,16,3124,1556,1568,21,275,11,10
7701,26,8510,16,10868,2200,8668,32,44,14,18
21353,26,13498,16,4458,1569,2889,24,138,10,14
9849,15,10530,11,499,192,307,6,26,4,2
11597,280,1519,177,719,413,306,10,14,5,5
12899,10,23747,9,243,94,149,2,32,1,1
3347,26,21918,16,6746,2826,3920,19,399,11,8
15229,26,23402,16,4972,2136,2836,21,24,12,9
14221,15,7922,11,3276,404,2872,11,15,5,6
15957,10,20898,9,179,94,85,2,30,1,1
15903,10,1719,9,204,104,100,2,31,1,1
18610,26,4552,16,7981,1867,6114,32,313,17,15
9117,10,11510,9,214,110,104,2,29,1,1
14283,10,4192,9,304,110,194,4,34,2,2
16131,15,25461,11,80556,2669,77887,84,144,28,56
21949,10,6232,9,229,110,119,2,30,1,1
8584,1238,16750,918,78,78,0,1,30,1,0
21704,10,4831,9,184,94,90,2,30,1,1
14078,10,8586,9,216,110,106,2,30,1,1
11670,26,9347,16,613606,29392,584214,757,42,337,420
14048,10,27014,9,182,93,89,2,31,1,1
9755,26,27817,16,11152,2086,9066,33,93,17,16
11778,26,2710,16,7683,2076,5607,42,131,21,21
20959,10,15194,9,289,86,203,2,30,1,1
21270,10,2885,9,193,102,91,2,30,1,1
18297,15,27183,11,1989,1365,624,11,151,6,5
8874,10,13795,9,178,94,84,2,30,1,1
11003,15,25423,11,426,240,186,8,26,5,3
22573,10,14237,9,301,108,193,4,55,2,2
11902,26,19211,16,22480,2705,19775,49,109,22,27
16904,26,1068,16,3447,788,2659,13,135,6,7
12431,1557,26943,1188,70,70,0,2,8,2,0
18662,26,7258,16,117190,11380,105810,171,212,67,104
3729,26,396,16,11269403,319214,10950189,11392,382,3773,7619
18552,3137,3058,2435,504,318,186,8,15,5,3
21966,10,3705,9,715,94,621,2,29,1,1
9317,10,15474,9,260,86,174,2,29,1,1
14308,10,23028,9,749,94,655,2,31,1,1
17802,10,24392,9,497,118,379,2,30,1,1
4729,26,12977,16,9605,2939,6666,29,46,17,12
17872,10,5446,9,303,85,218,2,30,1,1
15104,26,13337,16,5082,973,4109,18,60,9,9
15187,10,28665,9,184,94,90,2,31,1,1
14530,10,14667,9,810,108,702,2,31,1,1
13974,10,21734,9,199,102,97,2,30,1,1
6201,15,21987,11,73277,3302,69975,102,16,52,50
7732,10,23451,9,222,78,144,2,30,1,1
7140,26,1604,16,11748,7422,4326,59,113,31,28
22656,26,13831,16,92244,4799,87445,107,15,43,64
18521,3108,14904,2415,1587,935,652,14,16,8,6
8210,281,21194,178,152,152,0,1,1200,1,0
10305,26,20839,16,3211,781,2430,17,135,8,9
22038,10,21929,9,166,86,80,2,30,1,1
6284,26,1073,16,101952,6925,95027,143,333,72,71
5599,15,13064,11,5043,1656,3387,18,205,10,8
9607,15,21989,11,210639,12949,197690,287,23,147,140
8192,26,18722,16,229628,10653,218975,263,49,103,160
12725,2579,21697,2001,492,306,186,8,15,5,3
9026,10,22715,9,194,102,92,2,30,1,1
15977,15,26882,11,4507,2978,1529,13,15,6,7
15051,15,1125,11,48910,2361,46549,63,135,29,34
15897,10,12700,9,216,110,106,2,30,1,1
2371,10,9757,9,197,90,107,2,30,1,1
20129,26,268,16,10385,7051,3334,27,33,15,12
9047,10,6031,9,177,94,83,2,30,1,1
8437,26,14082,16,10367,2273,8094,43,730,22,21
16040,26,20803,16,380975,82011,298964,804,171,343,461
22472,10,27652,9,184,94,90,2,30,1,1
5072,26,25486,16,9398,4241,5157,22,135,11,11
14792,10,24342,9,819,102,717,2,29,1,1
9117,10,20092,9,214,110,104,2,30,1,1
16133,15,11840,11,808,485,323,8,75,5,3
1337,1981,24201,1511,209,85,124,4,54,2,2
2046,560,27118,376,491,150,341,2,1200,1,1
12547,2226,3941,1725,1513,989,524,17,16,10,7
14935,10,24878,9,214,97,117,2,30,1,1
14794,10,15895,9,168,86,82,2,30,1,1
8886,26,1151,16,180777,5704,175073,204,105,67,137
22248,10,8383,9,258,94,164,2,31,1,1
15995,26,13990,16,5502,1543,3959,17,20,9,8
21402,10,10841,9,177,94,83,2,30,1,1
10890,26,16379,16,6577,1938,4639,14,121,7,7
14103,10,16060,9,177,94,83,2,30,1,1
21213,10,24139,9,174,89,85,2,31,1,1
11704,26,9159,16,19594,11977,7617,48,100,25,23
15158,10,19727,9,98,98,0,1,30,1,0
15288,26,6353,16,8006,1986,6020,20,15,11,9
4386,26,15690,16,1520,1058,462,12,29,8,4
6764,26,3423,16,8324,1658,6666,24,83,14,10
8139,26,6405,16,15400,9133,6267,40,272,22,18
8816,10,25993,9,539,97,442,4,58,2,2
10960,15,7413,11,1669,865,804,13,76,8,5
9002,10,27782,9,866,221,645,6,56,3,3
18038,15,20214,11,1756,414,1342,12,15,6,6
10315,26,25307,16,8886,2767,6119,52,17,28,24
21261,1707,23190,1303,70,70,0,1,4,1,0
9604,26,15643,16,5572,4252,1320,18,34,11,7
9956,10,0,0,182,73,109,2,30,1,1
16951,255,25970,160,130,66,64,2,4,1,1
5805,26,13075,16,6982,1535,5447,30,26,15,15
14418,10,19504,9,192,98,94,2,31,1,1
3332,26,24467,16,7338,2419,4919,19,35,12,7
15700,10,3615,9,279,96,183,4,32,2,2
8504,10,21596,9,199,102,97,2,30,1,1
8824,10,19949,9,195,102,93,2,29,1,1
22282,10,12693,9,284,118,166,2,30,1,1
11092,26,814,16,61141,52577,8564,102,363,50,52
15913,10,2737,9,199,102,97,2,29,1,1
8638,10,23044,9,209,102,107,2,30,1,1
15514,10,28377,9,196,102,94,2,30,1,1
18512,26,7617,16,26571,2432,24139,42,30,21,21
5542,26,22606,16,6834,2189,4645,40,29,26,14
18535,26,26828,16,18018,4407,13611,36,100,19,17
21886,10,6009,9,464,99,365,4,39,2,2
4510,26,6637,16,130,70,60,2,15,1,1
15037,10,16579,9,196,102,94,2,30,1,1
21770,10,25768,9,174,89,85,2,30,1,1
21631,10,1167,9,198,102,96,2,30,1,1
9441,183,21901,121,5936,2690,3246,25,20,15,10
15112,26,325,16,185925,12445,173480,210,105,82,128
22455,10,22658,9,266,110,156,2,30,1,1
12398,144,3444,102,70,70,0,2,7,2,0
9728,287,13873,184,311,311,0,3,1200,3,0
9532,346,21941,220,4417,2499,1918,18,56,10,8
8934,26,17406,16,12934,1419,11515,27,127,11,16
4337,26,26197,16,70,70,0,1,4,1,0
12150,26,21346,16,12912,4288,8624,43,20,22,21
22536,10,673,9,184,94,90,2,31,1,1
9647,26,19342,16,9295,3094,6201,24,82,12,12
9735,26,24039,16,5611,3452,2159,22,133,13,9
7937,26,14731,16,996037,37114,958923,1187,271,459,728
9815,26,13077,16,5409,1834,3575,25,17,12,13
19634,26,27447,16,317388,25904,291484,338,200,128,210
12665,3010,15831,2340,70,70,0,1,4,1,0
8434,10,24221,9,209,94,115,2,30,1,1
8933,10,21132,9,200,102,98,2,30,1,1
8862,10,10846,9,178,94,84,2,31,1,1
6457,26,27197,16,9878,1936,7942,36,121,18,18
2690,26,868,16,7407,2650,4757,24,20,12,12
8601,26,1159,16,10377,3140,7237,23,52,11,12
22471,10,12594,9,295,101,194,4,31,2,2
2707,26,5455,16,7219,2522,4697,21,20,10,11
21260,224,10572,145,70,70,0,1,4,1,0
14218,10,8452,9,177,94,83,2,30,1,1
2202,26,8932,16,14483,1152,13331,27,19,12,15
2724,1240,21589,920,422,164,258,6,30,3,3
14110,15,18228,11,25970,2371,23599,52,17,26,26
9612,15,509,11,314,192,122,6,28,4,2
4253,15,10526,11,1114,540,574,17,191,10,7
15069,10,163,9,711,87,624,2,30,1,1
22532,10,1353,9,775,102,673,2,30,1,1
19421,26,1454,16,6049,1986,4063,23,19,12,11
22424,10,7692,9,197,102,95,2,30,1,1
8383,10,6316,9,181,94,87,2,30,1,1
19788,26,23029,16,10467,4259,6208,65,56,38,27
4369,10,2032,9,198,93,105,2,30,1,1
8546,10,115,9,198,101,97,2,30,1,1
4457,10,15862,9,257,106,151,2,30,1,1
21912,10,23210,9,186,95,91,2,30,1,1
18829,26,26997,16,1320,685,635,14,181,7,7
21912,10,20483,9,193,102,91,2,30,1,1
15320,2904,9692,2254,1556,588,968,11,16,6,5
22577,10,8535,9,762,101,661,2,30,1,1
9256,10,15246,9,199,102,97,2,31,1,1
15409,10,10269,9,178,94,84,2,29,1,1
11878,26,14320,16,9294,2728,6566,43,113,22,21
9762,26,22079,16,4351,1444,2907,19,28,11,8
9807,26,2741,16,7136,1421,5715,18,15,8,10
8714,26,28176,16,8912,2297,6615,43,255,20,23
10648,26,19624,16,6777,3431,3346,27,15,14,13
5190,26,16740,16,15584,2721,12863,44,103,21,23
12171,26,2872,16,604924,37384,567540,846,154,315,531
18048,15,6548,11,1052,612,440,10,15,5,5
10280,26,23222,16,21686,7655,14031,77,379,40,37
14410,10,26439,9,229,102,127,2,29,1,1
7900,26,19070,16,70,70,0,1,5,1,0
22671,10,18813,9,179,94,85,2,30,1,1
22443,10,13346,9,184,102,82,2,30,1,1
11992,26,11500,16,983,496,487,9,16,5,4
5813,26,13615,16,7399,3328,4071,76,4153,33,43
10585,26,14269,16,262,70,192,5,21,2,3
636,1750,231,1336,475,150,325,2,1200,1,1
9537,346,21946,220,378,180,198,7,31,4,3
4727,26,18137,16,6898,5202,1696,25,25,15,10
21709,10,26180,9,183,94,89,2,31,1,1
14918,10,10389,9,172,88,84,2,30,1,1
15217,15,1615,11,234,234,0,4,12,4,0
1173,26,16234,16,6575,1263,5312,22,315,12,10
17430,10,11784,9,260,86,174,2,30,1,1
10904,26,10295,16,1852,1103,749,16,31,9,7
8354,153,17461,108,70,70,0,2,7,2,0
2744,1248,9698,928,895,126,769,2,30,1,1
20534,26,28545,16,304,86,218,2,30,1,1
10996,866,7561,640,66,66,0,1,5,1,0
532,247,0,0,3562,1936,1626,48,194,24,24
4106,10,21664,9,199,94,105,2,30,1,1
11218,26,16319,16,1768,1034,734,16,65,8,8
11310,15,1126,11,7603,1651,5952,24,16,13,11
13883,10,10379,9,259,87,172,4,56,2,2
15465,10,17422,9,210,102,108,2,30,1,1
11868,26,2523,16,925322,25097,900225,971,113,287,684
6999,148,25785,105,502,150,352,2,1200,1,1
8866,15,19488,11,71320,1026,70294,64,52,12,52
13910,10,1380,9,199,102,97,2,30,1,1
16415,26,8101,16,2791,1800,991,26,185,15,11
15723,10,262,9,711,87,624,2,30,1,1
17134,26,18206,16,7880,5105,2775,25,17,13,12
18447,26,6045,16,130,70,60,2,15,1,1
8142,10,25347,9,164,78,86,2,30,1,1
9440,10,14589,9,178,94,84,2,29,1,1
9335,26,23119,16,6348,1071,5277,18,42,10,8
21414,10,19203,9,184,94,90,2,31,1,1
3459,15,16281,11,1658,1344,314,10,14,5,5
3995,26,15126,16,134405,6968,127437,187,97,85,102
3836,232,21112,147,10109,3480,6629,72,615,38,34
15069,10,8611,9,165,86,79,2,31,1,1
8574,26,14744,16,7967,2176,5791,27,125,14,13
8719,26,29132,16,6074,865,5209,16,15,9,7
9509,15,21671,11,300,180,120,6,29,4,2
202,295,473,190,5850,4395,1455,18,15,10,8
15615,10,8265,9,194,99,95,2,31,1,1
4393,10,0,0,139,70,69,2,30,1,1
7484,26,10861,16,1340,760,580,14,39,8,6
11234,1810,20305,1380,136,136,0,3,13,3,0
9821,15,13852,11,3664,1440,2224,12,20,6,6
17046,26,24079,16,5107,700,4407,15,15,7,8
5622,26,28872,16,284,164,120,4,15,2,2
13770,10,4898,9,994,86,908,2,29,1,1
8939,15,13316,11,70,70,0,1,5,1,0
18430,10,9307,9,233,110,123,2,30,1,1
8383,10,25102,9,274,94,180,2,30,1,1
8840,26,7987,16,5917,1570,4347,20,53,10,10
10809,2526,8296,1962,70,70,0,1,5,1,0
14219,10,25992,9,190,97,93,2,31,1,1
8667,26,15235,16,13077,4380,8697,34,1881,17,17
10192,26,9664,16,7343,2672,4671,20,76,12,8
15590,10,6675,9,177,94,83,2,30,1,1
14918,10,15865,9,198,93,105,2,30,1,1
9511,10,9627,9,198,102,96,2,30,1,1
7521,18,8837,13,184,94,90,2,30,1,1
14322,10,5179,9,167,86,81,2,30,1,1
9269,26,5895,16,60978,3794,57184,73,137,26,47
13246,26,6412,16,3170,1036,2134,13,135,6,7
11152,15,12963,11,4137,1236,2901,27,418,14,13
15145,10,5294,9,183,94,89,2,30,1,1
15681,26,12159,16,8997,1155,7842,19,76,11,8
15452,10,8947,9,168,86,82,2,31,1,1
14014,10,21245,9,789,110,679,2,31,1,1
8584,1241,18521,921,274,78,196,2,31,1,1
8797,10,13273,9,196,100,96,2,31,1,1
4867,15,16380,11,2180,1555,625,9,86,6,3
9100,10,11978,9,211,102,109,2,31,1,1
13195,26,21574,16,1648,813,835,17,186,9,8
14567,10,5934,9,212,102,110,2,30,1,1
4954,26,28925,16,4580,1210,3370,17,28,10,7
8439,10,22722,9,266,94,172,2,30,1,1
1093,10,3717,9,237,91,146,2,33,1,1
22372,10,1419,9,211,102,109,2,30,1,1
14430,10,24609,9,257,106,151,2,30,1,1
9674,15,7593,11,3561,1337,2224,13,20,7,6
6434,26,15827,16,4514,1928,2586,17,241,8,9
21755,10,18511,9,230,102,128,2,31,1,1
18373,26,5607,16,5445,1072,4373,24,80,11,13
14531,10,4945,9,747,92,655,2,31,1,1
10464,26,19022,16,334,70,264,5,17,1,4
16874,26,25924,16,4672,1765,2907,19,29,11,8
11088,363,7983,233,70,70,0,2,9,2,0
12424,2449,17821,1902,70,70,0,2,8,2,0
4674,26,9096,16,499,425,74,4,0,3,1
7423,26,12814,16,70,70,0,2,4,2,0
14344,1836,17113,1397,320,140,180,6,6,3,3
204,295,475,190,3054,1599,1455,16,15,8,8
636,945,8687,697,509,150,359,2,1200,1,1
7602,15,25692,11,3589,2432,1157,17,86,9,8
15987,10,1404,9,733,94,639,2,30,1,1
15237,26,4104,16,318,192,126,6,15,4,2
11133,303,26679,197,70,70,0,1,5,1,0
9070,26,14807,16,159116,5586,153530,191,47,77,114
6279,26,14400,16,1622,1137,485,11,26,7,4
9611,15,13590,11,197269,14917,182352,254,204,107,147
2863,2002,18978,1532,143,81,62,2,31,1,1
9846,15,24186,11,55224,28254,26970,230,174,114,116
12712,10,18825,9,70,70,0,1,30,1,0
19207,10,27203,9,261,106,155,2,29,1,1
13802,10,11905,9,256,87,169,4,36,2,2
22447,10,18811,9,733,94,639,2,30,1,1
10403,26,13262,16,2359,1283,1076,17,17,9,8
16346,329,25613,210,138,78,60,2,6,1,1
636,280,27742,177,502,150,352,2,1200,1,1
8666,10,13349,9,248,118,130,2,29,1,1
15230,10,15237,9,210,110,100,2,30,1,1
15225,10,25703,9,253,102,151,2,30,1,1
19743,26,27522,16,4533,1626,2907,19,29,11,8
14522,10,21522,9,198,101,97,2,31,1,1
15360,1402,11005,1065,66,66,0,1,5,1,0
10223,15,3258,11,366,240,126,7,20,5,2
15012,10,6661,9,204,104,100,2,30,1,1
12328,26,6497,16,7692,2183,5509,24,224,14,10
8723,26,25184,16,38022,18448,19574,53,57,27,26
9547,15,3264,11,4332,3596,736,14,32,8,6
9038,10,16015,9,173,94,79,2,30,1,1
3573,15,13605,11,1376,788,588,10,35,6,4
10586,26,7905,16,262,70,192,5,21,2,3
4192,23,0,0,18741,9242,9499,96,31,48,48
8329,10,12129,9,183,94,89,2,30,1,1
15249,26,18362,16,7889,1900,5989,20,15,11,9
21280,10,22990,9,183,94,89,2,29,1,1
8712,10,11912,9,212,110,102,2,30,1,1
7752,26,5711,16,8756,2298,6458,39,314,18,21
15121,10,19431,9,183,86,97,2,31,1,1
8928,10,2300,9,196,102,94,2,29,1,1
13903,15,25512,11,3564,1625,1939,12,131,6,6
12463,512,4395,337,320,140,180,6,6,3,3
12396,3071,151,2386,492,306,186,8,15,5,3
16127,1392,4608,1059,1806,1806,0,22,225,22,0
12155,26,12501,16,30264,2794,27470,47,322,19,28
8646,15,29064,11,6811,3791,3020,23,115,13,10
4301,26,17232,16,466,392,74,4,0,3,1
15691,10,19685,9,755,93,662,2,31,1,1
13679,10,5877,9,183,94,89,2,31,1,1
22646,10,12487,9,564,108,456,4,50,2,2
15795,26,22133,16,7549,2807,4742,42,78,22,20
21743,10,16778,9,385,134,251,2,30,1,1
16870,26,10292,16,9429,3621,5808,60,80,26,34
17749,26,10423,16,162,102,60,2,5,1,1
4302,234,10382,149,17762,4403,13359,92,616,47,45
4607,26,18862,16,5674,3900,1774,29,80,15,14
13179,26,14463,16,11527127,373718,11153409,12286,144,4090,8196
15246,26,27702,16,8300,3581,4719,25,19,15,10
19312,26,10507,16,652760,608740,44020,734,432,496,238
11071,2451,26456,1904,70,70,0,1,5,1,0
6900,10,19252,9,211,80,131,2,30,1,1
14269,3119,12688,2421,70,70,0,1,5,1,0
15698,10,17698,9,443,182,261,6,30,3,3
10286,26,8013,16,2132473,55149,2077324,2144,63,731,1413
14625,10,23454,9,198,101,97,2,31,1,1
11001,10,22738,9,240,98,142,2,30,1,1
2172,3184,14452,2470,150,150,0,1,1199,1,0
21321,313,14289,204,70,70,0,1,4,1,0
2072,10,8173,9,216,82,134,2,32,1,1
15327,10,25175,9,182,93,89,2,30,1,1
22275,15,28943,11,342198,13793,328405,355,23,126,229
913,26,13024,16,5658,501,5157,14,15,7,7
22525,10,260,9,226,86,140,2,29,1,1
18872,15,27024,11,5973,779,5194,17,16,9,8
11059,2668,20678,2075,70,70,0,2,7,2,0
9065,10,16815,9,193,102,91,2,29,1,1
20564,26,7795,16,382,164,218,2,30,1,1
5693,26,13286,16,9807,2542,7265,47,19,24,23
17745,26,571,16,10310,2469,7841,35,255,18,17
8616,10,11625,9,227,94,133,2,29,1,1
14893,10,24275,9,760,97,663,2,31,1,1
8788,26,18831,16,15336,2803,12533,47,202,24,23
14767,10,3236,9,194,102,92,2,30,1,1
5772,26,14162,16,3289,1265,2024,13,32,7,6
8083,26,20237,16,42932,2883,40049,63,14,31,32
19787,26,8610,16,10530,2001,8529,29,47,14,15
14094,26,14622,16,130,70,60,3,5,2,1
15543,26,24399,16,16378,3002,13376,35,17,17,18
21293,10,7728,9,184,94,90,2,31,1,1
20673,26,11206,16,4496,2346,2150,28,124,15,13
14693,26,24747,16,5493,2246,3247,22,39,13,9
14442,10,5703,9,196,102,94,2,29,1,1
13784,10,24265,9,220,90,130,2,29,1,1
22230,10,15809,9,195,102,93,2,30,1,1
8441,10,20103,9,194,99,95,2,31,1,1
15732,10,28568,9,200,102,98,2,31,1,1
10958,26,16006,16,18581,9681,8900,62,103,33,29
15190,15,3623,11,234,234,0,4,11,4,0
20000,26,13112,16,73341,3336,70005,85,48,27,58
1067,26,2716,16,6094,771,5323,17,25,9,8
18542,26,6634,16,6511,2810,3701,34,3665,12,22
5309,15,24421,11,190,70,120,4,16,2,2
6112,26,18118,16,4350,1443,2907,19,26,11,8
15295,10,8313,9,177,94,83,2,30,1,1
21682,10,9807,9,211,102,109,2,30,1,1
9636,15,25139,11,318,192,126,6,25,4,2
22333,10,16523,9,194,102,92,2,30,1,1
8347,26,7276,16,888019,22655,865364,902,18,322,580
6966,15,1130,11,3162,1159,2003,14,16,8,6
13868,26,16466,16,5312,1510,3802,18,45,11,7
21913,10,11914,9,811,94,717,2,30,1,1
18968,26,9471,16,166465,9498,156967,220,72,100,120
4878,26,17479,16,9037,1851,7186,26,180,14,12
7092,676,23775,475,130,70,60,2,6,1,1
22313,10,13869,9,266,110,156,2,30,1,1
10736,3024,4987,2352,66,66,0,1,5,1,0
15586,10,83,9,178,94,84,2,30,1,1
6458,26,554,16,14451,3012,11439,33,32,18,15
10552,26,28017,16,6559,2158,4401,30,17,16,14
17945,26,28098,16,15252,5376,9876,35,154,16,19
8059,26,23277,16,416,210,206,7,96,4,3
5946,10,17891,9,220,90,130,2,30,1,1
12661,26,6995,16,7980,1434,6546,24,19,13,11
14425,10,22251,9,760,97,663,2,30,1,1
3591,26,7792,16,25302,10587,14715,88,123,37,51
8610,10,9306,9,212,102,110,2,30,1,1
14494,10,3906,9,184,94,90,2,29,1,1
21808,26,12537,16,9156,2109,7047,27,32,15,12
8887,15,17953,11,340,140,200,6,15,3,3
9160,26,28023,16,19523,5346,14177,37,87,17,20
5245,26,6351,16,7082,4527,2555,31,31,16,15
13707,26,7076,16,6906,1283,5623,29,248,14,15
6925,26,19297,16,5480,2503,2977,20,15,11,9
3469,26,7721,16,194174,11657,182517,258,31,124,134
13795,10,11539,9,184,94,90,2,31,1,1
8344,10,17264,9,184,94,90,2,31,1,1
923,26,9774,16,6331,837,5494,19,28,10,9
6031,676,3901,475,130,70,60,2,5,1,1
6112,10,0,0,86,86,0,1,30,1,0
21748,10,300,9,209,102,107,2,30,1,1
21721,10,4516,9,183,94,89,2,30,1,1
11462,26,1937,16,1625,1038,587,14,28,8,6
8691,26,12409,16,14786,2845,11941,32,121,17,15
14752,10,28169,9,190,97,93,2,30,1,1
15841,10,953,9,212,108,104,2,31,1,1
18469,15,6702,11,1370,704,666,23,105,12,11
22710,10,23201,9,167,86,81,2,30,1,1
9566,26,5594,16,1389,868,521,12,25,6,6
21331,10,1146,9,233,94,139,2,30,1,1
14977,10,18355,9,183,94,89,2,30,1,1
9577,15,10317,11,318,192,126,6,26,4,2
13492,26,18554,16,19635,9923,9712,165,588,72,93
15002,26,21492,16,6294,1494,4800,22,17,11,11
16021,2775,28971,2154,330,330,0,6,1200,6,0
4835,3154,46,2444,489,149,340,2,1200,1,1
14321,2274,6065,1761,70,70,0,2,8,2,0
15973,10,2921,9,199,102,97,2,30,1,1
14978,10,12605,9,174,89,85,2,31,1,1
15839,10,5768,9,199,102,97,2,30,1,1
18347,26,2668,16,46713,2661,44052,55,120,21,34
14714,10,5979,9,199,102,97,2,33,1,1
21921,10,26023,9,361,107,254,4,37,2,2
21019,2436,8256,1895,70,70,0,1,4,1,0
14676,15,12094,11,5055,3100,1955,34,17,28,6
6119,26,9700,16,6516,1722,4794,26,17,15,11
22620,15,26072,11,366,180,186,7,29,4,3
7399,26,4173,16,19149,2846,16303,41,25,20,21
6425,10,6226,9,168,78,90,2,30,1,1
9114,26,24933,16,6770,2219,4551,21,89,11,10
21320,1010,6489,744,816,508,308,12,27,7,5
18401,295,26757,190,2163,676,1487,14,16,7,7
14248,10,14255,9,172,88,84,2,31,1,1
11280,26,22863,16,162355,8745,153610,178,22,66,112
13747,10,28302,9,194,102,92,2,29,1,1
14473,26,12343,16,3387,1672,1715,24,270,11,13
10473,26,4668,16,8933,1958,6975,25,81,14,11
7684,40,24705,23,45153,20621,24532,323,43,165,158
8774,10,4027,9,170,87,83,2,31,1,1
12100,15,4197,11,194,128,66,4,51,3,1
10744,18,21703,13,184,94,90,2,30,1,1
11238,2407,8335,1872,70,70,0,2,9,2,0
10896,1075,12211,788,70,70,0,1,5,1,0
9055,26,8399,16,1820,1101,719,18,73,10,8
15523,26,17768,16,5601,1203,4398,14,60,9,5
8867,10,23150,9,488,110,378,4,32,2,2
9265,10,21819,9,216,89,127,2,30,1,1
21916,10,20607,9,763,102,661,2,30,1,1
15253,10,27245,9,760,97,663,2,30,1,1
6142,26,11376,16,8385,3143,5242,35,98,18,17
12685,26,18343,16,499,425,74,4,0,3,1
19028,10,7310,9,525,150,375,6,33,3,3
14136,10,2431,9,216,110,106,2,29,1,1
15979,10,8388,9,774,101,673,2,30,1,1
4145,26,783,16,3120,1862,1258,18,15,11,7
17177,26,7469,16,2577,1550,1027,15,15,7,8
17927,26,9205,16,23244,13793,9451,50,29,26,24
13681,10,19491,9,177,94,83,2,29,1,1
22444,10,5560,9,767,102,665,2,30,1,1
10837,26,22663,16,1466,856,610,13,27,6,7
10885,1063,27626,782,70,70,0,2,7,2,0
21510,10,2298,9,181,94,87,2,33,1,1
11074,253,10902,158,70,70,0,1,5,1,0
13836,10,25314,9,311,94,217,2,30,1,1
22234,10,8317,9,199,102,97,2,30,1,1
18049,15,4699,11,1197,419,778,9,16,5,4
8584,1238,16580,918,249,78,171,2,30,1,1
4835,1725,13722,1317,820,152,668,4,1199,2,2
2744,1567,12139,1198,877,126,751,2,31,1,1
17664,10,10066,9,316,86,230,2,29,1,1
22210,10,8407,9,515,86,429,4,45,2,2
21045,1204,19039,891,66,66,0,2,7,2,0
14950,10,22105,9,168,86,82,2,29,1,1
2744,1240,12579,920,917,126,791,2,30,1,1
15218,10,8751,9,195,102,93,2,31,1,1
10754,1177,23977,868,70,70,0,2,8,2,0
18260,26,5663,16,3667,2243,1424,22,80,11,11
11148,1669,14165,1277,70,70,0,2,7,2,0
8563,10,12116,9,365,94,271,2,30,1,1
11715,26,16265,16,16022,3217,12805,25,138,11,14
7246,26,19766,16,5523,2276,3247,22,28,13,9
22167,10,1166,9,210,110,100,2,29,1,1
12598,3207,516,2487,2016,1076,940,14,17,8,6
15686,10,25791,9,198,94,104,2,30,1,1
14909,10,24023,9,170,87,83,2,30,1,1
15939,10,3493,9,184,94,90,2,31,1,1
9091,10,10662,9,763,102,661,2,30,1,1
6327,26,21171,16,123082,8734,114348,200,84,101,99
18180,26,26646,16,4700,1793,2907,19,28,11,8
3066,2625,19208,2035,502,150,352,2,1200,1,1
21039,2394,12403,1861,70,70,0,1,5,1,0
15559,10,22050,9,259,87,172,4,37,2,2
3922,26,15022,16,5537,2290,3247,22,39,13,9
22306,10,28248,9,199,102,97,2,30,1,1
11128,1411,28873,1073,70,70,0,1,5,1,0
4690,26,7192,16,499,425,74,4,0,3,1
14259,10,18519,9,422,96,326,4,42,2,2
2744,2497,6949,1943,887,126,761,2,31,1,1
8300,26,19083,16,6725,505,6220,20,181,5,15
14982,10,24900,9,244,98,146,2,32,1,1
8581,10,6770,9,194,102,92,2,30,1,1
13924,10,7699,9,258,110,148,2,30,1,1
13825,10,14851,9,182,93,89,2,31,1,1
14874,10,9212,9,351,110,241,2,29,1,1
12562,26,22794,16,327838,13327,314511,355,127,121,234
20555,26,17864,16,303,85,218,2,30,1,1
8584,1238,21661,918,248,78,170,2,30,1,1
22067,10,12391,9,167,86,81,2,30,1,1
13988,10,5075,9,185,102,83,2,29,1,1
8327,1671,14543,1279,1377,300,1077,6,1200,3,3
8515,15,25904,11,2695,601,2094,14,17,7,7
14115,10,9490,9,184,94,90,2,30,1,1
3680,26,14366,16,67835,6280,61555,96,108,45,51
4434,26,1119,16,9311,1387,7924,20,31,10,10
22330,10,23260,9,243,102,141,2,30,1,1
21289,10,12104,9,288,94,194,2,29,1,1
9100,10,14588,9,318,110,208,4,50,2,2
19322,26,28576,16,7288,1763,5525,22,77,12,10
22544,10,21628,9,228,110,118,2,30,1,1
14681,10,11650,9,186,102,84,2,29,1,1
15208,10,7410,9,194,99,95,2,31,1,1
5691,107,17470,83,156,156,0,3,8,3,0
21528,10,19741,9,334,103,231,4,54,2,2
15090,10,23006,9,889,404,485,10,31,5,5
18111,26,25980,16,8127,1796,6331,21,79,12,9
13825,10,13152,9,178,94,84,2,30,1,1
11894,26,3888,16,7093,2235,4858,39,111,20,19
4705,26,4155,16,7766,1810,5956,24,46,14,10
14676,10,25815,9,311,94,217,2,30,1,1
19282,15,10032,11,17583,1529,16054,30,255,16,14
21280,10,1449,9,183,94,89,2,30,1,1
795,10,27442,9,239209,233954,5255,2850,88,2822,28
9789,10,26397,9,177,94,83,2,30,1,1
15000,10,3200,9,177,94,83,2,30,1,1
1399,10,4820,9,194,87,107,2,30,1,1
17456,15,26251,11,1990,833,1157,10,21,6,4
21545,10,3474,9,280,91,189,4,33,2,2
10196,26,22315,16,32010,3207,28803,52,128,20,32
8488,10,24621,9,184,94,90,2,31,1,1
21504,10,10291,9,244,94,150,2,30,1,1
8508,10,17961,9,199,102,97,2,30,1,1
943,26,9687,16,5043,432,4611,12,15,6,6
14109,10,2143,9,186,102,84,2,30,1,1
13583,188,10567,123,312,140,172,4,31,2,2
9760,10,19552,9,177,94,83,2,30,1,1
22651,10,7308,9,102,102,0,1,30,1,0
14816,10,22068,9,278,102,176,2,30,1,1
8874,10,6977,9,178,94,84,2,30,1,1
22106,10,13180,9,232,102,130,2,30,1,1
9651,26,24306,16,7171,1729,5442,24,78,13,11
8788,10,20485,9,185,102,83,2,30,1,1
20601,26,20403,16,7127,1737,5390,18,16,10,8
15230,10,8936,9,209,110,99,2,30,1,1
9008,26,18200,16,6117,976,5141,21,72,10,11
9363,10,13595,9,774,102,672,2,30,1,1
4862,26,24270,16,884,464,420,13,28,7,6
20009,15,21938,11,1892,583,1309,12,16,6,6
14349,10,25427,9,170,87,83,2,31,1,1
10450,26,4189,16,8388,760,7628,20,145,6,14
15823,10,4274,9,753,96,657,2,31,1,1
3133,2315,27884,1799,330,330,0,6,3609,6,0
11856,26,21392,16,9629,2119,7510,42,114,20,22
4422,10,15817,9,227,90,137,2,29,1,1
8280,10,21281,9,172,76,96,2,30,1,1
8867,10,17087,9,197,102,95,2,31,1,1
8391,10,7089,9,185,102,83,2,30,1,1
5890,26,19918,16,6035,782,5253,16,109,8,8
10047,10,28156,9,168,78,90,2,30,1,1
15109,10,17042,9,193,102,91,2,30,1,1
827,18,20205,13,94,94,0,1,30,1,0
13652,10,22363,9,195,102,93,2,30,1,1
12136,26,18494,16,7461,1789,5672,25,69,14,11
14977,10,21152,9,338,110,228,2,30,1,1
15467,10,23922,9,178,94,84,2,29,1,1
15393,2268,21747,1755,70,70,0,1,5,1,0
7492,26,25247,16,13942,8293,5649,59,172,31,28
4835,639,17057,444,150,150,0,1,1199,1,0
6914,10,9263,9,306,212,94,3,29,2,1
8982,10,12324,9,401,91,310,4,29,2,2
8947,26,18684,16,7877,1949,5928,24,126,12,12
8191,26,15392,16,2098,1239,859,22,20,12,10
22249,10,14243,9,178,94,84,2,30,1,1
18342,26,25114,16,13199834,344312,12855522,13125,121,3739,9386
18888,26,27028,16,4918,1626,3292,17,17,10,7
22200,10,6079,9,756,95,661,2,31,1,1
8625,26,18602,16,2572,330,2242,12,135,5,7
11726,26,544,16,6876,3332,3544,22,140,11,11
11035,15,3721,11,46046,2705,43341,60,15,29,31
22637,10,788,9,184,102,82,2,30,1,1
12644,26,23461,16,499,425,74,4,0,3,1
16114,26,1151,16,4049,1992,2057,23,96,13,10
5071,26,12103,16,4393,1151,3242,22,165,13,9
13437,26,20226,16,9498,2578,6920,28,19,16,12
11136,2095,14212,1615,66,66,0,1,5,1,0
10833,1693,5204,1295,70,70,0,2,8,2,0
12423,3025,27420,2353,70,70,0,1,5,1,0
13689,26,22877,16,13310,3162,10148,31,46,16,15
8587,26,24055,16,5422,801,4621,21,173,9,12
22074,10,0,0,220,81,139,2,30,1,1
6354,26,16504,16,153,93,60,2,5,1,1
9411,153,25673,108,320,320,0,6,1200,6,0
3439,26,6194,16,1348,687,661,14,42,8,6
9745,26,23670,16,5035,3194,1841,23,72,12,11
8942,10,21650,9,256,114,142,2,30,1,1
9844,15,5738,11,648,256,392,8,27,5,3
22108,10,27355,9,199,102,97,2,30,1,1
21712,10,27700,9,184,94,90,2,29,1,1
22133,10,20109,9,238,102,136,2,31,1,1
10846,1337,14139,1012,70,70,0,2,8,2,0
4016,26,19810,16,87183,4177,83006,104,126,34,70
22688,26,12796,16,410116,12150,397966,421,16,148,273
14091,10,28514,9,168,86,82,2,32,1,1
15362,10,5479,9,209,110,99,2,30,1,1
11912,26,9704,16,31660,3248,28412,58,93,23,35
8422,295,21400,190,2163,676,1487,14,14,7,7
18758,26,16608,16,2042,559,1483,20,89,6,14
15056,10,5977,9,200,102,98,2,30,1,1
5838,26,28087,16,175097,9838,165259,244,106,120,124
8541,10,18547,9,197,94,103,2,30,1,1
22448,10,16212,9,353,98,255,4,32,2,2
15439,10,2034,9,200,102,98,2,30,1,1
10836,2527,18371,1963,66,66,0,1,5,1,0
9790,26,15195,16,6789,1020,5769,20,101,11,9
4987,26,16521,16,1452,817,635,16,20,9,7
21639,10,9458,9,225,110,115,2,30,1,1
10745,1421,4657,1080,414,136,278,6,16,3,3
10327,2411,5898,1876,323,150,173,2,1203,1,1
15430,10,15978,9,775,103,672,2,31,1,1
14193,10,24477,9,215,88,127,2,30,1,1
22690,10,77,9,226,94,132,2,29,1,1
11918,15,24521,11,1658,1344,314,10,15,5,5
22101,10,17394,9,767,102,665,2,30,1,1
21568,10,12151,9,209,110,99,2,29,1,1
14828,10,3747,9,179,86,93,2,29,1,1
14114,26,6733,16,23029908,732047,22297861,24550,183,8143,16407
21968,10,25188,9,210,102,108,2,30,1,1
17855,10,3776,9,571,166,405,2,29,1,1
636,608,21825,419,228,118,110,2,1199,1,1
9573,15,13648,11,318,192,126,6,26,4,2
18778,1989,28405,1519,316,136,180,6,6,3,3
14923,26,28227,16,8325,1483,6842,24,47,13,11
9613,26,10309,16,3049,1569,1480,17,19,10,7
8693,26,18672,16,5968,985,4983,17,26,8,9
2684,26,8039,16,11513,2842,8671,31,18,15,16
16454,15,27086,11,318,192,126,6,21,4,2
22495,10,16022,9,177,94,83,2,30,1,1
4835,770,19875,557,448,246,202,4,1199,2,2
18956,26,2012,16,75122,4244,70878,101,45,48,53
12130,26,19575,16,1950,1176,774,18,103,11,7
9033,15,15615,11,43386,3876,39510,79,22,42,37
8358,2614,10150,2026,504,318,186,8,15,5,3
11680,26,26201,16,1547,960,587,14,26,8,6
8927,10,13417,9,183,94,89,2,30,1,1
12011,26,238,16,10893,7149,3744,31,45,18,13
1731,2860,16263,2219,481,150,331,2,1200,1,1
17553,15,26319,11,107768,4073,103695,177,15,58,119
12601,2777,28265,2155,618,432,186,9,16,6,3
16924,26,13154,16,3182,1568,1614,8,121,4,4
10865,1439,1602,1093,70,70,0,2,7,2,0
5893,15,24386,11,79441,3092,76349,103,16,48,55
14343,26,24558,16,4575,1668,2907,19,30,11,8
8393,10,23512,9,765,102,663,2,30,1,1
15502,10,20684,9,177,94,83,2,30,1,1
13869,26,11201,16,12583,2945,9638,31,47,16,15
15924,10,22782,9,177,94,83,2,30,1,1
13830,10,28636,9,182,93,89,2,31,1,1
9129,10,8726,9,285,110,175,2,30,1,1
16213,26,17969,16,9493,2266,7227,24,14,13,11
21887,10,27237,9,278,94,184,2,30,1,1
13865,10,20733,9,91,91,0,1,30,1,0
2744,2664,4239,2071,901,126,775,2,31,1,1
726,26,2908,16,5640,2394,3246,25,82,13,12
478,10,11350,9,222,86,136,2,30,1,1
3521,26,23293,16,5947,1579,4368,22,315,12,10
14904,26,7738,16,4704,2423,2281,16,135,8,8
3,2605,2,2021,109,109,0,1,5,1,0
17429,26,14345,16,280,140,140,5,130,3,2
19399,15,27303,11,17105,750,16355,21,15,7,14
6594,10,22221,9,168,78,90,2,31,1,1
8743,10,23973,9,384,94,290,2,30,1,1
8798,10,13201,9,288,94,194,2,30,1,1
8865,10,11986,9,209,110,99,2,31,1,1
21816,10,22377,9,183,94,89,2,29,1,1
21548,10,1330,9,302,98,204,4,47,2,2
13921,10,27934,9,177,94,83,2,30,1,1
8531,10,27917,9,180,92,88,2,31,1,1
10548,26,5602,16,134,60,74,3,4,2,1
21456,10,7167,9,264,110,154,2,30,1,1
6116,10,0,0,86,86,0,1,29,1,0
8966,26,8099,16,44380,1589,42791,48,126,14,34
11128,15,18418,11,1955,913,1042,10,15,6,4
22642,10,19829,9,178,94,84,2,30,1,1
14269,10,19591,9,184,94,90,2,31,1,1
8210,2627,21194,2037,479,152,327,2,1200,1,1
7459,26,22457,16,1053,566,487,10,16,6,4
14195,10,15904,9,740,93,647,2,30,1,1
18621,26,18453,16,6483,3687,2796,18,135,9,9
8327,645,16757,449,854,150,704,4,1200,2,2
17252,15,22691,11,3037,2276,761,12,28,7,5
12664,2085,2540,1607,70,70,0,1,4,1,0
15635,10,14534,9,272,110,162,2,29,1,1
15408,1388,1094,1055,5436,3022,2414,17,32,11,6
9147,10,25548,9,211,110,101,2,30,1,1
8125,15,22731,11,812,672,140,6,28,4,2
19322,15,11380,11,214,140,74,4,41,3,1
22642,10,3697,9,178,94,84,2,30,1,1
22146,10,22895,9,197,102,95,2,33,1,1
22463,10,16345,9,821,102,719,2,30,1,1
636,280,2954,177,501,150,351,2,1200,1,1
9813,26,16054,16,12463,2350,10113,46,20,19,27
13894,26,15750,16,30281,3919,26362,44,62,21,23
10325,233,4323,148,11005,5789,5216,34,23,18,16
15371,26,26769,16,8074,2054,6020,20,15,11,9
8922,10,9824,9,264,89,175,4,47,2,2
12574,26,9326,16,499,425,74,4,0,3,1
3348,10,0,0,86,86,0,1,30,1,0
12241,15,23398,11,81339,4340,76999,84,57,22,62
8821,15,7826,11,1056,682,374,10,15,6,4
17724,26,17169,16,289380,13628,275752,335,70,142,193
9277,10,18849,9,152,78,74,2,31,1,1
15466,10,24841,9,177,94,83,2,30,1,1
12917,15,28419,11,214,140,74,4,15,3,1
15992,10,240,9,183,94,89,2,30,1,1
12397,405,18629,263,70,70,0,1,4,1,0
13978,10,10701,9,324,110,214,2,29,1,1
8383,3191,11320,2475,70,70,0,1,5,1,0
21877,10,20023,9,257,126,131,2,30,1,1
22053,10,26858,9,200,102,98,2,31,1,1
21230,10,5353,9,200,102,98,2,31,1,1
12147,26,18330,16,31919,3528,28391,49,323,19,30
11165,2369,21029,1843,70,70,0,2,8,2,0
22458,10,16450,9,184,94,90,2,30,1,1
14343,10,23486,9,168,86,82,2,30,1,1
15109,26,5979,16,198167,11702,186465,220,105,84,136
10077,15,23644,11,6920116,91852,6828264,6765,79,1277,5488
12472,2584,8653,2005,70,70,0,2,7,2,0
15449,10,14454,9,167,86,81,2,30,1,1
9141,10,16499,9,209,110,99,2,30,1,1
11037,26,728,16,10217,8266,1951,33,39,20,13
10995,15,4492,11,306,120,186,6,25,3,3
14998,10,3211,9,198,101,97,2,30,1,1
8674,10,27272,9,370,102,268,2,30,1,1
15050,15,8360,11,45108,2309,42799,60,134,28,32
9728,10,9805,9,744,89,655,2,31,1,1
9823,15,13435,11,62,62,0,1,4,1,0
21356,26,19182,16,7280,2277,5003,19,136,9,10
6878,26,11753,16,3067,1817,1250,18,16,8,10
9253,10,23741,9,146,75,71,2,31,1,1
2710,26,15131,16,20979,15982,4997,38,36,22,16
10567,26,8318,16,590874,19818,571056,669,42,271,398
9471,26,2826,16,7819,2474,5345,25,82,13,12
13774,10,20435,9,177,94,83,2,30,1,1
15148,10,28292,9,177,94,83,2,31,1,1
9728,10,7959,9,738,86,652,2,30,1,1
11019,15,3579,11,1344,899,445,8,15,6,2
7898,23,0,0,6387,2535,3852,22,30,11,11
8266,676,979,475,130,70,60,2,5,1,1
2074,10,8187,9,371,237,134,3,33,2,1
15622,10,28365,9,783,96,687,2,30,1,1
15821,10,3860,9,214,102,112,2,30,1,1
15404,10,26260,9,199,102,97,2,30,1,1
16021,284,174,181,616,414,202,5,1200,3,2
7223,10,19734,9,86,86,0,1,30,1,0
12727,280,13379,177,552,306,246,9,15,5,4
11294,2159,16492,1667,70,70,0,2,7,2,0
17659,26,28890,16,5058,2667,2391,25,92,13,12
22719,10,8666,9,167,86,81,2,29,1,1
19050,26,8189,16,4970,2272,2698,12,121,6,6
22128,26,6370,16,4659604,120303,4539301,4651,74,1586,3065
9040,15,9926,11,24764,4454,20310,30,88,12,18
7601,26,1156,16,8376,2231,6145,25,330,12,13
5144,26,28616,16,10216,3380,6836,26,120,12,14
15492,10,6739,9,193,102,91,2,29,1,1
9342,10,3564,9,734,94,640,2,30,1,1
5445,15,12593,11,2631,1207,1424,14,16,9,5
4373,26,11219,16,16244,2265,13979,35,262,19,16
8445,10,26905,9,200,94,106,2,30,1,1
9132,10,20131,9,285,94,191,2,30,1,1
9048,26,28381,16,5998,978,5020,19,50,10,9
11903,15,27915,11,1991,686,1305,10,335,6,4
14303,10,7393,9,190,97,93,2,0,1,1
22004,10,17269,9,758,93,665,2,31,1,1
7940,15,20286,11,1767,751,1016,10,15,6,4
8680,15,6593,11,1352,832,520,12,38,7,5
12080,26,8812,16,7694,3364,4330,21,123,11,10
12360,1960,17676,1497,70,70,0,1,4,1,0
8694,10,15554,9,177,94,83,2,29,1,1
13425,26,25540,16,7169,2405,4764,18,135,10,8
10728,3079,26568,2392,70,70,0,1,5,1,0
4346,26,15145,16,31814,26657,5157,52,212,32,20
8664,26,23266,16,4172,1018,3154,16,27,8,8
11045,26,22758,16,32358,7474,24884,49,49,23,26
9254,10,25164,9,733,94,639,2,30,1,1
8684,10,17651,9,167,86,81,2,30,1,1
22352,10,23107,9,323,102,221,2,30,1,1
15600,10,14443,9,177,94,83,2,30,1,1
3133,2344,6277,1828,330,330,0,6,3609,6,0
21649,10,1884,9,293,94,199,2,30,1,1
11907,15,25948,11,9956,2570,7386,21,335,10,11
22174,10,4148,9,196,94,102,2,30,1,1
7780,10,8267,9,168,78,90,2,30,1,1
636,280,4203,177,238,118,120,2,1200,1,1
14265,10,25808,9,209,110,99,2,30,1,1
15934,26,1548,16,5553,927,4626,16,15,10,6
15939,26,24052,16,5619,927,4692,17,15,10,7
21658,26,20323,16,5660875,75934,5584941,4719,141,686,4033
17769,26,2141,16,6703,1307,5396,28,18,14,14
14566,10,16659,9,172,88,84,2,30,1,1
21905,10,9063,9,229,110,119,2,30,1,1
13217,26,23923,16,7974,2926,5048,25,17,15,10
15792,10,26959,9,757,102,655,2,29,1,1
22261,10,16975,9,200,94,106,2,30,1,1
532,247,0,0,3562,1936,1626,48,193,24,24
17281,26,3704,16,3730,2378,1352,23,28,12,11
6894,26,15760,16,5960,1651,4309,21,85,12,9
9610,10,7788,9,199,102,97,2,30,1,1
15208,10,18216,9,164,84,80,2,31,1,1
15099,26,17522,16,11375,1770,9605,27,55,15,12
14532,10,20251,9,423,102,321,2,30,1,1
22335,26,20955,16,1765,1126,639,17,125,10,7
15220,26,2096,16,32966,3481,29485,49,80,21,28
12140,26,23348,16,1404,697,707,17,121,8,9
9763,10,18677,9,815,95,720,2,30,1,1
9497,26,6345,16,1775,169,1606,7,121,3,4
21976,10,9778,9,458,188,270,6,31,3,3
13272,26,21758,16,8152,4874,3278,22,138,11,11
14133,10,12371,9,177,94,83,2,30,1,1
14564,10,26415,9,184,94,90,2,30,1,1
11586,26,23060,16,4351,1444,2907,19,28,11,8
7580,15,20261,11,83777,2610,81167,90,155,27,63
13259,26,4063,16,6750,1755,4995,16,103,9,7
4992,26,12780,16,12591,2902,9689,40,55,19,21
2744,1238,7149,918,878,126,752,2,30,1,1
12183,26,24674,16,5600,1187,4413,24,80,13,11
2744,1238,19584,918,892,126,766,2,30,1,1
2864,26,14692,16,7775,3104,4671,18,76,10,8
21777,10,11987,9,367,102,265,2,31,1,1
22185,10,22376,9,493,111,382,4,57,2,2
15644,10,24980,9,190,97,93,2,30,1,1
19779,10,27547,9,216,90,126,2,30,1,1
342,15,217,11,2340,1419,921,10,15,5,5
21354,937,13247,691,66,66,0,2,7,2,0
2878,26,12620,16,6130,1264,4866,18,75,9,9
10780,2789,7491,2164,70,70,0,2,7,2,0
8353,10,21360,9,257,101,156,2,32,1,1
21574,10,14554,9,193,102,91,2,31,1,1
4765,26,17563,16,498507,26210,472297,544,207,200,344
6822,26,23533,16,12098,5328,6770,25,121,12,13
4555,26,6831,16,3296,1636,1660,17,255,9,8
2744,1238,8288,918,882,126,756,2,30,1,1
15497,10,27145,9,216,110,106,2,30,1,1
18473,26,1017,16,3683,1899,1784,20,20,10,10
8644,10,10689,9,172,94,78,2,30,1,1
12222,26,6991,16,21456,6153,15303,120,491,46,74
56,1328,23459,1003,132,70,62,2,30,1,1
21297,10,23246,9,196,102,94,2,30,1,1
8283,233,20165,148,70,70,0,2,5,2,0
14272,10,8509,9,184,94,90,2,30,1,1
12629,2403,16489,1869,70,70,0,1,5,1,0
8763,10,28301,9,168,86,82,2,31,1,1
8595,10,763,9,194,102,92,2,30,1,1
15120,10,7565,9,756,95,661,2,30,1,1
8574,26,18532,16,4189,2286,1903,35,256,17,18
13974,10,7421,9,308,94,214,2,30,1,1
9220,15,3214,11,2425,529,1896,11,75,6,5
9223,26,14160,16,6376,2499,3877,20,16,10,10
3133,2299,21515,1783,330,330,0,6,3609,6,0
4818,26,556,16,466,392,74,4,0,3,1
9439,15,14663,11,134242,13446,120796,154,161,58,96
15515,26,27460,16,494,420,74,4,0,3,1
5175,26,25323,16,6686,1197,5489,23,16,12,11
19447,10,21196,9,275,94,181,2,29,1,1
19615,26,27431,16,4521,1614,2907,19,26,11,8
12119,26,1236,16,6177,1038,5139,22,58,11,11
13698,26,24083,16,5549,2777,2772,24,16,14,10
15537,10,4825,9,774,101,673,2,31,1,1
19246,26,25606,16,1784740,34746,1749994,1769,331,357,1412
9783,15,8535,11,318,192,126,6,25,4,2
13969,10,28686,9,194,102,92,2,31,1,1
6275,26,1217,16,276,70,206,5,26,2,3
21254,10,17037,9,212,102,110,2,29,1,1
7048,15,19480,11,4372,2093,2279,16,19,10,6
9018,26,24130,16,5089,1037,4052,20,61,11,9
16599,15,18599,11,1651,550,1101,13,15,7,6
20958,26,26037,16,17242,3015,14227,19,143,5,14
15104,10,7314,9,168,94,74,2,30,1,1
22175,10,25714,9,453,186,267,6,30,3,3
12074,26,23011,16,4442408,142153,4300255,4731,235,1574,3157
15501,10,25239,9,178,94,84,2,30,1,1
10549,26,308,16,6848,769,6079,17,15,9,8
8722,26,7997,16,198375,6279,192096,205,153,69,136
21084,2563,18010,1990,70,70,0,1,5,1,0
22411,10,20346,9,637,178,459,6,70,3,3
9161,10,18358,9,264,102,162,2,30,1,1
9099,10,25546,9,775,102,673,2,30,1,1
18772,1989,7544,1519,316,136,180,6,7,3,3
9072,26,10686,16,4712,908,3804,18,75,9,9
17066,26,10164,16,6031,770,5261,18,15,8,10
8630,10,206,9,213,102,111,2,30,1,1
8841,10,27814,9,199,102,97,2,29,1,1
9137,10,11400,9,261,94,167,2,30,1,1
15708,10,5526,9,199,102,97,2,29,1,1
13499,183,24106,121,3424,1710,1714,16,31,8,8
17070,26,10099,16,6033,770,5263,18,15,8,10
9529,26,8600,16,11098,2853,8245,25,33,12,13
14501,10,3050,9,168,86,82,2,30,1,1
8686,26,21536,16,88797,5446,83351,137,76,70,67
21656,10,27385,9,196,102,94,2,30,1,1
10101,190,24792,125,409,107,302,4,31,2,2
9110,26,1288,16,8725,3341,5384,25,136,12,13
9028,10,28438,9,193,102,91,2,30,1,1
22279,10,23637,9,411,99,312,4,52,2,2
8946,10,1485,9,183,94,89,2,29,1,1
14358,345,27190,219,70,70,0,1,4,1,0
14328,1231,14212,911,70,70,0,2,8,2,0
14768,26,27456,16,6826,5299,1527,22,330,12,10
14928,10,24875,9,262,106,156,2,32,1,1
9409,26,14279,16,35817,18303,17514,160,138,85,75
8210,1951,21194,1488,1267,631,636,6,1199,3,3
16749,10,22475,9,260,86,174,2,30,1,1
9520,10,20681,9,167,78,89,2,30,1,1
9728,26,21910,16,36457,2308,34149,52,98,23,29
11841,26,14944,16,20789,4927,15862,35,31,20,15
8499,10,11903,9,281,98,183,4,56,2,2
14453,10,14948,9,177,94,83,2,30,1,1
14470,26,3480,16,2883,642,2241,13,135,6,7
15796,10,5903,9,193,102,91,2,31,1,1
22610,10,4024,9,198,101,97,2,31,1,1
16898,26,15721,16,34405,7602,26803,53,35,24,29
15393,10,19103,9,755,94,661,2,30,1,1
13654,10,13113,9,753,93,660,2,31,1,1
4518,15,15956,11,12799,979,11820,20,17,9,11
22383,10,15439,9,199,102,97,2,30,1,1
7829,10,20631,9,174,77,97,2,30,1,1
20302,26,2046,16,9928,5183,4745,34,134,17,17
9273,6,21822,6,184,120,64,4,4,3,1
18312,26,13266,16,3149,1969,1180,19,150,11,8
7870,26,10404,16,502,140,362,8,140,3,5
12013,3023,26161,2351,70,70,0,1,4,1,0
19626,15,2666,11,2058,589,1469,10,45,6,4
2257,10,14643,9,806,458,348,3,29,2,1
9801,15,23847,11,23292,2267,21025,28,21,10,18
22511,10,4508,9,184,94,90,2,30,1,1
4401,15,15790,11,416,198,218,7,121,4,3
18197,26,448,16,11519,3163,8356,51,25,26,25
22382,10,28189,9,184,94,90,2,31,1,1
14758,10,7132,9,178,94,84,2,30,1,1
21967,10,10560,9,165,86,79,2,29,1,1
16859,15,25914,11,348,132,216,6,26,3,3
2048,295,8059,190,4579,2182,2397,16,17,9,7
5039,26,24916,16,1312,651,661,13,185,7,6
17959,26,28132,16,21180,2662,18518,34,17,14,20
7279,15,19824,11,2081,1632,449,10,19,6,4
14041,26,25334,16,2352,1394,958,17,275,9,8
22217,10,13175,9,793,101,692,2,30,1,1
7894,10,11322,9,168,78,90,2,29,1,1
14782,10,848,9,170,87,83,2,30,1,1
8509,26,23731,16,10075,6346,3729,48,84,25,23
18478,26,13780,16,7727,2796,4931,36,104,18,18
14451,10,18313,9,170,87,83,2,30,1,1
15420,26,7338,16,16207,6355,9852,84,195,43,41
18875,26,10110,16,8338,3198,5140,28,46,16,12
15205,26,7384,16,6156,918,5238,18,26,10,8
4771,10,16246,9,194,87,107,2,30,1,1
15763,10,3080,9,199,102,97,2,29,1,1
18582,10,26849,9,248,106,142,2,29,1,1
16662,15,21621,11,1151,711,440,10,15,5,5
15651,10,24513,9,198,102,96,2,30,1,1
10751,1770,24089,1351,70,70,0,1,5,1,0
8793,26,26440,16,20583,3435,17148,54,95,27,27
14285,1854,22793,1414,70,70,0,1,5,1,0
12054,855,19859,630,70,70,0,2,8,2,0
13860,26,4139,16,10048,2128,7920,44,118,24,20
6250,2002,7581,1532,1487,743,744,10,30,5,5
781,2350,28254,1832,130,70,60,2,30,1,1
9977,26,13383,16,10475,1518,8957,24,139,11,13
16281,26,3482,16,117653,21783,95870,251,556,93,158
22483,10,7024,9,756,94,662,2,30,1,1
20084,10,21205,9,296,94,202,2,30,1,1
9753,15,10996,11,4163,2891,1272,17,17,9,8
22658,10,21553,9,195,102,93,2,30,1,1
22171,10,5002,9,209,110,99,2,30,1,1
15252,10,3018,9,200,102,98,2,30,1,1
6250,2958,14358,2295,596,256,340,10,30,5,5
22234,10,7978,9,199,102,97,2,30,1,1
13801,10,9697,9,194,102,92,2,30,1,1
12593,26,2156,16,499,425,74,4,0,3,1
22342,10,24867,9,458,104,354,4,57,2,2
15200,10,4002,9,711,87,624,2,31,1,1
8852,15,23782,11,2611,1811,800,13,15,7,6
11156,2875,6186,2234,70,70,0,2,8,2,0
15559,10,2825,9,259,87,172,4,37,2,2
1477,10,5188,9,239,94,145,2,30,1,1
2950,15,12088,11,602483,18143,584340,627,27,219,408
14239,2961,24029,2298,504,318,186,8,15,5,3
21440,10,3316,9,355,118,237,2,30,1,1
13423,26,11183,16,5493,933,4560,18,41,9,9
15453,10,6542,9,780,93,687,2,31,1,1
7605,15,4037,11,2068,1371,697,13,83,7,6
21397,10,19437,9,212,108,104,2,31,1,1
21974,183,28795,121,3347,1458,1889,15,18,8,7
9892,26,13440,16,70,70,0,2,171,2,0
6920,26,13088,16,13478,2683,10795,36,104,19,17
15136,10,10736,9,900,110,790,2,31,1,1
8686,15,22882,11,2011,975,1036,13,70,7,6
7600,26,20292,16,4401,1494,2907,19,29,11,8
12758,1113,27072,818,1735,975,760,11,16,7,4
15570,15,19820,11,214,140,74,4,35,3,1
3600,26,22765,16,244193,7090,237103,260,136,87,173
9639,15,3927,11,312,192,120,6,25,4,2
4524,10,8744,9,164,78,86,2,30,1,1
12370,1739,25430,1327,70,70,0,2,8,2,0
2077,295,8207,190,3610,2043,1567,16,17,9,7
14656,10,10420,9,168,86,82,2,30,1,1
10271,26,15748,16,6405463,157088,6248375,6383,90,2146,4237
21247,10,4469,9,195,102,93,2,30,1,1
18959,26,25538,16,1439,718,721,15,111,8,7
9043,26,13612,16,6121,1042,5079,21,53,11,10
2046,554,28524,370,478,149,329,2,1200,1,1
2744,1614,25812,1236,879,126,753,3,32,2,1
18007,10,26558,9,194,87,107,2,31,1,1
22356,10,12810,9,177,94,83,2,30,1,1
14523,10,26889,9,177,94,83,2,30,1,1
16895,10,1490,9,312,78,234,2,29,1,1
14173,183,24465,121,3488,1774,1714,17,32,9,8
10857,2464,16146,1915,164,70,94,2,4,1,1
22644,10,22037,9,242,94,148,2,30,1,1
12683,808,1123,588,320,140,180,6,7,3,3
22580,10,22592,9,94,94,0,1,30,1,0
14993,10,5066,9,178,94,84,2,29,1,1
8385,10,13428,9,179,86,93,2,30,1,1
9150,10,19972,9,779,110,669,2,30,1,1
18831,26,26999,16,1320,685,635,14,180,7,7
15380,26,14438,16,8022,2002,6020,20,15,11,9
4002,15,3231,11,1432,663,769,10,19,6,4
11408,26,12680,16,1043,556,487,10,16,6,4
2744,1448,26231,1101,913,126,787,2,30,1,1
15647,26,18457,16,7159,1851,5308,22,31,13,9
9126,10,13675,9,402,118,284,2,30,1,1
9258,10,9661,9,216,110,106,2,30,1,1
17254,15,9784,11,13330975,109486,13221489,10177,23,1394,8783
13836,10,2713,9,733,86,647,2,31,1,1
10694,15,8854,11,52002,2984,49018,77,35,35,42
9806,26,19495,16,3306,1714,1592,17,16,9,8
13806,26,4392,16,333522,14341,319181,347,129,109,238
14486,10,4653,9,711,87,624,2,30,1,1
12764,2270,21000,1757,70,70,0,2,8,2,0
14085,10,14900,9,184,94,90,2,29,1,1
2744,1240,11940,920,880,126,754,2,31,1,1
15673,10,235,9,193,102,91,2,30,1,1
11135,42,28676,25,70,70,0,1,4,1,0
5707,10,484,9,223,78,145,2,30,1,1
3957,26,8441,16,7174,4658,2516,18,121,10,8
16160,26,28565,16,154,94,60,2,5,1,1
14636,26,25746,16,8396,1919,6477,27,116,12,15
13676,10,4232,9,190,97,93,2,31,1,1
1099,26,5758,16,6100,777,5323,17,25,9,8
10853,15,25068,11,4456,1889,2567,11,39,6,5
14307,42,26565,25,70,70,0,2,8,2,0
9360,10,24803,9,756,94,662,2,29,1,1
18788,15,16307,11,254,128,126,5,15,3,2
8471,26,5421,16,12436,7656,4780,41,17,23,18
2571,10,10798,9,218,99,119,2,31,1,1
8444,10,6104,9,230,102,128,2,30,1,1
9185,10,5516,9,821,102,719,2,30,1,1
10891,10,22699,9,305,160,145,3,33,2,1
12902,26,14710,16,6931,1974,4957,24,342,11,13
3066,2074,1336,1598,509,150,359,2,1200,1,1
15659,10,25031,9,445,86,359,2,30,1,1
1219,2025,10429,1554,481,150,331,2,1200,1,1
14514,10,25970,9,181,94,87,2,30,1,1
10883,1491,26441,1133,136,136,0,3,14,3,0
20557,10,16854,9,86,86,0,2,31,2,0
1639,26,19097,16,2601,1455,1146,18,16,8,10
21283,2460,2960,1912,66,66,0,2,7,2,0
10548,26,26981,16,7211,823,6388,16,15,10,6
22099,10,15709,9,199,102,97,2,30,1,1
15320,26,25061,16,101899,20048,81851,132,62,67,65
13795,10,9563,9,184,94,90,2,30,1,1
6913,26,7582,16,156324,6993,149331,192,108,81,111
21834,10,16114,9,183,94,89,2,30,1,1
16210,10,25519,9,247,98,149,2,32,1,1
17313,26,19152,16,4596,1442,3154,24,154,11,13
11027,26,8057,16,2648,1797,851,19,22,11,8
3133,2340,28746,1824,462,462,0,8,3632,8,0
8934,10,16814,9,459,103,356,4,43,2,2
11429,26,16278,16,330,190,140,6,15,4,2
18826,15,27177,11,1658,1344,314,10,14,5,5
11055,2130,9597,1643,70,70,0,2,7,2,0
22084,10,27890,9,263,94,169,2,31,1,1
5991,26,11377,16,2733,1555,1178,22,275,11,11
22508,10,9177,9,216,110,106,2,30,1,1
12769,912,21455,674,70,70,0,2,7,2,0
4502,26,8709,16,2386,1423,963,18,169,10,8
21548,10,7691,9,196,102,94,2,31,1,1
15702,10,13071,9,193,102,91,2,30,1,1
18271,10,1416,9,236,94,142,2,30,1,1
21052,3172,6138,2458,66,66,0,1,5,1,0
9411,280,5307,177,491,150,341,2,1200,1,1
13845,10,27580,9,196,94,102,2,30,1,1
18868,233,8948,148,6278,2408,3870,27,3600,15,12
15110,10,4626,9,498,204,294,6,30,3,3
8584,1238,5889,918,248,71,177,2,31,1,1
13564,26,24083,16,78537,4022,74515,120,386,55,65
8896,10,17335,9,194,102,92,2,30,1,1
14815,10,25900,9,780,104,676,2,31,1,1
881,15,9837,11,65336,2808,62528,73,37,28,45
16360,26,4281,16,33667,25477,8190,60,33,34,26
22717,10,20723,9,217,75,142,4,30,2,2
2724,1240,17071,920,422,164,258,6,30,3,3
13703,26,14572,16,13661,4451,9210,32,46,18,14
9773,26,20826,16,6553,1034,5519,23,87,12,11
2744,1454,17773,1107,890,126,764,2,31,1,1
5266,26,15016,16,5519,1493,4026,20,121,9,11
10910,2659,18244,2066,86,86,0,1,30,1,0
11950,26,26688,16,8476,2030,6446,38,91,19,19
10922,15,12246,11,15867,8841,7026,29,26,16,13
16453,15,5675,11,5411,3618,1793,27,75,14,13
21293,10,20988,9,183,94,89,2,30,1,1
12498,2987,24145,2321,70,70,0,1,5,1,0
11080,1542,7167,1175,70,70,0,2,8,2,0
9738,26,20972,16,4337,3026,1311,21,141,12,9
16138,10,21163,9,290,86,204,2,29,1,1
10250,26,8719,16,640504,257235,383269,1476,797,643,833
13287,15,5447,11,4162,3455,707,14,15,8,6
18304,26,28401,16,19536,7593,11943,76,151,37,39
22379,10,5323,9,299,103,196,4,51,2,2
14847,183,24834,121,4768,1600,3168,19,17,10,9
19561,183,27402,121,3380,1730,1650,15,33,8,7
3694,183,14675,121,4930,2691,2239,24,19,14,10
15345,26,27301,16,5829,2962,2867,35,89,17,18
14274,10,5106,9,780,93,687,2,30,1,1
15594,26,3930,16,4697,1470,3227,20,131,9,11
21912,10,6364,9,199,102,97,2,30,1,1
12824,10,6572,9,102,102,0,1,30,1,0
21936,10,19640,9,195,102,93,2,31,1,1
22617,10,9802,9,706,195,511,6,52,3,3
13751,10,25272,9,711,87,624,2,30,1,1
21831,10,7082,9,751,94,657,2,29,1,1
9537,26,17946,16,7356,1014,6342,20,75,10,10
8672,10,9605,9,200,102,98,2,30,1,1
21205,1208,20518,894,70,70,0,1,4,1,0
18888,26,238,16,6505,2038,4467,26,46,15,11
18469,3226,9103,2502,70,70,0,1,5,1,0
14162,10,25458,9,370,126,244,2,30,1,1
22196,10,23234,9,196,102,94,2,30,1,1
16525,26,25412,16,2974,408,2566,13,135,6,7
458,10,1607,9,220,90,130,2,29,1,1
13610,10,24965,9,194,102,92,2,30,1,1
21721,10,4244,9,183,94,89,2,30,1,1
9704,10,27597,9,755,94,661,2,30,1,1
12548,15,26375,11,2434,516,1918,12,76,6,6
14279,10,8680,9,199,102,97,2,30,1,1
5380,26,25137,16,1053,566,487,10,31,6,4
4718,26,24321,16,8423,2244,6179,32,15,17,15
15167,10,3998,9,200,102,98,2,31,1,1
22529,10,13127,9,771,101,670,2,31,1,1
15159,10,2679,9,177,94,83,2,30,1,1
18531,3054,28721,2371,70,70,0,2,8,2,0
15457,10,13104,9,184,94,90,2,29,1,1
12411,405,4688,263,3428,1820,1608,21,17,12,9
5075,26,24845,16,10556,3559,6997,38,82,21,17
12760,26,19418,16,499,425,74,4,0,3,1
15187,10,10675,9,274,87,187,4,31,2,2
21933,10,12001,9,757,98,659,2,31,1,1
21808,10,12777,9,193,102,91,2,30,1,1
10123,26,4075,16,3137,1855,1282,19,16,9,10
11040,15,18577,11,29838,2481,27357,56,31,24,32
18557,281,8839,178,70,70,0,1,5,1,0
22486,10,24241,9,174,89,85,2,31,1,1
14630,10,1687,9,183,94,89,2,31,1,1
636,280,24989,177,231,111,120,2,1200,1,1
17884,26,15543,16,508206,39212,468994,748,192,296,452
7130,26,12422,16,7503,2345,5158,34,256,17,17
18104,26,954,16,134,60,74,3,4,2,1
16951,255,25970,160,62,62,0,1,5,1,0
5374,26,13716,16,1647482,62713,1584769,1898,219,744,1154
21741,10,6079,9,230,94,136,2,30,1,1
14247,10,26508,9,241,78,163,2,30,1,1
17815,26,24179,16,7747,1533,6214,27,31,13,14
3073,10,12858,9,233,90,143,2,33,1,1
3575,15,14488,11,14448,2001,12447,26,16,14,12
9163,10,5520,9,181,94,87,2,29,1,1
12738,26,24801,16,499,425,74,4,0,3,1
7528,10,27766,9,168,78,90,2,30,1,1
10922,2376,2531,1848,70,70,0,1,5,1,0
13166,10,13362,9,168,78,90,2,30,1,1
14021,10,21279,9,194,102,92,2,31,1,1
3899,26,1525,16,9114,2208,6906,36,120,19,17
21712,26,23391,16,251092,8989,242103,282,123,98,184
9432,26,21153,16,6414386,102255,6312131,5812,182,1634,4178
0,0,0,0,480,244,236,4,0,2,2
817,15,11814,11,1220,403,817,15,414,4,11
10996,26,21045,16,130,70,60,2,15,1,1
8831,10,2328,9,779,298,481,8,67,4,4
10926,2180,12690,1685,70,70,0,2,8,2,0
22705,10,17772,9,290,94,196,4,40,2,2
8468,26,14626,16,7616,3064,4552,14,120,6,8
12159,26,20922,16,21684,2143,19541,38,322,16,22
20100,26,4275,16,4595,3120,1475,18,33,10,8
15835,26,15217,16,8960,2949,6011,21,122,10,11
8521,10,12772,9,192,98,94,2,31,1,1
9082,10,10020,9,196,100,96,2,31,1,1
4124,26,13760,16,8676,3499,5177,31,373,17,14
10966,26,9956,16,4940,3363,1577,27,34,16,11
12859,26,2907,16,11123,4258,6865,48,197,27,21
22698,10,24599,9,321,102,219,2,30,1,1
14275,10,3118,9,168,86,82,2,30,1,1
12487,2962,23458,2299,70,70,0,1,4,1,0
15748,10,6577,9,782,105,677,2,30,1,1
9105,10,5435,9,193,102,91,2,30,1,1
12014,2707,20364,2103,70,70,0,2,8,2,0
4835,280,6339,177,1534,248,1286,4,1200,2,2
15449,10,24318,9,167,86,81,2,30,1,1
14937,10,11304,9,277,118,159,2,30,1,1
12129,26,10266,16,46348,20067,26281,75,60,37,38
21554,10,18665,9,364,94,270,4,49,2,2
700,15,3929,11,950,485,465,9,16,5,4
14486,10,1368,9,177,94,83,2,30,1,1
16021,2189,25206,1694,3960,3960,0,61,3411,61,0
8353,26,24168,16,508520,13734,494786,527,18,192,335
637,240,18947,154,654,150,504,3,1200,1,2
9411,2296,14719,1780,330,330,0,6,1200,6,0
10524,26,1668,16,1878,1050,828,9,16,5,4
15346,2193,8901,1698,70,70,0,1,5,1,0
14472,10,8651,9,197,102,95,2,29,1,1
4724,26,24529,16,697381,19797,677584,725,106,247,478
14938,10,14585,9,178,94,84,2,30,1,1
15357,10,19453,9,197,102,95,2,30,1,1
15865,26,16512,16,36373,15248,21125,172,123,69,103
13826,10,1529,9,209,110,99,2,30,1,1
19300,26,19027,16,4810,2361,2449,34,80,16,18
14159,26,10296,16,7845,1860,5985,24,81,14,10
12645,26,28831,16,499,425,74,4,0,3,1
1806,738,18119,529,122,62,60,2,30,1,1
21849,10,25943,9,166,86,80,2,30,1,1
10910,341,12320,217,270,270,0,4,33,4,0
7184,15,10775,11,574,500,74,6,15,5,1
18084,15,17935,11,1745,779,966,12,144,7,5
14709,26,9001,16,103486,7416,96070,161,42,82,79
9883,26,749,16,3108,1730,1378,16,16,9,7
8874,10,689,9,177,94,83,2,30,1,1
5646,10,17403,9,217,90,127,2,30,1,1
15331,26,9959,16,8007,1987,6020,20,15,11,9
19302,26,27258,16,4552,1645,2907,19,26,11,8
8909,10,4877,9,636,202,434,6,47,3,3
9667,26,19116,16,1389,868,521,12,25,6,6
14452,10,29071,9,183,94,89,2,30,1,1
15192,26,10853,16,7981,1961,6020,20,16,11,9
14814,10,6672,9,188,96,92,2,30,1,1
14333,2795,20266,2168,504,318,186,8,15,5,3
22447,10,1816,9,166,86,80,2,30,1,1
12893,26,2605,16,887350,41179,846171,1082,210,487,595
22192,10,27990,9,214,102,112,2,29,1,1
17613,15,22671,11,3442,1672,1770,19,22,10,9
4745,233,6462,148,110,110,0,1,5,1,0
12832,26,23705,16,4613,1706,2907,19,30,11,8
9020,26,5599,16,18685,4528,14157,31,151,13,18
7879,15,21654,11,1304,850,454,11,31,6,5
15546,10,19830,9,193,102,91,2,30,1,1
13444,26,20804,16,166136,7244,158892,202,149,76,126
8338,26,26071,16,13649,6228,7421,28,30,15,13
8829,26,15673,16,4271,1075,3196,16,25,8,8
17927,10,175,9,355,118,237,2,30,1,1
21110,2735,4176,2121,70,70,0,1,5,1,0
14992,15,20978,11,31432,748,30684,32,104,8,24
14848,10,24835,9,244,98,146,2,32,1,1
12062,1142,5476,842,70,70,0,2,8,2,0
14066,26,11446,16,343735,15691,328044,423,171,179,244
10946,1126,26749,830,70,70,0,1,5,1,0
14413,10,11809,9,177,94,83,2,30,1,1
16334,26,14904,16,4370,3370,1000,19,187,10,9
11083,1718,8706,1312,70,70,0,2,7,2,0
7353,10,17377,9,168,78,90,2,30,1,1
5075,15,24316,11,1013,504,509,10,15,6,4
15673,10,15402,9,193,102,91,2,30,1,1
14634,10,1722,9,177,94,83,2,29,1,1
8991,26,992,16,102548,19098,83450,140,35,60,80
2724,1240,14318,920,422,164,258,6,30,3,3
4310,26,24149,16,7018,1381,5637,24,17,14,10
6207,15,2511,11,1658,1344,314,10,15,5,5
9873,26,5088,16,3514,1609,1905,30,51,16,14
9802,15,23890,11,5018,4314,704,11,30,6,5
15409,2374,11947,1847,70,70,0,1,5,1,0
22595,26,20017,16,63040,3063,59977,78,129,30,48
8370,10,8501,9,168,86,82,2,31,1,1
1191,26,11896,16,1832,1113,719,18,110,10,8
10027,26,18751,16,14584,6798,7786,37,181,18,19
17006,15,12292,11,2543,1880,663,12,14,6,6
6583,26,26466,16,1053,566,487,10,15,6,4
17350,26,20894,16,11182,6150,5032,65,1775,41,24
13775,10,27344,9,193,102,91,2,29,1,1
15229,10,2753,9,209,110,99,2,30,1,1
20441,10,7525,9,213,86,127,2,30,1,1
6250,1997,11319,1527,148,86,62,2,30,1,1
15472,10,1349,9,258,102,156,2,30,1,1
3009,15,12389,11,27233,4047,23186,44,27,20,24
12182,26,11749,16,7740,4267,3473,39,97,21,18
8902,26,16157,16,378,192,186,7,15,4,3
15952,10,28962,9,183,94,89,2,30,1,1
9860,15,16748,11,3317,2376,941,17,165,9,8
14815,10,19473,9,284,96,188,4,33,2,2
6442,10,8669,9,168,78,90,2,30,1,1
2350,26,9677,16,20540,5514,15026,52,76,29,23
16380,26,10143,16,2725,1564,1161,19,124,10,9
10935,3263,19186,2527,66,66,0,1,5,1,0
18915,10,9954,9,335,78,257,2,29,1,1
15897,10,771,9,216,110,106,2,30,1,1
14157,10,11257,9,749,94,655,2,30,1,1
8509,10,16343,9,200,102,98,2,30,1,1
12810,3018,29021,2346,70,70,0,2,7,2,0
15685,10,23801,9,257,110,147,2,30,1,1
14354,1238,3067,918,628,462,166,4,31,2,2
15192,10,16448,9,228,110,118,2,30,1,1
15863,26,8871,16,8699,3391,5308,40,15,24,16
21299,10,28534,9,197,102,95,2,30,1,1
5606,2000,8952,1530,148,86,62,2,31,1,1
1050,26,6889,16,324745,7830,316915,327,31,112,215
22235,26,359,16,2227,1018,1209,17,16,8,9
7724,26,20451,16,4380,1473,2907,19,29,11,8
13825,10,7488,9,183,94,89,2,30,1,1
12301,26,3883,16,12474,4810,7664,39,66,19,20
9069,10,18874,9,176,90,86,2,31,1,1
14882,10,16639,9,228,75,153,4,31,2,2
15102,26,4978,16,5212,1037,4175,20,115,10,10
4514,10,15946,9,247,98,149,2,33,1,1
9450,10,16678,9,209,110,99,2,30,1,1
8645,15,28119,11,9192,4788,4404,30,126,17,13
21803,10,16087,9,757,102,655,2,30,1,1
22208,10,13577,9,166,86,80,2,30,1,1
8501,10,19145,9,194,102,92,2,31,1,1
13598,15,13841,11,5696,703,4993,14,75,8,6
18929,26,27053,16,16379,2214,14165,39,18,20,19
22111,10,23653,9,167,86,81,2,29,1,1
17497,10,26280,9,222,87,135,2,31,1,1
22208,10,3762,9,164,84,80,2,31,1,1
9226,10,13449,9,177,94,83,2,30,1,1
8534,10,22908,9,718,94,624,2,30,1,1
20109,26,20216,16,14673,3914,10759,31,27,14,17
13215,10,3938,9,199,94,105,2,29,1,1
15551,10,25763,9,774,101,673,2,30,1,1
14769,26,14990,16,12283477,390003,11893474,13073,164,4327,8746
13388,26,7642,16,8263,1279,6984,15,136,7,8
15345,26,7404,16,7889,1900,5989,20,15,11,9
13654,26,7143,16,134,60,74,3,10,2,1
15208,15,7923,11,234,234,0,4,12,4,0
15773,10,24628,9,810,108,702,2,30,1,1
6716,26,7334,16,10458,1688,8770,30,15,17,13
13867,26,15900,16,12954,2333,10621,20,120,9,11
16748,10,21930,9,167,78,89,2,30,1,1
15890,10,26972,9,167,86,81,2,30,1,1
18761,1989,23256,1519,316,136,180,6,5,3,3
10383,26,18302,16,162,102,60,2,5,1,1
14684,10,26228,9,166,85,81,2,31,1,1
2724,1240,14442,920,422,164,258,6,30,3,3
1052,26,12701,16,9308,2125,7183,27,34,13,14
14985,26,4316,16,8328,1391,6937,18,123,10,8
3933,26,7080,16,7703,1606,6097,23,80,13,10
9798,18,12254,13,184,94,90,2,30,1,1
14886,10,24341,9,177,94,83,2,30,1,1
5982,10,17941,9,235,90,145,2,33,1,1
9465,10,8667,9,168,78,90,2,30,1,1
9065,10,13698,9,231,102,129,2,30,1,1
11345,26,22913,16,5433,2251,3182,23,86,12,11
8902,26,28920,16,52574,2783,49791,61,129,19,42
13180,10,23297,9,291,86,205,2,30,1,1
13752,10,11609,9,194,99,95,2,30,1,1
9162,10,19237,9,94,94,0,1,30,1,0
4316,10,4671,9,199,94,105,2,30,1,1
14903,10,6153,9,183,94,89,2,30,1,1
21464,10,10707,9,193,102,91,2,30,1,1
21392,15,27305,11,5827,773,5054,16,73,9,7
16450,26,11366,16,8647,1990,6657,23,26,14,9
9026,10,27827,9,744,89,655,2,31,1,1
7147,15,4454,11,3044854,64416,2980438,2968,19,997,1971
4819,26,13303,16,130,70,60,3,5,2,1
6375,26,19826,16,7341,2111,5230,18,135,8,10
14157,10,3181,9,250,86,164,2,30,1,1
22669,10,9683,9,211,102,109,2,30,1,1
905,26,2734,16,6258,843,5415,19,29,10,9
13706,15,16140,11,11677266,314362,11362904,12711,129,5174,7537
5370,26,7130,16,2403265,93626,2309639,2795,243,1103,1692
9359,115,6737,88,70,70,0,1,4,1,0
848,26,14473,16,15177,5713,9464,37,120,17,20
8598,10,14822,9,812,110,702,2,30,1,1
4772,10,23763,9,220,78,142,2,30,1,1
21812,10,7324,9,209,110,99,2,30,1,1
11428,26,8134,16,7396,3677,3719,16,120,8,8
8210,2099,21194,1618,511,152,359,2,1200,1,1
5596,26,22320,16,6865,1958,4907,21,16,13,8
16837,26,12724,16,19356,2148,17208,34,112,17,17
10585,26,11891,16,6384,1899,4485,16,75,9,7
22392,1238,18260,918,262,78,184,2,29,1,1
9729,15,22056,11,9588,4478,5110,28,21,16,12
3843,232,14912,147,482,210,272,8,15,4,4
19031,26,27111,16,40415,2911,37504,57,18,27,30
9236,10,22615,9,261,97,164,4,44,2,2
10895,662,5787,463,70,70,0,1,5,1,0
3910,10,23524,9,70657,70002,655,845,88,839,6
9613,26,19760,16,19063941,342071,18721870,17124,384,4119,13005
14024,10,6188,9,195,94,101,2,29,1,1
15975,10,78,9,819,102,717,2,30,1,1
9180,10,5753,9,766,103,663,4,41,2,2
22198,10,3411,9,357,107,250,4,36,2,2
13659,10,10237,9,183,94,89,2,30,1,1
15242,15,11203,11,234,234,0,4,12,4,0
4649,26,24516,16,4898,1119,3779,17,30,9,8
12940,26,23772,16,65572,14874,50698,92,84,48,44
16986,26,21137,16,5061,876,4185,16,70,8,8
13781,10,14946,9,889,404,485,10,30,5,5
15318,26,17571,16,7789,2275,5514,30,47,16,14
22437,10,27482,9,302,104,198,4,46,2,2
8768,10,28091,9,178,94,84,2,30,1,1
14946,15,6213,11,1636,699,937,10,15,5,5
14544,10,27029,9,196,102,94,2,30,1,1
9213,10,22527,9,766,102,664,2,30,1,1
15188,10,25222,9,307,134,173,2,30,1,1
898,26,168,16,6334,840,5494,19,29,10,9
1414,10,4905,9,198,90,108,2,30,1,1
22543,10,21097,9,168,86,82,2,31,1,1
21002,15,5390,11,314,192,122,6,15,4,2
9533,26,27440,16,306,180,126,6,26,4,2
15580,10,12757,9,182,93,89,2,31,1,1
8584,1240,3944,920,260,78,182,2,31,1,1
20411,26,7910,16,10829,2227,8602,35,47,20,15
3351,26,15848,16,4234,2185,2049,36,1099,16,20
8716,26,12075,16,2338,1407,931,18,200,10,8
5268,26,21752,16,201217,15748,185469,327,207,163,164
8912,10,3459,9,290,102,188,2,30,1,1
15866,10,1344,9,197,102,95,2,30,1,1
18129,26,1773,16,350,210,140,6,15,4,2
2744,1238,10276,918,1630,126,1504,4,31,2,2
12977,26,23796,16,147750,13521,134229,182,92,84,98
15165,10,12416,9,198,101,97,2,31,1,1
15075,15,3581,11,410119,16112,394007,424,63,155,269
4575,26,5821,16,130,70,60,3,5,2,1
11138,26,11777,16,18735,3452,15283,42,52,22,20
21568,10,17200,9,209,110,99,2,30,1,1
15410,1329,19189,1004,130,70,60,2,5,1,1
8770,10,5121,9,179,94,85,2,30,1,1
13657,10,27414,9,196,102,94,2,30,1,1
22520,10,21644,9,822,102,720,2,29,1,1
21530,10,9489,9,198,94,104,2,30,1,1
12617,3156,15149,2446,70,70,0,2,7,2,0
8740,10,18180,9,193,102,91,2,29,1,1
8549,10,9831,9,200,102,98,2,30,1,1
9306,10,7175,9,152,78,74,2,30,1,1
11402,26,20725,16,12402,3972,8430,46,138,26,20
3461,10,14286,9,256,114,142,2,30,1,1
5606,1993,15052,1523,141,79,62,2,31,1,1
14679,10,17543,9,199,102,97,2,29,1,1
4361,26,12339,16,16276,14463,1813,33,95,20,13
8803,10,17694,9,255,102,153,2,30,1,1
9724,26,28204,16,2604,1413,1191,15,98,9,6
9726,26,24113,16,7453,1467,5986,19,25,10,9
15413,10,21450,9,170,87,83,2,30,1,1
13693,26,4815,16,62,62,0,1,4,1,0
842,26,4889,16,8062,2804,5258,43,161,20,23
9159,10,23643,9,303,98,205,4,40,2,2
6130,26,28291,16,9358,2304,7054,39,120,20,19
12157,26,26067,16,4241,706,3535,14,25,8,6
15109,10,10738,9,193,102,91,2,30,1,1
10613,10,11906,9,212,86,126,2,30,1,1
8358,10,14001,9,186,95,91,2,31,1,1
21676,10,23011,9,170,87,83,2,31,1,1
5855,26,12132,16,137809,4697,133112,153,170,55,98
8539,10,1648,9,527,208,319,6,64,3,3
18527,507,2236,335,1090,712,378,16,26,10,6
11706,15,25230,11,432,240,192,8,101,5,3
15435,10,26042,9,168,86,82,2,30,1,1
13876,10,15619,9,182,93,89,2,30,1,1
16021,1955,3095,1492,792,792,0,13,1200,13,0
11919,26,12880,16,48877,5205,43672,95,93,32,63
9570,10,21095,9,889,404,485,10,30,5,5
21816,10,3750,9,183,94,89,2,30,1,1
20930,26,10759,16,6187,933,5254,18,147,10,8
9717,26,11686,16,7282,953,6329,18,16,10,8
13914,10,7516,9,102,102,0,1,30,1,0
13748,10,23811,9,177,94,83,2,29,1,1
636,280,24359,177,853,355,498,4,1200,2,2
10839,26,4189,16,82930,18836,64094,131,128,55,76
8572,15,10234,11,32206,1049,31157,37,89,11,26
8434,10,29096,9,184,94,90,2,30,1,1
20395,26,27950,16,4377,1470,2907,19,30,11,8
4435,26,18895,16,9381,1457,7924,21,31,11,10
11029,15,14836,11,20433,10970,9463,34,42,19,15
8584,1238,25722,918,78,78,0,1,30,1,0
9715,15,28512,11,300,174,126,5,15,3,2
8933,10,15958,9,170,87,83,2,30,1,1
12127,15,26535,11,1726,940,786,8,55,5,3
15550,15,8314,11,214,140,74,4,35,3,1
15013,15,1286,11,17128,1499,15629,24,25,9,15
95,10,149,9,235,90,145,2,32,1,1
18633,10,10302,9,229,94,135,2,30,1,1
9106,10,18567,9,264,94,170,2,31,1,1
8393,26,10432,16,532687,14365,518322,560,20,211,349
9962,26,22185,16,1210,637,573,14,25,7,7
14104,10,28922,9,198,94,104,2,30,1,1
13725,10,12927,9,356,118,238,2,29,1,1
16500,26,28364,16,3296,1329,1967,14,135,7,7
13248,26,14332,16,4263,2019,2244,14,136,7,7
14254,3196,29046,2478,70,70,0,2,8,2,0
10647,26,8024,16,6952,3608,3344,27,21,14,13
5262,26,3911,16,350650,19028,331622,494,83,251,243
19390,26,16465,16,633920,7867,626053,505,41,81,424
14114,10,24572,9,177,94,83,2,30,1,1
8620,15,5595,11,3920,2138,1782,23,135,12,11
8993,26,8346,16,5927,1644,4283,18,16,10,8
14773,10,20391,9,174,89,85,2,31,1,1
22711,10,7323,9,1281,94,1187,2,30,1,1
2744,1052,20960,775,881,126,755,2,30,1,1
21358,3185,16944,2471,70,70,0,1,4,1,0
13308,26,23973,16,109880,24958,84922,154,20,83,71
4895,26,3983,16,863998,37140,826858,1072,61,479,593
22636,10,24002,9,199,102,97,2,30,1,1
11079,15,27484,11,34695,17472,17223,55,33,28,27
22237,10,3105,9,758,96,662,2,30,1,1
15801,10,25291,9,240,98,142,2,30,1,1
14232,2228,26980,1727,504,318,186,8,15,5,3
14738,10,25847,9,176,90,86,2,31,1,1
15801,26,19840,16,230914,10401,220513,290,76,121,169
11154,15,2092,11,366,240,126,7,26,5,2
15712,10,28167,9,286,97,189,4,47,2,2
15893,26,5925,16,6956,2856,4100,28,16,16,12
15402,10,13013,9,195,102,93,2,29,1,1
5527,26,15583,16,4552,1255,3297,27,183,12,15
15214,10,5324,9,168,86,82,2,31,1,1
12149,26,16223,16,572,292,280,9,33,5,4
11970,26,23788,16,6173,924,5249,18,177,10,8
7942,26,8197,16,6454,1447,5007,22,17,11,11
14684,10,18011,9,167,86,81,2,30,1,1
13868,10,8226,9,178,91,87,2,30,1,1
14255,10,8308,9,174,89,85,2,31,1,1
21606,10,10683,9,240,78,162,2,30,1,1
22124,10,29073,9,232,86,146,2,30,1,1
9064,26,12162,16,1820,1101,719,18,73,10,8
13332,26,17786,16,5692,2502,3190,24,131,12,12
11897,26,16700,16,10754,4129,6625,42,112,20,22
16679,26,15453,16,3581,1045,2536,10,122,5,5
8395,26,10960,16,13758,6577,7181,66,918,34,32
10370,1118,18178,823,70,70,0,1,5,1,0
6062,26,10415,16,760,422,338,12,28,7,5
7704,15,26183,11,1188,463,725,8,15,5,3
11301,15,22875,11,237488,7574,229914,231,27,71,160
20213,295,27828,190,2990,1599,1391,15,15,8,7
21242,10,23263,9,188,96,92,2,31,1,1
14509,10,9792,9,770,102,668,2,30,1,1
4083,26,15504,16,8530,2685,5845,25,100,15,10
7995,26,4886,16,10418,1427,8991,27,16,12,15
18793,206,3632,135,70,70,0,2,8,2,0
14723,10,12735,9,744,89,655,2,31,1,1
9006,26,17984,16,5309,1043,4266,22,72,11,11
22533,10,24117,9,313,110,203,4,33,2,2
1044,26,19516,16,5691,503,5188,14,15,7,7
13845,10,23479,9,214,110,104,2,31,1,1
17760,26,3541,16,10366,4530,5836,21,135,10,11
9019,10,20886,9,177,94,83,2,30,1,1
18627,15,15115,11,556,280,276,9,28,5,4
18513,2900,9322,2252,70,70,0,1,5,1,0
17022,26,24278,16,7973,4166,3807,28,141,14,14
3237,26,13825,16,5497,2520,2977,20,16,11,9
21279,10,27141,9,214,102,112,2,30,1,1
9778,10,13700,9,218,86,132,2,30,1,1
21187,917,2096,678,312,132,180,6,7,3,3
11256,2485,10186,1933,70,70,0,2,8,2,0
15872,26,19555,16,77504,4494,73010,112,200,54,58
18443,2821,13357,2189,70,70,0,1,5,1,0
9498,10,10360,9,209,110,99,2,30,1,1
16092,26,14833,16,7087,2587,4500,21,30,12,9
10969,15,4164,11,103732,4081,99651,128,61,55,73
15485,10,18750,9,216,94,122,2,30,1,1
17074,26,21978,16,7254,838,6416,27,290,9,18
9086,15,4464,11,1126,609,517,11,15,6,5
22479,10,6686,9,193,102,91,2,30,1,1
15550,10,18555,9,273,102,171,2,30,1,1
17025,26,8781,16,26960,13206,13754,53,17,28,25
8873,10,2485,9,733,85,648,2,31,1,1
21401,10,16329,9,216,102,114,2,30,1,1
4822,26,20411,16,6521,2079,4442,32,3827,19,13
21486,10,24902,9,280,94,186,2,30,1,1
10420,295,22433,190,2163,676,1487,14,15,7,7
12904,26,20456,16,444890,27602,417288,580,176,265,315
8531,10,17309,9,182,94,88,2,30,1,1
15861,26,19894,16,134,60,74,3,5,2,1
20990,26,28313,16,4398,1491,2907,19,27,11,8
9065,10,26437,9,193,102,91,2,31,1,1
15643,26,21198,16,7731,2016,5715,38,271,20,18
2083,183,8221,121,4145,1976,2169,22,18,13,9
8479,26,16795,16,3171,2293,878,17,40,10,7
9515,26,17250,16,456,390,66,4,0,3,1
9013,10,4401,9,196,102,94,2,30,1,1
15554,15,8231,11,214,140,74,4,35,3,1
7583,26,16968,16,7261,3272,3989,22,45,13,9
15623,10,13437,9,711,87,624,2,31,1,1
20314,26,27892,16,4398,1491,2907,19,26,11,8
3999,15,12860,11,947,376,571,8,14,5,3
11998,15,25212,11,1797,1070,727,10,15,5,5
3928,26,24855,16,1617,1062,555,13,45,8,5
9334,26,21844,16,12509,1447,11062,28,122,16,12
1161,26,2655,16,7617,4161,3456,34,332,15,19
13681,26,11439,16,17167,5192,11975,32,121,17,15
19714,26,6139,16,7118,2462,4656,18,75,10,8
21843,10,24331,9,168,86,82,2,30,1,1
16576,10,25750,9,262,106,156,2,34,1,1
13033,26,4044,16,499,425,74,4,0,3,1
12016,2395,6778,1862,70,70,0,2,8,2,0
14476,10,7906,9,437,98,339,4,41,2,2
8980,26,5691,16,8614049,176366,8437683,7757,202,1608,6149
12458,26,21108,16,6352,1552,4800,23,17,12,11
13870,10,10958,9,711,87,624,2,31,1,1
6707,10,18936,9,235,90,145,2,32,1,1
9422,233,1639,148,552,280,272,9,16,5,4
6226,26,2182,16,8962,1601,7361,26,186,14,12
518,7,1885,7,124,60,64,2,5,1,1
10994,15,27498,11,306,120,186,6,25,3,3
14107,10,5271,9,197,102,95,2,33,1,1
20096,26,14216,16,4608,3133,1475,18,35,10,8
10731,295,22614,190,2163,676,1487,14,15,7,7
22037,10,22440,9,214,110,104,2,30,1,1
13025,26,8218,16,499,425,74,4,0,3,1
2724,1240,24926,920,926,410,516,12,31,6,6
15285,26,10548,16,8057,2037,6020,20,15,11,9
11460,26,17537,16,41966,23593,18373,89,154,42,47
8439,10,10502,9,168,86,82,3,44,2,1
14611,10,11497,9,177,94,83,2,29,1,1
9775,26,1916,16,4158,1021,3137,15,26,8,7
22363,10,25902,9,500,204,296,6,75,3,3
760,15,3072,11,572,240,332,10,83,5,5
10927,2923,18903,2268,70,70,0,1,5,1,0
8956,10,22411,9,195,102,93,2,30,1,1
4504,15,20388,11,1678,1364,314,10,15,5,5
7236,15,1842,11,890,420,470,14,27,7,7
6879,26,22133,16,18921,10848,8073,49,401,20,29
8884,10,18291,9,807,94,713,2,30,1,1
8576,10,15139,9,167,86,81,2,31,1,1
20670,26,2499,16,1373,734,639,17,134,10,7
18517,845,8663,623,1842,1017,825,19,16,9,10
14248,10,20918,9,177,94,83,2,30,1,1
8633,10,28374,9,811,94,717,2,30,1,1
14969,10,8606,9,816,102,714,2,30,1,1
22524,10,8575,9,767,102,665,2,29,1,1
13648,26,12504,16,13580,3864,9716,40,18,23,17
8444,10,8498,9,199,102,97,2,30,1,1
12504,618,11353,426,70,70,0,1,4,1,0
13081,26,17943,16,8056,3762,4294,55,517,28,27
12086,15,12281,11,748,459,289,8,254,5,3
8722,10,224,9,300,100,200,4,43,2,2
12671,15,27185,11,5774,1483,4291,14,162,8,6
8464,10,20872,9,183,94,89,2,30,1,1
12701,26,22629,16,499,425,74,4,1,3,1
21327,900,9625,664,66,66,0,1,5,1,0
16384,26,27116,16,1853,1214,639,18,156,11,7
20521,26,11229,16,304,86,218,2,30,1,1
10961,896,7697,662,70,70,0,1,5,1,0
11024,15,16311,11,366,240,126,7,26,5,2
15695,10,11870,9,216,110,106,2,31,1,1
14482,26,19628,16,53845,7300,46545,80,31,38,42
14891,10,7155,9,814,110,704,2,30,1,1
21787,10,3631,9,766,102,664,2,30,1,1
8954,10,19844,9,198,102,96,2,33,1,1
15686,10,6750,9,199,102,97,2,29,1,1
10693,15,10660,11,318,192,126,6,37,4,2
9209,26,21786,16,4534,1627,2907,19,27,11,8
7366,26,23081,16,80200,69062,11138,193,89,100,93
15404,1655,28144,1272,316,136,180,6,5,3,3
14721,10,19015,9,183,94,89,2,30,1,1
11084,15,21366,11,1682,642,1040,13,54,4,9
14708,10,28319,9,199,102,97,2,29,1,1
3688,10,7048,9,168,78,90,2,30,1,1
6250,1993,5933,1523,148,86,62,2,31,1,1
15361,26,25082,16,4381,1474,2907,19,27,11,8
8210,405,21194,263,512,158,354,2,1200,1,1
8019,10,7255,9,199,94,105,2,30,1,1
8103,26,21207,16,934,420,514,15,30,7,8
8341,10,3965,9,323,107,216,4,47,2,2
12973,26,29050,16,3157,1827,1330,23,15,11,12
15381,26,20482,16,403093,31796,371297,497,151,185,312
14312,15,2482,11,70,70,0,2,8,2,0
14809,10,9335,9,772,103,669,2,31,1,1
5103,26,4363,16,5306,1619,3687,20,29,12,8
12597,1,2146,1,70,70,0,1,5,1,0
8862,10,6411,9,200,94,106,2,30,1,1
14775,10,10034,9,168,86,82,2,31,1,1
13878,10,14780,9,177,94,83,2,29,1,1
22202,10,20424,9,625,192,433,6,46,3,3
13704,15,21566,11,246,120,126,5,15,3,2
4595,26,21020,16,10281,4850,5431,23,400,13,10
14602,26,26359,16,7563,2253,5310,20,157,11,9
14891,10,23419,9,700,282,418,8,81,4,4
9522,26,6541,16,8663,1983,6680,21,33,10,11
8348,10,7802,9,184,102,82,2,30,1,1
10800,1850,12559,1410,316,136,180,6,6,3,3
21859,10,12284,9,193,102,91,2,29,1,1
13913,10,5272,9,193,102,91,2,29,1,1
2724,1240,14758,920,422,164,258,6,30,3,3
2744,1241,18235,921,881,126,755,2,30,1,1
9131,10,18013,9,186,95,91,2,31,1,1
21866,10,1747,9,198,101,97,2,31,1,1
14363,10,6641,9,199,102,97,2,30,1,1
22183,10,0,0,229,85,144,2,31,1,1
10038,26,4708,16,124,64,60,2,15,1,1
14296,15,25492,11,70,70,0,1,5,1,0
10616,26,21111,16,21523,4681,16842,37,149,18,19
21091,2493,15902,1940,70,70,0,1,4,1,0
17993,26,4002,16,1401,864,537,12,28,6,6
11291,10,3363,9,578,286,292,9,15,5,4
10775,150,971,107,66,66,0,1,5,1,0
5597,26,14906,16,6065,2277,3788,17,135,8,9
10889,1767,26401,1349,70,70,0,1,5,1,0
15992,11,5644,10,70,70,0,2,7,2,0
8722,15,18327,11,7002,5717,1285,15,45,9,6
15187,10,11914,9,178,94,84,2,30,1,1
7481,26,18025,16,9307,2265,7042,31,325,13,18
18314,26,9077,16,4512,1810,2702,16,135,7,9
18272,10,8670,9,214,85,129,2,0,1,1
7865,26,11888,16,1056,569,487,10,24,6,4
22602,10,5283,9,194,94,100,2,30,1,1
9769,26,21051,16,3090,1707,1383,15,19,9,6
13823,15,24288,11,374,240,134,7,15,5,2
8910,10,6049,9,816,102,714,2,30,1,1
13196,10,6878,9,199,94,105,2,30,1,1
4472,26,13586,16,70,70,0,1,5,1,0
5863,26,15740,16,5553,1055,4498,19,121,9,10
3859,26,5945,16,51393,3538,47855,70,30,29,41
14273,26,2615,16,9213,3751,5462,17,121,8,9
10783,678,1280,477,70,70,0,2,7,2,0
21235,10,0,0,219,81,138,2,30,1,1
9353,10,7181,9,166,86,80,2,30,1,1
8874,10,7845,9,186,95,91,2,31,1,1
9126,10,11866,9,184,94,90,2,30,1,1
19308,15,1491,11,283970,23419,260551,574,158,255,319
11275,26,19250,16,7488,2474,5014,23,3600,12,11
16517,26,26218,16,2257,1225,1032,15,18,8,7
18573,26,26846,16,4658,1751,2907,19,30,11,8
13875,10,24488,9,199,94,105,2,30,1,1
7649,26,14193,16,12488,5447,7041,28,16,16,12
13760,10,4994,9,711,87,624,2,30,1,1
12597,1,8758,1,70,70,0,2,8,2,0
15845,10,20393,9,177,94,83,2,30,1,1
3790,15,17945,11,3089,775,2314,15,16,9,6
16752,10,27087,9,167,78,89,2,30,1,1
3225,1993,12437,1523,280,182,98,2,30,1,1
9482,15,20417,11,1083,653,430,8,16,5,3
0,0,0,0,480,244,236,4,0,2,2
16585,26,23111,16,5584,1168,4416,19,17,11,8
13857,10,8199,9,760,97,663,2,30,1,1
9722,15,22049,11,35580,13335,22245,69,23,38,31
4835,3093,9973,2402,132,132,0,3,1199,3,0
9865,15,8843,11,3235,555,2680,13,20,6,7
16021,2224,10828,1723,353,166,187,2,1199,1,1
17815,26,1877,16,2316,1353,963,17,276,9,8
5545,15,12312,11,1614,1300,314,10,16,5,5
14651,10,11150,9,178,94,84,2,30,1,1
10327,2942,26057,2282,481,150,331,2,1200,1,1
9411,3028,15119,2354,4228,2471,1757,55,2758,31,24
18351,15,9036,11,5836,2829,3007,19,164,14,5
16494,23,0,0,11672,5710,5962,60,29,30,30
12135,232,16391,147,10577,3496,7081,68,616,36,32
14003,10,4012,9,184,94,90,2,29,1,1
9766,10,18228,9,202,83,119,2,30,1,1
15119,10,13883,9,183,94,89,2,31,1,1
13871,10,10134,9,199,102,97,2,30,1,1
21876,10,14140,9,225,102,123,2,30,1,1
9774,10,28518,9,209,110,99,2,30,1,1
5919,26,19562,16,7252,2147,5105,18,136,8,10
15313,10,15513,9,264,87,177,4,37,2,2
16021,1145,26313,845,132,132,0,3,1199,3,0
11189,15,17576,11,1278,731,547,10,15,6,4
16021,2450,26979,1903,132,132,0,3,1200,3,0
9547,10,9907,9,168,86,82,2,31,1,1
21215,2814,20868,2184,66,66,0,2,8,2,0
22666,10,27413,9,183,94,89,2,30,1,1
19998,26,12749,16,3170,1556,1614,7,121,3,4
6250,2626,19884,2036,725,325,400,12,31,6,6
8708,26,27587,16,40423,35897,4526,52,16,33,19
6450,188,21637,123,312,140,172,4,29,2,2
7016,26,2792,16,9982,2062,7920,37,120,19,18
5363,26,9224,16,621104,12188,608916,575,78,149,426
21729,10,10435,9,280,97,183,4,59,2,2
3133,2292,44,1777,462,462,0,8,3633,8,0
12095,15,15814,11,2622,1074,1548,14,282,8,6
2596,10,10943,9,220,90,130,2,30,1,1
288,183,804,121,4635,2460,2175,21,18,12,9
18504,3226,10267,2502,70,70,0,1,5,1,0
13469,26,3109,16,9501,1502,7999,24,29,13,11
17500,26,26733,16,26414,4349,22065,41,149,17,24
22550,10,13366,9,256,93,163,2,30,1,1
14315,10,5090,9,193,102,91,2,29,1,1
12296,26,23439,16,960,539,421,9,30,5,4
22047,10,16786,9,184,94,90,2,30,1,1
6545,26,7135,16,3831584,85342,3746242,3246,110,597,2649
21188,1832,150,1394,70,70,0,1,4,1,0
11007,15,19362,11,4305,699,3606,13,46,7,6
5796,26,22205,16,6451,1003,5448,21,360,11,10
225,10,4593,9,204,118,86,2,31,1,1
8798,26,15283,16,5598,1185,4413,24,80,13,11
9728,79,945,61,161,161,0,2,1200,2,0
12495,2941,19135,2281,492,306,186,8,15,5,3
7165,26,6960,16,81504,6111,75393,108,20,53,55
821,15,12253,11,1748,716,1032,19,395,6,13
21790,10,17630,9,578,179,399,6,56,3,3
17167,26,16301,16,16230,11127,5103,69,330,34,35
8824,10,18799,9,211,102,109,2,30,1,1
13255,26,19155,16,8060,2001,6059,24,19,14,10
3837,26,2312,16,6313,1368,4945,21,846,11,10
8350,10,16496,9,177,94,83,2,30,1,1
699,26,6791,16,6458,2658,3800,34,255,16,18
21710,10,19578,9,184,94,90,2,31,1,1
21040,1370,12090,1041,70,70,0,1,4,1,0
21415,10,1152,9,179,94,85,2,30,1,1
1531,10,5455,9,213,82,131,2,30,1,1
14400,10,27176,9,199,102,97,2,30,1,1
15292,10,22621,9,172,88,84,2,31,1,1
16951,255,25970,160,62,62,0,1,5,1,0
8910,10,1676,9,211,102,109,2,30,1,1
7295,15,18081,11,2784,1804,980,17,20,9,8
2744,1238,16095,918,879,126,753,2,31,1,1
8402,10,9336,9,172,94,78,2,30,1,1
9268,10,28073,9,178,94,84,2,30,1,1
8930,10,24006,9,199,102,97,2,30,1,1
21903,10,7866,9,276,94,182,2,30,1,1
8514,26,22693,16,611644,29314,582330,793,132,333,460
21115,891,24926,659,66,66,0,2,7,2,0
2744,1625,26123,1247,900,126,774,3,30,2,1
8838,10,15574,9,761,100,661,2,30,1,1
19637,26,27450,16,530764,27638,503126,528,175,179,349
10559,26,26716,16,1307,688,619,14,37,8,6
22089,10,5685,9,718,94,624,2,31,1,1
15525,10,26967,9,193,102,91,2,30,1,1
10921,15,8882,11,7434,3830,3604,17,30,9,8
15236,10,912,9,297,102,195,4,34,2,2
7436,26,17138,16,178,118,60,2,15,1,1
15334,10,4187,9,177,94,83,2,30,1,1
8401,10,16520,9,170,87,83,2,30,1,1
9851,10,26498,9,181,86,95,2,30,1,1
15480,10,22848,9,193,102,91,2,30,1,1
22699,26,20427,16,92101,4799,87302,107,16,43,64
22296,10,28084,9,230,102,128,2,31,1,1
2984,295,12286,190,3756,2125,1631,18,17,10,8
9842,255,22121,160,130,66,64,2,5,1,1
8884,10,17040,9,793,101,692,2,30,1,1
20730,26,13661,16,8451,2698,5753,21,129,9,12
4493,10,8520,9,168,78,90,2,30,1,1
12009,10,17001,9,326,102,224,2,29,1,1
8449,10,28856,9,178,94,84,2,30,1,1
831,26,11250,16,7182,1016,6166,28,412,11,17
9099,10,4382,9,75,75,0,1,30,1,0
21400,10,9268,9,199,102,97,2,31,1,1
15784,10,10717,9,178,94,84,2,30,1,1
20433,15,27970,11,1918,1469,449,10,20,6,4
11055,2130,19787,1643,70,70,0,1,4,1,0
11904,15,2007,11,1991,686,1305,10,335,6,4
8509,10,25104,9,200,102,98,2,30,1,1
19370,26,16663,16,45313,3360,41953,61,47,26,35
15012,10,11177,9,177,94,83,2,30,1,1
15267,26,13941,16,3932,2581,1351,18,18,10,8
11274,2997,534,2330,70,70,0,1,5,1,0
9632,15,24995,11,318,192,126,6,25,4,2
21659,10,2427,9,186,95,91,2,30,1,1
21402,10,12383,9,170,87,83,2,31,1,1
4610,10,22604,9,168,78,90,2,30,1,1
11015,1930,11738,1474,70,70,0,2,8,2,0
11715,26,20540,16,2802,1626,1176,18,72,9,9
22658,26,18016,16,92958,4869,88089,109,15,44,65
9720,26,12375,16,7282,953,6329,18,16,10,8
2744,1558,10519,1189,1796,252,1544,5,31,3,2
19791,26,24894,16,7856,2410,5446,30,17,16,14
9411,634,4654,439,132,132,0,3,1200,3,0
18827,26,14800,16,658,140,518,10,3632,3,7
9,18,6401,13,184,94,90,2,30,1,1
8584,1233,8137,913,274,78,196,2,31,1,1
8210,280,21194,177,506,152,354,2,1200,1,1
5043,10,16595,9,247,98,149,2,33,1,1
8785,10,146,9,184,86,98,2,30,1,1
4932,26,3649,16,5714,1536,4178,24,21,13,11
11101,26,25172,16,8232,3997,4235,21,16,11,10
14279,10,3173,9,199,102,97,2,29,1,1
5745,26,25571,16,256802,11839,244963,329,173,136,193
11115,1445,23948,1098,136,136,0,3,14,3,0
8081,26,12648,16,8415,883,7532,23,54,8,15
7698,26,8072,16,2809,1884,925,19,25,11,8
15679,10,25290,9,178,94,84,2,29,1,1
14192,10,25639,9,763,101,662,2,30,1,1
10690,15,1240,11,318,192,126,6,37,4,2
14451,10,21320,9,184,94,90,2,29,1,1
15330,10,3466,9,663,212,451,6,63,3,3
21562,10,12426,9,216,110,106,2,31,1,1
15299,10,17785,9,195,102,93,2,29,1,1
15750,10,25379,9,174,89,85,2,30,1,1
11155,15,18963,11,2178,1003,1175,10,15,6,4
19921,26,25594,16,3709,1176,2533,14,135,7,7
10279,15,22362,11,1502,817,685,10,20,6,4
13027,26,1440,16,499,425,74,4,0,3,1
15004,15,14549,11,17188,1559,15629,25,31,10,15
12536,2577,1092,1999,70,70,0,1,4,1,0
3133,2310,4067,1794,330,330,0,6,3609,6,0
19440,10,553,9,211,78,133,2,30,1,1
12026,2083,24447,1605,70,70,0,1,5,1,0
15184,15,16687,11,234,234,0,4,12,4,0
8210,2644,21194,2052,480,149,331,2,1200,1,1
15314,26,18170,16,7914,1925,5989,20,15,11,9
15234,10,26471,9,711,87,624,2,30,1,1
13876,10,2232,9,183,94,89,2,30,1,1
21244,10,23185,9,196,94,102,2,30,1,1
6276,15,28071,11,1081,641,440,9,14,4,5
6179,10,27815,9,199,94,105,2,29,1,1
8692,10,5159,9,272,97,175,4,58,2,2
14456,26,26436,16,7519,2177,5342,16,136,8,8
8652,10,3948,9,177,94,83,2,30,1,1
12137,26,26914,16,532222,22112,510110,645,232,259,386
8552,26,14898,16,44437,2600,41837,62,16,28,34
7948,26,1879,16,172,172,0,2,5,2,0
9176,10,11611,9,212,110,102,2,30,1,1
21797,10,10115,9,199,102,97,2,30,1,1
14064,10,23856,9,200,102,98,2,30,1,1
11188,15,13382,11,502,310,192,9,31,6,3
10874,15,22687,11,72734,3432,69302,83,25,31,52
2724,1240,28466,920,422,164,258,6,30,3,3
22510,15,20810,11,1014,507,507,8,133,5,3
14323,1365,26167,1037,504,318,186,8,16,5,3
15153,10,20736,9,198,110,88,2,30,1,1
11480,26,26833,16,33131,9092,24039,41,15,19,22
354,10,1064,9,216,88,128,2,30,1,1
15385,10,24093,9,170,87,83,2,31,1,1
17214,26,16997,16,5168,700,4468,16,16,7,9
6382,26,4880,16,6172,1310,4862,28,468,10,18
9660,15,17783,11,502,256,246,9,25,5,4
7672,26,12385,16,5861,1151,4710,18,34,10,8
6315,26,7107,16,130,70,60,3,5,2,1
3726,26,22790,16,520306,17622,502684,582,210,210,372
14887,10,27718,9,443,182,261,6,31,3,3
14125,15,15976,11,186387,10616,175771,243,33,116,127
17119,104,26056,81,124,60,64,2,5,1,1
21180,594,6781,405,66,66,0,2,7,2,0
9413,15,11619,11,12364,548,11816,17,46,6,11
9349,183,21852,121,3343,1454,1889,15,16,8,7
8735,10,24629,9,181,94,87,2,31,1,1
15294,10,22697,9,185,102,83,2,30,1,1
18794,26,9580,16,10417,2617,7800,32,15,17,15
10987,2911,24755,2260,316,136,180,6,6,3,3
13801,10,23117,9,194,102,92,2,31,1,1
13949,26,4792,16,14364,4095,10269,33,404,13,20
10327,2684,10049,2084,322,149,173,2,1201,1,1
19675,10,14917,9,207,86,121,2,29,1,1
17896,26,577,16,5834,1810,4024,24,17,13,11
15523,26,393,16,4391,2171,2220,14,135,7,7
13658,26,15276,16,27629,9041,18588,88,271,46,42
14910,10,12992,9,199,102,97,2,30,1,1
15786,10,5624,9,199,102,97,2,30,1,1
13675,10,1348,9,174,89,85,2,31,1,1
22627,10,4256,9,102,102,0,1,30,1,0
10849,3021,7698,2349,66,66,0,2,8,2,0
10098,26,23795,16,469,403,66,4,0,3,1
17896,26,29071,16,18360,1734,16626,32,28,13,19
14183,10,4049,9,711,87,624,2,30,1,1
12051,26,9539,16,23929,10333,13596,51,43,25,26
4285,26,15159,16,14614,1935,12679,36,16,20,16
225,10,92,9,204,118,86,2,31,1,1
12452,42,23115,25,70,70,0,2,8,2,0
4588,26,6639,16,8824,2041,6783,34,255,17,17
21933,10,10568,9,216,102,114,2,30,1,1
13876,10,879,9,183,94,89,2,30,1,1
22555,10,4055,9,181,94,87,2,30,1,1
19665,15,21903,11,9747,537,9210,14,16,6,8
10371,486,27228,319,70,70,0,2,8,2,0
21241,10,15216,9,184,86,98,2,30,1,1
3148,10,13199,9,231,88,143,2,34,1,1
13227,26,11917,16,7372,1764,5608,27,547,15,12
21407,10,4661,9,179,94,85,2,30,1,1
22567,10,19855,9,184,94,90,2,31,1,1
7235,26,26697,16,6964,2091,4873,20,15,10,10
12431,183,23519,121,3504,1790,1714,17,31,9,8
5098,26,24976,16,90139,3545,86594,96,15,32,64
8908,10,28855,9,223,102,121,2,30,1,1
8916,15,24520,11,1788,628,1160,11,15,6,5
22263,10,27853,9,225,86,139,2,30,1,1
22345,10,27777,9,199,102,97,2,31,1,1
11042,15,17554,11,366,240,126,7,25,5,2
8470,26,5025,16,10844,5117,5727,42,17,25,17
9773,15,16848,11,1658,1247,411,8,15,5,3
3025,10,12543,9,216,90,126,2,30,1,1
18516,1115,22639,820,70,70,0,2,8,2,0
14994,10,3745,9,199,102,97,2,30,1,1
7679,40,1206,23,9725,3931,5794,46,48,25,21
5295,26,9273,16,65158,3519,61639,89,200,41,48
13410,26,19906,16,5907,2630,3277,21,147,10,11
15788,10,469,9,168,86,82,2,31,1,1
21478,10,19502,9,295,93,202,4,30,2,2
22459,10,14782,9,168,86,82,2,30,1,1
8348,10,6236,9,491,98,393,4,40,2,2
2744,1238,2037,918,876,126,750,2,30,1,1
12008,2912,576,2261,70,70,0,1,4,1,0
681,15,2703,11,450,246,204,8,31,5,3
9182,15,1292,11,825,685,140,6,33,4,2
22615,10,16819,9,210,110,100,2,31,1,1
2744,1240,5380,920,890,126,764,2,30,1,1
21189,2768,16328,2147,696,452,244,11,21,7,4
2744,1238,9948,918,871,126,745,2,31,1,1
15545,10,10219,9,177,94,83,2,30,1,1
12372,2287,21253,1772,70,70,0,2,7,2,0
2744,1239,7138,919,883,126,757,2,30,1,1
8584,1238,18533,918,227,71,156,2,30,1,1
1103,26,15117,16,5179,2934,2245,25,32,13,12
18853,26,5111,16,3364,1737,1627,15,360,8,7
13839,10,24256,9,200,102,98,2,33,1,1
4789,26,19956,16,4647,1536,3111,25,40,12,13
6135,10,7366,9,168,78,90,2,30,1,1
14852,10,25491,9,214,110,104,2,31,1,1
22339,10,14942,9,198,102,96,2,30,1,1
14715,10,27869,9,168,78,90,2,30,1,1
13672,26,12655,16,7232,2925,4307,27,16,16,11
18405,26,5995,16,54103,3190,50913,68,362,27,41
8498,26,15417,16,78663,4968,73695,85,47,24,61
10986,1837,10707,1398,70,70,0,2,8,2,0
14754,10,20637,9,265,85,180,4,41,2,2
15502,10,1748,9,170,87,83,2,30,1,1
16085,15,17205,11,32368,2187,30181,45,337,23,22
5957,15,17673,11,1484,877,607,11,34,6,5
22070,10,18199,9,172,88,84,2,30,1,1
9147,10,7123,9,211,110,101,2,31,1,1
8341,10,26488,9,199,102,97,2,33,1,1
22176,10,16664,9,197,102,95,2,30,1,1
2744,1241,27302,921,252,252,0,3,2,3,0
15972,10,15901,9,771,101,670,2,31,1,1
15899,10,24299,9,167,86,81,2,31,1,1
9177,10,3107,9,662,195,467,6,39,3,3
13373,26,24770,16,9215,3253,5962,51,22,25,26
9093,26,15218,16,2484,330,2154,12,136,5,7
17172,26,22694,16,342665,10261,332404,369,90,117,252
4729,233,23374,148,70,70,0,1,5,1,0
9331,26,14400,16,5419,1080,4339,17,42,10,7
4057,15,10660,11,841,715,126,5,15,3,2
12936,26,8000,16,26357358,863775,25493583,27347,208,8650,18697
8948,10,12106,9,228,86,142,2,30,1,1
3779,26,13758,16,77395,64623,12772,206,188,116,90
9644,10,22875,9,164,84,80,2,30,1,1
9967,26,21524,16,6337,1378,4959,19,140,9,10
9227,10,21800,9,240,96,144,2,30,1,1
17598,26,24280,16,4821,1882,2939,19,15,9,10
11825,15,23596,11,4266,1776,2490,20,367,11,9
21496,10,17551,9,197,102,95,2,30,1,1
18904,26,9933,16,134,60,74,3,6,2,1
3634,26,6521,16,6206,1695,4511,25,16,13,12
3066,1608,18795,1231,502,150,352,2,1200,1,1
2863,1990,24143,1520,253,190,63,2,30,1,1
22279,10,16238,9,93,93,0,2,60,2,0
4793,26,16291,16,4441,1534,2907,19,25,11,8
2744,1239,3381,919,898,126,772,2,31,1,1
9461,10,16429,9,753,94,659,2,29,1,1
6881,26,5827,16,11367,9355,2012,32,395,13,19
12563,2635,22201,2045,70,70,0,2,7,2,0
15928,10,14009,9,212,108,104,2,31,1,1
3371,10,28375,9,816,228,588,8,29,4,4
18110,26,13603,16,6053,2582,3471,30,80,15,15
10000,15,17323,11,12388,742,11646,18,130,7,11
21329,10,11039,9,193,102,91,2,30,1,1
11100,2863,10573,2222,316,136,180,6,7,3,3
8928,10,14210,9,184,94,90,2,30,1,1
14040,10,12154,9,211,102,109,2,30,1,1
16038,26,24231,16,1778,1219,559,13,26,8,5
20112,26,19320,16,4427,2362,2065,11,119,6,5
20565,10,17570,9,304,86,218,2,30,1,1
22112,10,5215,9,199,102,97,2,29,1,1
19330,26,19609,16,1401,940,461,11,29,7,4
9153,10,10953,9,346,111,235,2,30,1,1
12370,1739,4701,1327,70,70,0,1,5,1,0
9418,10,27215,9,210,110,100,2,30,1,1
15421,10,19597,9,196,102,94,2,30,1,1
14359,1812,16542,1382,70,70,0,2,8,2,0
9728,281,26247,178,371,311,60,4,1199,3,1
13139,26,12527,16,18744,10266,8478,44,35,21,23
14560,10,28921,9,752,93,659,2,31,1,1
13362,26,13815,16,225732,7330,218402,246,174,86,160
9013,10,20881,9,325,126,199,2,30,1,1
11079,2690,9599,2089,70,70,0,1,5,1,0
7128,26,24418,16,36062,4663,31399,87,33,41,46
16330,183,25602,121,3347,1458,1889,15,18,8,7
12384,280,27132,177,492,306,186,8,14,5,3
15583,15,18553,11,214,140,74,4,30,3,1
14790,10,13160,9,211,110,101,2,31,1,1
21469,10,4864,9,172,88,84,2,30,1,1
5987,26,6761,16,29513,23962,5551,40,121,24,16
10327,967,4020,715,7308,6812,496,71,3243,63,8
15375,1,2250,1,70,70,0,2,8,2,0
3608,10,15547,9,225,78,147,2,30,1,1
1826,10,6485,9,199,94,105,2,30,1,1
14917,10,21167,9,816,102,714,2,30,1,1
11095,15,19464,11,692,300,392,9,26,6,3
15418,10,25584,9,177,94,83,2,30,1,1
16951,255,25970,160,130,66,64,2,4,1,1
16108,26,12207,16,3595,1957,1638,17,361,9,8
15518,15,10340,11,214,140,74,4,30,3,1
18238,26,21461,16,178,118,60,2,15,1,1
5661,26,9847,16,600,156,444,8,25,2,6
7109,26,28328,16,5959,169,5790,10,121,3,7
2046,1585,28440,1215,481,150,331,2,1200,1,1
6961,26,5954,16,7389,2124,5265,26,316,12,14
15646,10,20467,9,184,94,90,2,30,1,1
3706,26,4774,16,120,60,60,3,4,2,1
21245,10,13033,9,192,90,102,2,31,1,1
9728,2031,20190,1559,868,150,718,4,1200,2,2
14961,10,15676,9,177,94,83,2,30,1,1
12771,1305,23228,983,70,70,0,1,5,1,0
11186,839,21321,618,70,70,0,2,7,2,0
4835,2217,16881,1718,158,158,0,1,1199,1,0
22574,10,18269,9,267,94,173,2,30,1,1
225,10,6748,9,204,118,86,2,30,1,1
8933,10,20212,9,200,102,98,2,31,1,1
8724,10,20583,9,184,94,90,2,30,1,1
15741,10,12064,9,305,86,219,2,31,1,1
18050,26,18331,16,11836,3531,8305,37,121,19,18
20667,26,22244,16,4462,2023,2439,33,125,17,16
12382,1744,20454,1332,672,426,246,11,21,7,4
20651,26,28102,16,9324,4240,5084,24,16,13,11
14511,26,20524,16,4819,2304,2515,16,135,8,8
11082,15,28704,11,2188,593,1595,11,16,5,6
15197,10,2455,9,340,107,233,4,30,2,2
14348,26,13952,16,2494,719,1775,9,120,5,4
8908,26,13729,16,4490,750,3740,16,128,8,8
9282,26,18508,16,8464,2699,5765,48,147,26,22
1759,10,6552,9,244,98,146,2,31,1,1
19358,26,18673,16,6205,1125,5080,23,89,13,10
7455,10,20091,9,220,90,130,2,30,1,1
10936,26,14574,16,5685,1179,4506,18,29,10,8
13328,26,8504,16,12094,4159,7935,21,135,10,11
4646,26,22697,16,13836,6371,7465,34,23,20,14
15939,10,6315,9,969,86,883,2,30,1,1
1686,26,6128,16,16960,1347,15613,28,17,10,18
2172,503,23857,331,478,149,329,2,1200,1,1
17937,26,27319,16,306,180,126,6,29,4,2
22594,10,22396,9,178,94,84,2,30,1,1
15541,15,19160,11,53181,50384,2797,75,20,39,36
17130,1392,5581,1059,1806,1806,0,22,224,22,0
21585,10,5552,9,226,110,116,2,30,1,1
3956,26,19059,16,5505,995,4510,20,255,11,9
20802,10,28208,9,223,86,137,2,30,1,1
14081,10,27017,9,193,102,91,2,30,1,1
12473,2627,5435,2037,70,70,0,2,7,2,0
8548,10,28504,9,230,102,128,2,29,1,1
13737,26,16016,16,5556,1438,4118,22,196,12,10
21083,2828,25516,2195,3706,2125,1581,18,33,10,8
15331,10,5758,9,167,86,81,2,30,1,1
18429,26,13446,16,14484,7411,7073,26,60,15,11
4403,26,15795,16,4699,1792,2907,19,30,11,8
22713,10,16170,9,183,94,89,2,30,1,1
8622,26,19323,16,939,547,392,11,27,5,6
8793,10,25340,9,288,110,178,2,31,1,1
3684,26,25875,16,4880,3216,1664,29,79,15,14
17536,10,20570,9,285,106,179,2,31,1,1
18490,3094,1170,2403,70,70,0,2,8,2,0
7170,26,4933,16,9276,2422,6854,25,186,14,11
14411,10,5601,9,755,93,662,2,31,1,1
21419,10,7131,9,301,108,193,4,49,2,2
9444,10,9315,9,172,94,78,2,30,1,1
2131,10,23048,9,428,78,350,2,31,1,1
14303,10,21094,9,198,102,96,2,30,1,1
11179,2672,4036,2078,70,70,0,1,5,1,0
15484,10,8986,9,170,87,83,2,30,1,1
13913,10,16373,9,318,91,227,4,33,2,2
22016,15,9184,11,22646,1660,20986,29,135,10,19
3644,26,11010,16,6107,2012,4095,18,25,10,8
18523,2769,17700,2148,70,70,0,2,8,2,0
22630,10,23710,9,168,86,82,2,30,1,1
18476,2185,19130,1690,70,70,0,2,8,2,0
6596,10,29118,9,241,78,163,2,30,1,1
8379,1907,9381,1457,70,70,0,1,5,1,0
7869,26,13003,16,684,140,544,11,165,3,8
2744,1627,2459,1249,883,126,757,2,31,1,1
17860,26,5083,16,384,166,218,2,30,1,1
8889,10,3918,9,209,110,99,2,30,1,1
12506,15,1173,11,3741,3008,733,16,15,10,6
1909,1326,23693,1002,491,150,341,2,1200,1,1
9058,26,371,16,8633,2099,6534,29,35,15,14
21577,10,20094,9,273,90,183,4,32,2,2
20298,10,10812,9,184,86,98,2,30,1,1
16021,1796,13403,1370,132,132,0,3,1199,3,0
18479,2870,27409,2229,70,70,0,2,8,2,0
4118,15,21277,11,1155,781,374,10,15,6,4
21506,10,11306,9,199,102,97,2,30,1,1
14290,10,19934,9,212,102,110,2,30,1,1
18868,26,27022,16,8578,2549,6029,22,16,13,9
9459,15,4286,11,1030,310,720,11,56,6,5
21219,183,28426,121,3364,1714,1650,15,32,8,7
8868,15,1782,11,71256,962,70294,63,52,11,52
12623,26,8110,16,499,425,74,4,0,3,1
10089,15,26120,11,5533225,44880,5488345,4345,78,654,3691
14319,741,25857,532,70,70,0,2,8,2,0
9144,10,10924,9,152,78,74,2,30,1,1
9728,381,18576,245,1356,300,1056,6,1200,3,3
11791,26,15123,16,501046,7967,493079,419,118,69,350
13625,26,8455,16,13124,8442,4682,40,43,24,16
22633,10,19386,9,262,102,160,2,29,1,1
21935,10,4975,9,229,110,119,2,30,1,1
9406,10,19267,9,168,86,82,2,30,1,1
4966,15,7652,11,1678,1364,314,10,16,5,5
22209,10,21912,9,214,94,120,2,30,1,1
18475,583,9712,395,70,70,0,2,8,2,0
7434,26,20952,16,70,70,0,1,5,1,0
15964,10,26124,9,195,102,93,2,33,1,1
15395,902,19228,666,316,136,180,6,6,3,3
14555,10,22323,9,733,86,647,2,30,1,1
8989,10,1689,9,392,88,304,4,53,2,2
21765,10,25570,9,214,110,104,2,30,1,1
16000,10,5467,9,198,94,104,2,29,1,1
12610,2967,14391,2303,684,432,252,10,19,6,4
4697,26,9208,16,6506,1356,5150,24,16,14,10
21256,10,22107,9,200,102,98,2,30,1,1
15435,2554,16157,1984,70,70,0,2,8,2,0
14968,10,3527,9,182,93,89,2,31,1,1
9776,26,27287,16,10084,2145,7939,36,120,18,18
15014,10,14520,9,193,102,91,2,30,1,1
225,10,24159,9,204,118,86,2,31,1,1
14279,10,13370,9,198,101,97,2,30,1,1
22359,10,3176,9,295,103,192,4,48,2,2
8513,10,19114,9,164,78,86,2,31,1,1
8747,15,26115,11,2339,1107,1232,11,21,6,5
3454,10,14235,9,168,78,90,2,30,1,1
7185,26,19471,16,9535,3495,6040,18,121,10,8
7309,10,25853,9,164,78,86,2,30,1,1
8831,10,27857,9,289,99,190,4,35,2,2
17293,26,12876,16,2687,1593,1094,20,20,11,9
10863,2410,11155,1875,70,70,0,2,6,2,0
22421,10,5641,9,168,86,82,2,30,1,1
22440,10,5709,9,484,102,382,4,36,2,2
16632,26,27024,16,14898,12644,2254,32,316,18,14
9286,10,4194,9,183,94,89,2,30,1,1
7052,26,9435,16,17760,13913,3847,54,167,25,29
17170,26,19782,16,1411,921,490,12,15,7,5
16127,26,5818,16,7037,1786,5251,23,200,13,10
14449,10,5846,9,177,94,83,2,30,1,1
8185,10,21156,9,227,90,137,2,30,1,1
5876,10,3326,9,168,78,90,2,30,1,1
13838,10,2066,9,178,94,84,2,31,1,1
14460,10,10481,9,711,87,624,2,30,1,1
21850,10,23126,9,387,134,253,2,29,1,1
4903,26,28114,16,497663,22937,474726,585,38,245,340
16119,26,24652,16,9273,2712,6561,50,615,25,25
8330,10,11518,9,167,86,81,2,31,1,1
17136,26,22401,16,12230,8144,4086,33,17,18,15
15139,26,8074,16,4528,884,3644,15,26,9,6
9070,26,6598,16,6754,2219,4535,21,77,11,10
21874,183,28738,121,3327,1438,1889,15,17,8,7
9380,15,12674,11,2388,1066,1322,16,135,8,8
3338,26,9672,16,4446,1298,3148,15,34,8,7
14543,10,25942,9,177,94,83,2,30,1,1
15512,10,11489,9,216,110,106,2,30,1,1
14321,26,24546,16,23467,2707,20760,45,80,21,24
21497,10,2419,9,211,102,109,2,30,1,1
15176,26,3764,16,7889,1900,5989,20,15,11,9
13299,26,23969,16,13490,2525,10965,30,18,17,13
8874,15,25072,11,179277,5324,173953,171,108,49,122
13576,15,28300,11,1992,1350,642,10,15,5,5
22050,10,17642,9,213,102,111,2,30,1,1
8767,10,13672,9,178,94,84,2,30,1,1
11348,26,28693,16,294025,14919,279106,401,42,192,209
14667,10,1955,9,195,102,93,2,30,1,1
15208,10,26739,9,197,102,95,2,30,1,1
532,247,0,0,3562,1936,1626,48,194,24,24
22129,10,17762,9,194,94,100,2,30,1,1
6154,26,7987,16,5164,2984,2180,42,1285,26,16
8784,10,10492,9,774,101,673,2,30,1,1
22191,1264,27176,944,735,462,273,2,30,1,1
18483,26,6732,16,7330,1565,5765,20,134,10,10
14087,10,17609,9,193,102,91,2,29,1,1
16021,280,14133,177,792,792,0,13,1200,13,0
3122,10,13083,9,213,79,134,2,32,1,1
10270,26,23507,16,3155111,84086,3071025,3163,75,1072,2091
13845,10,3102,9,214,110,104,2,30,1,1
12174,15,11018,11,3096,1001,2095,12,150,7,5
14041,10,15233,9,326,102,224,2,29,1,1
22696,10,27868,9,177,94,83,2,30,1,1
6250,1989,18134,1519,1082,86,996,2,31,1,1
9275,26,6869,16,15168,5689,9479,51,34,27,24
2724,1240,10995,920,422,164,258,6,30,3,3
4795,26,23774,16,3595,1468,2127,13,135,6,7
21496,10,12955,9,321,99,222,4,52,2,2
21947,10,7537,9,214,110,104,2,30,1,1
3975,10,15093,9,240,98,142,2,30,1,1
22224,10,11001,9,473,105,368,4,30,2,2
9177,10,2757,9,199,102,97,2,30,1,1
8503,15,5727,11,3060,1219,1841,11,19,7,4
20541,26,13025,16,2928239,68426,2859813,2888,37,955,1933
5131,26,4217,16,90545,3481,87064,96,16,31,65
15909,10,12646,9,196,102,94,2,31,1,1
6680,15,18995,11,2132,997,1135,14,20,8,6
15665,15,16540,11,819,530,289,8,40,5,3
8385,232,19205,147,85080,31769,53311,661,1172,305,356
9728,2773,665,2152,1275,300,975,6,1200,3,3
21859,10,23252,9,226,102,124,2,30,1,1
896,15,8511,11,318,192,126,6,30,4,2
3403,26,10014,16,7579,3093,4486,25,21,14,11
2744,1238,10645,918,887,126,761,2,30,1,1
14455,26,11030,16,10087,3968,6119,32,271,17,15
15920,10,9356,9,178,94,84,2,30,1,1
16911,26,27330,16,8605,3169,5436,19,17,12,7
3372,10,17957,9,168,78,90,2,30,1,1
16220,26,15540,16,3150,1709,1441,26,276,13,13
12734,162,1365,112,70,70,0,2,8,2,0
4104,26,14470,16,938,576,362,14,27,9,5
12551,15,2359,11,2391,532,1859,11,75,6,5
16008,26,22938,16,6990,2193,4797,15,120,7,8
13958,10,15067,9,166,85,81,2,30,1,1
13659,10,28669,9,183,94,89,2,30,1,1
15333,10,5907,9,165,86,79,2,30,1,1
14000,10,5666,9,190,97,93,2,31,1,1
10850,15,4788,11,366,240,126,7,25,5,2
13192,15,9876,11,1596,511,1085,10,15,5,5
8396,10,24132,9,178,94,84,2,29,1,1
10030,26,385,16,6883,1378,5505,19,128,9,10
9258,10,7158,9,734,94,640,2,30,1,1
14294,10,21210,9,728,96,632,2,30,1,1
22546,10,24440,9,351,105,246,4,57,2,2
15078,10,26844,9,199,102,97,2,30,1,1
21499,10,2704,9,211,102,109,2,29,1,1
15694,10,10899,9,168,78,90,2,30,1,1
2724,1240,28951,920,422,164,258,6,30,3,3
6053,26,15727,16,1307513,51701,1255812,1486,148,576,910
8536,26,28037,16,6277395,184853,6092542,6543,317,2262,4281
22597,10,245,9,102,102,0,1,60,1,0
3845,15,70,11,2989,813,2176,15,166,8,7
8210,2518,21194,1957,490,149,341,2,1200,1,1
8619,10,1439,9,763,101,662,2,31,1,1
17950,26,5229,16,5520,3416,2104,27,22,13,14
8895,10,24454,9,210,102,108,2,30,1,1
6489,26,14666,16,6513,2043,4470,20,17,12,8
21719,10,11209,9,168,86,82,2,31,1,1
9401,10,11352,9,199,102,97,2,30,1,1
14647,10,9218,9,289,160,129,3,29,2,1
7050,10,22650,9,198,93,105,2,31,1,1
18775,1989,16679,1519,316,136,180,6,5,3,3
21053,783,5226,568,312,132,180,6,6,3,3
22298,10,2770,9,197,102,95,2,30,1,1
18134,26,5135,16,6194,1289,4905,23,66,12,11
3833,26,11394,16,100090,8304,91786,135,127,50,85
5071,26,19105,16,3448,1619,1829,18,18,8,10
11074,253,7598,158,70,70,0,2,8,2,0
8122,10,11611,9,78,78,0,1,30,1,0
15735,10,12980,9,322,110,212,4,31,2,2
9762,26,17019,16,11054,1724,9330,28,91,15,13
6947,15,19350,11,1916,1467,449,10,20,6,4
12443,2429,18356,1890,618,432,186,9,17,6,3
14409,10,5707,9,193,102,91,2,30,1,1
18017,15,1090,11,2025658,45348,1980310,1992,44,640,1352
22191,10,17218,9,90,90,0,1,31,1,0
19982,26,28720,16,598,598,0,8,41,8,0
12116,10,12689,9,205,86,119,2,29,1,1
15349,26,2107,16,7889,1900,5989,20,15,11,9
10049,15,25429,11,11626518,135099,11491419,9627,134,1907,7720
9483,15,3800,11,2668,870,1798,13,47,7,6
9063,26,597,16,26284,21857,4427,72,83,39,33
18820,923,17655,681,70,70,0,2,8,2,0
17247,26,28062,16,5166,700,4466,16,15,7,9
8598,15,23129,11,2231,899,1332,15,92,8,7
22404,10,2698,9,216,110,106,2,30,1,1
8090,349,5255,222,78,78,0,1,5,1,0
12786,37,23548,22,70,70,0,2,8,2,0
15724,10,0,0,198,91,107,2,30,1,1
21145,744,2207,535,70,70,0,1,4,1,0
4478,26,15419,16,7557,3602,3955,20,150,12,8
10222,26,20814,16,5220,3063,2157,14,135,7,7
1166,1983,4612,1513,156,94,62,2,30,1,1
9293,10,23360,9,448,184,264,6,31,3,3
7951,26,10116,16,7936,2847,5089,15,120,7,8
19250,26,5731,16,1786,172,1614,7,120,3,4
5543,26,12829,16,2674,1386,1288,17,120,8,9
10025,26,10496,16,9452,1832,7620,20,130,10,10
21572,10,14936,9,184,94,90,2,31,1,1
8797,10,28588,9,198,102,96,2,33,1,1
22057,10,13035,9,443,182,261,6,30,3,3
14852,26,20558,16,101747,13436,88311,135,319,53,82
18525,15,17347,11,1588,553,1035,10,75,6,4
12805,2790,27286,2165,70,70,0,1,5,1,0
6521,10,4611,9,194,86,108,2,30,1,1
11523,878,13790,647,492,216,276,2,31,1,1
22168,10,12204,9,322,84,238,4,36,2,2
532,247,0,0,3498,1872,1626,48,199,24,24
14901,10,13939,9,183,94,89,2,30,1,1
7482,26,12848,16,359878,6703,353175,325,36,88,237
10278,26,23898,16,13072,4708,8364,47,130,24,23
9155,10,4939,9,198,102,96,2,30,1,1
13698,26,29107,16,14427,4574,9853,34,61,18,16
18729,15,5034,11,144,78,66,2,5,1,1
2351,26,9694,16,5802,2592,3210,24,76,14,10
8876,26,28424,16,7691,1797,5894,22,137,12,10
22013,10,2945,9,184,94,90,2,30,1,1
15198,26,10427,16,8963,2190,6773,18,138,8,10
10878,26,6817,16,5788,3446,2342,22,135,11,11
14712,10,13281,9,172,88,84,2,31,1,1
15313,10,26060,9,198,102,96,2,30,1,1
1013,26,4358,16,3599,566,3033,15,15,8,7
8210,590,21194,401,787,296,491,4,1200,2,2
9388,10,21874,9,260,106,154,2,32,1,1
15909,10,2959,9,196,102,94,2,29,1,1
22426,26,22715,16,35968,13816,22152,77,96,34,43
8710,10,13150,9,226,86,140,2,30,1,1
17601,26,27025,16,9052,2120,6932,28,23,14,14
14456,10,2370,9,177,94,83,2,30,1,1
13660,10,2755,9,711,87,624,2,30,1,1
8845,10,2648,9,166,86,80,2,31,1,1
18979,26,24334,16,11535,4866,6669,34,50,20,14
13678,26,2686,16,6986,1578,5408,26,25,15,11
16004,10,11735,9,177,94,83,2,29,1,1
15187,10,6276,9,274,87,187,4,30,2,2
16970,10,7074,9,167,78,89,2,31,1,1
10562,26,23136,16,626132,21332,604800,730,33,294,436
15251,10,16961,9,178,94,84,2,31,1,1
18526,288,9702,185,164,70,94,3,8,2,1
19515,15,20170,11,5108,676,4432,14,15,7,7
14677,15,22279,11,5302,704,4598,14,18,8,6
13706,10,89,9,198,102,96,2,30,1,1
6089,26,13723,16,232,172,60,3,4,2,1
4283,15,15613,11,1920,1471,449,10,20,6,4
22038,18,15775,13,184,94,90,2,30,1,1
14760,10,18333,9,204,104,100,2,30,1,1
7801,26,11737,16,350,210,140,6,15,4,2
21666,10,28682,9,172,88,84,2,31,1,1
10810,978,3821,724,70,70,0,2,8,2,0
13648,10,20367,9,747,90,657,2,30,1,1
10864,1481,29066,1127,70,70,0,2,7,2,0
14291,919,26549,679,70,70,0,2,8,2,0
18154,26,25861,16,3195,1426,1769,15,141,8,7
18630,26,9739,16,5994,1594,4400,23,42,12,11
21510,10,10003,9,181,94,87,2,33,1,1
8045,15,20280,11,130,70,60,2,15,1,1
7927,26,1477,16,512466,48982,463484,912,124,446,466
4590,15,22328,11,234,234,0,4,12,4,0
6253,26,18590,16,449862,38989,410873,644,280,286,358
18513,2900,9523,2252,70,70,0,2,8,2,0
14936,26,14349,16,3734,1750,1984,24,203,12,12
15803,10,5112,9,183,94,89,2,30,1,1
13726,10,25604,9,701,88,613,2,30,1,1
8820,6,21598,6,7791,3373,4418,54,36,26,28
13840,10,19045,9,195,102,93,2,30,1,1
5395,15,17018,11,2898,1485,1413,10,15,6,4
18099,26,4084,16,1571,660,911,13,18,7,6
22638,10,21800,9,277,102,175,2,29,1,1
22247,10,21388,9,173,94,79,2,31,1,1
22498,10,27192,9,209,110,99,2,30,1,1
9728,10,18739,9,174,89,85,2,31,1,1
5649,26,3478,16,15367456,244322,15123134,12866,268,1819,11047
4311,26,27136,16,3777,1509,2268,18,120,9,9
9728,1500,9167,1140,1356,300,1056,6,1200,3,3
2656,15,11122,11,225609,13986,211623,285,31,134,151
9411,2827,10455,2194,481,150,331,2,1200,1,1
14753,15,4149,11,2670,799,1871,13,46,8,5
17189,676,13788,475,138,78,60,2,6,1,1
16516,15,17062,11,5571,2637,2934,23,75,12,11
4433,26,10880,16,9381,1457,7924,21,31,11,10
1090,26,25868,16,8533,1544,6989,22,30,11,11
6206,15,18250,11,2941,1499,1442,10,16,6,4
8392,10,26525,9,295,101,194,4,49,2,2
9196,10,8858,9,179,94,85,2,30,1,1
8945,26,12644,16,10057,1887,8170,23,126,12,11
7506,26,2961,16,87129,6924,80205,126,258,49,77
10157,26,14185,16,2227,1018,1209,17,16,8,9
15151,26,6811,16,14284,5729,8555,31,61,19,12
18432,26,13125,16,12859,2557,10302,25,80,10,15
6612,15,13332,11,1352,848,504,13,255,8,5
18207,23,0,0,8215,3237,4978,30,30,15,15
22518,10,25186,9,216,110,106,2,29,1,1
22101,10,7920,9,718,94,624,2,30,1,1
9263,10,12607,9,969,86,883,2,30,1,1
11118,15,23088,11,3442,1728,1714,15,21,9,6
15663,10,17020,9,198,102,96,2,30,1,1
3880,10,22665,9,168,78,90,2,30,1,1
22565,10,17545,9,376,102,274,4,47,2,2
3348,10,20491,9,168,78,90,2,30,1,1
5966,26,12890,16,4370,1148,3222,17,25,9,8
8927,10,15645,9,373,99,274,4,41,2,2
8650,10,20782,9,742,88,654,2,31,1,1
15558,10,11185,9,916,86,830,2,30,1,1
7695,26,29057,16,2809,1884,925,19,24,11,8
4835,2577,4095,1999,158,158,0,1,1199,1,0
8757,10,23805,9,408,86,322,4,31,2,2
21282,1931,24540,1475,66,66,0,1,5,1,0
21351,10,7458,9,353,118,235,2,30,1,1
15904,26,17254,16,3889,1296,2593,11,120,6,5
9663,26,28275,16,16215,1368,14847,36,77,12,24
14021,10,14346,9,212,102,110,2,30,1,1
10137,15,22286,11,450,246,204,8,25,5,3
13863,10,16930,9,210,102,108,2,30,1,1
15178,10,4357,9,174,89,85,2,31,1,1
5129,26,6321,16,90097,3289,86808,93,15,28,65
18133,23,28705,15,2800,2800,0,28,111,28,0
4693,26,19831,16,11038,3875,7163,33,16,18,15
11610,26,15383,16,5382,1353,4029,19,135,10,9
10970,1212,1488,897,66,66,0,1,5,1,0
8990,10,13418,9,168,86,82,2,29,1,1
14682,10,21810,9,271,88,183,4,38,2,2
9307,10,22102,9,776,102,674,2,30,1,1
14205,15,19169,11,70,70,0,1,5,1,0
21809,26,2265,16,24686,1935,22751,36,20,17,19
21730,26,19949,16,2872,717,2155,14,135,6,8
142,15,304,11,87958,5378,82580,100,95,39,61
8457,10,22191,9,184,94,90,2,30,1,1
8460,10,14919,9,382,95,287,4,48,2,2
21126,1258,15367,938,1130,924,206,5,30,3,2
21989,10,27772,9,214,110,104,2,31,1,1
15233,10,22695,9,177,94,83,2,30,1,1
13917,10,24649,9,198,110,88,2,30,1,1
9427,26,4273,16,25811,4278,21533,73,100,38,35
16125,15,25456,11,144228,2522,141706,135,144,36,99
6280,26,28308,16,1970,1231,739,14,30,8,6
3627,26,15088,16,5241,860,4381,17,15,9,8
7227,15,20976,11,1638,1324,314,10,15,5,5
9511,10,9253,9,578,286,292,9,15,5,4
8330,10,10105,9,166,85,81,2,30,1,1
17655,10,14487,9,179,86,93,2,30,1,1
22163,10,21841,9,402,118,284,2,30,1,1
21352,10,24173,9,199,94,105,2,30,1,1
6758,26,11373,16,7552,2611,4941,24,360,13,11
19843,26,12613,16,505589,13504,492085,462,345,91,371
12121,26,17613,16,69742,34581,35161,105,63,52,53
17116,26,25233,16,5168,700,4468,16,15,7,9
21799,10,19793,9,183,94,89,2,30,1,1
11251,26,27665,16,4567,717,3850,17,148,7,10
22484,183,29034,121,3409,1454,1955,16,16,8,8
14522,10,4452,9,199,102,97,2,30,1,1
21912,10,20623,9,785,110,675,2,30,1,1
4233,15,15521,11,514,246,268,9,76,5,4
8753,26,25614,16,5879,870,5009,18,53,9,9
8413,10,10149,9,779,86,693,2,30,1,1
8671,10,20240,9,232,110,122,2,30,1,1
16511,15,21597,11,3518,1780,1738,12,20,7,5
4073,26,28609,16,3221,705,2516,15,135,7,8
8643,10,1665,9,178,94,84,2,31,1,1
9583,26,24493,16,73712,18850,54862,135,717,61,74
15252,26,10141,16,7941,1952,5989,20,15,11,9
7944,26,28642,16,70,70,0,2,5,2,0
11389,10,0,0,138,69,69,2,30,1,1
2724,1240,5120,920,422,164,258,6,29,3,3
22622,10,29106,9,262,106,156,2,31,1,1
3813,26,21079,16,10207,3126,7081,26,24,14,12
17771,10,14067,9,290,102,188,2,30,1,1
14226,2089,10979,1610,70,70,0,2,8,2,0
6906,104,19271,81,150,60,90,2,9,1,1
21371,26,28498,16,5661,2415,3246,26,160,14,12
11127,1064,332,783,70,70,0,1,5,1,0
18657,10,26894,9,832,106,726,2,30,1,1
9090,10,21606,9,176,90,86,2,31,1,1
22375,10,1313,9,211,102,109,2,30,1,1
839,26,4460,16,49938,20855,29083,165,216,81,84
15348,26,22546,16,7941,1952,5989,20,15,11,9
22516,10,23402,9,247,118,129,2,30,1,1
8212,10,21345,9,168,78,90,2,30,1,1
22578,10,3517,9,221,94,127,2,30,1,1
1412,10,4897,9,214,82,132,2,33,1,1
15427,10,15742,9,762,101,661,2,31,1,1
8584,1238,6483,918,248,78,170,2,30,1,1
2026,10,7933,9,235,90,145,2,33,1,1
14912,10,10285,9,711,87,624,2,30,1,1
0,0,0,0,320,320,0,5,0,5,0
14793,10,9019,9,751,95,656,2,30,1,1
22264,10,5480,9,168,94,74,2,30,1,1
15537,10,22310,9,174,89,85,2,31,1,1
18399,298,26755,193,6127,4018,2109,19,17,11,8
1673,341,11184,217,212,150,62,2,31,1,1
16600,26,25768,16,4526,1619,2907,19,26,11,8
5058,15,27871,11,1289,303,986,12,16,5,7
15490,10,20621,9,188,96,92,2,31,1,1
12146,26,22357,16,8715,1814,6901,26,29,15,11
22498,10,7628,9,209,110,99,2,30,1,1
22389,10,18711,9,733,85,648,2,31,1,1
15076,10,17041,9,199,102,97,2,30,1,1
4097,10,15290,9,220,90,130,2,29,1,1
14900,10,15352,9,183,94,89,2,31,1,1
10631,10,22561,9,219,92,127,2,30,1,1
21270,15,17013,11,314,192,122,6,15,4,2
871,26,15693,16,6240,1399,4841,24,44,12,12
2724,1240,6034,920,422,164,258,6,29,3,3
12646,26,5397,16,499,425,74,4,0,3,1
15585,10,5498,9,230,86,144,2,29,1,1
2744,81,26159,63,865,126,739,2,30,1,1
13942,26,23978,16,9881,1486,8395,22,200,12,10
8904,26,22999,16,3085,1404,1681,15,15,7,8
11307,26,24191,16,7196,1791,5405,18,31,11,7
12081,26,19972,16,35788,2073,33715,54,21,20,34
15178,10,10868,9,1400,97,1303,4,57,2,2
6339,26,12766,16,190565,9979,180586,272,244,140,132
15852,10,14984,9,448,184,264,6,30,3,3
10002,234,1367,149,7069,1804,5265,20,3602,11,9
8977,10,16285,9,195,86,109,2,30,1,1
18862,26,7211,16,64658,47775,16883,115,16,63,52
21941,10,5523,9,770,102,668,2,30,1,1
15268,26,20493,16,7862,1873,5989,20,16,11,9
11924,26,595,16,9625,3512,6113,41,92,21,20
8095,26,998,16,115036,11567,103469,189,103,92,97
16021,94,4415,73,132,132,0,3,1199,3,0
12998,26,16556,16,195229,13204,182025,270,124,102,168
17198,26,4377,16,5108,700,4408,15,15,7,8
17928,26,12945,16,1560,977,583,15,30,8,7
636,1730,16865,1321,228,118,110,2,1200,1,1
14199,10,2637,9,889,404,485,10,30,5,5
22661,10,19518,9,209,110,99,2,30,1,1
4035,232,7300,147,10854,4776,6078,80,119,41,39
22196,10,2812,9,196,102,94,2,31,1,1
14728,10,8144,9,167,86,81,2,30,1,1
8391,10,13436,9,177,94,83,2,30,1,1
9452,15,18458,11,3179,863,2316,13,57,7,6
20579,26,24707,16,4609,2177,2432,11,120,6,5
4761,26,5273,16,7660,2239,5421,32,255,16,16
10842,26,24338,16,10741,7368,3373,32,135,16,16
10003,10,21217,9,86,86,0,1,30,1,0
14278,10,16982,9,179,94,85,2,29,1,1
17790,26,22238,16,562,562,0,4,175,4,0
18320,15,17436,11,21505,6581,14924,31,149,14,17
19681,26,11994,16,81136,7785,73351,109,131,40,69
11017,1056,26562,777,70,70,0,2,8,2,0
4926,10,16434,9,210,98,112,2,29,1,1
5986,26,4790,16,10024,6237,3787,22,27,11,11
14138,10,27423,9,198,101,97,2,1,1,1
12583,1096,19485,804,70,70,0,1,4,1,0
21729,10,19637,9,198,101,97,2,30,1,1
14397,10,3801,9,177,94,83,2,30,1,1
2724,1240,118,920,422,164,258,6,30,3,3
22033,10,1912,9,190,97,93,2,31,1,1
12355,15,14424,11,16965052,382638,16582414,16619,61,5458,11161
8146,26,23937,16,10802,2841,7961,29,21,14,15
5606,1997,28910,1527,150,88,62,2,30,1,1
15070,15,13344,11,74105,3416,70689,84,135,32,52
15424,1088,3934,798,66,66,0,1,5,1,0
22219,10,3127,9,312,94,218,2,30,1,1
2744,1238,24222,918,1666,126,1540,4,31,2,2
14735,10,779,9,184,94,90,2,31,1,1
8509,10,707,9,200,102,98,2,30,1,1
15348,10,2374,9,735,88,647,2,30,1,1
3862,10,14942,9,231,90,141,2,30,1,1
21945,10,19140,9,196,102,94,2,31,1,1
4190,10,15437,9,227,89,138,2,31,1,1
8648,10,26199,9,196,94,102,2,30,1,1
22438,10,20043,9,198,101,97,2,31,1,1
22037,10,13235,9,214,110,104,2,30,1,1
6335,10,18444,9,262,106,156,2,32,1,1
171,10,27926,9,210,78,132,2,30,1,1
10684,15,6912,11,312,192,120,6,37,4,2
17594,26,29094,16,3730,1956,1774,16,15,8,8
9010,26,21684,16,4693,1786,2907,19,27,11,8
8312,26,2412,16,3062,1747,1315,17,16,9,8
15288,26,12321,16,373053,9725,363328,374,45,129,245
17970,26,26360,16,2165,987,1178,17,40,8,9
22110,10,5130,9,266,110,156,2,30,1,1
11648,26,7625,16,266282,13744,252538,313,374,128,185
10820,2384,25023,1852,70,70,0,1,5,1,0
8908,10,6847,9,216,110,106,2,30,1,1
10229,15,15808,11,1614,1300,314,10,15,5,5
21859,10,24062,9,351,93,258,4,50,2,2
8850,10,19494,9,265,110,155,2,30,1,1
22348,10,9431,9,822,102,720,2,29,1,1
15252,10,20638,9,200,102,98,2,30,1,1
16506,26,1220,16,8930,1529,7401,21,19,9,12
14926,10,2361,9,199,102,97,2,31,1,1
5234,26,5807,16,1017,705,312,9,20,4,5
14079,10,5243,9,177,94,83,2,30,1,1
18113,26,26901,16,4275,1488,2787,17,143,9,8
9666,26,5004,16,13347,4662,8685,40,202,24,16
22577,10,21600,9,197,102,95,2,33,1,1
6794,26,23917,16,5498,3406,2092,28,95,16,12
15102,10,26810,9,182,102,80,2,31,1,1
17963,15,19536,11,307815,6418,301397,285,63,84,201
8539,10,7243,9,216,110,106,2,31,1,1
17882,10,9803,9,304,86,218,2,30,1,1
2744,1238,11170,918,1664,126,1538,4,30,2,2
16021,94,19359,73,594,594,0,10,1199,10,0
13714,10,9557,9,195,102,93,2,30,1,1
7571,26,4813,16,26724,2570,24154,52,42,26,26
20560,26,17064,16,448,166,282,2,31,1,1
15979,26,688,16,10222,4415,5807,26,15,11,15
9844,15,1422,11,417,417,0,4,9,4,0
19025,10,27104,9,180,82,98,2,30,1,1
6016,232,22297,147,208,60,148,4,14,2,2
14151,10,3461,9,186,95,91,2,30,1,1
18551,2713,28610,2107,70,70,0,2,8,2,0
14210,10,19643,9,170,87,83,2,30,1,1
22541,10,7176,9,177,94,83,2,29,1,1
20922,26,4532,16,6178,1669,4509,19,15,11,8
15263,10,5543,9,196,102,94,2,29,1,1
3598,26,6453,16,10073,4379,5694,33,42,17,16
884,10,25012,9,205,86,119,2,30,1,1
1731,386,12611,249,491,150,341,2,1200,1,1
9728,3182,19314,2468,161,161,0,2,1200,2,0
8736,26,20579,16,162268,121343,40925,316,6101,108,208
15819,10,14296,9,180,94,86,2,30,1,1
22018,10,20957,9,184,94,90,2,31,1,1
21121,15,18062,11,314,192,122,6,15,4,2
14695,10,14391,9,701,88,613,2,30,1,1
15064,15,296,11,46682,3447,43235,61,135,27,34
17214,10,632,9,244,86,158,2,30,1,1
22095,10,12514,9,230,102,128,2,29,1,1
7909,26,4892,16,9224,2055,7169,37,41,19,18
16540,10,342,9,249,102,147,2,29,1,1
13864,15,27470,11,2568,1705,863,12,186,7,5
2744,1250,13795,930,880,126,754,2,31,1,1
9686,26,6925,16,5347,2537,2810,17,120,8,9
14700,10,28440,9,197,102,95,2,30,1,1
2744,1240,1649,920,883,126,757,2,30,1,1
9528,26,4911,16,6147,911,5236,18,16,10,8
19256,26,16510,16,17666,3045,14621,52,213,21,31
22524,10,22144,9,732,89,643,2,0,1,1
14544,10,22687,9,731,85,646,2,30,1,1
12775,257,24765,162,70,70,0,1,5,1,0
22671,10,19970,9,179,94,85,2,31,1,1
18487,280,4287,177,320,140,180,6,7,3,3
22718,10,5127,9,199,102,97,2,30,1,1
22694,10,4993,9,164,84,80,2,31,1,1
14185,10,11255,9,194,102,92,2,30,1,1
21879,26,28742,16,6792,1521,5271,18,26,11,7
15815,10,14027,9,198,102,96,2,30,1,1
18917,26,5747,16,18805,1162,17643,28,135,11,17
4567,15,12267,11,1348,844,504,13,255,8,5
10631,10,27362,9,172,80,92,2,31,1,1
21843,10,23067,9,168,86,82,2,31,1,1
14245,10,16124,9,194,102,92,2,31,1,1
21892,10,5171,9,181,94,87,2,32,1,1
9992,10,0,0,286,79,207,2,30,1,1
16951,255,25970,160,126,62,64,2,5,1,1
8545,10,18325,9,306,94,212,2,30,1,1
10968,498,17827,327,70,70,0,1,5,1,0
15479,10,22210,9,166,85,81,2,31,1,1
18768,923,27786,681,70,70,0,1,5,1,0
8423,10,5241,9,177,94,83,2,30,1,1
16876,26,23399,16,17356,5096,12260,46,26,24,22
14866,26,11628,16,15248,5524,9724,54,364,27,27
6115,26,1041,16,55975,2553,53422,72,105,29,43
18565,2732,18850,2119,504,318,186,8,16,5,3
9087,10,6309,9,199,94,105,2,30,1,1
12417,669,4107,470,320,140,180,6,5,3,3
2724,26,1463,16,24703,16382,8321,49,21,28,21
4061,26,25213,16,4566,3317,1249,21,23,12,9
21364,10,16199,9,194,102,92,2,30,1,1
5728,26,22330,16,7298,2661,4637,21,17,11,10
21932,1277,16094,957,924,924,0,3,30,3,0
7391,15,9902,11,234,234,0,4,11,4,0
14397,26,11536,16,40169,4646,35523,61,122,24,37
4654,26,23438,16,986,499,487,9,17,5,4
18191,26,17236,16,4856,1587,3269,17,138,9,8
8724,10,12455,9,177,94,83,2,30,1,1
15358,987,7611,728,70,70,0,2,8,2,0
13817,10,17659,9,199,102,97,2,30,1,1
21872,10,22018,9,391,96,295,4,49,2,2
22187,10,12308,9,193,102,91,2,29,1,1
12023,26,1620,16,5610,1599,4011,24,17,14,10
13743,10,20401,9,192,98,94,2,30,1,1
21300,10,664,9,179,94,85,2,29,1,1
6416,26,891,16,20248,1033,19215,28,3620,9,19
2744,1238,21184,918,913,126,787,2,30,1,1
2128,10,8499,9,215,80,135,2,32,1,1
4158,26,25807,16,6108,3916,2192,51,1143,31,20
14275,26,26873,16,90956,83597,7359,106,127,70,36
12769,912,24326,674,70,70,0,1,5,1,0
13676,15,6229,11,1080714,29230,1051484,1137,174,436,701
3630,26,14579,16,11976,5066,6910,83,2475,43,40
15987,10,15004,9,392,134,258,2,30,1,1
14993,15,1711,11,33712,928,32784,36,104,11,25
14797,10,12954,9,260,102,158,2,30,1,1
532,247,0,0,3562,1936,1626,48,195,24,24
14988,10,15127,9,199,102,97,2,30,1,1
22032,10,19415,9,272,93,179,4,33,2,2
781,2350,10752,1832,130,70,60,2,30,1,1
12380,99,5820,76,70,70,0,1,5,1,0
20371,26,9600,16,4954,2554,2400,11,122,6,5
9164,10,6804,9,502,115,387,4,52,2,2
2879,26,21599,16,6435,1089,5346,18,75,9,9
15054,26,24937,16,4624,1717,2907,19,30,11,8
13583,188,25318,123,432,200,232,6,31,3,3
15109,10,22403,9,186,95,91,2,31,1,1
794,372,27327,240,66,66,0,1,30,1,0
10763,1496,4429,1137,70,70,0,1,4,1,0
21285,10,6955,9,394,96,298,4,47,2,2
12790,405,23014,263,70,70,0,1,4,1,0
10883,26,13877,16,7415,1550,5865,28,37,15,13
11263,2142,28963,1655,136,136,0,3,14,3,0
19507,26,11901,16,1786,172,1614,7,120,3,4
8046,26,12681,16,18462,11672,6790,47,63,26,21
11045,15,26534,11,14830,11044,3786,27,37,15,12
14897,10,9048,9,211,102,109,2,29,1,1
17524,26,7452,16,20971,2840,18131,52,89,24,28
14389,10,23999,9,184,102,82,2,29,1,1
2744,65,6793,48,870,126,744,2,30,1,1
14589,15,2287,11,130,70,60,2,15,1,1
6775,26,28551,16,1056,569,487,10,78,6,4
12022,26,19949,16,6515,1516,4999,23,16,12,11
21703,10,1956,9,182,93,89,2,0,1,1
21364,10,1076,9,194,102,92,2,31,1,1
11235,232,10099,147,684,280,404,11,26,5,6
6748,15,28350,11,1774,1460,314,13,15,8,5
1731,2897,9063,2250,481,150,331,2,1200,1,1
14863,26,18833,16,71414,17145,54269,194,292,91,103
206,295,477,190,3102,1551,1551,16,16,8,8
21973,10,2505,9,183,94,89,2,30,1,1
15863,10,4765,9,170,87,83,2,31,1,1
10899,1157,24709,854,70,70,0,1,5,1,0
10644,10,13296,9,296,94,202,2,30,1,1
18971,26,26467,16,275026,15030,259996,353,72,167,186
7512,26,12951,16,59700,5399,54301,109,32,57,52
8737,26,17397,16,12258,5621,6637,52,286,25,27
15670,10,27206,9,193,102,91,2,29,1,1
8596,26,20417,16,18859,5795,13064,62,3666,28,34
7593,26,7341,16,9506,4029,5477,30,330,17,13
21635,26,28612,16,18895,2061,16834,34,18,18,16
18710,15,18888,11,1737,796,941,12,16,7,5
21818,10,7702,9,211,102,109,2,30,1,1
11049,2045,21047,1572,70,70,0,2,8,2,0
9456,26,27269,16,466,392,74,4,0,3,1
22313,10,11643,9,193,102,91,2,30,1,1
6811,26,2422,16,6582,1943,4639,14,122,7,7
9125,10,5035,9,377,107,270,4,45,2,2
8584,1238,7719,918,244,78,166,2,30,1,1
15311,15,4623,11,194,128,66,4,25,3,1
15762,10,12085,9,184,94,90,2,30,1,1
8333,10,3144,9,468,93,375,4,34,2,2
15951,10,12192,9,262,88,174,4,59,2,2
11102,26,27819,16,7737,6531,1206,21,16,12,9
14933,10,17003,9,177,94,83,2,30,1,1
21056,10,28343,9,223,92,131,2,31,1,1
13801,10,28814,9,183,94,89,2,29,1,1
308,26,853,16,6915,882,6033,16,149,9,7
8915,10,20738,9,200,102,98,2,30,1,1
8481,26,20642,16,3185,2263,922,18,25,9,9
8893,10,28559,9,280,110,170,2,31,1,1
13888,10,2769,9,373,126,247,2,30,1,1
13023,26,23911,16,499,425,74,4,0,3,1
9756,15,20603,11,1559,1107,452,9,24,5,4
2724,1240,6503,920,422,164,258,6,30,3,3
5926,10,17865,9,404,259,145,3,32,2,1
17128,10,13623,9,215,102,113,2,30,1,1
5080,118,16634,90,146,60,86,2,9,1,1
8380,10,0,0,333,102,231,2,30,1,1
532,247,0,0,3562,1936,1626,48,193,24,24
247,26,629,16,8209,1695,6514,21,23,13,8
22449,10,13011,9,196,102,94,2,30,1,1
10428,15,19772,11,124,64,60,2,16,1,1
15926,770,2889,557,564,318,246,9,15,5,4
9317,26,3680,16,3312,1098,2214,19,137,10,9
15580,10,16580,9,183,94,89,2,30,1,1
16586,26,14189,16,12215,7275,4940,26,26,16,10
17389,10,1707,9,168,78,90,2,30,1,1
20091,26,3893,16,8302,2895,5407,22,25,11,11
12620,2400,9373,1867,70,70,0,2,8,2,0
13838,10,19515,9,172,88,84,2,30,1,1
8926,105,22976,82,626,352,274,10,15,6,4
21391,26,21643,16,7439,1156,6283,19,75,11,8
19264,26,18167,16,8492,2950,5542,27,16,15,12
17173,26,11583,16,1855088,42017,1813071,1821,49,531,1290
9079,26,14756,16,7648,2967,4681,23,15,13,10
9703,10,27506,9,216,110,106,2,30,1,1
14508,10,28809,9,168,86,82,2,30,1,1
6193,10,23144,9,199,94,105,2,31,1,1
2724,1240,13367,920,422,164,258,6,30,3,3
8349,10,17916,9,199,102,97,2,29,1,1
2344,10,9649,9,228,90,138,2,30,1,1
13153,26,2994,16,11828,2811,9017,31,76,16,15
9325,10,15922,9,211,78,133,2,30,1,1
636,280,5961,177,492,150,342,2,1200,1,1
15046,10,250,9,180,94,86,2,30,1,1
4938,26,3662,16,600,156,444,8,25,2,6
11231,2216,5905,1717,70,70,0,1,5,1,0
3611,232,20231,147,2853,1289,1564,30,1555,12,18
11495,15,28857,11,39793,2026,37767,55,16,27,28
11315,26,26448,16,38314,11683,26631,76,34,38,38
10749,619,2086,427,70,70,0,2,8,2,0
14776,10,1316,9,198,102,96,2,29,1,1
15501,15,17078,11,526,304,222,8,35,5,3
13758,10,22915,9,214,102,112,2,30,1,1
8304,26,22186,16,43887,3283,40604,60,398,21,39
22138,10,13237,9,309,118,191,2,30,1,1
4622,26,16122,16,4347,1440,2907,19,30,11,8
9104,10,6722,9,257,110,147,2,29,1,1
15878,10,14689,9,762,98,664,2,30,1,1
9023,15,9174,11,1644,1324,320,10,15,5,5
21911,10,9657,9,199,94,105,2,30,1,1
6051,23,0,0,109,109,0,2,34,2,0
11251,1637,14885,1258,70,70,0,2,8,2,0
21607,10,21727,9,402,118,284,2,29,1,1
12129,26,6868,16,1296713,27754,1268959,1253,118,366,887
12504,618,11463,426,70,70,0,2,8,2,0
532,247,0,0,3354,1792,1562,46,195,23,23
10588,183,22534,121,3609,1654,1955,19,18,11,8
13021,26,16101,16,499,425,74,4,0,3,1
22503,10,20721,9,258,110,148,2,30,1,1
10096,26,27696,16,5841,1986,3855,19,17,11,8
17024,26,16030,16,21610,9250,12360,40,17,19,21
11207,26,25636,16,7659,3234,4425,35,288,17,18
14277,26,7422,16,7045,2145,4900,18,136,8,10
3277,26,28244,16,6444,2640,3804,18,122,9,9
21343,10,28478,9,1184,83,1101,4,59,2,2
15062,10,5137,9,214,110,104,2,30,1,1
8724,10,18301,9,350,93,257,4,42,2,2
8722,26,5671,16,6440,1844,4596,22,141,11,11
10681,15,27027,11,378,192,186,7,38,4,3
22479,10,17195,9,193,102,91,2,30,1,1
2744,68,7464,51,824,126,698,2,29,1,1
15279,10,3386,9,194,102,92,2,31,1,1
22572,10,11741,9,317,102,215,2,31,1,1
14219,26,16083,16,7902,1565,6337,20,150,9,11
17578,10,26337,9,216,98,118,2,30,1,1
22605,26,17928,16,2494,1643,851,17,25,9,8
6214,26,93,16,3562,2096,1466,18,336,9,9
15368,10,10397,9,196,102,94,2,30,1,1
21761,10,21356,9,782,105,677,2,30,1,1
11124,26,5068,16,2960,1982,978,15,16,9,6
9391,15,23014,11,136475,59298,77177,166,53,78,88
22037,10,9742,9,755,94,661,2,30,1,1
15581,26,10687,16,10572,5109,5463,24,122,12,12
5071,26,16628,16,4378,1471,2907,19,29,11,8
9799,15,622,11,2108,1167,941,10,20,6,4
21581,10,22234,9,196,102,94,2,31,1,1
22392,1300,9764,978,235,71,164,2,31,1,1
15610,10,629,9,186,102,84,2,30,1,1
21773,10,26105,9,761,100,661,2,31,1,1
9273,6,21822,6,60,60,0,1,5,1,0
14002,10,4854,9,168,86,82,2,30,1,1
19253,26,16431,16,14131,5620,8511,38,216,20,18
21586,10,20171,9,167,86,81,2,30,1,1
14442,26,17196,16,128791,11254,117537,141,132,48,93
18750,26,12182,16,14776,5238,9538,41,175,21,20
16136,26,9786,16,2614,1689,925,18,20,10,8
15344,10,13501,9,183,94,89,2,30,1,1
3491,26,21750,16,6382,2331,4051,24,109,13,11
4654,26,23106,16,130,64,66,3,6,2,1
14856,10,9669,9,210,102,108,2,30,1,1
636,280,1974,177,324,150,174,2,1203,1,1
14421,10,13246,9,752,93,659,2,31,1,1
9019,10,4476,9,290,102,188,2,30,1,1
22521,10,6755,9,174,89,85,2,30,1,1
5505,10,1127,9,199,94,105,2,29,1,1
15024,10,10979,9,199,102,97,2,30,1,1
11119,26,4171,16,15525,1642,13883,32,16,16,16
16381,26,8365,16,1584,953,631,17,124,9,8
15067,10,6876,9,208,106,102,2,31,1,1
16380,15,6533,11,318,192,126,6,26,4,2
4643,739,1171,530,432,192,240,8,30,4,4
15815,10,1392,9,177,94,83,2,29,1,1
14841,26,8244,16,6728,1775,4953,25,275,13,12
7755,26,25076,16,11003,3821,7182,35,257,14,21
19383,26,19239,16,5325,1242,4083,23,27,13,10
14951,26,4837,16,26040,2148,23892,44,22,21,23
15197,15,10037,11,234,234,0,4,12,4,0
15985,15,24201,11,1056,682,374,10,15,6,4
2744,62,17673,45,902,126,776,2,30,1,1
16126,26,7312,16,2614,1689,925,18,19,10,8
11478,10,22988,9,240,98,142,2,30,1,1
6584,15,5821,11,630,630,0,10,217,10,0
9400,10,2879,9,749,94,655,2,30,1,1
14651,10,19668,9,178,94,84,2,30,1,1
14912,10,12894,9,198,101,97,2,31,1,1
19542,15,20553,11,134,60,74,3,11,2,1
15957,10,25148,9,179,94,85,2,31,1,1
15813,234,23421,149,7144,1872,5272,36,22,20,16
15312,15,19998,11,194,128,66,4,25,3,1
15247,26,12003,16,7888,1899,5989,20,15,11,9
636,2105,1322,1621,509,150,359,2,1200,1,1
11208,1506,626,1146,70,70,0,1,5,1,0
14803,10,7156,9,200,102,98,2,30,1,1
15265,26,13884,16,3936,2585,1351,18,18,10,8
21300,10,26291,9,174,89,85,2,30,1,1
17005,15,11176,11,4115,3452,663,13,15,7,6
16021,108,11215,84,528,528,0,9,1200,9,0
21119,2639,14811,2047,66,66,0,2,7,2,0
5776,341,21353,217,1259,639,620,20,300,10,10
2744,1238,10315,918,878,126,752,2,30,1,1
11030,15,15305,11,3604,2064,1540,15,40,10,5
17167,26,26292,16,5167,700,4467,16,15,7,9
4852,2504,5783,1947,156,156,0,3,8,3,0
17812,15,20192,11,5762500,128192,5634308,5613,134,1854,3759
3885,26,2466,16,7029,2223,4806,23,361,12,11
2744,1457,2183,1110,887,126,761,2,31,1,1
10103,15,8745,11,1095989,7833,1088156,841,37,117,724
9740,15,20395,11,1598,937,661,13,78,7,6
21767,10,26920,9,168,86,82,2,29,1,1
21729,10,7267,9,280,97,183,4,60,2,2
532,247,0,0,3354,1792,1562,46,194,23,23
16646,26,25798,16,4465,1558,2907,19,27,11,8
10097,26,108,16,10759,3158,7601,29,75,16,13
9092,15,21448,11,1270,679,591,13,15,7,6
9465,15,8418,11,50565,32661,17904,77,167,39,38
21064,796,3275,579,66,66,0,1,5,1,0
1047,26,859,16,3510,430,3080,10,15,6,4
16354,26,14387,16,1868,1229,639,18,177,11,7
14398,10,25819,9,283,98,185,4,51,2,2
8684,10,6761,9,193,102,91,2,30,1,1
17102,26,3137,16,5167,700,4467,16,15,7,9
15755,10,8090,9,195,102,93,2,33,1,1
21108,15,20783,11,314,192,122,6,15,4,2
14225,319,3558,205,70,70,0,2,8,2,0
14426,15,24605,11,424,198,226,7,143,4,3
10963,15,17684,11,3676,2136,1540,15,40,10,5
5998,26,9591,16,3976,2652,1324,20,312,11,9
14547,10,19233,9,758,93,665,2,31,1,1
21171,291,317,187,66,66,0,2,8,2,0
19134,26,10061,16,569471,20976,548495,666,333,273,393
9085,10,8905,9,214,110,104,2,31,1,1
13525,10,14038,9,168,78,90,2,30,1,1
12922,26,9728,16,2227,1018,1209,17,16,8,9
21096,736,13292,528,70,70,0,1,4,1,0
16851,18,13497,13,184,94,90,2,30,1,1
13064,26,21695,16,5768,3426,2342,22,135,11,11
930,26,22593,16,158704,5074,153630,184,34,69,115
15251,10,1635,9,172,88,84,2,31,1,1
16021,37,7170,22,330,330,0,6,1200,6,0
15483,10,26218,9,211,78,133,2,30,1,1
17048,26,428,16,522925,36953,485972,799,229,304,495
13809,10,8332,9,197,102,95,2,31,1,1
12063,2083,5409,1605,70,70,0,1,5,1,0
13710,10,10102,9,177,94,83,2,30,1,1
21831,10,1525,9,184,94,90,2,30,1,1
11094,2178,28629,1683,70,70,0,1,5,1,0
10883,15,21954,11,4903,4061,842,11,26,6,5
5722,26,17542,16,7772,2569,5203,23,148,13,10
2714,26,20677,16,20959,15902,5057,38,20,21,17
15432,10,6563,9,195,102,93,2,30,1,1
10714,234,18834,149,9476,2759,6717,27,3601,15,12
1219,1020,24505,752,323,150,173,2,1203,1,1
9448,26,19936,16,3051,1801,1250,18,15,8,10
8584,1238,16305,918,219,71,148,2,31,1,1
22594,10,21572,9,359,94,265,2,30,1,1
17954,26,28386,16,1307,666,641,15,46,7,8
3546,26,23221,16,416,210,206,7,57,4,3
4792,26,16288,16,109189,6692,102497,151,80,69,82
13436,26,12489,16,20465,3839,16626,43,229,22,21
16284,10,14785,9,168,78,90,2,31,1,1
1037,15,19187,11,1643,485,1158,10,15,5,5
15423,901,6423,665,66,66,0,1,5,1,0
12378,1038,10135,762,612,306,306,10,16,5,5
12123,26,23335,16,1276,703,573,15,33,8,7
8725,26,6114,16,1332,876,456,11,56,6,5
14601,10,5764,9,183,94,89,2,30,1,1
15145,10,23567,9,183,94,89,2,30,1,1
14765,26,16498,16,18931,4924,14007,46,139,20,26
8344,26,17531,16,840,700,140,13,59,11,2
5104,26,10012,16,89883,3417,86466,94,15,30,64
17142,26,19297,16,16260,10863,5397,39,19,21,18
10640,26,27668,16,2927,2062,865,14,134,8,6
2744,1239,21000,919,887,126,761,2,30,1,1
21144,477,3085,311,70,70,0,1,4,1,0
10346,26,8257,16,8024,2572,5452,39,15,23,16
12207,10,0,0,418,154,264,4,33,2,2
8057,15,3287,11,6713,1736,4977,24,1130,8,16
8584,1238,26739,918,253,78,175,2,31,1,1
11688,26,3348,16,5378,984,4394,18,17,10,8
22241,10,22192,9,184,94,90,2,30,1,1
21505,10,12431,9,198,101,97,2,30,1,1
22392,1238,10838,918,233,71,162,2,30,1,1
8788,10,25714,9,244,94,150,2,30,1,1
9959,15,6982,11,550,476,74,6,15,5,1
22258,10,16688,9,184,94,90,2,30,1,1
15622,26,2437,16,594793,518081,76712,1350,1004,781,569
22340,10,17839,9,273,102,171,2,30,1,1
21967,10,12033,9,173,94,79,2,29,1,1
12567,26,23565,16,499,425,74,4,0,3,1
14087,10,6348,9,186,95,91,2,30,1,1
17332,26,1502,16,8279,2876,5403,22,155,9,13
11007,15,17723,11,366,240,126,7,25,5,2
10365,1835,24345,1396,70,70,0,2,8,2,0
18855,26,7234,16,36974,3935,33039,56,61,27,29
15231,10,23989,9,255,88,167,4,53,2,2
17362,26,26187,16,4598,1691,2907,19,30,11,8
14333,10,2340,9,281,101,180,4,60,2,2
4429,15,4977,11,5189,2979,2210,19,136,12,7
10908,26,397,16,7241,1972,5269,28,68,16,12
6566,15,24444,11,805,665,140,6,32,4,2
22709,2896,21470,2249,558,318,240,9,143,5,4
22403,10,15376,9,290,102,188,2,30,1,1
12922,15,16537,11,78,78,0,1,5,1,0
3218,10,13693,9,823,98,725,2,31,1,1
8520,10,13070,9,738,86,652,2,31,1,1
17752,26,10215,16,4507,1525,2982,24,148,13,11
9192,26,12553,16,15425,9901,5524,33,84,17,16
9728,408,1454,265,166,166,0,1,1200,1,0
3144,10,13185,9,197,90,107,2,30,1,1
7708,305,17044,199,416,210,206,7,15,4,3
20093,295,27748,190,3959,1738,2221,15,15,8,7
13917,10,24043,9,198,110,88,2,29,1,1
20520,10,14355,9,510,164,346,2,30,1,1
4193,26,38,16,10857,4247,6610,27,121,13,14
22467,10,5929,9,237,94,143,2,30,1,1
5523,26,8485,16,26779179,169104,26610075,19911,91,1968,17943
21515,10,8217,9,197,94,103,2,30,1,1
5577,15,13919,11,9656,3195,6461,19,23,12,7
15900,26,20373,16,1607664,53945,1553719,1792,39,700,1092
4149,26,19149,16,17110,4513,12597,42,121,19,23
16021,936,13651,690,870,330,540,12,2308,6,6
8586,26,5329,16,5241,1194,4047,19,40,9,10
7369,26,4186,16,125213,5113,120100,153,96,58,95
15260,26,8289,16,7855,1866,5989,20,15,11,9
22159,10,7432,9,275,96,179,4,41,2,2
2744,1238,21632,918,893,126,767,2,30,1,1
15305,10,22303,9,733,86,647,2,30,1,1
10951,26,6819,16,7970,4154,3816,39,102,23,16
15761,10,28050,9,195,102,93,2,30,1,1
9219,26,19006,16,8205,2989,5216,42,115,21,21
11483,26,15465,16,32875,8836,24039,37,16,15,22
15954,10,17623,9,196,94,102,2,31,1,1
18709,26,11895,16,17071,1532,15539,17,147,3,14
22577,10,15125,9,197,102,95,2,33,1,1
2744,1238,18254,918,869,126,743,2,30,1,1
16021,481,5815,315,594,594,0,10,1200,10,0
14980,15,18414,11,1281,398,883,16,392,4,12
15263,10,8468,9,196,102,94,2,30,1,1
8508,15,28976,11,1969,463,1506,13,55,7,6
12613,696,5298,495,70,70,0,2,7,2,0
6705,10,18929,9,216,88,128,2,30,1,1
8805,10,12587,9,250,102,148,2,29,1,1
21985,10,16354,9,194,102,92,2,30,1,1
22428,10,12024,9,200,102,98,2,30,1,1
15089,10,13829,9,200,102,98,2,30,1,1
15355,26,26423,16,7922,1933,5989,20,16,11,9
15409,10,15555,9,172,88,84,2,30,1,1
4198,15,11720,11,1614,1300,314,10,15,5,5
0,0,0,0,320,320,0,5,0,5,0
719,10,2855,9,194,87,107,2,30,1,1
8584,1239,10947,919,262,78,184,2,30,1,1
9792,15,3859,11,1717,1247,470,9,15,5,4
13712,26,6880,16,12435,4022,8413,27,62,15,12
9479,10,5629,9,216,110,106,2,30,1,1
9785,10,26839,9,760,97,663,2,30,1,1
14182,10,26693,9,211,102,109,2,30,1,1
2399,10,19627,9,334,226,108,3,30,2,1
1205,26,19759,16,20612,7872,12740,57,643,21,36
12315,26,27339,16,6550,1555,4995,25,53,13,12
1300,10,4360,9,247,98,149,2,32,1,1
2744,1238,26647,918,876,126,750,2,31,1,1
16495,15,10046,11,9984,5333,4651,21,25,10,11
19310,26,28572,16,6143,1796,4347,21,21,11,10
8642,26,13319,16,7254,1183,6071,19,152,9,10
15176,10,5287,9,170,87,83,2,30,1,1
8746,10,1463,9,196,102,94,2,30,1,1
14306,10,17548,9,270,88,182,4,54,2,2
3453,26,23538,16,14402,2801,11601,28,205,11,17
11124,2868,14082,2227,66,66,0,1,5,1,0
636,280,25356,177,238,118,120,2,1200,1,1
6341,26,19953,16,3134,1983,1151,15,15,8,7
16109,26,25442,16,206737,25710,181027,212,180,75,137
15252,10,27096,9,200,102,98,2,30,1,1
18885,26,12978,16,8284,1577,6707,29,48,14,15
18406,295,26761,190,3114,1659,1455,17,15,9,8
17507,26,19680,16,10495,9044,1451,29,35,18,11
11972,15,26303,11,2424,1110,1314,11,78,7,4
8391,10,22507,9,199,102,97,2,34,1,1
10210,15,16900,11,3974,2713,1261,34,131,19,15
2241,10,9179,9,229,98,131,2,30,1,1
8900,26,7493,16,7548,1543,6005,22,18,12,10
15093,41,19939,24,2901,1472,1429,27,17,12,15
22464,10,25306,9,216,110,106,2,29,1,1
3225,1998,2436,1528,261,175,86,2,31,1,1
9848,15,3092,11,499,192,307,6,26,4,2
8210,43,21194,26,334,158,176,2,1199,1,1
4934,26,21749,16,134,60,74,3,4,2,1
10195,26,3340,16,19880,4739,15141,58,187,26,32
21753,10,17142,9,277,94,183,4,60,2,2
17128,26,3758,16,5166,700,4466,16,15,7,9
14245,10,8529,9,214,110,104,2,30,1,1
8370,10,226,9,195,102,93,2,30,1,1
21480,10,17824,9,212,94,118,2,30,1,1
6282,26,13740,16,1622,1137,485,11,26,7,4
8573,15,19046,11,4878,1570,3308,19,165,10,9
15249,10,8566,9,183,94,89,2,30,1,1
4194,26,19325,16,670261,26523,643738,728,188,262,466
15507,15,231,11,486,280,206,8,26,5,3
10265,26,4700,16,44048,4441,39607,97,317,43,54
7259,26,1359,16,2996,1629,1367,17,21,9,8
14269,26,23178,16,6133,1655,4478,12,119,5,7
15460,10,15445,9,177,94,83,2,30,1,1
15591,10,27739,9,209,110,99,2,29,1,1
15912,10,25342,9,242,98,144,2,30,1,1
15129,26,19742,16,116577,6817,109760,137,62,54,83
8078,26,4063,16,68467,4750,63717,100,276,48,52
9015,10,12088,9,164,84,80,2,30,1,1
6052,26,6570,16,626036,38764,587272,713,191,245,468
9019,10,8096,9,916,86,830,2,30,1,1
3029,10,12578,9,218,90,128,2,29,1,1
10196,26,2353,16,2997,1906,1091,29,186,17,12
3704,26,11961,16,5692,1597,4095,19,18,11,8
19283,15,24950,11,28791,2297,26494,41,255,20,21
22695,10,8690,9,197,102,95,2,30,1,1
8977,10,14917,9,193,102,91,2,30,1,1
8447,10,28068,9,167,86,81,2,30,1,1
18878,26,22439,16,1706,169,1537,6,121,3,3
13959,26,5078,16,6210,2720,3490,15,121,7,8
9229,26,6612,16,9148,1570,7578,31,257,13,18
20508,26,15334,16,304,86,218,2,30,1,1
7345,26,28937,16,3160640,65300,3095340,2786,144,547,2239
17599,26,6025,16,30995,9655,21340,65,121,27,38
15196,26,19724,16,7981,1961,6020,20,15,11,9
14355,10,14512,9,335,93,242,4,32,2,2
9738,15,7085,11,3116,452,2664,18,394,5,13
4458,10,23758,9,164,78,86,2,30,1,1
20393,40,6534,23,9608,4549,5059,88,199,45,43
13535,878,9229,647,476,216,260,2,30,1,1
13970,10,22835,9,211,110,101,2,30,1,1
532,247,0,0,3354,1792,1562,46,193,23,23
1144,10,3842,9,244,98,146,2,33,1,1
7677,26,7359,16,2809,1884,925,19,25,11,8
8508,10,20844,9,199,102,97,2,31,1,1
10810,978,7834,724,66,66,0,1,5,1,0
2744,1556,6839,1187,900,126,774,2,31,1,1
9752,26,23602,16,8058,2722,5336,17,31,10,7
4835,1148,17652,847,858,858,0,14,1199,14,0
2744,1868,11465,1426,886,126,760,2,31,1,1
14318,26,24543,16,14768,2185,12583,32,80,13,19
14245,10,25986,9,196,94,102,2,30,1,1
15421,10,9236,9,196,102,94,2,31,1,1
20671,26,920,16,1309,670,639,16,127,9,7
21154,2475,3530,1925,66,66,0,1,5,1,0
8665,26,5560,16,87970,5355,82615,141,483,55,86
21378,1933,10279,1476,66,66,0,2,8,2,0
4991,26,19763,16,103112,8212,94900,165,55,80,85
9411,1902,12378,1454,480,149,331,2,1200,1,1
5474,15,4260,11,1563,570,993,10,16,6,4
22245,10,16738,9,214,110,104,2,29,1,1
2744,1285,20437,964,636020,187240,448780,2701,104,1538,1163
22435,10,15818,9,215,102,113,2,30,1,1
15390,2582,24530,2003,70,70,0,1,5,1,0
12362,2442,13079,1897,70,70,0,1,4,1,0
4517,26,15955,16,4381,1474,2907,19,27,11,8
2910,26,18431,16,9686,2335,7351,28,124,13,15
22680,10,16831,9,186,95,91,2,30,1,1
11164,853,525,628,70,70,0,2,7,2,0
7035,26,22259,16,153,93,60,2,5,1,1
11304,15,22878,11,210890,8286,202604,208,28,64,144
15402,10,18916,9,190,97,93,2,31,1,1
10921,1062,12469,781,70,70,0,1,5,1,0
1609,26,5809,16,416,198,218,7,27,4,3
9852,15,11358,11,1658,1247,411,8,15,5,3
21977,10,9474,9,178,94,84,2,29,1,1
4596,10,15980,9,168,78,90,2,30,1,1
14416,26,24601,16,4578,1671,2907,19,28,11,8
8763,10,17416,9,86,86,0,1,30,1,0
14087,10,671,9,102,102,0,1,30,1,0
14891,10,5640,9,184,94,90,2,30,1,1
13622,10,26206,9,199,102,97,2,30,1,1
16453,10,25676,9,847,110,737,2,30,1,1
14120,10,12229,9,711,87,624,2,30,1,1
12411,15,24852,11,2270749,47314,2223435,2132,99,651,1481
20391,40,1048,23,8921,4675,4246,77,200,47,30
22556,10,21980,9,226,110,116,2,29,1,1
8675,26,21526,16,242669,43830,198839,310,67,159,151
8421,10,28310,9,173,94,79,2,29,1,1
15764,10,27922,9,195,102,93,2,29,1,1
6470,26,16065,16,6053,1321,4732,19,980,9,10
16245,676,7992,475,130,70,60,2,6,1,1
5250,26,5971,16,70,70,0,1,5,1,0
2989,10,12294,9,235,90,145,2,31,1,1
7316,10,10440,9,199,94,105,2,30,1,1
15592,10,21863,9,193,102,91,2,30,1,1
7634,26,24402,16,280,140,140,5,129,3,2
8733,10,12864,9,195,94,101,2,30,1,1
21989,10,13840,9,214,110,104,2,30,1,1
14317,1866,7436,1424,70,70,0,1,5,1,0
14808,10,9091,9,211,102,109,2,30,1,1
21035,15,28333,11,7324,1017,6307,16,20,8,8
10338,26,22896,16,7950,2502,5448,38,15,22,16
15612,26,25918,16,59451,47894,11557,177,91,99,78
16376,26,12101,16,20509,7660,12849,54,131,28,26
14186,10,27654,9,183,94,89,2,29,1,1
14441,10,21453,9,194,102,92,2,30,1,1
11120,26,23366,16,45583818,387905,45195913,35736,272,5246,30490
8210,2506,21194,1948,328,152,176,2,1200,1,1
14303,10,10009,9,195,102,93,2,30,1,1
22353,10,26632,9,498,204,294,6,29,3,3
13335,26,6795,16,6410,2001,4409,27,28,16,11
18199,26,1831,16,704,280,424,11,19,5,6
15164,26,7179,16,15450,6149,9301,106,177,47,59
8363,10,7617,9,230,91,139,3,47,2,1
9128,10,28382,9,380,110,270,2,31,1,1
5837,10,13757,9,168,78,90,2,29,1,1
8837,10,4639,9,183,94,89,2,29,1,1
2959,10,12153,9,197,76,121,2,30,1,1
13648,10,10203,9,202,103,99,2,31,1,1
8795,26,6815,16,5600,1187,4413,24,80,13,11
19318,26,3071,16,1113,589,524,12,28,6,6
14422,10,23706,9,711,87,624,2,30,1,1
22511,15,22140,11,2356,499,1857,10,134,6,4
9619,15,22811,11,2669,1434,1235,11,21,6,5
21252,10,20018,9,193,102,91,2,30,1,1
9124,15,25835,11,9718,819,8899,19,15,9,10
21671,10,8301,9,289,101,188,4,51,2,2
14157,15,15998,11,78,78,0,2,8,2,0
15211,10,3471,9,168,86,82,2,30,1,1
4698,26,2214,16,1654,931,723,20,16,11,9
10671,15,2518,11,318,192,126,6,39,4,2
18489,1185,7833,874,70,70,0,2,8,2,0
8580,26,28389,16,43326,4905,38421,56,43,16,40
19318,15,732,11,214,140,74,4,41,3,1
14292,10,26832,9,177,94,83,2,29,1,1
15794,10,25078,9,701,88,613,2,30,1,1
18738,26,8997,16,61464,11538,49926,87,32,41,46
15695,10,15574,9,177,94,83,2,30,1,1
14876,10,22547,9,260,102,158,2,30,1,1
14846,10,17317,9,177,94,83,2,30,1,1
10844,15,3384,11,11975,2907,9068,24,38,14,10
14861,26,9908,16,3093,868,2225,10,120,5,5
8876,10,485,9,179,94,85,2,30,1,1
8584,1238,5664,918,237,71,166,2,31,1,1
3826,26,19771,16,5586,1338,4248,17,109,9,8
14637,10,19542,9,173,94,79,2,30,1,1
21206,10,15720,9,682,199,483,6,46,3,3
5038,26,9581,16,1310,649,661,13,185,7,6
2657,26,11123,16,1251,722,529,11,147,6,5
16021,2179,24414,1684,2292,332,1960,11,1200,5,6
12057,1053,9338,776,958,454,504,14,21,8,6
22473,10,14483,9,226,86,140,2,30,1,1
21258,10,26772,9,214,110,104,2,30,1,1
7655,26,9450,16,1314,653,661,13,184,7,6
6540,232,15327,147,5415,2041,3374,53,467,23,30
8681,26,21532,16,102168,31819,70349,140,62,75,65
22036,10,11331,9,165,86,79,2,31,1,1
15211,10,15041,9,372,86,286,4,54,2,2
11221,1606,10480,1230,70,70,0,2,8,2,0
2140,10,8570,9,237,91,146,2,33,1,1
21271,10,14353,9,198,101,97,2,31,1,1
9968,10,6986,9,168,78,90,2,30,1,1
12711,26,6968,16,499,425,74,4,1,3,1
4290,26,12217,16,4039,2616,1423,24,45,14,10
9713,26,7545,16,5941,1856,4085,22,81,13,9
14915,10,28295,9,202,103,99,2,31,1,1
500,1468,8460,1118,832,832,0,14,96,14,0
2744,90,16949,70,858,126,732,2,30,1,1
15396,10,15921,9,199,102,97,2,29,1,1
7350,26,19943,16,1494,898,596,12,142,6,6
0,0,0,0,600,306,294,6,0,3,3
9728,3106,13823,2413,1377,300,1077,6,1200,3,3
11033,26,20027,16,18400,6207,12193,60,212,32,28
16021,617,4778,425,1577,594,983,20,1601,10,10
14869,10,24848,9,194,87,107,2,31,1,1
22674,10,11208,9,184,94,90,2,29,1,1
21856,10,25941,9,199,102,97,2,29,1,1
14844,10,16011,9,701,88,613,2,31,1,1
18868,233,6718,148,194,134,60,2,5,1,1
14829,10,22080,9,748,95,653,2,30,1,1
1338,26,4523,16,1311,782,529,12,23,7,5
8327,2577,8976,1999,150,150,0,2,1200,2,0
2715,26,170,16,11115,3034,8081,35,19,18,17
637,2053,26786,1579,228,118,110,2,1200,1,1
22012,26,15813,16,53280,3270,50010,78,142,31,47
4105,26,13551,16,2967,876,2091,11,120,5,6
4729,233,3790,148,417,417,0,4,13,4,0
12609,405,15274,263,70,70,0,2,8,2,0
13703,10,23073,9,733,86,647,2,31,1,1
14487,18,1435,13,184,94,90,2,30,1,1
8584,1238,10858,918,234,78,156,2,30,1,1
10761,1952,2522,1489,70,70,0,2,8,2,0
21667,10,16981,9,180,94,86,2,31,1,1
13805,10,2409,9,200,102,98,2,30,1,1
4220,26,24257,16,7229,2357,4872,26,270,14,12
5281,26,17353,16,4602,1305,3297,27,183,12,15
16021,280,16884,177,517,163,354,2,1200,1,1
15304,26,9756,16,8652,2148,6504,20,15,11,9
11049,2045,14499,1572,70,70,0,1,5,1,0
3387,26,8645,16,8888,1757,7131,26,174,15,11
0,0,0,0,2000,1020,980,20,0,10,10
8264,26,1097,16,10163,3585,6578,47,26,24,23
4670,26,26850,16,499,425,74,4,0,3,1
3681,305,17828,199,2845,419,2426,12,15,7,5
8976,26,2995,16,7551,2453,5098,22,126,12,10
14871,10,17590,9,711,87,624,2,30,1,1
9521,15,3063,11,1451,796,655,11,31,6,5
15326,10,15363,9,177,94,83,2,30,1,1
8295,26,7502,16,8960,2497,6463,35,32,19,16
14907,10,24868,9,257,101,156,2,34,1,1
13234,15,26529,11,1466,831,635,10,255,6,4
16326,26,3468,16,130,70,60,2,15,1,1
5421,15,25420,11,1614,1300,314,10,15,5,5
22115,10,22611,9,414,106,308,2,30,1,1
15738,26,13162,16,12844,2619,10225,23,120,10,13
15531,15,11363,11,9535,3968,5567,21,30,12,9
20811,26,12545,16,1950,1231,719,20,15,12,8
636,280,19042,177,502,150,352,2,1200,1,1
22234,10,17358,9,198,101,97,2,32,1,1
15213,26,28419,16,7855,1866,5989,20,15,11,9
15184,26,5519,16,11061,1566,9495,25,19,13,12
15764,10,25912,9,182,93,89,2,30,1,1
22657,10,3483,9,200,94,106,2,30,1,1
16702,26,5337,16,13442,1200,12242,26,29,11,15
9040,26,1628,16,5993,974,5019,19,54,10,9
8094,26,14176,16,6616,3644,2972,18,122,9,9
22053,10,153,9,200,102,98,2,30,1,1
12047,789,16715,574,70,70,0,1,4,1,0
8078,26,17340,16,232,172,60,3,5,2,1
9486,232,8161,147,9254,3356,5898,74,444,30,44
16461,26,21249,16,13206,7781,5425,29,253,15,14
7852,10,9875,9,168,78,90,2,29,1,1
7728,15,28159,11,613,539,74,7,15,6,1
4553,10,16012,9,220,90,130,2,30,1,1
22637,10,19513,9,204,104,100,2,30,1,1
22472,10,22986,9,184,102,82,2,29,1,1
12527,2633,1288,2043,70,70,0,2,8,2,0
2724,1240,15161,920,422,164,258,6,30,3,3
9456,15,13799,11,366,180,186,7,57,4,3
9005,10,23549,9,751,95,656,2,30,1,1
22395,10,14165,9,178,94,84,2,30,1,1
5430,26,9439,16,559339,545011,14328,595,316,388,207
2353,26,9696,16,4668,1745,2923,21,76,12,9
12048,26,14085,16,9711,3950,5761,38,28,22,16
12673,26,27131,16,499,425,74,4,0,3,1
3356,26,25510,16,6044,780,5264,16,66,8,8
13822,15,24287,11,374,240,134,7,15,5,2
10384,15,17453,11,6702,5879,823,19,135,10,9
13698,10,16666,9,196,102,94,2,30,1,1
14165,10,9919,9,168,86,82,2,30,1,1
8368,820,4220,600,66,66,0,1,5,1,0
20388,233,17855,148,11427,6608,4819,37,248,21,16
22032,10,14356,9,272,93,179,4,33,2,2
12408,795,16179,578,320,140,180,6,5,3,3
10331,26,21634,16,8590,1038,7552,16,120,7,9
8797,10,10289,9,184,102,82,2,30,1,1
21533,10,28872,9,110,110,0,1,30,1,0
9677,26,11912,16,3518,1654,1864,10,120,5,5
1731,2122,515,1636,480,149,331,2,1200,1,1
8841,10,27536,9,78,78,0,1,30,1,0
11176,15,19085,11,366,240,126,7,33,5,2
22456,10,10557,9,193,102,91,2,30,1,1
15373,2050,18762,1576,70,70,0,1,5,1,0
14260,2296,14152,1780,70,70,0,1,5,1,0
16021,2214,21759,1715,166,166,0,1,1199,1,0
13970,10,14926,9,211,110,101,2,30,1,1
15513,15,25598,11,606,70,536,10,278,2,8
14954,10,7,9,181,98,83,2,31,1,1
22501,10,520,9,184,94,90,2,31,1,1
22365,10,28980,9,256,114,142,2,30,1,1
18166,26,23873,16,6300,1427,4873,20,141,9,11
22249,10,28696,9,180,94,86,2,29,1,1
12494,2428,4530,1889,70,70,0,1,5,1,0
15460,10,28058,9,177,94,83,2,30,1,1
18251,26,16896,16,1059,556,503,12,25,6,6
3946,26,9870,16,9120,5103,4017,38,587,22,16
11832,26,24647,16,5581,1388,4193,19,15,9,10
13115,26,3000,16,7827,2416,5411,18,136,8,10
9187,10,21601,9,166,86,80,2,29,1,1
225,10,25034,9,204,118,86,2,30,1,1
3864,26,8992,16,70,70,0,1,5,1,0
11935,26,16669,16,20048,9134,10914,96,92,39,57
21158,1715,20845,1310,66,66,0,2,8,2,0
15287,10,1616,9,448,184,264,6,29,3,3
22087,10,26150,9,323,110,213,2,30,1,1
10692,15,12482,11,318,192,126,6,37,4,2
15724,26,11007,16,1798,1223,575,13,25,8,5
13928,10,27219,9,193,102,91,2,30,1,1
21324,10,18810,9,202,103,99,2,31,1,1
3966,15,24430,11,130,70,60,2,14,1,1
22427,10,23576,9,180,86,94,2,30,1,1
8666,15,7044,11,309313,41646,267667,433,486,113,320
15144,10,6999,9,211,110,101,2,30,1,1
4347,26,15705,16,4621,1714,2907,19,30,11,8
16021,612,8810,422,761,166,595,2,1200,1,1
8828,26,23097,16,4353,1145,3208,17,25,9,8
16364,26,26116,16,3588,1991,1597,27,176,14,13
15601,10,13637,9,776,102,674,2,31,1,1
9055,15,13046,11,1694,666,1028,10,75,6,4
13917,10,18509,9,285,103,182,4,50,2,2
9614,15,21996,11,2144,900,1244,11,26,7,4
3464,10,8812,9,168,78,90,2,30,1,1
18535,1018,25583,751,1599,743,856,13,36,7,6
11093,338,6762,215,70,70,0,1,5,1,0
22387,1285,1581,964,268,78,190,2,29,1,1
8246,10,21235,9,398,255,143,3,32,2,1
10972,1025,22462,755,210,70,140,4,8,2,2
22011,10,11770,9,199,102,97,2,30,1,1
13654,232,15331,147,32608,22014,10594,225,215,124,101
10984,15,17949,11,18285,8756,9529,29,27,15,14
3506,18,27568,13,184,94,90,2,30,1,1
22072,10,25278,9,332,104,228,2,30,1,1
15345,10,13438,9,779,86,693,2,30,1,1
19321,26,21539,16,7348,1763,5585,23,77,12,11
18395,26,25790,16,1867,1228,639,18,87,11,7
8661,26,7171,16,12452,10841,1611,26,27,14,12
8343,26,25321,16,10225,3155,7070,28,57,19,9
22333,10,10866,9,780,104,676,2,31,1,1
5605,15,27341,11,28577,1878,26699,47,31,23,24
2556,10,10720,9,823,98,725,2,30,1,1
15712,10,10214,9,170,87,83,2,30,1,1
21226,10,16524,9,216,110,106,2,30,1,1
22543,10,21271,9,168,86,82,2,30,1,1
9330,26,17593,16,6353,1075,5278,18,26,10,8
4415,15,26463,11,191737,8302,183435,205,31,79,126
15258,26,4042,16,8735,1819,6916,23,23,14,9
6759,26,19002,16,4792,2767,2025,38,255,20,18
14486,26,5537,16,21179,8150,13029,46,153,25,21
8380,26,3594,16,157994,4952,153042,186,255,68,118
20587,295,28065,190,3310,1535,1775,15,15,8,7
15361,26,20796,16,36203,1763,34440,46,119,17,29
12242,26,21615,16,6877,1694,5183,24,306,13,11
14185,10,7872,9,778,103,675,2,30,1,1
14699,26,10140,16,22293,16437,5856,51,30,27,24
8416,15,21396,11,265842,14126,251716,311,22,136,175
5533,26,10740,16,8309,4385,3924,26,121,12,14
21068,2851,12137,2213,66,66,0,2,7,2,0
20839,26,27392,16,5828,1439,4389,16,75,9,7
4561,10,24198,9,168,78,90,2,30,1,1
14339,10,680,9,728,96,632,2,30,1,1
18097,26,27625,16,3063,1395,1668,16,144,8,8
15176,10,368,9,177,94,83,2,31,1,1
4996,232,23504,147,7338,3611,3727,74,616,37,37
13925,10,18862,9,210,102,108,2,30,1,1
10099,15,11594,11,1123476,15099,1108377,963,39,223,740
3914,15,24205,11,350,210,140,6,30,4,2
15018,15,3882,11,17128,1499,15629,24,25,9,15
15058,10,23606,9,755,94,661,2,31,1,1
21603,10,6476,9,228,102,126,2,30,1,1
5606,1981,29143,1511,148,86,62,2,30,1,1
21974,26,14697,16,10750,1814,8936,37,195,17,20
18475,26,25972,16,7353,1573,5780,21,78,11,10
15951,10,17371,9,262,88,174,4,58,2,2
16563,18,18769,13,184,94,90,2,30,1,1
22205,1253,12674,933,737,462,275,2,29,1,1
1074,26,24313,16,5693,499,5194,14,15,7,7
8334,10,24655,9,193,102,91,2,30,1,1
20758,26,26581,16,2870,343,2527,11,120,5,6
9032,26,15794,16,6251,1706,4545,16,88,9,7
20495,26,14813,16,512,166,346,2,30,1,1
3867,26,20029,16,16227,7159,9068,40,524,21,19
6302,26,24243,16,4886,895,3991,16,31,9,7
22673,26,29129,16,4640,1733,2907,19,27,11,8
15945,10,15577,9,732,89,643,2,30,1,1
15776,10,24328,9,789,110,679,2,31,1,1
5611,26,274,16,14944,7430,7514,32,25,19,13
11521,10,27049,9,242,78,164,2,29,1,1
13697,26,13184,16,11681,3607,8074,40,120,20,20
21799,10,4048,9,182,93,89,2,31,1,1
21806,10,1823,9,194,102,92,2,31,1,1
22313,10,19389,9,266,87,179,4,33,2,2
2744,1453,13683,1106,890,126,764,3,31,2,1
2673,10,11197,9,217,87,130,2,31,1,1
10658,10,23008,9,260,86,174,2,30,1,1
15226,26,15768,16,4628,1035,3593,19,25,11,8
2744,1275,15358,955,908,126,782,2,30,1,1
4815,26,16314,16,4707,1800,2907,19,26,11,8
12539,1831,17124,1393,492,306,186,8,15,5,3
8584,1241,8917,921,255,78,177,2,31,1,1
16021,48,22651,31,402,132,270,6,1209,3,3
21942,10,14120,9,385,134,251,2,30,1,1
9970,26,4547,16,721741,131746,589995,1518,322,787,731
8427,15,24731,11,2013987,64000,1949987,1818,160,504,1314
8358,15,10508,11,2807,587,2220,13,16,7,6
8385,26,24128,16,590577,16239,574338,610,23,222,388
14816,10,8028,9,194,102,92,2,30,1,1
10797,3019,8939,2347,70,70,0,2,8,2,0
8627,10,16768,9,198,102,96,2,29,1,1
14992,10,12669,9,233,94,139,2,30,1,1
10991,26,19046,16,6913,1658,5255,22,17,12,10
8996,10,28166,9,198,94,104,2,30,1,1
3519,10,14408,9,216,90,126,2,30,1,1
11232,3219,7861,2496,250,66,184,4,9,2,2
17019,26,26328,16,1129,599,530,12,25,6,6
7428,26,26612,16,172,172,0,2,5,2,0
4117,26,17300,16,13035,2590,10445,27,125,14,13
7763,26,9117,16,5953,1848,4105,18,17,10,8
20520,26,28027,16,4419,1512,2907,19,30,11,8
15061,26,8419,16,6463,3844,2619,39,135,21,18
2405,15,9936,11,24232,4550,19682,59,17,34,25
9207,10,19251,9,168,86,82,2,31,1,1
22557,10,5359,9,196,102,94,2,30,1,1
22149,10,12579,9,210,110,100,2,29,1,1
18495,26,20086,16,4355,2135,2220,15,136,7,8
15270,10,20698,9,183,94,89,2,30,1,1
21789,10,2191,9,196,100,96,2,31,1,1
14080,10,6147,9,194,102,92,2,30,1,1
10633,26,28022,16,4638384,61757,4576627,3641,280,309,3332
9078,26,4281,16,10915,2554,8361,33,270,17,16
22680,10,2801,9,193,102,91,2,30,1,1
15059,10,11898,9,816,102,714,2,30,1,1
14024,26,24165,16,3997,1374,2623,14,136,7,7
16012,26,27827,16,6350,1550,4800,23,41,12,11
21797,10,6555,9,198,101,97,2,30,1,1
5000,26,7421,16,9824,2902,6922,38,48,19,19
12397,10,1131,9,168,78,90,2,29,1,1
4544,10,27433,9,168,78,90,2,30,1,1
9728,405,14020,263,311,311,0,3,1199,3,0
14643,10,16881,9,185,102,83,2,31,1,1
14284,10,8491,9,760,96,664,2,30,1,1
8943,26,16850,16,8638,2215,6423,24,126,14,10
14478,10,12560,9,210,110,100,2,30,1,1
4685,26,4884,16,8493,2314,6179,33,15,18,15
15246,26,26192,16,7940,1951,5989,20,16,11,9
9111,15,19064,11,362232,10443,351789,387,15,147,240
12053,26,148,16,7434,1695,5739,23,27,12,11
11035,1639,27383,1259,70,70,0,2,7,2,0
14089,10,2909,9,184,94,90,2,30,1,1
20488,10,11202,9,304,86,218,2,29,1,1
20674,26,28574,16,1373,734,639,17,125,10,7
15177,10,12357,9,197,102,95,2,30,1,1
21042,26,28337,16,4349,1442,2907,19,27,11,8
8773,15,22958,11,378,192,186,7,41,4,3
21237,10,25418,9,211,102,109,2,30,1,1
701,10,2764,9,213,79,134,2,32,1,1
10111,26,276,16,5552,1179,4373,24,80,13,11
13713,26,7858,16,32852,17447,15405,61,64,32,29
8584,1238,10882,918,78,78,0,1,30,1,0
7785,26,21381,16,130,70,60,2,15,1,1
9691,10,1848,9,210,110,100,2,30,1,1
21220,183,28427,121,4134,2109,2025,18,17,9,9
3891,15,24676,11,416,210,206,7,28,4,3
15074,10,12173,9,193,102,91,2,30,1,1
3817,26,20229,16,584,370,214,9,26,6,3
8397,10,15696,9,351,94,257,2,30,1,1
21329,10,15163,9,193,102,91,2,29,1,1
16528,1820,5969,1387,204,64,140,4,10,2,2
16189,10,12066,9,168,78,90,2,30,1,1
18807,26,26983,16,16401,8712,7689,53,297,25,28
7228,234,8951,149,2372,1452,920,16,3600,8,8
8584,1241,27454,921,248,71,177,2,30,1,1
14320,10,3604,9,198,102,96,2,31,1,1
5487,26,14144,16,1701571,69958,1631613,1930,170,782,1148
10251,26,22345,16,1210,637,573,14,25,7,7
2734,26,9522,16,21275,16156,5119,41,22,23,18
22371,10,19955,9,239,94,145,2,30,1,1
8187,26,14543,16,7107,1636,5471,24,38,11,13
13025,10,7630,9,199,94,105,2,30,1,1
21262,10,11481,9,244,94,150,2,30,1,1
8876,10,12021,9,480,93,387,4,50,2,2
12224,26,5689,16,5987,2780,3207,21,140,10,11
8586,10,27155,9,183,94,89,2,30,1,1
9892,26,16789,16,4749,1897,2852,16,124,8,8
22348,10,19622,9,184,94,90,2,30,1,1
21541,10,13100,9,193,102,91,2,31,1,1
9338,26,25339,16,6363,1073,5290,18,38,10,8
13914,10,8521,9,186,95,91,2,31,1,1
7379,15,1988,11,70,70,0,2,5,2,0
12700,26,23399,16,8712,2293,6419,26,315,13,13
12630,10,2627,9,167,78,89,2,29,1,1
15269,26,209,16,8058,2038,6020,20,15,11,9
7630,15,23544,11,25162,23336,1826,34,19,21,13
8580,26,2194,16,3427,2159,1268,20,17,11,9
7262,26,20107,16,6701,3487,3214,35,196,19,16
8404,26,8248,16,8293,4179,4114,22,128,11,11
14609,10,0,0,213,88,125,2,30,1,1
22483,10,636,9,369,102,267,2,30,1,1
2168,10,8738,9,226,90,136,2,30,1,1
8484,10,11952,9,194,102,92,2,29,1,1
7687,26,20399,16,4373,1466,2907,19,27,11,8
8971,10,28735,9,331,102,229,2,30,1,1
11973,26,23585,16,108155,4527,103628,115,83,30,85
9620,15,22000,11,28872,5086,23786,50,24,24,26
16021,3232,23436,2506,1386,1386,0,22,1526,22,0
12951,15,10673,11,1585,863,722,12,15,6,6
21444,10,4480,9,180,94,86,2,31,1,1
8908,10,3748,9,213,102,111,2,29,1,1
11082,1322,10355,998,316,136,180,6,6,3,3
15674,10,2277,9,168,86,82,2,30,1,1
8777,10,5851,9,184,94,90,2,30,1,1
10643,26,13695,16,9979,4380,5599,26,256,12,14
22232,10,12283,9,256,93,163,2,30,1,1
9160,15,6109,11,3007,604,2403,11,15,6,5
19001,1277,14033,957,1582,1386,196,6,30,4,2
13493,26,3685,16,10078,2210,7868,36,120,19,17
21600,10,15490,9,186,95,91,2,30,1,1
14869,10,28642,9,751,95,656,2,31,1,1
22618,10,10815,9,677,188,489,6,57,3,3
16021,1579,25419,1209,132,132,0,3,1199,3,0
0,0,0,0,2000,1020,980,20,0,10,10
2744,2556,1503,1986,1642,126,1516,4,31,2,2
19978,26,27683,16,5442,2195,3247,22,39,13,9
2179,10,8785,9,374,240,134,3,32,2,1
15006,10,104,9,178,94,84,2,30,1,1
4560,26,8099,16,10790,5444,5346,21,122,10,11
8645,295,21507,190,5200,3745,1455,18,15,10,8
13465,15,24081,11,23168,3380,19788,36,19,18,18
9095,10,9520,9,594,196,398,6,82,3,3
2329,15,9591,11,2270,1645,625,9,26,6,3
13610,10,14980,9,188,96,92,2,31,1,1
11371,26,17707,16,4145,2738,1407,29,27,16,13
4503,26,1452,16,21446,1599,19847,35,155,16,19
9728,2498,5981,1944,166,166,0,1,1199,1,0
9709,10,22127,9,707,94,613,2,30,1,1
15900,10,4013,9,214,86,128,2,29,1,1
22003,10,11599,9,209,102,107,2,30,1,1
13716,26,15683,16,14701,3640,11061,29,60,16,13
8849,15,3155,11,1548,847,701,10,15,5,5
17883,26,9325,16,571,166,405,2,30,1,1
8553,26,20478,16,6250,1765,4485,22,15,12,10
14130,10,11680,9,210,110,100,2,31,1,1
9553,10,20410,9,731,85,646,2,30,1,1
22639,10,5341,9,209,110,99,2,30,1,1
9092,26,9391,16,9330,2410,6920,25,81,13,12
7358,26,3664,16,8908,3897,5011,19,135,9,10
14736,10,24912,9,194,102,92,2,31,1,1
17028,26,10988,16,5167,700,4467,16,15,7,9
13846,10,21965,9,209,110,99,2,30,1,1
15132,10,7759,9,184,94,90,2,31,1,1
12822,2925,5468,2270,70,70,0,2,8,2,0
16041,26,20087,16,1778,1219,559,13,27,8,5
8829,10,7778,9,184,80,104,2,30,1,1
13426,346,13513,220,110,110,0,1,31,1,0
21980,10,23076,9,190,97,93,2,31,1,1
13063,26,28673,16,10173,1548,8625,25,41,14,11
8509,10,27591,9,200,102,98,2,30,1,1
15843,26,15889,16,134,60,74,3,10,2,1
14895,10,19355,9,756,95,661,2,31,1,1
586,15,2251,11,3058,774,2284,11,16,6,5
8584,1238,28267,918,71,71,0,1,30,1,0
15701,26,21893,16,498,210,288,8,26,4,4
11837,26,19106,16,5584,1390,4194,19,15,9,10
15560,10,13075,9,192,98,94,2,31,1,1
15952,10,16905,9,358,102,256,2,30,1,1
21757,10,1996,9,199,102,97,2,29,1,1
14914,10,6861,9,209,110,99,2,30,1,1
5727,26,4274,16,130,70,60,3,5,2,1
5768,26,24027,16,7236,2069,5167,25,25,12,13
17890,26,18772,16,165464,10322,155142,189,71,69,120
9283,26,28889,16,31982,9936,22046,61,16,33,28
9176,295,21768,190,3132,815,2317,14,16,7,7
21156,2190,21679,1695,70,70,0,1,4,1,0
17081,26,24523,16,6133,1655,4478,12,120,5,7
13207,26,28168,16,44294,9390,34904,167,319,83,84
21348,10,25657,9,304,101,203,4,38,2,2
8852,10,3733,9,343,94,249,2,30,1,1
13868,10,26223,9,1210,950,260,2,29,1,1
8028,26,18135,16,1343,616,727,14,82,7,7
21622,10,27585,9,399,102,297,4,54,2,2
21637,10,21244,9,248,102,146,2,30,1,1
8403,26,21383,16,554853,293345,261508,600,69,317,283
21817,26,27002,16,24686,1935,22751,36,18,17,19
14404,10,8802,9,189,102,87,2,29,1,1
8356,26,9594,16,9734,1613,8121,24,17,12,12
21418,10,28234,9,197,102,95,2,30,1,1
8932,10,24086,9,234,102,132,2,30,1,1
16951,255,25970,160,156,62,94,2,10,1,1
18171,26,10713,16,10893,4674,6219,43,121,19,24
2724,1240,10805,920,172,86,86,2,29,1,1
16951,255,25970,160,156,62,94,2,10,1,1
13952,10,16052,9,195,102,93,2,29,1,1
4500,10,15920,9,178,82,96,2,30,1,1
5763,26,7012,16,14327,1918,12409,37,270,17,20
2744,1614,7451,1236,879,126,753,2,31,1,1
15350,10,19696,9,177,94,83,2,30,1,1
13407,26,24041,16,149676,25300,124376,220,110,122,98
12898,26,13371,16,76388,4341,72047,107,169,48,59
16789,26,14087,16,560,280,280,9,30,5,4
1668,26,6019,16,20280,2078,18202,35,17,19,16
14010,10,19266,9,199,102,97,2,30,1,1
15332,10,17027,9,167,86,81,2,30,1,1
636,280,14757,177,253,118,135,2,1199,1,1
6351,26,7633,16,4694,2432,2262,34,81,16,18
8704,26,6691,16,2926,1825,1101,22,171,11,11
1325,183,4429,121,4085,1916,2169,21,18,12,9
11032,10,28779,9,289,86,203,2,30,1,1
9477,10,6246,9,193,102,91,2,29,1,1
13800,26,12011,16,1610,771,839,22,120,11,11
22152,10,9616,9,250,94,156,2,30,1,1
22621,10,18877,9,305,94,211,2,29,1,1
17786,233,3985,148,139,139,0,1,5,1,0
15272,26,8494,16,8007,1987,6020,20,15,11,9
5601,26,25378,16,1462,735,727,15,185,8,7
3579,26,18132,16,6288,3354,2934,9,122,5,4
12390,1335,10373,1010,320,140,180,6,7,3,3
7009,10,28677,9,164,78,86,2,31,1,1
14320,10,15140,9,196,100,96,2,30,1,1
6314,26,27958,16,79507,72433,7074,96,415,60,36
9,18,14737,13,184,94,90,2,30,1,1
18879,26,27026,16,1092,645,447,10,34,6,4
9504,15,16427,11,5307,2694,2613,17,25,9,8
15535,10,3659,9,177,94,83,2,30,1,1
9130,10,26515,9,166,86,80,2,30,1,1
17991,26,14660,16,8031,2957,5074,27,46,16,11
5797,26,17934,16,6517,1003,5514,22,360,11,11
6026,26,7195,16,188529,10173,178356,248,256,93,155
3170,10,13432,9,832,106,726,2,30,1,1
18402,295,26758,190,3486,1983,1503,15,16,8,7
14136,10,5401,9,200,102,98,2,30,1,1
22587,10,14051,9,178,94,84,2,30,1,1
9209,15,1353,11,1455,349,1106,10,15,5,5
9535,346,21944,220,1614,785,829,11,54,6,5
12525,1934,14077,1477,70,70,0,1,5,1,0
8948,26,682,16,7757,1997,5760,23,126,13,10
19712,26,16488,16,4348,1643,2705,14,138,6,8
4603,10,16090,9,213,79,134,2,32,1,1
21324,10,6582,9,209,110,99,2,30,1,1
22387,10,12925,9,225,102,123,2,30,1,1
20995,26,22404,16,7987,2092,5895,18,119,8,10
15797,10,25607,9,215,94,121,2,30,1,1
16000,26,990,16,9581,3281,6300,36,16,16,20
21334,10,25841,9,280,110,170,2,30,1,1
9559,26,28004,16,2542,1504,1038,16,20,9,7
3537,26,7077,16,37541,4945,32596,69,127,31,38
19850,10,18040,9,179,86,93,2,30,1,1
22717,10,8908,9,168,86,82,2,30,1,1
10877,15,11932,11,366,240,126,7,31,5,2
15723,10,18286,9,224,102,122,2,29,1,1
14252,10,26552,9,308,101,207,4,53,2,2
8826,10,9916,9,193,102,91,2,30,1,1
14398,10,8941,9,283,98,185,4,52,2,2
10866,10,21638,9,168,78,90,2,30,1,1
15908,10,22054,9,177,94,83,2,30,1,1
14613,10,12875,9,200,102,98,2,30,1,1
15871,10,13517,9,195,102,93,2,30,1,1
6999,865,20541,639,150,150,0,1,1200,1,0
21760,10,18551,9,353,118,235,2,30,1,1
6901,26,12507,16,6336,1633,4703,22,256,12,10
3288,15,9540,11,1542,831,711,7,16,5,2
15347,10,12817,9,185,102,83,2,29,1,1
22685,10,6659,9,194,102,92,2,29,1,1
8882,26,4791,16,9323,3144,6179,24,130,14,10
682,10,2704,9,398,255,143,3,32,2,1
15102,10,10965,9,182,102,80,2,30,1,1
15010,15,9009,11,17248,1619,15629,26,25,11,15
21293,10,3598,9,93,93,0,1,31,1,0
17093,26,11006,16,5167,700,4467,16,15,7,9
16092,26,25040,16,162,102,60,2,5,1,1
9728,2498,15755,1944,1290,300,990,6,1200,3,3
3996,26,20308,16,47587,20536,27051,345,581,173,172
15213,26,21842,16,44984,28294,16690,77,40,40,37
21863,10,7033,9,166,86,80,2,31,1,1
4645,15,17664,11,1630,918,712,12,16,7,5
525,10,1918,9,244,98,146,2,33,1,1
12714,2208,22811,1710,320,140,180,6,6,3,3
8906,26,27426,16,7554,2281,5273,22,129,13,9
7153,26,12908,16,2312,1382,930,19,28,11,8
11029,1729,6474,1320,70,70,0,1,5,1,0
15841,10,14295,9,173,94,79,2,29,1,1
10764,3040,20877,2364,70,70,0,1,5,1,0
16954,26,869,16,7127,3015,4112,24,144,12,12
15115,10,8643,9,401,95,306,4,57,2,2
21167,15,22211,11,314,192,122,6,15,4,2
12951,15,9386,11,25148,5233,19915,39,71,21,18
8481,10,26796,9,214,94,120,2,30,1,1
4892,26,27363,16,566856,28278,538578,737,37,351,386
15011,15,22882,11,17128,1499,15629,24,25,9,15
12633,953,8172,703,70,70,0,1,5,1,0
6250,1999,21135,1529,148,86,62,2,30,1,1
2724,1240,28841,920,422,164,258,6,30,3,3
10974,563,11022,377,316,136,180,6,6,3,3
22531,10,4081,9,314,88,226,4,44,2,2
9748,26,22070,16,4401,1494,2907,19,28,11,8
12949,26,1958,16,10425,1383,9042,23,75,13,10
9502,26,7636,16,5133,2154,2979,26,81,13,13
9694,26,18299,16,8123,1809,6314,22,71,12,10
21441,10,8227,9,174,89,85,2,30,1,1
12096,26,6460,16,3655,2344,1311,18,17,9,9
14164,10,624,9,183,94,89,2,30,1,1
637,280,27546,177,238,118,120,2,1200,1,1
22429,10,11852,9,195,102,93,2,30,1,1
21119,2639,13238,2047,1518,1396,122,12,45,10,2
12913,234,13223,149,7608,1824,5784,34,171,19,15
14758,10,21328,9,178,94,84,2,30,1,1
14042,10,24376,9,199,102,97,2,30,1,1
18483,15,18,11,14498,6454,8044,24,120,12,12
636,280,9448,177,502,150,352,2,1200,1,1
22042,10,5396,9,190,97,93,2,31,1,1
9096,10,21140,9,190,97,93,2,30,1,1
2149,10,8633,9,228,90,138,2,32,1,1
8942,10,18352,9,182,94,88,2,30,1,1
10795,26,7886,16,3026,965,2061,14,135,7,7
8653,10,4099,9,183,94,89,2,31,1,1
14835,10,29027,9,202,103,99,2,30,1,1
15446,10,10441,9,443,182,261,6,29,3,3
1917,10,7351,9,244,98,146,2,32,1,1
2085,10,8222,9,209,77,132,2,33,1,1
21382,10,9927,9,212,102,110,2,29,1,1
13749,10,6084,9,180,94,86,2,30,1,1
5432,26,13508,16,234,234,0,4,12,4,0
10071,26,16561,16,8058,1136,6922,19,126,9,10
19781,15,8026,11,1670,422,1248,13,17,5,8
19313,26,28394,16,7741,1614,6127,21,77,11,10
11187,1051,21784,774,70,70,0,1,5,1,0
13349,10,6510,9,263,86,177,2,30,1,1
17101,26,15446,16,8937,5785,3152,26,16,14,12
6943,15,29112,11,1354,850,504,13,256,8,5
5063,26,11639,16,1593,946,647,15,64,8,7
14197,26,26653,16,8979,5057,3922,89,110,51,38
22087,10,12232,9,808,110,698,2,30,1,1
15943,10,5475,9,193,102,91,2,31,1,1
22121,10,21798,9,812,110,702,2,30,1,1
7715,26,27849,16,3543,1570,1973,18,120,9,9
11036,2546,4477,1978,70,70,0,2,7,2,0
7007,8,19438,8,130,66,64,2,5,1,1
21408,10,13639,9,216,102,114,2,30,1,1
21855,10,1024,9,199,102,97,2,31,1,1
12655,791,28397,575,70,70,0,2,7,2,0
15523,10,23648,9,183,94,89,2,30,1,1
15663,10,4750,9,198,102,96,2,30,1,1
22637,10,11016,9,210,110,100,2,30,1,1
17935,15,8229,11,1052,612,440,10,15,5,5
14383,10,18074,9,747,90,657,2,30,1,1
22225,10,12424,9,193,102,91,2,30,1,1
6144,10,0,0,86,86,0,1,30,1,0
21479,10,26006,9,186,95,91,2,31,1,1
22082,26,26593,16,6454,1227,5227,18,122,9,9
12957,295,23782,190,4067,1750,2317,16,16,9,7
18006,26,8955,16,5429,2835,2594,19,140,9,10
10713,26,26903,16,5060,2867,2193,26,398,9,17
9399,10,3516,9,756,95,661,2,30,1,1
22067,10,5480,9,166,85,81,2,31,1,1
15359,1057,11640,778,70,70,0,1,5,1,0
15437,10,2730,9,198,94,104,2,30,1,1
13676,10,2845,9,195,102,93,2,30,1,1
18449,410,19670,266,624,318,306,10,16,5,5
14768,10,14411,9,184,94,90,2,30,1,1
5086,26,15814,16,9144,1783,7361,19,16,10,9
4238,26,26256,16,2233,1237,996,18,75,9,9
16951,255,25970,160,126,62,64,2,5,1,1
15465,10,2423,9,199,102,97,2,30,1,1
2234,183,9137,121,3910,1805,2105,20,19,12,8
14812,10,25929,9,185,102,83,2,31,1,1
7593,26,14474,16,7002,4142,2860,46,1485,29,17
8210,3073,21194,2387,519,158,361,2,1199,1,1
10452,26,22935,16,20351,3359,16992,52,103,27,25
11113,1220,25755,902,70,70,0,1,4,1,0
18907,26,27035,16,3672,2294,1378,23,17,13,10
12700,26,27417,16,499,425,74,4,1,3,1
22212,10,24120,9,224,78,146,2,30,1,1
12742,26,567,16,499,425,74,4,0,3,1
9339,26,23211,16,6363,1073,5290,18,38,10,8
21837,10,8151,9,718,94,624,2,30,1,1
15570,10,26205,9,711,87,624,2,30,1,1
1222,15,4032,11,450,246,204,8,24,5,3
21105,10,635,9,578,286,292,9,15,5,4
12105,26,14568,16,14933,1671,13262,31,66,15,16
13783,10,7154,9,214,110,104,2,30,1,1
3933,23,0,0,15190,7454,7736,78,30,39,39
13008,26,22163,16,18159,12786,5373,34,270,19,15
15019,10,5876,9,742,88,654,2,30,1,1
1331,26,4463,16,6981,948,6033,17,27,10,7
19374,26,7293,16,49181,3553,45628,65,46,29,36
3555,15,16931,11,424,210,214,7,27,4,3
14909,10,7462,9,177,94,83,2,29,1,1
10760,1653,27753,1270,70,70,0,2,8,2,0
8584,1867,18683,1425,237,71,166,2,30,1,1
8603,26,1666,16,9621,2347,7274,24,78,12,12
15275,15,8261,11,51889,4253,47636,68,64,31,37
8584,1239,13305,919,250,78,172,2,31,1,1
607,15,2420,11,326,186,140,6,29,4,2
10968,15,6784,11,4424,3281,1143,12,27,8,4
11845,234,4948,149,9201,2130,7071,41,5528,21,20
12497,10,5618,9,523,85,438,4,31,2,2
7331,10,25639,9,199,94,105,2,30,1,1
4935,15,477,11,3843,1312,2531,19,227,6,13
16682,26,5065,16,4039,805,3234,17,120,8,9
2724,1240,17732,920,422,164,258,6,30,3,3
15314,10,25057,9,825,99,726,2,30,1,1
21609,10,5415,9,183,94,89,2,30,1,1
14492,1030,836,758,150,150,0,1,1200,1,0
15535,10,14221,9,210,102,108,2,30,1,1
14531,10,12960,9,711,87,624,2,30,1,1
13646,10,995,9,195,102,93,2,30,1,1
8484,10,21043,9,166,86,80,2,30,1,1
4997,26,7524,16,3547,955,2592,13,120,6,7
14564,10,15024,9,184,94,90,2,31,1,1
22113,10,19966,9,197,102,95,2,30,1,1
7075,26,23551,16,1394,733,661,14,80,8,6
14252,10,22003,9,199,102,97,2,30,1,1
18812,1356,24348,1029,70,70,0,1,5,1,0
13697,26,3958,16,36707,3750,32957,54,60,24,30
14342,876,22352,645,320,140,180,6,6,3,3
16051,26,10273,16,3640,606,3034,13,120,6,7
7220,26,9509,16,130,70,60,2,15,1,1
22498,10,765,9,202,103,99,2,31,1,1
9064,26,3599,16,6300,2644,3656,16,121,8,8
10987,26,22842,16,3516,1732,1784,34,42,19,15
8327,3099,24887,2407,502,150,352,3,1200,2,1
20602,26,15061,16,6781,1289,5492,17,15,9,8
15243,10,18652,9,199,102,97,2,30,1,1
3881,26,5507,16,3308,2109,1199,30,751,16,14
15165,10,23593,9,711,87,624,2,30,1,1
14943,10,21658,9,190,97,93,2,31,1,1
14212,10,13263,9,184,80,104,2,30,1,1
8965,10,6082,9,183,94,89,2,30,1,1
9352,10,7625,9,751,95,656,2,31,1,1
16443,26,22649,16,124014,6270,117744,175,27,69,106
9013,10,16117,9,196,102,94,2,31,1,1
6250,1992,13178,1522,140,78,62,2,30,1,1
14705,10,26237,9,323,102,221,2,29,1,1
15035,10,16962,9,199,102,97,2,30,1,1
15199,10,17411,9,199,102,97,2,29,1,1
4036,26,15203,16,157435,9243,148192,220,97,101,119
22238,10,17798,9,265,94,171,2,30,1,1
8075,26,19443,16,227876,8050,219826,236,36,83,153
4427,15,15262,11,3335,2735,600,12,30,7,5
13869,26,644,16,1118883,33814,1085069,1206,48,451,755
5085,26,28233,16,6969,2162,4807,20,15,11,9
10649,295,22568,190,2163,676,1487,14,15,7,7
22182,1272,1571,952,735,462,273,2,31,1,1
6946,26,4486,16,9468,2242,7226,23,15,12,11
9154,10,26856,9,198,102,96,2,30,1,1
15561,10,18714,9,216,110,106,2,30,1,1
9915,26,7113,16,4521,2256,2265,15,135,7,8
8526,15,11280,11,60,60,0,2,154,2,0
11058,10,22763,9,194,87,107,2,31,1,1
12337,15,3559,11,2577,1278,1299,14,267,8,6
16476,15,11113,11,2312,1094,1218,25,89,13,12
10799,888,23041,656,70,70,0,1,5,1,0
1909,280,15179,177,150,150,0,1,1200,1,0
13895,10,28358,9,711,87,624,2,30,1,1
11193,638,10045,443,70,70,0,2,8,2,0
21653,10,958,9,102,102,0,1,30,1,0
9857,15,24239,11,708,384,324,12,195,7,5
8832,10,2624,9,325,126,199,2,30,1,1
21155,811,15174,591,66,66,0,2,8,2,0
4007,26,19322,16,7470,1088,6382,21,27,12,9
8678,26,27711,16,12472,1628,10844,35,195,16,19
1219,280,2739,177,490,150,340,2,1200,1,1
12152,26,9979,16,11175,1078,10097,25,41,11,14
1135,10,3815,9,197,90,107,2,30,1,1
22569,10,12149,9,770,102,668,2,30,1,1
20605,10,18170,9,78,78,0,1,30,1,0
11060,2160,17184,1668,70,70,0,2,8,2,0
9966,26,11924,16,166814,93487,73327,620,4017,312,308
2744,1238,11521,918,889,126,763,2,30,1,1
21718,10,20729,9,196,102,94,2,30,1,1
22535,10,23327,9,760,97,663,2,30,1,1
22162,10,16006,9,725,277,448,8,61,4,4
7347,26,19940,16,1494,898,596,12,142,6,6
2046,2627,21369,2037,459,149,310,2,1200,1,1
8933,15,14483,11,70,70,0,2,8,2,0
13650,10,646,9,168,86,82,2,31,1,1
11162,2813,11809,2183,70,70,0,1,4,1,0
8391,10,10716,9,199,102,97,2,30,1,1
15514,10,18435,9,196,102,94,2,30,1,1
17846,26,12173,16,304,86,218,2,31,1,1
17109,26,16475,16,4055,1295,2760,11,121,6,5
9627,26,12327,16,10050,1192,8858,28,81,14,14
11815,26,29024,16,17521,6560,10961,55,117,28,27
5363,26,27685,16,11188,5277,5911,95,587,44,51
22567,10,3256,9,184,94,90,2,30,1,1
14276,15,15326,11,70,70,0,1,5,1,0
18741,26,15622,16,41921,15385,26536,69,34,37,32
8890,10,14803,9,210,102,108,2,30,1,1
9870,1251,18438,931,269,78,191,2,30,1,1
10640,26,24100,16,19849,6817,13032,45,37,23,22
14019,10,15253,9,199,102,97,2,30,1,1
3597,15,15095,11,1836,662,1174,15,3826,6,9
12743,26,17338,16,499,425,74,4,0,3,1
3446,10,18321,9,164,78,86,2,29,1,1
12950,26,15717,16,11065,1394,9671,23,75,13,10
21911,10,2817,9,757,102,655,2,30,1,1
14252,10,594,9,199,102,97,2,30,1,1
14509,10,26490,9,733,85,648,2,30,1,1
17828,26,711,16,8867,2701,6166,21,105,9,12
8324,26,13842,16,5115,977,4138,18,18,10,8
16583,26,10245,16,153,93,60,2,5,1,1
16707,10,6612,9,255,86,169,2,30,1,1
12632,1,28683,1,70,70,0,1,4,1,0
22180,10,9005,9,250,102,148,2,31,1,1
4208,10,2610,9,198,93,105,2,30,1,1
8897,15,17541,11,318,192,126,6,130,4,2
15113,26,2161,16,6044,3444,2600,49,501,25,24
8931,10,4528,9,194,102,92,2,30,1,1
2744,1239,3772,919,884,126,758,2,30,1,1
16021,617,23572,425,1577,594,983,20,1638,10,10
15380,10,17025,9,178,94,84,2,30,1,1
9358,15,28345,11,1277,460,817,16,77,5,11
14923,183,24874,121,3424,1710,1714,16,33,8,8
14846,10,26976,9,170,87,83,2,31,1,1
6298,26,4686,16,9412,2994,6418,27,48,16,11
1111,26,5878,16,3614,434,3180,11,1,6,5
8943,10,23120,9,216,110,106,2,30,1,1
7965,26,11613,16,11482,2506,8976,48,1329,24,24
17857,26,1586,16,510,164,346,2,31,1,1
6567,26,5694,16,60,60,0,1,5,1,0
5900,26,13760,16,1807,1048,759,16,25,8,8
4318,26,10380,16,7298,2661,4637,21,18,11,10
11018,1578,5377,1208,66,66,0,1,5,1,0
9662,26,11369,16,1352,691,661,14,47,8,6
6640,26,21843,16,10316,2303,8013,39,120,20,19
5655,26,18632,16,20594,14251,6343,40,361,22,18
15245,15,19488,11,234,234,0,4,12,4,0
8856,10,6073,9,790,110,680,2,29,1,1
8887,26,14968,16,65732,3951,61781,102,65,40,62
21823,10,2031,9,602,93,509,4,42,2,2
15503,10,23573,9,774,101,673,2,31,1,1
18984,26,18217,16,212824,12881,199943,244,49,101,143
8339,10,13930,9,227,102,125,2,29,1,1
9417,26,1289,16,10103,2342,7761,39,121,22,17
14907,10,5511,9,177,94,83,2,30,1,1
1592,10,5740,9,235,90,145,2,32,1,1
4698,26,20797,16,499,425,74,4,0,3,1
13678,26,281,16,552073,14113,537960,536,31,176,360
13773,10,27555,9,762,97,665,2,31,1,1
17385,26,19832,16,30048,2775,27273,41,137,16,25
14720,10,1027,9,168,86,82,2,30,1,1
10906,26,917,16,1852,1103,749,16,32,9,7
21794,10,21337,9,273,94,179,2,30,1,1
14077,10,22128,9,711,87,624,2,30,1,1
14266,10,4439,9,168,86,82,2,30,1,1
14442,10,29047,9,196,102,94,2,31,1,1
10009,15,11677,11,186520,11545,174975,222,141,96,126
9825,15,26534,11,318,192,126,6,26,4,2
12519,1113,27667,818,1656,914,742,13,21,9,4
9411,2143,6756,1656,726,726,0,12,1200,12,0
11783,15,19327,11,6022,2590,3432,37,131,20,17
9016,10,6133,9,230,102,128,2,31,1,1
12651,26,12123,16,499,425,74,4,0,3,1
12353,2566,17941,1993,492,306,186,8,15,5,3
12712,26,10086,16,499,425,74,4,1,3,1
10762,2770,11612,2149,70,70,0,2,8,2,0
5519,26,1621,16,21106,2445,18661,45,20,24,21
19546,26,13000,16,7443,2692,4751,19,76,11,8
9064,295,21719,190,2958,1567,1391,15,15,8,7
21673,10,24735,9,195,102,93,2,30,1,1
22640,10,10922,9,315,87,228,4,40,2,2
14547,10,15623,9,177,94,83,2,30,1,1
9211,26,2850,16,27889,1445,26444,37,121,14,23
11224,1041,27395,765,66,66,0,1,5,1,0
8981,15,24934,11,130,70,60,2,15,1,1
13922,10,23617,9,701,88,613,2,30,1,1
1214,26,28194,16,6151,2939,3212,28,332,13,15
8730,10,27268,9,193,102,91,2,30,1,1
16316,26,58,16,91134,7506,83628,132,130,52,80
8584,1238,8077,918,255,78,177,2,30,1,1
3310,26,3759,16,3935,1010,2925,20,165,9,11
17886,26,16341,16,8432,1967,6465,35,68,17,18
2516,10,10547,9,231,90,141,2,30,1,1
21842,10,11017,9,89,89,0,1,30,1,0
11505,15,20536,11,4302,3722,580,14,15,8,6
11036,2546,26664,1978,70,70,0,1,5,1,0
13743,10,26460,9,196,102,94,2,29,1,1
22434,10,18259,9,209,110,99,2,30,1,1
11939,26,27709,16,2881,346,2535,12,120,5,7
2724,1240,3668,920,422,164,258,6,30,3,3
21837,10,5681,9,208,106,102,2,31,1,1
6847,15,19168,11,22407,7251,15156,35,23,16,19
3910,15,3197,11,7891,2035,5856,17,32,10,7
21313,10,16182,9,692,224,468,6,49,3,3
21363,1961,25271,1498,66,66,0,2,7,2,0
11022,1040,26920,764,70,70,0,2,7,2,0
18432,15,26779,11,266818,12375,254443,285,34,107,178
10643,26,22948,16,3013,1661,1352,14,20,8,6
13106,1239,6408,919,924,924,0,3,30,3,0
15050,10,4920,9,711,87,624,2,30,1,1
532,247,0,0,3354,1792,1562,46,192,23,23
14985,10,6228,9,213,102,111,2,30,1,1
11131,26,18747,16,22696,18094,4602,41,315,25,16
16746,10,13009,9,167,78,89,2,30,1,1
16008,10,28712,9,774,101,673,2,30,1,1
22637,10,10058,9,210,110,100,2,30,1,1
15447,10,12706,9,184,94,90,2,30,1,1
5552,15,613,11,7086,1841,5245,15,92,8,7
11840,26,29017,16,8519,1687,6832,29,17,16,13
8850,26,28525,16,9083,2300,6783,19,56,10,9
8514,26,18507,16,8309,949,7360,19,75,9,10
8327,433,9493,281,842,150,692,4,1200,2,2
10994,26,4456,16,5363,2713,2650,26,53,14,12
15600,10,23217,9,170,87,83,2,30,1,1
17462,10,17822,9,511,126,385,2,31,1,1
7871,26,17333,16,3718,420,3298,13,120,6,7
15299,10,14125,9,182,94,88,2,29,1,1
3593,15,7190,11,1360,540,820,20,191,10,10
11178,15,22813,11,62796,1961,60835,72,141,26,46
15185,26,1559,16,8035,2015,6020,20,16,11,9
15111,26,13362,16,3055,993,2062,10,120,5,5
22654,26,26376,16,92040,4799,87241,107,16,43,64
4308,26,19501,16,3579,1914,1665,23,291,8,15
15873,10,25325,9,216,82,134,2,32,1,1
12749,957,28411,706,612,366,246,10,19,6,4
6905,10,4418,9,168,78,90,2,30,1,1
16377,26,22946,16,5465,2653,2812,28,169,14,14
17275,26,1930,16,3155,836,2319,13,135,6,7
10312,26,27805,16,8857,2827,6030,52,17,29,23
14584,10,11600,9,939,678,261,2,30,1,1
22630,10,24626,9,751,95,656,2,31,1,1
13668,15,2555,11,1573,1145,428,13,32,8,5
15890,26,24491,16,12837,1681,11156,30,62,16,14
9424,10,5483,9,196,102,94,2,31,1,1
12953,26,1273,16,5702,1212,4490,19,139,10,9
15283,26,16387,16,9634,3110,6524,26,138,11,15
1078,26,15826,16,6096,777,5319,17,25,9,8
9046,15,21299,11,2560,599,1961,13,75,7,6
9256,10,16063,9,199,102,97,2,30,1,1
13890,10,11156,9,184,102,82,2,30,1,1
9435,10,3294,9,189,102,87,2,30,1,1
13869,10,27601,9,168,86,82,2,30,1,1
8576,10,2866,9,178,94,84,2,30,1,1
230,10,578,9,216,98,118,2,30,1,1
15177,10,24847,9,423,102,321,4,38,2,2
21297,10,13598,9,196,102,94,2,29,1,1
21996,10,21044,9,328,150,178,2,30,1,1
21278,10,16121,9,193,102,91,2,29,1,1
20777,26,28193,16,4659,1752,2907,19,30,11,8
22587,10,24443,9,186,102,84,2,29,1,1
15502,10,26148,9,177,94,83,2,30,1,1
9106,26,21741,16,29781,5947,23834,63,47,32,31
22558,10,26938,9,198,101,97,2,31,1,1
9096,10,460,9,289,94,195,2,30,1,1
9418,26,6351,16,8456,2502,5954,32,120,19,13
15071,15,5069,11,65864,3286,62578,76,135,30,46
7582,26,13136,16,7298,2661,4637,21,17,11,10
13912,10,8937,9,168,86,82,2,30,1,1
13714,18,11288,13,184,94,90,2,30,1,1
17143,15,8418,11,1439485,27511,1411974,1308,108,369,939
15299,10,14804,9,308,97,211,4,45,2,2
17428,10,28119,9,168,78,90,2,30,1,1
2724,1240,9821,920,340,82,258,5,29,2,3
19328,26,7677,16,7796,766,7030,16,27,8,8
15303,26,4729,16,8652,2148,6504,20,15,11,9
4513,15,18097,11,763,434,329,8,14,5,3
7759,15,16077,11,1638,1324,314,10,16,5,5
9043,10,25303,9,517,95,422,4,44,2,2
4280,26,4715,16,8111,5060,3051,31,396,11,20
15279,10,21415,9,177,94,83,2,31,1,1
21948,10,2873,9,184,94,90,2,30,1,1
21302,1227,9276,907,66,66,0,2,7,2,0
7625,15,1651,11,70,70,0,1,120,1,0
21700,10,18327,9,196,102,94,2,31,1,1
14961,10,15210,9,177,94,83,2,30,1,1
8220,26,26768,16,111590,17663,93927,212,115,93,119
20065,26,12800,16,16258,11067,5191,37,45,21,16
12475,26,20393,16,31965,26754,5211,63,22,34,29
21341,15,11828,11,314,192,122,6,15,4,2
13696,10,24079,9,782,105,677,2,30,1,1
14504,10,3220,9,182,93,89,2,30,1,1
17478,10,18736,9,164,78,86,2,30,1,1
4306,26,14195,16,2064683,47545,2017138,1994,33,657,1337
7475,26,5388,16,15452,3787,11665,36,62,19,17
8392,26,21374,16,854266,56622,797644,969,98,420,549
15588,15,22265,11,1348,844,504,13,255,8,5
11456,26,4208,16,5082,896,4186,16,70,8,8
636,280,21008,177,502,150,352,2,1200,1,1
13644,10,5545,9,168,86,82,2,31,1,1
13266,10,18534,9,304,86,218,2,30,1,1
13108,1238,4253,918,924,924,0,3,30,3,0
8541,10,19860,9,193,102,91,2,30,1,1
15269,10,12515,9,192,98,94,2,30,1,1
9454,15,9547,11,2481,723,1758,12,57,6,6
10828,15,22001,11,1825,824,1001,21,134,11,10
17130,26,9978,16,5168,700,4468,16,15,7,9
15952,26,24639,16,1054,567,487,10,24,6,4
2744,1351,8789,1024,918,126,792,2,30,1,1
15157,15,5368,11,1630,918,712,12,17,7,5
1184,26,25835,16,7481,2070,5411,25,315,12,13
15797,10,24005,9,180,94,86,2,30,1,1
5077,26,13444,16,318,192,126,6,14,4,2
10917,749,11935,538,70,70,0,1,5,1,0
10631,26,22066,16,5854,1148,4706,18,23,10,8
14976,10,23798,9,199,102,97,2,29,1,1
532,247,0,0,3354,1792,1562,46,193,23,23
21405,10,3186,9,215,94,121,2,31,1,1
11718,26,20221,16,352,218,134,6,28,4,2
9012,10,10789,9,167,86,81,2,30,1,1
15358,10,1098,9,186,95,91,2,30,1,1
6849,26,28748,16,36026,28458,7568,70,407,30,40
18441,26,20907,16,22073,10774,11299,48,107,26,22
225,10,15414,9,204,118,86,2,30,1,1
15035,10,7072,9,195,102,93,2,30,1,1
16006,10,18801,9,916,86,830,2,31,1,1
14076,10,23183,9,209,110,99,2,30,1,1
15403,2715,25515,2109,70,70,0,2,8,2,0
12500,862,27219,636,492,306,186,8,16,5,3
8718,10,17112,9,102,102,0,1,30,1,0
11635,15,22566,11,1960,1366,594,12,34,7,5
3621,26,27377,16,14068,7909,6159,37,82,23,14
18526,288,11633,185,70,70,0,1,5,1,0
20053,188,11773,123,140,140,0,1,30,1,0
13889,26,13302,16,36501,26194,10307,76,71,47,29
9423,26,28984,16,268,120,148,5,11,3,2
5759,26,22275,16,1093,662,431,10,41,6,4
11047,1193,12917,882,66,66,0,1,5,1,0
15329,26,17566,16,9868,2027,7841,24,20,12,12
612,139,2457,100,130,66,64,2,5,1,1
8584,1200,28033,888,254,78,176,2,30,1,1
11110,426,18709,277,70,70,0,1,5,1,0
13672,10,13340,9,174,89,85,2,30,1,1
3279,15,23050,11,1644,1324,320,10,15,5,5
10745,15,23461,11,3309,2152,1157,18,150,10,8
14955,10,23752,9,711,87,624,2,30,1,1
15297,26,1469,16,7941,1952,5989,20,15,11,9
14262,3003,8683,2334,70,70,0,1,5,1,0
12020,15,18204,11,3683,606,3077,12,15,6,6
11133,303,28760,197,70,70,0,2,7,2,0
6870,26,1536,16,10667,2992,7675,32,560,17,15
10794,15,17591,11,5605,3306,2299,21,74,13,8
13828,26,19991,16,2970,1689,1281,24,18,13,11
22313,10,23578,9,193,102,91,2,30,1,1
13503,26,22344,16,8093,1263,6830,25,39,13,12
18115,26,17485,16,134,60,74,3,6,2,1
8377,15,11035,11,2965,715,2250,9,75,5,4
9693,15,28761,11,378,192,186,7,21,4,3
8210,287,21194,184,1283,666,617,6,1200,3,3
15269,26,505,16,3723,2372,1351,18,18,10,8
8602,10,27337,9,718,94,624,2,30,1,1
15978,10,22133,9,747,90,657,2,30,1,1
6127,15,18140,11,127215,3221,123994,137,3685,42,95
14858,10,11601,9,195,102,93,2,29,1,1
2744,1238,7902,918,871,126,745,2,31,1,1
15256,10,3843,9,195,102,93,2,30,1,1
11901,26,17752,16,10754,4129,6625,42,112,20,22
18502,2429,6824,1890,70,70,0,2,8,2,0
8349,10,19214,9,211,102,109,2,30,1,1
16050,26,16804,16,5238,695,4543,14,25,8,6
11927,26,19632,16,26309,3035,23274,69,92,27,42
15342,10,19230,9,177,94,83,2,30,1,1
9518,10,28299,9,755,102,653,2,29,1,1
8694,10,20156,9,170,87,83,2,30,1,1
21936,10,20330,9,393,110,283,2,30,1,1
21243,10,2913,9,262,86,176,4,46,2,2
9728,2846,26015,2209,1326,300,1026,6,1200,3,3
3292,26,7497,16,47948,40338,7610,82,17,43,39
8742,15,1222,11,318,192,126,6,43,4,2
8177,15,14489,11,1794,1480,314,13,15,8,5
5697,107,17485,83,156,156,0,3,7,3,0
14216,10,14179,9,168,86,82,2,30,1,1
7467,26,20110,16,4594,1687,2907,19,30,11,8
11156,2875,3203,2234,70,70,0,1,5,1,0
22206,1246,10233,926,1773,924,849,6,30,3,3
22655,10,13275,9,200,102,98,2,33,1,1
15711,26,24395,16,1647,1375,272,9,37,5,4
5724,10,22712,9,168,78,90,2,30,1,1
9587,15,6653,11,378,192,186,7,19,4,3
15279,10,8117,9,188,96,92,2,31,1,1
8995,26,2905,16,6131,1960,4171,18,15,10,8
22702,10,12664,9,195,102,93,2,31,1,1
8991,10,11229,9,650,286,364,8,84,4,4
14422,10,1815,9,177,94,83,2,30,1,1
9505,15,17657,11,318,192,126,6,28,4,2
12710,1125,22574,829,70,70,0,1,5,1,0
18668,15,26897,11,1916,1467,449,10,19,6,4
14010,10,5653,9,271,93,178,4,42,2,2
9557,18,20893,13,184,94,90,2,31,1,1
8859,10,29055,9,209,110,99,2,30,1,1
14681,10,19639,9,237,94,143,2,29,1,1
3909,15,7666,11,3515,1137,2378,12,30,7,5
18794,1989,3432,1519,316,136,180,6,6,3,3
12076,26,15803,16,5244,1925,3319,33,21,17,16
8584,1868,19089,1426,239,71,168,2,30,1,1
8999,10,8251,9,194,102,92,2,30,1,1
8862,10,3772,9,178,94,84,2,30,1,1
8376,10,4053,9,198,101,97,2,31,1,1
3066,1644,20809,1263,502,150,352,2,1200,1,1
22347,10,22968,9,167,86,81,2,30,1,1
15792,10,13579,9,210,102,108,2,30,1,1
17165,26,248,16,505070,16437,488633,543,45,187,356
4620,26,7748,16,8619,2288,6331,41,361,16,25
8724,10,4092,9,193,102,91,2,30,1,1
6600,26,23443,16,130,70,60,2,15,1,1
21163,2184,26472,1689,312,132,180,6,6,3,3
18373,26,28138,16,2622412,144918,2477494,3052,316,1078,1974
14978,10,24923,9,179,94,85,2,31,1,1
5575,26,19619,16,29714,2090,27624,43,97,17,26
8819,26,24723,16,8915,2193,6722,22,46,13,9
4890,234,25651,149,4235,1797,2438,38,4443,13,25
21859,10,3124,9,193,102,91,2,30,1,1
16606,10,25773,9,237,93,144,2,31,1,1
6344,26,13087,16,10845900,123386,10722514,8862,139,1081,7781
3616,26,559,16,3208,2015,1193,19,34,11,8
1731,2700,18887,2097,28448,16525,11923,253,3696,148,105
18301,26,13918,16,1907736,31488,1876248,1747,21,470,1277
21978,26,17894,16,145226,5591,139635,164,120,58,106
15295,26,26659,16,4989,1014,3975,16,53,9,7
14527,10,9264,9,177,94,83,2,30,1,1
14133,10,26048,9,170,87,83,2,30,1,1
8520,26,13898,16,7030,1195,5835,20,76,10,10
15320,15,15087,11,214,140,74,4,25,3,1
15651,10,8142,9,198,102,96,2,30,1,1
9016,10,3261,9,94,94,0,1,29,1,0
21937,10,12915,9,179,86,93,2,30,1,1
15731,10,24435,9,177,94,83,2,30,1,1
9645,26,8114,16,1499,930,569,16,78,9,7
15725,26,5681,16,1779,1375,404,11,40,5,6
21413,10,3854,9,498,93,405,4,47,2,2
8332,259,10254,163,143727,72050,71677,1106,10824,655,451
12449,606,9592,417,70,70,0,2,7,2,0
22345,10,5884,9,199,102,97,2,30,1,1
10129,26,29100,16,6544,939,5605,17,17,10,7
15347,10,11513,9,168,86,82,2,30,1,1
12952,26,21016,16,2573,330,2243,12,136,5,7
22049,10,27655,9,260,102,158,2,30,1,1
10924,1190,16473,879,70,70,0,2,8,2,0
9641,26,27034,16,1322,725,597,14,78,7,7
22196,10,16289,9,194,102,92,2,30,1,1
6941,26,15323,16,6297,1831,4466,20,16,9,11
12522,968,17160,716,70,70,0,2,7,2,0
10205,15,25899,11,6363,3093,3270,36,130,19,17
17895,26,26501,16,4580,1673,2907,19,28,11,8
9200,26,23500,16,2652,1566,1086,15,86,9,6
9067,26,18394,16,8078,1511,6567,30,54,14,16
6058,26,6320,16,167721,6935,160786,185,77,68,117
17390,15,5315,11,2865,2000,865,12,16,7,5
15622,10,11493,9,170,87,83,2,31,1,1
22176,10,12160,9,197,102,95,2,31,1,1
16979,26,12675,16,11116,2910,8206,30,20,16,14
10537,26,4964,16,828,390,438,11,60,4,7
10639,26,8094,16,2013,1363,650,12,134,7,5
3834,234,636,149,10206,2218,7988,36,4265,18,18
15363,26,15408,16,22508,1965,20543,32,17,13,19
15482,10,1503,9,260,86,174,2,30,1,1
10201,233,7801,148,4070,1456,2614,26,2889,15,11
8688,26,25805,16,2731084,2639957,91127,2979,151,1945,1034
7544,26,22749,16,4146,2690,1456,31,37,16,15
6998,10,19432,9,86,86,0,1,30,1,0
9512,10,26242,9,70,70,0,1,30,1,0
12517,476,11294,310,70,70,0,2,8,2,0
8515,10,10263,9,194,102,92,2,31,1,1
10550,26,26981,16,451,259,192,5,23,2,3
22067,10,21738,9,196,102,94,2,30,1,1
15248,10,4300,9,193,102,91,2,30,1,1
4704,26,5961,16,7766,1810,5956,24,46,14,10
14340,10,22953,9,164,86,78,2,29,1,1
10983,26,28655,16,8900,2020,6880,28,25,15,13
8925,10,12146,9,216,110,106,2,30,1,1
22314,10,20357,9,195,94,101,2,29,1,1
4669,26,22132,16,499,425,74,4,2,3,1
9793,15,28078,11,1366,865,501,8,15,5,3
13609,10,24047,9,177,94,83,2,29,1,1
22011,10,27803,9,816,102,714,2,30,1,1
9411,2255,4294,1746,70,70,0,1,1200,1,0
2183,10,8816,9,244,98,146,2,33,1,1
13721,26,16538,16,3136,2025,1111,19,26,10,9
2767,10,28818,9,396,257,139,3,30,2,1
21992,10,24324,9,418,150,268,2,30,1,1
13975,26,9018,16,24341,15170,9171,78,461,39,39
4039,26,9940,16,119911,5690,114221,153,173,63,90
16021,1048,15984,772,481,150,331,2,1199,1,1
21298,10,7780,9,195,102,93,2,29,1,1
15911,10,10884,9,177,94,83,2,29,1,1
14353,660,28633,461,70,70,0,1,5,1,0
6036,26,5141,16,7670,2131,5539,30,27,15,15
17072,26,3902,16,5106,700,4406,15,15,7,8
18152,10,19638,9,168,78,90,2,30,1,1
13958,10,5224,9,167,86,81,2,30,1,1
4312,15,1418,11,1585,863,722,12,15,6,6
12449,26,4698,16,8738,2628,6110,23,154,11,12
8317,26,14709,16,3655,1807,1848,17,15,9,8
8546,15,10968,11,6307,2851,3456,18,150,9,9
9175,10,2859,9,766,102,664,2,30,1,1
2909,26,1024,16,8830,2388,6442,29,124,14,15
8724,10,7825,9,177,94,83,2,30,1,1
14239,10,17919,9,768,200,568,6,53,3,3
7395,26,20024,16,4398,1491,2907,19,30,11,8
3804,10,17539,9,168,78,90,2,30,1,1
4144,26,11031,16,5205,1251,3954,18,15,10,8
16680,10,25822,9,847,110,737,2,31,1,1
14629,10,28210,9,761,100,661,2,30,1,1
22174,10,21033,9,226,94,132,2,30,1,1
8907,26,25119,16,6060,1553,4507,18,129,10,8
636,2492,20784,1939,228,118,110,2,1199,1,1
7651,10,20351,9,194,87,107,2,30,1,1
21761,10,17094,9,261,87,174,4,46,2,2
654,15,2589,11,132958,3923,129035,143,38,53,90
12553,1188,17261,877,70,70,0,1,5,1,0
1610,10,5812,9,233,91,142,2,31,1,1
9769,15,10214,11,8688,4248,4440,56,131,34,22
11143,904,8190,668,70,70,0,1,4,1,0
12599,15,8487,11,997,582,415,11,315,6,5
10877,1572,16555,1203,70,70,0,2,9,2,0
14843,15,27457,11,1196,682,514,12,15,6,6
3388,26,19946,16,2567,1173,1394,19,179,8,11
12642,3043,11792,2365,320,140,180,6,6,3,3
15230,15,15722,11,234,234,0,4,12,4,0
8373,26,25045,16,7875,1817,6058,41,255,19,22
22455,26,4649,16,4019,708,3311,16,137,7,9
13676,10,6269,9,195,102,93,2,30,1,1
21345,10,11418,9,258,110,148,2,30,1,1
14372,10,24718,9,199,102,97,2,30,1,1
8646,10,1405,9,168,78,90,2,29,1,1
12939,26,20728,16,13210,3034,10176,47,153,19,28
13952,26,8650,16,7952,3638,4314,36,149,17,19
21184,1049,8747,773,504,382,122,8,15,6,2
13657,26,10944,16,7925,2114,5811,27,37,16,11
5223,26,12338,16,4144,2479,1665,19,361,10,9
11424,10,22952,9,310,94,216,2,31,1,1
9438,15,2045,11,442,250,192,8,44,5,3
17366,26,17557,16,77560,5020,72540,93,121,34,59
21784,10,5443,9,199,102,97,2,29,1,1
12622,26,27875,16,499,425,74,4,0,3,1
14700,10,6118,9,204,104,100,2,30,1,1
15005,10,8252,9,184,94,90,2,31,1,1
22013,26,14960,16,4725,1727,2998,11,121,6,5
21791,10,10661,9,270,94,176,2,30,1,1
12595,2278,18775,1763,320,140,180,6,6,3,3
2652,15,11118,11,168957,11365,157592,202,31,90,112
13882,10,11673,9,196,102,94,2,29,1,1
21218,10,14271,9,183,94,89,2,30,1,1
5882,26,27800,16,8933,1938,6995,21,16,12,9
12670,26,17456,16,499,425,74,4,0,3,1
15910,26,22238,16,70,70,0,1,5,1,0
22125,10,28434,9,356,118,238,2,30,1,1
9231,26,25851,16,827,484,343,8,15,5,3
18939,26,1325,16,5081,896,4185,16,70,8,8
21941,10,27338,9,209,110,99,2,30,1,1
14988,10,27486,9,199,102,97,2,31,1,1
22703,10,13882,9,214,110,104,2,31,1,1
17294,26,18182,16,9876,5325,4551,25,131,14,11
13611,10,13726,9,102,102,0,1,30,1,0
9610,10,14961,9,199,102,97,2,30,1,1
18448,3036,12030,2361,70,70,0,2,8,2,0
9539,26,18001,16,6205,2761,3444,25,28,14,11
8413,10,22412,9,164,86,78,2,31,1,1
21770,10,19695,9,179,94,85,2,30,1,1
14305,10,5811,9,177,94,83,2,29,1,1
13054,26,9524,16,7508,2864,4644,18,75,11,7
22655,10,11061,9,248,94,154,2,30,1,1
11251,10,26694,9,164,78,86,2,29,1,1
14274,10,17139,9,760,97,663,2,31,1,1
11579,26,26248,16,190,70,120,4,15,2,2
11821,10,23190,9,237,91,146,2,32,1,1
7716,676,5025,475,138,78,60,2,5,1,1
9587,10,16173,9,788,108,680,2,31,1,1
14955,10,5205,9,177,94,83,2,29,1,1
310,10,862,9,216,90,126,2,30,1,1
13721,10,752,9,164,84,80,2,31,1,1
8786,10,3935,9,211,110,101,2,29,1,1
8194,15,21165,11,560,264,296,9,44,5,4
2826,26,11615,16,1181,722,459,10,147,6,4
11666,26,27806,16,9026,3447,5579,50,45,26,24
8539,10,25538,9,210,110,100,2,30,1,1
15379,10,9510,9,760,96,664,2,31,1,1
4960,15,23224,11,350,210,140,6,16,4,2
13795,10,3865,9,184,94,90,2,30,1,1
15183,26,9002,16,10062,1631,8431,25,19,14,11
9469,26,3922,16,8725,2284,6441,17,120,8,9
9008,15,29131,11,18950,788,18162,23,89,8,15
10076,26,22251,16,1210,637,573,14,25,7,7
22717,10,9184,9,199,86,113,2,29,1,1
6686,26,7087,16,6804,914,5890,22,257,10,12
13718,26,4853,16,12611,3681,8930,26,61,15,11
14712,10,13689,9,178,94,84,2,31,1,1
9113,10,26708,9,186,95,91,2,31,1,1
17971,26,15550,16,2128,828,1300,19,40,8,11
10849,15,1905,11,5368,946,4422,16,77,9,7
602,10,2394,9,235,90,145,2,32,1,1
3133,2325,13424,1809,330,330,0,6,3609,6,0
11075,26,26803,16,51604,4684,46920,70,133,28,42
7527,234,6837,149,4520,2520,2000,40,3961,20,20
22343,10,16629,9,765,102,663,2,30,1,1
15521,10,15310,9,93,93,0,1,30,1,0
14277,10,10156,9,216,110,106,2,30,1,1
12332,10,22727,9,168,78,90,2,30,1,1
22110,10,23818,9,312,94,218,2,30,1,1
7356,10,19952,9,414,268,146,3,33,2,1
14330,10,9068,9,761,100,661,2,31,1,1
8372,26,21379,16,512444,20822,491622,555,159,191,364
22693,10,9593,9,193,102,91,2,30,1,1
22296,10,18932,9,209,102,107,2,30,1,1
12511,15,22031,11,956,502,454,12,15,7,5
7204,8,19696,8,7679,1922,5757,34,17,15,19
14052,10,2622,9,183,94,89,2,30,1,1
15155,10,15833,9,288,94,194,2,30,1,1
17279,26,5382,16,9218,1776,7442,28,23,13,15
11006,525,11994,348,70,70,0,1,5,1,0
15671,26,11428,16,38893,31305,7588,107,101,55,52
10031,15,27787,11,13974043,173337,13800706,11715,134,2429,9286
5754,232,12005,147,3474,915,2559,34,685,10,24
22440,10,363,9,198,102,96,2,30,1,1
6999,2622,6117,2033,509,150,359,2,1200,1,1
21116,851,14789,626,70,70,0,1,4,1,0
22203,10,8842,9,177,94,83,2,29,1,1
6209,26,11478,16,4057,966,3091,14,31,8,6
15614,10,25800,9,166,86,80,2,30,1,1
14501,10,21641,9,198,101,97,2,31,1,1
2744,101,9652,78,870,126,744,2,29,1,1
11235,1120,21909,825,136,136,0,3,13,3,0
22535,10,26270,9,183,94,89,2,30,1,1
12971,26,10172,16,4723,2593,2130,16,137,8,8
19808,26,3846,16,3150,831,2319,13,135,6,7
9096,10,5962,9,195,102,93,2,30,1,1
13647,10,21422,9,410,109,301,4,32,2,2
14074,26,25139,16,24415,1491,22924,34,131,14,20
13694,26,799,16,8558,1869,6689,31,236,14,17
8949,10,8436,9,174,89,85,2,31,1,1
1340,26,4533,16,179461,16904,162557,220,36,105,115
21799,10,7192,9,183,94,89,2,30,1,1
10923,3203,142,2483,70,70,0,1,5,1,0
8163,26,10071,16,18147,9173,8974,42,175,24,18
18859,26,4289,16,598135,40549,557586,873,251,326,547
9455,15,19607,11,2958,1116,1842,15,83,8,7
6860,26,19659,16,1657,1128,529,15,35,9,6
22286,10,22099,9,177,94,83,2,30,1,1
4502,26,25699,16,9705,4332,5373,32,321,17,15
17773,15,17497,11,1652,1264,388,10,17,4,6
5871,26,23481,16,3474,2349,1125,29,3438,17,12
7505,10,20159,9,414,268,146,3,34,2,1
14612,10,3989,9,199,102,97,2,30,1,1
8690,15,8795,11,1401,828,573,11,38,6,5
14021,10,22336,9,194,102,92,2,30,1,1
21667,10,18341,9,176,90,86,2,30,1,1
21261,10,17120,9,329,86,243,4,42,2,2
2744,1239,28369,919,879,126,753,2,30,1,1
8332,10,7282,9,212,102,110,2,29,1,1
13968,26,27016,16,18284,2468,15816,42,26,22,20
5811,10,17685,9,200,90,110,2,29,1,1
18043,26,11748,16,1820,1303,517,13,26,7,6
15878,26,27222,16,5613,733,4880,16,14,9,7
21964,10,437,9,816,102,714,2,30,1,1
14440,26,25823,16,5100,2001,3099,15,119,7,8
15903,10,9847,9,210,110,100,2,29,1,1
8140,26,5754,16,3538,2083,1455,17,256,9,8
15055,26,11627,16,5638,2934,2704,15,120,7,8
9798,15,17165,11,3728,1504,2224,13,21,7,6
22713,26,22506,16,282968,9210,273758,296,15,106,190
21979,26,19614,16,23561,3667,19894,40,121,19,21
9169,10,5724,9,199,102,97,2,30,1,1
6366,15,9245,11,7651,2046,5605,16,91,10,6
10939,15,1862,11,6057,4543,1514,16,15,9,7
4998,26,26953,16,23571,4700,18871,60,48,30,30
7240,26,10309,16,1022491,42917,979574,1099,36,416,683
7938,26,5712,16,37598,2397,35201,53,239,22,31
0,0,0,0,244,244,0,2,0,2,0
13779,10,3548,9,216,110,106,2,31,1,1
22660,10,2098,9,441,90,351,4,48,2,2
22704,10,7514,9,195,102,93,2,31,1,1
17253,15,22400,11,2493,1830,663,12,15,6,6
12427,691,2335,490,70,70,0,2,7,2,0
15350,961,11931,709,70,70,0,2,8,2,0
22546,10,27008,9,170,87,83,2,30,1,1
22359,10,28202,9,295,103,192,4,49,2,2
15916,10,8417,9,458,188,270,6,31,3,3
8918,10,28502,9,193,102,91,2,30,1,1
14901,10,3462,9,182,93,89,2,31,1,1
15323,10,18883,9,184,94,90,2,31,1,1
17601,26,155,16,276,70,206,5,26,2,3
22170,10,10960,9,194,99,95,2,31,1,1
6753,26,23588,16,9754,4277,5477,27,330,14,13
15043,26,1429,16,5058,913,4145,17,25,10,7
19080,10,27135,9,217,90,127,2,29,1,1
15823,10,9178,9,209,102,107,2,30,1,1
1731,1333,23207,1008,480,149,331,2,1200,1,1
17904,26,9852,16,276238,23971,252267,482,138,188,294
15407,1095,23307,803,130,70,60,2,5,1,1
1337,2019,23425,1549,213,89,124,4,54,2,2
17224,26,17517,16,5168,700,4468,16,15,7,9
22235,10,9828,9,347,94,253,2,30,1,1
532,247,0,0,3354,1792,1562,46,194,23,23
19967,10,7612,9,232,88,144,2,31,1,1
3016,10,12454,9,217,82,135,2,32,1,1
11066,2693,13240,2092,70,70,0,1,4,1,0
12044,1368,18304,1039,70,70,0,2,8,2,0
9127,10,25897,9,564,191,373,6,62,3,3
18503,2754,285,2135,320,140,180,6,6,3,3
14749,10,14675,9,711,87,624,2,31,1,1
5626,26,15133,16,7646,1024,6622,19,15,11,8
16536,392,19883,254,336,150,186,6,89,3,3
10015,15,28790,11,204646,11741,192905,240,141,104,136
21313,10,12091,9,360,93,267,4,57,2,2
9470,15,15431,11,2535,783,1752,13,48,7,6
12603,2566,21421,1993,492,306,186,8,16,5,3
532,247,0,0,3354,1792,1562,46,195,23,23
8287,26,7975,16,5792,1764,4028,24,31,14,10
14438,10,1230,9,214,110,104,2,31,1,1
14387,10,5167,9,182,94,88,2,30,1,1
14628,10,23347,9,711,87,624,2,30,1,1
14697,10,182,9,188,96,92,2,40,1,1
8584,1241,16964,921,259,71,188,2,31,1,1
8937,10,28722,9,272,110,162,2,30,1,1
502,1042,9614,766,832,832,0,14,95,14,0
22688,10,11769,9,182,102,80,2,30,1,1
12453,1893,5006,1446,70,70,0,2,8,2,0
15137,10,1633,9,166,85,81,2,31,1,1
11020,2114,5506,1630,70,70,0,2,8,2,0
4390,26,14379,16,11086707,166045,10920662,9176,172,1285,7891
4952,26,10423,16,200383,4673,195710,196,30,58,138
22475,10,14292,9,403,91,312,4,34,2,2
12145,26,14445,16,6185,1994,4191,27,16,16,11
8531,15,9585,11,1614,1300,314,10,15,5,5
12490,725,29042,518,70,70,0,2,8,2,0
11984,26,11560,16,6774,3651,3123,35,80,18,17
15285,10,18803,9,190,97,93,2,31,1,1
4289,15,26658,11,78,78,0,1,5,1,0
532,247,0,0,3354,1792,1562,46,194,23,23
5802,26,13977,16,10450,3898,6552,20,135,11,9
21866,10,9092,9,199,102,97,2,30,1,1
22025,10,17181,9,102,102,0,1,30,1,0
9820,15,9637,11,13054,6885,6169,27,26,13,14
2744,1274,1106,954,917,126,791,2,31,1,1
4217,10,15488,9,235,90,145,2,32,1,1
2172,2094,16340,1614,150,150,0,1,1199,1,0
11055,15,26458,11,87927,9680,78247,101,37,40,61
7854,234,15838,149,2880,1648,1232,22,3602,10,12
21377,10,10822,9,274,94,180,2,29,1,1
15736,10,21711,9,293,86,207,2,29,1,1
8671,10,18270,9,225,110,115,2,30,1,1
8638,10,9507,9,751,95,656,2,31,1,1
10861,1201,7227,889,70,70,0,1,5,1,0
14293,26,14820,16,6291,1499,4792,22,17,11,11
22278,10,5097,9,198,102,96,2,30,1,1
8894,26,6404,16,7626,1676,5950,29,63,10,19
9098,10,17859,9,752,93,659,2,30,1,1
7813,15,20601,11,2886,1481,1405,10,15,6,4
6599,26,20666,16,2423,1465,958,18,171,10,8
11939,26,16159,16,7263,1834,5429,27,16,15,12
2745,26,11361,16,1251,722,529,11,147,6,5
10998,26,28034,16,5315,3154,2161,56,47,32,24
11180,15,17557,11,546,300,246,10,32,6,4
21232,2591,11707,2011,70,70,0,1,5,1,0
18314,15,22893,11,29924,6743,23181,37,150,16,21
9489,15,11734,11,736,670,66,6,15,5,1
17593,26,18692,16,3218,1700,1518,16,15,8,8
2744,1455,16187,1108,881,126,755,2,30,1,1
18426,26,12068,16,5214,1101,4113,22,123,12,10
21204,3020,9434,2348,70,70,0,1,4,1,0
20926,26,22655,16,12760,2205,10555,39,122,21,18
6107,26,18110,16,4707,1800,2907,19,28,11,8
5105,26,13418,16,484,210,274,8,26,4,4
8858,10,12798,9,212,110,102,2,30,1,1
15851,26,13890,16,122959,4611,118348,142,150,51,91
15901,10,19392,9,228,110,118,2,30,1,1
10464,26,22176,16,190,70,120,4,8,2,2
11141,2716,14458,2110,1330,706,624,10,33,6,4
20837,26,20389,16,24271,2640,21631,38,123,16,22
15353,1764,20931,1347,70,70,0,1,5,1,0
16368,26,23187,16,4544,1112,3432,21,176,12,9
8109,10,12840,9,168,78,90,2,31,1,1
15202,26,4751,16,7889,1900,5989,20,15,11,9
5099,26,9846,16,4478,1133,3345,13,35,8,5
22435,10,26718,9,247,118,129,2,30,1,1
14852,10,18239,9,214,110,104,2,30,1,1
18970,26,2209,16,5027222,114898,4912324,4763,109,1375,3388
22687,10,9393,9,752,93,659,2,31,1,1
21244,10,14871,9,195,102,93,2,30,1,1
4943,26,16467,16,3333,2072,1261,21,148,12,9
12039,2207,9816,1709,320,140,180,6,6,3,3
14877,10,1886,9,197,102,95,2,29,1,1
10747,3176,5195,2462,70,70,0,2,8,2,0
8608,10,5114,9,326,110,216,2,30,1,1
21622,26,9938,16,2783,692,2091,10,120,5,5
11604,26,5834,16,14511,4628,9883,29,559,15,14
4780,26,18537,16,448,78,370,6,25,1,5
18042,26,6347,16,7701,3981,3720,27,70,12,15
19389,26,23023,16,14738,2175,12563,24,16,10,14
4571,26,942,16,70,70,0,1,5,1,0
3961,389,15079,252,138,78,60,2,5,1,1
13706,26,18416,16,4425,876,3549,15,29,8,7
2160,10,8691,9,216,90,126,2,30,1,1
6960,26,4855,16,13320,3575,9745,38,26,19,19
12291,264,24001,165,245,245,0,2,30,2,0
18967,26,7840,16,398300,18473,379827,492,72,222,270
18006,26,11648,16,1265,684,581,13,30,6,7
10445,26,10636,16,2838,944,1894,12,135,7,5
8648,10,27525,9,460,84,376,4,46,2,2
18584,26,26851,16,1088,641,447,10,25,6,4
15313,10,23288,9,242,110,132,2,29,1,1
14320,10,22341,9,198,102,96,2,30,1,1
1880,295,7118,190,2163,676,1487,14,15,7,7
15810,10,10503,9,199,102,97,2,29,1,1
0,0,0,0,244,244,0,2,0,2,0
11848,26,14572,16,16053,6801,9252,51,115,26,25
15186,10,24063,9,181,94,87,2,32,1,1
9786,15,23469,11,27013,3578,23435,36,21,15,21
22283,10,387,9,278,100,178,4,31,2,2
8572,10,9559,9,215,102,113,2,30,1,1
8866,26,21190,16,64,64,0,2,5,2,0
22685,26,6790,16,92799,4939,87860,111,16,45,66
15308,10,5658,9,170,87,83,2,30,1,1
8884,26,21845,16,7644833,215496,7429337,8664,135,2509,6155
382,10,1178,9,825,99,726,2,30,1,1
12026,234,18240,149,26821,4295,22526,95,5045,40,55
225,10,18241,9,204,118,86,2,31,1,1
10699,26,6264,16,3256,2213,1043,16,15,8,8
8374,2993,16531,2327,70,70,0,1,5,1,0
22498,10,10421,9,195,102,93,2,31,1,1
4150,26,8682,16,5524,1857,3667,27,3652,9,18
2575,10,10819,9,266,72,194,2,30,1,1
14554,10,5532,9,194,94,100,2,30,1,1
14449,10,7249,9,181,94,87,2,30,1,1
13719,10,3717,9,168,78,90,2,30,1,1
8210,2612,21194,2024,158,158,0,1,1200,1,0
8653,26,10451,16,72073,12550,59523,78,45,25,53
8767,10,19148,9,178,94,84,2,30,1,1
17156,26,26640,16,2694,1614,1080,14,386,8,6
21141,280,23956,177,66,66,0,2,7,2,0
13876,26,17932,16,39555,12054,27501,78,66,41,37
15325,10,25066,9,217,87,130,2,30,1,1
15988,11,23136,10,70,70,0,1,5,1,0
12137,26,3170,16,5995,974,5021,19,66,10,9
9007,15,22414,11,2901,1805,1096,17,108,13,4
8323,10,11815,9,304,118,186,2,30,1,1
22572,10,19556,9,241,110,131,2,30,1,1
15308,10,20447,9,187,98,89,3,52,2,1
21539,10,17801,9,492,90,402,4,45,2,2
17922,26,21619,16,147637,6160,141477,164,121,56,108
22414,10,12892,9,196,102,94,2,30,1,1
13660,10,19439,9,789,110,679,2,30,1,1
10196,15,3751,11,9133,1055,8078,17,151,8,9
21816,10,8799,9,173,94,79,2,30,1,1
4849,2504,22113,1947,156,156,0,3,8,3,0
14015,183,24387,121,3343,1454,1889,15,16,8,7
13992,10,10074,9,168,94,74,2,30,1,1
3795,26,29107,16,12120,5747,6373,22,120,10,12
14925,10,25893,9,194,102,92,2,31,1,1
2504,10,10508,9,217,87,130,2,30,1,1
2646,291,20581,187,192,192,0,4,1200,4,0
13348,26,24003,16,3186,1836,1350,16,17,10,6
5318,10,409,9,198,93,105,2,30,1,1
21902,10,24559,9,749,94,655,2,31,1,1
15347,26,16470,16,7889,1900,5989,20,15,11,9
9552,10,22841,9,182,93,89,2,30,1,1
21576,10,13294,9,190,97,93,2,31,1,1
16611,26,21343,16,841459,41656,799803,1083,141,389,694
22420,10,24206,9,178,94,84,2,30,1,1
10986,1837,4309,1398,66,66,0,1,5,1,0
14895,10,25259,9,214,102,112,2,29,1,1
10930,15,17431,11,366,240,126,7,29,5,2
14346,766,22052,554,70,70,0,1,5,1,0
14710,10,26305,9,216,110,106,2,30,1,1
15405,10,24531,9,195,102,93,2,30,1,1
13605,26,9127,16,69882,3520,66362,96,320,38,58
13621,10,11807,9,178,94,84,2,30,1,1
22291,10,7732,9,198,94,104,2,30,1,1
8550,10,16901,9,758,102,656,2,30,1,1
15430,3240,25906,2511,316,136,180,6,6,3,3
22635,10,6278,9,86,86,0,1,30,1,0
12562,280,10079,177,552,306,246,9,15,5,4
22342,10,25084,9,335,84,251,4,32,2,2
22026,10,5107,9,383,97,286,4,58,2,2
17866,10,24420,9,230,110,120,2,29,1,1
14275,10,23396,9,250,86,164,4,31,2,2
4835,56,22542,39,132,132,0,3,1199,3,0
3710,26,6959,16,3497,1845,1652,18,16,9,9
4741,26,23709,16,8134,2717,5417,24,16,15,9
14400,10,21409,9,97,97,0,1,60,1,0
17915,26,2924,16,10642,1102,9540,25,27,11,14
3998,26,15787,16,4866,3323,1543,25,94,14,11
3503,26,599,16,15017,6951,8066,49,20,25,24
8403,10,22740,9,377,94,283,2,30,1,1
19217,26,27909,16,8594,1042,7552,16,120,7,9
8446,10,21968,9,199,102,97,2,29,1,1
10975,26,26948,16,8830,1950,6880,27,25,14,13
8584,1241,15510,921,256,78,178,2,30,1,1
1638,26,15341,16,2629,1470,1159,18,15,8,10
6109,26,7337,16,6714,1515,5199,23,196,13,10
14390,10,15699,9,197,94,103,2,31,1,1
17592,26,6850,16,5801,1995,3806,19,16,10,9
3746,26,16829,16,1701,1048,653,15,38,8,7
9726,15,22053,11,6647,4891,1756,23,21,13,10
16159,26,22331,16,14555,5048,9507,82,134,33,49
11544,15,23037,11,3487,696,2791,13,142,6,7
19484,10,13741,9,82,82,0,2,31,2,0
6250,2011,9535,1541,720,549,171,4,30,2,2
20346,10,27911,9,237,91,146,2,33,1,1
13585,277,14490,175,124239,48650,75589,1342,84,628,714
8851,26,18021,16,8435,1687,6748,30,76,14,16
21219,1196,2025,884,66,66,0,2,7,2,0
10854,15,6902,11,15487,8701,6786,29,44,17,12
8522,10,2504,9,168,86,82,2,29,1,1
18340,15,9270,11,1528,946,582,11,149,6,5
15771,26,25746,16,25881,12394,13487,221,579,105,116
9045,10,12226,9,213,102,111,2,30,1,1
22141,10,26172,9,168,86,82,2,30,1,1
2724,1240,25276,920,422,164,258,6,30,3,3
21791,10,7129,9,461,91,370,4,60,2,2
9202,10,1829,9,193,102,91,2,30,1,1
2724,1240,1185,920,422,164,258,6,30,3,3
14178,10,17035,9,197,102,95,2,35,1,1
6833,26,4931,16,6263,1804,4459,21,361,11,10
19520,26,22032,16,12015,3771,8244,41,18,23,18
22591,10,27290,9,211,102,109,2,30,1,1
10629,15,17375,11,12683,8567,4116,53,271,33,20
17858,26,8502,16,304,86,218,2,30,1,1
8149,26,24203,16,638,70,568,10,207,2,8
1165,1984,8005,1514,148,86,62,2,31,1,1
14350,10,4121,9,229,110,119,2,30,1,1
15714,10,451,9,183,94,89,2,30,1,1
8584,1559,14592,1190,243,78,165,2,30,1,1
14350,1194,4930,883,70,70,0,2,8,2,0
796,7,3268,7,130,66,64,2,5,1,1
21401,10,10776,9,255,102,153,2,30,1,1
22324,10,5901,9,539,91,448,4,43,2,2
9126,10,25856,9,184,94,90,2,31,1,1
15452,10,18006,9,168,86,82,2,30,1,1
3654,15,1486,11,2865,2000,865,12,16,7,5
8597,10,9612,9,353,94,259,2,30,1,1
10368,545,6310,362,70,70,0,1,5,1,0
14963,10,7982,9,190,97,93,2,31,1,1
15923,10,26864,9,458,188,270,6,31,3,3
18879,26,3583,16,45373,35377,9996,88,72,48,40
9090,10,28212,9,180,94,86,2,30,1,1
18564,26,13609,16,416,210,206,7,28,4,3
15264,26,7050,16,4857,3938,919,18,81,11,7
5365,15,21104,11,1057,683,374,10,15,6,4
8988,10,19749,9,202,103,99,2,31,1,1
13658,26,19376,16,7960,2219,5741,27,35,16,11
8622,10,11655,9,360,110,250,2,29,1,1
10956,2988,28482,2322,70,70,0,1,5,1,0
15200,26,24151,16,6734,2065,4669,21,16,11,10
14543,10,7019,9,212,102,110,2,30,1,1
8499,10,17478,9,281,98,183,4,57,2,2
8453,10,5914,9,184,94,90,2,30,1,1
14805,10,1738,9,170,87,83,2,31,1,1
8037,10,20942,9,213,87,126,2,31,1,1
1961,10,7548,9,215,98,117,2,30,1,1
16365,15,16279,11,6518,1210,5308,15,24,8,7
9526,26,3831,16,10423,2542,7881,48,20,24,24
22002,10,16222,9,627,224,403,6,56,3,3
9071,10,22838,9,199,102,97,2,30,1,1
12145,26,14515,16,6181,1040,5141,22,65,11,11
21696,10,12194,9,341,110,231,2,29,1,1
19791,26,28072,16,9526,1375,8151,24,125,12,12
8385,26,21172,16,8929,3316,5613,38,255,18,20
22688,10,11710,9,167,86,81,2,30,1,1
22259,10,830,9,264,102,162,2,30,1,1
17105,10,18236,9,237,86,151,2,30,1,1
21314,860,9868,635,66,66,0,2,7,2,0
21416,10,21261,9,186,95,91,2,30,1,1
7287,392,26933,254,336,150,186,6,89,3,3
2744,1239,4678,919,902,126,776,2,30,1,1
6500,26,16404,16,7578,2358,5220,18,121,8,10
17062,26,16926,16,318,192,126,6,25,4,2
10649,26,20726,16,5052,2873,2179,26,15,14,12
4971,676,18678,475,130,70,60,2,6,1,1
15238,10,24661,9,181,94,87,2,30,1,1
14388,10,16658,9,168,78,90,2,30,1,1
21349,10,24030,9,209,110,99,2,30,1,1
11214,26,5402,16,13902,3253,10649,26,135,14,12
16839,10,18418,9,290,110,180,2,30,1,1
532,247,0,0,3562,1936,1626,48,193,24,24
21266,2979,26874,2313,504,382,122,8,16,6,2
8625,10,10259,9,198,101,97,2,30,1,1
21283,10,7329,9,247,94,153,2,30,1,1
7508,26,5561,16,11163,3642,7521,25,30,14,11
12675,295,23634,190,2099,676,1423,13,15,7,6
22323,10,7093,9,198,102,96,2,30,1,1
5922,26,3919,16,1482,988,494,12,26,7,5
22098,10,28852,9,753,93,660,2,31,1,1
8700,10,17577,9,193,102,91,2,29,1,1
10871,1008,2475,742,136,136,0,3,14,3,0
13680,10,21971,9,177,94,83,2,30,1,1
21510,10,12558,9,178,91,87,2,30,1,1
21810,10,5577,9,199,102,97,2,30,1,1
2588,10,14590,9,75510,75228,282,904,90,902,2
15232,26,23418,16,8059,2039,6020,20,15,11,9
15233,10,18283,9,177,94,83,2,29,1,1
939,15,16188,11,2949,546,2403,11,25,6,5
9411,2763,12823,2142,858,858,0,14,1200,14,0
11758,26,11395,16,11808,5409,6399,73,123,33,40
18950,26,1335,16,40105,2847,37258,61,17,28,33
9015,10,3791,9,166,86,80,2,29,1,1
6845,183,19164,121,4145,1976,2169,22,18,13,9
10062,26,23861,16,134,60,74,3,10,2,1
20016,15,26850,11,2895,771,2124,12,24,6,6
21906,10,13932,9,328,88,240,4,32,2,2
21689,10,20344,9,353,92,261,4,38,2,2
4511,15,21708,11,1114,534,580,12,15,7,5
14127,15,26104,11,164902,9835,155067,227,32,114,113
14860,10,20993,9,197,102,95,2,33,1,1
14685,10,1159,9,172,94,78,2,30,1,1
15965,26,24049,16,1054,567,487,10,15,6,4
13853,26,22090,16,1803,1029,774,16,185,9,7
15712,10,24317,9,164,84,80,2,30,1,1
19392,26,10743,16,182448,3931,178517,161,26,36,125
15195,10,28238,9,216,110,106,2,30,1,1
13873,10,2774,9,183,102,81,2,30,1,1
10847,2791,25302,2166,316,136,180,6,7,3,3
8584,1240,4458,920,247,78,169,2,30,1,1
15119,10,6502,9,183,94,89,2,30,1,1
21243,10,8671,9,262,86,176,4,46,2,2
11783,26,26239,16,3101,801,2300,13,136,6,7
21677,10,19601,9,482,188,294,6,44,3,3
2744,1374,22529,1045,875,126,749,2,30,1,1
5939,26,8585,16,7450,1203,6247,22,16,12,10
3856,26,10921,16,236097,12185,223912,307,32,125,182
14164,10,12840,9,816,97,719,2,31,1,1
10373,26,1170,16,4933,2248,2685,14,135,7,7
15565,10,12911,9,355,102,253,2,30,1,1
9049,26,12836,16,4626083,113708,4512375,4382,213,1198,3184
13667,10,11801,9,198,102,96,2,30,1,1
7094,676,25006,475,130,70,60,2,5,1,1
11044,26,22757,16,16507,6060,10447,32,49,16,16
10980,803,6380,585,70,70,0,2,8,2,0
5641,26,9566,16,7937,3883,4054,65,4602,25,40
2744,1633,14683,1255,895,126,769,2,30,1,1
9334,26,23614,16,6349,1071,5278,18,42,10,8
9112,10,20384,9,177,94,83,2,30,1,1
22674,10,14791,9,184,94,90,2,31,1,1
8801,10,7188,9,210,110,100,2,30,1,1
9085,10,11520,9,214,110,104,2,30,1,1
21964,10,19128,9,172,88,84,2,30,1,1
15335,26,5055,16,8006,1986,6020,20,15,11,9
22459,10,5456,9,168,86,82,2,30,1,1
8640,295,21503,190,3100,783,2317,14,15,7,7
22439,10,15282,9,755,102,653,2,30,1,1
15559,10,14890,9,259,87,172,4,36,2,2
2863,2013,20024,1543,141,79,62,2,31,1,1
15383,2780,22559,2157,70,70,0,2,8,2,0
12761,26,26356,16,499,425,74,4,0,3,1
17956,15,10785,11,397391,8624,388767,380,49,118,262
22269,10,14578,9,297,101,196,4,31,2,2
12906,26,21282,16,4128,1929,2199,38,48,21,17
9590,26,10788,16,5471,2089,3382,17,121,8,9
4710,26,25038,16,11338,2980,8358,31,46,18,13
8586,10,20828,9,183,94,89,2,30,1,1
15012,10,14469,9,210,110,100,2,29,1,1
12558,26,1080,16,499,425,74,4,0,3,1
8652,26,26876,16,4160,1015,3145,16,28,8,8
8433,10,6933,9,199,102,97,2,30,1,1
11190,26,14846,16,6679,3424,3255,19,138,10,9
10976,26,16797,16,8670,1805,6865,28,26,15,13
5197,26,16747,16,4480,1573,2907,19,29,11,8
11952,26,8043,16,17225,7769,9456,71,91,34,37
9428,26,2932,16,24856,2858,21998,57,100,30,27
16708,26,13779,16,6128,1394,4734,24,146,10,14
8382,2694,20030,2093,70,70,0,2,8,2,0
5405,15,9533,11,903,482,421,10,360,5,5
21450,10,7068,9,194,102,92,2,31,1,1
8535,26,2736,16,9482,4710,4772,19,17,11,8
8526,26,12443,16,6261,1362,4899,22,15,12,10
10116,15,14667,11,8047,2291,5756,22,19,13,9
16021,1574,10806,1204,480,149,331,2,1200,1,1
15333,10,15144,9,173,94,79,2,31,1,1
176,10,10920,9,210,78,132,2,30,1,1
22704,10,15377,9,718,94,624,2,30,1,1
14207,10,6094,9,172,88,84,2,30,1,1
11651,26,27328,16,348281,20002,328279,401,350,153,248
21607,10,1209,9,213,102,111,2,30,1,1
22033,10,25582,9,314,97,217,4,47,2,2
15563,15,25231,11,214,140,74,4,35,3,1
21139,26,8095,16,3182,1568,1614,8,120,4,4
14854,10,17722,9,166,86,80,2,31,1,1
8457,10,12488,9,184,94,90,2,30,1,1
15453,10,6402,9,744,95,649,2,30,1,1
22718,10,22097,9,821,102,719,2,30,1,1
13516,26,13837,16,15578,7071,8507,69,140,33,36
15559,10,10116,9,170,87,83,2,30,1,1
2291,26,9405,16,29021,6752,22269,48,30,29,19
5135,26,21873,16,89931,3417,86514,94,15,30,64
14925,10,11139,9,170,87,83,2,30,1,1
3737,26,11801,16,8107,2200,5907,34,255,16,18
13652,10,4829,9,179,94,85,2,30,1,1
2744,1292,26321,970,875,126,749,2,29,1,1
10573,26,11560,16,4045,765,3280,11,45,5,6
10362,718,1218,513,70,70,0,2,8,2,0
1200,26,11662,16,7122,1766,5356,27,331,14,13
10224,15,3636,11,9767,6194,3573,40,47,21,19
14270,10,1391,9,711,87,624,2,30,1,1
12288,10,14925,9,87,87,0,2,31,2,0
8625,10,14358,9,199,102,97,2,30,1,1
15637,10,4445,9,252,102,150,2,30,1,1
4924,26,22383,16,7034,1885,5149,28,95,15,13
18469,3226,20789,2502,70,70,0,2,8,2,0
22418,10,20473,9,276,126,150,2,30,1,1
21242,10,9570,9,274,93,181,4,64,2,2
22011,10,1275,9,198,101,97,2,30,1,1
15180,10,16452,9,341,110,231,2,30,1,1
10209,15,9342,11,4033,2712,1321,35,130,19,16
18007,183,26558,121,3624,1910,1714,19,32,11,8
15986,10,6587,9,200,102,98,2,29,1,1
9232,26,11548,16,22729,6539,16190,54,93,27,27
17262,26,17151,16,8209,2174,6035,25,210,12,13
8210,1077,21194,790,485,158,327,2,1200,1,1
8442,10,24309,9,283,97,186,4,30,2,2
10616,26,14801,16,3323,2023,1300,17,255,9,8
177,10,16099,9,210,78,132,2,30,1,1
916,26,4600,16,4072,434,3638,12,15,6,6
9728,385,25036,248,166,166,0,1,1200,1,0
1310,10,23286,9,177,86,91,2,30,1,1
15195,10,14517,9,216,110,106,2,31,1,1
10909,1920,24958,1465,70,70,0,1,5,1,0
16150,15,25481,11,265909,7294,258615,235,25,55,180
15466,10,22206,9,177,94,83,2,30,1,1
15307,10,13926,9,701,88,613,2,30,1,1
18505,10,21930,9,184,78,106,2,30,1,1
3436,26,5710,16,24440,2215,22225,46,316,20,26
22486,10,24307,9,179,94,85,2,30,1,1
8769,10,14715,9,326,126,200,2,30,1,1
14527,10,24958,9,170,87,83,2,31,1,1
8735,10,29059,9,181,94,87,2,32,1,1
15876,10,3560,9,189,102,87,2,30,1,1
9054,26,19837,16,6068,1047,5021,20,50,11,9
6490,26,2203,16,3063,1813,1250,18,16,8,10
11263,26,25501,16,5479,929,4550,20,360,10,10
15101,26,24747,16,28479,3138,25341,42,42,17,25
22573,10,8448,9,274,94,180,2,30,1,1
9728,1377,23780,1047,161,161,0,2,1200,2,0
9720,15,22047,11,24419,8463,15956,49,19,25,24
13946,10,11373,9,176,176,0,3,46,3,0
17884,10,14440,9,512,166,346,2,30,1,1
9976,26,14795,16,8057,1135,6922,19,139,9,10
22227,26,4191,16,5957,2481,3476,14,120,8,6
18436,26,8018,16,3875761,85491,3790270,3838,89,1315,2523
17865,26,3031,16,304,86,218,2,29,1,1
15603,10,4280,9,749,94,655,2,30,1,1
9222,10,7321,9,173,94,79,2,29,1,1
13511,26,6602,16,572,572,0,5,11,5,0
12069,26,24555,16,7876,3195,4681,22,20,11,11
14739,183,24774,121,4286,2261,2025,20,17,11,9
13964,10,28580,9,711,87,624,2,31,1,1
12419,43,27348,26,70,70,0,1,4,1,0
9010,26,26273,16,278883,9002,269881,313,72,115,198
9256,26,6908,16,12942,3659,9283,66,217,36,30
15707,10,19871,9,178,94,84,2,30,1,1
15700,10,20396,9,279,96,183,4,32,2,2
18328,15,8712,11,3401,2157,1244,12,149,7,5
8684,26,12323,16,6602,1573,5029,25,271,11,14
22673,10,13224,9,195,102,93,2,30,1,1
22644,10,11471,9,251,94,157,2,31,1,1
9300,10,1154,9,807,94,713,2,30,1,1
8439,10,19142,9,198,102,96,2,30,1,1
11173,1643,28422,1262,70,70,0,2,8,2,0
10323,26,10855,16,4540,1056,3484,19,17,11,8
8129,26,6176,16,7433,2086,5347,26,316,12,14
8427,10,12859,9,791,85,706,4,57,2,2
5406,15,9856,11,2191,1142,1049,21,370,9,12
8456,26,27040,16,3890599,46254,3844345,3173,116,609,2564
17493,15,26271,11,107904,4143,103761,179,15,59,120
11146,3244,19907,2513,70,70,0,2,8,2,0
16391,26,20683,16,38204,3737,34467,77,95,40,37
3304,26,19364,16,3312,1936,1376,19,29,10,9
20578,26,16940,16,3272,800,2472,10,120,5,5
16021,280,286,177,453,251,202,4,1199,2,2
17059,26,8768,16,6012,873,5139,18,25,9,9
20554,10,10259,9,304,86,218,2,30,1,1
14398,10,9371,9,819,102,717,2,30,1,1
9498,10,9747,9,209,110,99,2,30,1,1
13074,184,23851,122,60,60,0,1,5,1,0
16444,188,19250,123,312,140,172,4,30,2,2
21588,10,19280,9,200,94,106,2,31,1,1
17983,26,946,16,12357,5182,7175,30,108,13,17
21026,15,7435,11,314,192,122,6,15,4,2
9254,10,21813,9,197,90,107,2,30,1,1
17896,26,28652,16,70,70,0,1,5,1,0
8323,10,18923,9,195,102,93,2,32,1,1
18384,26,136,16,4679,2232,2447,15,136,7,8
11649,26,9346,16,203346,21619,181727,301,376,140,161
14903,10,11802,9,761,100,661,2,30,1,1
19513,26,23974,16,9218,3728,5490,30,50,16,14
16021,1110,3813,815,806,163,643,2,1201,1,1
9155,10,3114,9,198,102,96,2,30,1,1
4426,26,27906,16,6164,3172,2992,28,141,12,16
2744,92,4367,72,855,126,729,2,29,1,1
13729,15,13283,11,1129,580,549,11,74,6,5
12149,26,9385,16,23664,2213,21451,41,323,17,24
14064,10,9339,9,200,102,98,2,33,1,1
17113,26,5801,16,6475,4197,2278,22,16,12,10
9718,26,26583,16,5870,1785,4085,21,80,12,9
17132,26,1763,16,3862,2458,1404,16,15,8,8
21937,10,20273,9,211,110,101,2,30,1,1
6039,346,21950,220,78,78,0,2,8,2,0
15571,10,26016,9,177,94,83,2,29,1,1
785,15,3227,11,1875,567,1308,11,31,6,5
3355,26,19384,16,13265,1924,11341,33,201,17,16
11218,592,7012,403,70,70,0,1,4,1,0
1115,26,3895,16,3909,369,3540,16,35,5,11
6799,26,12263,16,8542,4191,4351,84,616,46,38
19926,26,27650,16,16675,2296,14379,37,78,17,20
18054,10,22382,9,395,115,280,2,30,1,1
12633,953,27057,703,70,70,0,2,8,2,0
17073,26,23262,16,3854,2390,1464,17,15,8,9
12605,723,865,516,70,70,0,1,5,1,0
14217,10,14175,9,177,94,83,2,29,1,1
14221,10,23449,9,102,102,0,1,30,1,0
13845,10,28078,9,214,110,104,2,30,1,1
9957,15,22181,11,514,246,268,9,42,5,4
13064,10,15393,9,86,86,0,1,30,1,0
12643,812,177,592,70,70,0,2,8,2,0
14713,26,19913,16,187927,12115,175812,276,42,137,139
2744,1509,6219,1148,898,126,772,2,30,1,1
21651,10,669,9,199,102,97,2,31,1,1
8532,15,4223,11,2361,1586,775,11,166,7,4
15197,26,5363,16,8034,2014,6020,20,15,11,9
11470,26,798,16,70,70,0,1,5,1,0
15082,10,1599,9,196,100,96,2,30,1,1
14363,10,23213,9,184,94,90,2,30,1,1
15962,10,4091,9,194,102,92,2,30,1,1
4108,26,23248,16,2060,1106,954,17,150,10,7
14444,10,22763,9,210,102,108,2,30,1,1
3965,26,19191,16,27553,21226,6327,57,216,31,26
17432,10,12242,9,260,86,174,2,30,1,1
15978,10,13509,9,821,102,719,2,30,1,1
8584,10,4603,9,776,102,674,2,30,1,1
15309,10,7202,9,751,95,656,2,30,1,1
9076,15,14039,11,1590,858,732,10,110,6,4
9889,26,14825,16,8422,1676,6746,25,16,13,12
11001,946,3546,698,66,66,0,1,5,1,0
21613,10,13951,9,228,110,118,2,30,1,1
1038,10,3682,9,200,90,110,2,30,1,1
6190,10,18233,9,262,106,156,2,32,1,1
8853,10,17602,9,184,102,82,2,30,1,1
9131,10,10624,9,193,102,91,2,31,1,1
21676,10,2589,9,177,94,83,2,30,1,1
12161,15,13049,11,11060,3925,7135,24,108,13,11
21855,10,17167,9,199,102,97,2,31,1,1
4094,15,12069,11,1849,1015,834,11,150,6,5
9284,10,1278,9,757,98,659,2,30,1,1
8333,10,7254,9,322,102,220,2,30,1,1
14369,10,7811,9,193,102,91,2,30,1,1
8993,10,13087,9,340,110,230,2,31,1,1
15953,10,18300,9,735,88,647,2,31,1,1
17086,26,27754,16,13240,8717,4523,33,16,17,16
4141,26,19349,16,13706,3115,10591,40,201,22,18
22404,10,18272,9,216,110,106,2,30,1,1
22234,10,3076,9,295,101,194,4,33,2,2
13583,26,8617,16,53816,22991,30825,139,306,71,68
22367,10,15141,9,262,94,168,2,30,1,1
7830,26,132,16,5778,1095,4683,17,26,10,7
14799,234,2426,149,7061,1730,5331,21,3600,11,10
10748,2812,26586,2182,66,66,0,1,5,1,0
16319,26,8895,16,9125,3736,5389,19,120,10,9
9118,15,26591,11,10841,821,10020,19,15,9,10
1956,10,7510,9,240,96,144,2,30,1,1
9033,10,7219,9,414,103,311,4,31,2,2
21625,10,28606,9,240,98,142,2,30,1,1
7342,15,10064,11,1638,1324,314,10,15,5,5
9291,10,25200,9,774,101,673,2,30,1,1
18541,2757,21851,2138,70,70,0,2,8,2,0
9481,10,3481,9,102,102,0,1,30,1,0
22095,10,597,9,176,90,86,2,30,1,1
10820,2384,24238,1852,70,70,0,2,8,2,0
10799,888,11881,656,70,70,0,2,8,2,0
12531,514,15538,339,492,306,186,8,16,5,3
9728,2585,20141,2006,166,166,0,1,1199,1,0
22464,10,11825,9,536,113,423,4,56,2,2
15510,358,6948,229,78,78,0,1,30,1,0
6654,26,27031,16,1848,1141,707,14,566,8,6
14408,10,13909,9,184,94,90,2,30,1,1
14829,15,24823,11,101524,1673,99851,94,15,24,70
6028,676,17780,475,130,70,60,2,5,1,1
2489,26,9658,16,2227,1018,1209,17,15,8,9
21948,10,15780,9,214,110,104,2,30,1,1
8486,10,19900,9,166,86,80,2,30,1,1
15992,10,20849,9,183,94,89,2,30,1,1
12386,3044,10348,2366,70,70,0,2,7,2,0
12689,810,24276,590,492,306,186,8,15,5,3
7312,26,27418,16,12852,3554,9298,35,24,19,16
11072,26,28402,16,8740,1799,6941,25,25,13,12
14640,10,17436,9,170,87,83,2,30,1,1
18795,1989,26339,1519,316,136,180,6,6,3,3
11034,26,28583,16,4804,866,3938,19,26,10,9
9613,15,21995,11,350722,14506,336216,459,26,231,228
4535,26,21762,16,14035,8420,5615,31,256,18,13
8675,10,522,9,339,110,229,2,30,1,1
14274,26,5553,16,11771,2624,9147,50,19,25,25
18490,3094,11884,2403,70,70,0,1,5,1,0
9273,26,19851,16,48255,4798,43457,100,149,47,53
12053,2456,2798,1908,320,140,180,6,7,3,3
14918,10,23661,9,196,102,94,2,35,1,1
3705,26,19179,16,1717,1153,564,13,26,7,6
9728,2251,11922,1743,161,161,0,1,1201,1,0
22236,10,8428,9,188,96,92,2,30,1,1
5756,26,11670,16,15679,4305,11374,32,43,17,15
14292,10,13750,9,195,102,93,2,30,1,1
14341,10,4645,9,308,94,214,2,30,1,1
15264,26,6978,16,7890,1901,5989,20,15,11,9
8697,26,21541,16,95223,30803,64420,107,23,50,57
8790,10,26567,9,293,126,167,2,30,1,1
10206,26,26642,16,14025,7301,6724,38,171,22,16
2733,26,17182,16,8466,3146,5320,30,20,15,15
21973,10,2802,9,152,78,74,2,30,1,1
14341,2429,2758,1890,70,70,0,2,8,2,0
20287,26,12801,16,126,60,66,3,10,2,1
14430,10,15851,9,183,94,89,2,30,1,1
22304,10,4529,9,260,94,166,2,30,1,1
15305,10,16913,9,177,94,83,2,29,1,1
14944,10,23199,9,212,102,110,2,30,1,1
14242,1435,10980,1089,70,70,0,1,5,1,0
20319,26,9146,16,28847,16957,11890,144,293,60,84
14565,10,2850,9,200,94,106,2,30,1,1
12809,872,27640,643,70,70,0,2,8,2,0
10255,15,27412,11,1114,534,580,12,16,7,5
21709,10,2896,9,182,93,89,2,30,1,1
14267,10,11638,9,244,94,150,2,30,1,1
22345,10,6059,9,752,110,642,2,30,1,1
10729,15,15124,11,15609,1298,14311,26,75,14,12
16594,10,9762,9,224,94,130,2,30,1,1
15101,10,21280,9,184,102,82,2,30,1,1
17982,26,7827,16,1066,545,521,11,28,5,6
9823,15,13228,11,2139,1167,972,10,20,6,4
8576,10,5155,9,178,94,84,2,30,1,1
10567,26,22519,16,153968,7663,146305,170,173,43,127
21374,2839,22214,2203,66,66,0,1,5,1,0
4464,26,27940,16,490,210,280,8,131,4,4
18942,26,19950,16,1373,712,661,14,18,8,6
14696,10,17860,9,177,94,83,2,30,1,1
19306,26,20073,16,4775,894,3881,18,28,10,8
7791,23,0,0,7809,3013,4796,28,31,14,14
8245,15,22273,11,2544,1681,863,12,185,7,5
15610,10,2095,9,186,102,84,2,31,1,1
14373,10,17558,9,216,110,106,2,30,1,1
14736,10,18486,9,194,102,92,2,31,1,1
7066,10,22836,9,168,78,90,2,30,1,1
10046,26,25569,16,22211,8661,13550,173,854,77,96
16207,10,20638,9,275,86,189,2,30,1,1
13699,26,2991,16,4660,3048,1612,31,81,15,16
6121,26,561,16,235626,4546,231080,232,339,53,179
18444,1206,17486,893,70,70,0,1,5,1,0
9063,10,9751,9,718,94,624,2,30,1,1
5666,10,17559,9,199,94,105,2,30,1,1
9076,10,10747,9,246,102,144,2,30,1,1
9202,26,17346,16,1097,654,443,12,86,7,5
4865,26,27740,16,6180,3550,2630,27,272,13,14
13874,26,27440,16,12645,4916,7729,39,94,22,17
14137,10,2026,9,711,87,624,2,30,1,1
9264,10,10885,9,209,110,99,2,30,1,1
21138,26,25674,16,8012,4410,3602,20,135,10,10
10999,15,8797,11,622,70,552,10,1117,2,8
8748,15,13097,11,454222,9730,444492,425,155,119,306
10030,15,3442,11,21445,1605,19840,36,255,19,17
2788,26,2986,16,5235,1839,3396,22,48,10,12
21714,10,424,9,272,94,178,2,30,1,1
14172,10,27744,9,177,94,83,2,30,1,1
5349,26,23450,16,9115,6806,2309,37,80,20,17
9448,26,6729,16,13459,1604,11855,27,187,14,13
12697,26,4740,16,499,425,74,4,1,3,1
15327,10,972,9,183,94,89,2,29,1,1
20837,26,8061,16,8543,1114,7429,26,93,11,15
15017,10,9097,9,312,94,218,2,30,1,1
12372,234,24531,149,9674,1776,7898,29,3764,11,18
22184,10,15636,9,257,102,155,2,30,1,1
8829,15,18727,11,8935,3175,5760,17,41,8,9
10655,26,11451,16,13526,2192,11334,32,141,16,16
636,1785,28751,1363,221,111,110,2,1200,1,1
17653,15,13562,11,1052,612,440,10,15,5,5
6911,26,20300,16,3698,1302,2396,13,136,6,7
22691,26,5068,16,92573,4519,88054,105,16,39,66
14518,10,5551,9,711,87,624,2,30,1,1
14262,10,3090,9,210,110,100,2,30,1,1
14656,10,792,9,168,86,82,2,31,1,1
17567,26,11949,16,15860,1930,13930,37,195,14,23
22288,10,21557,9,193,102,91,2,29,1,1
7902,26,1100,16,299614,32024,267590,587,115,304,283
8600,26,3355,16,197635,12994,184641,287,183,143,144
11137,495,5591,325,70,70,0,2,7,2,0
15697,10,18562,9,195,102,93,2,30,1,1
14379,10,13732,9,177,94,83,2,30,1,1
9721,15,22048,11,18679,9115,9564,45,18,24,21
18935,10,27059,9,237,91,146,2,32,1,1
17778,15,12479,11,1352,848,504,13,169,8,5
292,10,815,9,216,82,134,2,31,1,1
20190,26,11793,16,11741,7040,4701,40,172,22,18
5842,15,28008,11,540,540,0,10,186,10,0
8842,10,15540,9,733,86,647,2,30,1,1
14409,10,28064,9,177,94,83,2,29,1,1
8827,26,20355,16,10553,2117,8436,24,46,12,12
8639,26,13164,16,3990,1296,2694,17,158,9,8
11364,15,22925,11,2910,1489,1421,10,16,6,4
15281,15,7429,11,214,140,74,4,25,3,1
18456,26,13151,16,8049,1805,6244,23,81,12,11
12440,2910,1061,2259,70,70,0,1,4,1,0
3266,15,2379,11,1495,779,716,10,30,6,4
3713,26,25366,16,3497,1845,1652,18,15,9,9
22191,10,4115,9,200,102,98,2,29,1,1
4018,26,18154,16,269750,10062,259688,285,152,92,193
8802,26,21206,16,6158,1149,5009,17,52,9,8
15996,10,2159,9,199,102,97,2,30,1,1
22697,26,720,16,92884,4939,87945,111,16,45,66
10033,15,2458,11,14661588,141996,14519592,11768,134,2012,9756
22126,10,14587,9,211,102,109,2,30,1,1
16215,10,0,0,300,90,210,2,30,1,1
9027,10,26393,9,200,86,114,2,30,1,1
12681,26,14325,16,499,425,74,4,0,3,1
8875,15,15225,11,128214,4961,123253,134,108,43,91
4831,128,9781,96,3623810,67493,3556317,3486,35,943,2543
8611,10,14468,9,770,101,669,2,30,1,1
8963,10,1822,9,787,110,677,2,30,1,1
10172,15,13963,11,5678,1692,3986,13,17,8,5
14678,10,4509,9,168,86,82,2,30,1,1
9340,15,19248,11,1746,780,966,19,56,7,12
4069,10,28136,9,168,78,90,2,30,1,1
5098,26,2773,16,7897,3562,4335,19,16,10,9
3178,10,13467,9,235,90,145,2,34,1,1
15754,10,13312,9,2198,193,2005,6,90,3,3
10101,190,19514,125,258,107,151,2,31,1,1
6191,26,19440,16,9999,4008,5991,33,345,18,15
1895,10,7224,9,233,90,143,2,31,1,1
10960,26,4337,16,9114,2713,6401,33,82,15,18
15225,26,15652,16,4628,1035,3593,19,25,11,8
3538,15,5173,11,1052,612,440,10,15,5,5
4733,26,27631,16,8926,2746,6180,27,46,16,11
8513,26,8975,16,4312,2524,1788,34,132,19,15
8334,10,24308,9,258,94,164,2,30,1,1
10046,26,8220,16,8058,1136,6922,19,129,9,10
6472,26,18636,16,10239,2017,8222,23,18,14,9
6482,26,7864,16,6496,2026,4470,20,16,12,8
15074,10,15773,9,164,86,78,2,29,1,1
8844,15,19285,11,1977,921,1056,9,15,5,4
9129,10,2140,9,257,110,147,2,30,1,1
17731,26,16049,16,22106,5214,16892,23,127,9,14
21234,3069,7628,2384,66,66,0,2,8,2,0
16631,10,20857,9,259,86,173,2,30,1,1
6285,26,24622,16,321621,14025,307596,408,41,185,223
2059,10,8112,9,244,98,146,2,33,1,1
15024,10,23102,9,198,101,97,2,30,1,1
18983,26,27764,16,3182,1568,1614,8,120,4,4
13664,26,7844,16,7651,2261,5390,41,255,21,20
2620,10,11033,9,231,90,141,2,31,1,1
12647,26,1991,16,4622,860,3762,16,17,9,7
8933,10,1526,9,177,94,83,2,30,1,1
21229,10,7454,9,195,102,93,2,31,1,1
12691,26,15864,16,11779,3603,8176,42,142,21,21
8619,10,28625,9,227,110,117,2,31,1,1
21919,10,11642,9,760,97,663,2,31,1,1
907,26,5964,16,5734,498,5236,14,15,7,7
9577,10,27349,9,770,102,668,2,30,1,1
6049,26,19512,16,14424911,433341,13991570,15454,320,5482,9972
11168,1169,12883,862,70,70,0,2,8,2,0
22401,10,2195,9,448,94,354,4,49,2,2
1065,26,24291,16,7398,1480,5918,24,39,12,12
18270,10,13234,9,196,94,102,2,31,1,1
5682,10,17458,9,194,87,107,2,31,1,1
15217,26,11181,16,27108,2396,24712,40,80,18,22
15864,10,5800,9,177,94,83,2,30,1,1
15679,10,6179,9,756,95,661,2,30,1,1
22688,10,10891,9,167,86,81,2,29,1,1
8988,10,17084,9,209,110,99,2,31,1,1
2674,10,24599,9,197,94,103,2,29,1,1
16357,26,20425,16,1786,1147,639,17,177,10,7
4619,26,19337,16,8586,1714,6872,25,43,14,11
7241,26,27994,16,4851,848,4003,16,16,9,7
18992,10,5839,9,578,286,292,9,16,5,4
99,10,163,9,215,80,135,2,32,1,1
9997,26,19519,16,6883,1378,5505,19,131,9,10
10595,26,21809,16,13331,2421,10910,38,209,20,18
13623,10,5196,9,199,102,97,2,29,1,1
9276,26,14402,16,23870,3485,20385,55,143,29,26
12637,657,8166,459,320,140,180,6,5,3,3
11443,15,15202,11,5582,591,4991,14,75,7,7
17438,10,23465,9,222,94,128,2,30,1,1
8566,15,19394,11,3651,2020,1631,16,65,9,7
22569,10,21283,9,212,102,110,2,30,1,1
8669,26,2309,16,20565,2848,17717,31,27,10,21
5892,26,6553,16,30604,3050,27554,45,122,18,27
15231,10,17875,9,255,88,167,4,52,2,2
8467,10,10832,9,232,86,146,2,30,1,1
5912,26,14565,16,234,234,0,4,12,4,0
21224,10,13361,9,254,110,144,2,30,1,1
15073,10,3365,9,199,102,97,2,30,1,1
14339,10,14501,9,733,93,640,2,31,1,1
12422,1699,8008,1298,70,70,0,1,5,1,0
10663,26,22270,16,5678,3121,2557,39,256,18,21
8694,10,5482,9,177,94,83,2,30,1,1
12897,26,7918,16,72465,3991,68474,98,169,43,55
5609,26,22108,16,5656,1009,4647,24,87,10,14
9748,26,28877,16,1385,783,602,14,23,8,6
5495,26,20339,16,2190,1249,941,23,26,12,11
22646,183,29115,121,4350,2261,2089,21,17,11,10
18364,15,2514,11,1557,778,779,11,144,6,5
13929,10,6590,9,268,95,173,4,47,2,2
9810,15,15242,11,2937,1241,1696,12,22,7,5
21152,1735,11724,1324,504,382,122,8,15,6,2
22310,10,8451,9,198,94,104,2,30,1,1
11295,10,0,0,233,89,144,2,30,1,1
14470,10,9519,9,711,87,624,2,31,1,1
3545,26,17831,16,9407,2233,7174,38,96,16,22
14253,15,11590,11,389326,9849,379477,391,21,138,253
12723,26,16217,16,495,421,74,4,0,3,1
11070,15,23718,11,366,240,126,7,24,5,2
14175,10,14969,9,196,100,96,3,33,2,1
9036,26,29015,16,3120,1862,1258,18,15,11,7
8927,26,23395,16,36615,5107,31508,108,125,49,59
15178,10,13996,9,168,86,82,2,30,1,1
9728,1355,27763,1028,1302,300,1002,6,1200,3,3
13776,15,13158,11,4239,2334,1905,17,187,10,7
14840,15,24831,11,101529,1646,99883,94,15,24,70
4184,26,13557,16,3821,2814,1007,22,17,12,10
15789,10,4229,9,821,102,719,2,30,1,1
9057,26,10673,16,617481,41514,575967,856,221,381,475
9179,10,0,0,234,86,148,2,30,1,1
10796,15,3507,11,2190,1284,906,13,74,8,5
22720,10,19462,9,193,102,91,2,30,1,1
2037,10,17171,9,300,209,91,3,30,2,1
10465,26,12587,16,9076,2650,6426,35,247,15,20
21725,10,890,9,320,97,223,4,50,2,2
8664,10,28065,9,734,94,640,2,29,1,1
8951,10,16545,9,206,105,101,2,31,1,1
14891,10,23993,9,184,94,90,2,31,1,1
8769,10,7347,9,766,102,664,2,30,1,1
14102,26,16662,16,12399,3942,8457,83,615,42,41
5276,10,16846,9,221,89,132,2,30,1,1
21505,10,28782,9,199,102,97,2,29,1,1
4330,10,25875,9,302,208,94,3,30,2,1
8677,26,24767,16,1200,623,577,13,27,6,7
21803,10,25867,9,558,104,454,4,49,2,2
13667,10,28157,9,728,102,626,2,29,1,1
16914,15,1606,11,1360,900,460,10,515,6,4
21244,10,9222,9,323,85,238,4,34,2,2
4840,2504,9515,1947,156,156,0,3,7,3,0
11275,2744,334,2127,70,70,0,2,7,2,0
9055,10,18405,9,164,84,80,2,31,1,1
13825,10,7343,9,183,94,89,2,30,1,1
13732,26,25530,16,7156,1187,5969,20,16,10,10
15590,10,9193,9,177,94,83,2,30,1,1
9728,463,28314,299,161,161,0,2,1200,2,0
22414,10,5944,9,273,118,155,2,30,1,1
16012,26,9598,16,1857,1218,639,18,119,11,7
21248,10,27232,9,310,142,168,2,30,1,1
15524,10,22501,9,250,86,164,4,31,2,2
2744,1238,23561,918,894,126,768,2,30,1,1
14263,1925,19108,1469,70,70,0,1,5,1,0
17089,26,7061,16,14261,9361,4900,35,16,19,16
8971,10,21663,9,229,89,140,2,31,1,1
8412,10,10365,9,195,102,93,2,30,1,1
21816,10,13310,9,257,102,155,2,30,1,1
9129,10,4301,9,226,110,116,2,30,1,1
3971,26,12952,16,12481,2743,9738,53,20,26,27
8867,10,19592,9,523,92,431,4,48,2,2
14354,1238,6708,918,1173,924,249,6,30,3,3
4467,10,15870,9,197,90,107,2,30,1,1
8541,10,23908,9,186,95,91,2,31,1,1
11135,15,19035,11,422,240,182,8,26,5,3
14946,10,49,9,198,101,97,2,30,1,1
2724,1240,16606,920,6466,3520,2946,38,46,21,17
15050,10,3559,9,166,85,81,2,31,1,1
22392,1239,8537,919,249,78,171,2,29,1,1
15235,10,929,9,338,110,228,2,30,1,1
1408,10,4866,9,244,98,146,2,33,1,1
16863,10,19623,9,302,86,216,2,30,1,1
21387,26,17485,16,4116645,96572,4020073,4029,58,1356,2673
9873,26,2990,16,1323,738,585,10,16,6,4
15559,10,8836,9,177,94,83,2,31,1,1
8422,15,21400,11,8453,961,7492,18,20,9,9
5910,26,27039,16,12757,4053,8704,39,522,14,25
21060,26,13229,16,7995,2096,5899,18,120,8,10
14833,15,24827,11,101473,1494,99979,91,15,21,70
17890,10,13323,9,193,94,99,2,30,1,1
21923,10,17420,9,199,102,97,2,30,1,1
13672,10,16084,9,179,94,85,2,30,1,1
8394,153,15554,108,70,70,0,2,8,2,0
8052,676,25993,475,130,70,60,2,5,1,1
21379,10,8200,9,288,101,187,4,57,2,2
21717,10,9541,9,386,106,280,4,51,2,2
14919,10,10739,9,268,89,179,4,45,2,2
14657,10,5227,9,172,94,78,2,29,1,1
22549,26,17059,16,3122508,193850,2928658,4050,681,1740,2310
12549,676,2974,475,320,140,180,6,7,3,3
8618,26,3427,16,16012,6573,9439,43,175,20,23
5683,26,7109,16,317215,285998,31217,436,982,244,192
14210,1231,28689,911,70,70,0,1,5,1,0
13707,15,7438,11,162010,4343,157667,170,98,61,109
16483,15,23545,11,1225,711,514,11,15,5,6
15962,10,21532,9,194,102,92,2,30,1,1
8831,10,15025,9,168,86,82,2,32,1,1
8698,10,7574,9,443,182,261,6,31,3,3
13603,26,25694,16,493685,14728,478957,612,316,213,399
8001,26,16477,16,3138,2011,1127,16,255,9,7
14298,10,22942,9,774,101,673,2,30,1,1
14113,10,27518,9,183,94,89,2,31,1,1
20010,26,5374,16,6343025,74037,6268988,5018,58,765,4253
12402,1964,19893,1500,70,70,0,1,5,1,0
9286,10,25572,9,174,89,85,2,30,1,1
14601,10,6072,9,182,93,89,2,30,1,1
13907,10,8111,9,173,94,79,2,30,1,1
15952,10,2362,9,183,94,89,2,30,1,1
4796,26,10925,16,14283,12630,1653,29,126,17,12
15920,10,8380,9,178,94,84,2,29,1,1
8365,10,6864,9,261,94,167,2,29,1,1
15502,10,24274,9,784,94,690,2,30,1,1
11225,2600,18726,2019,70,70,0,2,8,2,0
12365,1865,21858,1423,70,70,0,2,7,2,0
10117,15,18908,11,5956,1595,4361,17,19,10,7
13641,10,27165,9,215,102,113,2,30,1,1
22717,10,12979,9,168,86,82,2,31,1,1
21465,10,11778,9,200,94,106,2,29,1,1
21324,10,16535,9,209,110,99,2,30,1,1
9165,10,14620,9,239,94,145,2,29,1,1
15810,26,6518,16,8613,2377,6236,41,17,23,18
8559,26,18342,16,62,62,0,1,5,1,0
9309,10,23268,9,756,95,661,2,30,1,1
9,18,5037,13,184,94,90,2,30,1,1
15104,26,23679,16,1560,988,572,13,25,7,6
11248,15,22846,11,1921,1472,449,10,20,6,4
5125,26,25335,16,90113,3417,86696,95,16,30,65
1053,26,189,16,5699,505,5194,14,15,7,7
13859,10,26710,9,238,94,144,2,30,1,1
22171,10,5062,9,209,110,99,2,30,1,1
15478,26,7909,16,7537,2310,5227,19,142,8,11
19815,26,27565,16,151233,12592,138641,190,19,88,102
10639,26,8274,16,19664,8943,10721,42,37,22,20
11389,10,0,0,138,69,69,2,30,1,1
17540,10,4117,9,211,78,133,2,30,1,1
22487,183,29035,121,3327,1438,1889,15,16,8,7
13500,183,24107,121,3413,1458,1955,16,17,8,8
6999,2627,111,2037,475,150,325,2,1200,1,1
6659,15,18875,11,1252,539,713,10,20,5,5
3651,26,4012,16,1984,1233,751,16,20,8,8
20543,10,28270,9,446,164,282,2,30,1,1
14451,10,26919,9,182,93,89,2,31,1,1
8229,10,17553,9,164,78,86,2,30,1,1
15334,10,15566,9,733,94,639,2,31,1,1
6915,26,25882,16,716,428,288,11,26,7,4
17256,10,19789,9,307,86,221,2,30,1,1
2935,183,12036,121,3850,1745,2105,19,18,11,8
22718,10,675,9,199,102,97,2,30,1,1
14019,10,16970,9,226,110,116,2,30,1,1
12640,3045,16898,2367,1973,1021,952,10,15,6,4
8697,15,11464,11,78,78,0,2,8,2,0
8584,1288,4011,966,78,78,0,1,30,1,0
15512,10,22110,9,216,110,106,2,31,1,1
13946,10,6431,9,88,88,0,2,31,2,0
15220,15,4509,11,234,234,0,4,12,4,0
10950,15,7015,11,5069,4443,626,11,30,6,5
9996,26,10733,16,6391,1285,5106,19,15,10,9
8441,10,5997,9,197,102,95,2,30,1,1
13711,26,2846,16,1364,940,424,12,16,7,5
8837,10,20455,9,183,94,89,2,30,1,1
3315,26,25477,16,300,180,120,4,15,2,2
4396,26,21830,16,232,172,60,3,5,2,1
22219,10,4577,9,276,118,158,2,29,1,1
12825,755,8311,543,70,70,0,1,5,1,0
12035,2243,15553,1736,70,70,0,1,5,1,0
14117,10,14993,9,758,96,662,2,30,1,1
8584,1240,2481,920,300,78,222,2,30,1,1
8364,153,13030,108,70,70,0,1,4,1,0
18134,26,29073,16,4722,2945,1777,18,142,10,8
12593,2381,19210,1850,492,306,186,8,15,5,3
18790,923,20227,681,70,70,0,1,5,1,0
15523,10,6430,9,363,109,254,4,46,2,2
11409,26,16155,16,1043,556,487,10,16,6,4
21273,2394,23832,1861,66,66,0,2,8,2,0
3781,15,7490,11,467664,17895,449769,610,355,265,345
1565,10,5607,9,237,91,146,2,32,1,1
19537,10,27387,9,221,90,131,2,30,1,1
22630,10,453,9,168,86,82,2,29,1,1
15639,10,23089,9,177,94,83,2,31,1,1
17854,26,26484,16,4730,1823,2907,19,28,11,8
6360,26,7468,16,3650,2162,1488,25,80,13,12
14989,10,29063,9,757,98,659,2,30,1,1
9499,26,152,16,1786,172,1614,7,120,3,4
20837,26,23296,16,5614,2964,2650,19,120,9,10
13773,10,12446,9,198,102,96,2,29,1,1
14672,10,27039,9,198,101,97,2,31,1,1
8111,15,24613,11,1113,534,579,12,15,7,5
12930,26,23765,16,171467,27550,143917,220,85,108,112
10288,26,7675,16,154,94,60,2,4,1,1
2744,1570,9379,1201,871,126,745,2,30,1,1
15144,26,21389,16,1277,705,572,13,25,7,6
22170,10,11634,9,216,94,122,2,30,1,1
14009,10,6511,9,184,102,82,2,29,1,1
10601,26,13804,16,254,70,184,5,21,2,3
3972,26,28511,16,291,171,120,4,15,2,2
15179,26,9419,16,2904,662,2242,13,135,6,7
3551,26,24457,16,1178,820,358,9,15,6,3
8356,26,15707,16,15611,1501,14110,32,361,14,18
16535,18,13573,13,184,94,90,2,30,1,1
8820,10,1934,9,184,94,90,2,30,1,1
15212,15,22981,11,234,234,0,4,12,4,0
14228,10,25416,9,184,94,90,2,30,1,1
1256,10,4157,9,237,91,146,2,32,1,1
13741,10,1213,9,193,102,91,2,29,1,1
9702,15,4220,11,318,192,126,6,26,4,2
15702,10,121,9,164,84,80,2,31,1,1
15299,10,6904,9,190,97,93,2,31,1,1
7526,26,14194,16,7330,4420,2910,31,316,16,15
5485,26,7641,16,5597,3595,2002,42,68,23,19
636,287,28476,184,228,118,110,2,1199,1,1
5073,26,8717,16,4089,1965,2124,25,83,13,12
21916,10,7797,9,182,93,89,2,31,1,1
932,15,3606,11,13456,880,12576,21,16,9,12
16021,42,14736,25,132,132,0,3,1200,3,0
9500,26,24542,16,505625,19174,486451,584,143,204,380
16436,234,26199,149,2725,1610,1115,20,3600,10,10
3445,15,19309,11,1570,754,816,10,15,6,4
9678,10,22026,9,216,88,128,2,30,1,1
22649,10,8997,9,387,102,285,2,29,1,1
6512,10,17925,9,168,78,90,2,30,1,1
21589,10,10554,9,193,102,91,2,30,1,1
8599,10,22426,9,278,94,184,2,30,1,1
8739,15,10234,11,180917,5183,175734,175,65,49,126
14379,10,17109,9,177,94,83,2,30,1,1
9012,26,9108,16,5997,976,5021,19,72,10,9
11501,15,20277,11,3771,3257,514,12,14,7,5
15827,10,23559,9,200,102,98,2,31,1,1
22180,10,4652,9,448,98,350,4,41,2,2
18227,26,21663,16,16448,5420,11028,47,319,23,24
13829,10,15197,9,177,94,83,2,29,1,1
15236,10,6820,9,288,93,195,4,32,2,2
21937,10,11248,9,211,110,101,2,30,1,1
8795,10,587,9,198,102,96,2,29,1,1
3878,26,21667,16,10059,2039,8020,23,186,12,11
12666,458,12526,296,70,70,0,2,7,2,0
5405,360,21287,231,280,214,66,2,30,1,1
10280,26,12789,16,975832,29038,946794,991,51,341,650
15662,10,3963,9,177,94,83,2,30,1,1
22392,1238,7426,918,257,78,179,2,30,1,1
8526,26,28741,16,63494,7222,56272,107,81,49,58
9664,10,20269,9,732,86,646,2,30,1,1
19611,7,27428,7,60,60,0,1,5,1,0
10717,15,10638,11,45058,2444,42614,90,52,33,57
14349,10,4933,9,177,94,83,2,29,1,1
12027,26,1140,16,7648,3641,4007,29,42,13,16
6104,26,9402,16,50425,3972,46453,63,122,25,38
2744,89,25719,69,855,126,729,2,29,1,1
11093,15,5070,11,366,240,126,7,26,5,2
21138,2284,9407,1769,376,254,122,6,15,4,2
15983,26,28229,16,5337,1085,4252,14,76,8,6
17785,10,9633,9,263,94,169,2,30,1,1
13497,26,21187,16,1633,819,814,16,40,8,8
11184,15,24138,11,366,240,126,7,32,5,2
4763,26,11989,16,14009,10561,3448,30,135,16,14
7061,26,18807,16,2227,1018,1209,17,16,8,9
1041,26,14971,16,7135,1346,5789,21,32,10,11
7394,26,26370,16,10103,3482,6621,59,16,29,30
22695,10,16983,9,194,99,95,2,30,1,1
13381,26,25904,16,6509,1635,4874,21,186,11,10
10858,531,23881,352,316,136,180,6,6,3,3
10406,26,21474,16,8433,3066,5367,21,17,10,11
3052,183,12727,121,4145,1976,2169,22,19,13,9
11668,26,8193,16,10819,5326,5493,45,16,27,18
22507,10,17211,9,195,102,93,2,30,1,1
22628,10,21229,9,1386,85,1301,4,53,2,2
14663,10,22972,9,196,102,94,2,30,1,1
8563,10,23243,9,373,98,275,4,43,2,2
18186,26,17950,16,1011,568,443,11,139,6,5
10987,15,24712,11,486,300,186,9,27,6,3
22506,10,27987,9,166,86,80,2,30,1,1
6427,10,24271,9,168,78,90,2,30,1,1
18265,10,20786,9,199,94,105,2,30,1,1
17729,26,13537,16,10200,2180,8020,26,19,15,11
8584,1284,20614,963,78,78,0,1,30,1,0
8210,390,21194,253,490,149,341,2,1200,1,1
9600,10,18439,9,754,94,660,2,30,1,1
10592,26,24688,16,642,582,60,2,5,1,1
2724,1240,6535,920,254,82,172,4,30,2,2
22384,10,18176,9,421,96,325,4,42,2,2
7404,26,3942,16,161,101,60,2,5,1,1
7623,10,20326,9,235,90,145,2,32,1,1
10550,40,1544,23,14747,5073,9674,109,45,51,58
15106,26,23784,16,8313,3597,4716,16,119,8,8
22264,10,25090,9,270,94,176,2,30,1,1
21754,10,6671,9,198,102,96,2,29,1,1
21761,10,8476,9,261,87,174,4,44,2,2
8335,10,5871,9,196,102,94,2,30,1,1
22257,10,11325,9,188,96,92,2,31,1,1
14590,10,20905,9,255,102,153,2,30,1,1
2714,26,9580,16,21239,16302,4937,35,20,20,15
8878,26,186,16,11365,1278,10087,23,131,10,13
15363,26,17114,16,7929,1940,5989,20,15,11,9
16046,15,26074,11,30979,1798,29181,46,14,23,23
9218,10,18447,9,177,94,83,2,29,1,1
22622,10,28026,9,210,102,108,2,30,1,1
17969,26,26170,16,27510,4470,23040,67,122,34,33
14241,10,10813,9,177,94,83,2,30,1,1
8915,26,17713,16,7398,1597,5801,20,128,10,10
15243,10,27437,9,177,94,83,2,29,1,1
3566,10,14478,9,643,88,555,2,31,1,1
21271,10,8046,9,199,102,97,2,30,1,1
8210,1616,21194,1238,152,152,0,1,1200,1,0
14478,10,26469,9,210,110,100,2,30,1,1
15358,987,10149,728,70,70,0,1,5,1,0
15631,10,16943,9,1780,674,1106,18,68,9,9
10097,15,7928,11,109660,1992,107668,99,35,20,79
21318,10,7344,9,200,102,98,2,30,1,1
9841,15,19391,11,54775,28230,26545,230,175,115,115
13001,26,27133,16,190,70,120,4,15,2,2
22225,10,4615,9,718,94,624,2,29,1,1
8700,10,21485,9,168,86,82,2,30,1,1
13659,10,24138,9,182,93,89,2,31,1,1
5082,26,19412,16,2335,1247,1088,15,28,8,7
21847,10,18143,9,305,100,205,4,54,2,2
12113,26,11845,16,6001,982,5019,19,65,10,9
22483,183,29033,121,3424,1710,1714,16,31,8,8
12016,26,25793,16,11811,4242,7569,27,46,15,12
8798,10,887,9,199,102,97,2,31,1,1
9569,26,14672,16,5653,1079,4574,14,26,8,6
19262,26,9593,16,7653,1226,6427,24,18,14,10
16531,183,25718,121,3549,1594,1955,18,16,10,8
2744,1240,20705,920,878,126,752,2,31,1,1
16753,26,5767,16,155345,11568,143777,195,195,73,122
10729,3199,11079,2480,66,66,0,1,5,1,0
15642,10,6071,9,195,102,93,2,30,1,1
14994,10,2576,9,179,94,85,2,30,1,1
10989,2119,27351,1633,70,70,0,1,4,1,0
22640,10,10605,9,170,87,83,2,31,1,1
11012,15,6806,11,2776,2091,685,9,47,5,4
14307,42,27533,25,70,70,0,1,5,1,0
1034,26,27158,16,3835,501,3334,14,15,7,7
7886,15,4971,11,1720,1406,314,10,15,5,5
8918,10,19169,9,182,94,88,2,29,1,1
15980,142,25375,101,156,156,0,3,8,3,0
4193,26,3159,16,2509208,64544,2444664,2429,304,700,1729
13351,15,1853,11,14855,1611,13244,26,77,14,12
12664,26,14315,16,499,425,74,4,0,3,1
9160,10,1049,9,182,93,89,2,31,1,1
9796,15,663,11,97934,5018,92916,124,20,55,69
2744,1237,27032,917,879,126,753,2,30,1,1
5826,26,22785,16,567854,22650,545204,713,158,311,402
4625,26,5958,16,9082,3492,5590,26,61,15,11
15253,10,21302,9,240,110,130,2,30,1,1
12130,26,2963,16,24835,2671,22164,42,323,17,25
6897,26,2024,16,6972,1375,5597,20,31,10,10
21343,10,13209,9,168,86,82,2,30,1,1
8453,10,17483,9,184,94,90,2,29,1,1
1219,280,252,177,460,150,310,2,1200,1,1
15567,10,29138,9,170,87,83,2,30,1,1
8484,10,18042,9,168,78,90,2,30,1,1
4305,26,26195,16,10691,3704,6987,25,181,13,12
21611,10,16909,9,192,98,94,2,31,1,1
19099,26,26130,16,6391,3788,2603,14,121,7,7
22040,10,27240,9,260,102,158,2,30,1,1
21250,10,5881,9,200,94,106,2,30,1,1
5843,15,17743,11,100182,8294,91888,137,127,69,68
15300,10,20356,9,262,90,172,4,59,2,2
8392,26,9527,16,11707,2326,9381,28,19,14,14
15456,10,1438,9,87,87,0,2,61,2,0
5681,26,21333,16,1053,566,487,10,47,6,4
15588,10,9767,9,363,102,261,2,30,1,1
15973,10,6112,9,295,101,194,4,31,2,2
3970,389,15089,252,138,78,60,2,5,1,1
10173,15,27728,11,1638,1324,314,10,14,5,5
9,18,3216,13,184,94,90,2,29,1,1
21113,135,12342,99,66,66,0,2,7,2,0
8974,26,26312,16,83683,2747,80936,92,125,32,60
9174,10,17117,9,756,95,661,2,31,1,1
15744,10,13660,9,178,94,84,2,30,1,1
9,18,11233,13,184,94,90,2,30,1,1
22654,10,27738,9,372,126,246,2,30,1,1
5798,26,18437,16,8142,2090,6052,22,360,10,12
16972,10,4327,9,167,78,89,2,29,1,1
19923,15,27647,11,2158,1419,739,11,150,6,5
8900,10,22564,9,259,110,149,2,30,1,1
14434,10,11012,9,215,94,121,2,30,1,1
13773,10,10082,9,295,86,209,2,30,1,1
227,10,567,9,221,83,138,2,32,1,1
5667,15,9237,11,1502,467,1035,9,180,5,4
1186,26,29038,16,25316,10344,14972,84,170,48,36
636,584,13659,396,622,356,266,4,1201,2,2
17538,10,14255,9,209,70,139,2,30,1,1
21516,10,513,9,332,102,230,2,30,1,1
22206,10,14004,9,210,110,100,2,31,1,1
15872,26,10541,16,134,60,74,3,5,2,1
15403,2715,5020,2109,66,66,0,1,5,1,0
21572,10,26358,9,184,94,90,2,31,1,1
9031,10,19104,9,170,87,83,2,30,1,1
9411,1222,21815,903,480,149,331,2,1201,1,1
9048,10,3301,9,252,102,150,2,30,1,1
12001,2596,15821,2015,70,70,0,2,8,2,0
2532,10,10633,9,231,90,141,2,31,1,1
14384,10,10039,9,177,94,83,2,30,1,1
14581,10,7747,9,193,102,91,2,31,1,1
13866,10,9194,9,193,102,91,2,30,1,1
6679,15,14864,11,1676620,41953,1634667,1725,25,636,1089
2472,10,10299,9,235,90,145,2,32,1,1
8642,298,21505,193,4215,2090,2125,15,16,8,7
17095,26,10349,16,10273,2573,7700,24,305,8,16
11026,2106,20318,1622,70,70,0,1,4,1,0
5708,26,9406,16,3167,2456,711,15,16,10,5
7020,26,16941,16,1849,1130,719,17,36,9,8
2682,10,11232,9,237,91,146,2,33,1,1
9804,15,22332,11,1658,1247,411,8,15,5,3
22254,10,6874,9,197,102,95,2,29,1,1
17177,10,11824,9,426,118,308,2,31,1,1
4284,26,20097,16,3256,1753,1503,17,315,10,7
13964,10,23478,9,199,102,97,2,30,1,1
7318,15,20499,11,23259,2769,20490,36,143,19,17
22185,10,19158,9,212,108,104,2,31,1,1
8940,10,17268,9,234,102,132,2,30,1,1
7433,26,24136,16,28173,21385,6788,100,41,51,49
12199,26,7919,16,2246,1396,850,15,117,9,6
14903,10,23300,9,183,94,89,2,30,1,1
10637,26,878,16,12552,2564,9988,29,16,17,12
7579,10,20260,9,217,87,130,2,31,1,1
17233,15,21181,11,2055,1651,404,8,76,5,3
21585,10,5233,9,174,89,85,2,31,1,1
15714,10,24833,9,720,94,626,2,30,1,1
15574,10,10492,9,177,94,83,2,30,1,1
14483,10,25979,9,172,88,84,2,30,1,1
14966,10,1154,9,249,85,164,4,55,2,2
15252,26,15989,16,6313,2068,4245,21,20,12,9
9720,15,13030,11,4189,1691,2498,16,24,9,7
15755,10,12340,9,190,97,93,2,31,1,1
22700,10,245,9,212,102,110,2,30,1,1
4313,26,27775,16,7046,3518,3528,66,612,35,31
14471,10,10913,9,167,86,81,2,31,1,1
4,2869,3,2228,118,118,0,1,120,1,0
8584,10,22354,9,379,93,286,4,37,2,2
22258,26,24486,16,12674,1396,11278,12,139,2,10
16315,26,23257,16,1320606,47731,1272875,1454,294,552,902
14523,10,26111,9,170,87,83,2,31,1,1
12097,26,8100,16,11664,7921,3743,23,16,14,9
9699,15,10062,11,318,192,126,6,26,4,2
13470,26,21010,16,9501,1502,7999,24,29,13,11
15255,349,10827,222,234,234,0,4,11,4,0
8498,10,15103,9,182,94,88,2,30,1,1
10128,10,25889,9,214,78,136,2,30,1,1
5210,26,16764,16,4644,1737,2907,19,28,11,8
8753,10,10843,9,229,102,127,2,30,1,1
9127,10,24119,9,279,96,183,4,59,2,2
15595,10,24215,9,369,150,219,2,30,1,1
10362,718,15840,513,70,70,0,1,5,1,0
8383,10,5880,9,181,94,87,2,30,1,1
8795,10,29002,9,198,102,96,2,31,1,1
15644,10,28736,9,195,102,93,2,30,1,1
3695,15,2167,11,1614,1300,314,10,15,5,5
10885,330,4817,211,12087,9521,2566,76,32,38,38
3345,10,12808,9,86,86,0,1,30,1,0
10941,656,8490,458,70,70,0,1,5,1,0
1054,26,21433,16,6094,771,5323,17,26,9,8
14172,10,1839,9,711,87,624,2,31,1,1
17367,26,20484,16,1469,702,767,20,120,10,10
7811,15,25931,11,1056,682,374,10,15,6,4
9788,15,10925,11,314,192,122,6,25,4,2
8929,26,28835,16,8439,1840,6599,21,127,11,10
8722,26,6798,16,8602,2308,6294,23,82,13,10
6312,15,18402,11,1913,1464,449,10,19,6,4
6801,15,993,11,36152,2792,33360,55,19,29,26
10342,26,1767,16,9668,4688,4980,42,16,25,17
14962,10,19236,9,192,98,94,2,31,1,1
15549,15,16226,11,214,140,74,4,35,3,1
22652,10,11533,9,210,102,108,2,30,1,1
22147,10,28993,9,193,102,91,2,30,1,1
12607,446,14949,286,70,70,0,2,7,2,0
13270,295,23955,190,3518,1951,1567,15,15,8,7
8584,212,2225,137,238,78,160,2,31,1,1
3389,26,23074,16,2161,1231,930,17,180,9,8
9094,26,2618,16,7934,1836,6098,23,15,13,10
8673,26,12256,16,9536,2399,7137,32,270,17,15
8435,26,27064,16,77368,9874,67494,139,100,65,74
18280,10,1468,9,491,115,376,2,31,1,1
8584,1243,9783,923,248,78,170,2,30,1,1
10676,26,6794,16,7419,2682,4737,26,66,13,13
22157,10,15177,9,240,86,154,2,30,1,1
11193,638,11616,443,70,70,0,1,5,1,0
22496,10,15924,9,190,97,93,2,31,1,1
16697,26,19979,16,7338,2419,4919,19,17,12,7
860,10,3552,9,224,88,136,2,30,1,1
12027,1754,13856,1339,70,70,0,1,5,1,0
9005,10,14630,9,264,110,154,2,31,1,1
21299,10,8694,9,194,99,95,2,1,1,1
13656,15,17912,11,10872190,337459,10534731,12500,208,5532,6968
15545,10,26951,9,301,126,175,2,30,1,1
18084,26,25514,16,158230,9208,149022,214,21,105,109
15263,26,26690,16,7942,1953,5989,20,15,11,9
8849,10,19316,9,262,94,168,2,29,1,1
8627,10,8732,9,821,102,719,2,29,1,1
10238,15,11876,11,366,240,126,7,21,5,2
11155,2511,7563,1952,70,70,0,2,8,2,0
20715,26,23736,16,9929,4574,5355,29,134,14,15
9993,26,27579,16,1501,590,911,12,26,6,6
8539,26,12894,16,6158,3587,2571,37,104,19,18
22220,10,25166,9,737,94,643,2,30,1,1
8210,280,21194,177,479,277,202,4,1200,2,2
22541,10,17513,9,177,94,83,2,30,1,1
22285,26,540,16,6118,5698,420,12,123,6,6
22477,10,8063,9,166,86,80,2,31,1,1
8680,26,21531,16,234110,36300,197810,309,66,160,149
16803,26,9420,16,26845,11746,15099,187,161,104,83
4731,26,17778,16,9811,3415,6396,29,46,17,12
21294,10,22552,9,202,103,99,2,30,1,1
7162,26,3950,16,2438,1442,996,21,27,12,9
7678,26,19647,16,416,210,206,7,35,4,3
8859,10,7061,9,196,94,102,2,30,1,1
22106,10,2287,9,326,134,192,2,30,1,1
14782,10,13099,9,177,94,83,2,30,1,1
12427,691,19889,490,70,70,0,1,4,1,0
10285,26,2044,16,12037,3531,8506,35,271,18,17
20394,40,12483,23,9624,4559,5065,88,196,45,43
15201,26,11162,16,7941,1952,5989,20,15,11,9
7689,10,26195,9,294,94,200,2,30,1,1
5877,26,3621,16,59486,3261,56225,74,360,29,45
12526,880,23564,649,70,70,0,1,30,1,0
9530,10,18311,9,782,110,672,2,30,1,1
21305,10,22140,9,263,134,129,2,30,1,1
7046,26,19478,16,5220,1973,3247,22,38,13,9
15614,10,4461,9,164,84,80,2,31,1,1
14399,10,24590,9,194,87,107,2,30,1,1
6333,26,4089,16,7284,1456,5828,21,360,10,11
22413,10,24046,9,183,94,89,2,30,1,1
1440,15,5008,11,7282,653,6629,16,16,8,8
9116,10,18727,9,196,94,102,2,30,1,1
22161,10,21027,9,212,110,102,2,31,1,1
10481,26,18571,16,7653,1188,6465,21,16,12,9
4707,26,7740,16,70,70,0,2,5,2,0
509,1826,25026,1391,166456,128,166328,270,35,3,267
22696,10,1232,9,166,85,81,2,31,1,1
6608,15,26118,11,23394,1667,21727,38,18,20,18
767,15,3103,11,7972,840,7132,16,50,6,10
10067,15,5067,11,40645,6133,34512,66,274,33,33
18597,15,26859,11,318,120,198,6,25,3,3
15176,10,7097,9,177,94,83,2,30,1,1
4511,26,7247,16,1835,1190,645,17,26,10,7
9728,2522,11480,1959,1320,300,1020,6,1200,3,3
15575,10,16895,9,211,94,117,2,30,1,1
14495,26,7774,16,25586,4360,21226,57,81,29,28
18900,26,2288,16,14819,8197,6622,47,45,26,21
15313,26,5670,16,7863,1874,5989,20,15,11,9
22680,26,21721,16,452013,13200,438813,465,16,163,302
15102,26,26724,16,759397,22470,736927,766,108,270,496
9625,15,1575,11,318,192,126,6,25,4,2
15432,10,11951,9,195,102,93,2,30,1,1
6080,26,25730,16,3196404,47816,3148588,2668,147,469,2199
13260,26,23947,16,157452,26878,130574,213,214,111,102
15518,10,5228,9,180,94,86,2,30,1,1
15852,26,1427,16,5614,733,4881,16,15,9,7
5379,26,24849,16,6944,1650,5294,24,40,14,10
9708,26,25390,16,1313,876,437,11,26,6,5
10974,10,22727,9,832,106,726,2,30,1,1
12814,2689,21028,2088,70,70,0,2,7,2,0
9411,1385,9985,1054,132,132,0,3,1200,3,0
14279,10,2498,9,760,97,663,2,30,1,1
5149,26,25133,16,9217,1548,7669,25,50,13,12
22125,10,9508,9,258,102,156,2,30,1,1
21306,10,13334,9,176,90,86,2,30,1,1
14648,26,19868,16,126,60,66,3,4,2,1
15340,10,410,9,188,96,92,2,31,1,1
18585,26,26852,16,1088,641,447,10,25,6,4
13726,10,26444,9,177,94,83,2,30,1,1
21564,10,4419,9,258,102,156,2,29,1,1
17434,10,26194,9,168,78,90,2,30,1,1
15126,10,21173,9,183,94,89,2,29,1,1
9411,2927,18192,2271,132,132,0,3,1200,3,0
16742,26,5967,16,10817,2611,8206,44,135,21,23
18760,1989,3832,1519,316,136,180,6,6,3,3
8396,10,20817,9,183,94,89,2,30,1,1
1731,3187,2942,2473,481,150,331,2,1200,1,1
6781,26,10535,16,5839,3664,2175,13,120,8,5
13741,10,23091,9,170,87,83,2,31,1,1
15930,26,27176,16,5620,927,4693,17,15,10,7
14868,26,3326,16,22352,9825,12527,111,370,55,56
13726,10,24591,9,177,94,83,2,30,1,1
21567,10,8069,9,199,102,97,2,30,1,1
12564,26,15035,16,7759,1476,6283,24,19,14,10
21438,10,23255,9,306,94,212,2,30,1,1
21952,10,27582,9,172,88,84,2,31,1,1
3354,26,19648,16,15474,4188,11286,14,139,4,10
14036,10,18835,9,180,94,86,2,30,1,1
20487,26,7084,16,304,86,218,2,30,1,1
11502,15,23862,11,3224,2776,448,11,15,7,4
9001,10,17201,9,212,108,104,2,30,1,1
18489,1185,14141,874,70,70,0,1,5,1,0
15394,10,185,9,209,110,99,2,30,1,1
8896,10,20394,9,211,110,101,2,30,1,1
5342,26,8048,16,8562,1634,6928,27,26,13,14
21937,10,19256,9,206,105,101,2,31,1,1
9109,10,27595,9,198,102,96,2,30,1,1
19368,26,18370,16,230640,12863,217777,253,62,98,155
8732,15,5211,11,1268,703,565,11,23,6,5
8733,10,15376,9,168,86,82,2,30,1,1
14360,10,12356,9,177,94,83,2,30,1,1
15054,10,5206,9,94,94,0,1,30,1,0
2744,1238,15211,918,886,126,760,2,30,1,1
14625,10,24864,9,168,86,82,2,29,1,1
8989,10,20041,9,178,94,84,2,30,1,1
15560,26,13685,16,3800,1324,2476,14,136,7,7
21952,10,10538,9,178,94,84,2,30,1,1
17107,26,12017,16,6033,770,5263,18,15,8,10
22461,15,11614,11,7440,4032,3408,48,629,25,23
17387,26,26207,16,4659,1752,2907,19,30,11,8
8568,10,27985,9,214,110,104,2,30,1,1
16265,26,1457,16,6783,3270,3513,22,120,11,11
15560,15,19927,11,214,140,74,4,35,3,1
8436,10,4648,9,254,102,152,2,30,1,1
14462,26,23101,16,8661,2036,6625,40,256,19,21
14430,10,27852,9,174,89,85,2,30,1,1
12512,947,15347,699,70,70,0,2,7,2,0
9310,26,9782,16,6666,1682,4984,28,1157,15,13
15458,10,8552,9,199,102,97,2,29,1,1
8210,280,21194,177,773,279,494,4,1200,2,2
9642,15,4857,11,312,192,120,6,25,4,2
14970,10,1791,9,279,93,186,4,32,2,2
15857,26,29085,16,8979,3093,5886,43,15,24,19
13866,15,3660,11,1146,606,540,8,45,5,3
14426,10,3932,9,816,102,714,2,30,1,1
4376,26,24640,16,142299,120615,21684,348,336,180,168
9064,213,310,138,78,78,0,1,5,1,0
8590,10,4411,9,198,102,96,2,33,1,1
21659,10,531,9,183,94,89,2,30,1,1
18539,1505,9836,1145,70,70,0,1,5,1,0
18961,26,25552,16,11529,8753,2776,41,120,22,19
14185,10,1556,9,194,102,92,2,31,1,1
2958,10,12152,9,365,233,132,3,32,2,1
18948,26,13630,16,103580,4856,98724,133,17,56,77
9050,10,22469,9,311,102,209,2,30,1,1
13757,10,25903,9,177,94,83,2,30,1,1
2744,1555,21192,1186,887,126,761,2,31,1,1
11775,26,9681,16,10234,2550,7684,47,139,23,24
14564,10,16943,9,164,86,78,2,30,1,1
18785,1989,9695,1519,316,136,180,6,7,3,3
10874,564,7058,378,70,70,0,2,8,2,0
11084,2583,23650,2004,66,66,0,1,5,1,0
532,247,0,0,3498,1872,1626,48,201,24,24
10198,15,5948,11,19699,2094,17605,32,229,14,18
21211,10,858,9,377,94,283,2,29,1,1
22095,10,27574,9,343,134,209,2,30,1,1
9357,10,1391,9,195,102,93,2,29,1,1
11333,26,14172,16,52235,4973,47262,81,179,39,42
6688,10,10487,9,164,78,86,2,30,1,1
15214,10,6813,9,168,86,82,2,36,1,1
19635,26,27448,16,280243,73972,206271,309,206,142,167
15550,10,2350,9,322,102,220,2,30,1,1
17054,10,0,0,258,80,178,2,30,1,1
9698,15,2656,11,378,192,186,7,26,4,3
2607,10,10981,9,414,268,146,3,33,2,1
3133,2335,8623,1819,66,66,0,1,3600,1,0
14970,10,12884,9,279,93,186,4,31,2,2
22028,10,15952,9,211,102,109,2,29,1,1
13105,10,23872,9,253,99,154,2,32,1,1
11029,1729,23382,1320,70,70,0,1,5,1,0
8486,26,18339,16,3191,2313,878,17,44,10,7
9845,26,181,16,45394,5743,39651,133,233,49,84
14316,10,22448,9,184,94,90,2,30,1,1
15830,10,6349,9,177,94,83,2,30,1,1
8779,15,28256,11,374,192,182,7,41,4,3
22428,10,14839,9,267,93,174,4,46,2,2
6593,15,19300,11,1560,684,876,10,15,5,5
13773,10,25168,9,198,102,96,2,30,1,1
18116,26,27981,16,5291,2624,2667,28,145,15,13
7764,26,27968,16,1989,1183,806,16,94,9,7
5409,26,5250,16,5596,3797,1799,27,96,14,13
22368,10,25830,9,200,102,98,2,31,1,1
6266,26,20375,16,4181,998,3183,14,26,7,7
18886,26,11683,16,4485,794,3691,17,25,9,8
14575,10,27248,9,86,86,0,1,29,1,0
8389,10,27285,9,418,150,268,2,30,1,1
11629,10,24895,9,199,94,105,2,30,1,1
6744,26,13320,16,18367,3429,14938,41,500,23,18
13658,15,8325,11,2394,630,1764,9,16,6,3
9431,26,25743,16,7210,2382,4828,33,100,19,14
20407,40,1310,23,8772,3614,5158,77,54,35,42
15251,15,12314,11,78,78,0,2,6,2,0
16974,10,25979,9,235,90,145,2,32,1,1
10754,1177,18592,868,66,66,0,1,5,1,0
14453,10,23896,9,170,87,83,2,31,1,1
4232,10,19208,9,326,78,248,2,31,1,1
3794,26,18612,16,6392,1025,5367,18,27,9,9
14551,10,11541,9,184,94,90,2,30,1,1
5501,10,20242,9,199,94,105,2,30,1,1
3133,2317,11544,1801,396,396,0,7,3616,7,0
17983,26,21598,16,6922,2214,4708,32,136,20,12
21577,10,15920,9,273,90,183,4,32,2,2
18642,15,13137,11,1364,860,504,13,17,8,5
17181,26,3964,16,1413,876,537,12,26,6,6
12755,44,27463,27,70,70,0,1,5,1,0
15861,10,21430,9,228,110,118,2,31,1,1
14203,1549,21987,1180,70,70,0,1,5,1,0
10115,15,5794,11,8074,2261,5813,22,19,13,9
15580,10,15612,9,183,94,89,2,31,1,1
12014,26,5673,16,7459,2962,4497,24,47,14,10
1731,3175,17954,2461,481,150,331,2,1200,1,1
8754,26,24408,16,5879,870,5009,18,53,9,9
14138,10,12989,9,199,102,97,2,31,1,1
15195,26,2836,16,8033,2013,6020,20,16,11,9
12933,26,12027,16,115373,6904,108469,171,117,87,84
22511,10,7527,9,184,94,90,2,30,1,1
15043,10,5265,9,170,87,83,2,31,1,1
13758,10,5400,9,184,94,90,2,30,1,1
11190,15,4158,11,502,310,192,9,31,6,3
14414,10,1605,9,811,94,717,2,30,1,1
13422,26,7609,16,5702,1143,4559,21,41,12,9
19564,26,14014,16,57467,4506,52961,86,30,42,44
3169,10,13423,9,213,90,123,2,29,1,1
9107,15,10933,11,10767,783,9984,19,15,9,10
5110,26,14413,16,90449,3289,87160,93,16,28,65
20208,183,27823,121,4410,2321,2089,22,18,12,10
13103,10,0,0,325,77,248,2,31,1,1
21535,10,461,9,436,89,347,4,42,2,2
9491,10,521,9,756,94,662,2,29,1,1
13078,26,2149,16,250,190,60,2,5,1,1
5833,26,13519,16,10675,5079,5596,88,588,47,41
225,10,13533,9,204,118,86,2,31,1,1
16376,26,2755,16,1912,1213,699,19,169,11,8
6460,10,25928,9,168,78,90,2,30,1,1
6498,26,15432,16,3259,1913,1346,18,16,8,10
16485,15,297,11,374,192,182,7,21,4,3
14895,10,27785,9,195,102,93,2,30,1,1
8679,10,28089,9,200,102,98,2,29,1,1
19800,26,14627,16,8666,2933,5733,46,15,27,19
15458,10,13159,9,177,94,83,2,30,1,1
19644,26,27457,16,36811,5190,31621,60,150,24,36
8815,26,8658,16,10099,1721,8378,27,46,14,13
9471,10,11364,9,720,94,626,2,31,1,1
10563,26,28069,16,10839,705,10134,14,46,4,10
2744,81,12628,63,865,126,739,2,29,1,1
21576,10,25083,9,195,102,93,2,31,1,1
8679,10,5430,9,200,102,98,2,31,1,1
20077,26,11000,16,16246,11056,5190,37,45,21,16
21804,26,17719,16,9151,2109,7042,27,30,15,12
8568,10,14911,9,214,110,104,2,30,1,1
3419,26,12447,16,9675,2389,7286,43,143,21,22
13970,10,19823,9,211,110,101,2,30,1,1
13734,10,799,9,711,87,624,2,31,1,1
10966,814,1172,594,70,70,0,1,5,1,0
8918,10,4304,9,193,102,91,2,29,1,1
2318,26,9553,16,6993,960,6033,17,31,10,7
14425,10,7672,9,261,89,172,4,32,2,2
21708,10,23587,9,264,110,154,2,30,1,1
12309,26,8630,16,7584,7094,490,14,123,7,7
8654,10,12408,9,194,102,92,2,30,1,1
18313,26,28161,16,4310,2523,1787,42,120,24,18
7850,1659,0,0,106,106,0,1,60,1,0
10777,295,22637,190,3132,815,2317,14,15,7,7
1027,26,25728,16,674,128,546,12,46,3,9
14860,10,26422,9,182,93,89,2,30,1,1
15248,26,21751,16,5726,1474,4252,22,81,13,9
8203,26,27952,16,7130,1890,5240,25,33,12,13
14545,10,15519,9,819,102,717,2,30,1,1
9625,26,21223,16,7653,1188,6465,21,15,12,9
12420,1078,18956,791,70,70,0,2,7,2,0
18361,15,13786,11,1463,865,598,11,144,6,5
10713,15,4687,11,59786,3488,56298,119,55,45,74
8598,10,1832,9,177,94,83,2,31,1,1
21454,10,19508,9,194,94,100,2,30,1,1
15342,26,16621,16,7941,1952,5989,20,15,11,9
22582,10,20836,9,720,94,626,2,30,1,1
21869,10,10673,9,718,94,624,2,30,1,1
11169,1904,25327,1455,70,70,0,2,7,2,0
13825,10,15620,9,188,96,92,2,31,1,1
15882,26,3664,16,5613,733,4880,16,14,9,7
22399,10,24865,9,172,94,78,2,29,1,1
15474,10,6873,9,264,94,170,2,31,1,1
4498,10,15915,9,237,98,139,2,30,1,1
4460,10,18812,9,241,78,163,2,30,1,1
5275,26,12564,16,5229,2388,2841,23,367,12,11
19303,26,7297,16,9492,3543,5949,49,117,25,24
8991,26,1611,16,1738,1159,579,16,74,10,6
15839,10,1331,9,199,102,97,2,29,1,1
9404,234,1945,149,6764,1575,5189,25,157,14,11
14549,10,17757,9,177,94,83,2,30,1,1
15577,10,5170,9,195,78,117,2,30,1,1
10977,15,13538,11,1582,866,716,11,27,7,4
12521,1534,8282,1168,70,70,0,1,5,1,0
9407,26,28509,16,10320,3495,6825,45,136,25,20
14258,10,25691,9,194,99,95,2,31,1,1
14122,10,8469,9,198,101,97,2,31,1,1
5514,10,20977,9,78,78,0,1,30,1,0
10040,26,3005,16,124,64,60,2,15,1,1
9506,10,13600,9,181,98,83,2,31,1,1
15795,10,12388,9,165,86,79,2,30,1,1
18031,15,16138,11,2615,830,1785,10,32,6,4
18322,15,100,11,31138,6772,24366,40,149,17,23
11487,10,22096,9,201,80,121,2,30,1,1
19337,26,19300,16,7832,1143,6689,19,26,9,10
9099,10,861,9,370,94,276,2,30,1,1
5078,26,14376,16,1468,893,575,15,62,8,7
10238,26,8128,16,2940,787,2153,11,119,5,6
6999,441,16264,283,502,150,352,2,1200,1,1
9115,15,20611,11,38898,1623,37275,49,15,21,28
5532,26,8065,16,4464,2847,1617,29,80,15,14
8494,26,14513,16,54335,2550,51785,74,42,29,45
20957,26,14863,16,15769,1619,14150,17,138,4,13
22404,10,16495,9,216,110,106,2,30,1,1
6912,26,26259,16,448741,15805,432936,491,109,181,310
18354,15,15076,11,1928,906,1022,11,145,6,5
11009,26,1800,16,11555,2620,8935,45,822,18,27
22254,10,24730,9,197,102,95,2,32,1,1
8324,10,25700,9,184,94,90,2,31,1,1
14168,10,21183,9,195,102,93,2,30,1,1
5757,26,25977,16,3321,1297,2024,13,28,7,6
8678,10,23291,9,190,97,93,2,31,1,1
8391,15,6287,11,2999,2271,728,11,15,6,5
11957,26,23258,16,6793,3206,3587,25,52,15,10
3572,26,26915,16,8623,1758,6865,36,28,17,19
15331,628,28630,435,70,70,0,1,5,1,0
15786,10,21950,9,344,94,250,2,30,1,1
15558,10,17546,9,165,86,79,2,29,1,1
6735,10,18979,9,227,90,137,2,30,1,1
21785,10,4039,9,469,97,372,4,49,2,2
22117,10,25589,9,199,102,97,2,29,1,1
21229,10,694,9,338,97,241,4,43,2,2
9028,10,25433,9,193,102,91,2,30,1,1
4301,26,16875,16,1149,709,440,13,38,8,5
22065,10,16323,9,211,102,109,2,30,1,1
6046,10,17613,9,376,78,298,2,30,1,1
10327,168,14341,115,870,330,540,12,1320,6,6
22098,10,22618,9,212,102,110,2,31,1,1
17067,26,8315,16,5167,700,4467,16,15,7,9
11184,219,28367,141,70,70,0,2,8,2,0
8182,26,2759,16,256887,11565,245322,293,56,112,181
21416,10,1593,9,193,102,91,2,29,1,1
4029,26,15194,16,4555,1648,2907,20,29,12,8
15980,10,29019,9,177,94,83,2,30,1,1
9384,26,19292,16,2994,1521,1473,15,83,9,6
11101,2939,18023,2279,70,70,0,2,8,2,0
22120,10,6890,9,211,102,109,2,30,1,1
14762,10,27469,9,756,95,661,2,30,1,1
849,26,9387,16,3645,609,3036,13,120,6,7
1991,10,7723,9,235,90,145,2,31,1,1
15167,10,5153,9,200,102,98,2,29,1,1
9361,115,12618,88,70,70,0,2,7,2,0
10988,2616,23004,2028,70,70,0,2,7,2,0
14028,10,14135,9,210,110,100,2,30,1,1
14409,10,19222,9,177,94,83,2,30,1,1
21976,10,26085,9,178,94,84,2,31,1,1
18542,3075,2834,2388,320,140,180,6,8,3,3
10846,1337,6487,1012,70,70,0,1,5,1,0
15897,10,22268,9,258,110,148,2,30,1,1
9004,26,25951,16,6998,1906,5092,22,24,12,10
9672,15,12385,11,66430,7013,59417,93,156,40,53
2744,1447,26959,1100,887,126,761,2,31,1,1
21294,10,944,9,209,110,99,2,30,1,1
1731,3097,28858,2405,16553,6930,9623,212,6269,106,106
15100,10,28948,9,177,94,83,2,31,1,1
3488,26,22994,16,170319,23354,146965,283,34,121,162
8584,1867,3304,1425,246,78,168,2,30,1,1
21539,10,7539,9,212,108,104,2,30,1,1
21252,10,9659,9,186,95,91,2,30,1,1
5995,10,17962,9,244,98,146,2,32,1,1
14732,10,9564,9,177,94,83,2,30,1,1
21945,10,24248,9,263,118,145,2,30,1,1
6988,26,15972,16,6975,2168,4807,20,15,11,9
9411,2627,5781,2037,460,150,310,2,1200,1,1
22127,26,6368,16,6120028,157580,5962448,6108,75,2083,4025
15797,10,0,0,230,87,143,2,30,1,1
22609,10,1942,9,197,94,103,2,30,1,1
1219,280,27144,177,469,150,319,2,1200,1,1
15224,10,15321,9,152,78,74,2,30,1,1
21537,10,18539,9,177,94,83,2,30,1,1
8903,26,22324,16,334252,14917,319335,405,73,179,226
17205,26,17820,16,13055,5677,7378,29,122,15,14
15034,10,20984,9,182,93,89,2,31,1,1
8829,10,25822,9,195,102,93,2,30,1,1
12517,476,24649,310,70,70,0,1,4,1,0
636,297,3738,192,118,118,0,1,1200,1,0
13673,10,6596,9,299,110,189,4,32,2,2
8807,26,23897,16,5776,1079,4697,15,53,8,7
21989,10,24087,9,195,102,93,2,30,1,1
8269,676,22415,475,130,70,60,2,6,1,1
16378,26,28829,16,7912,3215,4697,23,20,12,11
5417,26,19311,16,580560,15724,564836,583,30,187,396
14451,10,26222,9,164,84,80,2,31,1,1
12048,2992,12765,2326,698,320,378,10,18,6,4
15555,10,11756,9,177,94,83,2,31,1,1
15703,10,6592,9,170,87,83,2,30,1,1
21600,10,13739,9,193,102,91,2,30,1,1
21247,10,9578,9,195,102,93,2,33,1,1
11937,15,3480,11,2906,1233,1673,24,92,13,11
15212,10,18518,9,711,87,624,2,30,1,1
10722,40,3408,23,17462,4583,12879,93,19,47,46
14029,10,11761,9,195,102,93,2,31,1,1
10838,26,28608,16,3871,1166,2705,13,136,6,7
12752,188,24064,123,3532,1792,1740,58,88,29,29
8961,10,6574,9,209,110,99,2,30,1,1
21258,10,15381,9,214,110,104,2,30,1,1
7606,15,18021,11,2075,1376,699,13,83,7,6
4918,26,16423,16,11290,5394,5896,37,80,21,16
12530,2123,5209,1637,1821,1088,733,17,15,9,8
15536,10,28123,9,210,110,100,2,30,1,1
21231,26,7400,16,6718,3582,3136,18,126,10,8
4021,26,22631,16,15771,2037,13734,39,187,20,19
14995,10,17696,9,969,86,883,2,29,1,1
17778,26,19369,16,3197,1047,2150,15,120,8,7
10929,15,24377,11,1758,989,769,13,76,8,5
3831,15,20693,11,111678,5254,106424,150,240,71,79
3508,26,6078,16,8628,2898,5730,20,144,9,11
20937,26,28695,16,19821,11622,8199,77,135,39,38
15496,10,21404,9,711,87,624,2,30,1,1
8668,26,18865,16,31780,3232,28548,44,29,16,28
21620,26,24146,16,4741,1306,3435,26,300,14,12
12662,866,1277,640,70,70,0,2,8,2,0
4354,26,26109,16,2341,1054,1287,20,299,7,13
11192,681,10173,480,70,70,0,1,5,1,0
13610,10,15134,9,711,87,624,2,31,1,1
15684,26,11748,16,23906,9380,14526,40,16,24,16
22026,10,10912,9,182,102,80,2,30,1,1
989,15,3652,11,208056,7568,200488,227,39,88,139
8044,26,15322,16,7379,2268,5111,18,134,8,10
15972,10,750,9,193,102,91,2,30,1,1
8711,10,5771,9,195,102,93,2,30,1,1
20366,26,27930,16,4579,1672,2907,19,29,11,8
2705,26,5628,16,21487,16430,5057,39,21,22,17
4250,26,7730,16,638,350,288,10,26,6,4
14013,10,20044,9,711,87,624,2,31,1,1
8679,15,9405,11,476333,9582,466751,453,225,135,318
6792,26,5716,16,6114,862,5252,17,71,9,8
21993,10,1794,9,360,93,267,3,37,2,1
2744,1622,23778,1244,888,126,762,2,31,1,1
18576,15,23750,11,1641,944,697,9,15,5,4
5582,26,5463,16,8235,2076,6159,24,330,11,13
8822,26,16812,16,6006,763,5243,17,52,8,9
10860,1601,25298,1225,70,70,0,1,5,1,0
10839,2688,26091,2087,70,70,0,1,4,1,0
14501,10,29141,9,168,86,82,2,30,1,1
9100,10,22131,9,152,78,74,2,31,1,1
14529,10,25474,9,754,94,660,2,31,1,1
15521,10,9320,9,183,94,89,2,30,1,1
21240,10,20275,9,228,110,118,2,29,1,1
10841,26,18798,16,4007,2063,1944,12,122,6,6
8584,1240,19363,920,78,78,0,1,30,1,0
0,0,0,0,480,244,236,4,0,2,2
17166,26,23113,16,2353,1453,900,16,15,8,8
11707,15,9088,11,432,240,192,8,101,5,3
15378,26,27841,16,8020,2000,6020,20,15,11,9
2724,1240,26391,920,422,164,258,6,30,3,3
8983,10,9333,9,211,102,109,2,29,1,1
18288,15,19864,11,70,70,0,1,4,1,0
2744,1238,28783,918,901,126,775,2,30,1,1
15323,10,6531,9,184,94,90,2,30,1,1
18799,183,26978,121,3504,1790,1714,17,33,9,8
10565,26,3448,16,16287,13303,2984,49,38,26,23
14702,10,27368,9,816,102,714,2,30,1,1
7897,26,18675,16,4187,1350,2837,18,321,8,10
2744,1239,653,919,895,126,769,2,30,1,1
9228,10,11543,9,179,94,85,2,30,1,1
8413,10,17775,9,172,94,78,2,30,1,1
10690,10,22594,9,198,89,109,2,30,1,1
12445,1470,19466,1120,70,70,0,2,8,2,0
18404,26,1725,16,6844,2441,4403,19,181,9,10
19550,15,29078,11,6160,2912,3248,17,18,9,8
22177,1266,23900,946,747,462,285,2,31,1,1
10977,776,12481,562,70,70,0,2,8,2,0
10553,26,17535,16,4801,702,4099,13,16,8,5
11084,2583,16519,2004,70,70,0,2,9,2,0
8584,761,4163,549,71,71,0,1,30,1,0
15153,10,17099,9,182,94,88,2,30,1,1
5559,15,25609,11,1155,781,374,10,15,6,4
19004,26,6044,16,7863,1962,5901,29,270,16,13
7110,26,9467,16,10789,5723,5066,36,136,17,19
14315,10,7266,9,731,85,646,2,31,1,1
14305,756,2528,544,70,70,0,1,5,1,0
8740,10,655,9,496,92,404,4,58,2,2
16953,26,19071,16,4440,114,4326,7,122,2,5
9824,15,27441,11,23386,2375,21011,30,21,12,18
18786,26,1290,16,7639,2051,5588,33,120,17,16
13611,10,12991,9,197,102,95,2,33,1,1
8904,10,16925,9,228,86,142,2,29,1,1
14058,10,24918,9,200,102,98,2,30,1,1
15505,10,12953,9,172,94,78,2,30,1,1
14396,10,11920,9,373,103,270,4,43,2,2
15410,10,24762,9,177,94,83,2,29,1,1
9219,10,19835,9,718,94,624,2,30,1,1
16021,291,27304,187,37677,7875,29802,115,3342,58,57
10076,26,15624,16,9517,1898,7619,21,85,11,10
21675,10,10750,9,245,118,127,2,30,1,1
14993,10,7096,9,88,88,0,1,30,1,0
13897,10,12945,9,212,110,102,2,30,1,1
18811,15,26985,11,13869,3749,10120,28,26,15,13
10864,15,15485,11,366,240,126,7,32,5,2
14152,10,27299,9,194,102,92,2,30,1,1
15606,10,23284,9,216,110,106,2,30,1,1
13905,26,10007,16,4523,3044,1479,17,64,10,7
20589,26,453,16,5530,2343,3187,22,128,10,12
14847,10,6005,9,167,86,81,2,29,1,1
8667,26,11701,16,1882,1108,774,17,135,10,7
12723,1133,20714,835,258,70,188,4,7,2,2
8210,117,21194,89,158,158,0,1,1200,1,0
15375,26,14516,16,7518,2862,4656,18,75,10,8
13394,26,19481,16,10244,2295,7949,38,121,20,18
12676,26,27436,16,499,425,74,4,0,3,1
2744,1238,13965,918,1622,126,1496,4,30,2,2
10720,40,27452,23,11580,4032,7548,79,19,40,39
10987,10,22734,9,825,99,726,2,31,1,1
22430,10,730,9,200,102,98,2,30,1,1
3409,26,17631,16,4067,2672,1395,23,23,14,9
9078,10,3797,9,718,94,624,2,30,1,1
13911,10,8447,9,365,102,263,2,30,1,1
8727,10,6115,9,211,94,117,2,30,1,1
16021,1520,25629,1158,528,528,0,9,1199,9,0
10456,26,222,16,4721,2724,1997,35,130,19,16
12547,10,28057,9,86,86,0,1,30,1,0
13011,26,2111,16,4788,785,4003,15,70,8,7
12030,15,2923,11,2560,2083,477,13,15,7,6
11175,26,608,16,190,70,120,4,15,2,2
22690,10,27401,9,774,102,672,2,30,1,1
22159,10,4523,9,275,96,179,4,41,2,2
4134,26,1683,16,7500,2339,5161,18,136,8,10
14579,10,16833,9,810,108,702,2,31,1,1
21159,280,10473,177,70,70,0,1,5,1,0
4675,26,21880,16,499,425,74,4,0,3,1
12297,26,23440,16,960,539,421,9,30,5,4
18915,26,17811,16,3862,2679,1183,28,46,15,13
14101,10,3164,9,214,110,104,2,30,1,1
15048,10,11549,9,168,78,90,2,30,1,1
11173,26,10647,16,712,452,260,8,25,4,4
8943,10,579,9,485,79,406,4,31,2,2
15942,10,6843,9,177,94,83,2,30,1,1
102,2091,1766,1612,70,70,0,1,5,1,0
2744,1556,28793,1187,900,126,774,2,31,1,1
11987,26,20370,16,13599,5335,8264,35,171,18,17
3742,26,23639,16,2713,1386,1327,18,316,10,8
12349,26,14396,16,10893,6516,4377,36,131,16,20
8653,10,24458,9,183,94,89,2,30,1,1
15247,10,26674,9,199,102,97,2,30,1,1
9184,26,10849,16,9175,2213,6962,37,121,19,18
18244,26,4605,16,3041,1745,1296,28,3600,15,13
11293,735,21895,527,70,70,0,2,8,2,0
9249,10,26949,9,183,94,89,2,30,1,1
14060,10,13564,9,177,94,83,2,31,1,1
7058,15,19493,11,7061,2943,4118,16,23,9,7
4436,15,15362,11,10345,6823,3522,25,25,14,11
15967,10,9539,9,192,98,94,2,31,1,1
22690,26,14482,16,416348,12360,403988,429,16,151,278
15574,10,14746,9,210,110,100,2,30,1,1
14122,10,4685,9,195,102,93,2,30,1,1
17981,26,1256,16,1066,545,521,11,28,5,6
6463,10,18629,9,235,90,145,2,32,1,1
11966,15,237,11,2594,1200,1394,16,17,10,6
2704,26,5879,16,7283,2586,4697,22,19,11,11
21506,10,20810,9,199,102,97,2,30,1,1
18979,26,6406,16,30399,22692,7707,57,144,31,26
8329,10,14239,9,183,94,89,2,30,1,1
15367,2115,643,1631,70,70,0,2,8,2,0
15525,10,2680,9,186,95,91,2,30,1,1
15226,26,8841,16,8058,2038,6020,20,15,11,9
22074,10,16765,9,385,134,251,2,30,1,1
10452,26,5531,16,6703,3312,3391,31,145,14,17
8965,10,15205,9,485,93,392,4,48,2,2
15587,15,10668,11,214,140,74,4,30,3,1
8537,26,7264,16,350,210,140,6,16,4,2
22707,10,25204,9,198,94,104,2,30,1,1
8394,10,16994,9,174,89,85,2,30,1,1
10982,15,23972,11,1263,640,623,12,45,7,5
4835,2425,27032,1886,480,149,331,2,1200,1,1
10564,26,19025,16,2188,1329,859,23,19,13,10
14233,10,20580,9,772,103,669,2,31,1,1
15735,10,16848,9,168,78,90,2,30,1,1
18787,26,6625,16,4239,2026,2213,15,120,7,8
11114,1504,1970,1144,70,70,0,1,5,1,0
14402,10,5875,9,271,93,178,4,31,2,2
8845,26,27858,16,7938,1721,6217,25,172,12,13
11201,3162,21612,2450,70,70,0,2,8,2,0
15412,10,295,9,227,110,117,2,30,1,1
14210,10,20941,9,344,107,237,4,54,2,2
12797,15,4462,11,130,70,60,2,15,1,1
10044,26,5404,16,5159,1080,4079,20,255,10,10
8928,10,29032,9,184,94,90,2,30,1,1
13729,10,19327,9,760,97,663,2,30,1,1
10898,1480,21590,1126,70,70,0,2,8,2,0
21403,10,13668,9,186,95,91,2,30,1,1
9802,26,28767,16,4876,2522,2354,22,83,13,9
15116,26,15879,16,8335,2802,5533,26,567,14,12
1633,26,5908,16,15556,2973,12583,41,80,22,19
6173,10,19461,9,164,78,86,2,30,1,1
16807,10,20311,9,246,102,144,2,29,1,1
22246,10,6594,9,210,110,100,2,29,1,1
14325,10,5788,9,193,102,91,2,31,1,1
8964,10,26496,9,365,97,268,4,40,2,2
12803,1117,18080,822,1473,842,631,12,15,7,5
10706,15,7213,11,533166,22786,510380,905,50,321,584
4095,10,3726,9,198,93,105,2,30,1,1
5068,26,8634,16,9277,3025,6252,32,109,17,15
15876,10,25328,9,198,90,108,2,29,1,1
884,15,14492,11,318,192,126,6,30,4,2
21246,2137,8719,1650,66,66,0,2,7,2,0
15299,10,11746,9,182,94,88,2,30,1,1
9169,10,273,9,199,102,97,2,30,1,1
9094,10,2526,9,361,94,267,2,30,1,1
13722,10,26373,9,196,102,94,2,29,1,1
6461,183,18622,121,3910,1805,2105,20,19,12,8
2111,10,8374,9,404,259,145,3,33,2,1
22446,10,13863,9,779,86,693,2,30,1,1
4378,26,17286,16,11882,3450,8432,39,120,19,20
17921,10,6370,9,263,94,169,2,30,1,1
21769,10,1896,9,170,87,83,2,31,1,1
10033,15,25055,11,11091,2772,8319,22,154,12,10
11308,26,22883,16,1615,941,674,15,20,7,8
22524,10,28081,9,816,102,714,2,30,1,1
9200,10,28938,9,286,87,199,4,59,2,2
22536,10,18039,9,184,94,90,2,29,1,1
8210,2627,21194,2037,479,152,327,2,1200,1,1
22437,10,9381,9,168,86,82,2,29,1,1
10984,556,27544,372,70,70,0,2,7,2,0
3645,26,9417,16,11294,2234,9060,23,139,12,11
14321,10,26882,9,748,95,653,2,31,1,1
12138,26,23346,16,1404,697,707,17,121,8,9
16951,255,25970,160,62,62,0,1,5,1,0
9965,26,4773,16,6601,1120,5481,17,115,9,8
8552,10,26499,9,241,102,139,2,29,1,1
21562,10,9672,9,216,110,106,2,30,1,1
12879,26,23735,16,1468,763,705,16,181,8,8
8342,10,19610,9,193,102,91,2,31,1,1
12593,26,5782,16,6973,2166,4807,20,15,11,9
1834,10,6897,9,197,90,107,2,30,1,1
17784,26,23740,16,8362065,55143,8306922,6375,152,332,6043
6624,26,20193,16,670,382,288,10,133,6,4
5800,373,17667,241,156,156,0,3,8,3,0
15692,10,17717,9,793,101,692,2,31,1,1
3821,10,27976,9,168,78,90,2,30,1,1
13680,10,6136,9,177,94,83,2,30,1,1
6250,1991,13811,1521,148,86,62,2,29,1,1
9621,26,15015,16,2604,1413,1191,15,83,9,6
18126,26,8393,16,8216,2269,5947,42,106,25,17
10112,15,7327,11,7765,2215,5550,20,20,12,8
9973,26,4875,16,3292,2022,1270,16,16,9,7
3892,15,15978,11,350,210,140,6,28,4,2
22206,10,5985,9,210,110,100,2,30,1,1
10222,585,14307,397,948,473,475,13,15,7,6
10327,1583,9943,1213,870,330,540,12,1316,6,6
4199,26,19371,16,5689,1505,4184,24,19,13,11
10954,15,25876,11,32222,3146,29076,43,31,18,25
6844,26,2550,16,14455,6007,8448,45,120,26,19
21949,26,27098,16,7978900,79979,7898921,6464,210,644,5820
16985,18,22008,13,184,94,90,2,30,1,1
8733,15,4004,11,2855,1388,1467,12,44,7,5
22610,26,4628,16,2494,1643,851,17,24,9,8
532,247,0,0,3354,1792,1562,46,194,23,23
14043,10,6239,9,768,99,669,2,30,1,1
12453,10,9050,9,385,94,291,2,30,1,1
12148,26,23708,16,6250,1774,4476,27,17,14,13
12651,405,25526,263,1322,799,523,13,16,8,5
15560,10,26259,9,196,102,94,2,30,1,1
4522,26,8491,16,17201,10578,6623,57,145,27,30
14267,10,26173,9,196,102,94,2,30,1,1
12009,2966,6352,2302,70,70,0,2,8,2,0
13398,26,16216,16,84066,79714,4352,98,125,66,32
11482,26,9585,16,5782,1008,4774,17,15,8,9
21355,523,9163,346,66,66,0,2,8,2,0
15823,26,5290,16,16452,7129,9323,44,47,25,19
532,247,0,0,3354,1792,1562,46,192,23,23
17293,10,26144,9,825,99,726,2,30,1,1
9084,26,11416,16,9759,1989,7770,25,16,13,12
22222,10,18599,9,168,86,82,2,30,1,1
16373,26,17357,16,6115,1035,5080,21,170,11,10
4576,26,7876,16,995086,50081,945005,1281,216,515,766
12514,1546,1662,1178,70,70,0,2,7,2,0
14515,10,28506,9,177,94,83,2,29,1,1
15639,26,14259,16,15125,2482,12643,53,38,27,26
5832,15,15823,11,103213,8726,94487,178,38,109,69
10791,886,24048,655,70,70,0,2,8,2,0
18174,26,9560,16,1000,557,443,11,141,6,5
22438,10,26030,9,199,102,97,2,29,1,1
13822,10,9928,9,181,94,87,2,30,1,1
8922,10,9444,9,243,118,125,2,30,1,1
14379,10,15001,9,170,87,83,2,31,1,1
5606,1980,27254,1510,244,181,63,2,31,1,1
12939,26,23771,16,105609,16179,89430,150,84,79,71
2744,1239,10504,919,883,126,757,2,30,1,1
18407,15,1441,11,2005,1094,911,11,87,6,5
21676,10,15849,9,177,94,83,2,30,1,1
13636,10,10956,9,282,96,186,4,48,2,2
21973,10,23946,9,183,94,89,2,30,1,1
16951,255,25970,160,130,66,64,2,4,1,1
21720,10,14019,9,732,239,493,6,51,3,3
12150,26,19314,16,5025,973,4052,19,53,10,9
14306,10,24349,9,270,88,182,4,54,2,2
10327,2627,28021,2037,459,149,310,2,1200,1,1
14305,756,27488,544,70,70,0,2,8,2,0
15907,10,23262,9,257,94,163,2,30,1,1
12938,26,23770,16,79652,20710,58942,112,84,58,54
17512,26,14127,16,10243,3289,6954,41,26,21,20
6453,15,27954,11,944,529,415,11,315,6,5
9431,10,11278,9,760,97,663,2,31,1,1
15865,26,13925,16,8837,3033,5804,44,16,24,20
22711,26,20274,16,399281,11940,387341,412,16,145,267
9555,10,12220,9,86,86,0,1,30,1,0
9630,26,2841,16,1043,556,487,10,16,6,4
14245,10,26594,9,194,102,92,2,30,1,1
11275,26,22858,16,1615,941,674,15,21,7,8
13853,15,19589,11,1979,1326,653,16,500,10,6
2588,10,1541,9,243667,236247,7420,2897,90,2851,46
15056,15,22554,11,73400,4542,68858,87,136,37,50
9,18,1386,13,184,94,90,2,31,1,1
4431,26,18209,16,8975,1129,7846,19,31,10,9
15196,10,18319,9,170,87,83,2,30,1,1
11100,15,24960,11,3572,2746,826,14,15,8,6
14483,10,19660,9,178,94,84,2,30,1,1
11673,26,5081,16,1217451,39642,1177809,1359,39,539,820
12518,1540,8987,1173,70,70,0,1,5,1,0
9759,26,15752,16,1577,949,628,16,71,9,7
12388,2655,20755,2062,70,70,0,1,4,1,0
17431,10,12326,9,260,86,174,2,30,1,1
16040,10,25402,9,218,90,128,2,30,1,1
1909,875,16185,644,150,150,0,1,1200,1,0
18879,26,18115,16,7251,2098,5153,27,25,15,12
5783,15,28201,11,1614,1300,314,10,15,5,5
636,1171,4643,864,509,150,359,2,1200,1,1
11841,26,22151,16,3032,1082,1950,9,120,5,4
8898,15,15509,11,5236,1070,4166,13,145,6,7
8698,10,17516,9,195,102,93,2,30,1,1
10050,15,21036,11,9643,812,8831,18,128,8,10
9060,26,17117,16,151170,17408,133762,256,130,118,138
15514,10,1598,9,192,98,94,2,31,1,1
9411,2283,28600,1768,132,132,0,3,1200,3,0
12558,57,1355,40,320,140,180,6,8,3,3
8368,10,10280,9,243,86,157,2,30,1,1
14502,10,19369,9,193,102,91,2,31,1,1
15046,10,24757,9,209,110,99,2,30,1,1
7797,26,5212,16,2944,778,2166,10,120,5,5
3468,15,4351,11,130,70,60,2,15,1,1
4693,26,19422,16,499,425,74,4,0,3,1
15934,26,9505,16,11247,3991,7256,30,149,14,16
10735,414,5018,269,66,66,0,1,5,1,0
14233,10,10326,9,195,102,93,2,29,1,1
13880,26,2218,16,9176,2226,6950,28,31,16,12
6501,15,13454,11,7607,3563,4044,18,20,9,9
15234,10,14856,9,199,94,105,2,30,1,1
357,295,1071,190,3127,676,2451,15,19,7,8
21325,10,18095,9,209,102,107,2,30,1,1
8516,10,15897,9,183,94,89,2,31,1,1
14707,10,11700,9,227,110,117,2,30,1,1
18176,26,18991,16,5470,3223,2247,43,172,22,21
16379,26,19799,16,1851,1152,699,18,169,10,8
13646,10,27586,9,195,102,93,2,30,1,1
422,10,1329,9,230,90,140,2,30,1,1
10478,26,27050,16,25865,7151,18714,36,15,19,17
15195,10,3406,9,214,102,112,2,30,1,1
21582,10,22735,9,210,110,100,2,30,1,1
8869,10,21017,9,198,86,112,2,30,1,1
21911,10,8214,9,184,94,90,2,31,1,1
3854,15,14828,11,7794,1470,6324,18,151,9,9
16120,26,25452,16,13517,1521,11996,32,87,11,21
15900,10,10825,9,181,94,87,2,30,1,1
15897,10,2878,9,216,110,106,2,30,1,1
17990,10,12698,9,244,86,158,2,29,1,1
8463,26,21739,16,20862040,250452,20611588,16880,170,1832,15048
8776,10,22679,9,212,102,110,2,30,1,1
11156,15,2115,11,3592,2098,1494,26,417,14,12
12369,2276,2438,1762,70,70,0,2,8,2,0
5986,26,11279,16,433834,12764,421070,452,32,156,296
6373,26,23099,16,12561,2901,9660,29,17,15,14
8620,26,11766,16,7212,1757,5455,20,17,10,10
2744,1243,7911,923,890,126,764,2,30,1,1
10335,26,2023,16,9925,2939,6986,30,46,17,13
9779,10,3654,9,199,94,105,2,30,1,1
8933,10,19761,9,341,102,239,4,37,2,2
8589,26,28422,16,4287346,130607,4156739,4409,282,1473,2936
13455,26,27,16,6954,1758,5196,29,361,15,14
8584,1238,14397,918,246,78,168,2,31,1,1
14598,10,3574,9,199,102,97,2,30,1,1
10910,852,29,627,70,70,0,2,8,2,0
21414,10,9433,9,306,94,212,4,33,2,2
12657,3022,17388,2350,164,70,94,2,5,1,1
9323,10,16468,9,260,86,174,2,29,1,1
21651,10,14219,9,193,102,91,2,30,1,1
5383,15,17002,11,1058,497,561,10,16,6,4
8483,10,23098,9,338,102,236,2,30,1,1
9686,15,26762,11,1607,970,637,8,16,5,3
15324,15,10059,11,194,128,66,4,25,3,1
14054,10,1663,9,199,102,97,2,30,1,1
10200,10,21591,9,168,78,90,2,30,1,1
4287,26,5650,16,6147,910,5237,18,16,10,8
10687,26,5481,16,6660,1542,5118,21,305,11,10
4048,26,21620,16,162,102,60,2,4,1,1
20607,2859,7638,2218,316,190,126,5,15,3,2
13900,10,23148,9,287,102,185,2,30,1,1
2744,1238,3373,918,877,126,751,2,30,1,1
7696,26,12683,16,2809,1884,925,19,25,11,8
9761,15,19570,11,1658,1247,411,8,14,5,3
18491,2825,25775,2192,320,140,180,6,7,3,3
13669,26,12730,16,8133,2402,5731,35,255,17,18
8584,1248,28961,928,240,78,162,2,30,1,1
9217,1241,20206,921,468,390,78,5,30,4,1
17190,676,5388,475,138,78,60,2,5,1,1
14944,26,1659,16,4864,3011,1853,20,234,12,8
15241,26,10555,16,8006,1986,6020,20,15,11,9
7706,26,19454,16,328838,76878,251960,449,243,185,264
16146,15,25477,11,470276,8994,461282,388,25,75,313
9065,10,18644,9,752,93,659,2,31,1,1
14080,10,13575,9,751,95,656,2,31,1,1
10586,26,23154,16,94949,5974,88975,118,148,45,73
3066,2861,19745,2220,502,150,352,2,1200,1,1
20619,26,28080,16,4642,1735,2907,19,30,11,8
6212,10,18262,9,334,226,108,3,30,2,1
15574,15,20506,11,214,140,74,4,35,3,1
16512,15,5176,11,254,128,126,5,15,3,2
15938,26,10715,16,4645,700,3945,12,15,8,4
22662,10,17692,9,309,94,215,2,30,1,1
19809,15,5898,11,1862,616,1246,11,15,6,5
12366,405,4181,263,312,186,126,5,15,3,2
8962,10,14532,9,238,102,136,2,30,1,1
1337,2019,9865,1549,213,89,124,4,31,2,2
9089,10,7774,9,953,215,738,6,46,3,3
14684,10,14642,9,167,86,81,2,30,1,1
1907,10,7313,9,217,90,127,2,30,1,1
8940,15,18591,11,254,128,126,5,15,3,2
9656,15,1557,11,318,192,126,6,25,4,2
13811,10,12742,9,199,102,97,2,30,1,1
14915,10,26432,9,209,110,99,2,31,1,1
1724,10,6341,9,237,91,146,2,32,1,1
21686,10,9656,9,878,184,694,6,71,3,3
14130,10,7013,9,210,110,100,2,30,1,1
22505,10,24483,9,182,94,88,2,30,1,1
4484,26,25657,16,280,140,140,5,130,3,2
19575,26,189,16,251,69,182,3,120,1,2
4835,1004,16928,738,481,150,331,2,1199,1,1
8788,10,2226,9,209,102,107,2,30,1,1
4562,26,14508,16,9563,2336,7227,25,15,14,11
14518,10,7479,9,184,94,90,2,30,1,1
10802,3039,3939,2363,66,66,0,1,5,1,0
9803,10,19532,9,168,78,90,2,30,1,1
8923,10,3591,9,177,94,83,2,30,1,1
14930,10,18256,9,216,110,106,2,29,1,1
21991,10,12975,9,394,102,292,2,29,1,1
7524,26,139,16,5916,1144,4772,20,17,11,9
21352,935,22614,689,70,70,0,1,4,1,0
6818,10,19126,9,216,90,126,2,29,1,1
16437,26,1150,16,7970957,82522,7888435,6370,179,1027,5343
8774,10,28027,9,198,110,88,2,31,1,1
9207,10,5497,9,168,86,82,2,30,1,1
18158,26,4917,16,6395,2524,3871,18,141,10,8
9212,10,5126,9,253,87,166,4,51,2,2
14855,10,26482,9,453,186,267,6,30,3,3
12508,2590,10161,2009,70,70,0,2,7,2,0
4707,26,16183,16,1452,817,635,16,20,9,7
14024,10,19073,9,172,94,78,2,29,1,1
6774,26,6480,16,1392,731,661,14,80,8,6
10672,26,8997,16,3110,1049,2061,14,136,7,7
11991,26,4890,16,1287,800,487,13,16,9,4
21847,10,20250,9,196,100,96,2,31,1,1
13628,26,25073,16,8670,2248,6422,36,90,21,15
20626,26,28085,16,5407,2160,3247,22,38,13,9
11214,2932,7668,2275,70,70,0,2,8,2,0
15306,26,3467,16,7828,2313,5515,31,64,17,14
12440,2910,25953,2259,70,70,0,2,7,2,0
6197,26,22885,16,12322,3893,8429,28,139,13,15
9109,10,20983,9,281,97,184,4,58,2,2
5710,26,17519,16,4433,1526,2907,19,27,11,8
18303,15,13008,11,6854,6211,643,16,151,9,7
10902,2452,11787,1905,70,70,0,1,5,1,0
8418,10,5310,9,94,94,0,1,30,1,0
8363,10,7979,9,91,91,0,1,30,1,0
20222,26,27833,16,27723,5572,22151,59,47,31,28
17035,26,28106,16,1413,876,537,12,26,6,6
2724,1240,11597,920,422,164,258,6,30,3,3
9622,26,26500,16,25979,7217,18762,36,15,19,17
18269,26,3320,16,10178,1101,9077,22,125,10,12
14179,10,8539,9,209,110,99,2,30,1,1
8295,26,3674,16,7032,2643,4389,23,16,12,11
11097,15,14481,11,362,240,122,7,25,5,2
9231,10,10916,9,164,86,78,2,30,1,1
22516,10,14203,9,356,118,238,2,30,1,1
8563,15,6484,11,4382,2084,2298,18,66,10,8
8769,10,529,9,238,110,128,2,30,1,1
13775,10,4356,9,193,102,91,2,31,1,1
14544,10,9899,9,182,102,80,2,30,1,1
18543,2022,8425,1552,70,70,0,1,5,1,0
12091,26,25165,16,23323,1589,21734,27,85,10,17
8475,10,1954,9,195,94,101,2,29,1,1
15763,26,21315,16,1798,1223,575,13,28,8,5
9204,15,21782,11,2986,1514,1472,10,15,6,4
21790,10,9840,9,802,104,698,2,30,1,1
2815,10,11568,9,237,91,146,2,32,1,1
8306,26,7761,16,6318,877,5441,23,396,8,15
19541,15,1424,11,1555,954,601,14,47,8,6
22379,10,16897,9,193,102,91,2,30,1,1
15370,1774,12450,1353,70,70,0,1,5,1,0
22413,10,19258,9,183,94,89,2,30,1,1
11004,2804,19206,2175,70,70,0,1,4,1,0
14159,15,4941,11,3868,2218,1650,19,39,11,8
10774,114,25170,87,66,66,0,1,5,1,0
9107,15,21742,11,254742,14106,240636,305,22,131,174
21769,10,9642,9,712,214,498,6,44,3,3
14356,10,10248,9,195,102,93,2,31,1,1
8908,10,19213,9,199,94,105,2,30,1,1
15295,10,25550,9,916,86,830,2,31,1,1
7850,1660,0,0,106,106,0,1,61,1,0
6180,26,18225,16,3509,1693,1816,21,96,10,11
9410,26,12603,16,430,60,370,7,24,2,5
14926,26,28893,16,8111,1413,6698,21,28,12,9
20502,10,6988,9,384,166,218,2,30,1,1
8464,10,806,9,183,94,89,2,30,1,1
2744,1238,25482,918,902,126,776,2,30,1,1
12681,405,17046,263,70,70,0,1,4,1,0
10102,15,21479,11,1095221,7065,1088156,829,36,105,724
10107,15,21713,11,81390,4223,77167,103,21,49,54
18737,26,14381,16,6898,2843,4055,21,17,11,10
15144,10,6473,9,711,87,624,2,30,1,1
8584,1447,10605,1100,244,78,166,2,31,1,1
8500,10,27261,9,392,102,290,2,30,1,1
18802,1989,25934,1519,316,136,180,6,7,3,3
14739,10,18542,9,458,188,270,6,31,3,3
21986,10,23380,9,214,110,104,2,30,1,1
5034,10,5806,9,168,78,90,2,30,1,1
10200,26,14818,16,8192,2781,5411,22,374,12,10
13693,26,19937,16,7993,677,7316,16,16,8,8
9681,26,8867,16,6250,1595,4655,23,150,12,11
10304,26,28713,16,346,140,206,6,130,3,3
6817,26,1909,16,5157,917,4240,20,360,10,10
21198,26,9538,16,9043,5948,3095,31,121,15,16
18247,15,299,11,186,64,122,4,28,2,2
9312,10,6836,9,94,94,0,1,29,1,0
636,280,19123,177,502,150,352,2,1199,1,1
18582,10,26849,9,198,90,108,2,30,1,1
21860,26,15031,16,8391,5178,3213,41,256,20,21
7919,26,8194,16,6258,956,5302,20,16,11,9
9544,10,12009,9,177,94,83,2,30,1,1
13137,26,4363,16,18848,10436,8412,42,33,20,22
10586,26,1337,16,6359,1559,4800,24,19,13,11
11000,26,28247,16,17072,6138,10934,33,85,18,15
5398,26,2568,16,16012,10450,5562,33,80,18,15
12005,26,28446,16,9616,6956,2660,39,47,21,18
13216,26,29101,16,1786,172,1614,7,120,3,4
9159,10,25352,9,197,102,95,2,30,1,1
7822,15,26813,11,1114,534,580,12,16,7,5
2661,10,27991,9,306,99,207,2,0,1,1
636,280,692,177,237,118,119,2,1200,1,1
21137,26,3611,16,3811,1538,2273,20,135,10,10
10756,183,22626,121,3444,1730,1714,16,33,8,8
22153,10,22368,9,216,94,122,2,30,1,1
9186,10,2043,9,179,94,85,2,31,1,1
6700,26,10286,16,82838,3838,79000,104,31,42,62
10018,15,9367,11,312952,13869,299083,347,141,138,209
8916,233,22150,148,46785,27735,19050,232,5491,123,109
6629,10,25121,9,168,78,90,2,30,1,1
9100,15,3714,11,1130,613,517,11,15,6,5
21988,10,28706,9,177,94,83,2,30,1,1
21454,10,21685,9,216,94,122,2,29,1,1
15270,26,21601,16,3874,2523,1351,18,17,10,8
18317,15,8899,11,1114,534,580,12,16,7,5
14994,10,7573,9,179,94,85,2,29,1,1
12791,1232,3040,912,70,70,0,1,4,1,0
11110,26,12509,16,3052,2014,1038,16,15,9,7
8189,26,980,16,4801,2138,2663,23,15,12,11
18534,26,2113,16,3779,2809,970,23,47,12,11
15176,15,9300,11,234,234,0,4,12,4,0
11165,2369,4649,1843,70,70,0,1,5,1,0
16963,10,24512,9,168,78,90,2,30,1,1
13718,10,17593,9,774,101,673,2,31,1,1
9041,15,15784,11,28450,4547,23903,34,88,13,21
12636,10,28700,9,213,78,135,2,30,1,1
21591,10,24310,9,292,102,190,2,29,1,1
4557,26,25958,16,10809,2465,8344,45,121,21,24
15385,10,4721,9,177,94,83,2,30,1,1
21576,10,27625,9,195,102,93,2,30,1,1
5366,26,26820,16,121145,3578,117567,128,77,39,89
20001,26,1693,16,8217,2075,6142,31,76,15,16
5106,26,12472,16,484912,17317,467595,550,16,229,321
8396,10,17691,9,183,94,89,2,29,1,1
15898,26,10617,16,7551,2807,4744,42,26,22,20
21323,10,24466,9,604,89,515,4,45,2,2
21195,1603,27755,1227,66,66,0,2,8,2,0
8344,10,14418,9,184,94,90,2,31,1,1
11022,26,22120,16,1083,596,487,11,16,7,4
21462,10,17074,9,321,102,219,2,30,1,1
4687,26,585,16,573,425,148,5,0,3,2
19299,26,28540,16,4526,2655,1871,24,98,14,10
22372,15,25015,11,1516,481,1035,11,15,6,5
15839,10,9666,9,199,102,97,2,29,1,1
6913,26,25296,16,4709,2451,2258,18,304,8,10
15622,10,24747,9,185,102,83,2,30,1,1
15711,10,19660,9,222,86,136,2,30,1,1
14818,10,216,9,173,94,79,2,30,1,1
15133,10,20709,9,214,110,104,2,30,1,1
10655,676,9030,475,130,70,60,2,6,1,1
1164,2004,17407,1534,284,190,94,2,29,1,1
22305,10,25891,9,199,102,97,2,30,1,1
20660,10,28108,9,261,103,158,2,30,1,1
18065,10,5646,9,316,94,222,2,30,1,1
14737,183,24772,121,4365,2581,1784,20,32,11,9
2207,2091,26352,1612,70,70,0,2,8,2,0
2744,1239,17782,919,1622,126,1496,4,31,2,2
14387,10,3938,9,182,94,88,2,30,1,1
8032,10,20934,9,253,99,154,2,30,1,1
18484,281,28527,178,70,70,0,2,8,2,0
14637,26,27100,16,10622,4094,6528,29,514,16,13
17888,26,28317,16,7672,1164,6508,24,30,12,12
15648,26,28376,16,4730,2569,2161,16,135,8,8
15389,10,3786,9,193,102,91,2,30,1,1
15781,26,11667,16,24283,14945,9338,46,318,26,20
2724,1240,4861,920,422,164,258,6,30,3,3
9582,10,18614,9,199,102,97,2,29,1,1
14267,10,4407,9,819,102,717,2,30,1,1
9258,10,19194,9,216,110,106,2,30,1,1
8584,1239,20808,919,245,78,167,2,30,1,1
14439,10,13122,9,392,102,290,2,30,1,1
15144,10,14757,9,102,102,0,1,30,1,0
15749,377,25263,243,138,78,60,2,6,1,1
9253,10,26432,9,250,86,164,4,30,2,2
15282,10,26139,9,199,94,105,2,30,1,1
9641,10,10631,9,747,93,654,2,30,1,1
22437,10,5403,9,86,86,0,1,30,1,0
6632,10,26011,9,199,94,105,2,30,1,1
11423,26,5857,16,64135,3588,60547,88,40,38,50
15272,10,3051,9,711,87,624,2,31,1,1
10919,2230,28272,1729,70,70,0,2,8,2,0
8789,26,7204,16,3972,2532,1440,18,80,10,8
13982,10,18395,9,212,110,102,2,29,1,1
16387,26,18143,16,1853,1214,639,18,142,11,7
6250,1986,13351,1516,148,86,62,2,30,1,1
12306,26,23723,16,240325,8131,232194,262,31,100,162
12675,26,13991,16,499,425,74,4,0,3,1
4242,26,27579,16,7848,2137,5711,23,25,13,10
14990,10,17227,9,184,94,90,2,30,1,1
13714,15,19669,11,1289,724,565,11,26,6,5
14492,673,17906,473,480,149,331,2,1200,1,1
9510,15,23701,11,318,192,126,6,28,4,2
8210,856,21194,631,152,152,0,1,1200,1,0
16951,255,25970,160,62,62,0,1,5,1,0
6560,26,8552,16,11123,2634,8489,22,121,10,12
15319,10,23238,9,274,110,164,2,30,1,1
14508,10,22123,9,184,94,90,2,31,1,1
18035,15,9250,11,1638,1324,314,10,15,5,5
8903,10,1207,9,338,110,228,2,30,1,1
3631,10,14584,9,213,87,126,2,30,1,1
18401,26,4404,16,1862,1223,639,18,89,11,7
15334,10,1501,9,177,94,83,2,30,1,1
8739,26,18477,16,111881,6152,105729,137,139,51,86
17052,26,23161,16,5167,700,4467,16,15,7,9
15980,10,14570,9,177,94,83,2,30,1,1
22085,10,28674,9,166,86,80,2,31,1,1
18703,26,11649,16,1871,1235,636,13,31,8,5
18433,26,27886,16,6045,1834,4211,21,82,10,11
17076,26,20722,16,3991,2587,1404,17,16,9,8
10842,686,17756,485,70,70,0,1,4,1,0
8543,10,7939,9,209,110,99,2,30,1,1
12026,15,18522,11,23974,12718,11256,37,36,19,18
17204,26,8533,16,4732,3142,1590,20,18,9,11
200,295,471,190,3566,1999,1567,16,15,8,8
8251,10,590,9,168,78,90,2,30,1,1
1731,889,17895,657,481,150,331,2,1200,1,1
13007,26,9064,16,499,425,74,4,0,3,1
9510,26,8262,16,1755,986,769,13,25,8,5
22438,10,11833,9,757,102,655,2,29,1,1
8596,10,7562,9,279,94,185,2,30,1,1
3925,26,19153,16,6201,1790,4411,24,330,13,11
8654,10,21515,9,823,98,725,2,30,1,1
11441,26,22964,16,4750,1843,2907,19,26,11,8
15348,1358,2142,1030,70,70,0,2,8,2,0
10750,2624,21562,2034,70,70,0,2,8,2,0
15884,26,16732,16,5613,733,4880,16,15,9,7
21070,1123,20027,827,312,132,180,6,6,3,3
21533,10,25294,9,104,104,0,2,35,2,0
11030,15,15715,11,416,210,206,7,26,4,3
20265,26,1656,16,6805,3445,3360,31,121,15,16
9150,26,28651,16,11626,1206,10420,31,74,13,18
14469,26,11533,16,5944,1501,4443,27,163,13,14
15054,10,28298,9,239,94,145,2,30,1,1
14999,26,22724,16,5220,922,4298,17,135,10,7
9078,26,19170,16,5895,728,5167,16,27,8,8
6250,1980,10154,1510,140,78,62,2,31,1,1
4572,10,28560,9,168,78,90,2,31,1,1
8584,1242,16683,922,251,71,180,2,30,1,1
15982,11,28382,10,70,70,0,1,5,1,0
22036,10,15318,9,173,94,79,2,30,1,1
21949,10,12460,9,165,86,79,2,31,1,1
3335,26,19218,16,10328,5341,4987,26,35,13,13
19794,26,19424,16,11674,2699,8975,27,48,14,13
10327,2108,2861,1624,3917,1584,2333,50,3325,25,25
8930,10,15741,9,199,102,97,2,31,1,1
15479,10,24311,9,167,86,81,2,31,1,1
15576,26,16596,16,8592,3700,4892,39,108,21,18
4473,26,9495,16,70,70,0,1,5,1,0
10546,26,18841,16,416,210,206,7,15,4,3
19324,15,1758,11,214,140,74,4,41,3,1
21370,10,24853,9,177,94,83,2,30,1,1
13833,10,8391,9,256,93,163,2,30,1,1
12016,2395,8356,1862,70,70,0,1,5,1,0
9,18,19196,13,184,94,90,2,29,1,1
1909,1460,19874,1113,481,150,331,2,1200,1,1
13975,10,7235,9,294,106,188,4,56,2,2
8551,10,12218,9,305,93,212,4,48,2,2
17159,26,20852,16,39518,2389,37129,54,179,21,33
16021,2176,17600,1681,517,163,354,2,1200,1,1
8879,10,8462,9,821,102,719,2,30,1,1
10983,26,2464,16,7571,3372,4199,33,88,17,16
21761,10,24330,9,261,87,174,4,45,2,2
11084,15,16474,11,41406,4176,37230,57,32,25,32
9855,26,25256,16,7240,2265,4975,24,351,13,11
16451,15,25203,11,2494,1540,954,21,75,11,10
12126,26,10354,16,33472,16066,17406,57,48,29,28
12710,26,1016,16,499,425,74,4,1,3,1
14584,10,28979,9,190,97,93,2,30,1,1
7355,15,12457,11,134,60,74,3,6,2,1
14244,2157,7786,1665,70,70,0,2,8,2,0
6080,26,2402,16,32434,15588,16846,164,1128,83,81
9236,10,15043,9,787,110,677,2,30,1,1
4680,26,774,16,10497,3476,7021,34,17,18,16
12602,26,26961,16,499,425,74,4,0,3,1
16513,26,26293,16,560,280,280,9,28,5,4
11223,26,22241,16,13948,1150,12798,29,15,14,15
8842,10,17491,9,197,102,95,2,30,1,1
6030,676,2849,475,130,70,60,2,5,1,1
22125,10,10343,9,183,94,89,2,30,1,1
10724,2894,11393,2247,70,70,0,1,5,1,0
15954,10,19288,9,202,86,116,2,30,1,1
8678,10,28715,9,210,102,108,2,30,1,1
16021,2627,7250,2037,330,330,0,6,1199,6,0
21245,10,22232,9,306,94,212,2,30,1,1
3658,26,19255,16,10459,2529,7930,31,375,13,18
15250,10,5466,9,254,94,160,2,30,1,1
9068,10,13420,9,217,94,123,2,29,1,1
21805,10,2839,9,182,102,80,2,30,1,1
10533,166,22500,114,156,156,0,3,8,3,0
22196,10,14569,9,194,102,92,2,30,1,1
15784,10,16109,9,178,94,84,2,30,1,1
9728,15,22055,11,6706,4950,1756,23,20,13,10
8805,26,16119,16,7521,2117,5404,22,89,12,10
12793,2954,19520,2291,70,70,0,2,8,2,0
4543,10,21777,9,198,93,105,2,30,1,1
5176,26,19931,16,99092,3694,95398,115,170,43,72
14956,10,1374,9,322,110,212,4,30,2,2
14967,10,1187,9,177,94,83,2,30,1,1
1030,26,23676,16,428,128,300,8,47,3,5
14333,10,11718,9,281,101,180,4,59,2,2
10592,26,2961,16,202,70,132,3,11,1,2
12699,26,23121,16,499,425,74,4,1,3,1
7893,26,20298,16,556154,55291,500863,1146,559,440,706
18973,26,5537,16,49981,8331,41650,75,48,36,39
11009,26,10358,16,10613,3156,7457,42,15,24,18
22687,26,26013,16,3874,1587,2287,17,143,9,8
21864,10,22930,9,194,102,92,2,30,1,1
20159,26,18720,16,7740,2603,5137,13,120,7,6
15523,10,16795,9,183,86,97,2,29,1,1
18634,10,26885,9,197,76,121,2,30,1,1
11647,26,9432,16,10748,1634,9114,22,316,10,12
4363,26,15741,16,16116,3253,12863,52,97,29,23
14408,10,14777,9,199,94,105,2,29,1,1
4495,26,8862,16,43818,31519,12299,85,259,49,36
15287,10,7100,9,177,94,83,2,30,1,1
9451,15,17186,11,182517,10761,171756,265,352,130,135
11030,15,15388,11,3495,1150,2345,17,18,8,9
9508,26,16242,16,1727,926,801,15,30,7,8
10890,2755,26255,2136,70,70,0,1,5,1,0
7432,26,7954,16,7071,2628,4443,32,23,16,16
15769,10,23735,9,764,99,665,2,30,1,1
15375,26,7193,16,8074,2054,6020,20,16,11,9
8436,10,3245,9,198,110,88,2,30,1,1
21396,10,8722,9,365,102,263,2,31,1,1
13955,10,17956,9,192,98,94,2,31,1,1
5849,26,4428,16,6055,2800,3255,38,279,19,19
4165,26,1779,16,14329,8250,6079,26,22,16,10
15580,10,27992,9,183,94,89,2,31,1,1
3938,232,13757,147,1964,919,1045,20,16,10,10
8265,676,25712,475,130,70,60,2,5,1,1
2744,1239,12274,919,880,126,754,2,30,1,1
13600,26,2840,16,4891,2237,2654,12,121,6,6
8843,15,16335,11,1977,921,1056,9,16,5,4
7862,26,20356,16,12735,10573,2162,33,316,16,17
15073,10,20134,9,199,102,97,2,30,1,1
15510,10,22750,9,181,94,87,2,33,1,1
19561,26,4519,16,8655,2300,6355,24,21,12,12
11107,26,10552,16,6317,2196,4121,19,15,10,9
15712,10,15542,9,177,94,83,2,30,1,1
21617,10,11566,9,341,110,231,2,29,1,1
15462,10,21494,9,211,110,101,2,30,1,1
2744,1298,15664,976,876,126,750,2,30,1,1
9564,26,11435,16,648,210,438,10,27,4,6
15384,10,3875,9,167,86,81,2,30,1,1
6565,26,1666,16,120,120,0,2,5,2,0
532,247,0,0,3354,1792,1562,46,192,23,23
14670,10,5161,9,193,102,91,2,30,1,1
14186,10,18076,9,224,94,130,2,30,1,1
3920,15,20078,11,15651782,355118,15296664,15172,45,5065,10107
21276,3032,7328,2357,312,132,180,6,5,3,3
8417,15,11529,11,1623,629,994,8,75,5,3
8795,10,14011,9,742,88,654,2,30,1,1
21989,10,20734,9,214,110,104,2,29,1,1
13820,15,24285,11,374,240,134,7,15,5,2
9077,10,20485,9,216,110,106,2,30,1,1
2744,1239,24854,919,1640,126,1514,4,31,2,2
636,280,17431,177,238,118,120,2,1199,1,1
18309,15,6525,11,1131,772,359,10,151,6,4
15387,26,14779,16,8073,2053,6020,20,15,11,9
16303,26,13982,16,6162,925,5237,18,108,10,8
9552,10,4237,9,183,94,89,2,30,1,1
14162,10,28577,9,216,110,106,2,30,1,1
14106,10,6600,9,817,98,719,2,31,1,1
13777,10,14763,9,711,87,624,2,31,1,1
15761,10,24171,9,173,94,79,2,30,1,1
15148,10,24981,9,253,99,154,2,32,1,1
6754,26,20813,16,1440,719,721,15,198,8,7
21956,10,23099,9,1152,86,1066,2,29,1,1
6109,10,18113,9,257,101,156,2,33,1,1
8386,10,10024,9,264,102,162,2,30,1,1
15932,10,25734,9,247,102,145,2,30,1,1
9001,10,1175,9,183,102,81,2,30,1,1
12084,26,19079,16,2016,1160,856,17,46,9,8
15022,10,21013,9,250,86,164,4,29,2,2
15029,26,6824,16,1786,172,1614,7,120,3,4
14873,10,21629,9,183,94,89,2,31,1,1
3212,10,13665,9,200,90,110,2,29,1,1
9753,15,2827,11,12986,6816,6170,26,26,12,14
15950,10,28282,9,193,102,91,2,30,1,1
8617,10,20179,9,757,98,659,2,31,1,1
21753,10,8369,9,277,94,183,4,60,2,2
22145,10,182,9,738,86,652,2,31,1,1
10485,15,22469,11,4995,3443,1552,23,26,13,10
8705,10,28664,9,340,87,253,4,50,2,2
15139,10,13220,9,751,95,656,2,30,1,1
5140,26,22804,16,403299,12717,390582,439,16,171,268
1640,26,13178,16,7420,1078,6342,21,75,11,10
14113,15,12216,11,498,280,218,8,26,5,3
16665,10,8961,9,578,286,292,9,15,5,4
8907,10,15258,9,766,102,664,2,30,1,1
7169,26,22178,16,2396,1144,1252,14,982,7,7
6569,26,4461,16,27958,21973,5985,77,403,43,34
14946,10,3073,9,199,102,97,2,30,1,1
15034,10,5018,9,183,94,89,2,30,1,1
8827,26,6724,16,9021,2548,6473,38,80,19,19
15618,10,20542,9,1426,98,1328,4,53,2,2
17084,26,26093,16,41305,2456,38849,63,30,29,34
15939,10,6615,9,184,94,90,2,31,1,1
14710,10,623,9,216,110,106,2,30,1,1
16833,26,6450,16,3120,1862,1258,18,15,11,7
822,10,3464,9,214,97,117,2,30,1,1
16809,10,10910,9,305,102,203,2,30,1,1
14208,10,9227,9,788,108,680,2,30,1,1
9873,1251,3057,931,269,78,191,2,30,1,1
449,2091,212,1612,710,710,0,6,302,6,0
12757,15,27850,11,1829,755,1074,10,15,6,4
13631,10,16879,9,275,93,182,4,31,2,2
22315,10,7538,9,753,94,659,2,30,1,1
3782,26,851,16,74325,3719,70606,98,200,44,54
8384,10,22245,9,282,93,189,4,45,2,2
3917,15,12987,11,3650999,83941,3567058,3541,21,1184,2357
18480,2819,12748,2188,258,70,188,4,8,2,2
21844,10,25558,9,195,102,93,2,31,1,1
12606,26,20335,16,499,425,74,4,0,3,1
11286,2079,13270,1601,316,136,180,6,8,3,3
15047,10,10143,9,177,94,83,2,30,1,1
532,247,0,0,3562,1936,1626,48,192,24,24
12991,26,5013,16,2786,1537,1249,17,16,8,9
13758,10,17365,9,184,94,90,2,30,1,1
15897,142,25337,101,156,156,0,3,8,3,0
15188,26,12714,16,7981,1961,6020,20,16,11,9
15576,15,17617,11,526,304,222,8,35,5,3
4489,10,7160,9,78,78,0,1,30,1,0
13001,26,135,16,499,425,74,4,0,3,1
11057,15,4026,11,9732,8170,1562,18,38,10,8
8993,10,17501,9,578,286,292,9,15,5,4
8886,26,23753,16,4936,855,4081,17,52,7,10
17193,26,3747,16,5107,700,4407,15,15,7,8
15075,10,482,9,170,87,83,2,31,1,1
12040,1427,27724,1083,514,274,240,8,143,4,4
18897,26,24800,16,4252,1594,2658,13,135,6,7
22719,10,23471,9,194,102,92,2,30,1,1
18643,15,13379,11,123436,6053,117383,165,241,83,82
12667,26,13649,16,499,425,74,4,0,3,1
9610,15,26663,11,1718,1247,471,9,15,5,4
9837,26,251,16,306,120,186,6,23,3,3
15981,10,13861,9,168,86,82,2,30,1,1
8129,26,16400,16,7104,888,6216,19,27,9,10
13620,10,19225,9,171,88,83,3,33,2,1
8374,26,28242,16,19566,12185,7381,89,176,42,47
9333,26,9447,16,6350,1071,5279,18,42,10,8
14896,10,2688,9,198,102,96,2,29,1,1
22098,10,23930,9,182,102,80,2,31,1,1
6736,26,11475,16,6156,4764,1392,17,231,11,6
14680,26,8542,16,3970,1726,2244,13,135,6,7
22279,10,21715,9,93,93,0,2,60,2,0
16511,26,10179,16,6821,1076,5745,21,38,12,9
12315,183,23452,121,4245,2461,1784,18,31,9,9
15296,26,5888,16,7889,1900,5989,20,15,11,9
9475,15,27220,11,736,670,66,6,15,5,1
13503,183,24110,121,3327,1438,1889,15,17,8,7
4445,26,15845,16,4652,1745,2907,19,28,11,8
15035,10,19799,9,199,102,97,2,30,1,1
2744,1238,19583,918,881,126,755,2,30,1,1
12061,2872,7938,2231,70,70,0,2,8,2,0
10130,26,19581,16,5841,1986,3855,19,18,11,8
12825,755,17735,543,70,70,0,2,7,2,0
880,15,27521,11,98161,5033,93128,125,37,45,80
3287,26,19971,16,8137,2110,6027,29,394,10,19
15423,10,24092,9,764,99,665,2,31,1,1
18181,26,20383,16,2090,1218,872,15,140,8,7
19132,26,27168,16,1092,645,447,10,34,6,4
19354,26,11694,16,6271,1191,5080,24,94,14,10
9805,15,3928,11,2693,461,2232,14,17,6,8
8167,26,11606,16,19402,10414,8988,35,22,21,14
4835,1535,23929,1169,4530,2856,1674,62,2421,35,27
14238,1068,5477,787,70,70,0,1,5,1,0
10814,1722,22955,1314,66,66,0,1,5,1,0
14925,10,22999,9,177,94,83,2,29,1,1
9728,2627,13419,2037,800,150,650,4,1200,2,2
8778,15,19353,11,378,192,186,7,41,4,3
14403,10,4703,9,200,94,106,2,30,1,1
11281,26,10910,16,23328780,730794,22597986,24754,320,8113,16641
15660,15,4529,11,130,70,60,2,15,1,1
8632,10,20788,9,209,110,99,2,30,1,1
8355,10,8917,9,777,87,690,2,31,1,1
21768,10,3100,9,194,102,92,2,29,1,1
2744,1274,3656,954,917,126,791,2,31,1,1
22103,10,5655,9,210,110,100,2,30,1,1
3391,26,12252,16,31065,6730,24335,68,18,37,31
9101,26,382,16,240,240,0,5,338,5,0
21444,10,21672,9,176,90,86,2,31,1,1
17879,10,5547,9,569,164,405,2,31,1,1
9599,26,4629,16,107749,6262,101487,142,138,58,84
8521,10,10803,9,196,102,94,2,30,1,1
10012,15,15551,11,395978,13168,382810,411,143,151,260
18211,26,10264,16,3015,2086,929,16,15,9,7
12575,3005,698,2336,70,70,0,2,7,2,0
8451,10,17725,9,195,86,109,2,30,1,1
9528,15,7712,11,2537,783,1754,13,20,7,6
5337,26,24350,16,7759,4000,3759,23,96,11,12
16137,26,79,16,2614,1689,925,18,23,10,8
6875,15,8343,11,51651,48866,2785,74,19,38,36
19425,26,1524,16,208,60,148,4,13,2,2
8077,26,26219,16,1985333,91427,1893906,2159,190,721,1438
5323,15,7835,11,3198,1493,1705,18,80,11,7
15420,1289,23100,967,316,136,180,6,7,3,3
13235,15,25681,11,16896,1514,15382,30,255,16,14
15278,10,16588,9,183,94,89,2,30,1,1
9531,26,1164,16,2227,1018,1209,17,16,8,9
14995,15,15771,11,33755,928,32827,36,104,11,25
4853,26,8629,16,13123,6654,6469,29,135,15,14
3633,26,3166,16,70,70,0,1,5,1,0
13728,26,27365,16,2459,1608,851,17,25,9,8
9158,15,3735,11,2618,591,2027,11,16,6,5
12001,2596,18906,2015,70,70,0,1,4,1,0
10462,26,9409,16,202,70,132,3,11,1,2
14485,10,3209,9,196,102,94,2,31,1,1
11396,10,15368,9,168,78,90,2,30,1,1
21423,10,28832,9,340,134,206,2,30,1,1
15349,1956,4249,1493,70,70,0,2,8,2,0
9734,15,6706,11,1507,951,556,13,78,7,6
9099,10,19574,9,168,86,82,2,30,1,1
19608,15,27424,11,16848,822,16026,23,16,9,14
2744,1240,23619,920,1634,126,1508,4,31,2,2
8871,26,22295,16,156357,6403,149954,155,81,44,111
9169,15,18779,11,2088,1160,928,10,86,6,4
13884,26,3048,16,6186,1650,4536,20,16,11,9
11031,15,8432,11,8117874,148550,7969324,7318,25,2033,5285
14561,10,1360,9,197,102,95,2,30,1,1
18339,26,6137,16,499,425,74,4,0,3,1
9253,10,8676,9,168,86,82,2,30,1,1
14852,10,25339,9,385,134,251,2,31,1,1
14292,10,133,9,195,102,93,2,30,1,1
4043,26,23005,16,6804,1473,5331,33,258,15,18
22183,10,28898,9,218,85,133,2,30,1,1
6506,26,20890,16,4579,580,3999,13,22,5,8
8341,26,24292,16,524887,14310,510577,546,18,201,345
10119,10,22743,9,232,94,138,2,29,1,1
14104,10,14704,9,193,102,91,2,30,1,1
21881,10,28004,9,240,110,130,2,30,1,1
20089,10,28813,9,441,162,279,6,32,3,3
5415,26,28749,16,125906,21096,104810,172,130,68,104
17889,15,61,11,5558,3386,2172,29,36,15,14
4615,26,24260,16,59233,7514,51719,70,122,27,43
12762,26,11194,16,499,425,74,4,0,3,1
22190,10,1591,9,194,102,92,2,31,1,1
16091,26,18872,16,25519,7061,18458,37,16,20,17
3810,26,21640,16,3386,1833,1553,17,255,9,8
14331,624,28363,431,70,70,0,1,5,1,0
13143,26,20990,16,12268,2979,9289,35,81,18,17
15397,10,26848,9,184,94,90,2,30,1,1
12511,3066,13091,2381,70,70,0,1,4,1,0
532,247,0,0,3498,1872,1626,48,193,24,24
9295,234,27194,149,7727,2172,5555,44,104,23,21
20604,2631,21084,2041,70,70,0,2,8,2,0
958,15,28168,11,318,192,126,6,26,4,2
6254,26,25799,16,101673,5966,95707,121,178,47,74
10909,1920,11624,1465,70,70,0,2,8,2,0
7606,26,27459,16,10812,3429,7383,39,315,20,19
16417,26,22379,16,6885,3239,3646,53,190,24,29
14056,10,22240,9,760,97,663,2,31,1,1
14258,10,17007,9,197,102,95,2,30,1,1
4347,15,15705,11,514,246,268,9,76,5,4
7930,26,20778,16,4716,1809,2907,19,26,11,8
11182,2965,24737,2301,70,70,0,1,5,1,0
4073,26,23590,16,3297,2327,970,22,37,11,11
11140,1769,18323,1350,70,70,0,2,8,2,0
9162,26,10265,16,24410,6698,17712,32,16,13,19
14570,10,2877,9,214,102,112,2,30,1,1
8989,10,3816,9,172,88,84,2,31,1,1
636,890,17862,658,509,150,359,2,1199,1,1
6250,2019,1890,1549,140,78,62,2,30,1,1
13902,26,17903,16,3524,2973,551,15,16,9,6
11068,655,7681,457,70,70,0,2,7,2,0
4635,15,26891,11,10438,979,9459,21,38,11,10
4202,26,5050,16,4883,3524,1359,20,200,11,9
6505,15,1410,11,1151,711,440,10,15,5,5
4835,2059,10874,1585,150,150,0,1,1199,1,0
6393,26,12854,16,7102,1857,5245,28,95,15,13
13782,10,5474,9,168,86,82,2,30,1,1
2046,952,19131,702,480,149,331,2,1200,1,1
10642,26,6289,16,4343,2350,1993,17,36,9,8
1010,26,28281,16,5687,499,5188,14,16,7,7
15171,10,4276,9,194,102,92,2,31,1,1
15139,10,23315,9,292,126,166,2,30,1,1
5679,10,7333,9,168,78,90,2,31,1,1
2744,1240,23369,920,1634,126,1508,4,30,2,2
8732,26,24829,16,2888,1389,1499,18,15,9,9
7866,26,21167,16,1053,566,487,10,43,6,4
19633,233,9155,148,10784,5831,4953,33,521,15,18
18266,10,5445,9,168,78,90,2,30,1,1
15059,26,13195,16,1853,1214,639,18,134,11,7
4600,26,15948,16,11113,2993,8120,26,143,14,12
12638,10,11182,9,224,86,138,2,30,1,1
13731,10,6189,9,246,94,152,2,30,1,1
9828,15,22222,11,1658,1247,411,8,15,5,3
4660,26,18579,16,499,425,74,4,0,3,1
3986,389,15113,252,138,78,60,2,6,1,1
12547,26,15327,16,7272,930,6342,19,75,9,10
14611,10,6759,9,177,94,83,2,30,1,1
10720,10,12038,9,198,86,112,2,29,1,1
14409,10,14226,9,177,94,83,2,30,1,1
15967,10,16626,9,711,87,624,2,31,1,1
22173,10,2863,9,243,110,133,2,30,1,1
11698,26,2745,16,10359,1566,8793,27,150,13,14
2872,26,8748,16,5517,1390,4127,18,15,9,9
18336,10,1038,9,215,86,129,2,30,1,1
21514,10,28564,9,288,83,205,2,30,1,1
15643,10,9405,9,197,102,95,2,33,1,1
12015,26,491,16,7738,2230,5508,24,45,14,10
11158,988,19510,729,70,70,0,1,4,1,0
934,26,11153,16,318,192,126,6,22,4,2
8491,26,28218,16,6586,3686,2900,35,75,17,18
20120,26,26724,16,7206,4320,2886,16,120,8,8
18877,26,20085,16,4265,1678,2587,21,142,10,11
9624,26,10649,16,57535,3735,53800,70,122,26,44
9040,10,18465,9,211,102,109,2,30,1,1
532,247,0,0,3562,1936,1626,48,195,24,24
7815,26,17453,16,8710,2009,6701,30,395,10,20
21589,10,22511,9,293,95,198,4,46,2,2
8822,10,24227,9,193,102,91,2,30,1,1
5480,26,21350,16,6883,1887,4996,23,361,12,11
15101,26,18230,16,5212,1037,4175,20,115,10,10
9594,15,21639,11,26924,4418,22506,34,25,13,21
12397,405,25783,263,70,70,0,2,7,2,0
835,26,10524,16,541643,15245,526398,507,416,103,404
7101,15,27106,11,2865,2000,865,12,18,7,5
15346,10,5177,9,261,94,167,2,30,1,1
9603,15,14175,11,1328,917,411,10,28,6,4
15331,10,16410,9,167,86,81,2,30,1,1
10867,1871,8055,1429,316,136,180,6,5,3,3
9836,15,15186,11,57678,29714,27964,241,175,120,121
13729,10,10414,9,183,94,89,2,30,1,1
9686,26,4350,16,86426,3497,82929,102,170,38,64
21510,10,14008,9,181,94,87,2,30,1,1
8725,10,2325,9,164,84,80,2,31,1,1
10756,854,14734,629,316,136,180,6,7,3,3
17158,26,25081,16,7413235,214811,7198424,7869,344,2785,5084
14052,10,3802,9,183,94,89,2,30,1,1
12432,405,18096,263,1268,960,308,9,32,5,4
11471,26,3457,16,26154,6874,19280,35,17,16,19
1171,2003,25096,1533,156,94,62,2,30,1,1
6372,15,2190,11,1222,782,440,11,15,6,5
12017,26,17792,16,13914,7812,6102,52,69,28,24
15247,10,10339,9,199,102,97,2,29,1,1
7182,10,2623,9,168,78,90,2,30,1,1
3544,26,8577,16,8237,1724,6513,31,270,16,15
8622,10,18451,9,199,102,97,2,31,1,1
22521,10,9588,9,179,94,85,2,30,1,1
7918,26,4411,16,18158,2080,16078,34,122,19,15
9626,15,15569,11,314,192,122,6,25,4,2
16122,26,6064,16,7629,3270,4359,34,337,17,17
8777,878,21536,647,594,174,420,2,31,1,1
10327,2627,23238,2037,460,150,310,2,1200,1,1
15271,26,25510,16,8059,2039,6020,20,15,11,9
8378,701,12938,499,70,70,0,1,5,1,0
3629,26,16219,16,43883,3446,40437,57,122,22,35
12393,26,7663,16,6812,1127,5685,24,255,11,13
19644,10,27457,9,216,90,126,2,30,1,1
17109,26,14945,16,4054,2590,1464,18,16,9,9
8873,15,6512,11,196092,6387,189705,189,108,57,132
7973,26,23503,16,7193,1890,5303,22,37,15,7
18887,26,18884,16,5710,1228,4482,21,16,12,9
9057,15,18539,11,1376,946,430,8,86,5,3
14977,10,19156,9,182,93,89,2,31,1,1
2744,1238,241,918,888,126,762,2,30,1,1
11218,592,21148,403,70,70,0,2,9,2,0
7041,26,25138,16,16225,2078,14147,38,42,19,19
8505,10,8508,9,368,94,274,2,30,1,1
14938,10,18809,9,819,102,717,2,30,1,1
9411,3272,19037,2532,222,132,90,4,1210,3,1
14080,10,7782,9,194,102,92,2,30,1,1
9099,10,20178,9,177,94,83,2,30,1,1
18800,1989,20120,1519,316,136,180,6,6,3,3
16202,26,11570,16,6568,2770,3798,20,121,10,10
9690,15,818,11,1990,812,1178,9,15,5,4
13794,10,14859,9,181,94,87,2,30,1,1
13613,10,24170,9,230,90,140,2,29,1,1
21751,10,17729,9,188,96,92,2,31,1,1
11346,26,22914,16,5444,2263,3181,23,86,12,11
22126,10,10942,9,555,195,360,6,62,3,3
3024,26,6268,16,2227,1018,1209,17,16,8,9
22129,10,7838,9,718,94,624,2,30,1,1
14104,10,2301,9,320,95,225,4,41,2,2
16021,2498,5633,1944,166,166,0,1,1200,1,0
21331,10,28035,9,178,91,87,2,31,1,1
21808,10,4621,9,193,102,91,2,30,1,1
8701,15,13325,11,1548,847,701,10,16,5,5
21255,10,28657,9,316,94,222,2,30,1,1
15065,15,19736,11,42070,2703,39367,53,135,22,31
8494,10,6323,9,396,102,294,2,30,1,1
9893,26,28584,16,70,70,0,2,171,2,0
14868,10,1335,9,177,94,83,2,30,1,1
13885,26,298,16,9352,2524,6828,27,46,14,13
18492,2385,22763,1853,70,70,0,2,8,2,0
12112,26,23761,16,7457,1726,5731,25,65,13,12
2328,26,9590,16,10943,5186,5757,32,25,18,14
14775,10,5623,9,167,86,81,2,30,1,1
16193,15,17898,11,2274,1660,614,21,15,11,10
22364,26,21545,16,1786,172,1614,7,120,3,4
9519,15,9392,11,350,210,140,6,15,4,2
12576,1846,20451,1406,70,70,0,2,7,2,0
6567,15,20385,11,811,671,140,6,32,4,2
22055,10,15874,9,195,102,93,2,30,1,1
22001,10,34,9,810,108,702,2,30,1,1
9702,10,19317,9,733,94,639,2,30,1,1
13900,26,7536,16,8431,2584,5847,25,46,14,11
14260,2296,11818,1780,70,70,0,2,8,2,0
22597,10,18667,9,273,102,171,2,30,1,1
21907,10,27094,9,808,272,536,8,78,4,4
15507,10,20923,9,216,110,106,2,31,1,1
22608,26,18866,16,2494,1643,851,17,25,9,8
8576,10,24115,9,178,94,84,2,30,1,1
13691,26,23326,16,13372,3722,9650,37,47,21,16
16832,10,1878,9,86,86,0,1,30,1,0
15899,10,6844,9,167,86,81,2,31,1,1
18340,26,10367,16,6155,1709,4446,29,1710,15,14
11023,26,144,16,1209,656,553,13,16,8,5
5050,10,24538,9,391,102,289,2,30,1,1
15347,3104,7535,2412,70,70,0,2,8,2,0
636,280,23019,177,118,118,0,1,1200,1,0
6484,234,22214,149,4708,1753,2955,27,4133,12,15
8395,10,22766,9,209,110,99,2,30,1,1
17099,26,12670,16,7899,5184,2715,24,16,13,11
1219,1726,9628,1318,480,149,331,2,1200,1,1
10278,10,11656,9,168,78,90,2,30,1,1
4147,26,760,16,7237,2204,5033,15,120,7,8
14735,10,7870,9,184,94,90,2,30,1,1
14429,10,1694,9,257,102,155,2,29,1,1
22484,10,21518,9,180,94,86,2,30,1,1
13595,26,10184,16,13018,3066,9952,65,361,33,32
22678,10,25650,9,531,97,434,4,35,2,2
14930,10,6067,9,184,102,82,2,29,1,1
22178,10,27189,9,347,100,247,4,49,2,2
13895,26,27548,16,3056958,73055,2983903,3016,43,1023,1993
3561,18,8672,13,184,94,90,2,30,1,1
17841,26,7726,16,70,70,0,2,5,2,0
2724,1240,11354,920,422,164,258,6,30,3,3
13975,10,25769,9,198,102,96,2,30,1,1
10,20,8457,14,384,384,0,5,51,5,0
8879,10,1051,9,198,102,96,2,30,1,1
22070,10,11375,9,178,94,84,2,30,1,1
21465,10,23992,9,434,96,338,4,30,2,2
9398,10,2781,9,165,86,79,2,30,1,1
21439,10,25226,9,212,102,110,2,30,1,1
17922,26,16969,16,23950,2135,21815,43,35,16,27
13133,26,2343,16,2402,1444,958,18,167,10,8
22412,10,7051,9,212,102,110,2,30,1,1
4640,738,28483,529,432,192,240,8,30,4,4
17969,26,14302,16,10266,7336,2930,49,222,24,25
10327,3138,10970,2436,132,132,0,3,1200,3,0
2790,10,11499,9,823,98,725,2,30,1,1
4922,26,459,16,7841,2301,5540,18,135,8,10
10043,15,2214,11,13780884,170419,13610465,11542,134,2387,9155
18144,26,15614,16,23967,5983,17984,40,142,17,23
8927,15,21642,11,2937,703,2234,13,142,6,7
21366,10,6681,9,178,94,84,2,30,1,1
3138,10,13155,9,194,87,107,2,30,1,1
14166,10,13587,9,198,101,97,2,30,1,1
17113,15,24797,11,2393,551,1842,10,21,6,4
9411,838,22003,617,966,464,502,14,1200,7,7
21228,15,3609,11,314,192,122,6,15,4,2
7612,10,20304,9,230,91,139,2,30,1,1
13986,10,10081,9,498,204,294,6,30,3,3
3919,15,15018,11,1918,1469,449,10,20,6,4
819,26,10154,16,9742,2044,7698,30,391,12,18
17156,15,2129,11,1614,1300,314,10,15,5,5
12894,26,22487,16,828875,45659,783216,1020,210,456,564
15238,10,12045,9,215,102,113,2,30,1,1
16951,255,25970,160,160,66,94,2,9,1,1
21891,10,22499,9,168,86,82,2,34,1,1
3472,26,13690,16,8088,2191,5897,28,508,13,15
14172,10,4178,9,177,94,83,2,29,1,1
9986,15,63,11,1118864,18787,1100077,1036,132,280,756
8648,295,21510,190,3098,1611,1487,16,15,9,7
3133,2296,28190,1780,330,330,0,6,3609,6,0
12732,26,2338,16,499,425,74,4,0,3,1
10560,295,22514,190,3490,1923,1567,14,16,7,7
2744,1241,22454,921,881,126,755,2,30,1,1
9827,26,10589,16,6414,1372,5042,19,171,9,10
9374,15,1116,11,1935,895,1040,15,75,8,7
2744,1235,10448,915,1622,126,1496,4,31,2,2
9836,15,12940,11,5727,3584,2143,15,31,8,7
13772,26,25235,16,17936,14273,3663,59,122,33,26
2744,2557,4359,1987,1636,126,1510,4,31,2,2
15075,10,6854,9,177,94,83,2,30,1,1
8210,2577,21194,1999,334,158,176,2,1203,1,1
3490,26,23888,16,479444,14906,464538,489,62,173,316
12419,43,24991,26,70,70,0,2,8,2,0
11121,223,27485,144,70,70,0,1,5,1,0
21950,10,18937,9,195,102,93,2,30,1,1
14606,26,9149,16,3640,606,3034,13,120,6,7
2207,2091,13163,1612,70,70,0,1,5,1,0
8354,15,16726,11,1213,471,742,10,111,6,4
8643,26,24090,16,1332,876,456,11,27,6,5
12121,15,23333,11,6385,778,5607,17,16,9,8
15571,10,634,9,199,94,105,2,30,1,1
14982,26,15298,16,24745,1926,22819,39,170,18,21
21942,10,7644,9,195,102,93,2,31,1,1
9307,15,20273,11,731402,17622,713780,600,97,116,484
7901,26,9880,16,8504,4770,3734,46,196,25,21
21796,10,246,9,188,96,92,2,30,1,1
15199,10,22275,9,196,102,94,2,30,1,1
21315,1366,18415,1038,70,70,0,1,4,1,0
8659,10,20866,9,241,118,123,2,30,1,1
9387,10,6632,9,733,93,640,2,30,1,1
9735,15,28431,11,318,192,126,6,25,4,2
14641,10,3491,9,762,98,664,2,30,1,1
6250,2010,21836,1540,1341,657,684,8,30,4,4
1061,26,6866,16,6285,839,5446,19,25,10,9
14372,26,1802,16,11503,3691,7812,30,240,14,16
8218,10,2975,9,198,93,105,2,30,1,1
13429,26,24055,16,4608,1701,2907,19,27,11,8
12074,26,5218,16,8020,1134,6886,23,15,11,12
15806,26,5221,16,7965,2643,5322,42,15,24,18
13827,10,5385,9,711,87,624,2,30,1,1
19632,26,27445,16,95212,17857,77355,119,175,53,66
5247,26,6181,16,7772,4119,3653,31,17,16,15
15510,10,22673,9,178,91,87,2,30,1,1
13666,26,18792,16,7249,1797,5452,29,32,17,12
7032,26,14339,16,5578,764,4814,14,15,8,6
16951,255,25970,160,126,62,64,2,5,1,1
5088,26,9463,16,1294,864,430,12,81,7,5
15405,10,15021,9,752,93,659,2,30,1,1
9511,15,6410,11,318,192,126,6,28,4,2
1159,2020,9673,1550,151,89,62,2,30,1,1
8603,26,5912,16,586175,29694,556481,753,182,349,404
9631,15,28664,11,13796,627,13169,20,30,8,12
13652,15,13755,11,2814,2440,374,13,16,7,6
4863,26,21810,16,8805,1300,7505,23,30,12,11
13692,26,11245,16,4424,876,3548,15,35,8,7
22506,10,14106,9,193,102,91,2,30,1,1
15169,10,21949,9,165,86,79,2,29,1,1
1007,26,24945,16,3792,488,3304,14,16,7,7
14593,10,23322,9,744,89,655,2,30,1,1
17904,26,21965,16,173218,14836,158382,227,48,114,113
1549,10,5520,9,235,90,145,2,32,1,1
1469,10,14259,9,211,86,125,2,30,1,1
9142,10,7038,9,195,102,93,2,31,1,1
15216,15,26652,11,234,234,0,4,12,4,0
13813,26,17119,16,12946,5235,7711,38,185,21,17
15270,26,1777,16,8006,1986,6020,20,15,11,9
11189,15,9861,11,502,310,192,9,31,6,3
14005,26,20386,16,101466,17775,83691,225,74,112,113
17986,10,11004,9,391,102,289,2,29,1,1
21750,10,3221,9,216,110,106,2,30,1,1
9411,1517,19351,1155,150,150,0,1,1200,1,0
3133,2342,4869,1826,462,462,0,8,3632,8,0
9172,10,20702,9,193,102,91,2,31,1,1
8883,26,4933,16,20576,8959,11617,42,130,24,18
13513,26,9799,16,4478,1133,3345,13,26,8,5
8864,10,23483,9,184,102,82,2,30,1,1
15897,10,17907,9,711,87,624,2,30,1,1
8464,10,5676,9,182,93,89,2,31,1,1
9715,15,27873,11,318,192,126,6,26,4,2
17044,26,25755,16,14878,4225,10653,83,330,41,42
21529,26,28569,16,4747,1840,2907,19,27,11,8
13810,10,3755,9,170,87,83,2,31,1,1
14483,10,2469,9,184,94,90,2,30,1,1
14468,10,14680,9,168,86,82,2,30,1,1
11703,15,11839,11,2501,1085,1416,15,108,8,7
4568,26,4832,16,19840,6479,13361,57,127,32,25
13990,10,15105,9,216,110,106,2,30,1,1
5211,26,7820,16,346170,16091,330079,454,16,225,229
21489,10,13813,9,245,94,151,2,30,1,1
7012,10,19447,9,216,90,126,2,29,1,1
2744,1242,23527,922,881,126,755,2,30,1,1
18041,26,7361,16,34167,3638,30529,50,200,23,27
18093,15,10472,11,1883,1263,620,11,83,6,5
18641,26,7307,16,41114,1554,39560,49,120,18,31
18136,15,23672,11,3431,2292,1139,17,142,10,7
21256,1172,8635,865,66,66,0,1,5,1,0
22053,10,19107,9,371,126,245,2,30,1,1
8603,10,4037,9,199,102,97,2,30,1,1
9,18,25097,13,184,94,90,2,30,1,1
18891,26,17690,16,3795,2679,1116,27,45,15,12
14435,26,8412,16,15097,2888,12209,40,28,20,20
8382,10,10674,9,214,102,112,2,30,1,1
16021,863,2320,637,594,594,0,10,1199,10,0
19692,295,27489,190,4131,1750,2381,17,15,9,8
8703,10,20239,9,269,96,173,4,59,2,2
5434,26,3986,16,6133,1343,4790,22,275,12,10
14948,26,2101,16,4863,3011,1852,20,234,12,8
8327,1400,1110,1063,830,150,680,4,1200,2,2
6401,26,15724,16,10837,3411,7426,34,272,17,17
3265,26,8579,16,8080,2049,6031,23,255,12,11
12668,26,25824,16,499,425,74,4,0,3,1
5182,26,1569,16,23292,17154,6138,141,522,79,62
17154,26,7431,16,5202,3361,1841,19,16,10,9
532,247,0,0,3498,1872,1626,48,195,24,24
15197,26,16118,16,3575,1079,2496,15,155,7,8
2744,1238,630,918,878,126,752,2,30,1,1
6599,15,5647,11,78,78,0,1,4,1,0
15302,10,22435,9,250,86,164,4,54,2,2
15128,10,4570,9,190,97,93,2,31,1,1
13869,10,14939,9,168,86,82,2,31,1,1
10012,15,22216,11,163985,6578,157407,188,26,72,116
18492,2385,8693,1853,70,70,0,1,5,1,0
10976,421,3975,274,70,70,0,2,7,2,0
16311,26,12345,16,912754,34972,877782,1035,294,410,625
14248,10,9710,9,177,94,83,2,30,1,1
17172,26,1246,16,1178,820,358,9,15,6,3
12729,26,4560,16,499,425,74,4,0,3,1
15296,10,5257,9,711,87,624,2,30,1,1
22543,10,6130,9,212,102,110,2,31,1,1
6897,10,8733,9,221,75,146,2,30,1,1
21578,10,28476,9,195,102,93,2,30,1,1
7766,26,25879,16,64727,10981,53746,91,141,36,55
8017,10,11631,9,199,94,105,2,30,1,1
22198,10,7843,9,196,100,96,2,30,1,1
22339,10,24252,9,198,102,96,2,30,1,1
9835,15,7187,11,55050,28089,26961,228,175,112,116
14717,10,21900,9,731,91,640,2,30,1,1
8584,1238,16267,918,236,78,158,2,30,1,1
15608,10,12418,9,199,102,97,2,30,1,1
8231,26,3038,16,12824,2604,10220,46,255,20,26
12467,2564,18276,1991,552,306,246,9,38,5,4
8865,10,2808,9,266,89,177,4,58,2,2
9757,26,23406,16,1512,850,662,16,93,9,7
8980,26,8708,16,3964,780,3184,14,125,8,6
18080,26,8979,16,30171,25514,4657,77,37,42,35
5172,2021,501,1551,142,80,62,2,31,1,1
1731,1092,26093,802,10840,6789,4051,143,4379,82,61
16222,26,24293,16,10392,2789,7603,25,16,13,12
9738,15,22062,11,9937,4191,5746,27,17,13,14
4418,15,15410,11,156726,8626,148100,206,32,104,102
15357,26,10894,16,7956,1967,5989,20,15,11,9
19361,26,6845,16,6204,1125,5079,23,89,13,10
18940,26,12996,16,7771,2691,5080,34,28,19,15
16951,255,25970,160,126,62,64,2,5,1,1
12931,26,2858,16,6840,1394,5446,29,270,14,15
6603,234,11021,149,6668,1369,5299,20,3600,10,10
15175,26,18449,16,13773,6668,7105,31,105,19,12
10148,26,17249,16,6999,2523,4476,22,80,13,9
15190,10,14506,9,177,94,83,2,30,1,1
13108,1238,11266,918,924,924,0,3,29,3,0
10906,1779,21368,1357,70,70,0,1,5,1,0
13679,10,3319,9,93,93,0,1,31,1,0
9296,10,11115,9,209,110,99,2,30,1,1
3808,429,14849,279,152,66,86,2,10,1,1
5741,233,20747,148,5723,1105,4618,27,473,10,17
16021,415,24764,270,491,150,341,2,1199,1,1
11707,26,8103,16,10091,2314,7777,33,17,18,15
12611,26,17636,16,499,425,74,4,0,3,1
9765,26,18247,16,3171,1473,1698,15,93,9,6
22389,1285,24032,964,268,78,190,2,30,1,1
6808,10,19112,9,209,79,130,2,30,1,1
8715,26,23205,16,7896,1770,6126,26,171,13,13
10002,15,25861,11,7313,1684,5629,15,148,8,7
13607,10,22390,9,289,134,155,2,30,1,1
15552,10,20265,9,209,110,99,2,29,1,1
14474,26,13958,16,11485,3525,7960,32,33,18,14
19549,15,1058,11,9323,5142,4181,23,20,12,11
14528,10,6280,9,184,94,90,2,31,1,1
8888,26,7545,16,9698,3026,6672,54,618,27,27
16021,981,12719,726,166,166,0,1,1200,1,0
19203,26,4713,16,8970,5359,3611,22,121,11,11
14782,10,20790,9,177,94,83,2,30,1,1
7368,26,20155,16,16656,3094,13562,29,271,14,15
8377,10,19393,9,183,94,89,2,30,1,1
4835,719,17273,514,1320,1320,0,21,1682,21,0
6422,10,18587,9,224,88,136,2,30,1,1
11150,26,22678,16,305183,9715,295468,312,44,107,205
14703,10,22029,9,817,102,715,2,30,1,1
8789,15,4915,11,454,262,192,8,42,5,3
8333,10,19688,9,770,101,669,2,31,1,1
14998,15,1395,11,34098,808,33290,34,104,9,25
21291,2493,388,1940,66,66,0,2,8,2,0
21541,10,19312,9,193,102,91,2,29,1,1
988,26,1695,16,8041,2882,5159,29,23,16,13
4835,2779,2584,2156,132,132,0,3,1199,3,0
22540,10,8323,9,352,94,258,2,30,1,1
11665,26,22274,16,186399,56439,129960,335,45,170,165
14347,345,20381,219,70,70,0,1,4,1,0
11838,26,11065,16,8623,4829,3794,44,195,22,22
14171,10,28495,9,177,94,83,2,30,1,1
14950,26,11054,16,3674,1750,1924,23,203,12,11
0,0,0,0,244,244,0,2,0,2,0
9140,10,2021,9,393,110,283,2,30,1,1
17330,10,20770,9,78,78,0,1,30,1,0
8178,26,846,16,2437,1321,1116,15,83,9,6
9602,10,12525,9,177,94,83,2,31,1,1
7142,26,2741,16,3657,1867,1790,22,391,7,15
7029,26,7027,16,23886,6994,16892,26,129,12,14
6227,10,18284,9,259,114,145,2,29,1,1
10950,26,22182,16,98155,20830,77325,151,103,70,81
8334,10,1945,9,816,102,714,2,30,1,1
8477,10,16083,9,239,102,137,2,30,1,1
2744,1250,27208,930,880,126,754,2,31,1,1
16679,26,22484,16,7349712,213635,7136077,7600,192,2303,5297
10005,26,8905,16,6889,1381,5508,19,129,9,10
5012,26,11148,16,7778,1724,6054,29,17,16,13
8824,26,21915,16,14121,2299,11822,37,19,19,18
14262,3003,7547,2334,70,70,0,2,8,2,0
17780,10,17540,9,714,454,260,2,30,1,1
6974,10,26400,9,179,86,93,2,30,1,1
13671,10,8465,9,288,110,178,2,29,1,1
9133,10,11691,9,199,102,97,2,30,1,1
14536,10,25098,9,184,94,90,2,29,1,1
15965,10,2723,9,168,86,82,2,30,1,1
17523,15,26295,11,107500,4003,103497,173,16,57,116
6364,15,21414,11,5562,1204,4358,11,91,7,4
5324,10,14099,9,199,94,105,2,30,1,1
9653,15,207,11,49872,11098,38774,65,24,27,38
14714,10,1546,9,199,102,97,2,30,1,1
8720,10,5319,9,204,104,100,2,30,1,1
11156,26,8767,16,1672,1149,523,13,37,8,5
20191,298,27812,193,4231,2106,2125,15,15,8,7
8883,26,22909,16,4876,855,4021,16,52,7,9
2744,1238,19519,918,878,126,752,2,30,1,1
9377,15,28945,11,12572,8562,4010,48,442,26,22
16477,15,4093,11,318,192,126,6,20,4,2
997,26,8409,16,4216,771,3445,16,26,9,7
9203,26,2494,16,17237,1717,15520,36,152,16,20
18562,26,23789,16,103479,7755,95724,165,19,70,95
15518,10,4675,9,180,94,86,2,30,1,1
8333,26,4162,16,70,70,0,1,5,1,0
12757,1790,16330,1366,70,70,0,1,4,1,0
8202,26,16126,16,6464,1223,5241,25,33,12,13
22035,10,21592,9,177,94,83,2,30,1,1
21555,26,19889,16,115035,5282,109753,128,120,44,84
15332,10,1169,9,783,96,687,2,31,1,1
15863,10,8530,9,573,186,387,6,71,3,3
7705,26,23482,16,6803,2164,4639,14,121,7,7
17178,26,9443,16,25575,16682,8893,57,21,31,26
10327,2042,8295,1569,594,594,0,10,1200,10,0
21651,10,23280,9,387,134,253,2,30,1,1
13697,10,16184,9,167,86,81,2,30,1,1
21123,707,29021,505,1592,1044,548,15,15,9,6
982,7,3643,7,146,60,86,2,10,1,1
11056,15,9125,11,422,240,182,8,25,5,3
22463,10,21259,9,207,86,121,2,30,1,1
8696,10,24077,9,265,102,163,2,30,1,1
4590,26,781,16,4859,964,3895,17,26,10,7
11112,665,3921,466,70,70,0,2,8,2,0
15309,2263,18266,1752,1640,460,1180,8,30,4,4
14127,10,14542,9,216,110,106,2,29,1,1
3037,10,12612,9,235,90,145,2,32,1,1
12581,2201,23437,1704,70,70,0,2,7,2,0
13511,26,2997,16,150,150,0,1,5,1,0
2992,15,12303,11,10148,1458,8690,23,25,11,12
7234,15,18310,11,890,420,470,14,27,7,7
14451,10,21924,9,166,86,80,2,30,1,1
14419,10,6038,9,735,88,647,2,30,1,1
16546,10,5168,9,83,83,0,2,31,2,0
10758,2841,4664,2205,316,136,180,6,6,3,3
21079,546,13032,363,70,70,0,1,4,1,0
9452,10,22062,9,1370,89,1281,4,33,2,2
9889,26,2985,16,6354,1372,4982,18,161,9,9
15330,26,28046,16,1327,918,409,10,26,6,4
8659,26,17095,16,9692,6055,3637,21,30,11,10
14381,10,13819,9,170,87,83,2,31,1,1
3744,26,5515,16,8277,2394,5883,31,316,16,15
17105,26,10848,16,32148,21507,10641,72,21,42,30
532,247,0,0,3562,1936,1626,48,196,24,24
3554,10,14459,9,1415,689,726,3,31,2,1
8781,10,12975,9,413,170,243,6,31,3,3
5592,26,9668,16,13459,1604,11855,27,66,14,13
15285,15,13418,11,30614,1926,28688,44,45,23,21
8327,1917,4859,1463,868,150,718,4,1200,2,2
9479,10,11496,9,216,110,106,2,29,1,1
15233,10,25016,9,257,114,143,2,30,1,1
9562,10,25713,9,185,102,83,2,30,1,1
21955,10,15738,9,262,94,168,2,30,1,1
16951,255,25970,160,66,66,0,1,4,1,0
615,15,2478,11,514,246,268,9,82,5,4
5076,15,2370,11,1013,504,509,10,15,6,4
13699,26,11083,16,5541,2778,2763,24,15,14,10
9200,10,1580,9,281,78,203,2,31,1,1
14576,10,17991,9,209,110,99,2,30,1,1
2869,26,19522,16,5577,1390,4187,19,15,9,10
4438,26,27971,16,1988,1348,640,16,30,9,7
15892,26,2208,16,4048,3089,959,24,15,13,11
9430,10,2550,9,168,78,90,2,30,1,1
9697,183,22038,121,3327,1438,1889,15,17,8,7
16352,15,21377,11,5518,527,4991,13,75,6,7
14956,10,10709,9,216,110,106,2,30,1,1
8788,15,14214,11,454,262,192,8,42,5,3
8338,26,22569,16,7966,2735,5231,22,120,10,12
14358,10,314,9,819,102,717,2,29,1,1
5330,26,25143,16,7450,2503,4947,21,977,11,10
8515,10,10771,9,188,96,92,2,31,1,1
4259,10,19183,9,168,78,90,2,30,1,1
5089,26,4221,16,11202,2200,9002,39,131,20,19
6648,15,18864,11,44566,6675,37891,58,23,27,31
13101,10,10607,9,284,79,205,2,30,1,1
18226,26,7821,16,2998,1997,1001,16,16,8,8
19364,26,25721,16,6211,1132,5079,23,88,13,10
9377,15,8361,11,2384,952,1432,15,75,8,7
3712,26,1971,16,9167,2205,6962,37,120,19,18
17071,26,26253,16,5750,1163,4587,25,258,13,12
15883,10,12219,9,90,90,0,1,30,1,0
17434,10,19200,9,260,86,174,2,30,1,1
8331,10,24096,9,226,102,124,2,30,1,1
5543,26,17871,16,130,70,60,2,15,1,1
16569,10,25746,9,194,87,107,2,30,1,1
15697,10,21031,9,178,94,84,2,30,1,1
16796,26,3373,16,81295,4140,77155,114,117,42,72
14926,10,20832,9,199,102,97,2,30,1,1
19725,15,27511,11,2102,1583,519,11,23,6,5
14297,10,6561,9,177,94,83,2,30,1,1
2744,1304,27027,982,883,126,757,2,30,1,1
4821,26,24279,16,6124,860,5264,18,361,9,9
5791,373,17649,241,156,156,0,3,8,3,0
17285,26,28524,16,972647,20727,951920,916,263,245,671
8934,15,17620,11,254,128,126,5,15,3,2
11839,15,15860,11,76193,2105,74088,75,359,23,52
8581,26,16287,16,9623,3235,6388,33,118,18,15
12112,10,14504,9,165,78,87,2,30,1,1
22169,10,26106,9,196,102,94,2,30,1,1
6827,26,8273,16,7151,1943,5208,30,25,17,13
22498,10,20058,9,209,110,99,2,30,1,1
14135,10,5042,9,817,102,715,2,30,1,1
9733,10,21916,9,733,85,648,2,30,1,1
13690,10,1032,9,177,94,83,2,30,1,1
11052,2745,23303,2128,66,66,0,1,5,1,0
10700,1178,18786,869,9372,9372,0,11,30,11,0
15878,10,7709,9,199,102,97,2,30,1,1
9429,26,15880,16,290,142,148,5,11,3,2
7559,10,20233,9,216,98,118,2,30,1,1
15018,10,9353,9,751,95,656,2,30,1,1
7832,26,21854,16,5149,852,4297,16,15,9,7
18499,2909,27089,2258,564,318,246,9,16,5,4
12671,26,18601,16,190,70,120,4,15,2,2
7072,10,19524,9,404,259,145,3,32,2,1
17248,26,210,16,5108,700,4408,15,15,7,8
19792,26,3849,16,2139,1140,999,15,124,9,6
10976,421,26898,274,70,70,0,1,4,1,0
6713,10,26870,9,199,94,105,2,30,1,1
11691,15,4680,11,2426,1594,832,17,151,9,8
18086,26,6929,16,25649,1485,24164,36,144,14,22
11830,26,19396,16,36892,20283,16609,191,116,77,114
22383,10,3013,9,199,102,97,2,30,1,1
21418,10,14262,9,273,94,179,2,30,1,1
21449,10,12547,9,180,94,86,2,31,1,1
20489,10,25837,9,303,85,218,2,31,1,1
6340,26,6842,16,8533,2023,6510,23,15,12,11
16021,2751,1398,2132,132,132,0,3,1199,3,0
4038,26,17040,16,5120,3761,1359,21,49,12,9
8488,10,29060,9,225,102,123,2,30,1,1
8584,1565,2240,1196,78,78,0,1,30,1,0
8890,10,5350,9,183,94,89,2,30,1,1
14278,10,20653,9,174,89,85,2,30,1,1
10258,15,11557,11,78198970,2041652,76157318,79332,368,28698,50634
15693,26,17535,16,6489,1065,5424,22,255,12,10
18879,26,3994,16,1786,172,1614,7,120,3,4
15195,15,26931,11,234,234,0,4,12,4,0
15200,26,26264,16,7888,1899,5989,20,15,11,9
22518,10,20972,9,216,110,106,2,30,1,1
9946,26,7354,16,9328,1709,7619,18,139,8,10
11105,1886,6893,1440,70,70,0,1,4,1,0
19521,26,22033,16,10714,3531,7183,26,120,12,14
22449,10,18604,9,199,102,97,2,30,1,1
21701,10,13984,9,350,89,261,4,53,2,2
8089,26,10100,16,3908,630,3278,12,17,7,5
8595,10,20573,9,194,102,92,2,30,1,1
8777,10,20685,9,184,94,90,2,29,1,1
22020,10,2661,9,178,94,84,2,30,1,1
8658,10,14964,9,199,102,97,2,31,1,1
19518,15,15610,11,79505,3799,75706,105,53,43,62
15398,2576,29128,1998,316,136,180,6,6,3,3
21215,10,13912,9,209,110,99,2,29,1,1
16620,26,11552,16,3108,1047,2061,14,136,7,7
6038,346,7455,220,78,78,0,2,8,2,0
1456,10,5099,9,231,90,141,2,30,1,1
9344,26,13402,16,2404,1121,1283,14,115,7,7
11046,15,3653,11,124703,6134,118569,147,125,64,83
18385,26,21609,16,1743,1164,579,16,25,10,6
5820,26,2720,16,10836,1733,9103,34,180,15,19
8853,10,28005,9,241,94,147,2,29,1,1
16520,26,7371,16,543,303,240,8,5,4,4
2232,10,9126,9,217,82,135,2,32,1,1
10999,15,18070,11,7304882,206543,7098339,7398,37,2677,4721
18976,26,17193,16,18274,7660,10614,46,48,26,20
15480,10,24303,9,193,102,91,2,30,1,1
12020,26,11708,16,7169,1715,5454,18,325,9,9
8531,26,1450,16,5141,896,4245,17,69,8,9
11224,15,18366,11,1151,711,440,10,15,5,5
184,10,14209,9,210,78,132,2,30,1,1
21937,10,7253,9,211,110,101,2,30,1,1
12748,26,15591,16,499,425,74,4,0,3,1
10874,564,3504,378,70,70,0,1,5,1,0
636,2312,16104,1796,228,118,110,2,1199,1,1
21611,10,19174,9,196,102,94,2,30,1,1
3480,26,13545,16,10856,3151,7705,34,361,16,18
10584,26,19760,16,202,70,132,3,11,1,2
13810,10,11015,9,177,94,83,2,30,1,1
14576,10,13010,9,209,110,99,2,30,1,1
13846,10,8168,9,209,110,99,2,30,1,1
11201,3162,10765,2450,70,70,0,1,5,1,0
14528,10,16468,9,184,94,90,2,31,1,1
13228,15,19965,11,2544,900,1644,12,255,7,5
12393,26,23499,16,1386,751,635,15,181,8,7
15984,10,6947,9,198,94,104,2,30,1,1
20206,26,11506,16,6939,2970,3969,19,144,9,10
14963,10,11732,9,195,102,93,2,30,1,1
8442,10,26554,9,190,97,93,2,31,1,1
18383,10,13352,9,316,80,236,2,31,1,1
15608,15,6433,11,953,524,429,11,256,6,5
3702,26,7472,16,5823,1597,4226,21,19,11,10
14020,26,7288,16,40612,4090,36522,71,150,31,40
8852,10,20405,9,183,94,89,2,30,1,1
18346,15,11713,11,1422,734,688,7,99,4,3
16951,255,25970,160,160,66,94,2,9,1,1
1219,287,6706,184,481,150,331,2,1200,1,1
14919,10,12562,9,268,89,179,4,45,2,2
6003,26,22169,16,78,78,0,1,5,1,0
3885,26,4995,16,190,70,120,4,15,2,2
636,280,11042,177,502,150,352,2,1200,1,1
22321,10,23029,9,193,102,91,2,30,1,1
6255,26,23767,16,433261,34730,398531,604,279,258,346
12663,26,10072,16,499,425,74,4,0,3,1
21539,10,18215,9,214,110,104,2,30,1,1
9962,26,22513,16,6601,1120,5481,17,115,9,8
0,0,0,0,244,244,0,2,0,2,0
13890,10,4719,9,168,78,90,2,30,1,1
8679,10,15450,9,200,102,98,2,30,1,1
22169,10,24986,9,196,102,94,2,31,1,1
13932,10,14796,9,196,102,94,2,30,1,1
2744,1238,24159,918,882,126,756,2,30,1,1
8584,1238,18285,918,251,78,173,2,30,1,1
9069,10,13365,9,180,94,86,2,29,1,1
4678,26,6417,16,60339,4689,55650,79,47,35,44
5003,26,5919,16,272822,10124,262698,330,81,126,204
3344,26,28264,16,25617,6531,19086,87,220,46,41
0,0,0,0,320,320,0,5,0,5,0
14501,10,19408,9,199,102,97,2,30,1,1
18834,26,11858,16,16554,7445,9109,49,255,24,25
1085,26,17418,16,8952,5576,3376,35,38,21,14
4300,26,15635,16,4651,1744,2907,19,28,11,8
7875,26,1467,16,214,140,74,4,15,3,1
8644,10,25830,9,164,86,78,2,31,1,1
16003,26,23939,16,12192,3788,8404,36,18,18,18
22452,10,20132,9,459,94,365,4,45,2,2
9653,10,5972,9,789,110,679,2,31,1,1
10667,15,26817,11,502,256,246,9,39,5,4
3938,26,26216,16,639937,14873,625064,627,230,188,439
9017,10,21039,9,811,94,717,2,30,1,1
5418,26,1010,16,2396,1144,1252,14,982,7,7
21951,10,25999,9,757,102,655,2,30,1,1
3045,10,22871,9,200,86,114,2,30,1,1
12141,26,22235,16,6899,2368,4531,27,27,14,13
16282,26,7495,16,30057,13955,16102,146,556,65,81
21608,10,17711,9,243,94,149,2,30,1,1
3149,10,13202,9,240,98,142,2,30,1,1
14917,10,22993,9,193,102,91,2,30,1,1
11960,204,26485,133,115,115,0,1,31,1,0
15953,10,24716,9,177,94,83,2,31,1,1
14995,10,12793,9,816,102,714,2,30,1,1
532,247,0,0,3354,1792,1562,46,193,23,23
8927,15,7353,11,2113,1181,932,10,127,6,4
4441,26,17082,16,3789,2373,1416,24,26,14,10
15564,26,12185,16,20986,10828,10158,35,95,20,15
11594,280,20127,177,1162,856,306,10,14,5,5
21426,10,17132,9,409,92,317,4,30,2,2
19316,15,965,11,214,140,74,4,41,3,1
7378,15,2563,11,70,70,0,2,5,2,0
11036,26,5732,16,2898,2047,851,19,22,11,8
8625,26,4045,16,10166,3392,6774,35,133,18,17
12550,1346,14768,1021,70,70,0,1,4,1,0
21864,10,11351,9,194,102,92,2,31,1,1
19810,15,15810,11,2806,626,2180,12,15,6,6
8816,26,11283,16,92597,47158,45439,747,1187,422,325
22547,10,5247,9,168,86,82,2,30,1,1
14794,10,15036,9,195,102,93,2,30,1,1
5216,26,21634,16,16499,9522,6977,44,364,22,22
15113,10,930,9,209,110,99,2,31,1,1
15143,10,12191,9,194,102,92,2,31,1,1
13615,26,19722,16,25572,2605,22967,56,133,29,27
22071,10,10466,9,451,124,327,4,45,2,2
10946,15,27218,11,182,60,122,4,26,2,2
22532,10,21976,9,186,95,91,2,31,1,1
4403,2,5434,2,138,78,60,2,5,1,1
10345,15,977,11,1451,949,502,12,46,7,5
2744,66,29087,49,855,126,729,2,29,1,1
9102,15,1822,11,1130,613,517,11,15,6,5
22524,10,5771,9,308,102,206,2,30,1,1
21400,10,24526,9,370,94,276,2,30,1,1
21410,10,15970,9,196,102,94,2,30,1,1
15413,10,13344,9,327,87,240,4,50,2,2
15035,10,25754,9,199,102,97,2,30,1,1
8933,10,26541,9,200,102,98,2,30,1,1
2194,10,24362,9,245648,213726,31922,2763,89,2579,184
18138,26,11167,16,1015,572,443,11,142,6,5
15419,2233,21974,1731,70,70,0,1,5,1,0
11965,26,23261,16,49826,37097,12729,66,163,40,26
14162,10,13523,9,216,110,106,2,30,1,1
13289,15,17052,11,4096,3455,641,13,15,8,5
21976,10,25668,9,178,94,84,2,30,1,1
22696,10,1190,9,167,86,81,2,30,1,1
14336,1016,904,750,564,318,246,9,15,5,4
11809,15,13484,11,4292,1932,2360,32,118,17,15
2744,1238,15165,918,884,126,758,2,31,1,1
15347,10,3542,9,168,86,82,2,30,1,1
10547,26,13759,16,4710,699,4011,12,15,8,4
8852,10,15097,9,182,93,89,2,30,1,1
11197,3126,1022,2427,70,70,0,1,5,1,0
21980,10,26826,9,195,102,93,2,30,1,1
14961,10,24502,9,170,87,83,2,31,1,1
17280,26,14083,16,2894,1653,1241,24,26,12,12
15596,10,28545,9,174,89,85,2,31,1,1
18445,3144,6993,2438,70,70,0,1,5,1,0
7993,26,25108,16,62,62,0,1,4,1,0
21463,10,1592,9,215,102,113,2,30,1,1
9048,26,14531,16,5265,1647,3618,16,88,9,7
8330,10,5426,9,167,86,81,2,29,1,1
8937,10,4530,9,728,96,632,2,31,1,1
8806,26,19167,16,12619,3258,9361,33,47,19,14
21031,15,24460,11,374,192,182,7,15,4,3
9764,15,13926,11,16709,10372,6337,31,52,16,15
22666,10,20882,9,183,94,89,2,30,1,1
9310,10,493,9,777,87,690,2,0,1,1
6771,15,28833,11,1894,1520,374,15,15,9,6
16979,26,3096,16,3330,737,2593,10,121,5,5
11387,26,8433,16,8659,3601,5058,34,80,18,16
5247,10,13181,9,168,78,90,2,30,1,1
11147,960,13045,708,70,70,0,2,8,2,0
6412,26,26204,16,10233,2198,8035,25,81,14,11
6136,10,18149,9,237,91,146,2,33,1,1
8372,10,27493,9,194,102,92,2,30,1,1
14259,26,25779,16,6897,2509,4388,16,121,8,8
8598,10,22309,9,177,94,83,2,30,1,1
15682,26,28771,16,5133,631,4502,14,15,8,6
16246,15,11595,11,2754,1602,1152,17,22,9,8
14577,10,8965,9,243,94,149,2,30,1,1
14377,10,19848,9,211,110,101,2,29,1,1
13097,15,1559,11,552,280,272,9,30,5,4
12123,26,23476,16,6059,1040,5019,20,58,11,9
8881,10,6917,9,184,94,90,2,30,1,1
3357,26,2090,16,11110,1700,9410,33,750,11,22
18121,15,26613,11,2959,1505,1454,10,15,6,4
10914,1047,201,771,70,70,0,1,5,1,0
21311,10,11491,9,194,102,92,2,30,1,1
12569,26,6543,16,499,425,74,4,0,3,1
7522,183,20180,121,4145,1976,2169,22,20,13,9
14734,10,9795,9,195,86,109,2,30,1,1
11486,15,22994,11,15453,911,14542,25,16,11,14
13698,15,11298,11,306,180,126,6,34,4,2
5989,26,11663,16,7112,5916,1196,20,30,10,10
1319,26,4406,16,6671,3244,3427,26,30,16,10
1008,26,17484,16,3649,424,3225,12,15,6,6
4499,10,6221,9,168,78,90,2,29,1,1
11087,15,2599,11,422,240,182,8,25,5,3
12739,2296,11702,1780,70,70,0,2,7,2,0
21929,10,5528,9,214,102,112,2,30,1,1
10990,2985,14818,2319,70,70,0,1,5,1,0
15362,26,4672,16,5639,846,4793,18,27,10,8
4335,26,18188,16,4216,2615,1601,26,80,13,13
15225,26,15964,16,8008,1988,6020,20,15,11,9
17131,26,11172,16,5167,700,4467,16,15,7,9
7081,26,12872,16,9599,1234,8365,27,29,15,12
13681,26,8360,16,19367,11346,8021,47,19,26,21
8335,10,25156,9,196,102,94,2,30,1,1
15553,15,2197,11,214,140,74,4,35,3,1
12631,10,23508,9,260,86,174,2,30,1,1
11914,15,23230,11,278027,5087,272940,288,22,76,212
2744,1569,21225,1200,884,126,758,2,31,1,1
3809,26,28302,16,3120,1862,1258,18,15,11,7
11108,699,20742,497,70,70,0,2,7,2,0
14555,10,11215,9,170,87,83,2,30,1,1
10855,1161,4518,857,70,70,0,2,9,2,0
7047,26,28690,16,373033,19903,353130,469,143,180,289
2744,1238,18104,918,868,126,742,2,30,1,1
8504,26,8649,16,3185,2263,922,18,26,9,9
2744,1238,15528,918,889,126,763,2,30,1,1
2724,1240,13473,920,254,82,172,4,30,2,2
21884,10,4923,9,312,94,218,2,30,1,1
22702,10,25535,9,195,102,93,2,29,1,1
11308,234,7564,149,2147,1315,832,14,3601,7,7
21261,1707,23608,1303,66,66,0,2,8,2,0
12693,26,16641,16,499,425,74,4,0,3,1
780,1953,3054,1490,78,78,0,1,30,1,0
22189,10,8647,9,198,102,96,2,30,1,1
13631,10,28276,9,275,93,182,4,32,2,2
15492,10,24838,9,177,94,83,2,30,1,1
7556,349,27899,222,234,234,0,4,11,4,0
8391,10,27074,9,177,94,83,2,30,1,1
15413,1756,19281,1341,70,70,0,1,5,1,0
3312,15,16085,11,21387,1482,19905,38,18,19,19
793,371,20435,239,66,66,0,1,30,1,0
22033,10,10542,9,193,102,91,2,29,1,1
9797,15,23105,11,1658,1247,411,8,15,5,3
9412,26,5437,16,6344,2063,4281,26,21,12,14
19341,26,321,16,6109,1902,4207,33,141,19,14
15693,26,22474,16,10724,3758,6966,38,403,13,25
8584,1238,9608,918,256,78,178,2,30,1,1
12410,26,5646,16,12007,942,11065,19,120,8,11
16683,10,26330,9,215,102,113,2,30,1,1
15866,10,18053,9,316,110,206,2,30,1,1
14667,10,17699,9,195,102,93,2,30,1,1
9534,10,12569,9,772,103,669,2,30,1,1
19319,15,10938,11,214,140,74,4,41,3,1
14111,10,1018,9,381,102,279,4,44,2,2
11947,26,8295,16,7393,2050,5343,34,92,16,18
8405,10,21385,9,235,90,145,2,32,1,1
1768,10,6586,9,235,90,145,2,32,1,1
12607,446,8046,286,70,70,0,1,4,1,0
14452,10,3712,9,183,94,89,2,30,1,1
11095,2665,9822,2072,70,70,0,1,4,1,0
3487,26,22287,16,4281,1160,3121,12,122,6,6
6293,26,12464,16,8616,2683,5933,30,459,15,15
6090,10,976,9,168,78,90,2,30,1,1
14228,10,1558,9,209,110,99,2,30,1,1
8968,26,9132,16,9506,1461,8045,20,158,9,11
10356,15,22845,11,23175,13071,10104,134,1929,67,67
13003,26,1213,16,26903,3579,23324,72,278,33,39
22500,10,4872,9,244,94,150,2,30,1,1
9581,15,28834,11,314,192,122,6,26,4,2
14275,10,5524,9,168,86,82,2,31,1,1
12752,188,26860,123,3532,1792,1740,58,88,29,29
14922,10,17378,9,198,102,96,2,30,1,1
15233,10,13767,9,193,102,91,2,30,1,1
13749,10,3442,9,176,90,86,2,30,1,1
16926,26,17253,16,3301,1240,2061,14,135,7,7
9013,10,27121,9,196,102,94,2,31,1,1
21899,10,17955,9,576,195,381,6,51,3,3
10282,26,26793,16,1532,965,567,14,20,7,7
12757,26,25685,16,499,425,74,4,0,3,1
15195,10,13347,9,216,110,106,2,30,1,1
12554,26,4364,16,4933,957,3976,17,15,10,7
8648,15,27672,11,378,192,186,7,39,4,3
15840,10,6279,9,185,102,83,2,30,1,1
876,15,8597,11,318,192,126,6,29,4,2
15006,10,26429,9,166,86,80,2,30,1,1
14994,10,2529,9,198,101,97,2,30,1,1
10973,2838,13189,2202,70,70,0,2,8,2,0
11202,15,11408,11,362,240,122,7,17,5,2
1862,10,7056,9,217,87,130,2,30,1,1
10978,1741,26757,1329,316,136,180,6,6,3,3
17870,26,5112,16,304,86,218,2,30,1,1
15573,10,13774,9,194,102,92,2,30,1,1
12023,1741,8424,1329,758,320,438,11,16,6,5
9406,10,21937,9,196,86,110,2,30,1,1
13113,295,23878,190,3310,1535,1775,15,15,8,7
11902,26,684,16,190,70,120,4,15,2,2
15641,10,8506,9,166,86,80,2,29,1,1
9413,10,20892,9,734,94,640,2,31,1,1
10841,962,27311,710,70,70,0,2,8,2,0
9282,26,14724,16,15032,5689,9343,51,35,27,24
11842,26,27047,16,5582,1388,4194,19,15,9,10
15206,26,7310,16,7889,1900,5989,20,16,11,9
15322,10,10344,9,172,94,78,2,30,1,1
11190,2510,19699,1951,316,136,180,6,6,3,3
15259,26,10456,16,8737,1821,6916,23,23,14,9
15059,15,6089,11,71347,4788,66559,83,136,34,49
14900,10,6508,9,183,94,89,2,30,1,1
2744,1275,11300,955,908,126,782,2,31,1,1
3483,26,24119,16,314376,14130,300246,399,246,169,230
15699,10,26680,9,209,110,99,2,29,1,1
21914,10,4174,9,183,94,89,2,29,1,1
8998,26,11972,16,9890,4516,5374,26,124,14,12
21313,10,8410,9,183,94,89,2,30,1,1
2744,1246,1710,926,1640,126,1514,4,30,2,2
21859,10,17935,9,186,95,91,2,31,1,1
15869,10,6849,9,1385,85,1300,4,42,2,2
9403,26,2869,16,249660,21361,228299,416,141,191,225
1987,10,7697,9,235,90,145,2,32,1,1
14483,10,28270,9,184,94,90,2,31,1,1
14623,26,23470,16,162,102,60,2,5,1,1
10876,2087,18551,1609,70,70,0,1,5,1,0
1023,26,28044,16,3255,430,2825,11,15,6,5
7311,26,29091,16,5508,999,4509,20,255,11,9
12682,26,11166,16,499,425,74,4,0,3,1
14052,10,13217,9,183,94,89,2,31,1,1
16021,1427,16027,1083,2772,2772,0,43,2311,43,0
8580,26,13778,16,11485,3381,8104,39,124,23,16
12633,26,10602,16,499,425,74,4,0,3,1
22306,10,6971,9,199,102,97,2,30,1,1
9482,26,9109,16,9653,1740,7913,23,81,12,11
17126,26,14058,16,5168,700,4468,16,15,7,9
14355,10,27439,9,177,94,83,2,30,1,1
12627,10,26531,9,224,86,138,2,30,1,1
10221,26,15852,16,20280,13177,7103,82,1176,46,36
21924,10,26504,9,430,106,324,4,58,2,2
15568,10,1513,9,167,86,81,2,30,1,1
19165,26,26579,16,1864,250,1614,8,121,4,4
14942,10,20855,9,816,102,714,2,30,1,1
15159,26,1864,16,9416,2366,7050,25,19,14,11
12794,172,17417,118,70,70,0,2,7,2,0
772,10,3139,9,220,90,130,2,30,1,1
6402,26,18034,16,8155,1999,6156,22,81,13,9
10333,26,126,16,1396,735,661,14,80,8,6
8915,26,22386,16,54416,3219,51197,76,240,30,46
6488,26,14811,16,6443,1973,4470,19,16,11,8
22523,10,26470,9,766,102,664,2,29,1,1
19484,10,8974,9,86,86,0,1,30,1,0
10900,26,12485,16,4375,1230,3145,16,26,8,8
8312,10,8834,9,199,94,105,2,30,1,1
17239,26,10198,16,5108,700,4408,15,15,7,8
9493,15,10239,11,3909,888,3021,12,15,6,6
7042,15,10094,11,1729,1287,442,7,15,5,2
22713,10,22439,9,182,93,89,2,31,1,1
4835,3006,22130,2337,1577,594,983,20,1724,10,10
22147,10,1122,9,198,102,96,2,30,1,1
4486,15,15898,11,13825,1203,12622,22,29,9,13
13645,10,14446,9,177,94,83,2,30,1,1
21785,10,24496,9,167,86,81,2,30,1,1
18776,1989,26722,1519,316,136,180,6,7,3,3
6729,26,19950,16,2257,461,1796,9,39,4,5
7710,15,20432,11,276453,7832,268621,287,165,92,195
7285,26,23982,16,6558,2131,4427,26,262,10,16
8551,10,13271,9,178,91,87,2,31,1,1
10110,26,11933,16,8407,3736,4671,19,101,11,8
19372,26,16167,16,5716,1341,4375,29,80,16,13
13798,10,8875,9,180,94,86,2,29,1,1
4918,26,4059,16,8185,2274,5911,18,135,8,10
14015,10,17878,9,195,102,93,2,30,1,1
14957,10,15419,9,198,102,96,2,30,1,1
12715,2189,16160,1694,70,70,0,1,5,1,0
5886,26,13068,16,8837,1938,6899,21,17,12,9
22364,10,16871,9,198,94,104,2,30,1,1
5716,26,1521,16,7338,2419,4919,19,23,12,7
14542,10,9230,9,209,110,99,2,30,1,1
14736,10,5232,9,188,96,92,2,30,1,1
5164,15,16696,11,369073,4523,364550,316,142,59,257
8471,26,22829,16,932965,16289,916676,768,65,148,620
8816,10,10351,9,216,110,106,2,29,1,1
16021,405,13368,263,1577,594,983,20,1614,10,10
18882,26,16367,16,764899,31427,733472,883,60,368,515
11539,15,23032,11,16474,1881,14593,28,143,12,16
7309,10,6599,9,774,76,698,4,29,2,2
7960,26,3660,16,7658,4247,3411,29,31,15,14
15416,1437,11752,1091,70,70,0,2,8,2,0
5336,26,23170,16,7832,1895,5937,24,83,14,10
12395,1,25166,1,70,70,0,2,8,2,0
5328,26,13174,16,2045,1025,1020,17,80,9,8
10108,15,4932,11,576971,8128,568843,497,38,114,383
8948,15,5677,11,1661,1147,514,9,210,5,4
7844,26,20647,16,4743,1836,2907,19,29,11,8
9385,10,6683,9,164,78,86,2,29,1,1
15292,10,591,9,178,94,84,2,30,1,1
9112,15,530,11,19740,993,18747,28,15,12,16
7592,10,20276,9,404,259,145,3,32,2,1
4745,233,3157,148,110,110,0,1,5,1,0
7005,234,916,149,6819,1586,5233,18,3603,9,9
22615,10,25250,9,210,110,100,2,29,1,1
8864,26,27866,16,14762,1871,12891,30,34,16,14
15345,2708,3969,2104,70,70,0,1,5,1,0
8714,10,467,9,263,102,161,2,29,1,1
3939,26,28324,16,309321,13076,296245,368,189,150,218
14312,10,7962,9,193,102,91,2,29,1,1
8697,10,1142,9,182,93,89,2,31,1,1
4072,26,14329,16,5383,3710,1673,27,309,14,13
2744,1250,25810,930,1654,126,1528,4,31,2,2
22694,10,5502,9,166,86,80,2,30,1,1
8584,1238,13326,918,239,78,161,2,30,1,1
14449,10,24763,9,177,94,83,2,30,1,1
21397,10,17716,9,214,110,104,2,30,1,1
17482,10,23835,9,168,78,90,2,30,1,1
9728,581,1198,393,346,161,185,2,1200,1,1
2744,1238,1888,918,887,126,761,2,30,1,1
18736,26,266,16,1716,1136,580,15,30,9,6
9447,15,2135,11,5100,1620,3480,17,114,10,7
22677,10,1291,9,266,110,156,2,30,1,1
13426,26,26869,16,5158,2609,2549,11,121,6,5
8872,26,15654,16,32941,1850,31091,46,131,19,27
15564,26,25169,16,6305,1352,4953,19,16,10,9
8600,10,12901,9,326,134,192,2,30,1,1
4663,26,17687,16,7982,2392,5590,25,26,14,11
11284,26,15857,16,13640,2316,11324,24,136,10,14
808,15,3370,11,194259,7011,187248,211,39,80,131
14587,10,8874,9,193,102,91,2,31,1,1
13390,26,7279,16,3989,1104,2885,12,122,5,7
1660,10,5991,9,209,77,132,2,32,1,1
19803,10,21434,9,181,78,103,2,30,1,1
22119,10,7682,9,209,110,99,2,30,1,1
2801,10,2749,9,168,78,90,2,30,1,1
14363,10,3862,9,199,102,97,2,30,1,1
14767,10,5564,9,177,94,83,2,30,1,1
4558,15,16020,11,52625,3140,49485,55,52,14,41
12232,26,15110,16,8626,2839,5787,47,27,24,23
13984,26,19491,16,13181,6041,7140,60,410,27,33
9233,26,15947,16,1625,838,787,18,92,10,8
9095,26,19697,16,3278,1835,1443,22,16,13,9
9843,15,11998,11,54318,27824,26494,227,174,113,114
532,247,0,0,3562,1936,1626,48,194,24,24
18177,26,1750,16,1000,557,443,11,141,6,5
10806,659,17887,460,70,70,0,2,8,2,0
4334,26,17758,16,6293,1501,4792,22,16,11,11
21652,10,21034,9,224,94,130,2,30,1,1
963,15,18647,11,860,794,66,6,17,5,1
15939,142,25355,101,156,156,0,3,8,3,0
12755,44,23110,27,70,70,0,2,8,2,0
15378,10,8431,9,195,102,93,2,31,1,1
4582,26,25697,16,1842,1134,708,14,315,8,6
11422,26,6730,16,10070,5084,4986,41,16,24,17
10996,26,24204,16,35199,15909,19290,70,152,34,36
10667,26,5593,16,5021,2884,2137,14,135,7,7
13652,10,8989,9,198,102,96,2,31,1,1
10981,3266,25142,2529,70,70,0,2,8,2,0
512,10,1843,9,178,82,96,2,30,1,1
8486,10,408,9,166,86,80,2,29,1,1
13662,10,8097,9,215,102,113,2,30,1,1
16386,26,9975,16,7953,5153,2800,33,142,19,14
22197,10,15548,9,182,93,89,2,31,1,1
9740,26,22342,16,9573,1963,7610,25,72,12,13
18802,183,26980,121,4226,2201,2025,19,18,10,9
3873,26,8858,16,8093,2068,6025,23,360,11,12
21583,10,8070,9,281,110,171,2,30,1,1
21272,10,20628,9,338,110,228,2,31,1,1
6579,305,9146,199,3299,665,2634,18,16,10,8
13684,26,16129,16,5372,1221,4151,23,18,14,9
7150,10,28675,9,168,78,90,2,30,1,1
21520,10,29045,9,211,78,133,2,31,1,1
11173,1643,14441,1262,70,70,0,1,5,1,0
4633,26,17370,16,13299,2872,10427,34,41,19,15
22487,10,9493,9,181,94,87,2,29,1,1
7652,15,20352,11,82739,3221,79518,91,156,28,63
21797,10,7990,9,199,102,97,2,30,1,1
2046,2753,26598,2134,481,150,331,2,1200,1,1
12612,636,18283,441,70,70,0,1,5,1,0
21585,10,11297,9,324,89,235,4,31,2,2
5171,10,16703,9,229,89,140,2,30,1,1
10469,26,26747,16,8774,3355,5419,19,36,11,8
17863,15,6039,11,699554,16426,683128,701,95,244,457
636,2577,17301,1999,238,118,120,2,1199,1,1
22196,10,15638,9,192,98,94,2,30,1,1
21627,10,9112,9,210,94,116,2,30,1,1
9411,1217,13353,900,480,149,331,2,1200,1,1
18542,15,15247,11,7406,1038,6368,18,16,10,8
14542,10,1051,9,186,95,91,2,30,1,1
22197,10,3160,9,180,94,86,2,30,1,1
11126,2857,498,2216,70,70,0,2,7,2,0
11104,10,8842,9,199,94,105,2,30,1,1
13109,1239,12344,919,924,924,0,3,30,3,0
14252,15,3108,11,70,70,0,2,8,2,0
7400,26,9358,16,4900,2781,2119,25,95,13,12
22535,10,17510,9,183,94,89,2,30,1,1
11033,835,28269,614,70,70,0,1,5,1,0
2744,1281,7813,961,883,126,757,2,31,1,1
14763,10,15372,9,253,87,166,4,30,2,2
18033,10,28538,9,168,78,90,2,30,1,1
9,18,1625,13,184,94,90,2,30,1,1
9021,15,16865,11,7800,1743,6057,20,89,11,9
14847,26,2633,16,3325,1067,2258,13,135,6,7
15340,10,11386,9,194,102,92,2,31,1,1
7321,26,19343,16,211720,46699,165021,332,109,152,180
9806,26,4284,16,6518,1200,5318,17,16,8,9
21330,10,14979,9,183,94,89,2,30,1,1
18911,26,10678,16,7477,3022,4455,27,45,15,12
12712,1128,26617,832,70,70,0,2,7,2,0
8826,10,26171,9,193,102,91,2,29,1,1
12739,2296,15093,1780,70,70,0,1,4,1,0
21280,10,1845,9,182,93,89,2,30,1,1
4530,10,5935,9,231,86,145,2,29,1,1
13605,26,1342,16,30123,21849,8274,65,77,38,27
20077,26,27742,16,4507,1600,2907,19,26,11,8
15230,10,376,9,210,110,100,2,30,1,1
16297,26,843,16,9783,5855,3928,22,122,11,11
22083,10,20409,9,200,102,98,2,31,1,1
8928,10,6966,9,184,94,90,2,30,1,1
11362,232,2833,147,3983,1663,2320,40,151,19,21
14205,10,20548,9,199,102,97,2,30,1,1
8901,26,15140,16,6292,1682,4610,21,15,9,12
8155,15,25652,11,1912,1464,448,14,16,7,7
8861,10,5370,9,772,103,669,2,31,1,1
14984,26,2489,16,12470,1570,10900,21,125,10,11
15636,10,12878,9,197,94,103,2,30,1,1
17226,15,12401,11,1291,887,404,8,89,5,3
14485,10,28492,9,196,102,94,2,30,1,1
15486,10,27539,9,247,94,153,2,30,1,1
9621,15,26485,11,648,256,392,8,25,5,3
22023,10,25670,9,211,102,109,2,29,1,1
15228,10,14956,9,78,78,0,1,30,1,0
11048,147,6363,104,70,70,0,2,9,2,0
12767,26,27495,16,499,425,74,4,0,3,1
4819,26,16760,16,2738,1475,1263,19,275,10,9
13804,10,16482,9,212,102,110,2,30,1,1
5484,26,17143,16,4744,1837,2907,19,27,11,8
13541,26,24134,16,313399,38167,275232,411,23,205,206
11163,677,25106,476,70,70,0,2,8,2,0
9074,10,16620,9,218,94,124,2,30,1,1
10549,26,28843,16,43980,3500,40480,65,16,31,34
22035,10,20104,9,177,94,83,2,30,1,1
14826,15,24820,11,44949,1017,43932,48,15,15,33
9105,10,25885,9,193,102,91,2,30,1,1
8603,10,9979,9,199,102,97,2,30,1,1
10875,496,14420,326,316,136,180,6,6,3,3
10930,705,10477,503,316,136,180,6,6,3,3
22496,10,15734,9,758,102,656,2,30,1,1
7051,26,23545,16,6861,2809,4052,33,407,11,22
13675,26,1319,16,5987,1556,4431,19,47,12,7
2724,1240,683,920,422,164,258,6,30,3,3
8781,10,3889,9,276,94,182,2,30,1,1
7593,26,20278,16,4427,1520,2907,19,30,11,8
9135,26,2093,16,62,62,0,1,120,1,0
14705,10,9561,9,177,94,83,2,30,1,1
8558,10,15289,9,398,93,305,4,45,2,2
14303,10,23124,9,764,99,665,2,31,1,1
14882,10,19163,9,168,86,82,2,30,1,1
9745,10,25685,9,760,97,663,2,30,1,1
21347,15,5909,11,314,192,122,6,15,4,2
14447,10,11482,9,86,86,0,2,34,2,0
22076,10,9806,9,223,94,129,2,29,1,1
22179,10,19048,9,751,102,649,2,30,1,1
14304,1394,26333,1060,316,190,126,5,15,3,2
4835,1508,2778,1147,528,528,0,9,1199,9,0
16935,26,12767,16,6796,1541,5255,23,121,11,12
22409,10,20101,9,167,86,81,2,30,1,1
14720,10,19238,9,168,86,82,2,29,1,1
8385,10,9480,9,195,102,93,2,31,1,1
21576,10,5789,9,296,97,199,4,53,2,2
8426,10,12271,9,168,86,82,2,30,1,1
22107,10,3166,9,195,102,93,2,30,1,1
2863,1981,2323,1511,140,78,62,2,30,1,1
15498,10,3033,9,192,98,94,2,30,1,1
9976,15,6537,11,268155,6485,261670,281,25,97,184
636,111,27813,85,324,150,174,2,1200,1,1
18661,26,557,16,478331,21023,457308,573,211,201,372
18398,299,26754,194,2960,432,2528,11,15,6,5
2728,26,17502,16,7362,1770,5592,31,87,16,15
10854,26,29140,16,10841,6594,4247,75,585,37,38
8738,26,16511,16,11583,4967,6616,31,47,17,14
9061,15,6298,11,188,128,60,3,15,2,1
18646,10,19825,9,300,86,214,2,31,1,1
4985,15,23960,11,1114,534,580,12,16,7,5
2064,10,8124,9,216,90,126,2,30,1,1
11271,2649,7877,2057,70,70,0,1,4,1,0
10006,15,14281,11,331828,15003,316825,363,141,140,223
14754,10,20753,9,194,102,92,2,30,1,1
4961,18,26054,13,184,94,90,2,30,1,1
9009,10,26146,9,168,86,82,2,30,1,1
16750,10,10486,9,167,78,89,2,30,1,1
4301,10,15688,9,199,94,105,2,30,1,1
6234,26,19845,16,224,164,60,3,5,2,1
14415,10,24209,9,199,102,97,2,30,1,1
7711,676,17272,475,138,78,60,2,5,1,1
13795,10,21080,9,184,94,90,2,30,1,1
15999,26,13569,16,8287,2469,5818,31,18,14,17
22418,10,22663,9,186,95,91,2,30,1,1
7735,26,18142,16,5789,952,4837,19,150,10,9
8632,10,10044,9,209,110,99,2,30,1,1
17071,15,28882,11,2062,904,1158,10,258,6,4
22036,10,13505,9,565,215,350,6,37,3,3
15483,10,969,9,199,102,97,2,30,1,1
14520,10,1844,9,182,93,89,2,30,1,1
15137,10,1697,9,167,86,81,2,30,1,1
15242,26,2719,16,8057,2037,6020,20,16,11,9
8112,15,8353,11,959,544,415,11,315,6,5
7636,676,13026,475,130,70,60,2,6,1,1
15118,26,3839,16,130,70,60,2,15,1,1
2418,10,9996,9,216,98,118,2,30,1,1
8414,10,2387,9,478,196,282,6,64,3,3
14721,10,9010,9,177,94,83,2,30,1,1
14942,10,6107,9,193,102,91,2,30,1,1
21039,2394,19846,1861,66,66,0,2,8,2,0
9025,26,4766,16,5995,974,5021,19,56,10,9
8301,15,27185,11,1638,1324,314,10,15,5,5
14810,10,18462,9,177,94,83,2,29,1,1
9668,10,23158,9,816,102,714,2,29,1,1
12279,26,10024,16,9953,1605,8348,35,18,19,16
13439,26,27318,16,12507,6114,6393,30,90,18,12
9865,15,18655,11,7550,5292,2258,13,29,7,6
21818,10,18078,9,173,94,79,2,31,1,1
22403,10,17940,9,214,110,104,2,29,1,1
8957,10,16126,9,412,90,322,4,34,2,2
11068,15,22673,11,70,70,0,1,5,1,0
6390,10,27379,9,198,93,105,2,30,1,1
21910,10,21427,9,821,102,719,2,29,1,1
9226,10,3290,9,177,94,83,2,30,1,1
14927,10,7735,9,199,94,105,2,30,1,1
14264,1165,22212,860,320,140,180,6,6,3,3
12041,1316,21314,993,758,320,438,11,20,6,5
21869,10,23814,9,751,94,657,2,30,1,1
14071,10,24413,9,198,90,108,2,30,1,1
14320,844,11090,622,320,140,180,6,7,3,3
16302,26,29080,16,6163,925,5238,18,109,10,8
18856,26,24485,16,7471,2914,4557,26,47,15,11
4506,26,11142,16,9710,2136,7574,26,363,11,15
14460,10,24501,9,177,94,83,2,30,1,1
9249,10,22066,9,164,86,78,2,30,1,1
14360,10,261,9,194,102,92,2,30,1,1
9082,26,21351,16,10385,3107,7278,28,16,16,12
15272,26,22100,16,3593,2749,844,18,22,11,7
14116,10,15647,9,378,97,281,4,33,2,2
18898,26,6042,16,3507,900,2607,13,135,6,7
15342,1723,26937,1315,564,318,246,9,16,5,4
21765,10,15899,9,214,110,104,2,30,1,1
8490,26,27974,16,9802,2846,6956,33,79,15,18
14357,10,1251,9,256,96,160,4,42,2,2
13163,10,6069,9,168,78,90,2,30,1,1
21630,10,3800,9,196,102,94,2,33,1,1
1998,26,7151,16,2227,1018,1209,17,15,8,9
21664,10,2313,9,210,102,108,2,30,1,1
12171,26,13083,16,1786,172,1614,7,119,3,4
4670,26,26969,16,19675,10416,9259,53,81,30,23
2194,10,14792,9,80280,68084,12196,889,90,816,73
9181,10,25720,9,195,102,93,2,31,1,1
8029,233,14544,148,4164,1264,2900,23,1140,13,10
21934,10,16031,9,437,89,348,4,48,2,2
22149,10,18764,9,183,94,89,2,29,1,1
3759,26,3551,16,1402,910,492,11,360,6,5
17941,26,7723,16,182,60,122,4,26,2,2
14205,10,8703,9,199,102,97,2,30,1,1
16297,26,25573,16,4434,1527,2907,19,29,11,8
1731,1863,10027,1421,528,528,0,9,1199,9,0
14120,26,4483,16,5039,2002,3037,14,120,7,7
19659,26,27465,16,4918,1626,3292,17,17,10,7
6083,26,2040,16,1820,1101,719,18,82,10,8
8584,1239,14258,919,259,78,181,2,29,1,1
22666,10,25308,9,183,94,89,2,30,1,1
5084,26,13914,16,13463,5427,8036,24,121,11,13
22710,10,16376,9,167,86,81,2,29,1,1
11898,26,25598,16,10694,4129,6565,41,111,20,21
8918,10,59,9,182,94,88,2,30,1,1
18432,26,11164,16,6052,1841,4211,21,82,10,11
11505,26,5253,16,4307,2005,2302,37,18,20,17
17002,1252,22612,932,70,70,0,2,9,2,0
21702,10,2577,9,174,89,85,2,30,1,1
1219,10,4022,9,220,90,130,2,30,1,1
15465,10,14061,9,199,102,97,2,31,1,1
8810,15,7233,11,2950,601,2349,12,15,6,6
8536,10,7335,9,246,94,152,2,30,1,1
15206,15,11516,11,61771,2713,59058,80,45,35,45
21399,10,13706,9,236,86,150,2,30,1,1
8922,10,6624,9,396,94,302,4,41,2,2
13839,10,1161,9,533,102,431,4,42,2,2
9202,10,27940,9,322,102,220,2,30,1,1
22676,26,25158,16,413465,12290,401175,427,16,150,277
7203,26,12055,16,24785,17234,7551,68,421,36,32
14490,10,10865,9,296,110,186,2,30,1,1
14080,10,21436,9,188,96,92,2,30,1,1
13965,10,2870,9,177,94,83,2,30,1,1
2744,1200,25571,888,889,126,763,2,31,1,1
12459,37,6895,22,70,70,0,2,7,2,0
8383,10,20154,9,316,91,225,4,32,2,2
8955,10,17471,9,177,94,83,2,30,1,1
10224,15,28805,11,14616,6227,8389,32,31,16,16
21372,26,5043,16,6372,1893,4479,15,120,8,7
9304,15,8169,11,78701,4331,74370,77,75,21,56
10479,26,14874,16,7653,1188,6465,21,17,12,9
6628,233,15070,148,3651,1103,2548,17,1802,10,7
21400,10,3374,9,198,101,97,2,31,1,1
8977,26,25264,16,6503,2037,4466,24,125,13,11
15248,10,5408,9,183,94,89,2,30,1,1
12106,26,9001,16,6058,1038,5020,20,66,11,9
12300,233,4312,148,134,60,74,3,4,2,1
14639,10,12713,9,168,94,74,2,31,1,1
17152,26,10936,16,3723,1793,1930,21,69,10,11
15399,26,5597,16,18356,13354,5002,47,34,29,18
5585,15,2164,11,2437,1277,1160,12,16,7,5
13805,10,12427,9,200,102,98,2,30,1,1
22256,10,16891,9,645,185,460,6,40,3,3
22334,26,11207,16,3055,1759,1296,22,126,12,10
8761,10,7066,9,176,90,86,2,30,1,1
15305,10,19739,9,210,110,100,2,30,1,1
22197,1266,5749,946,1764,924,840,6,31,3,3
15377,10,3713,9,753,93,660,2,31,1,1
9644,15,106,11,318,192,126,6,25,4,2
10200,26,13711,16,6653,3225,3428,18,135,9,9
11178,26,14468,16,375357,11451,363906,356,61,100,256
22171,10,28099,9,245,102,143,2,31,1,1
19112,26,24556,16,12854,2237,10617,47,638,19,28
10718,15,16712,11,1517,481,1036,11,15,6,5
6350,26,4137,16,117381,60398,56983,518,4126,256,262
9411,1710,13421,1306,480,149,331,2,1200,1,1
21526,10,18880,9,168,86,82,2,30,1,1
8842,10,10982,9,216,110,106,2,30,1,1
18647,10,0,0,344,94,250,2,30,1,1
3845,26,14675,16,13074,2439,10635,46,279,22,24
14571,10,15906,9,193,102,91,2,30,1,1
10741,45,1792,28,70,70,0,1,5,1,0
5732,26,17556,16,4624,1717,2907,19,28,11,8
22265,10,1932,9,199,102,97,2,30,1,1
7519,234,25627,149,1410,933,477,11,3601,6,5
8327,2627,15695,2037,800,150,650,4,1200,2,2
18939,26,2451,16,59999,8737,51262,95,18,43,52
8665,26,341,16,5541,2623,2918,28,144,15,13
15462,10,11644,9,206,105,101,2,31,1,1
9536,346,21945,220,8962,4731,4231,26,75,14,12
11236,3017,9665,2345,316,136,180,6,9,3,3
22414,10,19853,9,196,102,94,2,30,1,1
14283,10,18957,9,754,94,660,2,31,1,1
5484,26,11499,16,7425,2276,5149,24,16,12,12
4507,26,15934,16,4637,1730,2907,19,30,11,8
8584,1242,22016,922,71,71,0,1,30,1,0
6289,26,22589,16,13108,2630,10478,26,120,12,14
18248,232,15756,147,908,650,258,11,20,7,4
14667,10,26468,9,294,102,192,2,30,1,1
6542,26,10409,16,2088188,38201,2049987,1829,84,404,1425
15100,10,24212,9,177,94,83,2,30,1,1
15219,26,23371,16,3079,1895,1184,18,16,10,8
14937,10,27454,9,184,102,82,2,30,1,1
16791,26,28603,16,15305,3334,11971,45,198,21,24
15866,26,18219,16,134,60,74,3,6,2,1
13920,10,10662,9,213,94,119,2,30,1,1
14091,10,10654,9,209,110,99,2,30,1,1
15909,10,15017,9,816,102,714,2,30,1,1
15377,26,2715,16,8072,2052,6020,20,15,11,9
8329,10,27426,9,371,94,277,2,29,1,1
15888,10,11814,9,164,86,78,2,30,1,1
1219,53,5014,36,490,149,341,2,1200,1,1
9000,10,26167,9,327,102,225,2,30,1,1
2724,1240,15355,920,422,164,258,6,29,3,3
10284,26,12120,16,13341,4805,8536,88,378,42,46
11176,15,9428,11,1868,1374,494,12,16,7,5
21843,26,1776,16,5505,3166,2339,22,136,11,11
21324,2257,28692,1747,66,66,0,2,8,2,0
8822,26,21783,16,11810,2769,9041,29,47,15,14
8031,26,20933,16,4743,1836,2907,19,26,11,8
11277,26,22860,16,948720,23674,925046,988,26,349,639
11123,15,2894,11,3019,716,2303,12,23,7,5
3485,26,3008,16,7418,1880,5538,28,396,9,19
2974,10,12222,9,404,259,145,3,32,2,1
15688,10,17368,9,745,93,652,2,30,1,1
22371,10,2791,9,185,102,83,2,31,1,1
11209,642,9555,446,70,70,0,1,5,1,0
2744,1455,17815,1108,881,126,755,2,31,1,1
18579,10,13576,9,198,86,112,2,30,1,1
2811,26,13736,16,10099,1635,8464,31,83,14,17
6500,26,4440,16,3117,1867,1250,19,16,9,10
18058,15,26584,11,16324,808,15516,25,59,11,14
13123,26,5434,16,3176,752,2424,10,121,5,5
11240,702,23652,500,70,70,0,2,8,2,0
3828,10,14877,9,414,268,146,3,33,2,1
1785,26,925,16,7525,1098,6427,22,16,12,10
1199,26,8830,16,10940,4625,6315,36,347,19,17
712,10,2811,9,244,98,146,2,32,1,1
10834,10,22660,9,247,98,149,2,33,1,1
14960,10,26308,9,166,86,80,2,30,1,1
10125,26,26962,16,12654,1719,10935,28,21,15,13
22581,10,28874,9,387,134,253,2,30,1,1
17179,26,18693,16,10439,1785,8654,25,85,10,15
22055,10,15112,9,195,102,93,2,31,1,1
17688,26,1981,16,6285,1545,4740,22,17,12,10
15203,15,17682,11,1359,435,924,13,30,7,6
21768,10,25305,9,194,102,92,2,30,1,1
4575,26,22929,16,4734755,152171,4582584,5334,405,2083,3251
9728,3161,22366,2449,166,166,0,1,1200,1,0
8661,26,19096,16,9037,3596,5441,36,321,19,17
10599,26,19480,16,876,390,486,12,39,4,8
9887,26,22675,16,6811,1923,4888,21,15,11,10
3542,10,27984,9,168,78,90,2,30,1,1
13277,26,16390,16,3766,1654,2112,10,120,5,5
4407,10,15798,9,237,93,144,2,31,1,1
3597,232,4101,147,74654,9673,64981,221,616,106,115
2360,26,9434,16,2227,1018,1209,17,15,8,9
4103,26,18922,16,6824,1142,5682,24,134,13,11
14815,10,4961,9,284,96,188,4,33,2,2
22509,10,17119,9,225,110,115,2,30,1,1
14261,10,11251,9,793,101,692,2,31,1,1
22703,10,7199,9,177,94,83,2,29,1,1
7401,26,16347,16,190,70,120,4,16,2,2
605,26,16978,16,2227,1018,1209,17,16,8,9
3395,26,16428,16,14244,2907,11337,33,17,17,16
5964,10,28022,9,202,83,119,2,30,1,1
2744,92,20184,72,855,126,729,2,30,1,1
8539,10,26040,9,216,110,106,2,30,1,1
21298,10,8825,9,190,97,93,2,30,1,1
2744,1452,19567,1105,890,126,764,2,31,1,1
11076,3038,15930,2362,70,70,0,2,7,2,0
22300,10,26340,9,630,204,426,6,64,3,3
13077,18,14087,13,184,94,90,2,30,1,1
21545,10,8602,9,178,91,87,2,31,1,1
14607,10,21362,9,177,94,83,2,30,1,1
12224,26,28093,16,2950,679,2271,13,120,6,7
17308,26,9972,16,12676,4222,8454,36,87,20,16
18890,26,14668,16,3855,2679,1176,28,45,15,13
22060,26,20360,16,5467,2738,2729,23,137,11,12
21847,10,8985,9,198,102,96,2,30,1,1
14862,10,23802,9,177,94,83,2,30,1,1
14164,10,23965,9,183,94,89,2,29,1,1
21251,2147,24294,1659,504,382,122,8,15,6,2
21694,10,27202,9,293,110,183,2,29,1,1
13153,15,7370,11,3517,1612,1905,17,186,10,7
13129,26,12843,16,12594,5098,7496,32,36,17,15
14355,10,20737,9,701,88,613,2,31,1,1
30,10,13,9,644,90,554,2,30,1,1
8823,15,24409,11,1278,774,504,12,361,7,5
8999,10,2559,9,817,102,715,2,30,1,1
8930,10,22197,9,199,102,97,2,30,1,1
7586,26,7049,16,7087,746,6341,16,15,9,7
10770,1796,1871,1370,136,136,0,3,14,3,0
14909,10,27835,9,177,94,83,2,30,1,1
4413,15,3696,11,235873,12126,223747,306,31,154,152
13388,26,27540,16,175780,7700,168080,196,36,78,118
19263,15,18695,11,1931,752,1179,15,16,8,7
9853,15,8377,11,708,384,324,12,195,7,5
8197,15,21168,11,560,264,296,9,44,5,4
22409,10,3514,9,762,98,664,2,30,1,1
22359,10,9067,9,295,103,192,4,48,2,2
21486,26,110,16,24320,6711,17609,45,122,20,25
13978,10,14017,9,184,94,90,2,31,1,1
10473,26,15116,16,200230,8733,191497,250,122,106,144
14993,10,14412,9,178,94,84,2,31,1,1
15093,26,25059,16,5083,969,4114,18,32,10,8
8105,10,1139,9,168,78,90,2,30,1,1
4299,26,23940,16,1149,709,440,13,39,8,5
9728,287,26421,184,161,161,0,2,1200,2,0
15771,10,3318,9,258,110,148,2,30,1,1
2724,1240,22093,920,422,164,258,6,30,3,3
14418,10,15498,9,196,102,94,2,30,1,1
14918,10,6365,9,489,88,401,4,46,2,2
22097,10,1107,9,195,102,93,2,30,1,1
15348,15,6742,11,1462,703,759,8,16,5,3
8816,15,2088,11,318,192,126,6,41,4,2
13957,10,26424,9,244,94,150,2,31,1,1
8529,26,14449,16,9551,6129,3422,35,47,19,16
20414,40,15554,23,8257,4187,4070,70,43,42,28
13970,10,6693,9,206,105,101,2,31,1,1
9158,10,14351,9,86,86,0,1,29,1,0
8667,10,28193,9,193,102,91,2,31,1,1
22670,10,12042,9,168,86,82,2,31,1,1
22488,10,27018,9,335,97,238,4,31,2,2
7882,26,10157,16,23751,3197,20554,42,170,19,23
10656,26,10419,16,3330,2281,1049,17,16,9,8
10850,2748,22993,2129,70,70,0,1,5,1,0
8668,15,9231,11,2300864,53111,2247753,2242,18,755,1487
3358,26,16945,16,35031,3490,31541,60,363,28,32
21771,10,2471,9,363,94,269,2,30,1,1
19206,10,27202,9,197,76,121,2,30,1,1
8518,26,22051,16,11389,1184,10205,22,76,9,13
8929,26,20723,16,12767,8343,4424,31,122,17,14
19027,26,27105,16,5830,2583,3247,22,40,13,9
5305,10,2897,9,199,94,105,2,30,1,1
22275,10,9574,9,327,102,225,2,30,1,1
6800,26,11409,16,6109,3363,2746,60,615,33,27
6690,183,18912,121,3910,1805,2105,20,19,12,8
1521,10,5399,9,227,88,139,2,31,1,1
8377,1681,23276,1286,70,70,0,2,8,2,0
15466,10,8967,9,177,94,83,2,30,1,1
21958,10,23047,9,189,102,87,2,30,1,1
10792,575,19058,389,70,70,0,2,8,2,0
636,281,20080,178,324,150,174,2,1200,1,1
22252,10,2998,9,213,94,119,2,29,1,1
21938,10,13927,9,210,102,108,2,30,1,1
21797,26,10297,16,24984,2042,22942,41,32,19,22
3382,26,3537,16,1067,650,417,10,27,6,4
16513,15,10779,11,318,192,126,6,21,4,2
15178,26,8285,16,7890,1901,5989,20,16,11,9
15097,10,28256,9,166,85,81,2,31,1,1
10111,26,12872,16,8227,3496,4731,20,82,11,9
15942,15,16076,11,2546,1294,1252,17,138,9,8
14540,26,24836,16,6271,1354,4917,25,113,14,11
16930,26,13893,16,6345,1545,4800,23,18,12,11
9728,2469,2691,1920,161,161,0,1,1200,1,0
6066,26,23410,16,5379,1424,3955,19,507,11,8
14248,10,15508,9,178,94,84,2,31,1,1
15392,2478,9937,1927,130,70,60,2,5,1,1
17836,183,26475,121,4134,2109,2025,18,17,9,9
1337,2011,10842,1541,148,86,62,2,30,1,1
12758,26,6937,16,499,425,74,4,0,3,1
11561,10,16412,9,338,94,244,2,29,1,1
9752,26,2150,16,5039,2265,2774,21,30,11,10
7151,26,3339,16,8798,1667,7131,25,22,14,11
6825,26,24563,16,8241,1810,6431,25,20,14,11
8584,1238,5273,918,271,78,193,2,31,1,1
8831,10,4967,9,194,99,95,2,30,1,1
9732,26,3337,16,2460,1267,1193,16,98,9,7
12880,26,4202,16,34629391,1109219,33520172,36863,278,12240,24623
15152,26,4883,16,6971,1510,5461,21,80,11,10
18382,18,2421,13,184,94,90,2,30,1,1
636,2627,15224,2037,475,150,325,2,1200,1,1
5610,26,10332,16,10196,2175,8021,25,186,14,11
12621,1808,464,1378,70,70,0,1,5,1,0
16021,1198,26726,886,1320,1320,0,21,1624,21,0
8558,15,5669,11,156587,46628,109959,307,314,203,104
11332,15,22903,11,450,246,204,8,29,5,3
11467,26,13416,16,7985,2085,5900,18,121,8,10
11250,3261,18859,2526,70,70,0,2,8,2,0
12658,690,10887,489,164,70,94,2,4,1,1
9785,26,11602,16,1473,890,583,13,140,7,6
10503,26,4387,16,1048,1048,0,9,16,9,0
14193,10,21892,9,775,103,672,2,30,1,1
527,15,1943,11,514,246,268,9,91,5,4
15855,10,24223,9,323,110,213,2,30,1,1
14327,10,8794,9,211,102,109,2,29,1,1
1062,26,17638,16,6092,775,5317,17,25,9,8
14977,10,15900,9,183,94,89,2,30,1,1
16837,10,5384,9,332,102,230,2,29,1,1
13725,10,11868,9,711,87,624,2,30,1,1
4544,26,28260,16,1622,1137,485,11,26,7,4
3926,26,3087,16,234,234,0,4,12,4,0
8957,26,3276,16,6057,767,5290,16,126,8,8
9728,1203,20481,890,161,161,0,2,1199,2,0
13397,234,10618,149,6679,2730,3949,43,4309,23,20
4497,26,15913,16,4510,1603,2907,19,28,11,8
15391,26,6643,16,7956,1967,5989,20,15,11,9
14905,10,8792,9,166,86,80,2,29,1,1
20269,26,19020,16,266781,12334,254447,323,161,119,204
13066,15,2064,11,6006,861,5145,18,19,10,8
18475,583,3525,395,70,70,0,1,5,1,0
9745,15,22067,11,4206,3273,933,17,19,9,8
21243,10,20081,9,262,86,176,4,46,2,2
14566,10,14577,9,178,94,84,2,30,1,1
20445,26,8705,16,1304,612,692,18,120,9,9
13643,15,16478,11,8159037,271621,7887416,9644,214,4424,5220
10263,10,22441,9,167,78,89,2,30,1,1
9388,10,10780,9,728,102,626,2,30,1,1
3398,26,1184,16,7279,2884,4395,28,16,16,12
2158,10,8690,9,295,90,205,2,30,1,1
20532,10,16877,9,304,86,218,2,30,1,1
13522,26,21603,16,5860,1151,4709,18,283,10,8
6763,26,24158,16,12666,4180,8486,37,504,20,17
21597,10,19963,9,286,102,184,4,45,2,2
13424,26,24050,16,32709,8467,24242,54,20,29,25
18370,15,4574,11,4419,3852,567,15,144,8,7
14335,10,23957,9,811,94,717,2,30,1,1
105,10,183,9,194,87,107,2,30,1,1
22595,10,5685,9,256,94,162,2,30,1,1
3830,26,1462,16,284320,14149,270171,398,244,203,195
15098,10,3564,9,177,94,83,2,29,1,1
17306,26,13350,16,27298,11122,16176,59,31,30,29
6349,26,9367,16,5559,1639,3920,21,186,12,9
12462,43,7934,26,320,140,180,6,7,3,3
6958,26,28924,16,4419,3179,1240,17,17,10,7
8913,26,9190,16,7087,1705,5382,19,128,10,9
16718,10,18028,9,352,78,274,2,30,1,1
13946,10,22869,9,1448,103,1345,4,54,2,2
8210,283,21194,180,328,152,176,2,1200,1,1
9186,15,4645,11,10023148,180272,9842876,9438,193,2907,6531
11240,15,12768,11,372,246,126,6,30,4,2
9409,10,9976,9,172,94,78,2,30,1,1
22187,10,15092,9,229,102,127,2,30,1,1
13620,10,9632,9,170,87,83,3,32,2,1
5259,26,13179,16,10831,1381,9450,22,20,12,10
6532,26,14747,16,4550611,95139,4455472,4046,217,935,3111
17122,26,17637,16,3594,1787,1807,31,163,17,14
8420,10,19050,9,199,102,97,2,30,1,1
9014,10,20303,9,166,86,80,2,30,1,1
10284,26,5564,16,13772,1738,12034,26,31,12,14
12573,2039,21098,1566,70,70,0,1,4,1,0
21991,15,11169,11,18045,3544,14501,28,156,12,16
14599,10,14335,9,194,94,100,2,30,1,1
21485,10,25274,9,199,94,105,2,30,1,1
9718,15,6294,11,61763,2941,58822,75,135,33,42
10550,26,5197,16,49843,3506,46337,77,16,39,38
11117,2698,6384,2095,136,136,0,3,14,3,0
4585,15,4586,11,1221,781,440,11,16,6,5
8641,10,12851,9,819,102,717,2,30,1,1
22549,10,26991,9,197,94,103,2,31,1,1
22117,10,18918,9,199,102,97,2,30,1,1
20211,26,7367,16,6990,2057,4933,19,121,9,10
12559,26,23889,16,3225,1939,1286,26,139,14,12
15505,10,18719,9,172,94,78,2,29,1,1
10830,26,1005,16,36048,2364,33684,54,28,23,31
22491,10,2816,9,184,102,82,2,30,1,1
5315,26,26975,16,7691,1999,5692,35,256,18,17
11701,26,451,16,8083,1790,6293,27,150,14,13
8030,15,9134,11,946,531,415,11,315,6,5
8766,10,9736,9,243,94,149,2,30,1,1
15201,15,19175,11,234,234,0,4,12,4,0
18153,6,26631,6,7974,3469,4505,57,40,28,29
15129,10,5726,9,198,101,97,2,30,1,1
2724,1240,2231,920,422,164,258,6,30,3,3
15326,15,24048,11,1462,703,759,8,16,5,3
17756,26,766,16,7762,1777,5985,22,80,13,9
7589,10,20269,9,314,98,216,2,29,1,1
9095,10,682,9,195,102,93,2,30,1,1
21698,10,1685,9,292,102,190,2,30,1,1
11902,26,14720,16,57778,2562,55216,73,200,29,44
6627,26,3903,16,224,164,60,3,5,2,1
14379,10,19361,9,200,102,98,2,30,1,1
15344,10,11027,9,195,102,93,2,30,1,1
8834,15,18901,11,318,192,126,6,41,4,2
15129,10,20202,9,199,102,97,2,30,1,1
8838,26,14633,16,10080,2728,7352,28,188,14,14
12159,26,23951,16,12757,4360,8397,41,17,23,18
8711,26,18972,16,6606,936,5670,17,23,9,8
8488,10,19958,9,184,94,90,2,30,1,1
14375,26,17113,16,21446,1599,19847,35,154,16,19
10688,15,20000,11,318,192,126,6,37,4,2
9384,10,23546,9,183,94,89,2,31,1,1
3865,26,6561,16,70,70,0,1,5,1,0
22651,10,7670,9,98,98,0,1,30,1,0
4835,1680,20320,1285,1548,265,1283,4,1200,2,2
3686,10,19784,9,168,78,90,2,30,1,1
6916,26,6146,16,6502,1347,5155,31,1195,10,21
14703,10,10103,9,194,102,92,2,30,1,1
16151,26,17556,16,9315,2153,7162,23,127,6,17
2262,15,9297,11,490,264,226,8,30,5,3
8658,10,19237,9,199,102,97,2,30,1,1
17171,26,10242,16,405189,13572,391617,446,89,155,291
9509,26,8138,16,712,374,338,11,28,6,5
8652,10,17662,9,177,94,83,2,31,1,1
2724,1240,24561,920,20322,11404,8918,118,133,67,51
14707,10,19723,9,179,94,85,2,30,1,1
14401,345,8885,219,70,70,0,1,5,1,0
18837,10,27004,9,220,90,130,2,30,1,1
14596,10,14767,9,301,80,221,2,31,1,1
2744,1238,13669,918,1634,126,1508,4,31,2,2
9434,10,13110,9,764,102,662,2,30,1,1
8734,10,7245,9,214,102,112,2,30,1,1
1642,26,13913,16,2556,1470,1086,17,16,8,9
3640,10,14602,9,227,106,121,2,30,1,1
795,10,8850,9,80361,77433,2928,946,89,930,16
13135,10,6875,9,578,286,292,9,16,5,4
10809,2526,10322,1962,70,70,0,2,8,2,0
11255,1551,9528,1182,70,70,0,2,8,2,0
15227,15,19223,11,9012,4718,4294,43,81,21,22
13878,10,3193,9,177,94,83,2,30,1,1
14728,10,27543,9,183,94,89,2,31,1,1
13965,10,16966,9,177,94,83,2,29,1,1
15190,26,2222,16,22938,14436,8502,43,41,23,20
9990,183,22203,121,3613,1594,2019,19,18,10,9
8584,1240,18898,920,259,71,188,2,31,1,1
8700,10,14234,9,186,95,91,2,31,1,1
21671,10,2188,9,289,101,188,4,50,2,2
10793,1698,4354,1297,70,70,0,2,8,2,0
3565,10,14477,9,404,259,145,3,32,2,1
10166,26,12145,16,17469,2444,15025,39,207,17,22
10763,1496,21256,1137,70,70,0,2,8,2,0
22032,10,9950,9,199,102,97,2,29,1,1
14915,10,17641,9,209,110,99,2,30,1,1
14009,10,17953,9,168,86,82,2,30,1,1
8384,10,19684,9,282,93,189,4,45,2,2
16159,15,16922,11,1115,534,581,12,16,7,5
21342,10,10900,9,331,102,229,2,30,1,1
20427,26,3303,16,46033,7524,38509,103,141,49,54
4023,10,15185,9,217,87,130,2,30,1,1
17754,26,5755,16,2150,1280,870,18,832,10,8
15302,10,1539,9,250,86,164,4,46,2,2
7863,15,16869,11,3524,2698,826,14,16,8,6
12653,1969,7865,1503,320,140,180,6,5,3,3
16444,188,3365,123,312,140,172,4,30,2,2
14905,10,0,0,166,73,93,2,31,1,1
11199,3034,22187,2359,70,70,0,2,8,2,0
12941,26,4540,16,147104,9481,137623,217,115,111,106
10994,64,11272,47,70,70,0,1,4,1,0
10215,15,22488,11,3374,1914,1460,33,131,18,15
21843,10,24417,9,168,86,82,2,30,1,1
2744,1238,8050,918,880,126,754,2,30,1,1
8584,1273,13532,953,269,78,191,2,30,1,1
15150,10,3927,9,275,94,181,2,30,1,1
14715,10,15869,9,212,102,110,2,30,1,1
2724,1240,13814,920,422,164,258,6,30,3,3
10859,2358,10331,1836,66,66,0,1,5,1,0
13649,26,18334,16,13281,4753,8528,32,17,18,14
10862,26,8886,16,2831,740,2091,11,120,5,6
17554,15,26320,11,32527,13068,19459,56,15,21,35
10759,3180,5334,2466,70,70,0,2,8,2,0
10991,2030,8171,1558,70,70,0,2,8,2,0
10511,26,4860,16,6957,1775,5182,22,17,12,10
9454,10,12354,9,193,102,91,2,29,1,1
9708,26,28726,16,1894028,31411,1862617,1579,122,209,1370
17948,26,15373,16,1394,733,661,14,80,8,6
15279,10,18954,9,194,102,92,2,29,1,1
21350,44,10162,27,70,70,0,1,4,1,0
4927,26,16442,16,4653,1746,2907,19,26,11,8
9024,10,28114,9,184,102,82,2,30,1,1
21327,10,12902,9,1114,468,646,12,67,6,6
10616,26,5322,16,9753,2821,6932,39,201,22,17
5007,26,12720,16,53562,2314,51248,64,31,24,40
5730,26,22413,16,10293,1331,8962,22,255,12,10
17027,26,6088,16,26922,13251,13671,50,18,26,24
9799,15,1718,11,91198,3990,87208,113,19,49,64
11122,26,7606,16,13078,7055,6023,114,162,59,55
2724,1240,19989,920,422,164,258,6,30,3,3
10384,26,22415,16,4334,1427,2907,19,27,11,8
9679,15,11426,11,36985,3992,32993,56,151,25,31
20529,26,10382,16,304,86,218,2,30,1,1
7502,26,9860,16,493,280,213,8,97,5,3
14945,26,12144,16,10427,6311,4116,33,234,20,13
6672,26,17110,16,8761,2571,6190,24,17,14,10
15190,10,25747,9,170,87,83,2,30,1,1
2744,1242,9737,922,873,126,747,2,31,1,1
15350,10,27813,9,200,94,106,2,29,1,1
15197,10,23853,9,214,110,104,2,30,1,1
4315,26,19147,16,234,234,0,4,12,4,0
4214,26,15481,16,228681,29484,199197,303,110,149,154
22619,26,2687,16,14203,1525,12678,13,143,2,11
14152,10,25978,9,194,102,92,2,29,1,1
1665,26,6008,16,254281,66535,187746,336,317,183,153
4773,10,4947,9,86,86,0,1,30,1,0
7334,234,5484,149,7528,1416,6112,29,811,11,18
9996,15,1252,11,1888,1814,74,10,15,9,1
4289,15,25875,11,78,78,0,1,5,1,0
18897,26,1909,16,46690,9390,37300,77,54,36,41
2744,1239,3533,919,881,126,755,2,30,1,1
9411,2296,19949,1780,402,132,270,6,1209,3,3
9386,10,13466,9,183,94,89,2,31,1,1
22320,10,11604,9,196,102,94,2,31,1,1
3383,26,4690,16,67123,10708,56415,100,124,41,59
11788,26,1979,16,110507,3940,106567,129,118,37,92
235,26,598,16,8209,1695,6514,21,23,13,8
9034,26,8740,16,6062,1042,5020,20,55,11,9
8397,10,361,9,168,86,82,2,31,1,1
15424,1088,1413,798,70,70,0,2,8,2,0
4266,295,15576,190,3638,2027,1611,17,15,9,8
9519,26,8292,16,4707,865,3842,17,30,9,8
7079,26,23727,16,7794,2844,4950,26,29,16,10
12428,3158,25295,2448,70,70,0,1,5,1,0
11065,1815,20171,1384,70,70,0,2,9,2,0
8458,10,8986,9,771,102,669,2,30,1,1
6284,26,6689,16,8561,2300,6261,37,316,18,19
15076,26,4669,16,1343,763,580,14,26,8,6
1148,10,3876,9,244,98,146,2,32,1,1
8430,10,18913,9,178,94,84,2,30,1,1
2744,1240,17693,920,600,126,474,2,31,1,1
7108,234,16361,149,9107,2358,6749,24,3600,13,11
14257,10,19360,9,168,86,82,2,31,1,1
10060,15,15795,11,875,518,357,10,75,6,4
14263,10,5562,9,177,94,83,2,30,1,1
3336,26,8906,16,11414,6355,5059,30,40,15,15
12601,18,24182,13,184,94,90,2,30,1,1
8499,10,15370,9,276,118,158,2,30,1,1
8545,10,14395,9,179,86,93,2,30,1,1
9137,10,12228,9,747,93,654,2,30,1,1
14233,10,3096,9,190,97,93,2,31,1,1
11915,15,23231,11,258732,4788,253944,268,25,71,197
15240,15,18208,11,234,234,0,4,12,4,0
14969,26,14740,16,70,70,0,1,5,1,0
12321,10,12594,9,168,78,90,2,30,1,1
13822,10,25249,9,195,102,93,2,30,1,1
8638,10,16246,9,210,110,100,2,30,1,1
9522,10,4436,9,199,102,97,2,29,1,1
15354,10,1979,9,173,94,79,2,30,1,1
14440,10,8757,9,775,103,672,2,31,1,1
11543,15,23036,11,1899,1310,589,12,48,6,6
16021,1297,5652,975,4212,2724,1488,57,2411,33,24
932,26,21963,16,4941,429,4512,12,15,6,6
8775,10,8557,9,177,94,83,2,29,1,1
8952,26,4134,16,8941,1816,7125,27,15,15,12
21398,10,6818,9,325,102,223,2,30,1,1
14261,2795,13378,2168,504,318,186,8,15,5,3
11859,26,5429,16,628801,19603,609198,708,114,227,481
21536,10,283,9,337,110,227,2,30,1,1
13908,10,9164,9,193,102,91,2,30,1,1
15298,26,503,16,7889,1900,5989,20,15,11,9
15292,10,25560,9,183,94,89,2,29,1,1
18724,26,11669,16,5166,1989,3177,15,122,7,8
21295,10,4230,9,229,94,135,2,30,1,1
9261,10,8973,9,168,86,82,2,30,1,1
2744,1238,5093,918,887,126,761,2,30,1,1
14482,10,19736,9,732,89,643,2,30,1,1
4039,26,18258,16,2350,1392,958,17,275,9,8
11106,1401,18255,1064,70,70,0,2,8,2,0
22176,10,8641,9,194,99,95,2,31,1,1
3555,26,28704,16,6495,1547,4948,19,318,10,9
21865,10,14108,9,215,102,113,2,29,1,1
12765,3118,16,2420,70,70,0,1,4,1,0
722,15,2881,11,34707,1796,32911,45,45,20,25
14689,10,13941,9,738,86,652,2,31,1,1
8498,10,16228,9,182,94,88,2,30,1,1
15500,10,7986,9,182,93,89,2,31,1,1
11839,26,8434,16,5584,1390,4194,19,15,9,10
8878,10,1083,9,178,94,84,2,30,1,1
11212,10,14858,9,199,94,105,2,30,1,1
22671,26,11365,16,6762,3351,3411,31,160,14,17
18697,10,24052,9,278,102,176,2,31,1,1
17100,26,2001,16,3874,2470,1404,17,15,9,8
8335,26,5582,16,519325,13798,505527,535,18,193,342
17224,26,5542,16,7783,2690,5093,24,255,13,11
3066,649,26946,453,868,150,718,4,1200,2,2
20961,26,17666,16,8640,5157,3483,17,120,10,7
15461,26,13631,16,15807,12220,3587,44,242,18,26
8487,10,18297,9,331,90,241,4,38,2,2
11219,26,10957,16,4688,3009,1679,33,80,17,16
12820,1107,24192,812,70,70,0,1,4,1,0
3267,15,23940,11,1412,848,564,14,316,8,6
8668,10,1847,9,193,102,91,2,30,1,1
22721,10,14421,9,196,102,94,2,30,1,1
14943,10,21493,9,195,102,93,2,30,1,1
7849,26,28938,16,5447,1074,4373,21,17,10,11
14290,10,22509,9,753,93,660,2,31,1,1
9185,15,14398,11,10026538,185017,9841521,9515,195,2989,6526
6397,26,22797,16,130,70,60,2,15,1,1
12369,2276,11578,1762,70,70,0,1,5,1,0
22274,15,28942,11,874843,22526,852317,878,44,304,574
11730,26,26351,16,4913,751,4162,18,28,8,10
8621,10,18365,9,1750,184,1566,6,85,3,3
20565,26,3331,16,4771341,155341,4616000,5024,147,1667,3357
7555,407,20225,264,124,60,64,2,5,1,1
21441,10,7242,9,179,94,85,2,30,1,1
15623,10,11128,9,177,94,83,2,30,1,1
16522,26,6763,16,5041,2002,3039,14,120,7,7
13225,26,85,16,3885,2355,1530,26,270,13,13
11140,1769,12806,1350,66,66,0,1,5,1,0
15447,10,4592,9,184,94,90,2,29,1,1
14237,1972,26842,1505,70,70,0,1,5,1,0
17944,26,1984,16,302,120,182,6,28,3,3
12972,26,29003,16,9464,1751,7713,29,48,13,16
9672,15,12387,11,1658,1247,411,8,16,5,3
18561,2627,28176,2037,70,70,0,1,5,1,0
8515,10,8837,9,749,94,655,2,30,1,1
21979,10,4625,9,339,134,205,2,30,1,1
15867,26,18243,16,134,60,74,3,6,2,1
14213,2448,7659,1901,70,70,0,1,5,1,0
9749,26,7908,16,13409,3033,10376,29,124,15,14
3998,349,19661,222,78,78,0,1,4,1,0
12635,26,12529,16,499,425,74,4,0,3,1
9077,10,22092,9,216,110,106,2,31,1,1
6250,1994,4999,1524,140,78,62,2,31,1,1
22041,10,23379,9,198,94,104,2,30,1,1
21993,10,28096,9,93,93,0,1,31,1,0
3540,26,849,16,16120,8754,7366,36,327,21,15
11348,10,5102,9,294,86,208,2,30,1,1
14476,10,21483,9,196,102,94,2,30,1,1
13852,10,21581,9,196,94,102,2,30,1,1
18094,10,26603,9,86,86,0,1,29,1,0
15181,10,7031,9,762,97,665,2,31,1,1
17131,26,1841,16,8004,2236,5768,41,18,23,18
5978,10,17939,9,218,90,128,2,30,1,1
22320,10,6184,9,196,102,94,2,29,1,1
8842,10,8025,9,216,110,106,2,30,1,1
8703,10,17802,9,686,276,410,8,74,4,4
8724,10,12995,9,184,94,90,2,30,1,1
15124,10,2579,9,198,101,97,2,31,1,1
14765,26,14200,16,1310,649,661,13,185,7,6
21232,10,18235,9,358,105,253,4,44,2,2
12554,281,16081,178,70,70,0,2,7,2,0
15857,10,26105,9,184,94,90,2,31,1,1
13992,10,12111,9,168,94,74,2,30,1,1
14402,10,11238,9,271,93,178,4,30,2,2
8361,26,1927,16,605037,246018,359019,1735,1300,846,889
10102,15,25279,11,314164,13077,301087,356,25,144,212
21635,26,1573,16,3677,1168,2509,17,120,8,9
7878,10,20704,9,200,90,110,2,30,1,1
15762,26,3129,16,1728,1153,575,12,28,7,5
12121,26,23333,16,1270,697,573,15,33,8,7
22512,10,20471,9,285,103,182,4,44,2,2
4466,15,18766,11,5733,3036,2697,25,235,9,16
2889,26,25711,16,5780,4574,1206,20,16,11,9
14567,10,17640,9,177,94,83,2,30,1,1
2863,1984,3782,1514,148,86,62,2,30,1,1
15270,10,25382,9,776,102,674,2,30,1,1
13654,10,13369,9,193,102,91,2,29,1,1
10475,26,25616,16,8292,2164,6128,31,120,17,14
15570,10,27671,9,86,86,0,1,30,1,0
18943,10,9256,9,168,78,90,2,30,1,1
11353,26,21431,16,5670,2739,2931,18,129,9,9
17146,26,25909,16,7680,4905,2775,24,17,12,12
17700,26,12065,16,448,78,370,6,24,1,5
10682,15,16154,11,974005,25912,948093,1003,32,361,642
17917,26,15026,16,5678,2820,2858,25,141,11,14
12546,26,23513,16,499,425,74,4,0,3,1
9067,26,4426,16,355761,14847,340914,423,33,183,240
5775,373,17627,241,156,156,0,3,8,3,0
6703,26,3323,16,19123,2319,16804,39,28,21,18
13880,10,1793,9,177,94,83,2,29,1,1
14288,10,16141,9,757,98,659,2,30,1,1
9355,15,21092,11,1221,781,440,11,14,6,5
8635,26,18783,16,8779,3672,5107,17,119,8,9
15827,26,15423,16,9415,3482,5933,57,16,29,28
14271,10,22913,9,183,94,89,2,29,1,1
18904,10,13432,9,181,86,95,2,30,1,1
15078,10,14771,9,198,101,97,2,31,1,1
6357,26,9478,16,10548,2689,7859,38,24,19,19
15167,10,10391,9,200,102,98,2,30,1,1
15275,26,5320,16,8059,2039,6020,20,16,11,9
15929,26,16325,16,4612,700,3912,12,15,8,4
4267,26,19718,16,14212,8194,6018,38,104,21,17
11208,1506,17330,1146,70,70,0,2,7,2,0
9099,26,20853,16,366,180,186,7,28,4,3
3225,1998,1593,1528,148,86,62,2,30,1,1
21064,796,5722,579,66,66,0,2,8,2,0
15462,10,14556,9,170,87,83,2,31,1,1
15508,10,22613,9,821,102,719,2,30,1,1
8787,10,9526,9,182,93,89,2,31,1,1
11276,26,22859,16,1615,941,674,15,21,7,8
10991,26,24151,16,2600,1396,1204,18,48,10,8
6573,26,18815,16,8065,2689,5376,27,315,14,13
14934,10,13789,9,216,102,114,2,29,1,1
21270,10,10761,9,193,102,91,2,31,1,1
22570,10,502,9,126,126,0,1,29,1,0
22498,10,9403,9,308,97,211,4,33,2,2
21145,744,17056,535,66,66,0,2,7,2,0
4750,10,16212,9,240,98,142,2,30,1,1
14084,10,6361,9,1449,108,1341,4,33,2,2
8960,10,356,9,197,102,95,2,30,1,1
9225,26,11905,16,7144,2505,4639,14,120,7,7
22680,10,2290,9,889,404,485,10,30,5,5
9194,10,6382,9,181,94,87,2,30,1,1
3773,15,27610,11,1026,417,609,7,19,5,2
8352,10,10937,9,307,94,213,2,29,1,1
17598,10,2093,9,203,86,117,2,30,1,1
13845,10,27562,9,152,78,74,2,30,1,1
3156,10,13242,9,216,90,126,2,30,1,1
22137,10,4156,9,338,110,228,2,30,1,1
13554,26,24140,16,136775,6729,130046,181,18,82,99
14175,10,13147,9,177,94,83,2,30,1,1
21232,10,6014,9,211,110,101,2,30,1,1
4245,26,13280,16,9386,1934,7452,32,135,17,15
5384,26,27297,16,9767,2138,7629,22,16,12,10
15347,3104,27891,2412,66,66,0,1,5,1,0
8820,10,11048,9,184,94,90,2,30,1,1
8391,10,1470,9,199,102,97,2,32,1,1
16035,15,25401,11,1248,535,713,10,20,5,5
14572,26,24686,16,8882,1866,7016,24,148,13,11
5271,26,6647,16,330651,13398,317253,404,115,179,225
8641,295,21504,190,3546,2043,1503,16,15,9,7
8928,26,22873,16,7479,2226,5253,29,151,15,14
14256,10,23607,9,199,94,105,2,30,1,1
21920,10,12176,9,248,102,146,2,30,1,1
8587,10,6272,9,744,89,655,2,31,1,1
2776,26,20011,16,4329,2374,1955,23,520,8,15
20549,26,18088,16,7975,423,7552,15,119,6,9
18532,26,6732,16,7289,1899,5390,29,317,16,13
21273,2394,6464,1861,70,70,0,1,4,1,0
6661,10,18063,9,168,78,90,2,30,1,1
15421,1223,18869,904,70,70,0,1,5,1,0
9375,10,19458,9,173,94,79,2,30,1,1
10568,26,6527,16,38155,33545,4610,79,26,42,37
8604,26,28139,16,18773,1492,17281,38,94,11,27
16171,15,5784,11,172,172,0,2,5,2,0
6215,10,18264,9,639,86,553,2,31,1,1
13802,10,19217,9,194,102,92,2,30,1,1
22390,10,17604,9,345,101,244,4,53,2,2
18048,15,22662,11,1186,390,796,9,16,5,4
15764,10,10523,9,190,97,93,2,30,1,1
11463,18,2462,13,184,94,90,2,30,1,1
12850,26,6758,16,33220,3819,29401,77,255,39,38
11230,2129,6551,1642,66,66,0,2,10,2,0
5937,10,17879,9,825,99,726,2,30,1,1
22234,10,2499,9,199,102,97,2,30,1,1
9870,26,16792,16,26161,3618,22543,80,119,31,49
12660,320,24115,206,70,70,0,1,4,1,0
9816,15,2179,11,1718,1247,471,9,14,5,4
1386,10,4754,9,216,88,128,2,31,1,1
359,10,1085,9,217,82,135,2,32,1,1
22658,10,26983,9,327,110,217,2,30,1,1
18828,26,26996,16,1386,751,635,15,181,8,7
10865,26,8245,16,48635,5346,43289,83,151,38,45
18465,2396,23569,1863,320,140,180,6,7,3,3
14316,10,20926,9,183,94,89,2,31,1,1
4269,26,15223,16,6419,2962,3457,25,148,12,13
10806,341,2275,217,328,142,186,6,90,3,3
21750,26,3598,16,2649258,1156086,1493172,7283,5215,3384,3899
6273,26,26843,16,4181,998,3183,14,27,7,7
16528,1820,589,1387,204,64,140,4,10,2,2
15345,10,17899,9,212,110,102,2,30,1,1
13994,10,18640,9,756,95,661,2,31,1,1
12732,26,17392,16,9312,4088,5224,23,76,13,10
14851,10,10275,9,177,94,83,2,30,1,1
15204,10,16133,9,177,94,83,2,30,1,1
19437,10,11967,9,86,86,0,1,30,1,0
15279,26,18157,16,8125,2039,6086,21,15,11,10
17505,26,17525,16,16232,3319,12913,23,125,9,14
9728,2884,5902,2239,166,166,0,1,1200,1,0
7333,10,5381,9,241,78,163,2,30,1,1
10525,26,2676,16,20313,6637,13676,45,24,23,22
9114,15,24068,11,3991,620,3371,14,15,7,7
8535,26,11831,16,5224,1560,3664,15,165,9,6
10700,1178,4895,869,9434,9434,0,11,30,11,0
10473,10,1332,9,252,78,174,2,30,1,1
13910,10,29069,9,199,102,97,2,30,1,1
15126,18,11803,13,184,94,90,2,30,1,1
9376,15,15434,11,1743,979,764,13,81,7,6
13148,26,26941,16,5892088,193411,5698677,6287,213,2098,4189
13611,15,22272,11,416,210,206,7,15,4,3
14578,10,18674,9,731,91,640,2,31,1,1
15410,10,27070,9,177,94,83,2,29,1,1
22474,10,7323,9,819,102,717,2,31,1,1
22203,10,28906,9,180,82,98,2,30,1,1
21648,10,22099,9,230,110,120,2,29,1,1
18165,26,5166,16,3465,818,2647,11,122,5,6
8132,15,21076,11,19225,817,18408,29,15,13,16
5901,26,6447,16,1807,1048,759,16,26,8,8
7186,15,11403,11,573,499,74,6,15,5,1
13302,10,18663,9,101,101,0,2,31,2,0
14838,26,12498,16,80340,72269,8071,106,122,65,41
12545,26,10711,16,1579,988,591,13,44,7,6
14930,10,7208,9,216,110,106,2,31,1,1
9728,881,8198,650,300,300,0,3,1200,3,0
12189,15,25005,11,130,64,66,3,4,2,1
9830,26,29125,16,6586,1807,4779,23,360,12,11
14477,10,5887,9,214,102,112,2,30,1,1
10596,10,25487,9,304,86,218,2,30,1,1
17021,26,21853,16,32598,22046,10552,83,60,49,34
15206,10,13452,9,199,94,105,2,30,1,1
1786,26,17879,16,13126,5105,8021,37,31,21,16
22015,15,4919,11,508,256,252,9,77,5,4
21231,10,12940,9,193,102,91,2,30,1,1
17433,10,12097,9,260,86,174,2,29,1,1
14914,10,7111,9,193,102,91,2,30,1,1
11123,2057,13862,1583,258,70,188,4,8,2,2
11018,1578,2501,1208,70,70,0,2,8,2,0
22693,26,16957,16,92275,4799,87476,107,16,43,64
13952,10,15133,9,438,180,258,6,30,3,3
11920,26,2405,16,30012,3461,26551,72,93,28,44
15485,10,3223,9,199,102,97,2,30,1,1
15991,10,18904,9,184,102,82,2,30,1,1
7657,15,20354,11,5464,713,4751,15,16,8,7
3176,10,13451,9,220,90,130,2,30,1,1
3331,15,21785,11,130,70,60,2,15,1,1
13790,26,24269,16,4480,555,3925,11,20,6,5
3335,26,13767,16,130,70,60,2,14,1,1
12435,26,23522,16,1468,763,705,16,181,8,8
15113,26,2161,16,210110,14803,195307,246,105,103,143
21470,10,16317,9,194,94,100,2,29,1,1
9547,10,3921,9,749,94,655,2,30,1,1
14711,10,16635,9,278,96,182,4,54,2,2
11006,15,28473,11,366,240,126,7,25,5,2
1153,10,3914,9,235,90,145,2,33,1,1
22138,10,0,0,371,77,294,2,30,1,1
13932,10,1560,9,196,102,94,2,30,1,1
17595,26,21037,16,66108,6145,59963,93,16,41,52
11373,26,11517,16,7488,2474,5014,23,3600,12,11
9238,26,14688,16,7274,2208,5066,26,255,14,12
9859,15,4581,11,1106,326,780,12,140,6,6
14830,15,24824,11,101607,1692,99915,94,15,24,70
6438,10,18605,9,260,106,154,2,33,1,1
6899,26,23899,16,466,392,74,4,0,3,1
8898,26,14518,16,4414,993,3421,14,25,6,8
8903,10,14638,9,184,86,98,2,31,1,1
7827,26,23530,16,490,210,280,8,28,4,4
14873,10,25042,9,182,93,89,2,31,1,1
13930,10,26142,9,194,102,92,2,29,1,1
3315,26,28485,16,12597,6029,6568,36,267,15,21
15889,10,21248,9,168,86,82,2,30,1,1
8384,2699,16686,2096,2189,1143,1046,10,16,6,4
8210,1431,21194,1086,506,152,354,2,1201,1,1
9171,10,16809,9,216,110,106,2,30,1,1
12650,26,18704,16,499,425,74,4,0,3,1
13913,10,15986,9,186,95,91,2,31,1,1
7159,26,835,16,2378,1382,996,20,21,11,9
12963,26,12853,16,272587,11910,260677,336,76,140,196
15073,15,2836,11,32396,2695,29701,46,135,22,24
15103,26,22562,16,14108,2487,11621,32,81,18,14
8584,1270,19804,950,78,78,0,1,30,1,0
8856,10,14985,9,216,110,106,2,30,1,1
18081,26,23077,16,345468,18536,326932,432,22,200,232
9365,26,26811,16,6320,1382,4938,24,167,13,11
21917,10,7554,9,338,110,228,2,30,1,1
9057,26,14927,16,7115,1670,5445,24,35,13,11
18441,507,7141,335,1218,774,444,17,26,10,7
5432,26,668,16,78,78,0,1,5,1,0
22429,10,10308,9,195,102,93,2,30,1,1
18457,15,22850,11,2047,701,1346,16,26,5,11
14133,10,1039,9,340,134,206,2,30,1,1
7532,26,23110,16,6407,984,5423,21,360,11,10
10920,15,23485,11,7097,3553,3544,15,31,8,7
15973,26,4545,16,43052,2466,40586,64,18,21,43
16601,40,27980,23,430,60,370,7,24,2,5
2737,26,11340,16,1251,722,529,11,147,6,5
9526,15,1609,11,1369,799,570,13,77,7,6
8551,10,11893,9,181,94,87,2,29,1,1
7219,26,25690,16,17031,8260,8771,39,128,19,20
6250,2001,28964,1531,148,86,62,2,30,1,1
18318,15,12200,11,14705,6415,8290,26,149,12,14
9273,6,21822,6,152,66,86,2,10,1,1
11032,1714,20208,1309,66,66,0,1,5,1,0
12612,10,2962,9,70,70,0,1,30,1,0
4100,26,21856,16,3389452,85022,3304430,3290,159,997,2293
14957,10,21754,9,198,102,96,2,31,1,1
19841,26,18873,16,10390,3051,7339,16,121,6,10
6199,10,1100,9,168,78,90,2,30,1,1
8594,10,14880,9,267,94,173,2,31,1,1
22669,26,21450,16,310863,9840,301023,323,16,115,208
21885,10,13118,9,785,110,675,2,30,1,1
15734,10,11573,9,196,102,94,2,31,1,1
14257,1803,5238,1374,504,318,186,8,16,5,3
15432,10,16967,9,195,102,93,2,30,1,1
20876,183,28244,121,4365,2581,1784,20,33,11,9
13714,10,6934,9,195,102,93,2,30,1,1
1219,2822,8649,2190,481,150,331,2,1200,1,1
15137,10,717,9,216,110,106,2,31,1,1
16321,26,17778,16,17236,1691,15545,19,146,5,14
11158,26,18682,16,16113,2152,13961,35,20,18,17
15625,15,347,11,25138,16043,9095,79,2410,53,26
11676,26,18994,16,25048,2850,22198,45,26,23,22
15978,10,18347,9,198,102,96,2,30,1,1
15651,10,10860,9,196,100,96,2,31,1,1
8550,10,19151,9,94,94,0,1,30,1,0
6465,10,19934,9,198,93,105,2,30,1,1
14616,10,16568,9,178,94,84,2,30,1,1
14859,10,2725,9,193,102,91,2,30,1,1
13891,10,6378,9,193,102,91,2,30,1,1
21046,2357,2210,1835,70,70,0,1,4,1,0
18292,26,3074,16,6075,3806,2269,18,120,10,8
21084,2563,13059,1990,66,66,0,2,7,2,0
12470,26,28098,16,10520,3200,7320,29,38,16,13
10547,26,6123,16,8939,3462,5477,25,263,12,13
2164,10,8716,9,235,90,145,2,31,1,1
9013,10,14521,9,173,94,79,2,31,1,1
12137,26,11704,16,41125,3625,37500,62,323,25,37
21237,10,19497,9,214,94,120,2,29,1,1
21980,10,8922,9,195,102,93,2,30,1,1
21144,26,17524,16,3182,1568,1614,8,120,4,4
14860,10,16301,9,330,126,204,2,30,1,1
20505,26,1447,16,304,86,218,2,29,1,1
2693,26,9603,16,21391,16334,5057,38,20,21,17
12669,10,5099,9,258,86,172,2,31,1,1
15555,15,28244,11,214,140,74,4,35,3,1
5533,15,19512,11,3472,2124,1348,14,21,8,6
2744,1238,11804,918,888,126,762,2,31,1,1
7267,26,1447,16,2553,1355,1198,22,77,13,9
7296,26,7888,16,8706,1430,7276,23,316,9,14
22302,26,23487,16,2414,639,1775,9,121,5,4
12853,10,23715,9,233,90,143,2,32,1,1
17151,26,27765,16,15848,13507,2341,37,32,19,18
22661,26,26100,16,460338,13340,446998,472,16,165,307
14189,10,18654,9,166,86,80,2,30,1,1
19106,26,29098,16,121129,5559,115570,157,640,51,106
8040,26,18116,16,2227,1018,1209,17,15,8,9
6250,1997,17797,1527,629,83,546,4,31,2,2
6639,26,21410,16,5948,1664,4284,21,247,12,9
11748,26,11760,16,4114,2920,1194,19,80,11,8
21725,10,13936,9,215,102,113,2,30,1,1
2892,10,11850,9,233,90,143,2,32,1,1
21016,1434,26838,1088,66,66,0,1,5,1,0
8974,10,2168,9,386,134,252,2,30,1,1
22715,10,16239,9,199,102,97,2,30,1,1
11131,3217,18523,2494,1200,576,624,8,31,4,4
17838,26,6700,16,303966,26201,277765,521,167,208,313
13675,10,22147,9,179,94,85,2,30,1,1
12031,382,28182,246,70,70,0,2,8,2,0
15034,10,25949,9,183,94,89,2,30,1,1
15838,26,10632,16,212477,8324,204153,232,122,79,153
7062,26,24645,16,570,318,252,10,20,6,4
18320,26,9121,16,12256,5443,6813,33,437,18,15
12125,26,23337,16,1210,637,573,14,34,7,7
18766,1989,25280,1519,316,136,180,6,5,3,3
17873,10,2853,9,211,78,133,2,30,1,1
10440,15,17359,11,882,527,355,10,255,6,4
13653,26,28001,16,6430,1513,4917,26,40,14,12
11164,26,19244,16,473832,22822,451010,464,109,139,325
17771,26,26443,16,4401,1494,2907,19,29,11,8
8700,10,4696,9,193,102,91,2,31,1,1
1273,10,4214,9,215,80,135,2,32,1,1
15084,10,17054,9,807,94,713,2,30,1,1
6838,26,9322,16,2754856,125760,2629096,3115,32,1340,1775
10618,26,3143,16,1522,1210,312,9,28,4,5
15010,10,26380,9,177,94,83,2,30,1,1
2744,1239,5137,919,879,126,753,2,30,1,1
8068,26,26526,16,572565,17274,555291,546,147,124,422
262,10,676,9,194,87,107,2,30,1,1
8828,10,7137,9,268,93,175,4,57,2,2
9694,26,6877,16,4551,2140,2411,14,135,6,8
22568,10,19305,9,193,102,91,2,31,1,1
18447,10,19370,9,234,96,138,2,31,1,1
15096,10,3536,9,170,87,83,2,30,1,1
15234,26,24118,16,8058,2038,6020,20,15,11,9
8509,10,4025,9,443,182,261,6,30,3,3
14546,10,26982,9,177,94,83,2,30,1,1
16386,10,5630,9,295,77,218,2,30,1,1
8391,26,6691,16,93540,22718,70822,155,918,65,90
13687,26,25403,16,19846,10062,9784,42,47,22,20
14625,10,24216,9,168,86,82,2,30,1,1
11161,26,7357,16,6565,1251,5314,27,31,14,13
12606,191,2217,126,70,70,0,1,4,1,0
5927,15,826,11,1723,438,1285,10,136,6,4
8790,26,24736,16,6440,1965,4475,22,36,12,10
11178,1414,4974,1075,70,70,0,2,8,2,0
8148,26,14501,16,29988,20891,9097,170,598,95,75
22038,10,436,9,164,84,80,2,31,1,1
10467,26,16502,16,8186,2146,6040,29,33,16,13
10851,26,16573,16,3002,258,2744,9,119,4,5
8823,26,12380,16,9039,2175,6864,32,20,17,15
2744,2497,16825,1943,887,126,761,2,30,1,1
12881,26,28449,16,8340,3417,4923,20,75,11,9
22686,10,8057,9,490,111,379,4,54,2,2
4406,26,8572,16,27557,20627,6930,89,5581,44,45
16676,10,17423,9,202,86,116,2,30,1,1
10394,6,22420,6,5624,2099,3525,30,23,17,13
22310,10,20246,9,311,94,217,2,30,1,1
18512,1371,13684,1042,70,70,0,1,5,1,0
14323,10,28793,9,177,94,83,2,29,1,1
14181,10,24012,9,788,108,680,2,30,1,1
17664,15,27737,11,2633,1151,1482,10,32,6,4
22212,10,11362,9,200,78,122,2,30,1,1
14334,10,18357,9,209,110,99,2,30,1,1
2760,10,11400,9,414,268,146,3,33,2,1
11713,26,15042,16,1581,924,657,15,125,7,8
12508,15,8312,11,1173,665,508,13,16,7,6
15899,26,25421,16,10761,5724,5037,43,15,25,18
9247,26,8442,16,292,172,120,4,15,2,2
12728,1945,22294,1483,70,70,0,1,5,1,0
8452,10,20392,9,94,94,0,1,30,1,0
22545,26,1271,16,12690,1918,10772,39,195,19,20
21222,10,3511,9,228,94,134,2,30,1,1
15096,10,18273,9,177,94,83,2,29,1,1
6114,26,19448,16,6204,1328,4876,21,139,12,9
21949,10,9809,9,677,198,479,6,68,3,3
5636,26,17387,16,4520,1613,2907,19,26,11,8
13798,10,13593,9,177,94,83,2,30,1,1
15719,10,3154,9,165,86,79,2,30,1,1
21782,10,17961,9,754,94,660,2,30,1,1
22454,10,12301,9,357,105,252,4,57,2,2
6322,15,18428,11,29727,1571,28156,44,16,21,23
9026,10,10506,9,176,90,86,2,30,1,1
9615,10,10203,9,168,78,90,2,30,1,1
8846,15,1396,11,1548,847,701,10,16,5,5
8447,15,21802,11,200808,6612,194196,217,3669,83,134
15846,26,5450,16,2693,1361,1332,17,19,10,7
10269,26,23413,16,2791,1800,991,26,186,15,11
1863,10,21734,9,225,78,147,2,31,1,1
18254,15,6782,11,1564,990,574,15,24,8,7
21346,10,13131,9,188,96,92,2,31,1,1
13677,10,19032,9,216,102,114,2,30,1,1
16021,280,9365,177,353,166,187,2,1199,1,1
16074,10,19962,9,199,94,105,2,30,1,1
3846,26,13647,16,8230,2275,5955,18,135,8,10
12905,26,28447,16,37440,7952,29488,67,128,28,39
9739,15,27783,11,2049,1065,984,15,78,8,7
15952,26,10588,16,9318,3350,5968,31,140,14,17
5475,15,19082,11,1638,1324,314,10,15,5,5
15508,15,23956,11,1482,878,604,10,75,6,4
11279,26,22862,16,152755,7304,145451,171,21,65,106
18835,26,13203,16,4435,2482,1953,10,121,6,4
8485,10,26131,9,718,94,624,2,30,1,1
6361,26,8598,16,10204,2106,8098,37,255,19,18
12072,26,11040,16,6094,1073,5021,19,15,10,9
22564,10,4248,9,197,102,95,2,29,1,1
10759,3180,2512,2466,70,70,0,1,5,1,0
22719,10,18368,9,194,102,92,2,30,1,1
8900,15,3201,11,88983,2379,86604,92,129,30,62
22146,10,19997,9,194,99,95,2,31,1,1
14773,10,9217,9,179,94,85,2,30,1,1
14671,10,5527,9,193,102,91,2,30,1,1
15874,26,3753,16,5614,733,4881,16,15,9,7
8703,10,10463,9,269,96,173,4,59,2,2
5108,26,16652,16,3028,1828,1200,19,21,11,8
4852,26,23858,16,1650,815,835,17,186,9,8
5779,10,17632,9,213,87,126,2,31,1,1
22171,10,15316,9,173,94,79,2,30,1,1
15384,10,28631,9,172,88,84,2,31,1,1
6949,10,19352,9,197,76,121,2,30,1,1
15070,10,2375,9,184,94,90,2,30,1,1
14923,10,4701,9,243,94,149,2,30,1,1
22229,10,8721,9,168,94,74,2,31,1,1
8425,15,21402,11,17197,1551,15646,29,27,13,16
6034,676,6148,475,130,70,60,2,5,1,1
22293,10,20804,9,196,94,102,2,30,1,1
10451,26,14679,16,5795,3322,2473,22,93,13,9
22572,15,5790,11,1630,982,648,13,78,7,6
8995,26,10224,16,8471,2343,6128,30,240,15,15
8245,10,21233,9,217,87,130,2,30,1,1
8692,26,9629,16,6032,1049,4983,18,26,9,9
5208,10,8755,9,198,93,105,2,31,1,1
12067,2141,21175,1654,70,70,0,2,8,2,0
15637,10,11358,9,178,94,84,2,30,1,1
20553,26,22788,16,304,86,218,2,30,1,1
8944,10,2070,9,319,98,221,4,53,2,2
18830,26,26998,16,1320,685,635,14,182,7,7
11213,610,25769,420,70,70,0,1,5,1,0
12153,26,9423,16,7424,1825,5599,25,18,13,12
9463,15,8938,11,3855,828,3027,11,15,5,6
9572,15,22152,11,312,192,120,6,27,4,2
2744,1240,27291,920,878,126,752,2,30,1,1
22459,10,4468,9,313,97,216,4,56,2,2
7319,15,9418,11,6959,2024,4935,14,148,8,6
17331,10,4385,9,231,110,121,2,30,1,1
18817,1989,1074,1519,316,136,180,6,6,3,3
12739,26,25262,16,499,425,74,4,0,3,1
2744,1239,11166,919,880,126,754,2,30,1,1
3697,15,4793,11,874,500,374,10,14,6,4
10821,2879,10146,2237,70,70,0,1,5,1,0
12597,26,6426,16,499,425,74,4,0,3,1
0,0,0,0,244,244,0,2,0,2,0
4634,26,6245,16,23647,9422,14225,52,40,28,24
22254,10,20428,9,755,94,661,2,30,1,1
21331,10,22924,9,181,94,87,2,29,1,1
729,15,2922,11,176670,11287,165383,216,46,96,120
21623,10,9079,9,181,86,95,2,30,1,1
636,282,8665,179,259,150,109,2,1200,1,1
15192,15,28410,11,234,234,0,4,12,4,0
13393,26,24756,16,2285,1130,1155,25,120,12,13
17185,676,3545,475,138,78,60,2,5,1,1
14363,10,26157,9,256,93,163,2,30,1,1
22521,10,12523,9,182,102,80,2,31,1,1
14743,10,24778,9,832,106,726,2,30,1,1
9819,15,19249,11,1658,1247,411,8,15,5,3
15214,10,18072,9,168,86,82,2,30,1,1
15558,10,19525,9,711,87,624,2,31,1,1
15869,10,18881,9,208,106,102,2,30,1,1
22036,740,11181,531,432,192,240,8,30,4,4
8812,26,17973,16,5647,1832,3815,16,36,9,7
9532,26,5325,16,6734,4301,2433,21,29,12,9
8573,10,21468,9,247,98,149,2,32,1,1
15890,10,15782,9,167,86,81,2,31,1,1
14815,10,14188,9,200,102,98,2,30,1,1
4508,10,15935,9,645,90,555,2,29,1,1
11820,10,23189,9,414,268,146,3,32,2,1
15543,26,3058,16,6815,3817,2998,23,143,11,12
13623,10,18064,9,199,102,97,2,29,1,1
8872,10,18278,9,296,102,194,4,41,2,2
20603,2399,7860,1866,574,448,126,10,25,8,2
12567,405,22818,263,320,140,180,6,5,3,3
14914,10,14206,9,199,102,97,2,29,1,1
10553,26,24780,16,887,635,252,7,23,3,4
11907,26,14721,16,18064,5135,12929,108,95,44,64
10233,15,13823,11,1426,930,496,10,22,7,3
13115,26,10961,16,5850,1617,4233,28,127,13,15
10969,10,1335,9,222,94,128,2,30,1,1
12629,26,4209,16,499,425,74,4,0,3,1
15422,10,10731,9,225,86,139,2,30,1,1
10684,15,15776,11,141348,4210,137138,161,17,58,103
15120,26,9284,16,1323,616,707,18,120,9,9
15888,10,25643,9,178,94,84,2,29,1,1
16453,10,25676,9,265,114,151,2,30,1,1
12544,26,17697,16,5743,1339,4404,18,180,8,10
17774,26,21121,16,3304,1468,1836,18,139,10,8
14909,15,17427,11,2541,689,1852,13,60,8,5
8324,26,28725,16,2529,1230,1299,17,16,9,8
22676,10,27743,9,184,94,90,2,30,1,1
10723,1164,4673,859,66,66,0,1,5,1,0
8584,1256,2977,936,250,78,172,2,31,1,1
8327,625,27516,432,150,150,0,1,1201,1,0
22695,10,6810,9,197,102,95,2,30,1,1
5341,15,12930,11,1638,1324,314,10,16,5,5
9002,10,3098,9,182,93,89,2,31,1,1
12568,898,25551,663,320,140,180,6,7,3,3
6202,26,11097,16,70,70,0,1,5,1,0
10779,103,22730,80,70,70,0,1,5,1,0
22024,15,6223,11,2424,529,1895,11,75,6,5
21197,2895,28233,2248,70,70,0,1,4,1,0
15705,10,6211,9,165,86,79,2,30,1,1
2940,15,12047,11,10145,1446,8699,23,29,11,12
16500,15,24214,11,62067,24127,37940,79,34,33,46
4835,1634,11454,1256,3957,2324,1633,51,1732,29,22
21240,10,19942,9,178,94,84,2,30,1,1
15249,10,3232,9,183,94,89,2,30,1,1
15571,10,13295,9,177,94,83,2,30,1,1
915,10,3593,9,244,98,146,2,32,1,1
8729,15,4882,11,318,192,126,6,45,4,2
22554,15,13848,11,1347,771,576,11,86,7,4
12544,676,656,475,70,70,0,2,7,2,0
19244,26,2815,16,31549,6352,25197,64,206,26,38
14832,15,24826,11,101477,1626,99851,93,15,23,70
15645,10,3794,9,199,94,105,2,30,1,1
19301,26,4775,16,12588,4915,7673,28,94,15,13
8926,15,21641,11,613303,16858,596445,666,143,251,415
9,18,19143,13,184,94,90,2,30,1,1
20397,40,19228,23,8840,4151,4689,80,190,41,39
15904,26,25431,16,1081375,19607,1061768,921,122,142,779
9103,10,15257,9,229,102,127,2,30,1,1
6115,15,3594,11,1740,708,1032,19,396,6,13
18305,26,1636,16,1868,1229,639,18,151,11,7
11424,26,8396,16,8760,1218,7542,25,15,14,11
13772,10,10312,9,173,94,79,2,30,1,1
22199,1269,3820,949,735,462,273,2,31,1,1
14774,10,28156,9,215,94,121,2,30,1,1
10685,15,17824,11,8100,4781,3319,23,166,12,11
21803,10,14834,9,184,94,90,2,30,1,1
21731,26,14062,16,1786,172,1614,7,120,3,4
15717,10,4676,9,396,102,294,2,30,1,1
11714,26,14048,16,1581,924,657,15,125,7,8
21882,10,10784,9,225,102,123,2,30,1,1
10216,15,1366,11,3378,1918,1460,33,131,18,15
15507,10,8817,9,216,110,106,2,31,1,1
12880,234,10238,149,8767,2486,6281,45,6062,24,21
17071,26,9893,16,5167,700,4467,16,15,7,9
15844,10,20765,9,305,102,203,2,29,1,1
15601,346,4062,220,78,78,0,2,8,2,0
9176,10,18969,9,94,94,0,1,30,1,0
11054,2420,927,1882,70,70,0,1,4,1,0
5184,15,9026,11,288702,9850,278852,312,105,123,189
8210,280,21194,177,490,149,341,2,1200,1,1
8584,1238,18121,918,242,71,171,2,31,1,1
16553,183,25735,121,4245,2461,1784,18,33,9,9
15340,10,22962,9,194,102,92,2,30,1,1
15487,10,10260,9,821,102,719,2,30,1,1
8487,26,12223,16,2371,1839,532,14,45,8,6
11696,10,0,0,296,87,209,2,30,1,1
18799,923,10677,681,70,70,0,1,5,1,0
9466,26,18833,16,8156,1586,6570,24,82,11,13
9686,10,8182,9,762,98,664,2,30,1,1
6856,10,22588,9,199,94,105,2,30,1,1
7290,26,18607,16,1625,1038,587,14,26,8,6
21439,10,13396,9,209,110,99,2,30,1,1
16406,26,25647,16,18738,1904,16834,33,17,17,16
10827,15,3646,11,1929,796,1133,21,135,11,10
3721,26,3829,16,33131,26333,6798,49,121,28,21
11840,26,28535,16,416,210,206,7,26,4,3
6246,26,28016,16,6827,1776,5051,26,121,13,13
14907,10,22772,9,177,94,83,2,30,1,1
4697,26,1421,16,18611,3046,15565,41,362,20,21
14548,10,13487,9,209,110,99,2,30,1,1
22079,10,21700,9,305,97,208,4,53,2,2
8584,1239,374,919,281,78,203,2,31,1,1
20726,26,3822,16,1786,172,1614,7,120,3,4
11756,26,10901,16,843201,50940,792261,1191,159,451,740
17319,10,21881,9,295,86,209,2,30,1,1
15822,10,10975,9,762,98,664,2,30,1,1
11313,41,22888,24,146,82,64,2,5,1,1
951,26,8397,16,6020,792,5228,18,25,9,9
14044,10,25873,9,195,94,101,2,30,1,1
6250,1996,5708,1526,148,86,62,2,30,1,1
13467,26,22521,16,3388,894,2494,19,154,8,11
9196,10,6452,9,179,94,85,2,30,1,1
5174,10,16710,9,216,90,126,2,30,1,1
9088,15,1695,11,1126,609,517,11,15,6,5
22210,10,2072,9,178,94,84,2,29,1,1
14868,10,24847,9,851,114,737,2,30,1,1
9728,1183,811,873,1377,300,1077,6,1200,3,3
15012,15,15110,11,17188,1559,15629,25,25,10,15
18471,2844,19199,2208,70,70,0,2,8,2,0
14895,10,27600,9,711,87,624,2,30,1,1
13783,10,24691,9,214,110,104,2,31,1,1
22709,26,9380,16,438102,12780,425322,449,15,157,292
15340,10,23164,9,711,87,624,2,30,1,1
5053,26,17669,16,3605,1648,1957,20,255,10,10
14048,10,10597,9,183,94,89,2,30,1,1
4479,15,23033,11,130,70,60,2,15,1,1
4701,15,4252,11,350,210,140,6,15,4,2
15313,26,25056,16,48740,2961,45779,73,46,33,40
13648,10,1229,9,209,110,99,2,30,1,1
21709,10,19818,9,183,94,89,2,30,1,1
0,0,0,0,480,244,236,4,0,2,2
12815,1024,3796,754,492,306,186,8,17,5,3
532,247,0,0,3354,1792,1562,46,192,23,23
10327,2627,6263,2037,460,150,310,2,1200,1,1
8718,10,14963,9,194,102,92,2,30,1,1
10852,15,5023,11,3709,1390,2319,17,19,10,7
21173,15,6477,11,314,192,122,6,15,4,2
7230,10,19747,9,178,82,96,2,30,1,1
7156,26,15359,16,2312,1382,930,19,34,11,8
18358,10,14310,9,312,78,234,2,30,1,1
9052,26,12677,16,117085,3435,113650,123,87,43,80
11181,15,16550,11,546,300,246,10,32,6,4
7218,233,11075,148,4196,1378,2818,21,3002,12,9
18314,26,873,16,92975,3289,89686,107,316,40,67
17451,26,4148,16,9335,3052,6283,25,125,11,14
22249,10,27870,9,176,90,86,2,31,1,1
12724,2482,9260,1930,70,70,0,1,4,1,0
6250,1992,16384,1522,209,87,122,4,29,2,2
14731,10,16093,9,199,102,97,2,30,1,1
18550,1331,15558,1006,70,70,0,2,8,2,0
18986,26,6176,16,3465,2532,933,20,47,12,8
5808,26,10730,16,1062,724,338,16,41,11,5
2419,10,10001,9,230,90,140,2,30,1,1
14233,10,5031,9,300,88,212,4,51,2,2
11247,15,11515,11,1074,565,509,11,16,6,5
11152,26,19704,16,5841,1986,3855,19,15,11,8
3896,26,14983,16,1542,489,1053,8,20,5,3
12939,15,1708,11,1594,1280,314,10,15,5,5
15319,26,11574,16,8008,1988,6020,20,15,11,9
8646,10,16587,9,428,96,332,4,52,2,2
17893,26,10158,16,966,480,486,17,29,9,8
15689,10,2517,9,183,94,89,2,31,1,1
8069,26,27466,16,4654,2499,2155,17,31,9,8
14011,10,12551,9,164,86,78,2,30,1,1
3270,15,16534,11,7450,2372,5078,26,24,15,11
14802,10,10630,9,168,78,90,2,30,1,1
11344,26,22912,16,17806,3169,14637,41,86,18,23
22419,26,11908,16,4748,2193,2555,14,135,7,7
16233,26,19917,16,12689,5742,6947,26,43,14,12
902,26,28014,16,6128,763,5365,17,29,9,8
14994,26,8636,16,6032,1722,4310,22,117,13,9
21751,10,7673,9,194,102,92,2,31,1,1
501,2372,17598,1845,832,832,0,14,96,14,0
2882,26,1346,16,5578,1390,4188,19,16,9,10
8329,10,17116,9,183,94,89,2,29,1,1
14890,10,24420,9,185,102,83,2,31,1,1
8785,15,5118,11,318,192,126,6,42,4,2
12376,2490,18307,1937,70,70,0,1,4,1,0
12291,26,23435,16,4198,2498,1700,25,102,12,13
15911,10,28632,9,198,94,104,2,29,1,1
13564,26,16706,16,4559,2054,2505,11,120,6,5
10267,26,2838,16,8351,2366,5985,41,185,20,21
15484,10,15759,9,177,94,83,2,31,1,1
9056,26,4825,16,5930,910,5020,18,36,9,9
22609,26,13908,16,2494,1643,851,17,26,9,8
6342,26,7857,16,215284,28807,186477,346,129,151,195
5339,26,25935,16,4362,1145,3217,17,26,9,8
22433,10,28811,9,186,95,91,2,31,1,1
9786,10,18092,9,165,86,79,2,30,1,1
12537,268,9166,168,70,70,0,1,4,1,0
8389,26,28513,16,476852,12774,464078,491,17,177,314
12637,10,17730,9,260,86,174,2,30,1,1
8702,15,5098,11,4544,3602,942,15,15,8,7
22363,10,8549,9,286,103,183,4,51,2,2
8980,10,7760,9,212,102,110,2,29,1,1
7889,26,3338,16,8404,3653,4751,25,256,14,11
14287,1879,16079,1435,70,70,0,1,5,1,0
16001,10,22214,9,342,142,200,2,30,1,1
11099,2734,13961,2120,70,70,0,1,5,1,0
18888,26,4662,16,7411,3022,4389,26,46,15,11
4824,26,16898,16,2593394,70243,2523151,2678,303,908,1770
16888,15,25932,11,348,132,216,6,26,3,3
11356,26,19635,16,4362,1266,3096,26,129,11,15
11008,2940,25372,2280,70,70,0,1,5,1,0
15972,10,27811,9,186,95,91,2,31,1,1
873,10,3561,9,227,89,138,2,30,1,1
22012,10,28680,9,779,86,693,2,30,1,1
19023,26,6310,16,77650,64697,12953,148,902,81,67
13359,26,23009,16,2352,1394,958,17,275,9,8
15485,10,16328,9,753,96,657,2,31,1,1
12551,1484,11706,1128,320,140,180,6,5,3,3
13713,10,23678,9,711,87,624,2,30,1,1
16370,329,25625,210,138,78,60,2,5,1,1
11000,15,13698,11,366,240,126,7,25,5,2
11046,26,22759,16,219803,9390,210413,222,49,72,150
11003,552,20252,368,1260,636,624,9,30,5,4
21950,26,22213,16,8602,1050,7552,16,121,7,9
22184,10,5816,9,210,102,108,2,30,1,1
12018,26,15638,16,72734,14614,58120,112,44,39,73
19894,10,11675,9,578,286,292,9,15,5,4
14882,10,5101,9,168,86,82,2,30,1,1
15432,2175,6743,1680,70,70,0,2,8,2,0
14853,10,7528,9,733,85,648,2,30,1,1
8758,10,20460,9,177,94,83,2,30,1,1
14161,10,1261,9,758,93,665,2,31,1,1
12361,26,11082,16,560,280,280,9,34,5,4
14088,10,10084,9,193,102,91,2,29,1,1
9310,10,2496,9,186,102,84,2,30,1,1
10799,15,23087,11,74039,4367,69672,91,19,40,51
7629,26,15723,16,5506,878,4628,16,26,9,7
14916,10,24564,9,170,87,83,2,30,1,1
4092,26,19973,16,8414,4131,4283,36,64,16,20
14820,10,14730,9,757,98,659,2,30,1,1
4977,15,16508,11,5397,713,4684,14,16,8,6
9107,10,7643,9,718,94,624,2,30,1,1
15749,26,3733,16,20317684,620294,19697390,20965,186,6716,14249
10322,26,6928,16,11490,3671,7819,33,93,18,15
15511,15,22280,11,1403,841,562,10,75,6,4
5603,232,12873,147,8250,3928,4322,80,296,44,36
13635,10,26362,9,757,102,655,2,29,1,1
8547,10,4077,9,198,101,97,2,31,1,1
13740,10,19326,9,344,110,234,2,30,1,1
8586,10,28897,9,183,94,89,2,31,1,1
15312,26,21635,16,7915,1926,5989,20,16,11,9
15623,10,8995,9,177,94,83,2,30,1,1
6712,26,1778,16,7775,1963,5812,22,77,13,9
3340,26,25311,16,90054,6681,83373,104,133,33,71
3954,389,15069,252,138,78,60,2,5,1,1
9215,26,14298,16,7630,839,6791,20,79,9,11
15333,1979,2108,1509,70,70,0,1,5,1,0
532,247,0,0,3354,1792,1562,46,195,23,23
9015,26,4450,16,6058,1038,5020,20,71,11,9
9694,15,6466,11,374,192,182,7,26,4,3
17877,10,24548,9,384,166,218,2,29,1,1
1060,26,19092,16,5693,499,5194,14,15,7,7
13254,26,15850,16,10017,2436,7581,22,138,10,12
5700,10,7715,9,284,79,205,2,30,1,1
6250,2008,25654,1538,652,83,569,4,31,2,2
6997,26,9980,16,3188,2056,1132,23,121,13,10
18683,26,27377,16,34758,2573,32185,50,320,21,29
21609,10,1363,9,182,93,89,2,31,1,1
8368,10,1087,9,200,102,98,2,30,1,1
2744,1239,504,919,883,126,757,2,30,1,1
9728,10,8326,9,179,94,85,2,30,1,1
14224,664,7863,465,630,444,186,9,16,6,3
15415,10,1534,9,242,110,132,2,30,1,1
17626,10,15379,9,215,86,129,2,29,1,1
22379,10,828,9,186,95,91,2,30,1,1
10851,1373,9798,1044,316,136,180,6,6,3,3
3655,10,14615,9,240,98,142,2,29,1,1
4234,26,25989,16,50384,5218,45166,76,99,26,50
8638,26,1948,16,3897,1306,2591,17,158,9,8
21469,10,394,9,178,94,84,2,30,1,1
3689,26,5847,16,65853,31390,34463,203,694,105,98
18567,10,0,0,340,90,250,2,31,1,1
8210,2627,21194,2037,485,158,327,2,1199,1,1
8584,1241,20377,921,249,71,178,2,31,1,1
7845,26,26173,16,6268,1904,4364,30,119,16,14
17595,10,13816,9,232,94,138,2,30,1,1
20516,26,12786,16,512,166,346,2,30,1,1
13111,295,23876,190,755529,16895,738634,785,16,264,521
13764,10,17769,9,198,102,96,2,29,1,1
22407,10,21967,9,183,94,89,2,29,1,1
21327,10,22288,9,430,172,258,6,61,3,3
15405,10,25111,9,195,102,93,2,30,1,1
8568,15,13530,11,405,285,120,5,15,3,2
16021,1112,18030,817,132,132,0,3,1200,3,0
13966,26,24361,16,16304,2069,14235,39,17,19,20
17188,26,5341,16,274616,12640,261976,352,28,167,185
7121,15,18679,11,1114,534,580,12,16,7,5
18028,10,12432,9,197,78,119,2,30,1,1
11139,3085,16150,2397,258,70,188,4,8,2,2
9458,15,28303,11,736,670,66,6,15,5,1
22633,15,28615,11,366,180,186,7,28,4,3
8965,10,14248,9,183,94,89,2,29,1,1
4452,26,7498,16,10252,2152,8100,38,126,18,20
5322,26,21543,16,9320,3888,5432,21,119,10,11
2744,65,12249,48,870,126,744,2,29,1,1
11586,26,152,16,4399,1857,2542,28,136,14,14
8210,285,21194,182,491,150,341,2,1200,1,1
15858,10,11991,9,177,94,83,2,30,1,1
12781,1403,15023,1066,320,140,180,6,6,3,3
14481,10,24858,9,168,86,82,2,30,1,1
13678,10,13535,9,179,94,85,2,30,1,1
15360,10,5325,9,213,102,111,2,30,1,1
16416,26,22647,16,3282,781,2501,17,136,8,9
12416,1045,7238,769,70,70,0,1,5,1,0
15517,15,21068,11,214,140,74,4,30,3,1
11177,15,39,11,366,240,126,7,32,5,2
13650,10,17068,9,168,86,82,2,35,1,1
20652,26,28103,16,9340,4256,5084,24,16,13,11
4902,26,10021,16,15449,1976,13473,32,16,16,16
22120,10,10769,9,168,86,82,2,30,1,1
8770,10,5817,9,86,86,0,1,29,1,0
22162,10,3213,9,186,95,91,2,31,1,1
15146,26,25364,16,4722,1330,3392,18,80,9,9
16118,26,25450,16,8019,4063,3956,33,92,16,17
22085,10,9104,9,166,86,80,2,31,1,1
19016,10,6309,9,167,78,89,2,30,1,1
10797,3019,24869,2347,70,70,0,1,5,1,0
6240,26,18315,16,1530,817,713,17,68,9,8
506,1469,798,1119,621281,256,621025,881,49,5,876
14325,10,28744,9,193,102,91,2,31,1,1
12404,3010,2606,2340,70,70,0,1,4,1,0
21141,280,1550,177,70,70,0,1,4,1,0
21834,10,16861,9,182,93,89,2,30,1,1
21212,10,8953,9,380,105,275,4,35,2,2
13995,10,5229,9,754,94,660,2,31,1,1
8899,15,399,11,4198,2450,1748,20,148,15,5
9088,26,3598,16,13502,2331,11171,42,194,19,23
3676,26,2460,16,3528,1045,2483,13,120,6,7
20977,26,15340,16,9152483,314975,8837508,9599,206,3195,6404
21892,10,8113,9,181,94,87,2,31,1,1
11726,26,9185,16,8355,1923,6432,32,16,18,14
11767,26,13987,16,7735,1260,6475,16,133,7,9
13910,10,19087,9,199,102,97,2,30,1,1
22136,10,25794,9,747,93,654,2,31,1,1
9450,15,13975,11,5500,2829,2671,19,34,10,9
8657,10,6212,9,492,94,398,4,45,2,2
15248,26,6265,16,7941,1952,5989,20,15,11,9
2744,1239,21208,919,1688,126,1562,4,31,2,2
13701,26,888,16,7069,2512,4557,25,46,14,11
10865,1439,17526,1093,70,70,0,1,5,1,0
14682,10,13558,9,271,88,183,4,37,2,2
21181,3129,22292,2429,70,70,0,1,4,1,0
8961,10,378,9,211,102,109,2,30,1,1
5155,26,10386,16,7878,1531,6347,36,257,16,20
9749,15,21655,11,1657,1247,410,8,15,5,3
9753,10,5501,9,766,102,664,2,30,1,1
12287,26,23431,16,15095,2556,12539,37,102,15,22
12809,15,6698,11,662,448,214,10,15,7,3
9009,10,0,0,206,83,123,2,30,1,1
2744,1239,23272,919,889,126,763,3,31,2,1
14966,10,21974,9,249,85,164,4,56,2,2
16127,15,2543,11,486,280,206,8,26,5,3
11006,26,18446,16,2466,1497,969,21,46,12,9
9473,15,26354,11,55878,5841,50037,70,94,29,41
8584,1239,22124,919,258,78,180,2,31,1,1
636,2470,27839,1921,502,150,352,2,1199,1,1
21910,10,27656,9,198,102,96,2,29,1,1
10782,295,22641,190,3638,2087,1551,17,16,10,7
8633,26,7583,16,4564,2466,2098,20,119,11,9
2744,1241,26993,921,881,126,755,2,31,1,1
17124,26,20092,16,11863,7694,4169,33,17,17,16
22097,10,20971,9,239,110,129,2,30,1,1
9273,6,21822,6,152,66,86,2,9,1,1
16121,26,1532,16,15613,1408,14205,32,125,15,17
15519,10,5976,9,732,89,643,2,31,1,1
22533,10,10076,9,313,110,203,4,34,2,2
12731,26,3393,16,499,425,74,4,0,3,1
19634,26,13477,16,7490,2688,4802,23,383,10,13
12534,405,22231,263,1179,606,573,12,17,7,5
15942,10,14905,9,197,102,95,2,30,1,1
6909,10,6536,9,199,94,105,2,30,1,1
14481,10,25004,9,196,102,94,2,30,1,1
10065,26,4138,16,10546,2453,8093,28,15,16,12
17241,26,14252,16,5168,700,4468,16,15,7,9
8384,10,8490,9,209,110,99,2,29,1,1
10000,26,11095,16,7646,1697,5949,31,271,15,16
15025,26,236,16,16401,10833,5568,32,362,18,14
15143,10,24732,9,188,96,92,2,31,1,1
5705,26,2411,16,4916,2083,2833,24,43,13,11
9520,10,9789,9,166,86,80,2,31,1,1
14306,2705,4102,2101,70,70,0,2,8,2,0
8401,10,19141,9,167,86,81,2,30,1,1
17183,26,22517,16,1115,591,524,12,25,6,6
14272,10,14442,9,184,94,90,2,31,1,1
6285,26,19341,16,26481,1832,24649,40,330,18,22
8591,10,27122,9,772,102,670,2,30,1,1
9114,15,17644,11,51651,48866,2785,74,20,38,36
2884,26,6214,16,5578,1390,4188,19,15,9,10
12878,26,23734,16,1386,751,635,15,181,8,7
15932,26,28533,16,130,70,60,2,15,1,1
12135,26,10559,16,6574,1935,4639,14,121,7,7
13604,26,7734,16,5281,1393,3888,22,16,13,9
22420,10,8780,9,184,94,90,2,30,1,1
4541,26,25511,16,4713,895,3818,18,16,10,8
8821,26,12076,16,50533,7291,43242,74,61,34,40
16413,15,27868,11,1718,1404,314,11,15,6,5
8709,10,4753,9,779,110,669,2,30,1,1
14169,10,2758,9,814,110,704,2,30,1,1
9231,10,20889,9,172,94,78,2,30,1,1
18957,26,25633,16,50093,8331,41762,75,48,36,39
18601,26,26863,16,4455,1548,2907,19,27,11,8
11423,26,11289,16,6527,1142,5385,23,32,13,10
6164,26,17416,16,2394,1365,1029,18,275,9,9
2744,1238,1678,918,876,126,750,2,30,1,1
168,10,23376,9,260,86,174,2,30,1,1
8183,26,23895,16,77050,5353,71697,113,95,46,67
22138,10,19608,9,257,102,155,2,30,1,1
15201,26,16256,16,45304,28614,16690,82,41,45,37
13710,15,10950,11,306,180,126,6,26,4,2
15295,26,25256,16,7941,1952,5989,20,15,11,9
8799,26,395,16,60196,10141,50055,122,33,62,60
10833,1693,13696,1295,66,66,0,1,5,1,0
14449,26,22795,16,5278,1026,4252,20,15,11,9
3534,15,14435,11,490,264,226,8,142,5,3
4272,26,499,16,7316,1933,5383,27,15,15,12
7541,26,8610,16,6665,1130,5535,24,287,13,11
8776,10,20956,9,241,94,147,2,30,1,1
22281,10,22007,9,195,102,93,2,29,1,1
14312,10,20261,9,214,110,104,2,30,1,1
11209,642,28569,446,70,70,0,2,8,2,0
8631,26,25552,16,11184,6821,4363,27,53,14,13
7974,26,27294,16,1429,1295,134,10,30,8,2
9083,10,668,9,225,102,123,2,30,1,1
9255,10,25501,9,199,94,105,2,30,1,1
11066,15,3354,11,366,240,126,7,24,5,2
14483,10,22625,9,184,94,90,2,29,1,1
14407,10,6399,9,245,94,151,2,29,1,1
13964,10,20588,9,199,102,97,2,29,1,1
11979,26,26533,16,408922,10621,398301,421,121,145,276
18914,26,8060,16,3862,2679,1183,28,46,15,13
6538,26,26654,16,9781,3108,6673,28,15,15,13
14278,832,10002,611,504,318,186,8,15,5,3
13726,10,19783,9,170,87,83,2,31,1,1
5150,26,11997,16,9058,1542,7516,25,50,13,12
19551,26,13608,16,21125,2413,18712,42,49,20,22
9746,15,22068,11,7596,5063,2533,28,27,16,12
8939,10,26316,9,225,110,115,2,30,1,1
16491,26,12021,16,10454,1724,8730,28,525,12,16
21529,10,20532,9,455,102,353,4,33,2,2
16403,26,20453,16,29612,2205,27407,53,186,21,32
14311,10,28409,9,391,134,257,2,30,1,1
22435,10,9083,9,177,94,83,2,30,1,1
14481,10,28660,9,168,86,82,2,30,1,1
22681,26,18501,16,92573,4519,88054,105,16,39,66
17139,26,12300,16,6270,4231,2039,22,16,11,11
9617,15,2435,11,1658,1247,411,8,15,5,3
16021,2627,14531,2037,460,150,310,2,1199,1,1
9650,15,28558,11,318,192,126,6,25,4,2
22357,10,12584,9,168,86,82,2,30,1,1
5509,26,15516,16,167,107,60,2,5,1,1
5524,26,3917,16,15058,8409,6649,40,271,21,19
6652,26,7736,16,6636,3565,3071,22,187,13,9
22628,10,27239,9,195,102,93,2,31,1,1
14476,10,17337,9,199,102,97,2,29,1,1
13620,26,2106,16,4645,2498,2147,14,135,7,7
14357,10,14184,9,199,102,97,2,30,1,1
21958,10,19120,9,189,102,87,2,29,1,1
16021,269,2435,169,330,330,0,6,1200,6,0
1002,26,25585,16,3837,488,3349,15,15,7,8
8576,10,26599,9,324,87,237,4,55,2,2
14706,10,6393,9,508,102,406,2,30,1,1
8615,15,21489,11,416,198,218,7,29,4,3
8923,10,13534,9,177,94,83,2,31,1,1
15372,26,26081,16,8022,2002,6020,20,16,11,9
5213,26,6939,16,3217,2090,1127,16,255,9,7
7025,26,6921,16,2841,1916,925,18,26,10,8
14512,10,23455,9,194,102,92,2,30,1,1
14177,10,3702,9,774,101,673,2,31,1,1
10907,26,6273,16,1852,1103,749,16,31,9,7
8424,10,2493,9,199,102,97,2,30,1,1
9395,26,20047,16,6125,1674,4451,22,81,11,11
8399,10,22965,9,242,78,164,2,29,1,1
13253,10,339,9,164,86,78,2,29,1,1
18916,26,10530,16,9959,2430,7529,27,46,16,11
15378,10,18789,9,182,93,89,2,30,1,1
11822,26,14417,16,50739,5508,45231,100,116,36,64
8471,10,13064,9,214,102,112,2,30,1,1
4609,26,25797,16,13829,1724,12105,28,516,13,15
16704,26,26342,16,864,436,428,13,29,7,6
15332,10,9400,9,322,118,204,2,30,1,1
10993,15,15348,11,422,240,182,8,25,5,3
19398,26,20690,16,1506,984,522,14,27,8,6
15360,10,28865,9,186,95,91,2,31,1,1
8654,10,5728,9,188,96,92,2,30,1,1
2696,26,5915,16,21804,16558,5246,43,21,24,19
15785,26,22652,16,9322,2994,6328,26,22,16,10
4627,26,21555,16,17284,5197,12087,46,48,25,21
8398,26,19287,16,474745,13542,461203,502,17,189,313
15568,15,12574,11,214,140,74,4,35,3,1
13861,10,7423,9,315,126,189,2,29,1,1
10721,15,8287,11,1273,471,802,11,290,6,5
9897,26,18816,16,10133,2663,7470,35,255,18,17
21389,3214,13073,2492,66,66,0,2,8,2,0
8374,26,15034,16,2643240,203689,2439551,3285,576,1237,2048
10900,10,22703,9,825,99,726,2,30,1,1
14772,15,27822,11,2085,797,1288,10,15,6,4
2046,280,13081,177,491,150,341,2,1200,1,1
17377,26,19355,16,2192,1049,1143,24,119,11,13
2764,15,11422,11,6397,947,5450,15,18,8,7
14293,2228,9933,1727,504,318,186,8,15,5,3
8584,1238,15944,918,223,71,152,2,31,1,1
15018,10,21594,9,198,102,96,2,29,1,1
11109,42,17149,25,66,66,0,1,5,1,0
9284,26,23186,16,15069,5689,9380,51,35,27,24
7419,330,21255,211,1440,956,484,15,35,8,7
3465,26,5701,16,3672,1802,1870,25,129,10,15
9479,26,12533,16,3193,346,2847,12,121,5,7
9109,10,22239,9,281,97,184,4,58,2,2
7549,26,21186,16,9505,3214,6291,33,19,19,14
7473,10,7531,9,240,86,154,2,30,1,1
22568,10,18413,9,186,95,91,2,31,1,1
14939,15,3210,11,1569,1077,492,11,30,6,5
14581,10,4152,9,186,95,91,2,30,1,1
14073,10,18998,9,774,101,673,2,30,1,1
21821,10,24696,9,179,86,93,2,30,1,1
15356,26,26394,16,7870,1881,5989,20,15,11,9
14956,10,18045,9,177,94,83,2,30,1,1
6000,26,13215,16,8090,2462,5628,22,21,12,10
14404,10,23762,9,181,94,87,2,30,1,1
11968,10,11453,9,168,78,90,2,30,1,1
21535,10,24266,9,197,102,95,2,31,1,1
18767,1989,10601,1519,316,136,180,6,6,3,3
20100,2072,15884,1597,454923,271912,183011,516,549,295,221
21594,10,27292,9,355,118,237,2,30,1,1
4661,26,24415,16,499,425,74,4,0,3,1
12071,26,5800,16,16255,8279,7976,42,422,21,21
14343,10,7902,9,168,86,82,2,29,1,1
9832,10,9571,9,78,78,0,1,30,1,0
13065,26,10365,16,6620,672,5948,17,128,8,9
14720,15,12136,11,891,536,355,10,255,6,4
8787,15,6436,11,318,192,126,6,42,4,2
2863,1985,2627,1515,148,86,62,2,30,1,1
9800,26,27312,16,3815,1772,2043,18,16,10,8
8195,26,10840,16,6423,1145,5278,19,33,11,8
9,18,2939,13,184,94,90,2,31,1,1
5372,18,2425,13,184,94,90,2,30,1,1
18944,26,18062,16,1598,794,804,16,18,9,7
14265,10,1957,9,209,110,99,2,29,1,1
22202,10,13337,9,196,94,102,2,29,1,1
22173,1248,11780,928,1334,462,872,4,30,2,2
15494,26,21717,16,8416,2142,6274,25,330,12,13
21701,10,20498,9,177,94,83,2,31,1,1
15498,10,8440,9,196,102,94,2,30,1,1
22513,10,4973,9,227,110,117,2,30,1,1
14902,10,17703,9,455,94,361,2,30,1,1
15355,2458,457,1910,264,70,194,4,19,1,3
4231,26,15546,16,6620,1197,5423,22,129,12,10
21890,10,7663,9,578,286,292,9,15,5,4
3605,10,14525,9,79,79,0,1,30,1,0
21171,26,678,16,254829,10396,244433,255,194,64,191
22564,10,26746,9,194,99,95,2,31,1,1
5214,26,23577,16,4613,2811,1802,27,95,14,13
21872,26,11999,16,7752,4399,3353,34,159,17,17
9200,10,0,0,275,85,190,2,31,1,1
14670,10,15416,9,770,101,669,2,30,1,1
16507,15,27193,11,1550,853,697,9,15,5,4
5035,26,28792,16,5021,1030,3991,16,30,9,7
16197,10,0,0,195,79,116,2,30,1,1
9099,10,24261,9,458,111,347,4,59,2,2
15728,10,5465,9,177,94,83,2,30,1,1
16699,10,15665,9,233,102,131,2,30,1,1
14596,10,21495,9,205,86,119,2,30,1,1
3536,26,9290,16,5815,1128,4687,19,0,9,10
4392,26,19762,16,6786,1795,4991,18,16,11,7
22392,10,11479,9,180,94,86,2,30,1,1
4751,26,28293,16,234688,15158,219530,324,173,157,167
15325,15,4228,11,194,128,66,4,25,3,1
22391,10,22551,9,731,91,640,2,31,1,1
14877,10,1654,9,197,102,95,2,30,1,1
12682,2952,7471,2290,492,306,186,8,14,5,3
21402,10,4383,9,471,182,289,6,57,3,3
9813,26,6555,16,8464,2256,6208,25,255,13,12
12632,10,20639,9,224,86,138,2,30,1,1
7138,26,5259,16,6290,4832,1458,18,120,11,7
6715,305,7043,199,4955,1749,3206,24,16,15,9
2744,1283,29056,962,913,126,787,2,30,1,1
5002,26,3470,16,593,473,120,4,15,2,2
13721,26,1828,16,17968,12031,5937,38,63,21,17
8608,10,17253,9,198,94,104,2,31,1,1
13794,10,18568,9,181,94,87,2,30,1,1
9565,15,26929,11,7162,3201,3961,19,27,11,8
12381,1705,24279,1302,70,70,0,1,4,1,0
789,367,15853,235,66,66,0,1,30,1,0
5606,2014,16218,1544,156,94,62,2,30,1,1
13858,26,15640,16,10500,5056,5444,23,143,11,12
8577,10,8563,9,195,102,93,2,30,1,1
15903,10,7591,9,210,110,100,2,29,1,1
20501,26,4331,16,384,166,218,2,30,1,1
21810,10,7546,9,180,94,86,2,30,1,1
22306,10,29083,9,720,94,626,2,30,1,1
6718,15,9812,11,2597,699,1898,11,181,6,5
5416,26,25741,16,127970,4968,123002,144,30,53,91
16021,1,11785,1,132,132,0,3,1199,3,0
22650,10,379,9,268,110,158,2,30,1,1
18201,26,17122,16,268,120,148,5,10,3,2
9728,10,5471,9,793,101,692,2,30,1,1
15538,10,19425,9,183,94,89,2,30,1,1
13566,15,15469,11,1107,630,477,10,16,6,4
8751,10,17062,9,732,86,646,2,30,1,1
9521,10,27063,9,214,110,104,2,30,1,1
9181,10,10375,9,300,97,203,4,36,2,2
15535,10,3803,9,177,94,83,2,30,1,1
19552,15,11368,11,32457,1499,30958,42,50,16,26
22678,10,9244,9,242,102,140,2,30,1,1
14625,10,21101,9,168,86,82,2,31,1,1
11177,1477,10193,1124,70,70,0,2,8,2,0
11856,2467,14260,1918,5180,2470,2710,49,339,25,24
5977,26,9569,16,1973617,48070,1925547,1945,84,606,1339
8817,15,10278,11,318,192,126,6,41,4,2
8523,26,12232,16,5946,1254,4692,20,33,10,10
11101,15,15358,11,362,240,122,7,25,5,2
8501,10,23996,9,184,94,90,2,31,1,1
18352,15,27855,11,1052,612,440,10,15,5,5
9241,10,22416,9,199,94,105,2,30,1,1
9179,10,25502,9,287,94,193,2,29,1,1
14910,10,5517,9,178,94,84,2,30,1,1
6839,26,17330,16,2863,1501,1362,20,317,10,10
8429,26,5057,16,4353,1227,3126,12,135,6,6
14724,10,27011,9,94,94,0,1,30,1,0
3736,26,8011,16,9649,3714,5935,47,340,24,23
8684,10,27914,9,266,110,156,2,30,1,1
6250,205,4584,134,132,64,68,2,30,1,1
21545,10,11492,9,497,90,407,4,33,2,2
779,26,3170,16,1024,539,485,10,58,5,5
19119,26,10227,16,27000,11646,15354,176,640,82,94
15221,26,4074,16,1327,918,409,10,26,6,4
15172,26,26138,16,8700,2196,6504,21,16,12,9
22281,10,2976,9,195,102,93,2,30,1,1
22218,10,10830,9,165,86,79,2,30,1,1
9019,10,14797,9,177,94,83,2,30,1,1
8938,10,23893,9,181,94,87,2,31,1,1
12771,15,13776,11,1134,465,669,9,18,6,3
9121,15,27960,11,6389,690,5699,16,15,8,8
9026,26,28154,16,819841,23462,796379,897,56,298,599
14959,10,4634,9,214,102,112,2,30,1,1
9306,10,19115,9,168,94,74,2,30,1,1
22575,26,8771,16,8613,1465,7148,22,15,13,9
15216,26,7057,16,7942,1953,5989,20,15,11,9
8210,1806,21194,1376,519,158,361,2,1200,1,1
8210,55,21194,38,334,158,176,2,1199,1,1
8147,10,13204,9,199,94,105,2,29,1,1
14207,10,4844,9,178,94,84,2,30,1,1
16689,26,10803,16,6438,2646,3792,18,37,11,7
12562,26,4252,16,70,70,0,2,7,2,0
6620,26,6046,16,144138,17538,126600,275,300,115,160
21058,2627,2692,2037,66,66,0,2,7,2,0
15645,10,14670,9,212,102,110,2,30,1,1
19284,15,8236,11,14158,1392,12766,26,255,14,12
2169,15,8739,11,159790,4676,155114,177,128,67,110
13952,10,10265,9,195,102,93,2,30,1,1
15786,10,20786,9,199,102,97,2,31,1,1
10191,15,17203,11,1299,793,506,12,16,6,6
2744,1238,21311,918,872,126,746,2,30,1,1
2744,1354,20828,1027,1640,126,1514,4,30,2,2
21941,10,15047,9,209,110,99,2,30,1,1
15945,10,13588,9,266,86,180,2,30,1,1
4835,2627,9643,2037,2020,1090,930,18,1200,15,3
2835,10,11681,9,404,259,145,3,32,2,1
14900,10,24539,9,182,93,89,2,31,1,1
14852,10,27723,9,214,110,104,2,29,1,1
9484,15,6091,11,306,180,126,6,41,4,2
14492,3130,23555,2430,481,150,331,2,1200,1,1
8516,26,7046,16,5282,1090,4192,17,25,10,7
8802,26,12261,16,50297,4871,45426,86,31,40,46
15369,1,12874,1,70,70,0,1,5,1,0
15609,26,16980,16,6847,1658,5189,21,25,12,9
12704,26,16952,16,499,425,74,4,1,3,1
8952,10,28554,9,209,110,99,2,30,1,1
13749,10,6210,9,474,200,274,6,43,3,3
22090,10,10400,9,182,93,89,2,31,1,1
5712,10,15685,9,271,102,169,2,30,1,1
9581,183,21973,121,3444,1730,1714,16,31,8,8
15826,10,28025,9,183,94,89,2,30,1,1
8210,506,21194,334,481,150,331,2,1200,1,1
11102,1166,6916,861,66,66,0,1,5,1,0
14290,1813,6255,1383,504,318,186,8,17,5,3
14186,10,3258,9,183,94,89,2,30,1,1
20111,15,24192,11,890,440,450,10,33,6,4
16021,597,14273,408,166,166,0,1,1199,1,0
10374,26,7152,16,638,292,346,10,28,5,5
16247,676,20247,475,130,70,60,2,5,1,1
15865,10,17161,9,302,110,192,2,30,1,1
18172,26,12827,16,490571,27526,463045,511,141,170,341
5653,26,11110,16,8229,2091,6138,24,361,12,12
21687,10,4292,9,183,94,89,2,30,1,1
7176,232,20549,147,4579,2357,2222,46,114,26,20
2744,1238,5538,918,880,126,754,2,30,1,1
10885,1063,6807,782,70,70,0,1,5,1,0
9728,156,1827,109,150,150,0,1,1200,1,0
21896,10,10437,9,198,94,104,2,30,1,1
14143,26,5199,16,10499,2421,8078,28,15,14,14
12579,1312,4491,989,70,70,0,2,7,2,0
13185,26,6881,16,7256,1669,5587,27,318,15,12
14282,841,15595,619,70,70,0,1,5,1,0
9640,15,7937,11,318,192,126,6,25,4,2
4739,15,15557,11,974,481,493,8,15,5,3
5238,26,6087,16,3970,2230,1740,17,114,10,7
9728,280,6864,177,166,166,0,1,1200,1,0
8999,10,9905,9,168,86,82,2,30,1,1
6330,10,18440,9,216,98,118,2,30,1,1
15871,10,23448,9,195,102,93,2,30,1,1
12469,1944,14306,1482,552,306,246,9,16,5,4
22320,10,5834,9,177,94,83,2,29,1,1
15013,10,12214,9,316,94,222,2,30,1,1
16951,255,25970,160,156,62,94,2,10,1,1
9069,10,12598,9,180,94,86,2,30,1,1
6945,15,15349,11,2121,1558,563,13,16,7,6
15071,26,2302,16,10532,6786,3746,55,81,28,27
11641,26,5391,16,130,70,60,3,5,2,1
10977,776,1530,562,70,70,0,1,5,1,0
4051,10,15226,9,213,79,134,2,33,1,1
9430,26,12042,16,208,60,148,4,12,2,2
11098,1971,13031,1504,70,70,0,1,5,1,0
8643,26,27932,16,8416,1247,7169,21,152,10,11
9118,10,23325,9,216,110,106,2,29,1,1
8169,18,16288,13,184,94,90,2,30,1,1
8833,10,12942,9,759,102,657,2,31,1,1
15145,10,9625,9,182,93,89,2,31,1,1
13779,10,8429,9,216,110,106,2,30,1,1
17096,26,6107,16,7402,2429,4973,40,139,22,18
3869,26,18586,16,36366,2297,34069,51,139,21,30
10252,15,22346,11,66992,5462,61530,79,26,30,49
7014,26,23748,16,1849,1130,719,17,38,9,8
8467,26,4538,16,10704,4094,6610,52,47,29,23
8938,10,27708,9,181,94,87,2,29,1,1
8584,1238,15051,918,78,78,0,1,30,1,0
4526,26,8421,16,7794,2670,5124,27,316,14,13
8819,15,27736,11,372,192,180,7,42,4,3
22563,10,15,9,196,100,96,2,31,1,1
161,10,22450,9,404,261,143,3,30,2,1
17230,26,26819,16,10413,7123,3290,30,18,17,13
16021,280,5797,177,490,163,327,2,1200,1,1
10593,15,5491,11,1861,1219,642,10,15,5,5
15967,26,13565,16,214,140,74,4,15,3,1
9510,15,20854,11,23852,1662,22190,36,15,19,17
9736,26,275,16,9646,3396,6250,23,79,12,11
7365,26,6545,16,6999,1563,5436,18,186,3,15
15063,15,8640,11,569,365,204,6,16,3,3
13616,10,10516,9,194,102,92,2,30,1,1
15009,10,11264,9,199,102,97,2,30,1,1
14435,26,24612,16,4543,1636,2907,19,29,11,8
22238,10,16058,9,79,79,0,2,33,2,0
9660,26,21519,16,12855,2077,10778,30,78,15,15
16700,26,25377,16,4568,2059,2509,17,33,9,8
10910,342,23457,218,86,86,0,1,29,1,0
22006,10,19333,9,195,102,93,2,30,1,1
14324,3223,26661,2500,316,190,126,5,15,3,2
8795,10,8091,9,916,86,830,2,30,1,1
4359,26,14023,16,16455,11185,5270,37,271,22,15
9728,3065,20048,2380,166,166,0,1,1200,1,0
22532,10,5439,9,949,285,664,8,39,4,4
22399,10,25862,9,177,94,83,2,30,1,1
8490,10,27513,9,196,102,94,2,30,1,1
14283,3186,22087,2472,70,70,0,1,5,1,0
12880,26,9258,16,12268,7082,5186,26,85,15,11
211,295,482,190,3566,1999,1567,16,15,8,8
8310,26,14158,16,3800867,77753,3723114,3263,625,478,2785
15524,26,4508,16,5601,1203,4398,14,60,9,5
14194,26,4929,16,21087,4784,16303,25,146,7,18
7491,15,2487,11,1373,669,704,10,16,5,5
10105,15,19950,11,1094127,5977,1088150,812,35,88,724
12579,1312,12233,989,70,70,0,1,4,1,0
15460,10,6573,9,170,87,83,3,56,2,1
5209,26,14077,16,13187,2075,11112,35,420,11,24
9106,10,16206,9,196,94,102,2,31,1,1
5178,26,21305,16,79659,3269,76390,96,170,37,59
7512,26,22114,16,7072,1541,5531,27,271,12,15
1093,26,6044,16,6100,777,5323,17,26,9,8
9101,15,27119,11,1130,613,517,11,15,6,5
9721,10,18333,9,819,102,717,2,30,1,1
7376,15,24753,11,70,70,0,2,5,2,0
6406,26,7841,16,162,102,60,2,5,1,1
9174,10,16332,9,205,86,119,2,30,1,1
7222,26,8439,16,8636,1914,6722,31,95,16,15
12703,405,28038,263,70,70,0,1,5,1,0
7701,10,6080,9,199,94,105,2,30,1,1
22546,10,1338,9,177,94,83,2,29,1,1
22506,10,2230,9,193,102,91,2,30,1,1
14771,10,23806,9,764,99,665,2,31,1,1
15744,10,11538,9,172,88,84,2,30,1,1
4538,26,1537,16,466,392,74,4,0,3,1
19323,15,21250,11,214,140,74,4,41,3,1
22451,10,3219,9,766,102,664,2,30,1,1
13632,15,4743,11,1448,539,909,17,32,9,8
15749,10,8411,9,193,102,91,2,30,1,1
9822,15,22999,11,1549,1097,452,9,21,5,4
5138,26,5894,16,90241,3033,87208,89,16,24,65
21744,10,28241,9,280,118,162,2,29,1,1
7264,15,12920,11,130,70,60,2,15,1,1
12743,2618,4198,2029,70,70,0,1,4,1,0
15793,26,14926,16,2294,1126,1168,25,120,12,13
10113,15,11504,11,8706,2289,6417,22,19,13,9
9364,10,14847,9,789,110,679,2,31,1,1
15233,26,15444,16,18959,1799,17160,35,110,15,20
10869,1303,21363,981,70,70,0,1,5,1,0
14941,10,27000,9,184,102,82,2,30,1,1
12631,10,26008,9,204,204,0,3,46,3,0
9551,346,21958,220,378,180,198,7,33,4,3
12525,1934,19177,1477,70,70,0,2,8,2,0
12901,26,20652,16,1060654,45683,1014971,1265,176,560,705
10083,15,22256,11,514,246,268,9,42,5,4
22289,26,14490,16,5291,339,4952,11,120,5,6
21301,2949,12637,2288,312,132,180,6,6,3,3
14106,10,941,9,193,102,91,2,30,1,1
2744,1239,1915,919,879,126,753,2,30,1,1
16886,26,19142,16,28468,2316,26152,43,42,15,28
8422,10,27838,9,212,102,110,2,30,1,1
13716,15,18089,11,486,240,246,9,28,5,4
4326,15,15671,11,15249,1015,14234,24,29,9,15
15815,10,6812,9,177,94,83,2,30,1,1
1945,10,7460,9,235,90,145,2,33,1,1
14424,26,19178,16,30007,2755,27252,41,136,16,25
11473,26,9492,16,22817,7615,15202,30,16,16,14
14552,10,7930,9,197,102,95,2,31,1,1
7441,26,19858,16,10106,2096,8010,24,186,13,11
4835,1587,7262,1217,766,248,518,4,1200,2,2
10501,26,24969,16,642,582,60,2,15,1,1
12582,3173,20502,2459,1294,797,497,13,15,7,6
22507,10,13146,9,195,102,93,2,30,1,1
14974,26,3197,16,25779,3436,22343,42,109,19,23
1612,10,5826,9,245,98,147,2,29,1,1
14272,2282,8310,1767,70,70,0,1,5,1,0
11309,23,0,0,550,550,0,6,35,6,0
8639,10,25618,9,290,118,172,2,30,1,1
17085,26,10379,16,11873,7787,4086,32,16,17,15
15583,10,8595,9,198,101,97,2,30,1,1
954,15,16372,11,318,192,126,6,26,4,2
8323,10,3814,9,190,97,93,2,30,1,1
18419,26,6332,16,8079,2282,5797,26,17,15,11
12652,2304,3062,1788,3156,1011,2145,16,16,8,8
15395,10,14052,9,186,95,91,2,31,1,1
11414,10,10210,9,168,78,90,2,30,1,1
7718,18,9744,13,184,94,90,2,30,1,1
8584,2559,3869,1988,268,78,190,2,30,1,1
14456,26,6865,16,3538,2015,1523,28,323,14,14
1018,26,10457,16,3616,429,3187,11,15,6,5
11212,26,23530,16,10422,1313,9109,23,75,12,11
14036,10,1504,9,405,99,306,4,41,2,2
4213,26,4128,16,3171,1490,1681,22,21,12,10
13685,26,9084,16,134,60,74,3,5,2,1
18874,10,12788,9,220,94,126,2,30,1,1
15212,26,11179,16,7907,1918,5989,20,15,11,9
4083,26,27964,16,5776,1880,3896,19,272,11,8
15487,10,18009,9,731,85,646,2,30,1,1
9224,15,12488,11,4709,4006,703,11,25,6,5
2724,1240,13626,920,422,164,258,6,30,3,3
4953,26,16481,16,5510,2263,3247,22,40,13,9
11806,26,20329,16,5424,1445,3979,29,117,14,15
10034,15,10489,11,5166,1278,3888,14,144,8,6
15557,10,23305,9,199,102,97,2,29,1,1
14438,10,12270,9,212,108,104,2,30,1,1
22443,10,22086,9,193,102,91,2,30,1,1
14441,10,21499,9,184,94,90,2,30,1,1
21589,10,12898,9,193,102,91,2,29,1,1
1430,26,4968,16,18634,3895,14739,48,29,27,21
18077,15,20922,11,890,469,421,10,360,5,5
15255,10,3304,9,211,102,109,2,30,1,1
17108,15,5941,11,2295,1574,721,10,375,6,4
8836,26,2053,16,886,541,345,11,15,6,5
9582,10,20911,9,295,101,194,4,31,2,2
15794,26,19476,16,3283,1030,2253,16,136,8,8
12015,26,10196,16,3358,1952,1406,16,360,8,8
18487,26,6998,16,1477,940,537,13,26,7,6
14850,10,9380,9,184,94,90,2,31,1,1
8571,10,5931,9,94,94,0,1,30,1,0
9340,26,25209,16,6357,1079,5278,18,32,10,8
21615,10,23799,9,212,102,110,2,30,1,1
9727,10,16316,9,819,102,717,2,30,1,1
15171,10,24681,9,199,102,97,2,29,1,1
17581,10,1798,9,189,78,111,2,30,1,1
14428,15,9353,11,1248,755,493,7,81,5,2
10082,15,14330,11,942,527,415,11,342,6,5
15512,10,26242,9,216,110,106,2,31,1,1
11347,26,22915,16,5438,2255,3183,23,86,12,11
8692,10,2334,9,272,97,175,4,58,2,2
12024,26,23281,16,8361,2182,6179,26,40,15,11
17266,26,25270,16,3715,1958,1757,23,21,12,11
14752,10,27363,9,195,102,93,2,30,1,1
14598,10,9364,9,199,102,97,2,30,1,1
21328,10,18705,9,211,102,109,2,30,1,1
13700,10,1852,9,300,102,198,4,40,2,2
17204,18,27441,13,184,94,90,2,30,1,1
16378,15,26732,11,6453,1210,5243,14,23,8,6
18103,26,7785,16,32538,7037,25501,49,143,20,29
18952,26,24999,16,68539,4175,64364,98,32,46,52
15564,10,15894,9,748,106,642,2,30,1,1
16777,26,23285,16,138065,109491,28574,429,186,230,199
13700,15,24234,11,1056,682,374,10,16,6,4
22258,10,1328,9,210,110,100,2,31,1,1
18061,26,17010,16,2303,1334,969,18,16,10,8
15731,10,19380,9,170,87,83,2,30,1,1
22336,10,10628,9,646,200,446,6,62,3,3
10887,2037,20550,1565,70,70,0,1,5,1,0
10181,15,12428,11,36568,23029,13539,94,194,47,47
14269,10,10177,9,184,94,90,2,31,1,1
5925,26,28844,16,70,70,0,1,5,1,0
13737,26,12946,16,6936,819,6117,20,85,11,9
15928,10,1947,9,214,110,104,2,30,1,1
13606,26,4679,16,61842,4466,57376,109,293,46,63
3474,26,12882,16,4640,1416,3224,18,121,9,9
5905,26,9075,16,3697,2379,1318,26,16,14,12
11015,1930,55,1474,70,70,0,1,5,1,0
8546,10,10019,9,199,102,97,2,30,1,1
11119,26,6546,16,6032,3616,2416,39,187,20,19
10948,26,14879,16,28031,11553,16478,122,108,61,61
12529,2145,27193,1657,70,70,0,2,7,2,0
14785,10,24157,9,811,94,717,2,30,1,1
16004,10,4254,9,177,94,83,2,29,1,1
7304,26,27399,16,39986,3118,36868,72,82,30,42
7550,18,11240,13,184,94,90,2,30,1,1
15862,10,28226,9,177,94,83,2,30,1,1
15179,26,13947,16,7314,2061,5253,29,92,15,14
14776,10,5497,9,198,102,96,2,31,1,1
10840,1682,20735,1287,66,66,0,1,5,1,0
20902,10,28258,9,209,79,130,2,30,1,1
9739,26,21326,16,2862,1587,1275,15,95,9,6
11220,1438,938,1092,70,70,0,2,8,2,0
7936,26,19472,16,12813,5036,7777,40,383,20,20
5786,10,18536,9,78,78,0,1,29,1,0
10957,3171,26878,2457,70,70,0,1,5,1,0
11124,26,19069,16,2983,1667,1316,25,153,12,13
21642,10,15530,9,183,94,89,2,30,1,1
9647,26,28065,16,5987,1085,4902,15,25,8,7
17447,10,7639,9,228,94,134,2,30,1,1
21825,10,2871,9,237,110,127,2,30,1,1
14823,26,14457,16,8971,2446,6525,50,347,23,27
14104,10,6197,9,186,95,91,2,30,1,1
15749,26,14319,16,7162,1731,5431,29,32,14,15
9009,26,23864,16,8518,2260,6258,32,806,12,20
21754,10,19387,9,184,86,98,2,29,1,1
19312,26,13330,16,4890,1219,3671,17,28,10,7
14256,10,1192,9,198,102,96,2,30,1,1
21048,1965,24679,1501,504,382,122,8,16,6,2
8842,10,26989,9,322,110,212,4,31,2,2
18867,26,5763,16,134,60,74,3,5,2,1
21494,10,21938,9,258,110,148,2,30,1,1
22683,26,27116,16,92044,4379,87665,102,16,37,65
22010,10,20578,9,168,86,82,2,30,1,1
15752,10,16791,9,177,94,83,2,30,1,1
8884,15,25489,11,11291,1348,9943,17,131,6,11
11463,26,6385,16,14908,4027,10881,28,136,11,17
13939,183,24346,121,4365,2581,1784,20,33,11,9
10743,1678,11672,1283,70,70,0,1,5,1,0
1149,10,26421,9,179,86,93,2,29,1,1
11351,26,22919,16,960,539,421,9,52,5,4
15725,10,14613,9,209,110,99,2,30,1,1
5117,26,9690,16,10335,2523,7812,42,32,20,22
15895,26,11563,16,8126,1887,6239,32,732,17,15
22363,10,6283,9,286,103,183,4,52,2,2
15987,15,26235,11,11357,5000,6357,22,30,11,11
11852,26,23904,16,14640,5951,8689,52,115,26,26
18456,2363,5874,1838,320,140,180,6,7,3,3
21988,10,22134,9,177,94,83,2,30,1,1
8376,10,11397,9,199,102,97,2,31,1,1
8757,10,2875,9,168,86,82,2,32,1,1
15319,26,20824,16,6205,986,5219,16,32,10,6
1092,26,12322,16,6100,777,5323,17,26,9,8
15747,10,17793,9,177,94,83,2,30,1,1
16787,26,1803,16,9371,1936,7435,26,29,14,12
15037,10,3566,9,196,102,94,2,31,1,1
21712,10,25087,9,184,94,90,2,31,1,1
10,20,24400,14,114,114,0,2,32,2,0
14759,10,27697,9,745,93,652,2,30,1,1
15016,15,22894,11,17128,1499,15629,24,21,9,15
16713,26,1339,16,7493,1658,5835,22,255,12,10
22236,10,12728,9,193,102,91,2,30,1,1
16021,94,24921,73,792,792,0,13,1199,13,0
4728,26,16197,16,4659,1752,2907,19,30,11,8
17804,15,28647,11,2026957,42480,1984477,1975,80,655,1320
22456,10,27966,9,178,94,84,2,30,1,1
10536,216,22504,139,156,156,0,3,8,3,0
8832,26,28792,16,14531,7971,6560,36,190,20,16
17264,26,24426,16,4934,1351,3583,21,21,11,10
19546,15,1931,11,1864,1024,840,10,16,6,4
975,15,11009,11,378,192,186,7,26,4,3
15099,26,21174,16,8760,3693,5067,20,90,12,8
14245,10,20005,9,214,110,104,2,30,1,1
13132,26,14416,16,14063,6328,7735,33,37,16,17
9766,15,19651,11,11907,10409,1498,28,52,16,12
21327,900,20222,664,66,66,0,2,8,2,0
21971,10,4744,9,186,95,91,2,31,1,1
14313,2463,14764,1914,320,140,180,6,6,3,3
16021,2627,8704,2037,132,132,0,3,1199,3,0
15635,10,5718,9,182,102,80,2,29,1,1
4658,18,22477,13,184,94,90,2,30,1,1
8992,26,1564,16,21625,7638,13987,45,48,24,21
6250,2010,7259,1540,148,86,62,2,30,1,1
14953,10,28184,9,172,94,78,2,29,1,1
17234,10,14022,9,205,86,119,2,30,1,1
16021,1858,11459,1417,1566,332,1234,11,1199,5,6
14360,10,27658,9,188,96,92,2,31,1,1
14192,10,20585,9,177,94,83,2,29,1,1
13783,10,24264,9,825,99,726,2,31,1,1
14788,10,12135,9,184,102,82,2,30,1,1
2172,2785,11037,2161,323,150,173,2,1199,1,1
18153,26,3012,16,4648,1505,3143,17,141,9,8
2724,1240,2136,920,422,164,258,6,30,3,3
14334,1674,16324,1281,210,140,70,4,14,3,1
18431,26,14646,16,6041,1830,4211,21,82,10,11
8728,10,12124,9,198,94,104,2,30,1,1
14148,18,14941,13,184,94,90,2,30,1,1
9475,10,21918,9,237,93,144,2,0,1,1
18224,10,13245,9,218,78,140,2,30,1,1
10017,15,17893,11,291594,13131,278463,312,159,116,196
4681,26,28667,16,8102,2685,5417,24,17,15,9
2364,10,9726,9,242,98,144,2,30,1,1
9723,15,22050,11,32612,18106,14506,83,24,47,36
12626,10,3999,9,260,86,174,2,30,1,1
13669,26,10188,16,22687,6933,15754,50,50,26,24
16535,10,17201,9,168,78,90,2,30,1,1
14449,26,14430,16,8420,4472,3948,63,450,32,31
9166,10,17784,9,196,102,94,2,30,1,1
3330,26,24101,16,3723,2408,1315,28,376,15,13
14029,26,1282,16,7347,2127,5220,18,135,8,10
17208,26,24951,16,6278402,111931,6166471,5306,1119,732,4574
22674,10,11126,9,184,94,90,2,31,1,1
5993,15,14505,11,306627,58973,247654,556,297,246,310
21350,10,21464,9,352,86,266,4,36,2,2
11733,26,17017,16,67984,17257,50727,121,148,50,71
9552,10,28744,9,755,94,661,2,31,1,1
13694,26,13128,16,15722,5108,10614,39,16,22,17
8708,26,9371,16,9824,1839,7985,27,172,13,14
8440,295,21413,190,2163,676,1487,14,15,7,7
21582,10,26428,9,214,102,112,2,29,1,1
22179,10,18443,9,184,94,90,2,29,1,1
15497,10,16440,9,177,94,83,2,31,1,1
20130,26,20392,16,14891,3970,10921,32,33,15,17
9506,10,25770,9,214,110,104,2,29,1,1
22435,10,1991,9,758,102,656,2,30,1,1
15006,10,8076,9,166,86,80,2,30,1,1
8763,10,14161,9,168,86,82,2,31,1,1
11841,15,8052,11,4214,1921,2293,18,383,10,8
20399,40,23936,23,178,118,60,2,15,1,1
3830,15,25002,11,1299,793,506,12,15,6,6
2817,10,11579,9,214,82,132,2,33,1,1
384,15,2321,11,6826,1214,5612,20,105,12,8
15380,10,27347,9,178,94,84,2,31,1,1
1219,1550,16684,1181,481,150,331,2,1200,1,1
4665,26,8106,16,13435,2441,10994,30,26,16,14
21044,1823,14739,1390,66,66,0,2,8,2,0
1000,26,23109,16,3616,429,3187,11,16,6,5
9221,26,3661,16,7199,2528,4671,18,76,10,8
14372,10,480,9,198,101,97,2,30,1,1
1731,280,15976,177,490,149,341,2,1200,1,1
8930,26,23412,16,7128,865,6263,19,127,9,10
15019,10,3861,9,711,87,624,2,31,1,1
14432,15,7836,11,11093,1415,9678,18,18,8,10
9669,15,15512,11,152171,9332,142839,189,156,78,111
12728,26,18446,16,8935,4627,4308,22,121,12,10
21306,1926,10711,1470,70,70,0,1,4,1,0
15580,10,9309,9,183,94,89,2,30,1,1
22035,10,4749,9,335,90,245,4,35,2,2
14114,10,4862,9,170,87,83,2,31,1,1
17814,26,19434,16,5173,860,4313,16,15,9,7
6728,26,26152,16,368,160,208,6,33,3,3
14136,10,4946,9,200,102,98,2,30,1,1
14054,10,5327,9,174,89,85,2,30,1,1
14284,10,19146,9,214,110,104,2,30,1,1
8383,10,11273,9,401,142,259,2,30,1,1
20541,26,22141,16,571,166,405,2,30,1,1
15068,26,27699,16,11756,4004,7752,26,121,12,14
9069,15,24042,11,1173,672,501,8,31,5,3
8467,26,10915,16,8282,3240,5042,40,255,20,20
14860,10,11081,9,182,93,89,2,31,1,1
15539,10,23631,9,177,94,83,2,30,1,1
16450,15,224,11,3822,2132,1690,19,32,11,8
14954,10,3679,9,177,94,83,2,30,1,1
14083,26,7579,16,165191,6141,159050,184,30,67,117
22055,10,17134,9,195,102,93,2,30,1,1
17282,26,13230,16,4330,1777,2553,18,122,9,9
22371,10,6440,9,230,110,120,2,30,1,1
4533,15,16920,11,1638,1324,314,10,16,5,5
13511,26,28450,16,70,70,0,1,5,1,0
8584,1324,4041,1000,258,78,180,2,30,1,1
8817,10,13060,9,312,94,218,2,29,1,1
10614,26,10867,16,3021,960,2061,14,135,7,7
4005,26,13425,16,571121,38361,532760,718,69,342,376
13644,10,7287,9,168,86,82,2,29,1,1
14010,10,28733,9,271,93,178,4,43,2,2
10503,10,22481,9,217,87,130,2,31,1,1
7500,15,20152,11,8300,966,7334,14,20,6,8
8349,10,5361,9,199,102,97,2,30,1,1
9118,10,21699,9,216,110,106,2,30,1,1
15331,10,18429,9,760,97,663,2,30,1,1
13757,10,24249,9,200,90,110,2,30,1,1
6250,2012,19037,1542,245,182,63,2,30,1,1
3937,10,5664,9,168,78,90,2,29,1,1
12575,3005,10298,2336,70,70,0,1,4,1,0
9472,15,3045,11,366,180,186,7,47,4,3
2724,1240,10706,920,422,164,258,6,30,3,3
4970,676,4061,475,130,70,60,2,5,1,1
13642,26,28040,16,69664,6958,62706,98,23,46,52
22397,10,27456,9,402,142,260,2,31,1,1
21101,2082,508,1604,66,66,0,2,8,2,0
6272,26,11626,16,90562,4227,86335,118,200,49,69
13684,10,20077,9,177,94,83,2,30,1,1
22590,10,0,0,191,75,116,2,30,1,1
15898,10,13798,9,184,94,90,2,31,1,1
15479,10,14981,9,167,86,81,2,31,1,1
21789,10,26712,9,258,110,148,2,29,1,1
12161,26,20622,16,20745,2083,18662,36,322,15,21
22385,10,27200,9,634,199,435,6,79,3,3
22002,10,22175,9,193,102,91,2,29,1,1
10317,26,13066,16,8248,2460,5788,45,17,26,19
15657,10,11926,9,198,102,96,2,30,1,1
8577,26,21391,16,17524,2569,14955,38,124,17,21
9020,10,25182,9,168,78,90,2,30,1,1
10848,2209,16331,1711,258,70,188,4,8,2,2
22297,10,23366,9,212,102,110,2,29,1,1
12933,26,6728,16,3182,1568,1614,8,120,4,4
13900,26,5280,16,3257,782,2475,17,140,8,9
17418,15,6674,11,1031,314,717,13,175,3,10
17170,26,6054,16,7415,2363,5052,17,120,9,8
14828,10,10048,9,176,90,86,2,31,1,1
10336,15,25962,11,6798,4486,2312,42,107,22,20
21303,10,335,9,211,102,109,2,30,1,1
4834,26,8873,16,153,93,60,2,5,1,1
10958,2687,4511,2086,70,70,0,1,5,1,0
21086,15,21620,11,314,192,122,6,15,4,2
13125,15,17060,11,1515,481,1034,11,16,6,5
14522,10,19503,9,199,102,97,2,29,1,1
10220,15,21126,11,254,128,126,5,16,3,2
13758,26,25296,16,12000,3846,8154,29,28,17,12
2744,1238,130,918,880,126,754,3,31,2,1
15798,10,4776,9,760,97,663,2,31,1,1
4005,26,3850,16,7504,2762,4742,35,61,17,18
9273,6,21822,6,184,120,64,4,11,3,1
11339,26,23160,16,65770,4466,61304,94,46,44,50
14469,10,7776,9,195,102,93,2,31,1,1
13616,10,20655,9,241,102,139,2,31,1,1
10064,26,7026,16,167483,7402,160081,221,23,93,128
22047,10,1975,9,728,96,632,2,31,1,1
13656,10,18516,9,196,102,94,2,31,1,1
19344,10,0,0,223,89,134,2,30,1,1
14639,10,25085,9,168,94,74,2,29,1,1
15200,10,21004,9,193,102,91,2,29,1,1
9721,10,15567,9,196,102,94,2,30,1,1
8865,26,1062,16,9968,2106,7862,27,128,14,13
15412,10,5149,9,180,94,86,2,30,1,1
2744,1566,17151,1197,889,126,763,2,30,1,1
22127,10,24565,9,168,86,82,2,30,1,1
9053,10,15558,9,197,102,95,2,29,1,1
2870,26,22905,16,5746,1271,4475,25,105,12,13
21419,10,8268,9,301,108,193,4,49,2,2
14229,2215,19441,1716,504,318,186,8,15,5,3
15631,10,10402,9,197,94,103,2,29,1,1
22703,10,18765,9,214,110,104,2,30,1,1
10735,26,27461,16,7117,619,6498,19,34,6,13
2744,1239,27276,919,881,126,755,2,31,1,1
21839,10,618,9,292,102,190,2,30,1,1
12367,1103,13900,810,70,70,0,2,8,2,0
18491,15,24269,11,20301,1264,19037,28,26,11,17
18341,26,1917,16,10324,8406,1918,44,87,26,18
21323,726,5819,519,70,70,0,1,4,1,0
14454,10,3274,9,429,94,335,4,52,2,2
15242,10,7478,9,199,102,97,2,30,1,1
3440,26,11719,16,3603,2013,1590,21,42,12,9
16021,1929,15307,1473,545,166,379,2,1199,1,1
4205,26,6040,16,7050,984,6066,18,39,12,6
6267,26,10795,16,276,70,206,5,26,2,3
15738,10,23891,9,178,94,84,2,29,1,1
8487,10,26561,9,177,94,83,2,30,1,1
18379,15,5189,11,1498,539,959,10,77,6,4
13709,15,13097,11,306,180,126,6,26,4,2
4872,26,13519,16,25214,14000,11214,66,99,34,32
22047,10,12181,9,184,94,90,2,31,1,1
7738,26,4019,16,11278,2044,9234,32,178,17,15
6250,1988,27627,1518,148,86,62,2,30,1,1
10878,26,25689,16,68198,5503,62695,102,40,43,59
4398,26,7669,16,7480,1122,6358,27,257,13,14
17854,26,4601,16,7310,967,6343,18,25,10,8
15600,18,20902,13,184,94,90,2,30,1,1
14016,10,12138,9,277,102,175,2,30,1,1
10568,26,22520,16,15967,3046,12921,39,173,15,24
15731,10,19879,9,177,94,83,2,31,1,1
17755,26,436,16,2149,1277,872,18,829,10,8
6125,26,8720,16,5586,1404,4182,17,212,10,7
22179,10,8863,9,389,134,255,2,30,1,1
8323,26,12629,16,8569,2165,6404,23,34,12,11
14261,10,24031,9,816,97,719,2,30,1,1
5507,10,22620,9,223,78,145,2,30,1,1
13268,10,23954,9,235,90,145,2,33,1,1
15367,10,440,9,782,105,677,2,31,1,1
10801,885,421,654,70,70,0,1,5,1,0
21213,10,6643,9,179,94,85,2,31,1,1
5115,26,11452,16,8871,3470,5401,24,123,13,11
22536,10,4107,9,184,94,90,2,30,1,1
9778,26,11526,16,8220,1670,6550,26,71,13,13
21923,10,5458,9,199,102,97,2,30,1,1
13738,10,3897,9,301,94,207,2,30,1,1
15943,26,25592,16,1056,569,487,10,38,6,4
7180,10,28825,9,199,94,105,2,30,1,1
15714,10,18003,9,733,94,639,2,30,1,1
11873,26,4403,16,9893,2231,7662,42,113,21,21
10311,18,8108,13,184,94,90,2,30,1,1
22194,10,2152,9,181,94,87,2,30,1,1
8789,26,12396,16,36302,2869,33433,67,180,32,35
13359,26,26075,16,8367,3945,4422,81,616,42,39
20386,10,26524,9,248,78,170,2,30,1,1
14614,10,10300,9,197,102,95,2,35,1,1
10998,2191,3872,1696,70,70,0,2,8,2,0
22317,10,26795,9,198,94,104,2,29,1,1
18465,15,10133,11,1135,736,399,7,95,4,3
6656,15,10724,11,1947,1182,765,10,515,6,4
15830,10,12395,9,177,94,83,2,30,1,1
16951,255,25970,160,156,62,94,2,10,1,1
3225,2000,906,1530,148,86,62,2,31,1,1
17147,26,4655,16,7014,1630,5384,20,120,10,10
532,247,0,0,3354,1792,1562,46,194,23,23
12412,2172,11959,1678,492,306,186,8,16,5,3
14781,10,318,9,177,94,83,2,30,1,1
11151,3008,4465,2339,66,66,0,1,5,1,0
14816,10,7508,9,174,89,85,2,31,1,1
22049,10,20404,9,881,243,638,6,39,3,3
5933,26,2236,16,994089,30018,964071,1058,350,373,685
13019,26,815,16,499,425,74,4,0,3,1
21737,10,24804,9,199,102,97,2,30,1,1
8878,10,12710,9,172,88,84,2,30,1,1
14005,10,10586,9,215,102,113,2,30,1,1
12569,2048,20400,1575,70,70,0,1,4,1,0
2197,10,8912,9,625,79,546,2,30,1,1
4352,279,19611,176,7584,4075,3509,51,169,27,24
4707,26,16164,16,5783,1761,4022,24,46,14,10
8698,10,26343,9,331,92,239,4,40,2,2
213,298,486,193,10300,8829,1471,24,15,13,11
15295,10,8856,9,170,87,83,2,31,1,1
18493,2627,21724,2037,70,70,0,1,5,1,0
9093,10,23680,9,214,110,104,2,30,1,1
8946,10,3601,9,183,94,89,2,31,1,1
13558,26,21059,16,10035,2160,7875,35,120,18,17
15412,2381,26426,1850,70,70,0,1,5,1,0
15491,10,17838,9,778,103,675,2,30,1,1
1659,10,5986,9,404,259,145,3,32,2,1
11159,2843,5147,2207,70,70,0,2,8,2,0
12280,2648,791,2056,546,306,240,9,142,5,4
15113,10,28532,9,209,110,99,2,30,1,1
21212,26,19976,16,103248,6121,97127,124,144,47,77
7034,10,19463,9,235,90,145,2,32,1,1
11950,26,24370,16,214,140,74,4,15,3,1
17947,10,23491,9,168,78,90,2,30,1,1
18460,26,21625,16,7643,1678,5965,21,80,11,10
17896,26,7744,16,6055,3602,2453,16,136,8,8
15543,10,25332,9,428,103,325,4,34,2,2
21107,26,9558,16,8243,4867,3376,33,137,16,17
7229,26,19744,16,4702,1795,2907,19,28,11,8
11171,50,8025,33,316,136,180,6,7,3,3
9148,10,17946,9,172,88,84,2,30,1,1
22704,10,6559,9,652,209,443,6,50,3,3
21847,10,24659,9,198,102,96,2,31,1,1
5239,26,20152,16,3159,1237,1922,14,19,8,6
7843,10,22438,9,168,78,90,2,30,1,1
3802,26,26668,16,50100,46087,4013,73,121,43,30
22206,10,14092,9,199,102,97,2,30,1,1
14398,15,24589,11,3538,701,2837,11,20,6,5
21937,10,9610,9,760,97,663,2,30,1,1
11162,2813,24007,2183,70,70,0,2,7,2,0
4893,26,27113,16,1053962,45604,1008358,1190,69,456,734
21094,3076,16932,2389,66,66,0,2,8,2,0
2744,91,11531,71,857,126,731,2,30,1,1
14280,26,24522,16,141647,19296,122351,203,55,102,101
17131,26,17552,16,9378,2858,6520,48,196,21,27
15422,1809,22535,1379,624,318,306,10,15,5,5
13891,26,3841,16,6799,1581,5218,27,25,14,13
9100,10,2166,9,216,110,106,2,31,1,1
7980,26,19863,16,19394,2961,16433,51,196,24,27
10365,1835,26481,1396,70,70,0,1,5,1,0
8268,10,11835,9,306,212,94,3,29,2,1
15518,10,12666,9,711,87,624,2,30,1,1
8410,10,8181,9,212,102,110,2,30,1,1
532,247,0,0,3498,1872,1626,48,195,24,24
5564,26,16445,16,7855,1850,6005,24,187,14,10
11543,15,23036,11,1680,696,984,11,142,6,5
11100,15,2782,11,362,240,122,7,25,5,2
15162,10,14464,9,177,94,83,2,31,1,1
10225,15,17910,11,8827,4961,3866,34,47,18,16
13385,26,6557,16,7077,3245,3832,24,173,12,12
8584,1238,8628,918,249,78,171,2,30,1,1
6335,26,28539,16,130,70,60,3,5,2,1
8754,10,23682,9,733,94,639,2,29,1,1
7964,26,19366,16,10825,4667,6158,25,159,15,10
16476,15,2777,11,2482,516,1966,11,75,6,5
9014,10,6212,9,166,86,80,2,30,1,1
12021,26,23083,16,33229,7810,25419,63,44,24,39
4341,26,11420,16,10488,4495,5993,38,32,20,18
6162,15,5145,11,31196,607,30589,29,500,5,24
14794,10,15032,9,190,97,93,2,31,1,1
8584,1238,19219,918,71,71,0,1,30,1,0
12090,26,3096,16,3907,2251,1656,16,321,8,8
15650,15,14920,11,2944,1074,1870,12,75,7,5
18511,351,23176,224,3105,1298,1807,20,16,10,10
13715,26,16455,16,18682,8068,10614,42,62,22,20
9304,15,833,11,11574,901,10673,20,46,11,9
8685,15,8721,11,2981,1514,1467,12,38,7,5
11136,2095,2851,1615,70,70,0,2,9,2,0
3718,10,14694,9,213,79,134,2,33,1,1
15460,10,23684,9,250,87,163,4,60,2,2
14571,10,11900,9,193,102,91,2,30,1,1
10220,26,21364,16,3402,1258,2144,13,135,6,7
4963,26,1430,16,499,425,74,4,1,3,1
21631,10,15314,9,168,86,82,2,32,1,1
12723,1133,26671,835,164,70,94,2,5,1,1
7286,26,3136,16,8471,3275,5196,21,120,11,10
5026,26,19465,16,8918,730,8188,20,72,7,13
22015,10,10848,9,168,86,82,2,29,1,1
8698,10,5585,9,195,102,93,2,30,1,1
529,15,1963,11,326,186,140,6,29,4,2
8980,10,0,0,166,73,93,2,30,1,1
19893,26,18221,16,4283,2038,2245,14,135,7,7
15683,10,0,0,318,95,223,2,31,1,1
15000,10,9989,9,170,87,83,2,30,1,1
9666,26,23582,16,460,394,66,4,0,3,1
21812,10,28508,9,209,110,99,2,30,1,1
15197,10,22353,9,757,98,659,2,31,1,1
15832,10,29070,9,170,87,83,2,31,1,1
6611,26,11247,16,8198,656,7542,19,327,5,14
12503,823,6731,603,320,140,180,6,7,3,3
22190,10,9586,9,188,96,92,2,31,1,1
6597,26,23181,16,5977,1326,4651,18,30,11,7
18072,26,8546,16,7448,1347,6101,24,16,13,11
2943,10,12067,9,213,79,134,2,32,1,1
15438,10,16070,9,177,94,83,2,30,1,1
4898,26,20039,16,70,70,0,1,5,1,0
17518,10,26292,9,197,90,107,2,30,1,1
2744,2664,12661,2071,252,252,0,3,32,3,0
6137,26,21110,16,8333,2153,6180,31,100,18,13
8532,10,14641,9,199,94,105,2,31,1,1
22344,10,6304,9,216,110,106,2,30,1,1
15078,10,7753,9,775,103,672,2,31,1,1
9047,26,2448,16,17238,4435,12803,32,103,15,17
4111,26,20496,16,1053,566,487,10,31,6,4
15922,10,3977,9,780,104,676,2,31,1,1
12002,1417,4411,1078,70,70,0,2,8,2,0
22282,10,2712,9,227,94,133,2,29,1,1
15365,26,4848,16,8073,2053,6020,20,16,11,9
14210,10,14652,9,168,86,82,2,30,1,1
15552,10,21834,9,180,94,86,2,29,1,1
20544,26,28998,16,569,164,405,2,30,1,1
17714,26,24051,16,4038,1219,2819,22,135,9,13
21245,522,13078,345,66,66,0,1,5,1,0
15513,26,6295,16,4184,2787,1397,19,345,10,9
8646,10,26160,9,184,94,90,2,31,1,1
14831,10,13069,9,231,86,145,2,30,1,1
17207,26,21811,16,2976,1572,1404,17,17,9,8
8418,26,24769,16,15567,1944,13623,40,81,17,23
15149,26,28743,16,16205,6113,10092,36,110,20,16
14146,10,19270,9,783,96,687,2,30,1,1
18323,26,25152,16,12389,5180,7209,31,149,17,14
8477,10,27145,9,186,95,91,3,33,2,1
6658,26,25326,16,172272,14401,157871,254,418,100,154
11654,26,4510,16,26901,2286,24615,46,319,18,28
15883,26,1216,16,64382,9305,55077,101,123,41,60
6380,26,10390,16,224178,118713,105465,333,140,162,171
12608,882,8707,651,70,70,0,1,5,1,0
22685,10,2303,9,210,86,124,2,30,1,1
21294,10,22922,9,209,110,99,2,30,1,1
22090,10,18154,9,209,110,99,2,30,1,1
15779,26,8255,16,7306,2784,4522,22,202,12,10
961,15,12049,11,378,192,186,7,26,4,3
6861,234,3251,149,7292,4509,2783,50,6392,25,25
16387,15,28547,11,6515,1210,5305,15,23,8,7
10984,26,22586,16,2995,1894,1101,20,46,11,9
9,18,9834,13,184,94,90,2,30,1,1
9433,15,26738,11,3325,607,2718,11,45,6,5
3448,26,18501,16,4764,1876,2888,22,81,10,12
15287,10,1464,9,177,94,83,2,30,1,1
21328,26,27336,16,4395,1673,2722,14,119,7,7
11874,15,3627,11,4004,1347,2657,29,114,15,14
4650,26,24706,16,214,140,74,4,15,3,1
15392,10,3908,9,772,103,669,2,30,1,1
8673,10,14138,9,177,94,83,2,30,1,1
16971,10,17345,9,167,78,89,2,30,1,1
13576,26,24151,16,4401,1494,2907,19,27,11,8
1393,26,4789,16,5599,2459,3140,23,29,14,9
12141,26,8352,16,6053,974,5079,20,66,10,10
15038,10,24279,9,392,86,306,2,30,1,1
14997,15,9317,11,39249,938,38311,40,104,11,29
2260,15,9283,11,490,264,226,8,26,5,3
14901,10,9143,9,183,94,89,2,29,1,1
13724,15,28659,11,246,120,126,5,16,3,2
9075,10,11200,9,258,110,148,2,30,1,1
16366,15,20274,11,6519,1210,5309,15,17,8,7
14297,10,16405,9,177,94,83,2,30,1,1
8693,10,8003,9,200,94,106,2,30,1,1
8500,26,4713,16,30571,1990,28581,53,80,21,32
11274,2997,9235,2330,70,70,0,2,6,2,0
12388,2655,18710,2062,70,70,0,2,7,2,0
15240,26,17402,16,8058,2038,6020,20,15,11,9
18684,232,2773,147,9852,2665,7187,60,360,25,35
9362,115,24974,88,70,70,0,2,8,2,0
11146,15,7501,11,422,240,182,8,26,5,3
13448,10,1347,9,245,110,135,2,30,1,1
22073,10,18808,9,211,102,109,2,30,1,1
6999,1081,24693,793,509,150,359,2,1200,1,1
14926,10,11406,9,198,101,97,2,31,1,1
18556,1676,23069,1282,504,318,186,8,16,5,3
13000,15,13419,11,2640,540,2100,12,45,6,6
14849,10,13138,9,177,94,83,2,31,1,1
17711,26,10515,16,3888,1169,2719,13,136,6,7
9133,10,21729,9,198,101,97,2,31,1,1
16129,26,27614,16,291,171,120,4,16,2,2
6604,26,1623,16,13482,3731,9751,40,500,17,23
10070,15,13855,11,10272889,104948,10167941,8416,121,1525,6891
21662,10,20550,9,369,94,275,4,49,2,2
2744,1238,5980,918,901,126,775,2,30,1,1
5103,26,9967,16,101056,3737,97319,107,15,35,72
15913,10,11055,9,199,102,97,2,30,1,1
8375,280,1873,177,66,66,0,1,5,1,0
14738,10,11241,9,180,94,86,2,30,1,1
15283,26,1460,16,8059,2039,6020,20,15,11,9
2732,10,11326,9,197,90,107,2,30,1,1
22011,26,1644,16,1786,172,1614,7,121,3,4
12303,26,4238,16,15368,8643,6725,36,49,19,17
15394,10,19375,9,209,110,99,2,29,1,1
6250,1986,2398,1516,148,86,62,2,30,1,1
7436,26,24795,16,7493,3793,3700,40,109,26,14
18267,26,6420,16,9811,1112,8699,21,125,10,11
14146,10,19629,9,779,86,693,2,29,1,1
14647,10,2389,9,193,102,91,2,31,1,1
21586,10,17475,9,167,86,81,2,30,1,1
10261,26,1401,16,4942,2409,2533,11,120,6,5
15050,10,5622,9,167,86,81,2,31,1,1
22019,10,2514,9,183,94,89,2,30,1,1
21244,10,15153,9,195,102,93,2,30,1,1
10370,1118,17986,823,70,70,0,2,8,2,0
21586,10,24925,9,195,102,93,2,31,1,1
12591,26,28711,16,61501,14276,47225,91,35,39,52
8510,10,8375,9,478,106,372,4,48,2,2
16858,26,1869,16,2408,1399,1009,18,274,9,9
11032,1714,6840,1309,70,70,0,2,7,2,0
22632,15,10955,11,366,180,186,7,28,4,3
12675,676,18459,475,130,70,60,2,5,1,1
10973,10,25229,9,200,86,114,2,30,1,1
5934,26,23069,16,9669,2488,7181,26,149,11,15
8656,26,5865,16,9109,1943,7166,32,270,16,16
4651,26,22582,16,13774,4989,8785,35,51,20,15
6250,2010,3234,1540,157,94,63,2,30,1,1
18001,10,19594,9,198,93,105,2,30,1,1
6250,1986,10782,1516,206,84,122,4,29,2,2
7154,26,697,16,2312,1382,930,19,24,11,8
22374,10,23114,9,194,94,100,2,29,1,1
3066,2544,12421,1977,502,150,352,2,1200,1,1
14754,10,3678,9,194,102,92,2,30,1,1
17397,10,26488,9,70,70,0,1,30,1,0
2237,10,9148,9,198,90,108,2,30,1,1
21964,10,15356,9,164,86,78,2,31,1,1
12134,26,26008,16,4595,1038,3557,19,69,11,8
11172,15,22249,11,246,120,126,5,32,3,2
9278,26,964,16,15217,5689,9528,52,35,27,25
22476,10,25053,9,182,93,89,2,31,1,1
14591,10,583,9,216,102,114,2,30,1,1
5562,10,18544,9,168,78,90,2,30,1,1
15614,10,2082,9,735,88,647,2,31,1,1
9774,10,16048,9,754,94,660,2,30,1,1
13133,26,10016,16,10318,2117,8201,38,371,19,19
15410,10,21129,9,177,94,83,2,30,1,1
15558,15,26403,11,214,140,74,4,35,3,1
4548,26,16008,16,4401,1494,2907,19,25,11,8
17231,26,18491,16,1413,876,537,12,28,6,6
14238,10,1834,9,822,102,720,2,29,1,1
15169,10,1785,9,173,94,79,2,30,1,1
10910,342,3789,218,86,86,0,1,30,1,0
21403,10,15919,9,193,102,91,2,30,1,1
4532,26,10393,16,7440,3165,4275,31,358,17,14
8561,10,17639,9,390,111,279,4,53,2,2
10996,866,5260,640,70,70,0,2,8,2,0
3133,2319,3349,1803,330,330,0,6,3609,6,0
9582,10,6275,9,296,101,195,4,31,2,2
11040,26,2282,16,7722,2568,5154,26,63,15,11
2724,1240,9639,920,422,164,258,6,29,3,3
2744,1239,10613,919,1006,252,754,4,32,3,1
13073,26,23850,16,4699,1792,2907,19,28,11,8
9411,1526,4363,1163,726,726,0,12,1200,12,0
22449,10,17193,9,179,94,85,2,31,1,1
14386,10,15413,9,177,94,83,2,30,1,1
3614,26,2570,16,5987,1678,4309,21,199,12,9
10036,15,7457,11,12289218,202774,12086444,11470,149,2789,8681
9608,15,2087,11,26020,2247,23773,47,18,23,24
11871,26,4842,16,8602,1050,7552,16,120,7,9
9286,10,5151,9,183,94,89,2,29,1,1
22642,10,914,9,728,234,494,6,67,3,3
2891,26,21999,16,5578,1390,4188,19,15,9,10
8662,10,10038,9,194,102,92,2,30,1,1
15899,10,8208,9,167,86,81,2,30,1,1
4835,280,20065,177,479,150,329,2,1199,1,1
21020,1006,7725,740,504,382,122,8,15,6,2
6045,26,5361,16,122547,6414,116133,160,81,61,99
22115,10,20953,9,762,98,664,2,30,1,1
22128,10,4405,9,177,94,83,2,30,1,1
2724,1240,28,920,422,164,258,6,29,3,3
8423,10,6305,9,212,102,110,2,30,1,1
12702,1799,22596,1372,2254,1281,973,17,17,10,7
18822,26,16862,16,9127,2506,6621,38,146,20,18
20097,26,7755,16,14832,3978,10854,32,34,15,17
17701,10,0,0,216,72,144,2,30,1,1
7229,349,10656,222,234,234,0,4,12,4,0
21994,10,4376,9,228,110,118,2,30,1,1
14849,10,2383,9,177,94,83,2,30,1,1
14306,10,21670,9,270,88,182,4,54,2,2
18352,10,11983,9,168,78,90,2,29,1,1
19509,26,11405,16,12453,3460,8993,43,18,24,19
13517,26,2050,16,119863,100823,19040,322,229,183,139
15858,10,18524,9,177,94,83,2,29,1,1
3564,26,20962,16,11277,2233,9044,43,215,20,23
11496,15,23004,11,1916,1467,449,10,19,6,4
21464,10,26824,9,186,95,91,2,30,1,1
21840,10,3879,9,181,94,87,2,29,1,1
22563,10,17376,9,198,102,96,2,30,1,1
18066,26,3449,16,166170,5611,160559,189,16,78,111
8859,26,6737,16,12060,4857,7203,25,71,14,11
14612,10,14494,9,199,102,97,2,29,1,1
6755,26,22794,16,1442,721,721,15,199,8,7
17277,10,19322,9,168,78,90,2,29,1,1
7098,26,28062,16,4497,2208,2289,15,137,7,8
18560,2819,23707,2188,164,70,94,2,5,1,1
9002,10,14264,9,183,94,89,2,30,1,1
13302,26,19061,16,68345,58488,9857,122,329,62,60
12540,2296,3607,1780,492,306,186,8,15,5,3
5763,26,23147,16,448,78,370,7,20,2,5
9594,10,22739,9,209,110,99,2,30,1,1
14514,10,25475,9,181,94,87,2,30,1,1
14859,10,21329,9,235,86,149,2,30,1,1
14896,26,2937,16,37465,18615,18850,299,588,135,164
867,26,20354,16,6677,1097,5580,21,25,11,10
9046,26,2134,16,5019,1424,3595,15,87,9,6
11692,15,14211,11,1746,980,766,15,151,8,7
4,3181,3,2467,102,102,0,1,5,1,0
17284,10,2352,9,168,78,90,2,30,1,1
6789,26,26457,16,8551,1685,6866,24,170,12,12
14993,10,5900,9,178,94,84,2,30,1,1
5116,26,26828,16,90369,3417,86952,95,15,30,65
15778,10,22294,9,701,88,613,2,30,1,1
9070,10,10282,9,200,94,106,2,29,1,1
914,26,9592,16,5658,501,5157,14,15,7,7
8850,10,8772,9,305,94,211,2,29,1,1
10275,26,20849,16,9466,2602,6864,41,185,20,21
13961,10,9141,9,193,102,91,2,31,1,1
22631,10,21602,9,181,94,87,2,30,1,1
15921,10,28527,9,177,94,83,2,30,1,1
9064,213,28185,138,78,78,0,1,5,1,0
4690,26,22133,16,7866,2680,5186,26,16,14,12
18125,26,16638,16,3643,607,3036,13,120,6,7
0,0,0,0,320,320,0,5,0,5,0
17792,10,6696,9,199,94,105,2,30,1,1
14711,10,7615,9,167,86,81,2,30,1,1
15610,10,7796,9,194,102,92,2,33,1,1
2744,1239,23809,919,876,126,750,2,30,1,1
1036,15,28951,11,1643,485,1158,10,15,5,5
14449,10,12651,9,181,94,87,2,31,1,1
11271,2649,12850,2057,70,70,0,2,5,2,0
13507,10,5635,9,198,93,105,2,30,1,1
12574,1013,6070,747,70,70,0,1,5,1,0
15627,10,10515,9,194,102,92,2,30,1,1
553,10,2065,9,213,87,126,2,31,1,1
4580,10,16051,9,213,87,126,2,30,1,1
14224,10,443,9,177,94,83,2,29,1,1
11224,26,14272,16,9075,3727,5348,38,50,18,20
8889,10,16860,9,427,90,337,4,41,2,2
22637,10,9119,9,210,110,100,2,30,1,1
8414,10,25118,9,478,196,282,6,63,3,3
16021,3138,1149,2436,149,149,0,1,1200,1,0
7233,26,23150,16,7951,1449,6502,22,125,12,10
8786,26,9408,16,4565,3479,1086,13,138,8,5
154,10,354,9,194,87,107,2,30,1,1
15513,26,20535,16,5147,2613,2534,19,137,10,9
8408,26,21388,16,31778,6075,25703,54,49,28,26
7876,26,959,16,69732,65832,3900,104,316,55,49
9,18,22954,13,184,94,90,2,30,1,1
13825,10,2876,9,194,102,92,2,33,1,1
2724,1240,16255,920,422,164,258,6,30,3,3
14409,10,18983,9,177,94,83,2,31,1,1
12527,880,23565,649,64,64,0,1,30,1,0
22534,10,15655,9,200,102,98,2,31,1,1
14052,10,14529,9,182,93,89,2,31,1,1
21568,10,8058,9,209,110,99,2,30,1,1
14790,10,3968,9,211,110,101,2,30,1,1
21897,10,10080,9,193,102,91,2,30,1,1
16021,3213,6833,2491,330,330,0,6,1199,6,0
21723,10,2243,9,225,110,115,2,30,1,1
22681,10,22446,9,707,94,613,2,29,1,1
7640,676,21501,475,130,70,60,2,5,1,1
13882,26,28678,16,10293,2881,7412,25,45,14,11
14760,10,23683,9,210,110,100,2,30,1,1
18534,942,1340,694,70,70,0,1,5,1,0
15332,10,12959,9,167,86,81,2,31,1,1
3720,15,2061,11,416,210,206,7,15,4,3
9477,15,3484,11,5517,2843,2674,19,47,10,9
843,10,22016,9,225,78,147,2,29,1,1
19642,26,27455,16,132180,4407,127773,146,75,51,95
14804,10,3534,9,165,86,79,2,30,1,1
8281,26,26442,16,44584,2838,41746,66,31,31,35
13107,1238,2580,918,924,924,0,3,30,3,0
7388,26,11605,16,206090,6478,199612,211,170,69,142
21687,10,25564,9,183,94,89,2,29,1,1
22484,10,13796,9,222,86,136,2,30,1,1
21551,10,15642,9,329,118,211,2,30,1,1
8833,26,17194,16,8329,2188,6141,29,100,16,13
14106,10,13514,9,193,102,91,2,30,1,1
9411,2210,10623,1712,132,132,0,3,1200,3,0
4164,26,3983,16,8272,2091,6181,25,331,12,13
1960,10,6354,9,376,94,282,2,30,1,1
18908,26,7284,16,2356,1309,1047,16,31,9,7
22193,10,8005,9,190,97,93,2,31,1,1
7754,26,28199,16,2701330,44089,2657241,2230,134,296,1934
14866,26,25211,16,97608,4852,92756,108,121,37,71
8495,26,9067,16,74569,3173,71396,97,80,36,61
6740,26,16735,16,4922,2860,2062,25,39,14,11
15167,10,3327,9,262,94,168,2,30,1,1
11056,568,1634,382,70,70,0,1,4,1,0
13872,26,10446,16,711879,19394,692485,724,98,238,486
13774,10,25610,9,177,94,83,2,29,1,1
15617,10,10045,9,234,94,140,2,29,1,1
3739,26,26742,16,10255,2803,7452,35,26,18,17
15236,26,25513,16,334,70,264,5,17,1,4
19506,26,6697,16,6279,1859,4420,25,16,14,11
21908,26,18759,16,2924,653,2271,13,135,6,7
8199,26,21176,16,4398,1491,2907,19,27,11,8
17190,15,907,11,1883,1448,435,11,16,6,5
0,0,0,0,480,244,236,4,0,2,2
14905,10,2799,9,202,103,99,2,31,1,1
12116,26,2784,16,16336,3219,13117,46,59,21,25
16344,1242,14934,922,468,390,78,5,30,4,1
8584,1238,21055,918,266,71,195,2,31,1,1
8990,10,20155,9,793,101,692,2,30,1,1
6089,26,28495,16,2350,1392,958,17,275,9,8
5418,26,21849,16,64247,3857,60390,94,30,43,51
11569,15,5121,11,2543,691,1852,13,30,8,5
22608,10,13289,9,183,94,89,2,30,1,1
22214,10,13793,9,94,94,0,1,30,1,0
8584,1239,19612,919,255,78,177,2,30,1,1
859,26,9169,16,318,192,126,6,29,4,2
19897,26,21912,16,6973,2413,4560,22,148,11,11
8362,10,5706,9,239,110,129,2,30,1,1
15521,26,8036,16,5601,1203,4398,14,59,9,5
22153,10,7116,9,199,102,97,2,30,1,1
9555,346,21960,220,1626,798,828,11,61,6,5
9082,26,1873,16,3291,1714,1577,18,16,11,7
20452,26,2635,16,5036,2564,2472,15,125,8,7
15147,10,12936,9,749,94,655,2,31,1,1
9940,26,13255,16,7067,1129,5938,19,141,9,10
22335,10,6749,9,324,110,214,2,30,1,1
18874,26,7804,16,8219,2676,5543,40,15,24,16
7985,26,27410,16,33481,5635,27846,73,287,32,41
2744,1509,15407,1148,898,126,772,2,31,1,1
15211,10,14559,9,168,86,82,2,30,1,1
12311,26,21381,16,6118,5698,420,12,124,6,6
1671,10,6032,9,230,90,140,2,30,1,1
9619,26,19422,16,3893,1910,1983,36,255,17,19
7644,15,24786,11,29218,27458,1760,36,22,24,12
8145,26,20020,16,6371,848,5523,20,16,11,9
9943,26,17511,16,1590,1038,552,12,48,6,6
17565,10,2513,9,429,116,313,2,31,1,1
21432,10,22730,9,255,118,137,2,29,1,1
16360,15,26657,11,6526,1210,5316,15,17,8,7
10914,1047,1911,771,70,70,0,2,8,2,0
516,10,6580,9,377,94,283,2,30,1,1
17304,26,22329,16,6278,3531,2747,23,122,12,11
2744,1456,6716,1109,889,126,763,2,31,1,1
15857,10,18688,9,184,94,90,2,30,1,1
4137,26,6256,16,664348,23858,640490,757,119,292,465
6625,233,15674,148,142,142,0,1,4,1,0
15132,10,25854,9,184,94,90,2,31,1,1
4642,26,13132,16,9824,2477,7347,27,37,16,11
6999,3001,1658,2332,501,150,351,2,1200,1,1
13688,26,24208,16,154907,10748,144159,217,20,101,116
8630,26,18860,16,4555,2472,2083,20,119,11,9
13805,10,12503,9,200,102,98,2,30,1,1
22514,10,12606,9,166,85,81,2,30,1,1
7383,26,16244,16,5161,3826,1335,16,137,9,7
13773,10,25595,9,198,102,96,2,31,1,1
5718,15,25257,11,1104,475,629,10,15,6,4
11132,15,12438,11,22495,1895,20600,33,27,15,18
7682,15,20390,11,82082,3212,78870,90,155,27,63
11043,26,22756,16,43964,6675,37289,60,49,25,35
8460,10,25921,9,172,88,84,2,31,1,1
10642,26,9334,16,2013,1363,650,12,134,7,5
9023,26,20385,16,18811,1868,16943,22,142,7,15
12011,26,20437,16,36181,3264,32917,51,62,24,27
2744,80,8486,62,867,126,741,2,30,1,1
7249,26,11436,16,5378,984,4394,18,17,10,8
20775,10,28191,9,235,90,145,2,33,1,1
8874,10,21864,9,193,102,91,2,30,1,1
17043,26,1520,16,5167,700,4467,16,15,7,9
22449,10,19914,9,183,98,85,3,31,2,1
8976,10,22997,9,300,118,182,2,29,1,1
15341,10,7991,9,210,110,100,2,30,1,1
11945,26,19379,16,13229,3527,9702,56,91,28,28
9818,26,24433,16,8709,1708,7001,22,19,11,11
21392,10,15405,9,350,94,256,2,29,1,1
14318,10,25110,9,182,93,89,2,30,1,1
21997,10,15964,9,214,102,112,2,29,1,1
3133,2289,23968,1774,66,66,0,1,3600,1,0
22429,10,20358,9,193,102,91,2,30,1,1
15065,10,12573,9,778,103,675,2,31,1,1
21944,10,23030,9,781,94,687,2,30,1,1
4630,15,3706,11,3565,1020,2545,16,15,9,7
15121,10,23755,9,224,102,122,2,30,1,1
1731,990,20265,731,479,150,329,2,1200,1,1
21340,10,25052,9,264,94,170,2,29,1,1
4229,26,25135,16,26538,7971,18567,70,128,38,32
16390,277,14954,175,8164,1336,6828,34,18,18,16
9968,26,651,16,1445207,43930,1401277,1562,219,556,1006
18443,26,12480,16,70,70,0,1,5,1,0
14626,10,12520,9,728,102,626,2,30,1,1
9462,26,19150,16,13565,6019,7546,35,112,19,16
14711,10,21025,9,278,96,182,4,54,2,2
21318,10,4575,9,200,102,98,2,31,1,1
18477,2691,2545,2090,70,70,0,1,5,1,0
10769,3134,13157,2432,70,70,0,2,8,2,0
21932,10,4500,9,179,94,85,2,29,1,1
929,15,28919,11,17643,1063,16580,26,35,11,15
19663,467,3040,302,10811,2571,8240,27,48,15,12
17038,26,10103,16,12382,9652,2730,43,58,26,17
9362,115,20644,88,70,70,0,1,5,1,0
7443,26,8637,16,6373,1744,4629,22,15,13,9
6516,26,13270,16,10096,3002,7094,25,16,13,12
6869,26,19351,16,424,210,214,7,132,4,3
14390,345,20800,219,70,70,0,1,5,1,0
11458,26,9173,16,29896,14149,15747,61,209,35,26
15143,10,20442,9,701,88,613,2,30,1,1
10535,26,8464,16,828,390,438,11,40,4,7
18529,3226,11329,2502,70,70,0,1,5,1,0
20950,10,10284,9,299,102,197,2,30,1,1
22009,10,12660,9,728,102,626,2,30,1,1
15339,2347,18182,1830,164,70,94,2,5,1,1
22238,10,26275,9,183,94,89,2,31,1,1
13961,26,3771,16,9462,2297,7165,23,15,13,10
6011,10,17991,9,265,111,154,2,0,1,1
8786,15,8944,11,318,192,126,6,42,4,2
9149,10,27487,9,312,90,222,2,31,1,1
10685,10,25738,9,237,86,151,2,29,1,1
13775,10,25247,9,177,94,83,2,30,1,1
1751,188,12965,123,428935914,213443641,215492273,635946,2242,308738,327208
8519,10,21038,9,214,94,120,2,30,1,1
10621,233,29036,148,4183,1283,2900,23,163,13,10
10031,15,27307,11,130,70,60,2,15,1,1
10468,26,17492,16,25490,8419,17071,54,48,30,24
15505,15,14095,11,8325,5642,2683,16,28,9,7
4139,26,15293,16,232,172,60,3,5,2,1
17933,26,7104,16,1401,864,537,12,29,6,6
13738,26,25637,16,5803,4960,843,19,124,11,8
21168,2508,28204,1950,66,66,0,2,8,2,0
15013,10,24917,9,243,94,149,2,32,1,1
9572,26,2305,16,4356,806,3550,14,15,7,7
15665,10,22327,9,229,94,135,2,30,1,1
9811,15,22105,11,15686,1227,14459,24,20,11,13
16494,15,13896,11,318,192,126,6,21,4,2
4092,26,18381,16,7840,1829,6011,24,85,14,10
9984,26,14700,16,6341,1382,4959,19,132,9,10
8787,10,2488,9,501,188,313,6,33,3,3
8959,10,18699,9,718,94,624,2,30,1,1
14999,15,25546,11,34636,928,33708,37,104,11,26
9860,15,12061,11,1649,963,686,7,15,5,2
17294,26,6180,16,6362,1745,4617,25,18,13,12
8670,305,10712,199,8962,1625,7337,28,16,15,13
3269,15,27271,11,7454,2436,5018,26,23,16,10
12736,2443,2906,1898,70,70,0,2,8,2,0
2744,1238,25068,918,869,126,743,2,30,1,1
6250,1993,4003,1523,140,78,62,2,31,1,1
6205,26,27161,16,6865,3366,3499,39,206,15,24
13801,10,360,9,183,94,89,2,30,1,1
11853,26,4779,16,58499,47163,11336,106,115,59,47
2927,15,11998,11,12237,2818,9419,27,26,14,13
13920,10,17812,9,770,101,669,2,30,1,1
11237,220,12671,142,136,136,0,3,14,3,0
2724,1240,22203,920,254,82,172,4,30,2,2
9570,10,9949,9,760,97,663,2,30,1,1
8584,1238,15350,918,78,78,0,1,29,1,0
5877,10,17794,9,216,82,134,2,31,1,1
15197,10,10246,9,179,94,85,2,30,1,1
11581,26,29122,16,5837,1982,3855,19,19,11,8
4198,26,6965,16,5378,1423,3955,19,56,11,8
7069,10,19512,9,216,82,134,2,33,1,1
13680,26,16940,16,3591,1906,1685,22,80,11,11
14447,10,9216,9,168,86,82,2,30,1,1
15148,10,22157,9,438,180,258,6,30,3,3
12108,26,14069,16,6058,1038,5020,20,66,11,9
8566,15,6116,11,40119,2475,37644,49,84,16,33
0,0,0,0,320,320,0,5,0,5,0
9457,15,6451,11,17102,1099,16003,19,16,5,14
14874,10,22572,9,749,89,660,2,30,1,1
14653,10,8084,9,177,94,83,2,30,1,1
15928,10,28755,9,214,110,104,2,30,1,1
8217,26,22851,16,655052,13866,641186,599,31,150,449
9194,10,2259,9,181,94,87,2,30,1,1
22042,10,13532,9,195,102,93,2,30,1,1
8804,10,8422,9,210,110,100,2,30,1,1
8484,10,27188,9,164,84,80,2,31,1,1
12577,26,14347,16,12192,3674,8518,53,454,26,27
6419,26,27202,16,28707,2793,25914,58,115,29,29
17459,26,26254,16,27659,5508,22151,59,47,31,28
15220,26,10398,16,37030,24937,12093,83,1286,30,53
8809,26,12741,16,1640,1089,551,14,15,8,6
3430,26,9974,16,9818,2036,7782,28,31,12,16
10230,15,20006,11,2433,1280,1153,11,20,7,4
4976,26,21317,16,9194,5026,4168,24,32,11,13
8946,10,14829,9,183,94,89,2,29,1,1
22347,10,23123,9,167,86,81,2,29,1,1
10876,2087,7516,1609,70,70,0,2,8,2,0
4127,15,15335,11,871846,24071,847775,900,30,326,574
8376,10,20904,9,199,102,97,2,31,1,1
9054,10,28075,9,767,102,665,2,30,1,1
6250,1987,29109,1517,140,78,62,2,30,1,1
13800,10,14101,9,184,94,90,2,30,1,1
14078,10,14181,9,216,110,106,2,30,1,1
10856,26,24403,16,682,370,312,12,32,7,5
225,10,7896,9,826,826,0,8,44,8,0
12745,2565,3521,1992,552,306,246,9,16,5,4
11037,1876,8624,1432,70,70,0,1,4,1,0
5971,15,13691,11,1866,1032,834,11,150,6,5
16112,15,25445,11,55886,2728,53158,68,148,25,43
3286,26,24854,16,5701,1585,4116,23,1102,13,10
9022,10,14690,9,177,94,83,2,30,1,1
15158,10,9849,9,711,87,624,2,31,1,1
12247,10,8062,9,298,86,212,2,30,1,1
8939,10,8396,9,994,86,908,2,30,1,1
22283,10,13047,9,278,100,178,4,30,2,2
14624,10,11890,9,194,102,92,2,31,1,1
14188,10,26379,9,182,94,88,2,30,1,1
1434,10,4981,9,229,89,140,2,30,1,1
14567,10,14068,9,177,94,83,2,30,1,1
14646,10,19324,9,754,94,660,2,31,1,1
14643,10,10973,9,179,94,85,2,30,1,1
22348,10,1354,9,184,94,90,2,31,1,1
14752,10,17164,9,195,102,93,2,30,1,1
18560,2819,14970,2188,258,70,188,4,8,2,2
17953,15,23493,11,711697,18422,693275,716,50,253,463
14456,10,7146,9,177,94,83,2,30,1,1
2744,1240,17796,920,883,126,757,2,30,1,1
17222,26,838,16,14553,9653,4900,38,19,22,16
9728,287,3500,184,166,166,0,1,1200,1,0
10905,1143,1075,843,70,70,0,1,5,1,0
10524,26,25914,16,7638,1758,5880,24,17,13,11
15925,26,25349,16,4401,1494,2907,19,28,11,8
6681,26,24163,16,30090,19982,10108,77,543,41,36
9751,15,6557,11,1657,1247,410,8,14,5,3
8005,15,8154,11,1638,1324,314,10,15,5,5
1731,3163,2199,2451,481,150,331,2,1200,1,1
3745,26,21359,16,21512,4620,16892,22,127,8,14
21245,522,9939,345,66,66,0,2,8,2,0
15018,10,15286,9,198,102,96,2,31,1,1
13934,10,8159,9,198,94,104,2,30,1,1
21450,10,18953,9,194,102,92,2,30,1,1
10106,15,5611,11,45483,4137,41346,68,21,36,32
17236,26,20419,16,9081,3368,5713,42,76,24,18
7715,26,15590,16,6326,4367,1959,31,144,17,14
8457,10,6135,9,184,94,90,2,31,1,1
14912,10,20962,9,199,102,97,2,30,1,1
10873,15,22686,11,35384,3225,32159,49,26,20,29
7534,26,25163,16,6409,984,5425,21,360,11,10
12794,172,10639,118,70,70,0,1,5,1,0
16021,1136,2628,837,132,132,0,3,1199,3,0
6018,10,28862,9,243,86,157,2,29,1,1
8935,26,26909,16,14166,2015,12151,27,127,11,16
18397,26,3874,16,8945,5766,3179,30,130,18,12
10460,10,22458,9,197,90,107,2,30,1,1
18768,923,23843,681,70,70,0,2,8,2,0
19311,15,10978,11,2366,764,1602,10,137,5,5
8626,10,28875,9,458,188,270,6,30,3,3
14339,10,7152,9,177,94,83,2,30,1,1
15428,10,10408,9,167,86,81,2,29,1,1
11016,15,1147,11,1274,694,580,13,16,6,7
12688,26,8938,16,7015200,135026,6880174,6063,438,1252,4811
8404,15,4098,11,1934086,60476,1873610,1754,162,493,1261
15924,26,25348,16,4381,1474,2907,19,29,11,8
8735,10,8037,9,198,102,96,2,30,1,1
2744,1454,18520,1107,890,126,764,2,31,1,1
8409,10,16747,9,167,86,81,2,29,1,1
21831,10,11137,9,185,102,83,2,30,1,1
3895,26,14982,16,5046,2069,2977,20,15,11,9
15656,10,27885,9,226,110,116,2,30,1,1
15219,15,11404,11,234,234,0,4,12,4,0
18495,15,26809,11,19915,764,19151,23,16,7,16
8381,2980,23598,2314,70,70,0,2,8,2,0
9799,15,1275,11,1507,682,825,13,20,8,5
8369,10,25476,9,226,86,140,2,30,1,1
8091,10,6855,9,221,75,146,2,30,1,1
12671,2797,15609,2170,492,306,186,8,16,5,3
9705,15,8166,11,318,192,126,6,26,4,2
21817,10,12242,9,166,85,81,2,30,1,1
8345,10,7125,9,348,105,243,4,45,2,2
16354,10,25618,9,231,97,134,2,30,1,1
18876,26,10578,16,27204,15677,11527,59,62,30,29
839,10,3501,9,1415,689,726,3,30,2,1
10891,15,17516,11,366,240,126,7,31,5,2
5202,15,3528,11,5491,2690,2801,13,15,7,6
12121,26,27967,16,102629,3555,99074,114,58,40,74
21789,10,12658,9,198,110,88,2,30,1,1
11176,836,18220,615,70,70,0,2,7,2,0
4760,26,14043,16,8060,2166,5894,23,255,12,11
7021,26,8025,16,11891,6219,5672,35,174,16,19
19514,26,19190,16,6117,1224,4893,21,50,12,9
12502,2815,6911,2185,320,140,180,6,6,3,3
4439,10,23063,9,404,261,143,3,30,2,1
15137,10,28093,9,167,86,81,2,30,1,1
9550,346,21957,220,47078,2874,44204,66,51,32,34
13824,15,24289,11,374,240,134,7,15,5,2
3838,26,7610,16,11605,6867,4738,29,256,17,12
9245,15,9866,11,3148,687,2461,12,15,7,5
10977,26,2929,16,3893,2046,1847,29,56,16,13
2744,1238,13713,918,878,126,752,2,30,1,1
17837,26,9025,16,3420,983,2437,15,121,7,8
8240,26,26133,16,740,210,530,12,110,4,8
16443,15,21123,11,1056,682,374,10,15,6,4
22508,10,12998,9,216,110,106,2,30,1,1
11021,15,25176,11,482,300,182,9,25,6,3
9370,10,16915,9,165,86,79,2,30,1,1
9606,10,13410,9,299,94,205,2,30,1,1
16511,26,15033,16,10493,2658,7835,50,1469,26,24
18783,1356,13969,1029,70,70,0,1,5,1,0
15892,388,25216,251,742,298,444,11,16,5,6
14051,26,26181,16,6053,4104,1949,31,84,17,14
7792,26,2244,16,153,93,60,2,5,1,1
2744,1239,5713,919,1656,126,1530,4,30,2,2
10979,15,16984,11,5106,766,4340,16,45,9,7
13720,10,9687,9,180,94,86,2,31,1,1
11168,1169,9086,862,70,70,0,1,5,1,0
18605,26,22575,16,52666,33941,18725,95,139,49,46
14614,10,1293,9,99,99,0,1,30,1,0
21297,10,19226,9,192,98,94,2,31,1,1
10359,26,918,16,8247,2116,6131,23,360,11,12
2046,1784,19171,1362,481,150,331,2,1200,1,1
15699,10,15866,9,209,110,99,2,31,1,1
15586,10,7165,9,178,94,84,2,30,1,1
17188,676,19355,475,138,78,60,2,5,1,1
21367,654,1272,456,66,66,0,2,8,2,0
9360,15,2882,11,1277,460,817,16,71,5,11
14905,10,8020,9,166,86,80,2,30,1,1
13022,26,12963,16,499,425,74,4,0,3,1
11122,2479,22318,1928,316,136,180,6,7,3,3
5422,10,4582,9,86,86,0,1,30,1,0
14066,10,13168,9,182,102,80,2,30,1,1
14518,10,7575,9,184,94,90,2,31,1,1
15992,10,13548,9,182,93,89,2,30,1,1
21277,10,22702,9,263,126,137,2,30,1,1
18410,15,3250,11,2124,1158,966,13,87,7,6
11033,835,18328,614,70,70,0,2,7,2,0
16951,255,25970,160,62,62,0,1,5,1,0
22471,10,4140,9,295,101,194,4,32,2,2
9150,26,27501,16,25918,2247,23671,53,124,26,27
4109,26,2089,16,6751,1889,4862,24,316,13,11
2369,10,9749,9,234,93,141,2,30,1,1
13725,10,14288,9,177,94,83,2,31,1,1
13937,10,23001,9,230,110,120,2,30,1,1
5591,10,17316,9,229,89,140,2,31,1,1
17415,26,9099,16,7139,3570,3569,22,166,11,11
8443,10,9682,9,199,102,97,2,29,1,1
16905,26,4161,16,6453,1742,4711,20,17,10,10
16951,255,25970,160,130,66,64,2,4,1,1
22149,10,20441,9,210,110,100,2,30,1,1
16489,26,23690,16,10192,3621,6571,24,36,12,12
15674,26,25964,16,7170,1436,5734,35,261,19,16
18878,26,466,16,777438,37182,740256,940,64,407,533
8958,26,1225,16,6089,799,5290,16,126,8,8
3734,26,19887,16,6214,1750,4464,24,316,12,12
18284,26,26057,16,26423,2338,24085,50,152,24,26
9728,1914,19936,1460,166,166,0,1,1200,1,0
6616,26,16701,16,20739,7254,13485,97,734,44,53
17942,26,24985,16,82533,15815,66718,124,131,50,74
15891,26,1701,16,11347,2434,8913,28,62,15,13
636,2577,18749,1999,238,118,120,2,1199,1,1
4835,2391,22208,1858,4089,2456,1633,53,1773,31,22
9247,10,16793,9,752,93,659,2,31,1,1
21347,10,13256,9,292,110,182,2,30,1,1
11065,15,8956,11,426,240,186,8,24,5,3
15231,10,17680,9,255,88,167,4,53,2,2
7198,15,1314,11,416,210,206,7,28,4,3
13640,10,18408,9,214,110,104,2,30,1,1
12635,1044,15997,768,258,70,188,4,8,2,2
5887,26,12239,16,11771,2624,9147,50,19,25,25
18947,26,15122,16,391561,17125,374436,478,17,213,265
2642,15,11095,11,490,264,226,8,32,5,3
22332,10,8091,9,216,94,122,2,30,1,1
15367,26,18659,16,8074,2054,6020,20,15,11,9
15641,26,23944,16,20873,8800,12073,68,19,37,31
14981,10,12653,9,322,134,188,2,30,1,1
8430,10,9487,9,172,88,84,2,31,1,1
22462,10,23845,9,88,88,0,1,30,1,0
9250,15,8367,11,11297,8141,3156,52,508,34,18
16021,127,23304,95,858,858,0,14,1199,14,0
12028,679,27517,478,70,70,0,2,7,2,0
14934,26,6910,16,3775,1791,1984,24,203,12,12
5170,26,14191,16,5206,3832,1374,23,25,13,10
9152,26,3153,16,642,582,60,2,5,1,1
15619,10,27828,9,512,95,417,4,34,2,2
8342,10,26533,9,186,95,91,2,30,1,1
21609,10,13166,9,183,94,89,2,29,1,1
2863,1980,15342,1510,148,86,62,2,30,1,1
12366,26,8466,16,280,140,140,5,129,3,2
8562,10,9022,9,177,94,83,2,30,1,1
3596,26,26070,16,31008,10449,20559,69,130,31,38
9765,26,18466,16,10905,4352,6553,30,18,18,12
15571,10,3410,9,170,87,83,2,31,1,1
10859,15,15,11,1484,928,556,13,76,8,5
15313,10,3300,9,264,87,177,4,37,2,2
3706,26,3419,16,1717,1153,564,13,26,7,6
9824,26,6799,16,7066,1129,5937,19,172,9,10
5345,183,16951,121,3910,1805,2105,20,18,12,8
457,10,21348,9,207,86,121,2,30,1,1
12771,1305,6164,983,70,70,0,2,7,2,0
22290,10,18589,9,305,94,211,4,35,2,2
9609,15,21991,11,202622,12371,190251,264,22,132,132
9145,10,16043,9,438,180,258,6,30,3,3
7566,15,4763,11,1151,711,440,10,15,5,5
10872,15,22685,11,407760,15074,392686,424,25,154,270
5017,26,24749,16,2227,1018,1209,17,15,8,9
5840,26,17739,16,4639,1732,2907,19,30,11,8
22283,10,21622,9,278,100,178,4,30,2,2
12720,3100,3315,2408,320,140,180,6,6,3,3
21477,10,11942,9,196,94,102,2,30,1,1
5764,26,17618,16,4378,1471,2907,19,25,11,8
9136,10,2174,9,314,94,220,4,31,2,2
12600,26,25924,16,13059,3730,9329,73,3729,32,41
14770,10,24790,9,229,98,131,2,30,1,1
20349,26,3143,16,17772,2595,15177,25,122,12,13
15253,26,16131,16,4099,2450,1649,36,2615,19,17
9728,280,18049,177,1357,369,988,6,1200,3,3
8624,10,6284,9,280,94,186,2,30,1,1
10208,10,18615,9,164,78,86,2,30,1,1
7250,26,7101,16,4417,3084,1333,17,361,9,8
14956,15,22333,11,1609,919,690,15,72,8,7
15579,10,6229,9,819,102,717,2,30,1,1
6922,10,19293,9,204,92,112,2,30,1,1
15540,26,43,16,9222,3148,6074,26,91,14,12
22586,10,14685,9,754,94,660,2,30,1,1
16671,26,25816,16,4674,1767,2907,19,26,11,8
16475,26,28956,16,8828,2193,6635,38,99,17,21
5736,26,5457,16,10010,4051,5959,32,346,17,15
16021,280,4968,177,453,251,202,4,1199,2,2
2744,1239,19444,919,887,126,761,2,30,1,1
10941,15,23721,11,5474,1920,3554,20,65,12,8
21512,10,2219,9,177,94,83,2,30,1,1
13850,10,24304,9,239,98,141,2,30,1,1
0,0,0,0,600,306,294,6,0,3,3
21929,10,6569,9,314,92,222,4,31,2,2
17200,26,9510,16,8547,5209,3338,30,19,15,15
2744,1294,21789,972,876,126,750,2,29,1,1
18348,26,17055,16,63696,4774,58922,83,125,32,51
15868,10,23149,9,768,99,669,2,31,1,1
6996,26,22455,16,34881,6721,28160,62,46,30,32
8713,26,15420,16,1346,918,428,10,23,6,4
14706,15,1768,11,31087,1654,29433,42,16,18,24
22523,10,13799,9,733,94,639,2,30,1,1
636,2192,15177,1697,150,150,0,1,1201,1,0
12710,1125,18569,829,70,70,0,2,8,2,0
9825,26,15768,16,6888,1380,5508,19,171,9,10
8329,10,17939,9,183,94,89,2,30,1,1
13724,10,511,9,190,97,93,2,31,1,1
9072,10,16907,9,789,110,679,2,30,1,1
21232,10,14030,9,211,110,101,2,29,1,1
12979,10,23797,9,242,98,144,2,30,1,1
11389,10,0,0,139,70,69,2,30,1,1
9049,10,7073,9,760,97,663,2,31,1,1
3200,10,13611,9,241,95,146,2,30,1,1
11445,15,8263,11,2425,529,1896,11,75,6,5
22318,10,305,9,209,110,99,2,31,1,1
17904,26,17247,16,1457,816,641,15,28,7,8
4403,26,15152,16,1320,822,498,16,41,9,7
17664,26,10302,16,9161,2202,6959,28,374,14,14
15761,10,20262,9,214,110,104,2,30,1,1
16021,1724,6627,1316,527,166,361,2,1200,1,1
14640,10,17350,9,177,94,83,2,29,1,1
12823,1218,18404,901,70,70,0,1,4,1,0
21441,10,18593,9,211,102,109,2,29,1,1
22383,10,11888,9,199,102,97,2,30,1,1
3222,10,13722,9,228,90,138,2,33,1,1
13757,10,9438,9,184,94,90,2,30,1,1
13902,10,25687,9,79,79,0,2,35,2,0
15432,10,12832,9,711,87,624,2,30,1,1
8527,10,22388,9,321,102,219,2,30,1,1
21810,10,25997,9,425,90,335,4,43,2,2
21151,1882,2272,1437,66,66,0,2,7,2,0
15251,26,23536,16,7889,1900,5989,20,15,11,9
11180,1870,28124,1428,70,70,0,1,5,1,0
7779,26,28568,16,6318,1025,5293,17,31,9,8
12888,15,26956,11,2545,515,2030,12,17,6,6
9015,10,982,9,166,86,80,2,30,1,1
4721,26,15009,16,3886,2516,1370,22,95,12,10
9434,26,26174,16,8207,2558,5649,41,80,23,18
10136,15,22285,11,114613,6365,108248,134,26,51,83
9007,10,5662,9,193,102,91,2,30,1,1
11154,500,7117,328,70,70,0,2,8,2,0
14781,10,11478,9,177,94,83,2,30,1,1
13776,10,24259,9,220,100,120,2,31,1,1
11812,26,16177,16,87558,4155,83403,115,117,41,74
9617,18,16547,13,184,94,90,2,30,1,1
11099,2734,16609,2120,70,70,0,2,7,2,0
15753,15,15716,11,2235,1055,1180,12,16,7,5
22047,10,23058,9,184,94,90,2,30,1,1
14404,10,326,9,94,94,0,1,30,1,0
8801,26,21323,16,54634,6944,47690,99,47,47,52
2863,2006,15279,1536,140,78,62,2,30,1,1
6678,15,284,11,13872,1244,12628,29,19,14,15
15501,10,21269,9,172,88,84,2,31,1,1
2172,1225,5792,905,480,149,331,2,1200,1,1
12639,15,18002,11,1056,682,374,10,15,6,4
8798,10,10935,9,199,102,97,2,30,1,1
21487,10,15338,9,322,118,204,2,30,1,1
15001,10,10469,9,195,102,93,2,31,1,1
826,18,17163,13,94,94,0,1,30,1,0
10046,26,29130,16,6813,1729,5084,18,16,10,8
15113,10,21407,9,209,110,99,2,30,1,1
9003,10,26449,9,258,110,148,2,29,1,1
11027,10,25664,9,164,78,86,2,30,1,1
9325,26,25300,16,130,70,60,2,14,1,1
16973,10,6944,9,260,86,174,2,30,1,1
4671,26,22047,16,499,425,74,4,0,3,1
2744,1867,10223,1425,880,126,754,2,30,1,1
18803,1989,6166,1519,316,136,180,6,6,3,3
11117,26,20173,16,5780,1646,4134,22,15,11,11
15208,10,25927,9,166,86,80,2,30,1,1
17093,26,14466,16,40456,12307,28149,114,140,58,56
15573,10,10625,9,188,96,92,2,31,1,1
21248,1852,16080,1412,504,382,122,8,15,6,2
8148,26,12711,16,7605,2028,5577,23,159,11,12
8226,26,16460,16,2497156,63601,2433555,2465,17,852,1613
21629,10,28609,9,235,90,145,2,33,1,1
16443,15,5939,11,1898,1524,374,14,15,8,6
16326,26,3330,16,25053,19627,5426,38,76,23,15
20453,10,27982,9,404,259,145,3,33,2,1
22510,10,26948,9,195,102,93,2,29,1,1
21843,10,27296,9,538,179,359,6,63,3,3
11098,1971,26145,1504,70,70,0,2,8,2,0
9741,15,22063,11,16296,9143,7153,48,27,26,22
9483,15,10057,11,2475,723,1752,12,41,6,6
8349,10,19060,9,198,101,97,2,30,1,1
8669,15,22819,11,121857,7431,114426,166,486,38,128
8940,26,18776,16,8130,2220,5910,23,16,13,10
11681,26,20438,16,14838,2048,12790,32,25,18,14
11188,199,28919,131,70,70,0,2,7,2,0
9547,10,14256,9,168,86,82,2,30,1,1
14241,10,14687,9,170,87,83,2,30,1,1
8669,10,18657,9,167,86,81,2,29,1,1
19878,26,15070,16,4975,2828,2147,14,135,7,7
2744,1238,1378,918,869,126,743,2,30,1,1
12743,2618,8929,2029,70,70,0,2,7,2,0
19287,26,18026,16,11151,3001,8150,51,365,25,26
13003,26,13581,16,499,425,74,4,0,3,1
2744,1238,1153,918,887,126,761,2,30,1,1
9087,26,22669,16,466,392,74,4,1,3,1
7313,26,2547,16,234,234,0,4,11,4,0
14939,26,25387,16,3734,1750,1984,24,203,12,12
12021,15,28665,11,2957,619,2338,12,15,6,6
12528,784,9124,569,70,70,0,2,8,2,0
8667,10,2940,9,734,94,640,2,29,1,1
2744,1563,1193,1194,886,126,760,2,30,1,1
22588,26,4961,16,2494,1643,851,17,25,9,8
8595,10,7108,9,210,110,100,2,29,1,1
18497,502,7212,330,70,70,0,1,5,1,0
0,0,0,0,124,64,60,2,0,1,1
21318,10,12189,9,380,92,288,4,37,2,2
21937,10,13161,9,273,118,155,2,30,1,1
6528,15,2594,11,3494,1589,1905,16,186,9,7
9093,10,19209,9,214,110,104,2,29,1,1
11251,10,4344,9,177,86,91,2,30,1,1
4437,26,19985,16,7293,1544,5749,22,256,11,11
14572,10,11578,9,755,93,662,2,30,1,1
19291,26,19826,16,550484,8433,542051,541,246,99,442
400,15,1245,11,9399,632,8767,15,15,7,8
3133,2341,16529,1825,330,330,0,6,3609,6,0
9703,10,14340,9,178,94,84,2,29,1,1
22081,10,24738,9,216,102,114,2,30,1,1
11146,3244,1237,2513,70,70,0,1,5,1,0
22174,1265,6537,945,747,462,285,2,30,1,1
22555,10,4273,9,181,94,87,2,30,1,1
12431,1557,17306,1188,70,70,0,1,5,1,0
10774,114,22706,87,70,70,0,2,8,2,0
14804,10,19633,9,168,78,90,2,29,1,1
11301,1844,21523,1405,316,136,180,6,6,3,3
21784,10,25221,9,498,204,294,6,30,3,3
12333,26,5748,16,8333,2292,6041,27,360,15,12
16083,26,12575,16,25540,8247,17293,187,574,79,108
6685,26,9854,16,6941,1551,5390,25,200,12,13
21256,1172,19994,865,66,66,0,2,8,2,0
1235,10,4088,9,370,238,132,3,31,2,1
9724,26,7191,16,2723,1383,1340,29,37,16,13
4340,273,24228,172,922,428,494,10,14,5,5
22080,10,11725,9,765,102,663,2,30,1,1
18866,26,1851,16,12604,6376,6228,27,133,16,11
22283,10,1980,9,164,86,78,2,31,1,1
8546,10,15444,9,199,102,97,2,31,1,1
3301,26,4682,16,5746,1079,4667,17,27,10,7
21226,10,22475,9,216,110,106,2,29,1,1
11996,3030,9168,2356,70,70,0,1,5,1,0
9587,15,21978,11,73400,3702,69698,77,19,26,51
12765,3118,2050,2420,70,70,0,2,8,2,0
6645,26,28280,16,9445,6593,2852,43,96,25,18
16138,15,25468,11,16101,4026,12075,35,38,16,19
13818,15,24284,11,268230,8528,259702,292,231,106,186
15371,2081,24072,1603,70,70,0,1,5,1,0
22541,10,25365,9,214,102,112,2,31,1,1
14155,10,24456,9,197,90,107,2,29,1,1
20408,40,21815,23,8033,4241,3792,67,54,42,25
11187,1051,17058,774,70,70,0,2,7,2,0
8584,1241,16960,921,247,78,169,2,30,1,1
2971,15,12213,11,83253,4938,78315,99,26,39,60
637,2569,8213,1994,296,150,146,2,1200,1,1
10910,203,13116,132,270,270,0,4,32,4,0
2744,1626,10513,1248,928,126,802,2,31,1,1
20653,26,28104,16,9324,4240,5084,24,16,13,11
22419,10,17168,9,410,99,311,4,56,2,2
22196,1258,12336,938,734,462,272,2,30,1,1
15124,10,23931,9,199,102,97,2,31,1,1
9432,26,12838,16,10203,2365,7838,40,86,22,18
21736,10,13498,9,212,102,110,2,30,1,1
2724,1240,4757,920,422,164,258,6,30,3,3
13694,15,18163,11,486,240,246,9,34,5,4
14407,10,9282,9,245,94,151,2,29,1,1
4183,15,27552,11,11575,902,10673,20,46,11,9
5294,26,2577,16,8991,2438,6553,18,120,8,10
9409,10,27312,9,753,96,657,2,30,1,1
15136,10,6535,9,164,86,78,2,29,1,1
13992,10,27734,9,214,110,104,2,30,1,1
6019,10,17999,9,213,79,134,2,32,1,1
11122,26,22028,16,4642,3496,1146,18,16,10,8
892,15,26079,11,49165,1785,47380,56,36,21,35
5673,15,13103,11,1566,754,812,10,15,6,4
15528,10,8395,9,184,86,98,2,29,1,1
17548,15,26315,11,24437,12718,11719,41,15,16,25
10782,1544,734,1176,70,70,0,2,8,2,0
16951,255,25970,160,66,66,0,1,4,1,0
9044,10,6925,9,817,102,715,2,30,1,1
8516,10,12461,9,182,93,89,2,31,1,1
8874,10,8107,9,212,94,118,2,29,1,1
14081,26,28688,16,13284,3562,9722,38,26,21,17
8549,10,23041,9,200,102,98,2,31,1,1
6250,2017,28445,1547,148,86,62,2,30,1,1
8582,10,6822,9,185,102,83,2,30,1,1
8429,10,11816,9,168,86,82,2,31,1,1
10796,2455,27973,1907,70,70,0,2,7,2,0
6857,26,15515,16,1268867,60489,1208378,1558,141,557,1001
9585,15,26991,11,318,192,126,6,26,4,2
4166,26,25218,16,1786,172,1614,7,120,3,4
15993,26,4047,16,9539,3344,6195,36,17,17,19
15394,10,7127,9,209,110,99,2,31,1,1
18821,1989,10655,1519,316,136,180,6,6,3,3
21985,10,22039,9,194,102,92,2,30,1,1
18382,15,14966,11,2714,2154,560,12,26,7,5
6160,26,9454,16,21620,7973,13647,112,488,57,55
10943,2672,4727,2078,70,70,0,2,8,2,0
5064,26,12869,16,6385,1090,5295,18,33,10,8
22127,10,28410,9,86,86,0,1,29,1,0
12923,10,23649,9,164,78,86,2,30,1,1
16776,10,27199,9,307,86,221,2,30,1,1
7727,26,7790,16,7166,2377,4789,16,122,7,9
11151,26,17733,16,199757,7497,192260,216,45,80,136
16368,26,20596,16,85263,3763,81500,115,216,46,69
2744,1269,25525,949,1948,378,1570,6,33,4,2
15990,26,9202,16,9237,2447,6790,30,16,14,16
12073,26,6727,16,13515,3057,10458,40,21,20,20
16951,255,25970,160,62,62,0,1,5,1,0
22290,10,6544,9,182,93,89,2,31,1,1
3133,2333,25507,1817,330,330,0,6,3609,6,0
3522,26,2970,16,6998,2361,4637,20,17,10,10
22332,26,17870,16,958,384,574,14,34,7,7
13779,10,17133,9,216,110,106,2,29,1,1
14712,10,8379,9,178,94,84,2,30,1,1
8528,10,19709,9,184,94,90,2,31,1,1
14820,15,24814,11,44747,815,43932,45,15,12,33
14763,10,5123,9,253,87,166,4,29,2,2
1162,1993,28853,1523,156,94,62,2,30,1,1
6972,26,27682,16,5954,1454,4500,22,142,13,9
12753,1379,3089,1049,70,70,0,1,4,1,0
14189,10,400,9,164,84,80,2,31,1,1
15690,10,7164,9,193,102,91,2,31,1,1
9462,15,24927,11,3800,2776,1024,16,83,9,7
10363,1894,1961,1447,210,140,70,4,14,3,1
9135,10,24581,9,198,102,96,2,30,1,1
15498,10,21136,9,196,102,94,2,30,1,1
10878,15,20759,11,12009,5364,6645,23,31,12,11
2228,10,9090,9,209,77,132,2,32,1,1
21106,2269,24596,1756,66,66,0,2,8,2,0
9560,15,3021,11,11343,3864,7479,22,21,11,11
22321,10,12771,9,253,87,166,4,31,2,2
14003,10,11086,9,184,94,90,2,30,1,1
18139,26,7019,16,15769,1619,14150,17,141,4,13
12620,2400,23026,1867,70,70,0,1,5,1,0
15996,10,25995,9,199,102,97,2,30,1,1
14135,10,10577,9,193,102,91,2,30,1,1
14847,10,10334,9,167,86,81,2,30,1,1
2744,1241,15501,921,1634,126,1508,4,31,2,2
22394,10,24656,9,294,102,192,2,30,1,1
14478,10,15281,9,778,103,675,2,31,1,1
14503,26,24641,16,4581,1674,2907,19,30,11,8
14024,10,17817,9,164,86,78,2,30,1,1
17378,26,22936,16,8742,3785,4957,21,16,12,9
8198,26,116,16,6353,1075,5278,18,33,10,8
16549,26,3693,16,2396,1144,1252,14,979,7,7
8726,26,25731,16,13516,6981,6535,61,2149,34,27
3777,15,13276,11,1420,715,705,12,16,7,5
2744,1240,4130,920,600,126,474,2,30,1,1
21271,10,17175,9,199,102,97,2,30,1,1
3066,565,27103,379,502,150,352,2,1200,1,1
13650,15,6311,11,1979,826,1153,13,17,9,4
15596,10,24813,9,179,94,85,2,30,1,1
15164,10,3237,9,197,102,95,2,30,1,1
9524,26,5451,16,306,180,126,6,25,4,2
7965,26,8743,16,9021,1511,7510,21,121,11,10
10690,15,21875,11,152651,4700,147951,174,17,65,109
14494,10,4723,9,184,94,90,2,30,1,1
12768,3081,4350,2394,320,140,180,6,6,3,3
15733,26,5500,16,13932,3673,10259,26,121,11,15
11020,26,25980,16,2094,1402,692,14,15,8,6
11288,26,715,16,3757,356,3401,12,120,5,7
10010,15,26656,11,325925,18062,307863,377,146,161,216
9059,26,17034,16,6060,1040,5020,20,34,11,9
21157,3064,5318,2379,70,70,0,1,4,1,0
21968,26,14560,16,31480,1953,29527,54,196,20,34
21366,10,23206,9,172,88,84,2,30,1,1
6420,26,918,16,3961,1595,2366,21,15,12,9
8892,26,564,16,3941,902,3039,13,50,7,6
10310,26,27590,16,5737,1829,3908,22,18,13,9
14333,10,3633,9,281,101,180,4,58,2,2
22601,10,9915,9,216,94,122,2,30,1,1
8831,15,15218,11,8457,3062,5395,16,41,7,9
4144,26,25675,16,9126,3975,5151,21,15,11,10
8581,10,27847,9,194,102,92,2,30,1,1
22555,10,6725,9,747,93,654,2,30,1,1
10874,26,15903,16,6752,1387,5365,21,115,10,11
3951,26,17619,16,3542,1045,2497,13,120,6,7
18825,1989,14456,1519,316,136,180,6,5,3,3
5941,26,13268,16,7601,1595,6006,25,35,12,13
7964,10,26384,9,199,94,105,2,30,1,1
12132,26,22194,16,242426,7999,234427,277,70,100,177
22537,10,22751,9,190,90,100,3,60,2,1
16754,26,21870,16,6277528,124223,6153305,5970,160,1890,4080
2780,26,10894,16,10243,1659,8584,29,83,13,16
22670,10,7221,9,168,86,82,2,30,1,1
8784,15,2019,11,314,192,122,6,42,4,2
14962,10,20270,9,196,102,94,2,31,1,1
11267,10,22853,9,220,90,130,2,30,1,1
21063,2080,21890,1602,66,66,0,2,8,2,0
22570,10,28794,9,376,126,250,2,30,1,1
238,10,22892,9,164,86,78,2,31,1,1
718,10,2854,9,198,90,108,2,30,1,1
11212,10,22831,9,832,106,726,2,30,1,1
3944,15,7985,11,130,70,60,2,15,1,1
22025,15,3896,11,5518,527,4991,13,75,6,7
18826,26,26994,16,2871,1671,1200,17,179,9,8
12591,1024,13269,754,754,502,252,11,20,7,4
21299,3087,26921,2398,70,70,0,1,4,1,0
13882,10,25543,9,216,102,114,2,30,1,1
14281,10,23383,9,199,102,97,2,30,1,1
4898,26,14509,16,574857,27894,546963,745,57,346,399
6281,26,9617,16,6598,1506,5092,22,305,12,10
9089,15,7806,11,12290,10150,2140,37,256,19,18
13790,10,8949,9,770,101,669,2,31,1,1
6853,15,19188,11,1915,1466,449,10,20,6,4
20924,26,569,16,7146,2010,5136,34,167,18,16
9967,26,3143,16,178483,7778,170705,219,218,90,129
7215,23,0,0,41552,20621,20931,212,31,106,106
485,10,1772,9,216,90,126,2,30,1,1
15546,10,21937,9,193,102,91,2,30,1,1
10587,183,22533,121,4425,2641,1784,21,33,12,9
4782,26,2711,16,9481,3482,5999,58,16,29,29
14100,10,3884,9,216,110,106,2,31,1,1
15971,26,6413,16,28216,10325,17891,93,23,42,51
18478,10,26799,9,257,101,156,2,33,1,1
13772,10,7315,9,173,94,79,2,30,1,1
8327,285,20663,182,854,150,704,4,1200,2,2
17188,26,3779,16,5166,700,4466,16,14,7,9
21659,10,25837,9,406,142,264,2,30,1,1
10968,15,2181,11,82321,4061,78260,109,61,50,59
19923,15,20686,11,1511,517,994,8,15,5,3
14188,10,6011,9,1026,292,734,8,50,4,4
12003,26,844,16,11030,4292,6738,32,61,17,15
8384,10,13034,9,282,93,189,4,45,2,2
8891,26,4070,16,311104,8270,302834,336,18,99,237
13008,26,26088,16,499,425,74,4,0,3,1
15548,15,9929,11,214,140,74,4,35,3,1
9625,26,8888,16,1258,716,542,13,83,7,6
3580,10,25736,9,168,78,90,2,30,1,1
1613,10,5830,9,197,90,107,2,30,1,1
19331,26,8466,16,1401,940,461,11,29,7,4
10945,232,19595,147,11827,5467,6360,100,144,54,46
17657,26,6644,16,7825,4076,3749,19,121,10,9
3026,10,12548,9,241,98,143,2,30,1,1
22148,10,24643,9,816,102,714,2,30,1,1
14976,10,25092,9,199,102,97,2,29,1,1
14350,1194,22429,883,70,70,0,1,5,1,0
16751,10,805,9,167,78,89,2,30,1,1
22121,10,24200,9,232,94,138,2,30,1,1
14204,26,24482,16,4665,1758,2907,19,28,11,8
17479,10,26264,9,194,87,107,2,30,1,1
21445,10,9246,9,453,100,353,4,57,2,2
8815,26,28822,16,5964,674,5290,16,60,7,9
14715,10,16613,9,177,94,83,2,30,1,1
15363,10,228,9,199,102,97,2,30,1,1
8523,10,13617,9,763,102,661,2,31,1,1
2643,15,11096,11,490,264,226,8,32,5,3
6237,26,18312,16,1916,1121,795,19,69,10,9
14890,10,10286,9,185,102,83,2,29,1,1
15557,10,8658,9,199,102,97,2,29,1,1
10254,26,20958,16,5759,1904,3855,19,15,11,8
8816,26,28018,16,93063,2948,90115,107,80,30,77
14930,10,14482,9,168,86,82,2,29,1,1
9562,10,782,9,760,96,664,2,31,1,1
8570,10,9711,9,200,94,106,2,30,1,1
15729,10,18134,9,195,102,93,2,30,1,1
14066,10,27597,9,182,102,80,2,30,1,1
9813,26,27321,16,2985,1505,1480,16,20,9,7
9073,10,7378,9,1410,95,1315,4,57,2,2
6012,26,18218,16,4354,2166,2188,14,136,7,7
2744,1238,19413,918,858,126,732,2,30,1,1
15240,10,6640,9,216,102,114,2,30,1,1
532,247,0,0,3562,1936,1626,48,193,24,24
11763,26,19077,16,2082,1322,760,14,41,8,6
12866,26,18939,16,7724,2555,5169,26,47,15,11
8772,10,24472,9,328,94,234,4,43,2,2
22368,10,23474,9,200,102,98,2,30,1,1
12775,26,1935,16,886,70,816,14,166,2,12
16021,3121,18426,2423,330,330,0,6,1199,6,0
5537,26,18388,16,5446,805,4641,17,26,9,8
11101,2939,16650,2279,70,70,0,1,5,1,0
22687,10,21554,9,749,94,655,2,30,1,1
14646,10,16918,9,731,91,640,2,30,1,1
12487,2962,13599,2299,70,70,0,2,7,2,0
5732,10,17093,9,223,78,145,2,30,1,1
467,26,22682,16,1191,692,499,12,40,7,5
9464,10,2820,9,194,102,92,2,30,1,1
5909,10,17837,9,398,255,143,3,32,2,1
8348,10,28864,9,168,86,82,2,30,1,1
4554,26,18057,16,130,70,60,3,5,2,1
8407,346,21387,220,22799,6835,15964,35,56,20,15
22550,10,16401,9,194,102,92,2,29,1,1
194,7,454,7,152,66,86,2,10,1,1
8749,26,23599,16,10877,2925,7952,56,285,23,33
1025,26,9941,16,3616,429,3187,11,15,6,5
8993,26,2895,16,1737,1158,579,16,74,10,6
10471,26,16430,16,13187,6736,6451,22,55,12,10
22015,10,23447,9,184,94,90,2,30,1,1
18470,351,4240,224,2541,1158,1383,19,16,9,10
14244,10,17780,9,776,102,674,2,30,1,1
13865,26,24634,16,6528,1918,4610,23,45,13,10
15766,18,9063,13,184,94,90,2,30,1,1
20420,40,1183,23,8856,4253,4603,79,27,42,37
16810,18,27107,13,184,94,90,2,30,1,1
636,2915,2223,2263,150,150,0,1,1199,1,0
13617,10,9851,9,210,110,100,2,30,1,1
2046,3101,26734,2409,323,150,173,2,1200,1,1
6709,26,6168,16,8900,2090,6810,26,80,14,12
9108,10,16144,9,196,102,94,2,30,1,1
22456,10,7676,9,763,102,661,2,30,1,1
6660,26,18402,16,8420,2986,5434,23,138,13,10
7214,10,5604,9,168,78,90,2,31,1,1
15929,10,24135,9,177,94,83,2,30,1,1
21068,10,4940,9,298,102,196,2,30,1,1
187,10,417,9,216,89,127,2,30,1,1
7826,10,20627,9,227,92,135,2,31,1,1
10208,15,22321,11,19837,2061,17776,30,21,14,16
2744,1237,16903,917,882,126,756,2,30,1,1
15238,26,11051,16,9691,2221,7470,16,120,8,8
12442,2028,18017,1556,70,70,0,2,7,2,0
15169,10,12493,9,167,86,81,2,30,1,1
11248,3128,4822,2428,136,136,0,3,12,3,0
16808,26,23850,16,2659,1417,1242,19,276,9,10
22392,1459,6802,1112,276,78,198,2,30,1,1
8526,10,7542,9,216,110,106,2,30,1,1
4223,26,17850,16,5901,1324,4577,25,50,14,11
10832,26,19023,16,4976,1826,3150,19,151,9,10
9261,10,18022,9,168,86,82,2,31,1,1
22719,10,8630,9,166,85,81,2,30,1,1
8395,10,21377,9,825,99,726,2,30,1,1
8357,26,19205,16,568536,16389,552147,598,19,224,374
22207,10,16292,9,547,91,456,4,35,2,2
12586,322,1056,207,70,70,0,2,7,2,0
9056,26,1597,16,6966,1436,5530,32,600,13,19
16052,26,15627,16,2696,1695,1001,24,105,13,11
9093,10,5481,9,260,124,136,2,31,1,1
11057,2541,24063,1975,70,70,0,2,7,2,0
22655,10,1095,9,733,86,647,2,31,1,1
9652,26,25864,16,7588,1850,5738,19,25,10,9
8584,1248,7967,928,71,71,0,1,30,1,0
15436,10,18527,9,756,95,661,2,31,1,1
12659,26,23629,16,1386,751,635,15,180,8,7
22575,10,25988,9,194,99,95,2,30,1,1
8296,26,14764,16,8535,2139,6396,25,394,9,16
22676,10,25705,9,184,94,90,2,29,1,1
18118,26,4755,16,76774,9184,67590,104,143,41,63
21853,10,20361,9,228,94,134,2,30,1,1
14255,10,7487,9,240,110,130,2,30,1,1
12043,2244,19676,1737,320,140,180,6,5,3,3
14409,10,9593,9,177,94,83,2,30,1,1
10093,15,5499,11,4680740,67312,4613428,4675,77,985,3690
5275,26,28685,16,206769,6309,200460,215,27,77,138
8434,10,19211,9,184,94,90,2,31,1,1
22392,1238,27139,918,250,78,172,2,30,1,1
532,247,0,0,3354,1792,1562,46,194,23,23
18325,26,27226,16,5169,790,4379,16,72,8,8
5242,26,14152,16,4832,3054,1778,27,16,14,13
21923,10,22382,9,199,102,97,2,30,1,1
6826,10,19135,9,233,90,143,2,32,1,1
22435,10,19507,9,177,94,83,2,30,1,1
6250,2015,11969,1545,205,83,122,4,29,2,2
15515,10,16522,9,177,94,83,2,30,1,1
1117,26,20112,16,3613,433,3180,11,16,6,5
5831,26,25716,16,1396,735,661,14,80,8,6
2724,1240,20113,920,422,164,258,6,30,3,3
20675,26,19568,16,5846,3321,2525,34,96,19,15
22438,10,11594,9,199,102,97,2,30,1,1
21450,10,10767,9,188,96,92,2,31,1,1
6642,26,921,16,8964,2125,6839,34,120,18,16
15975,10,10370,9,326,110,216,2,29,1,1
15667,10,5414,9,402,118,284,2,30,1,1
1080,26,1706,16,5695,505,5190,14,15,7,7
6358,26,3250,16,8384,2161,6223,24,255,12,12
19507,15,2672,11,16580,1400,15180,33,48,15,18
14469,10,21294,9,195,102,93,2,30,1,1
4691,26,8219,16,499,425,74,4,0,3,1
7753,26,20488,16,4555,1648,2907,19,30,11,8
2744,1233,15201,913,887,126,761,2,31,1,1
15238,26,11324,16,1299,730,569,13,25,7,6
19257,10,27225,9,235,90,145,2,32,1,1
4281,26,17750,16,3781,1917,1864,23,396,7,16
11129,26,13471,16,39798,12257,27541,68,97,27,41
15126,10,26622,9,182,93,89,2,31,1,1
8423,10,27941,9,179,94,85,2,30,1,1
10988,26,2539,16,9994,8270,1724,34,68,19,15
10976,15,18490,11,1716,952,764,13,69,8,5
12793,2954,12506,2291,70,70,0,1,5,1,0
11909,26,19954,16,17711,5894,11817,47,96,24,23
8364,153,3361,108,70,70,0,2,7,2,0
9426,10,8539,9,916,86,830,2,31,1,1
15366,26,24225,16,8021,2001,6020,20,15,11,9
3373,188,17956,123,338,110,228,2,300,1,1
897,26,7184,16,10056,2310,7746,27,36,14,13
3271,10,13964,9,194,87,107,2,31,1,1
5934,26,24498,16,6015,4418,1597,38,246,22,16
4015,10,20610,9,291,86,205,2,29,1,1
6838,26,13719,16,7352,1790,5562,24,263,12,12
9314,10,17291,9,173,94,79,2,30,1,1
9273,6,21822,6,60,60,0,1,5,1,0
14758,10,1660,9,178,94,84,2,30,1,1
14887,10,8571,9,184,94,90,2,30,1,1
9569,10,10151,9,199,102,97,2,30,1,1
6250,1999,20662,1529,148,86,62,2,31,1,1
9602,26,10820,16,523577,34256,489321,1025,208,473,552
18476,15,8638,11,958,543,415,11,315,6,5
13664,10,16503,9,190,97,93,2,31,1,1
9425,26,10954,16,1128,654,474,17,18,10,7
9728,3229,8210,2504,161,161,0,2,1200,2,0
2744,1239,22556,919,1626,126,1500,4,30,2,2
18355,26,8481,16,6753,2052,4701,25,15,13,12
21192,10,28441,9,178,75,103,2,30,1,1
21999,10,27644,9,198,94,104,2,30,1,1
21967,10,10690,9,761,102,659,2,29,1,1
16218,26,29123,16,7915,1994,5921,31,270,15,16
8430,10,4355,9,731,85,646,2,31,1,1
22281,10,17415,9,293,102,191,2,30,1,1
14397,10,7209,9,167,86,81,2,30,1,1
22118,10,27747,9,283,102,181,2,30,1,1
15298,10,710,9,733,85,648,2,31,1,1
10720,15,15427,11,16205,2525,13680,31,139,15,16
21512,10,28981,9,177,94,83,2,30,1,1
14625,10,22381,9,199,102,97,2,32,1,1
7823,26,18091,16,11072,3983,7089,27,186,15,12
3133,2327,28806,1811,330,330,0,6,3609,6,0
15063,26,20912,16,5711,1208,4503,21,121,11,10
8781,15,18461,11,374,192,182,7,41,4,3
16319,10,21595,9,308,118,190,2,29,1,1
19848,26,27586,16,4378,1471,2907,19,27,11,8
15864,26,8766,16,8407,3013,5394,43,15,24,19
5785,26,4236,16,9524,3934,5590,20,135,10,10
9066,26,5417,16,7456,1591,5865,32,54,15,17
16056,26,27732,16,16532,2229,14303,26,133,11,15
1629,26,5885,16,1582,883,699,18,32,10,8
13870,10,26299,9,180,92,88,2,31,1,1
9296,10,5836,9,177,94,83,2,30,1,1
13673,26,24198,16,3773,2325,1448,24,18,13,11
21753,10,22837,9,184,94,90,2,30,1,1
8803,26,7517,16,50296,4666,45630,90,31,43,47
5217,10,7931,9,242,78,164,2,29,1,1
2724,1240,12796,920,422,164,258,6,30,3,3
8331,10,1714,9,212,94,118,2,30,1,1
10677,15,16597,11,499,192,307,6,38,4,2
8406,346,21386,220,378,180,198,7,53,4,3
5935,10,22493,9,198,93,105,2,30,1,1
21828,10,4029,9,250,94,156,2,29,1,1
5576,26,10356,16,161,101,60,2,5,1,1
12693,1963,3417,1499,1890,1010,880,13,16,8,5
14149,10,6081,9,179,94,85,2,31,1,1
14013,10,3198,9,214,110,104,2,30,1,1
22663,10,5246,9,198,94,104,2,30,1,1
9513,15,17815,11,318,192,126,6,28,4,2
9767,26,23966,16,13392,11220,2172,31,53,19,12
6999,549,25720,365,502,150,352,2,1200,1,1
5023,10,16575,9,214,82,132,2,32,1,1
10643,26,10498,16,5188,1096,4092,21,95,12,9
15891,10,26714,9,184,94,90,2,31,1,1
8393,10,2761,9,194,102,92,2,29,1,1
8963,10,25415,9,306,94,212,2,30,1,1
14575,26,12591,16,214312,69934,144378,612,671,303,309
15328,15,25804,11,1462,703,759,8,16,5,3
5561,15,17259,11,1919,1470,449,10,20,6,4
11223,26,17150,16,8868,4111,4757,24,16,12,12
10907,607,3972,418,70,70,0,2,8,2,0
13397,26,9341,16,10029,4115,5914,31,61,17,14
13676,10,19692,9,195,102,93,2,30,1,1
13339,15,23994,11,2244,1549,695,11,18,7,4
15126,10,25990,9,84,84,0,1,31,1,0
21432,10,5993,9,225,110,115,2,30,1,1
22446,10,21338,9,212,110,102,2,30,1,1
12014,15,8576,11,4198,3534,664,13,19,8,5
9649,15,27612,11,318,192,126,6,25,4,2
9720,10,9281,9,765,102,663,2,29,1,1
12541,405,4159,263,1328,960,368,10,32,5,5
14297,10,6307,9,94,94,0,1,29,1,0
5003,26,7653,16,14768,3347,11421,69,1902,32,37
21518,10,853,9,168,86,82,2,30,1,1
5530,26,1324,16,40820,4400,36420,81,81,42,39
11593,26,5525,16,70,70,0,1,5,1,0
5656,15,10920,11,2119,808,1311,12,16,7,5
18537,26,22876,16,585392,18731,566661,623,119,209,414
22245,10,17559,9,214,110,104,2,30,1,1
12646,26,26706,16,12788,2594,10194,40,17,20,20
1909,42,14745,25,323,150,173,2,1200,1,1
15557,15,11473,11,214,140,74,4,35,3,1
22086,10,13601,9,195,94,101,2,31,1,1
21732,10,25372,9,196,94,102,2,30,1,1
13721,10,11111,9,178,94,84,2,31,1,1
10126,26,20057,16,3772,2099,1673,22,18,11,11
9359,10,19892,9,780,104,676,2,31,1,1
6969,26,28105,16,4920,2738,2182,33,259,16,17
15813,26,22896,16,47762,39522,8240,77,332,43,34
21814,15,28708,11,142674,8057,134617,192,27,94,98
8423,10,15633,9,179,94,85,2,29,1,1
2323,26,9573,16,205941,20753,185188,264,30,129,135
12435,1791,28433,1367,320,140,180,6,6,3,3
6527,15,8952,11,3477,1572,1905,16,186,9,7
15642,10,3931,9,195,102,93,2,30,1,1
14123,10,13329,9,210,94,116,2,29,1,1
13930,10,9530,9,268,87,181,4,35,2,2
5390,26,6132,16,3884,1859,2025,20,255,10,10
21237,15,25406,11,314,192,122,6,15,4,2
14990,15,19062,11,35574,868,34706,36,104,10,26
7119,26,7538,16,16297,12965,3332,54,193,30,24
10250,26,10130,16,6678,1212,5466,22,256,12,10
16021,617,12483,425,1577,594,983,20,1600,10,10
12647,1390,9883,1057,70,70,0,1,4,1,0
4317,10,15653,9,226,106,120,2,29,1,1
920,26,1690,16,89362,3092,86270,100,21,37,63
13679,26,14840,16,7654,2110,5544,21,46,13,8
14369,10,1196,9,780,93,687,2,30,1,1
15121,26,22252,16,3413,1537,1876,19,7,10,9
22539,10,18615,9,183,94,89,2,29,1,1
15900,10,14311,9,181,94,87,2,30,1,1
8757,10,22348,9,168,86,82,2,30,1,1
5944,15,17885,11,1914,1465,449,10,19,6,4
11993,26,6297,16,130,70,60,2,15,1,1
15765,10,11449,9,711,87,624,2,30,1,1
4583,15,26847,11,554,258,296,9,13,5,4
10882,26,7306,16,1382291,55962,1326329,1491,24,582,909
15641,10,27343,9,164,84,80,2,31,1,1
8490,10,13846,9,204,104,100,2,31,1,1
18368,26,19728,16,7914400,166459,7747941,6839,775,1138,5701
8448,10,28413,9,251,102,149,2,30,1,1
10209,15,2212,11,3324,663,2661,12,15,7,5
10997,26,16713,16,10684,3167,7517,43,34,24,19
22494,10,13202,9,277,110,167,2,30,1,1
18437,799,8833,581,564,318,246,9,18,5,4
5386,26,26696,16,9766,2050,7716,23,15,12,11
19096,26,15781,16,10803,2906,7897,20,135,10,10
9125,10,20042,9,216,110,106,2,31,1,1
12830,757,6500,545,70,70,0,2,8,2,0
9719,15,22046,11,44569,12221,32348,81,19,42,39
0,0,0,0,124,64,60,2,0,1,1
14419,10,15593,9,177,94,83,2,31,1,1
13548,10,26267,9,199,94,105,2,30,1,1
2744,1238,22165,918,881,126,755,2,30,1,1
11043,1761,12425,1346,66,66,0,1,5,1,0
19713,26,10447,16,24420,19966,4454,64,136,35,29
17914,26,21456,16,1887,1152,735,18,28,9,9
12570,1843,20626,1404,70,70,0,2,7,2,0
5202,26,8496,16,3489,636,2853,16,143,7,9
21567,10,367,9,198,101,97,2,31,1,1
15377,15,9722,11,1559,762,797,14,30,7,7
15543,10,7741,9,230,110,120,2,30,1,1
2172,1947,2415,1484,323,150,173,2,1200,1,1
9548,346,21955,220,11938,4533,7405,33,98,20,13
19982,26,26607,16,4778,1121,3657,15,280,8,7
22673,26,12611,16,148284,6200,142084,165,16,63,102
12599,26,25669,16,499,425,74,4,0,3,1
22147,10,23949,9,193,102,91,2,29,1,1
12818,1801,18752,1373,164,70,94,2,5,1,1
16348,26,18770,16,183325,10358,172967,289,227,95,194
15344,494,3949,324,70,70,0,2,8,2,0
6503,26,25618,16,7192,1772,5420,25,305,13,12
12136,26,23344,16,1528,757,771,19,121,9,10
20002,26,13006,16,3908576,93181,3815395,3743,56,1160,2583
2120,10,8440,9,217,90,127,2,30,1,1
20266,26,8894,16,357841,77119,280722,646,142,316,330
9424,26,11419,16,259911,11421,248490,336,92,144,192
5052,15,21832,11,1114,534,580,12,16,7,5
5031,23,0,0,8977,3570,5407,30,31,15,15
15366,511,9791,336,70,70,0,1,5,1,0
3874,26,311,16,2401,1149,1252,14,982,7,7
21242,10,22941,9,483,189,294,6,85,3,3
636,2627,7401,2037,150,150,0,1,1200,1,0
11563,26,17572,16,2046,1026,1020,17,80,9,8
17203,15,21452,11,22851,3171,19680,39,147,20,19
11126,26,4979,16,86745,6260,80485,121,32,58,63
2744,1242,9052,922,1648,126,1522,4,31,2,2
1969,16,7614,12,146,60,86,2,10,1,1
12824,10,28203,9,306,306,0,4,47,4,0
15744,10,9556,9,178,94,84,2,29,1,1
8867,26,13584,16,13022,1500,11522,30,23,15,15
8947,10,15150,9,254,102,152,2,29,1,1
21659,10,5299,9,183,94,89,2,29,1,1
16458,15,7643,11,20532,14664,5868,47,75,24,23
14782,10,6342,9,170,87,83,2,30,1,1
17185,26,2178,16,152,86,66,2,5,1,1
5611,26,27342,16,5377,857,4520,21,88,8,13
8729,10,11754,9,200,102,98,2,30,1,1
13241,26,12363,16,48303,3997,44306,69,271,30,39
9418,10,22020,9,168,78,90,2,30,1,1
8681,10,8883,9,226,110,116,2,29,1,1
16385,26,18959,16,10141,5997,4144,56,156,28,28
22486,10,21825,9,564,193,371,6,51,3,3
12493,1843,11373,1404,70,70,0,1,5,1,0
16021,709,12077,507,149,149,0,2,1199,2,0
8584,1236,22750,916,241,78,163,2,30,1,1
14969,10,9594,9,186,95,91,3,34,2,1
15158,10,7414,9,196,102,94,2,32,1,1
18747,26,26949,16,2169,1158,1011,20,15,11,9
9280,26,4379,16,48860,5749,43111,91,147,47,44
22020,10,13875,9,303,88,215,4,40,2,2
5091,676,2019,475,138,78,60,2,5,1,1
15755,10,20819,9,195,102,93,2,33,1,1
21822,10,8677,9,177,94,83,2,30,1,1
2744,1239,4672,919,876,126,750,3,31,2,1
14409,10,2869,9,193,102,91,2,30,1,1
15223,15,26596,11,234,234,0,4,12,4,0
19548,26,13121,16,134,60,74,3,10,2,1
10258,15,22350,11,33072,3959,29113,40,46,14,26
9088,10,28398,9,353,94,259,2,31,1,1
8615,10,4708,9,216,110,106,2,30,1,1
14336,345,7144,219,70,70,0,1,5,1,0
7057,26,28131,16,4991,3096,1895,22,220,13,9
14023,10,6097,9,199,102,97,2,30,1,1
17056,26,4200,16,5168,700,4468,16,15,7,9
20535,26,7684,16,26697,7168,19529,74,213,39,35
14131,15,24439,11,124,60,64,2,5,1,1
15575,15,2384,11,214,140,74,4,35,3,1
8486,10,3529,9,199,102,97,2,30,1,1
15928,10,6026,9,321,108,213,4,33,2,2
4674,26,16166,16,4572,1665,2907,19,27,11,8
20086,26,4810,16,9977,4364,5613,19,121,9,10
3915,26,3296,16,4652,3109,1543,25,95,14,11
16607,26,14357,16,7883,1768,6115,30,36,14,16
13828,10,15791,9,293,94,199,2,30,1,1
661,10,2607,9,229,90,139,2,30,1,1
3514,26,22877,16,18876,16514,2362,43,95,24,19
21683,10,9032,9,198,101,97,2,30,1,1
13822,10,28240,9,190,97,93,2,31,1,1
8799,10,16147,9,210,102,108,2,30,1,1
14297,10,10301,9,195,94,101,2,30,1,1
9328,26,23868,16,6081,844,5237,17,15,9,8
12474,3247,15483,2516,70,70,0,1,4,1,0
18056,15,25725,11,440081,8465,431616,424,24,137,287
13883,10,2348,9,259,87,172,4,56,2,2
2208,26,8960,16,14344,1146,13198,25,19,11,14
20830,26,2477,16,606,300,306,11,60,6,5
22127,10,5727,9,224,94,130,2,30,1,1
8977,26,9263,16,6128,1356,4772,20,978,10,10
10045,15,20079,11,12767608,157856,12609752,11936,135,2227,9709
14700,10,10160,9,197,102,95,2,30,1,1
14308,10,23381,9,198,94,104,2,30,1,1
10936,802,2730,584,70,70,0,1,5,1,0
15409,10,10621,9,178,94,84,2,30,1,1
13689,26,3265,16,5653,2347,3306,33,361,18,15
2744,1243,22623,923,1626,126,1500,4,30,2,2
8817,26,2603,16,920003,731041,188962,2024,929,1212,812
14886,10,13474,9,177,94,83,2,30,1,1
21990,15,23886,11,3199,988,2211,14,99,7,7
21844,10,25005,9,395,89,306,4,32,2,2
4638,26,18266,16,9959,2495,7464,27,37,15,12
15817,10,13244,9,211,102,109,2,30,1,1
22419,10,13183,9,197,102,95,2,29,1,1
2744,1450,24724,1103,1640,126,1514,4,30,2,2
21844,10,16834,9,190,97,93,2,31,1,1
12347,26,28596,16,558,210,348,9,29,4,5
5729,26,19826,16,41517,28432,13085,89,601,47,42
0,0,0,0,320,320,0,5,0,5,0
11431,10,21730,9,183,86,97,2,30,1,1
22322,10,2807,9,220,94,126,2,29,1,1
13939,10,22876,9,779,86,693,2,30,1,1
14941,26,24632,16,188316,24744,163572,302,172,119,183
17490,26,2108,16,8332,1024,7308,21,25,11,10
21593,10,2681,9,266,110,156,2,30,1,1
5782,26,15467,16,4125,2847,1278,18,255,10,8
9841,15,29061,11,318,192,126,6,27,4,2
11106,26,22578,16,24299,8382,15917,69,93,35,34
2744,1239,22919,919,892,126,766,2,30,1,1
11782,26,7903,16,13139,6481,6658,36,262,16,20
6544,26,25909,16,2027060,31188,1995872,1708,77,321,1387
21916,10,20975,9,183,94,89,2,30,1,1
8761,10,3749,9,180,94,86,2,30,1,1
14426,10,9081,9,193,102,91,2,30,1,1
9046,10,22889,9,441,104,337,4,48,2,2
15624,10,23314,9,173,94,79,2,31,1,1
15510,302,4969,196,126,126,0,1,30,1,0
18451,15,2677,11,2424,529,1895,11,125,6,5
4850,15,16357,11,3581,2902,679,13,23,8,5
15135,10,28315,9,177,94,83,2,30,1,1
15702,10,25237,9,235,90,145,2,32,1,1
9328,10,20620,9,768,99,669,2,31,1,1
8704,15,22728,11,2050,1691,359,9,75,6,3
21891,10,19674,9,250,86,164,4,33,2,2
15336,1736,20628,1325,70,70,0,1,5,1,0
15259,10,8880,9,301,94,207,2,31,1,1
19661,467,18625,302,10747,2507,8240,26,48,14,12
22001,10,20070,9,497,102,395,4,40,2,2
3206,30,28181,18,879,462,417,2,600,1,1
9104,26,6417,16,4363,1298,3065,17,127,8,9
4937,26,19101,16,130,70,60,2,15,1,1
15608,10,8234,9,198,101,97,2,31,1,1
5850,26,5555,16,153,93,60,2,5,1,1
22157,10,13655,9,733,94,639,2,30,1,1
13020,26,1572,16,499,425,74,4,0,3,1
16271,26,18738,16,6182,3879,2303,53,3828,31,22
9090,10,6428,9,180,94,86,2,30,1,1
10095,26,22077,16,17161,1619,15542,18,143,4,14
8734,10,23462,9,184,102,82,2,29,1,1
13673,26,14571,16,12411,7888,4523,33,17,19,14
12818,1801,1805,1373,258,70,188,4,7,2,2
2744,1619,7207,1241,892,126,766,2,30,1,1
21911,10,6504,9,184,94,90,2,31,1,1
14014,10,7389,9,711,87,624,2,30,1,1
306,10,846,9,240,96,144,2,30,1,1
13621,10,19009,9,178,94,84,2,31,1,1
4844,26,5869,16,8365,3018,5347,31,271,15,16
21906,10,7095,9,211,102,109,2,31,1,1
11073,15,15661,11,4185,3462,723,14,15,7,7
22391,1285,13751,964,268,78,190,2,29,1,1
22412,10,15679,9,166,86,80,2,30,1,1
7915,10,20768,9,260,106,154,2,32,1,1
8559,10,5978,9,183,86,97,2,30,1,1
3370,234,9160,149,15651,3559,12092,63,6557,28,35
15383,10,7428,9,180,94,86,2,35,1,1
11197,15,15666,11,1734,800,934,10,16,6,4
11277,10,10094,9,216,86,130,2,30,1,1
22107,10,7979,9,195,102,93,2,30,1,1
10514,26,8826,16,8618,3110,5508,34,1695,18,16
15454,10,5536,9,209,110,99,2,30,1,1
5222,15,21082,11,1280,586,694,10,15,5,5
12819,10,13222,9,199,94,105,2,31,1,1
5866,26,864,16,3384,762,2622,15,135,7,8
21554,26,9026,16,56432,4371,52061,72,135,29,43
13974,10,11239,9,199,102,97,2,31,1,1
6250,1981,4665,1511,724,550,174,4,30,2,2
1105,26,9853,16,3614,434,3180,11,15,6,5
18811,1989,18526,1519,316,136,180,6,7,3,3
21046,2357,26225,1835,66,66,0,2,7,2,0
19534,26,4346,16,9963,2631,7332,37,48,20,17
7816,26,28034,16,9950,4684,5266,26,306,12,14
10841,26,25465,16,18108,1782,16326,31,215,15,16
11431,15,21231,11,1647,481,1166,13,15,6,7
15637,10,28727,9,172,88,84,2,30,1,1
12811,2586,11941,2007,2069,1081,988,12,16,7,5
18907,26,27035,16,13557,3307,10250,43,47,25,18
11328,10,15582,9,70,70,0,1,29,1,0
15082,10,19819,9,102,102,0,1,30,1,0
15155,26,10015,16,23150,13858,9292,52,49,32,20
12550,1346,11847,1021,70,70,0,2,7,2,0
9779,26,5001,16,8252,1702,6550,26,72,13,13
21567,10,1412,9,199,102,97,2,29,1,1
15508,10,27995,9,198,102,96,2,30,1,1
8822,10,23595,9,309,118,191,2,30,1,1
8898,26,4506,16,592433,191668,400765,1555,1157,608,947
14172,10,22162,9,177,94,83,2,30,1,1
14419,10,9041,9,177,94,83,2,30,1,1
972,15,20863,11,318,192,126,6,26,4,2
7646,10,20342,9,197,90,107,2,30,1,1
6244,26,25208,16,6021,1249,4772,20,23,11,9
13742,10,18576,9,198,101,97,2,30,1,1
1999,10,7767,9,233,90,143,2,32,1,1
4501,15,22335,11,1056,682,374,10,15,6,4
2724,1240,18804,920,422,164,258,6,30,3,3
1646,26,1754,16,2556,1470,1086,17,15,8,9
15024,10,12389,9,199,102,97,2,30,1,1
14509,10,27854,9,711,87,624,2,31,1,1
22419,10,8642,9,197,102,95,2,31,1,1
6236,26,18311,16,2200,1253,947,23,76,12,11
14199,10,19061,9,168,86,82,2,31,1,1
14956,10,23499,9,184,102,82,2,30,1,1
12638,26,13694,16,499,425,74,4,0,3,1
636,280,16507,177,231,111,120,2,1200,1,1
2724,1240,25458,920,172,86,86,2,30,1,1
2744,1247,3544,927,1760,252,1508,5,31,3,2
17044,26,16308,16,42954,12409,30545,154,319,67,87
9187,10,26830,9,166,86,80,2,31,1,1
7912,26,21065,16,8708,3949,4759,22,21,11,11
15357,10,22668,9,197,102,95,2,33,1,1
8993,10,19413,9,733,86,647,2,29,1,1
8910,15,14947,11,1111,749,362,9,15,5,4
1220,15,4030,11,7351,803,6548,16,24,7,9
22492,10,4247,9,212,102,110,2,29,1,1
22288,10,10729,9,209,110,99,2,30,1,1
17150,26,3567,16,18715,10778,7937,39,96,16,23
15481,26,2147,16,187104,26358,160746,205,190,58,147
8458,10,13037,9,759,102,657,2,30,1,1
13477,26,5473,16,9487,2103,7384,32,24,16,16
1019,26,27088,16,3616,429,3187,11,15,6,5
15941,10,25641,9,228,110,118,2,30,1,1
18037,26,1012,16,6065,1772,4293,27,1587,15,12
18488,26,10875,16,1541,1004,537,14,26,8,6
14126,26,20752,16,5123,2651,2472,15,123,8,7
6414,26,12021,16,15769,1619,14150,17,137,4,13
14567,10,27963,9,177,94,83,2,29,1,1
21778,10,25850,9,209,110,99,2,30,1,1
15908,10,21274,9,177,94,83,2,30,1,1
5668,26,26418,16,6058,1749,4309,22,201,13,9
12184,26,23365,16,4348,1441,2907,19,29,11,8
14408,10,18065,9,184,94,90,2,30,1,1
18072,26,7611,16,6720,1166,5554,22,360,11,11
21888,10,21170,9,216,102,114,2,30,1,1
8097,26,12924,16,47703,2616,45087,62,120,24,38
8210,472,21194,306,2736,1992,744,37,1580,25,12
3909,26,16418,16,16010,4754,11256,47,130,20,27
9386,26,19157,16,9418,2681,6737,39,256,18,21
6429,10,9760,9,168,78,90,2,30,1,1
10075,26,28562,16,29452,1988,27464,37,3619,10,27
3526,10,26161,9,168,78,90,2,29,1,1
6499,26,18668,16,3051,1801,1250,18,16,8,10
20509,26,19896,16,304,86,218,2,29,1,1
20894,26,28251,16,4742,1835,2907,19,29,11,8
22635,15,6777,11,486,240,246,9,28,5,4
6523,26,18702,16,4493,1586,2907,19,26,11,8
6835,26,16063,16,2709,1698,1011,20,1143,11,9
12790,15,3479,11,78,78,0,2,7,2,0
22011,10,21466,9,199,102,97,2,30,1,1
14492,2627,24366,2037,460,150,310,2,1200,1,1
7120,26,26399,16,11233,3101,8132,37,150,18,19
8650,295,21512,190,2958,1567,1391,15,15,8,7
2644,15,11097,11,490,264,226,8,32,5,3
9273,6,21822,6,66,66,0,1,5,1,0
2744,86,4544,66,862,126,736,2,30,1,1
17842,26,24060,16,8380,1882,6498,29,396,9,20
9717,15,4520,11,318,192,126,6,26,4,2
4549,15,16009,11,7850,1208,6642,16,20,8,8
21995,10,6797,9,416,107,309,4,29,2,2
11185,3201,22701,2482,70,70,0,2,7,2,0
13640,10,11161,9,214,110,104,2,30,1,1
15738,10,13105,9,172,88,84,2,30,1,1
9944,26,4529,16,6337,1378,4959,19,140,9,10
6182,15,1506,11,1711,698,1013,14,17,6,8
6474,15,19550,11,2088,472,1616,15,155,3,12
21901,10,27842,9,183,94,89,2,29,1,1
14910,10,21586,9,172,88,84,2,31,1,1
12716,26,28768,16,499,425,74,4,1,3,1
13676,3055,28415,2372,1550,1130,420,15,25,9,6
8360,26,17842,16,11773,2390,9383,29,19,15,14
8778,10,14129,9,234,94,140,2,31,1,1
17398,26,19254,16,2863,1501,1362,20,315,10,10
15163,10,1943,9,184,94,90,2,31,1,1
8933,10,687,9,177,94,83,2,30,1,1
14815,10,24482,9,512,187,325,6,58,3,3
7739,26,23393,16,777,432,345,10,15,5,5
22273,10,21451,9,754,94,660,2,31,1,1
12658,690,9486,489,258,70,188,4,8,2,2
6885,26,11597,16,9060,3523,5537,27,319,15,12
15077,15,28041,11,277848,13775,264073,301,63,118,183
15841,26,5044,16,1402,917,485,12,27,7,5
11243,15,18594,11,5022,1422,3600,16,135,8,8
14293,10,19804,9,229,94,135,2,30,1,1
12524,1182,15054,872,552,306,246,9,15,5,4
18467,1884,99,1438,164,70,94,2,5,1,1
3724,15,4983,11,494,280,214,8,14,5,3
9719,15,5317,11,318,192,126,6,25,4,2
15820,10,8071,9,167,86,81,2,30,1,1
1765,341,24625,217,212,150,62,2,30,1,1
18918,10,27045,9,220,100,120,2,31,1,1
3008,15,12376,11,490,264,226,8,35,5,3
21489,10,28285,9,302,92,210,4,30,2,2
18340,26,18394,16,9551,2173,7378,33,26,17,16
15001,10,12825,9,195,102,93,2,30,1,1
15287,26,18996,16,1540037,36876,1503161,1511,62,511,1000
8706,10,16996,9,198,110,88,2,31,1,1
3814,26,9134,16,2119,1310,809,21,27,12,9
13952,10,11973,9,195,102,93,2,31,1,1
22085,10,9921,9,323,94,229,2,30,1,1
3671,10,14640,9,823,98,725,2,31,1,1
15477,15,22762,11,25125,2681,22444,36,318,19,17
9706,26,23663,16,103466,11111,92355,258,140,119,139
22005,10,4231,9,214,94,120,2,30,1,1
5263,26,25126,16,310402,12194,298208,374,82,157,217
11080,15,26193,11,20868,10484,10384,34,32,17,17
7073,26,15935,16,131573,4926,126647,152,152,55,97
18510,1811,6615,1381,70,70,0,2,8,2,0
5733,26,2089,16,190,70,120,4,15,2,2
15719,10,7018,9,755,94,661,2,31,1,1
22126,10,19900,9,183,94,89,2,30,1,1
10937,2415,17549,1879,316,136,180,6,5,3,3
7268,26,4160,16,5359,3152,2207,51,2901,28,23
16355,26,20936,16,3486,2064,1422,26,177,14,12
13691,26,2401,16,130,70,60,3,5,2,1
8424,15,21401,11,19393,1504,17889,30,32,12,18
636,558,726,374,216,118,98,2,1199,1,1
3803,10,14846,9,257,106,151,2,30,1,1
13650,10,12834,9,252,102,150,2,29,1,1
3675,10,14645,9,229,89,140,2,31,1,1
13640,10,27530,9,214,110,104,2,30,1,1
15097,10,5864,9,167,86,81,2,29,1,1
5789,10,17647,9,210,98,112,2,31,1,1
8282,15,5639,11,3422,2088,1334,18,152,9,9
13835,10,23807,9,211,102,109,2,30,1,1
15603,10,25795,9,283,101,182,4,38,2,2
9094,10,22726,9,258,110,148,2,30,1,1
12638,3135,10599,2433,164,70,94,2,4,1,1
19621,26,27214,16,8189,3146,5043,26,30,14,12
22628,10,26395,9,488,111,377,4,53,2,2
11421,26,229,16,1043,556,487,10,15,6,4
8497,26,1473,16,7913,2091,5822,23,42,11,12
2606,295,10978,190,2269,815,1454,14,16,7,7
9680,15,10307,11,24166,3105,21061,31,24,12,19
6780,26,12012,16,6599,3950,2649,36,186,20,16
10940,26,13999,16,308,188,120,4,15,2,2
4431,15,16268,11,12993,6920,6073,22,20,13,9
2220,26,9045,16,17221,1314,15907,31,44,16,15
10327,2627,2507,2037,459,149,310,2,1201,1,1
2046,2259,3747,1749,481,150,331,2,1200,1,1
16951,255,25970,160,130,66,64,2,4,1,1
16021,2378,28078,1849,528,528,0,9,1201,9,0
14018,10,11455,9,289,97,192,4,45,2,2
11078,26,5729,16,3182,1568,1614,8,120,4,4
12494,26,7035,16,9485,2173,7312,32,27,17,15
5745,10,13907,9,221,75,146,2,30,1,1
8006,10,20888,9,262,106,156,2,33,1,1
14834,10,15272,9,200,102,98,2,30,1,1
17973,26,24050,16,12809,7765,5044,95,84,55,40
4979,26,16509,16,4609,1702,2907,19,29,11,8
21719,10,23460,9,168,86,82,2,29,1,1
15838,10,18397,9,172,88,84,2,30,1,1
2724,1240,24195,920,422,164,258,6,30,3,3
22703,10,6036,9,214,110,104,2,29,1,1
4013,26,3731,16,2392,917,1475,16,224,8,8
13696,26,20928,16,5409,1471,3938,21,17,12,9
13609,10,26917,9,177,94,83,2,31,1,1
10898,1480,7200,1126,70,70,0,1,5,1,0
21439,10,21948,9,209,102,107,2,30,1,1
15003,15,4772,11,17135,1507,15628,24,22,9,15
14340,1343,3498,1018,316,190,126,5,16,3,2
6784,26,16779,16,6750,4410,2340,19,120,9,10
5169,26,5900,16,9185,3854,5331,23,16,13,10
14726,10,13404,9,245,94,151,2,30,1,1
10088,15,27934,11,5730351,74236,5656115,4865,78,1088,3777
11040,1084,21486,795,316,136,180,6,5,3,3
22389,10,1860,9,285,94,191,2,30,1,1
9411,555,10030,371,858,858,0,14,1200,14,0
8741,10,26451,9,244,102,142,2,29,1,1
8372,1408,10121,1071,316,136,180,6,7,3,3
15543,15,5946,11,1783,841,942,10,20,6,4
21609,10,25408,9,271,85,186,4,30,2,2
10319,26,25608,16,18745,11713,7032,67,77,37,30
13938,10,15146,9,199,102,97,2,30,1,1
7454,26,23925,16,9172,3518,5654,39,103,21,18
17851,1257,10327,937,1218,924,294,6,30,3,3
8396,10,3435,9,88,88,0,1,31,1,0
12666,458,18900,296,70,70,0,1,5,1,0
3606,26,25014,16,19547,2951,16596,42,82,21,21
8641,10,21763,9,243,110,133,2,30,1,1
13807,10,3730,9,732,89,643,2,30,1,1
3733,26,21408,16,1820,1101,719,18,76,10,8
5488,26,18209,16,56980,4095,52885,90,256,37,53
1073,26,19549,16,5699,505,5194,14,15,7,7
14076,10,19350,9,177,94,83,2,30,1,1
10159,26,5620,16,7298,2661,4637,21,17,11,10
11261,44,23867,27,136,136,0,3,14,3,0
8469,26,16710,16,9232,3149,6083,55,40,31,24
9175,10,20618,9,1398,98,1300,4,31,2,2
14214,792,28029,576,70,70,0,2,8,2,0
13830,10,28188,9,183,94,89,2,30,1,1
9522,10,3641,9,199,102,97,2,29,1,1
3145,10,13186,9,365,233,132,3,34,2,1
13917,10,4824,9,285,103,182,4,51,2,2
4416,15,3954,11,196328,10952,185376,244,31,117,127
11910,26,16437,16,25010,3519,21491,42,135,17,25
1909,402,15489,261,491,150,341,2,1200,1,1
14938,10,15307,9,270,110,160,2,30,1,1
15006,10,26295,9,164,84,80,2,31,1,1
18937,26,17343,16,5081,896,4185,16,70,8,8
8751,10,26576,9,718,94,624,2,30,1,1
15466,10,8659,9,177,94,83,2,31,1,1
7971,26,20846,16,4485,1578,2907,19,28,11,8
5822,26,27124,16,1786,172,1614,7,121,3,4
18811,10,26985,9,248,106,142,2,30,1,1
17880,15,6539,11,1278,774,504,12,361,7,5
1224,15,4034,11,450,246,204,8,24,5,3
15252,10,13727,9,286,103,183,4,48,2,2
10993,26,16767,16,14602,6734,7868,46,56,26,20
17905,26,18279,16,162,102,60,2,5,1,1
11017,15,16208,11,2175,1532,643,10,22,7,3
15348,10,13206,9,183,94,89,2,30,1,1
4211,26,17761,16,11769,1894,9875,27,99,13,14
13953,26,27730,16,4005,1162,2843,17,142,8,9
6244,234,20341,149,3489,1598,1891,25,631,7,18
21921,10,25665,9,209,102,107,2,30,1,1
15212,10,22720,9,214,110,104,2,30,1,1
3628,26,13362,16,2044,1024,1020,17,80,9,8
16021,816,3967,596,1818,1188,630,26,2804,19,7
21604,10,5820,9,213,102,111,2,29,1,1
17288,26,24611,16,3284,1878,1406,20,27,11,9
7983,26,22854,16,1429,1295,134,10,29,8,2
13811,10,9815,9,193,102,91,2,29,1,1
9035,26,20457,16,615040,25597,589443,704,54,245,459
16444,26,6884,16,3264,1175,2089,14,120,7,7
11846,26,18575,16,22218,12408,9810,66,115,33,33
899,26,5534,16,6334,840,5494,19,29,10,9
7890,26,2349,16,15600,2166,13434,32,205,16,16
13863,26,24312,16,3239,740,2499,15,40,8,7
10479,10,13966,9,168,78,90,2,30,1,1
8445,15,13809,11,991,525,466,10,136,6,4
8392,15,9955,11,15343,3240,12103,23,81,9,14
12139,26,23347,16,1464,757,707,18,121,9,9
14505,10,10114,9,267,94,173,4,55,2,2
21364,10,8461,9,197,94,103,2,30,1,1
21441,10,20527,9,179,94,85,2,30,1,1
10098,26,19068,16,7221,2265,4956,16,127,7,9
21482,10,8809,9,265,110,155,2,30,1,1
13299,26,3178,16,3296,1329,1967,14,135,7,7
5911,26,19553,16,8248,876,7372,25,186,9,16
22551,10,1618,9,443,182,261,6,30,3,3
14967,10,3880,9,177,94,83,2,31,1,1
14335,10,16309,9,170,87,83,2,31,1,1
22070,10,8140,9,178,94,84,2,31,1,1
656,10,2592,9,235,90,145,2,32,1,1
915,26,5490,16,5242,902,4340,16,29,8,8
3259,183,13934,121,4021,1916,2105,20,18,12,8
12110,26,18708,16,57706,2486,55220,67,65,23,44
21697,10,11450,9,261,102,159,2,30,1,1
5061,26,7060,16,20651533,655694,19995839,24885,362,8746,16139
15547,10,8968,9,814,110,704,2,30,1,1
22053,10,16752,9,179,94,85,2,30,1,1
9080,10,22943,9,395,111,284,2,31,1,1
8493,26,26254,16,5514,3341,2173,31,75,15,16
11135,42,15457,25,70,70,0,2,7,2,0
14909,10,20824,9,177,94,83,2,31,1,1
8964,10,18853,9,196,102,94,2,30,1,1
11071,2451,15569,1904,70,70,0,2,8,2,0
4657,26,2933,16,13637,6347,7290,34,46,20,14
8876,10,10984,9,89,89,0,1,30,1,0
12497,349,1026,222,70,70,0,2,8,2,0
16864,232,1326,147,2834,1238,1596,26,34,13,13
9711,26,5649,16,1202,720,482,12,139,7,5
6170,26,6559,16,10195,2175,8020,25,187,14,11
15204,26,4803,16,23887293,546911,23340382,23137,108,7700,15437
14284,10,2819,9,214,110,104,2,30,1,1
21840,10,20072,9,189,102,87,2,30,1,1
12796,1446,320,1099,552,366,186,9,17,6,3
10129,26,13194,16,41713,34380,7333,67,333,38,29
9648,26,20443,16,5476,1073,4403,22,78,12,10
5719,26,13458,16,130,70,60,3,5,2,1
11130,26,26128,16,190,70,120,4,15,2,2
22635,183,29110,121,4305,2521,1784,19,34,10,9
13708,26,2849,16,6903,1481,5422,33,612,12,21
4512,26,9516,16,1835,1190,645,17,26,10,7
15038,10,8626,9,209,110,99,2,30,1,1
14977,26,11779,16,4239,1850,2389,25,179,12,13
18873,26,27011,16,10630,3315,7315,27,46,15,12
9712,15,7078,11,318,192,126,6,26,4,2
14315,10,19598,9,193,102,91,2,29,1,1
4660,10,26063,9,168,78,90,2,30,1,1
22537,10,8715,9,90,90,0,1,30,1,0
13846,10,5783,9,209,110,99,2,30,1,1
14347,600,4524,411,70,70,0,2,8,2,0
7291,15,771,11,41602,9508,32094,72,476,36,36
15022,10,532,9,168,86,82,2,30,1,1
8327,2663,4587,2070,800,150,650,4,1200,2,2
11221,1606,13301,1230,70,70,0,1,4,1,0
15669,26,10155,16,17207,7111,10096,44,51,23,21
21298,10,24025,9,195,102,93,2,30,1,1
2732,26,15015,16,7599,2842,4757,27,22,15,12
14754,10,5751,9,265,85,180,4,42,2,2
21988,10,14699,9,195,94,101,2,30,1,1
15432,10,28408,9,190,97,93,2,31,1,1
14876,10,11320,9,177,94,83,2,31,1,1
11550,10,2316,9,265,91,174,4,40,2,2
15942,10,17369,9,194,99,95,2,31,1,1
6066,26,28330,16,20594,4629,15965,46,317,29,17
12812,10,19743,9,578,286,292,9,15,5,4
4666,26,23127,16,499,425,74,4,0,3,1
9878,26,2466,16,22676,8150,14526,33,16,17,16
10980,15,17854,11,1268,645,623,12,45,7,5
8389,10,6453,9,199,94,105,2,30,1,1
10470,26,28661,16,36713,3193,33520,57,623,23,34
15211,10,21469,9,168,86,82,2,30,1,1
2028,10,7944,9,414,268,146,3,32,2,1
14643,10,9741,9,183,94,89,2,30,1,1
22458,10,1312,9,199,102,97,2,30,1,1
12659,422,11731,275,70,70,0,2,7,2,0
4694,26,1002,16,2141,1270,871,18,130,10,8
7235,26,11083,16,7764,1734,6030,23,20,13,10
14145,10,1817,9,184,94,90,2,30,1,1
12013,26,16619,16,1630,1089,541,14,15,8,6
8379,15,272,11,1013,566,447,8,134,5,3
21597,10,21083,9,286,102,184,4,46,2,2
5980,26,25202,16,2767442,82304,2685138,2961,85,1088,1873
18877,26,20466,16,60954,33730,27224,101,63,50,51
0,0,0,0,244,244,0,2,0,2,0
11722,15,10585,11,82430,3774,78656,108,67,49,59
8588,10,23142,9,719,208,511,6,32,3,3
4279,15,2253,11,1348,844,504,13,255,8,5
3623,15,14568,11,490,264,226,8,140,5,3
11027,646,9748,450,130,70,60,2,4,1,1
9834,26,18966,16,354,294,60,2,5,1,1
15163,10,28526,9,184,94,90,2,31,1,1
15187,10,12773,9,274,87,187,4,31,2,2
8552,26,3436,16,16316,7445,8871,49,237,23,26
6821,26,28750,16,280,140,140,5,130,3,2
21655,10,3773,9,257,126,131,2,31,1,1
14574,10,9223,9,184,94,90,2,30,1,1
5600,26,17331,16,11928,3226,8702,23,160,11,12
13503,26,22725,16,9035,1873,7162,28,124,14,14
12466,3100,24620,2408,320,140,180,6,7,3,3
21425,10,20762,9,182,93,89,2,31,1,1
11150,15,1031,11,366,240,126,7,26,5,2
7865,26,20697,16,4585,1678,2907,19,28,11,8
15944,10,21437,9,178,94,84,2,30,1,1
12174,26,391,16,123194,68738,54456,402,287,167,235
21346,10,11854,9,424,104,320,4,31,2,2
22134,10,558,9,209,102,107,2,30,1,1
11541,15,23034,11,3886,696,3190,13,142,6,7
18334,26,15224,16,6627,1780,4847,23,149,13,10
8854,10,4270,9,782,110,672,2,30,1,1
13511,10,24115,9,404,259,145,3,33,2,1
16168,15,25497,11,64437,2630,61807,64,31,18,46
8584,1240,4962,920,239,78,161,2,30,1,1
13805,10,21530,9,199,102,97,2,29,1,1
8366,351,18169,224,370,190,180,6,15,3,3
56,1328,19702,1003,132,70,62,2,31,1,1
19525,15,21030,11,11437,2775,8662,32,53,15,17
3232,10,13791,9,229,89,140,2,30,1,1
5632,15,17383,11,1032410,43358,989052,1356,72,591,765
2724,1240,28417,920,422,164,258,6,30,3,3
14294,1820,14563,1387,70,70,0,1,5,1,0
17053,26,11874,16,70,70,0,1,5,1,0
12281,26,1664,16,9896,2040,7856,34,120,17,17
18773,1989,1522,1519,316,136,180,6,6,3,3
8581,10,4875,9,313,83,230,4,54,2,2
11052,2745,14558,2128,70,70,0,2,8,2,0
17429,10,0,0,619,76,543,2,30,1,1
5776,26,16111,16,3287,2049,1238,12,31,7,5
14506,10,17569,9,216,102,114,2,30,1,1
21273,10,1478,9,225,110,115,2,30,1,1
21319,10,9313,9,320,94,226,2,29,1,1
2744,1238,26879,918,902,126,776,2,30,1,1
19333,26,3777,16,4933,771,4162,18,28,8,10
12629,10,4011,9,167,78,89,2,30,1,1
15467,10,11379,9,178,94,84,2,30,1,1
15308,10,1993,9,183,94,89,2,30,1,1
8516,15,21445,11,450,246,204,8,141,5,3
15800,10,8345,9,173,94,79,2,30,1,1
8584,1238,22801,918,232,71,161,2,31,1,1
11220,15,4802,11,3223,843,2380,12,30,7,5
18345,26,26735,16,7428,729,6699,19,80,7,12
21810,10,6769,9,176,90,86,2,31,1,1
22534,10,2828,9,200,102,98,2,30,1,1
11016,2109,20564,1625,70,70,0,2,8,2,0
14918,10,22844,9,196,102,94,2,35,1,1
504,1726,2552,1318,247495,256,247239,361,49,5,356
12085,26,105,16,4371,1115,3256,19,19,9,10
18895,26,23369,16,204,70,134,4,25,2,2
8828,10,12673,9,211,102,109,2,29,1,1
14406,10,27210,9,322,134,188,2,29,1,1
8718,15,13385,11,1963,1067,896,11,15,6,5
15528,10,14862,9,183,94,89,2,30,1,1
8935,10,12867,9,785,110,675,2,30,1,1
15236,26,13931,16,8059,2039,6020,20,15,11,9
15087,15,16649,11,3697,832,2865,12,15,7,5
3346,26,4110,16,6411,1611,4800,24,17,13,11
17941,26,23971,16,948180,35714,912466,1121,119,378,743
15171,10,16796,9,188,96,92,2,31,1,1
8650,26,26095,16,407843,11895,395948,436,271,157,279
10826,2483,24360,1931,70,70,0,2,8,2,0
15284,26,27056,16,1239919,29325,1210594,1214,46,409,805
9064,26,9143,16,6896,2139,4757,31,33,15,16
3790,26,28388,16,7950,1925,6025,26,66,14,12
21294,10,4392,9,461,94,367,2,29,1,1
21290,2044,15800,1571,66,66,0,2,8,2,0
22356,10,13974,9,167,86,81,2,31,1,1
15228,26,9240,16,1272,876,396,10,25,6,4
15218,26,24120,16,7914,1925,5989,20,15,11,9
5560,233,20962,148,5386,1100,4286,27,686,10,17
12432,183,23520,121,3489,1534,1955,17,16,9,8
3650,26,2004,16,8208,2080,6128,24,81,14,10
12288,26,23432,16,2511,1464,1047,21,102,10,11
7446,1180,10589,870,332,192,140,6,25,4,2
22558,10,19367,9,458,188,270,6,31,3,3
22004,10,26715,9,212,102,110,2,29,1,1
6250,1995,4734,1525,148,86,62,2,30,1,1
532,247,0,0,3354,1792,1562,46,192,23,23
21166,2597,19575,2016,66,66,0,2,8,2,0
16800,26,18393,16,10588,1664,8924,29,631,11,18
15199,10,14728,9,177,94,83,2,30,1,1
8610,10,18541,9,401,88,313,4,38,2,2
15278,15,9286,11,41915,4128,37787,59,64,29,30
10890,2755,11875,2136,70,70,0,2,7,2,0
21955,10,22886,9,770,102,668,2,30,1,1
17055,26,3076,16,11839,7753,4086,30,17,15,15
5967,15,18448,11,1000,577,423,10,200,6,4
15497,10,21158,9,216,110,106,2,30,1,1
15662,10,2611,9,177,94,83,2,30,1,1
22340,10,13200,9,229,110,119,2,30,1,1
7397,10,24959,9,311,86,225,2,30,1,1
532,247,0,0,3498,1872,1626,48,195,24,24
14943,10,23123,9,453,186,267,6,30,3,3
15901,26,13199,16,30232,22633,7599,77,23,46,31
14801,10,4717,9,168,86,82,2,31,1,1
7679,10,3916,9,199,94,105,2,30,1,1
22390,10,1396,9,198,101,97,2,30,1,1
8631,26,20869,16,2894,725,2169,10,121,5,5
12594,26,10255,16,499,425,74,4,0,3,1
6737,18,2259,13,184,94,90,2,29,1,1
9676,15,20874,11,4561,2110,2451,15,26,9,6
6613,234,5460,149,2531,1416,1115,17,3600,8,9
19703,15,5785,11,4295,719,3576,16,125,8,8
2744,1243,555,923,1622,126,1496,4,31,2,2
14637,10,10136,9,173,94,79,2,30,1,1
11273,1780,7283,1358,70,70,0,2,6,2,0
14948,10,12968,9,194,102,92,2,30,1,1
7470,26,21076,16,232,172,60,3,5,2,1
22605,10,4286,9,197,102,95,2,31,1,1
9277,26,10028,16,307104860,2750998,304353862,234597,6122,15017,219580
13872,26,20382,16,8025,3048,4977,23,45,13,10
15779,10,20161,9,184,102,82,2,29,1,1
7081,26,13706,16,6533,1777,4756,24,271,13,11
17080,26,16566,16,5971,706,5265,17,15,7,10
8355,10,26012,9,621,111,510,4,35,2,2
6836,26,2831,16,63895,4604,59291,80,276,34,46
21049,15,28884,11,314,192,122,6,15,4,2
12449,606,18764,417,70,70,0,1,4,1,0
15795,10,25774,9,165,86,79,2,30,1,1
7328,26,28481,16,4046,967,3079,13,27,7,6
3911,15,27594,11,15867,2466,13401,29,33,16,13
22032,10,25645,9,199,102,97,2,30,1,1
18562,2250,2820,1742,70,70,0,1,5,1,0
17614,26,15815,16,7913,5787,2126,28,316,14,14
21541,10,11976,9,186,95,91,2,31,1,1
21665,10,1003,9,194,102,92,2,31,1,1
12097,15,23110,11,2953,785,2168,12,116,8,4
1246,10,4125,9,404,259,145,3,33,2,1
16021,280,4007,177,163,163,0,1,1200,1,0
8641,26,19109,16,10402,1945,8457,24,158,11,13
5880,26,27768,16,8582,4759,3823,29,135,14,15
13659,26,13967,16,134,60,74,3,11,2,1
17288,26,10159,16,204,70,134,4,25,2,2
9360,115,7900,88,70,70,0,2,8,2,0
4835,834,3640,613,3957,2324,1633,51,1794,29,22
8885,26,11838,16,4717,849,3868,15,52,7,8
21268,10,8012,9,259,110,149,2,30,1,1
15880,10,10331,9,194,102,92,2,31,1,1
8488,26,6193,16,3005,2082,923,18,28,9,9
9678,15,4466,11,318,192,126,6,25,4,2
9962,15,15631,11,35970,11674,24296,108,265,55,53
12672,26,55,16,499,425,74,4,0,3,1
9233,10,13570,9,168,86,82,2,30,1,1
14971,10,441,9,701,88,613,2,30,1,1
12954,10,28880,9,168,78,90,2,31,1,1
19357,26,28378,16,9619,879,8740,19,135,8,11
15164,26,12076,16,10615,5909,4706,28,42,14,14
15171,10,13464,9,194,102,92,2,30,1,1
8463,10,12287,9,186,95,91,2,31,1,1
8756,15,9518,11,314,128,186,6,26,3,3
22069,10,16798,9,199,102,97,2,30,1,1
10949,26,15555,16,17595,8241,9354,80,106,43,37
5479,26,3350,16,69542,11991,57551,139,157,60,79
8800,10,18683,9,344,126,218,2,30,1,1
17143,26,19372,16,6033,770,5263,18,16,8,10
22536,10,19820,9,197,102,95,2,30,1,1
14108,10,17442,9,760,97,663,2,31,1,1
15303,10,4758,9,166,86,80,2,30,1,1
18965,26,12188,16,396507,14667,381840,458,21,171,287
15825,10,18563,9,205,94,111,2,30,1,1
5139,26,24042,16,90043,3609,86434,97,15,33,64
22012,10,5743,9,178,94,84,2,29,1,1
15686,10,13632,9,216,110,106,2,30,1,1
16021,287,17188,184,507,163,344,2,1200,1,1
21591,10,18044,9,200,102,98,2,30,1,1
9436,26,21472,16,26064,2233,23831,44,97,23,21
13693,10,3643,9,177,94,83,2,30,1,1
14461,10,24207,9,265,86,179,4,59,2,2
8888,26,7320,16,5943,850,5093,16,50,7,9
10820,15,26279,11,1936,1085,851,9,15,5,4
15567,10,7855,9,177,94,83,2,30,1,1
21111,580,6048,392,70,70,0,1,5,1,0
16021,2071,28834,1596,1716,1716,0,27,1598,27,0
14584,10,17049,9,195,102,93,2,30,1,1
8336,10,28975,9,184,94,90,2,30,1,1
19928,26,27652,16,169315,5255,164060,190,77,66,124
3547,26,7480,16,696,152,544,11,48,3,8
3112,10,13044,9,196,88,108,2,30,1,1
14024,10,7223,9,761,100,661,2,31,1,1
10981,26,24727,16,6633,3485,3148,34,197,19,15
2744,1237,18316,917,882,126,756,2,30,1,1
21499,10,26798,9,213,102,111,2,30,1,1
21816,26,5679,16,8573,2039,6534,25,32,14,11
15078,10,23976,9,164,86,78,2,30,1,1
16021,1728,16986,1319,481,150,331,2,1199,1,1
890,15,15266,11,908,842,66,7,18,6,1
22379,10,26720,9,299,103,196,4,53,2,2
4012,26,28981,16,1833,991,842,14,224,7,7
9833,15,4297,11,54757,28216,26541,229,175,114,115
2744,89,22985,69,855,126,729,2,30,1,1
13907,10,22911,9,183,94,89,2,29,1,1
14149,10,8889,9,174,89,85,2,31,1,1
6219,26,14217,16,7870,2945,4925,19,136,9,10
14460,26,24811,16,9374,2150,7224,42,255,19,23
10356,15,11882,11,2339,1680,659,11,17,6,5
1587,10,5716,9,213,87,126,2,31,1,1
12011,404,12760,262,70,70,0,1,5,1,0
9712,26,15184,16,5877,1792,4085,21,81,12,9
6250,2010,22940,1540,156,94,62,2,30,1,1
17160,26,26031,16,5594,3484,2110,16,15,8,8
22045,10,21626,9,754,94,660,2,30,1,1
8474,10,27275,9,210,102,108,2,29,1,1
5921,26,20120,16,7595,1115,6480,18,35,10,8
4212,10,15476,9,220,100,120,2,30,1,1
22053,10,17896,9,179,94,85,2,30,1,1
15375,26,9118,16,79399,4048,75351,90,120,32,58
8698,10,11957,9,730,102,628,2,31,1,1
11019,15,17861,11,4166,1708,2458,14,16,7,7
14536,10,20749,9,184,94,90,2,29,1,1
10088,10,27214,9,94,94,0,1,30,1,0
15374,1,21273,1,316,136,180,6,6,3,3
15299,26,3322,16,14956,2081,12875,30,20,16,14
21980,10,10205,9,757,98,659,2,30,1,1
2744,1239,13412,919,884,126,758,2,30,1,1
22551,10,12014,9,193,102,91,2,30,1,1
13757,10,15783,9,314,94,220,4,33,2,2
14079,10,18495,9,177,94,83,2,30,1,1
12619,1136,10986,837,70,70,0,2,8,2,0
12584,26,20386,16,499,425,74,4,0,3,1
10110,26,8538,16,5553,1179,4374,24,80,13,11
16116,26,25448,16,2506,1461,1045,21,88,10,11
2744,1239,7076,919,914,126,788,2,31,1,1
21638,10,9116,9,244,94,150,2,30,1,1
8409,26,10912,16,4528,803,3725,14,15,8,6
9330,10,9651,9,758,96,662,2,31,1,1
304,10,843,9,200,90,110,2,30,1,1
5163,26,27189,16,410,210,200,7,86,4,3
8884,10,22091,9,184,94,90,2,30,1,1
12329,15,2979,11,3307,937,2370,17,16,10,7
17039,26,18778,16,22751,17995,4756,67,73,42,25
22379,10,28953,9,183,94,89,2,30,1,1
22253,26,13491,16,4446,2496,1950,9,120,5,4
15518,10,11396,9,176,90,86,2,31,1,1
14990,10,14265,9,184,94,90,2,31,1,1
5548,26,28519,16,6812,2910,3902,31,282,8,23
18531,3054,28162,2371,70,70,0,1,5,1,0
10009,26,5449,16,7984,2447,5537,41,2904,24,17
15627,10,28906,9,194,102,92,2,31,1,1
12556,26,6515,16,70,70,0,1,5,1,0
12566,1187,13221,876,70,70,0,1,5,1,0
15209,15,10013,11,234,234,0,4,12,4,0
2744,1238,25896,918,881,126,755,2,30,1,1
3740,26,26562,16,6378,1571,4807,23,315,12,11
3647,26,3260,16,130,70,60,2,15,1,1
11346,26,23459,16,134,60,74,3,6,2,1
10866,1878,25562,1434,70,70,0,1,4,1,0
5455,26,23713,16,4439,862,3577,16,160,9,7
9789,10,11714,9,177,94,83,2,30,1,1
12561,26,2248,16,70,70,0,1,4,1,0
13110,295,23875,190,4007,1690,2317,15,0,8,7
14166,10,599,9,199,102,97,2,31,1,1
3706,26,26389,16,9415,3998,5417,23,301,11,12
21861,10,1420,9,762,98,664,2,30,1,1
17188,26,9990,16,7329,949,6380,17,35,7,10
12470,1640,18102,1260,70,70,0,2,7,2,0
15287,10,25320,9,170,87,83,2,31,1,1
18802,26,17599,16,12106,2192,9914,38,38,19,19
14588,18,2956,13,184,94,90,2,30,1,1
0,0,0,0,320,320,0,5,0,5,0
8580,10,19262,9,561,112,449,4,53,2,2
14824,10,6383,9,199,94,105,2,30,1,1
15214,15,10043,11,234,234,0,4,12,4,0
22684,10,27720,9,209,110,99,2,31,1,1
8769,10,12528,9,199,102,97,2,30,1,1
12600,2296,14766,1780,70,70,0,2,7,2,0
21781,10,24580,9,755,94,661,2,31,1,1
6009,26,21563,16,24256,1841,22415,41,131,18,23
8451,280,28278,177,411,225,186,6,16,3,3
22379,10,21215,9,193,102,91,2,31,1,1
15358,10,13580,9,751,95,656,2,31,1,1
9582,10,3440,9,199,102,97,2,29,1,1
9598,15,21985,11,450,246,204,8,33,5,3
21593,10,28593,9,237,91,146,2,33,1,1
19772,10,4151,9,301,102,199,2,30,1,1
15091,10,24124,9,215,102,113,2,30,1,1
14258,2198,9914,1702,70,70,0,2,8,2,0
9495,15,12127,11,1083,653,430,8,15,5,3
4817,26,28225,16,9227,2999,6228,64,616,35,29
22000,10,8700,9,269,110,159,2,30,1,1
9078,10,13208,9,215,86,129,2,30,1,1
8702,10,1819,9,239,94,145,2,30,1,1
14068,10,12179,9,192,98,94,2,30,1,1
15186,10,19593,9,177,94,83,2,30,1,1
8799,10,405,9,245,94,151,2,29,1,1
12907,26,20047,16,4982,2205,2777,46,61,24,22
21586,10,11872,9,166,85,81,2,31,1,1
9004,10,21241,9,277,102,175,2,30,1,1
14081,26,26572,16,1455177,56285,1398892,1600,31,632,968
21985,10,9969,9,200,94,106,2,30,1,1
15756,10,9251,9,754,94,660,2,31,1,1
9455,15,24628,11,7979,802,7177,17,57,8,9
11669,26,13331,16,27467,22472,4995,85,42,45,40
11567,26,17421,16,3523,518,3005,12,15,6,6
1396,10,4801,9,213,79,134,2,32,1,1
4703,26,23813,16,471102,14016,457086,503,25,191,312
9153,10,18295,9,677,217,460,6,74,3,3
6235,26,18309,16,4398,1491,2907,19,26,11,8
14598,10,3055,9,183,94,89,2,30,1,1
7508,15,25122,11,1967,1133,834,12,45,7,5
9223,15,6655,11,186,64,122,4,25,2,2
15344,26,10637,16,7941,1952,5989,20,15,11,9
2724,1240,8892,920,422,164,258,6,30,3,3
9429,26,677,16,49752,4187,45565,87,100,45,42
3497,26,2443,16,247438,52606,194832,305,237,124,181
14457,10,15888,9,195,102,93,2,29,1,1
8518,10,4965,9,164,84,80,2,30,1,1
22454,10,5750,9,213,102,111,2,30,1,1
14316,10,14049,9,182,93,89,2,30,1,1
14849,15,22023,11,72600,58760,13840,186,1232,107,79
4655,26,5848,16,499,425,74,4,0,3,1
18810,26,12533,16,3282,1018,2264,10,121,5,5
21106,2269,24236,1756,66,66,0,1,5,1,0
18767,10,10189,9,198,93,105,2,30,1,1
8483,10,27340,9,184,94,90,2,30,1,1
9542,15,20830,11,318,192,126,6,26,4,2
18867,10,27021,9,298,114,184,2,30,1,1
6819,26,22304,16,232,172,60,3,5,2,1
17280,26,17581,16,10624,6845,3779,50,123,25,25
7555,26,16533,16,10768,1726,9042,35,199,17,18
8598,10,25161,9,170,87,83,2,31,1,1
3302,26,7974,16,1527,940,587,14,90,8,6
9238,26,947,16,32829,8718,24111,41,17,18,23
9655,15,5922,11,318,192,126,6,25,4,2
9744,10,22066,9,257,101,156,2,34,1,1
10682,26,23317,16,30116,4336,25780,44,123,18,26
9471,26,16518,16,552885,34781,518104,733,245,314,419
12172,26,9951,16,9121,2486,6635,22,45,13,9
8595,10,7957,9,210,110,100,2,30,1,1
15690,10,26388,9,186,95,91,2,31,1,1
15193,26,13171,16,3096,1882,1214,19,16,10,9
14099,10,2475,9,194,102,92,2,30,1,1
21377,10,23895,9,619,102,517,4,43,2,2
7205,26,23901,16,16362,3716,12646,79,601,38,41
15873,26,13082,16,5613,733,4880,16,15,9,7
15137,10,15772,9,167,86,81,2,30,1,1
12021,2213,13392,1714,698,320,378,10,16,6,4
1015,26,4150,16,4106,703,3403,15,26,8,7
2744,87,9312,67,868,126,742,2,30,1,1
15280,26,28311,16,8007,1987,6020,20,15,11,9
14499,10,14342,9,166,86,80,2,31,1,1
4982,15,7403,11,2008,810,1198,20,394,7,13
8144,26,12175,16,4160,2675,1485,25,95,14,11
5938,26,22549,16,350,210,140,6,30,4,2
17175,26,4131,16,5168,700,4468,16,15,7,9
6732,26,7434,16,5733,1543,4190,24,28,13,11
18222,26,18468,16,10407,3966,6441,30,149,18,12
22613,26,23005,16,2494,1643,851,17,23,9,8
10845,15,5876,11,3910,2158,1752,15,32,10,5
12703,26,28531,16,13492,3615,9877,42,120,20,22
4835,3185,20727,2471,10717,6715,4002,121,4588,71,50
8374,26,15249,16,9852,2190,7662,49,257,22,27
12559,26,21048,16,70,70,0,2,8,2,0
17071,26,17904,16,4726,2487,2239,19,305,9,10
9247,10,24806,9,718,94,624,2,30,1,1
11268,2496,2538,1942,70,70,0,2,4,2,0
14434,10,24611,9,235,90,145,2,32,1,1
14450,10,22326,9,177,94,83,2,30,1,1
6417,26,14313,16,3379,2111,1268,19,15,10,9
22444,10,14114,9,174,89,85,2,31,1,1
13686,26,19012,16,12704,3182,9522,35,49,16,19
18966,26,18782,16,10208,5093,5115,46,15,27,19
2355,10,20706,9,344,78,266,2,30,1,1
9411,1875,9151,1431,132,132,0,3,1200,3,0
8601,10,28904,9,608,199,409,6,69,3,3
8041,26,5177,16,7417,1760,5657,21,256,12,9
21258,10,15155,9,214,110,104,2,30,1,1
22387,10,5340,9,166,86,80,2,30,1,1
14192,10,24746,9,188,96,92,2,31,1,1
9122,15,4834,11,11173,821,10352,19,15,9,10
18809,923,12839,681,70,70,0,2,8,2,0
22596,10,21922,9,560,104,456,4,43,2,2
8536,10,24088,9,183,94,89,2,30,1,1
13741,10,14917,9,177,94,83,2,30,1,1
22575,10,19910,9,735,88,647,2,31,1,1
8493,10,13313,9,193,102,91,2,31,1,1
12855,26,8621,16,121935,7839,114096,175,255,82,93
21744,26,27531,16,18370,2434,15936,26,120,11,15
14611,26,8336,16,53826,3670,50156,85,275,41,44
21768,10,11886,9,188,96,92,2,31,1,1
21556,10,28602,9,166,86,80,2,30,1,1
21866,10,20149,9,199,102,97,2,30,1,1
4828,15,14344,11,1616,1302,314,10,15,5,5
636,2474,5117,1924,228,118,110,2,1199,1,1
7617,183,20319,121,3457,1568,1889,17,21,10,7
7115,26,24244,16,7221,3151,4070,20,162,9,11
14379,10,2598,9,200,102,98,2,30,1,1
14843,10,1176,9,498,204,294,6,30,3,3
12062,1142,17487,842,70,70,0,1,5,1,0
21403,10,11078,9,193,102,91,2,30,1,1
13841,26,10437,16,3543,1855,1688,20,122,10,10
14909,10,357,9,177,94,83,2,29,1,1
3910,10,17504,9,214830,214584,246,2594,88,2591,3
14168,10,745,9,168,86,82,2,30,1,1
7336,26,5203,16,4715,1935,2780,24,183,11,13
4261,26,18696,16,3871,2466,1405,22,95,12,10
15174,15,14060,11,234,234,0,4,12,4,0
11262,1757,5369,1342,70,70,0,1,5,1,0
18887,26,17341,16,11586,5435,6151,46,46,25,21
21843,10,19891,9,616,188,428,6,35,3,3
6568,15,10333,11,811,671,140,6,31,4,2
14311,890,28442,658,320,140,180,6,7,3,3
8948,26,23457,16,70,70,0,2,7,2,0
14670,10,9820,9,193,102,91,2,30,1,1
22211,10,15119,9,184,102,82,2,30,1,1
15338,26,4335,16,8058,2038,6020,20,15,11,9
18084,26,11308,16,296863,14073,282790,351,127,130,221
2871,26,28464,16,5515,1388,4127,18,15,9,9
8856,10,10078,9,216,110,106,2,30,1,1
15666,10,5277,9,278,102,176,2,31,1,1
9630,15,18846,11,378,192,186,7,21,4,3
15236,10,3602,9,297,102,195,4,34,2,2
8196,15,21167,11,560,264,296,9,44,5,4
21789,10,28326,9,198,102,96,2,30,1,1
11017,26,24353,16,134,60,74,3,5,2,1
15229,10,24146,9,102,102,0,2,31,2,0
7199,15,16216,11,350,210,140,6,28,4,2
8816,10,21465,9,776,102,674,2,31,1,1
3248,10,13886,9,231,90,141,2,31,1,1
636,1150,12958,848,498,150,348,4,1273,2,2
10022,15,5089,11,290951,15209,275742,327,141,132,195
4774,10,886,9,199,94,105,2,30,1,1
22038,10,10464,9,166,86,80,2,30,1,1
14827,15,24821,11,44951,1019,43932,48,15,15,33
22642,10,2862,9,178,94,84,2,31,1,1
15876,10,9382,9,176,90,86,2,30,1,1
15739,26,23948,16,1610,771,839,22,120,11,11
13990,10,20015,9,216,110,106,2,30,1,1
15274,26,8068,16,8006,1986,6020,20,15,11,9
8584,1275,16038,955,263,78,185,2,30,1,1
16762,26,25391,16,24040,4851,19189,86,160,41,45
20108,26,12557,16,10391,7059,3332,27,27,15,12
6450,188,25003,123,452,280,172,5,30,3,2
9357,10,17799,9,189,102,87,2,30,1,1
9570,26,3936,16,5713,1079,4634,15,26,8,7
21471,10,10512,9,277,94,183,2,30,1,1
5028,26,402,16,33980,7386,26594,51,121,22,29
15000,10,2012,9,350,94,256,2,30,1,1
10700,26,27958,16,1203,703,500,14,42,8,6
15702,10,22543,9,166,86,80,2,30,1,1
15513,10,8519,9,316,97,219,4,33,2,2
18940,26,27063,16,4680,1773,2907,19,29,11,8
14468,10,1004,9,387,134,253,2,30,1,1
14211,667,11915,468,70,70,0,1,5,1,0
7146,26,8148,16,56118,3429,52689,77,26,35,42
14132,10,9725,9,184,102,82,2,29,1,1
10783,295,22642,190,3638,2087,1551,17,15,10,7
15631,10,12083,9,1780,674,1106,18,68,9,9
8383,10,10773,9,178,91,87,2,31,1,1
8441,10,22449,9,197,102,95,2,29,1,1
15869,10,25324,9,208,94,114,2,30,1,1
5433,26,22082,16,482030,16677,465353,539,28,207,332
2388,10,24547,9,177,94,83,2,29,1,1
11839,26,10636,16,4596,1029,3567,15,26,9,6
13644,26,21387,16,20961,10306,10655,49,48,25,24
8978,10,23353,9,775,102,673,2,30,1,1
10656,26,19117,16,4320,932,3388,16,15,10,6
14499,26,19346,16,3954,778,3176,17,121,8,9
13214,26,24137,16,2782,1778,1004,20,33,10,10
8670,26,9293,16,62,62,0,1,5,1,0
13729,10,19735,9,182,93,89,2,31,1,1
22283,10,13219,9,293,94,199,2,29,1,1
21974,10,11974,9,199,94,105,2,33,1,1
18207,26,12761,16,6351,1857,4494,20,16,11,9
22017,10,708,9,338,110,228,2,30,1,1
11045,1159,17076,855,70,70,0,1,5,1,0
6978,26,11700,16,4173582,66515,4107067,3494,129,510,2984
22170,10,18198,9,197,102,95,2,31,1,1
10192,15,5535,11,525373,237667,287706,1387,390,693,694
6223,10,19916,9,209,86,123,2,30,1,1
14604,10,13086,9,716,95,621,2,30,1,1
13833,10,19901,9,172,94,78,2,29,1,1
15233,26,5202,16,1560,988,572,13,23,7,6
15397,10,12022,9,184,94,90,2,30,1,1
22337,10,17083,9,168,86,82,2,31,1,1
12567,10,26609,9,172,72,100,2,30,1,1
17439,26,24998,16,4489,2046,2443,23,121,11,12
7210,10,10847,9,198,93,105,2,31,1,1
14938,10,20544,9,196,102,94,2,30,1,1
12286,10,23430,9,197,76,121,2,31,1,1
8814,15,10643,11,318,192,126,6,41,4,2
10982,2603,15805,2020,70,70,0,2,7,2,0
8534,10,2617,9,548,112,436,4,36,2,2
327,7,940,7,66,66,0,1,5,1,0
4249,26,17674,16,3554,2208,1346,18,256,10,8
8877,26,5053,16,18088,1844,16244,34,130,14,20
8877,15,18343,11,2269,821,1448,15,51,8,7
13724,10,8919,9,195,102,93,2,30,1,1
22179,10,3472,9,184,94,90,2,29,1,1
16021,2577,15325,1999,490,149,341,2,1201,1,1
14772,10,24463,9,762,98,664,2,0,1,1
13928,26,5084,16,2895,726,2169,10,121,5,5
18575,26,19009,16,9047,2015,7032,25,39,13,12
13389,18,11305,13,184,94,90,2,31,1,1
22046,26,23531,16,2442,356,2086,12,120,5,7
9997,10,22207,9,242,98,144,2,30,1,1
4551,26,1865,16,6840,1556,5284,32,26,17,15
5955,26,17905,16,4565,1658,2907,19,29,11,8
15693,10,4168,9,778,103,675,2,31,1,1
16501,10,25701,9,231,88,143,2,32,1,1
6402,26,17384,16,20255,5440,14815,32,122,16,16
18233,26,13688,16,7741,2692,5049,24,16,13,11
14909,10,14790,9,177,94,83,2,30,1,1
8210,2525,21194,1961,513,152,361,2,1200,1,1
22267,10,15230,9,168,86,82,2,30,1,1
16811,26,10930,16,12060,3749,8311,42,17,23,19
6529,15,24307,11,3605,1700,1905,16,186,9,7
9654,15,1976,11,378,192,186,7,25,4,3
9186,10,27009,9,174,89,85,2,31,1,1
8008,26,843,16,214,140,74,4,15,3,1
22345,10,28683,9,198,101,97,2,30,1,1
16824,10,15916,9,307,86,221,2,29,1,1
14761,10,23205,9,198,102,96,2,31,1,1
2744,1867,2195,1425,880,126,754,2,31,1,1
1909,2577,19737,1999,491,150,341,2,1200,1,1
9728,280,12624,177,502,150,352,2,1200,1,1
22107,10,90,9,550,113,437,4,46,2,2
10007,26,17897,16,1786,172,1614,7,121,3,4
14248,10,27730,9,178,94,84,2,30,1,1
22557,10,18561,9,196,102,94,2,31,1,1
9728,3123,11421,2425,166,166,0,1,1200,1,0
22474,10,17594,9,199,102,97,2,30,1,1
14205,10,871,9,699,204,495,6,57,3,3
14789,10,4640,9,79,79,0,2,33,2,0
531,10,1969,9,288,83,205,2,31,1,1
1404,26,4835,16,12020,5977,6043,38,30,23,15
12636,26,26121,16,499,425,74,4,0,3,1
8904,10,754,9,215,102,113,2,30,1,1
12127,26,27247,16,13597,1371,12226,26,323,11,15
18140,26,871,16,1573,769,804,16,47,9,7
13696,26,19683,16,126,60,66,3,5,2,1
16021,2877,10598,2235,1359,726,633,6,1199,3,3
10551,26,27895,16,10861,5281,5580,65,49,33,32
1948,10,7476,9,825,99,726,2,30,1,1
21340,10,12578,9,270,94,176,2,30,1,1
2017,10,7882,9,398,255,143,3,33,2,1
21252,10,12110,9,325,94,231,2,30,1,1
22096,10,21276,9,184,94,90,2,30,1,1
18439,26,9105,16,9379,2092,7287,21,126,9,12
9723,15,20545,11,1827,989,838,13,78,7,6
15833,26,19099,16,14236,2699,11537,51,31,27,24
12606,191,28758,126,70,70,0,2,8,2,0
14208,2348,28018,1831,70,70,0,1,5,1,0
15900,10,10929,9,178,91,87,2,31,1,1
22257,10,13962,9,194,102,92,2,30,1,1
7994,26,21075,16,12648,5285,7363,58,32,27,31
15908,10,21130,9,184,94,90,2,29,1,1
3588,26,5967,16,6919,2112,4807,19,15,10,9
22568,10,12586,9,193,102,91,2,30,1,1
22392,1384,17033,1053,266,78,188,2,30,1,1
15191,10,13526,9,183,94,89,2,30,1,1
13703,26,1523,16,1600,1089,511,13,151,7,6
22230,10,12370,9,195,102,93,2,31,1,1
7225,15,19738,11,52365,3013,49352,53,51,13,40
22185,1271,19689,951,3142,1386,1756,8,31,4,4
18811,26,6012,16,69973,4662,65311,108,135,43,65
19840,26,28840,16,21219,1329,19890,32,122,13,19
15853,10,19827,9,200,102,98,2,30,1,1
9116,10,28970,9,195,102,93,2,31,1,1
18282,15,4339,11,3596,2562,1034,14,151,8,6
12262,26,21062,16,5196,2308,2888,34,137,16,18
10971,893,26240,661,70,70,0,1,5,1,0
9667,10,13375,9,199,102,97,2,30,1,1
14930,10,9120,9,216,110,106,2,30,1,1
22687,10,17229,9,209,110,99,2,30,1,1
7828,26,20827,16,7464,2375,5089,15,120,7,8
8595,10,12465,9,188,96,92,2,31,1,1
14283,3186,9816,2472,70,70,0,2,8,2,0
6782,26,16998,16,11774,5465,6309,75,585,38,37
4085,15,3347,11,1970,977,993,12,61,7,5
21818,26,25417,16,9156,2109,7047,27,32,15,12
22391,10,14921,9,213,102,111,2,30,1,1
4668,15,16803,11,3587,2484,1103,19,135,10,9
9574,15,12694,11,318,192,126,6,26,4,2
10547,26,4031,16,350,210,140,6,14,4,2
14816,10,16863,9,194,102,92,2,30,1,1
15889,10,26175,9,184,102,82,2,30,1,1
11004,26,20356,16,17456,7877,9579,47,49,24,23
14401,10,11028,9,701,88,613,2,30,1,1
6803,26,9958,16,8049289,98432,7950857,6501,125,717,5784
3612,26,6479,16,7280,4154,3126,30,735,16,14
5014,10,16559,9,233,91,142,2,31,1,1
887,15,11137,11,318,192,126,6,30,4,2
11889,15,22754,11,3111,1364,1747,28,112,15,13
20405,26,2068,16,8426,2893,5533,27,16,15,12
12795,2090,18885,1611,492,306,186,8,17,5,3
12688,2196,14143,1700,552,306,246,9,15,5,4
14330,15,12310,11,70,70,0,1,5,1,0
14298,1514,11632,1153,70,70,0,1,5,1,0
9498,26,16249,16,71226,18632,52594,137,318,63,74
16360,10,25620,9,216,90,126,2,29,1,1
22671,10,21876,9,179,94,85,2,30,1,1
13251,15,15706,11,1384,937,447,9,360,5,4
17918,10,27335,9,168,78,90,2,30,1,1
10928,2589,4478,2008,70,70,0,2,8,2,0
12008,26,28134,16,21933,11660,10273,206,188,114,92
11834,26,512,16,114867,4243,110624,128,120,44,84
18425,26,7467,16,130,70,60,2,15,1,1
5467,26,28370,16,10921,3102,7819,25,217,13,12
21397,10,12614,9,214,110,104,2,30,1,1
19920,26,27644,16,211574,21152,190422,236,96,92,144
2645,15,11098,11,490,264,226,8,32,5,3
12645,1702,13258,1300,70,70,0,2,7,2,0
21414,10,21067,9,184,94,90,2,30,1,1
18558,2916,9513,2264,504,318,186,8,15,5,3
11180,1870,16912,1428,70,70,0,2,7,2,0
15975,26,913,16,9224,2381,6843,29,19,14,15
22633,26,3191,16,3783,1087,2696,11,120,5,6
22458,10,4955,9,184,94,90,2,30,1,1
9591,10,11417,9,765,102,663,2,30,1,1
11814,26,26237,16,3478,1580,1898,21,31,12,9
12198,2907,28019,2256,672,432,240,10,142,6,4
8907,15,11928,11,1149,412,737,8,17,5,3
21279,651,14999,455,66,66,0,2,7,2,0
2744,1447,5352,1100,876,126,750,2,31,1,1
22180,10,4437,9,87,87,0,1,31,1,0
10804,774,19801,561,70,70,0,2,8,2,0
1451,15,5079,11,6215,769,5446,14,16,7,7
9571,15,18915,11,312,192,120,6,27,4,2
10943,2672,25704,2078,66,66,0,1,5,1,0
3365,26,8710,16,8138,2101,6037,17,121,9,8
9311,10,19733,9,758,96,662,2,30,1,1
636,769,13644,556,509,150,359,2,1200,1,1
12126,26,23338,16,1210,637,573,14,34,7,7
21815,10,24532,9,210,110,100,2,30,1,1
17972,26,17348,16,5301,953,4348,17,28,9,8
8086,26,19778,16,8400,2088,6312,33,20,18,15
14235,819,12627,599,504,318,186,8,16,5,3
4739,26,17038,16,8493,2314,6179,33,15,18,15
14370,10,20766,9,165,86,79,2,30,1,1
3560,26,6337,16,8171028,105740,8065288,6637,149,745,5892
13631,15,9305,11,4259,1114,3145,12,18,8,4
4962,6,16490,6,9022,3349,5673,57,43,26,31
12070,26,8085,16,2309,1443,866,16,17,8,8
8342,153,13050,108,70,70,0,2,8,2,0
17156,26,15561,16,6350667,198580,6152087,6885,451,2497,4388
4835,1306,6940,984,150,150,0,1,1199,1,0
21327,10,11530,9,430,172,258,6,59,3,3
8210,2427,21194,1888,1837,852,985,8,1200,4,4
22158,10,1936,9,452,118,334,2,30,1,1
11006,525,27178,348,70,70,0,2,8,2,0
14963,10,2137,9,195,102,93,2,31,1,1
22561,10,8777,9,193,102,91,2,30,1,1
8390,15,23876,11,1793,1030,763,11,15,6,5
5621,26,18611,16,7407,2516,4891,37,32,19,18
18352,15,26570,11,10135,7433,2702,28,164,19,9
1362,2091,17255,1612,70,70,0,1,5,1,0
8584,1241,10953,921,71,71,0,1,31,1,0
2744,1457,11243,1110,887,126,761,2,31,1,1
13493,10,5906,9,206,86,120,2,30,1,1
14302,10,6000,9,744,89,655,2,31,1,1
16021,650,25071,454,1035,253,782,4,1200,2,2
3693,10,14674,9,241,98,143,2,30,1,1
14112,15,2912,11,498,280,218,8,26,5,3
22344,10,25733,9,754,94,660,2,31,1,1
8855,10,26692,9,812,110,702,2,30,1,1
9942,15,24103,11,3874,684,3190,11,141,6,5
6468,15,18378,11,1506,1446,60,2,5,1,1
11033,15,3846,11,88807,5957,82850,113,15,54,59
4652,26,447,16,499,425,74,4,0,3,1
11238,2407,28230,1872,70,70,0,1,5,1,0
22383,10,1139,9,165,86,79,2,29,1,1
5470,26,11161,16,6128,1344,4784,19,87,12,7
8738,26,18642,16,1820,1101,719,18,18,10,8
14185,10,17043,9,188,96,92,2,31,1,1
5917,10,8000,9,168,78,90,2,30,1,1
5606,1984,10366,1514,148,86,62,2,30,1,1
22229,10,16214,9,152,78,74,2,30,1,1
6431,15,26871,11,78,78,0,1,4,1,0
15155,10,14621,9,711,87,624,2,30,1,1
22715,10,7257,9,199,102,97,2,29,1,1
1571,10,5654,9,215,98,117,2,30,1,1
15728,10,17728,9,170,87,83,2,30,1,1
9215,10,29093,9,775,103,672,2,31,1,1
22258,10,6717,9,210,110,100,2,30,1,1
14088,10,17406,9,816,102,714,2,29,1,1
17265,15,17147,11,1431,783,648,10,75,6,4
10972,1025,12004,755,140,70,70,2,5,1,1
13050,26,18656,16,499,425,74,4,0,3,1
5055,234,23075,149,3534,1679,1855,30,3640,11,19
6471,26,13494,16,6792,3009,3783,20,46,12,8
18787,1989,7040,1519,316,136,180,6,6,3,3
5316,26,10106,16,7134,1963,5171,22,284,11,11
13646,10,23264,9,195,102,93,2,29,1,1
10332,15,5777,11,579418,15579,563839,599,76,219,380
14819,15,24813,11,44881,949,43932,47,15,14,33
14567,10,7065,9,177,94,83,2,30,1,1
10951,1877,26493,1433,70,70,0,2,8,2,0
15972,10,23616,9,193,102,91,2,30,1,1
14267,10,17143,9,292,102,190,2,29,1,1
14063,10,3077,9,181,98,83,2,30,1,1
9450,26,4726,16,3325,1851,1474,19,16,9,10
3367,15,5775,11,7406,1038,6368,18,15,10,8
2744,1238,24594,918,873,126,747,3,31,2,1
21542,10,24448,9,229,110,119,2,30,1,1
9828,26,15705,16,6909,2495,4414,20,15,11,9
5714,26,19925,16,11101,4498,6603,35,430,20,15
9519,10,28863,9,211,110,101,2,30,1,1
2744,1238,16574,918,878,126,752,2,30,1,1
13720,26,6767,16,39091,9981,29110,93,208,42,51
15200,10,26407,9,186,95,91,2,31,1,1
8972,26,9981,16,2796,1730,1066,15,126,9,6
14602,10,25116,9,182,94,88,2,30,1,1
14936,10,18755,9,184,94,90,2,31,1,1
1086,26,27316,16,9340,5582,3758,36,38,21,15
22092,10,9806,9,173,94,79,2,30,1,1
14983,15,5612,11,17376,1687,15689,28,40,12,16
21904,10,5032,9,172,88,84,2,31,1,1
19549,26,26786,16,3168,1038,2130,16,136,8,8
4110,26,7690,16,8264,1910,6354,21,361,10,11
13883,10,5832,9,193,102,91,2,30,1,1
14763,10,16938,9,216,102,114,2,30,1,1
4729,233,18781,148,142,142,0,1,5,1,0
8583,10,5761,9,211,110,101,2,30,1,1
3977,26,15098,16,4700,1793,2907,19,27,11,8
8561,10,6825,9,315,90,225,4,32,2,2
8634,26,22609,16,6940,1302,5638,20,119,10,10
13918,10,22723,9,166,85,81,2,31,1,1
7391,15,4188,11,78,78,0,1,5,1,0
4715,26,10391,16,8134,2717,5417,24,16,15,9
21870,10,17294,9,177,94,83,2,30,1,1
2172,2627,13362,2037,459,149,310,2,1200,1,1
14165,15,166,11,3335,2314,1021,19,38,11,8
15364,26,8983,16,257154,11550,245604,303,54,121,182
8620,10,24891,9,762,97,665,2,31,1,1
8014,18,10405,13,184,94,90,2,30,1,1
17920,26,20175,16,2334,1113,1221,19,27,9,10
2559,1392,10577,1059,1806,1806,0,22,225,22,0
6094,26,414,16,11804,4009,7795,41,150,21,20
9529,15,23404,11,28942,2526,26416,39,25,16,23
18904,26,22419,16,7426,1877,5549,22,81,13,9
9597,15,21984,11,450,246,204,8,30,5,3
14683,10,26890,9,711,87,624,2,30,1,1
8729,10,11810,9,200,102,98,2,31,1,1
18545,26,26272,16,3089,866,2223,11,121,6,5
8688,26,5064,16,3090,1796,1294,19,26,10,9
636,405,4078,263,502,150,352,2,1199,1,1
22002,10,17580,9,193,102,91,2,31,1,1
13776,10,21552,9,253,87,166,4,44,2,2
15359,26,13989,16,7957,1968,5989,20,15,11,9
21410,10,9911,9,196,102,94,2,30,1,1
12672,2871,6357,2230,70,70,0,2,8,2,0
9071,26,26480,16,5895,728,5167,16,47,8,8
16119,26,25451,16,2504,1458,1046,21,87,10,11
178,10,7758,9,210,78,132,2,29,1,1
10958,15,3456,11,1357,963,394,10,26,7,3
9053,10,1515,9,338,110,228,2,30,1,1
15100,10,11985,9,170,87,83,2,30,1,1
3296,26,15589,16,2299332,50663,2248669,2117,141,553,1564
14607,10,7557,9,177,94,83,2,29,1,1
14363,10,7033,9,772,100,672,2,30,1,1
9351,10,5726,9,758,102,656,2,30,1,1
8504,26,20682,16,5483,2770,2713,30,361,15,15
17813,26,2925,16,16524,4274,12250,35,133,15,20
8712,10,12881,9,193,102,91,2,30,1,1
14382,10,25397,9,779,86,693,2,30,1,1
7740,26,15910,16,11342,3715,7627,28,92,17,11
9712,26,28237,16,15702,3473,12229,50,70,23,27
8536,10,14713,9,324,86,238,4,47,2,2
22144,10,3343,9,230,102,128,2,30,1,1
8377,1681,2293,1286,70,70,0,1,5,1,0
6976,26,23945,16,10087,4073,6014,33,88,18,15
15327,15,15329,11,1462,703,759,8,16,5,3
12556,280,13746,177,70,70,0,1,4,1,0
17036,10,26014,9,235,90,145,2,32,1,1
21635,10,18902,9,179,94,85,2,30,1,1
15970,10,14118,9,214,102,112,2,29,1,1
18194,26,13775,16,9091,2988,6103,47,19,22,25
15315,15,15164,11,1462,703,759,8,17,5,3
225,10,18310,9,204,118,86,2,31,1,1
15021,10,23524,9,167,86,81,2,30,1,1
17202,26,24251,16,8119,5152,2967,29,18,14,15
6749,233,14146,148,3721,1173,2548,18,257,11,7
14581,10,15430,9,193,102,91,2,29,1,1
13088,26,12749,16,9986,2440,7546,17,120,8,9
7892,15,20731,11,9621,1618,8003,19,20,10,9
3530,26,1202,16,2378,1126,1252,14,979,7,7
9303,10,21833,9,198,90,108,2,29,1,1
12515,1446,24176,1099,612,426,186,10,22,7,3
9445,10,13309,9,770,102,668,2,30,1,1
13665,26,18718,16,134,60,74,3,10,2,1
10512,26,2574,16,7674,2829,4845,23,31,14,9
9577,10,12715,9,193,102,91,2,30,1,1
1189,26,16637,16,11412,1763,9649,27,110,13,14
8669,10,3441,9,167,86,81,2,30,1,1
7476,15,28082,11,1053,613,440,10,15,5,5
21233,10,8492,9,426,89,337,4,49,2,2
9996,10,5833,9,199,94,105,2,30,1,1
8840,10,3585,9,211,102,109,2,29,1,1
9214,10,8120,9,738,86,652,2,30,1,1
21407,10,3523,9,174,89,85,2,30,1,1
593,10,2324,9,217,87,130,2,30,1,1
16366,26,1907,16,6845,1743,5102,22,81,13,9
15490,10,11847,9,194,102,92,2,31,1,1
14737,10,13409,9,748,106,642,2,31,1,1
22436,10,1108,9,225,94,131,2,30,1,1
22547,10,2217,9,168,86,82,2,31,1,1
14933,15,11637,11,1258,752,506,13,16,7,6
11461,26,22977,16,4400,1493,2907,19,31,11,8
13678,10,11975,9,168,86,82,2,30,1,1
13797,10,6979,9,285,102,183,2,30,1,1
6260,26,4720,16,416,210,206,7,27,4,3
12134,26,367,16,28206,2737,25469,45,323,18,27
15859,10,7708,9,770,102,668,2,31,1,1
14682,10,1568,9,182,94,88,2,30,1,1
3066,1975,2027,1507,501,150,351,2,1200,1,1
4827,26,10966,16,5463,1378,4085,16,145,10,6
15489,26,15809,16,13829,2472,11357,30,243,13,17
15931,10,19701,9,733,86,647,2,31,1,1
15161,26,21430,16,7157,2183,4974,22,16,12,10
13855,10,3708,9,98,98,0,1,30,1,0
10886,3152,19530,2442,136,136,0,3,13,3,0
14587,10,15885,9,186,95,91,2,31,1,1
8584,1238,21868,918,286,78,208,2,31,1,1
15912,26,20363,16,36265,3519,32746,55,46,27,28
8373,10,1063,9,448,184,264,6,30,3,3
15416,10,27589,9,177,94,83,2,30,1,1
8799,26,22473,16,4348,911,3437,14,135,8,6
9049,26,26592,16,37539,4310,33229,63,51,27,36
18321,15,14213,11,22768,6548,16220,31,149,14,17
21275,2341,24327,1825,66,66,0,2,8,2,0
11810,15,25482,11,3020,1414,1606,30,118,16,14
2119,10,8434,9,235,90,145,2,32,1,1
5522,15,5230,11,1658,1344,314,10,15,5,5
9067,10,29029,9,231,110,121,2,30,1,1
19801,26,6129,16,11903,6327,5576,48,15,27,21
21805,10,15785,9,268,110,158,2,31,1,1
4786,15,11323,11,2087,729,1358,10,15,5,5
8194,26,7656,16,6490,1145,5345,20,33,11,9
13876,10,29041,9,467,96,371,4,44,2,2
8380,10,8917,9,272,94,178,2,30,1,1
17557,15,26322,11,108790,4633,104157,192,15,66,126
14229,10,18103,9,815,95,720,2,30,1,1
17618,26,7624,16,252,70,182,3,120,1,2
12413,26,4014,16,12646,7169,5477,53,198,25,28
15449,10,20799,9,166,85,81,2,31,1,1
18671,26,17893,16,5663,1711,3952,22,17,13,9
16431,26,25404,16,6254,1581,4673,21,190,12,9
12284,26,22248,16,4383,2064,2319,11,120,6,5
225,10,9069,9,204,118,86,2,30,1,1
8848,26,16233,16,9766,1633,8133,27,172,13,14
8817,15,21169,11,1854,945,909,13,106,7,6
10451,26,20461,16,9584,1871,7713,28,106,14,14
8104,26,11890,16,6945,1551,5394,25,200,12,13
20307,26,11221,16,4911,3442,1469,29,322,16,13
22559,26,12710,16,5666,4417,1249,23,86,12,11
10374,15,27079,11,1114,534,580,12,16,7,5
12410,2990,25192,2324,70,70,0,2,8,2,0
22275,10,12161,9,86,86,0,1,30,1,0
21578,10,14107,9,376,126,250,2,30,1,1
18618,10,22216,9,343,86,257,2,30,1,1
14910,10,1343,9,178,94,84,2,30,1,1
13679,15,5182,11,1142,626,516,8,180,5,3
11606,15,13620,11,26073,2868,23205,41,110,17,24
8072,10,20987,9,398,255,143,3,33,2,1
14445,10,27059,9,819,102,717,2,30,1,1
8607,26,12123,16,2921276,89544,2831732,3090,63,1086,2004
5042,15,17225,11,1571,877,694,11,181,6,5
9203,26,20965,16,7924,1798,6126,26,15,14,12
16880,1392,2292,1059,1806,1806,0,22,224,22,0
15382,837,13847,616,70,70,0,1,5,1,0
13841,10,14634,9,969,86,883,2,29,1,1
10518,26,13038,16,6779,2365,4414,19,15,10,9
22551,10,12415,9,186,95,91,2,30,1,1
13682,26,25384,16,7196,2834,4362,28,17,16,12
4123,26,7667,16,7634,4417,3217,35,197,19,16
3999,26,16312,16,6584,1945,4639,14,120,7,7
11030,470,337,305,70,70,0,1,5,1,0
8377,10,4054,9,183,94,89,2,30,1,1
14794,10,21268,9,168,86,82,2,30,1,1
7276,15,11292,11,1579,1217,362,8,15,5,3
21240,10,11725,9,178,94,84,2,30,1,1
13006,26,18938,16,499,425,74,4,0,3,1
9639,10,10262,9,182,102,80,2,30,1,1
21014,907,12967,671,70,70,0,1,5,1,0
14296,15,518,11,70,70,0,2,8,2,0
6234,26,24677,16,6431,1665,4766,22,275,12,10
11087,1733,5507,1323,70,70,0,2,8,2,0
4994,10,14461,9,336,231,105,3,30,2,1
17850,26,27661,16,7236,827,6409,17,25,8,9
8923,15,9452,11,1396,864,532,9,15,5,4
7095,676,21169,475,130,70,60,2,6,1,1
13364,26,1050,16,311000,8576,302424,319,175,103,216
15652,26,26837,16,9905,4321,5584,27,315,13,14
9563,15,1614,11,350,350,0,1,120,1,0
6408,26,19133,16,130,70,60,3,5,2,1
15731,10,0,0,208,86,122,2,30,1,1
15570,10,13634,9,273,102,171,2,30,1,1
5089,676,20468,475,138,78,60,2,5,1,1
10923,15,26156,11,14289,7263,7026,27,27,14,13
8622,26,3348,16,10956,1757,9199,21,37,10,11
877,15,27560,11,8732,2438,6294,23,36,11,12
22241,10,3690,9,184,94,90,2,30,1,1
21060,3236,27407,2507,70,70,0,1,4,1,0
9408,26,21629,16,7608,2413,5195,19,120,9,10
22585,10,24040,9,230,94,136,2,30,1,1
6512,15,16791,11,139303,9065,130238,210,20,120,90
15825,26,1913,16,1617,1073,544,16,15,9,7
8510,10,196,9,209,110,99,2,30,1,1
6536,26,10440,16,7476,2192,5284,27,316,13,14
19439,10,27962,9,260,86,174,2,29,1,1
17090,26,11666,16,3558,2453,1105,17,15,9,8
7594,26,22995,16,350,210,140,6,25,4,2
12080,15,28179,11,1871,712,1159,10,15,5,5
3369,26,12485,16,7639,948,6691,25,395,9,16
21349,10,7837,9,209,110,99,2,30,1,1
15508,10,16008,9,174,89,85,2,31,1,1
21210,2466,4266,1917,66,66,0,2,7,2,0
10999,1866,8877,1424,70,70,0,2,8,2,0
15711,10,12375,9,612,114,498,4,52,2,2
18890,26,19812,16,12652,6172,6480,44,16,26,18
6598,26,5465,16,2895,726,2169,10,121,5,5
9433,10,11938,9,781,94,687,2,30,1,1
8672,26,11289,16,18260,2912,15348,30,28,11,19
8584,1239,11002,919,257,71,186,2,30,1,1
13736,10,24937,9,216,110,106,2,30,1,1
13828,10,24344,9,199,102,97,2,30,1,1
8775,15,10418,11,11534,719,10815,18,61,7,11
15768,10,8034,9,183,94,89,2,30,1,1
22706,26,25611,16,92117,4799,87318,107,15,43,64
8242,10,14892,9,164,78,86,2,31,1,1
15942,26,8302,16,8747,3323,5424,45,110,25,20
22399,10,24056,9,392,90,302,4,55,2,2
12951,26,17949,16,10109,1394,8715,22,75,13,9
9042,15,18408,11,2086,1214,872,8,88,5,3
6216,26,449,16,6610,1106,5504,23,361,12,11
7905,10,26069,9,164,78,86,2,29,1,1
11224,1041,20331,765,70,70,0,2,8,2,0
22128,10,14484,9,170,87,83,2,31,1,1
14521,10,23919,9,211,110,101,2,30,1,1
12147,10,28221,9,277,78,199,2,30,1,1
21230,26,20894,16,5844,2360,3484,25,127,12,13
4385,26,26129,16,178,118,60,2,15,1,1
14584,10,21580,9,711,87,624,2,30,1,1
5657,18,10657,13,184,94,90,2,30,1,1
22542,10,3962,9,275,110,165,2,30,1,1
11139,3085,19529,2397,156,66,90,2,5,1,1
15529,10,21731,9,183,94,89,2,30,1,1
15179,26,2000,16,7915,1926,5989,20,15,11,9
21068,2851,4190,2213,70,70,0,1,4,1,0
15903,26,14929,16,1547,960,587,14,22,8,6
21987,10,15044,9,211,102,109,2,30,1,1
14668,10,26877,9,168,94,74,2,30,1,1
6116,26,4165,16,7218,4166,3052,38,133,19,19
11241,2907,25618,2256,70,70,0,2,8,2,0
7300,26,19860,16,4430,1523,2907,19,27,11,8
14557,10,1612,9,94,94,0,1,30,1,0
4444,26,28768,16,9787,2382,7405,17,120,7,10
16470,15,14896,11,3877,2069,1808,15,26,9,6
16369,26,27075,16,10639,4680,5959,53,176,24,29
9497,15,29074,11,8007,830,7177,17,30,8,9
8396,10,16233,9,243,110,133,2,29,1,1
9319,15,26548,11,2181,849,1332,14,97,7,7
14822,15,24816,11,44955,1023,43932,48,15,15,33
4797,26,16294,16,1452,817,635,16,20,9,7
9612,15,21994,11,90393,7684,82709,132,22,69,63
21952,10,16987,9,178,94,84,2,30,1,1
8825,26,11812,16,11455,2804,8651,59,121,28,31
2655,15,11121,11,184480,11115,173365,239,30,116,123
7563,15,26046,11,1802,1488,314,11,16,6,5
16021,280,390,177,528,528,0,9,1200,9,0
12559,2519,26157,1958,70,70,0,2,8,2,0
15133,10,13448,9,212,108,104,2,31,1,1
11056,568,586,382,70,70,0,2,7,2,0
8686,10,24464,9,229,102,127,2,30,1,1
22643,10,13610,9,365,102,263,2,30,1,1
14151,10,20429,9,193,102,91,2,30,1,1
14979,10,15527,9,498,204,294,6,29,3,3
15299,10,22978,9,195,102,93,2,30,1,1
208,295,479,190,5914,4395,1519,19,15,10,9
15285,10,28146,9,193,94,99,2,29,1,1
8699,15,18337,11,8220,849,7371,13,28,5,8
995,26,6495,16,4216,771,3445,16,26,9,7
13746,10,15000,9,244,94,150,2,30,1,1
9697,15,5648,11,378,192,186,7,26,4,3
9582,15,5661,11,314,192,122,6,26,4,2
5958,26,6479,16,6670,1576,5094,23,200,13,10
2744,1239,8848,919,902,126,776,2,30,1,1
8387,10,13761,9,755,94,661,2,30,1,1
14419,10,25806,9,817,102,715,2,30,1,1
21256,10,14852,9,200,102,98,2,30,1,1
18235,15,16618,11,1056,682,374,10,15,6,4
12376,2490,23763,1937,70,70,0,2,7,2,0
10994,26,12161,16,54794,16744,38050,82,71,42,40
19563,26,26504,16,231110,14545,216565,307,18,154,153
8584,1238,22921,918,295,78,217,2,30,1,1
21218,2183,28973,1688,160,70,90,2,5,1,1
7871,15,10225,11,2865,2000,865,12,15,7,5
15199,10,23279,9,259,118,141,2,29,1,1
19639,26,27452,16,80743,4724,76019,101,89,37,64
3090,10,12934,9,229,89,140,2,30,1,1
8457,26,8661,16,1629306,22920,1606386,1339,116,262,1077
11143,904,9923,668,70,70,0,2,8,2,0
22203,10,24857,9,177,94,83,2,30,1,1
5680,15,22159,11,15535,2173,13362,30,21,17,13
9489,26,19202,16,1385,868,517,12,30,6,6
14149,10,11074,9,179,94,85,2,29,1,1
7925,26,23787,16,932130,36511,895619,1142,167,465,677
12047,26,2551,16,7427,1517,5910,22,323,11,11
12864,26,22353,16,43491,8521,34970,69,50,34,35
21952,10,9233,9,231,94,137,2,30,1,1
8404,26,21384,16,33985,8645,25340,53,35,28,25
15314,26,25057,16,94524,4465,90059,126,45,56,70
532,247,0,0,3562,1936,1626,48,194,24,24
14081,10,23786,9,193,102,91,2,30,1,1
15719,26,28555,16,1647,1375,272,9,48,5,4
22198,10,5742,9,192,98,94,2,30,1,1
15603,10,2905,9,283,101,182,4,39,2,2
8327,43,5791,26,868,150,718,4,1200,2,2
21969,10,14111,9,376,118,258,2,30,1,1
4896,15,3582,11,6442,1404,5038,23,30,12,11
13685,26,10771,16,3625,1378,2247,14,135,7,7
18181,26,16788,16,292,172,120,4,15,2,2
9688,10,21228,9,816,102,714,2,30,1,1
13325,23,0,0,14172,5597,8575,50,31,25,25
14375,10,26944,9,194,102,92,2,30,1,1
9912,15,3165,11,6420,677,5743,13,151,6,7
13916,10,4796,9,754,94,660,2,30,1,1
8460,10,9332,9,811,94,717,2,30,1,1
20493,10,17603,9,512,166,346,2,29,1,1
8421,10,20787,9,173,94,79,2,30,1,1
5301,26,16882,16,4378,1471,2907,19,29,11,8
7777,26,433,16,130,70,60,2,15,1,1
21693,10,16281,9,322,102,220,2,29,1,1
18024,10,26568,9,231,90,141,2,31,1,1
14374,10,25284,9,215,102,113,2,29,1,1
3392,26,8977,16,21538,3952,17586,48,17,27,21
21956,10,2051,9,261,94,167,2,30,1,1
15479,26,3681,16,1712418,88847,1623571,2014,149,715,1299
8769,26,25532,16,11841,1700,10141,37,195,16,21
17438,26,11244,16,9050,4611,4439,37,222,20,17
22313,10,9308,9,266,87,179,4,35,2,2
9606,15,15942,11,113965,10014,103951,154,204,65,89
15243,10,2685,9,199,102,97,2,30,1,1
21788,10,25577,9,321,102,219,2,31,1,1
4810,26,16308,16,4704,1797,2907,19,30,11,8
15803,377,25292,243,138,78,60,2,5,1,1
9116,10,22137,9,190,97,93,2,30,1,1
12636,2442,28079,1897,70,70,0,1,5,1,0
12559,2519,6520,1958,70,70,0,1,5,1,0
1993,10,7729,9,370,238,132,3,32,2,1
10361,3205,27925,2485,70,70,0,1,5,1,0
8359,351,13877,224,2050,1277,773,15,15,8,7
15497,10,2728,9,216,110,106,2,30,1,1
6726,26,16733,16,677212,30094,647118,785,136,282,503
10289,26,9390,16,13708,1734,11974,25,31,12,13
19293,15,19537,11,2425,529,1896,11,75,6,5
9345,26,5505,16,50338,5239,45099,54,165,19,35
12056,1015,13678,749,70,70,0,1,4,1,0
18126,26,26213,16,25215,5119,20096,55,144,26,29
16344,1242,17263,922,2338,634,1704,10,30,6,4
22674,26,28965,16,92447,4519,87928,105,16,39,66
22275,10,25678,9,214,110,104,2,30,1,1
14054,10,27077,9,198,102,96,2,30,1,1
10597,26,12019,16,6662,522,6140,15,16,5,10
14720,15,27956,11,2091,799,1292,10,15,6,4
18459,26,2110,16,5964,1586,4378,19,80,10,9
15407,15,15907,11,54049,2036,52013,69,18,31,38
2744,1283,25503,962,893,126,767,2,30,1,1
14224,10,10792,9,194,102,92,2,31,1,1
9321,10,24784,9,211,78,133,2,30,1,1
4881,26,16389,16,1452,817,635,16,20,9,7
17091,26,4491,16,5167,700,4467,16,15,7,9
12150,26,17077,16,96485,4565,91920,119,150,45,74
22635,10,17923,9,227,110,117,2,29,1,1
18372,26,18535,16,5574,1200,4374,26,80,13,13
10860,15,23671,11,486,300,186,9,31,6,3
13392,26,12436,16,18487,3434,15053,37,80,20,17
10839,2688,27738,2087,70,70,0,2,8,2,0
15269,10,802,9,427,88,339,4,55,2,2
5651,26,28045,16,626,352,274,10,16,6,4
22537,10,2295,9,211,102,109,2,30,1,1
15332,26,3886,16,8057,2037,6020,20,15,11,9
5698,15,379,11,1680,950,730,12,15,6,6
225,10,5594,9,204,118,86,2,30,1,1
14474,10,10672,9,182,102,80,2,30,1,1
199,295,470,190,3164,783,2381,15,16,7,8
11441,26,3041,16,9648,3653,5995,37,155,19,18
6511,26,12861,16,9462,4488,4974,28,96,13,15
21870,10,27591,9,177,94,83,2,30,1,1
5121,26,7751,16,1069542,21337,1048205,1028,16,310,718
17383,26,1250,16,7174,1831,5343,31,110,17,14
8330,10,1471,9,167,86,81,2,30,1,1
5019,26,23760,16,12624,5203,7421,48,274,24,24
8299,15,21318,11,3568,2889,679,13,23,8,5
8420,10,13753,9,593,188,405,6,59,3,3
13962,10,5874,9,172,88,84,2,31,1,1
8547,10,20723,9,199,102,97,2,30,1,1
14419,10,8401,9,177,94,83,2,29,1,1
15573,10,16325,9,193,94,99,2,30,1,1
8223,26,22208,16,36383,29447,6936,103,163,51,52
636,280,706,177,150,150,0,1,1200,1,0
2744,1240,303,920,891,126,765,2,30,1,1
22198,10,15837,9,410,100,310,4,55,2,2
16444,15,19588,11,2803,1625,1178,16,21,9,7
9684,26,10846,16,134507,6585,127922,148,121,51,97
15659,10,18694,9,270,102,168,2,30,1,1
5291,26,13387,16,8126,2183,5943,29,270,14,15
2300,26,9446,16,18490,7811,10679,47,81,27,20
8400,346,21380,220,2602,846,1756,13,136,7,6
11072,15,7007,11,70,70,0,2,8,2,0
3942,26,4302,16,8866,4928,3938,26,121,13,13
2873,26,28923,16,10168,968,9200,19,15,9,10
16344,1242,11593,922,468,390,78,5,30,4,1
6013,26,3624,16,6816,1197,5619,24,269,12,12
17129,26,4444,16,2576,1549,1027,15,15,7,8
8584,1238,13854,918,255,78,177,2,29,1,1
6934,26,28793,16,8850,2551,6299,32,369,16,16
5606,1997,10023,1527,566,86,480,2,30,1,1
14450,10,9805,9,168,78,90,2,30,1,1
8714,10,15710,9,198,94,104,2,29,1,1
6578,26,14255,16,3691281,56325,3634956,3201,138,570,2631
10115,26,16806,16,18156,12850,5306,32,76,19,13
21245,10,4787,9,180,94,86,2,30,1,1
11849,26,16917,16,14640,5951,8689,52,115,26,26
5647,10,13726,9,168,78,90,2,29,1,1
14508,10,19289,9,184,94,90,2,30,1,1
9579,15,12255,11,318,192,126,6,27,4,2
12041,26,14201,16,116790,7062,109728,166,144,85,81
4984,26,19597,16,3830718,112946,3717772,4353,224,1395,2958
11414,26,22156,16,2114,1152,962,14,15,8,6
11250,3261,138,2526,70,70,0,1,5,1,0
16021,75,6334,58,402,132,270,6,1209,3,3
4867,10,16380,9,213,87,126,2,31,1,1
9512,26,20001,16,8048,1189,6859,19,25,10,9
19930,26,14145,16,7205,2250,4955,16,120,7,9
11124,2868,23018,2227,70,70,0,2,8,2,0
2744,1351,11486,1024,918,126,792,2,31,1,1
9146,10,6733,9,211,110,101,2,30,1,1
18281,26,22829,16,4706,2475,2231,13,120,7,6
17221,26,20415,16,10782,7193,3589,30,16,17,13
10523,26,17226,16,3961,1595,2366,21,16,12,9
22719,10,9020,9,167,86,81,2,30,1,1
15309,15,28891,11,194,128,66,4,25,3,1
13862,10,28049,9,174,89,85,2,30,1,1
19631,10,27442,9,237,91,146,2,33,1,1
16951,255,25970,160,66,66,0,1,4,1,0
5788,15,28380,11,1712,786,926,12,17,7,5
8973,10,10500,9,268,102,166,2,29,1,1
5356,26,25250,16,204,70,134,4,26,2,2
11182,26,17221,16,433460,26631,406829,595,147,224,371
6907,10,19272,9,216,90,126,2,30,1,1
17765,26,20843,16,5682,1562,4120,23,61,13,10
9116,10,28633,9,195,102,93,2,29,1,1
20524,10,14486,9,384,166,218,2,30,1,1
10787,2796,10073,2169,66,66,0,1,5,1,0
15708,10,14238,9,199,102,97,2,31,1,1
2724,1240,19096,920,250,164,86,4,30,3,1
8900,10,14543,9,216,110,106,2,30,1,1
11267,765,15695,553,70,70,0,2,4,2,0
14228,10,15587,9,184,94,90,2,30,1,1
19771,26,27541,16,4625,1718,2907,19,27,11,8
5924,26,6084,16,2974,1378,1596,28,34,15,13
21770,10,10070,9,179,94,85,2,30,1,1
3532,15,2838,11,1286,782,504,12,361,7,5
22437,10,6547,9,168,86,82,2,31,1,1
21984,10,28801,9,220,100,120,2,31,1,1
11132,903,4094,667,70,70,0,2,8,2,0
9278,26,24548,16,6407,1101,5306,18,26,10,8
8891,10,7722,9,211,102,109,2,29,1,1
15184,10,25044,9,198,101,97,2,30,1,1
14544,10,7082,9,182,102,80,2,30,1,1
8907,10,19467,9,177,94,83,2,30,1,1
15383,10,18223,9,180,94,86,2,35,1,1
11104,15,3172,11,422,240,182,8,26,5,3
14697,10,4694,9,194,102,92,2,30,1,1
11050,15,22761,11,6764,5555,1209,20,28,12,8
18344,15,26734,11,671,313,358,7,75,4,3
21257,2783,13356,2160,66,66,0,2,8,2,0
16176,26,26099,16,35696,3196,32500,48,121,19,29
11090,1443,6962,1097,70,70,0,2,8,2,0
3133,2338,19334,1822,462,462,0,8,3631,8,0
10327,280,16582,177,469,150,319,2,1200,1,1
8368,10,1900,9,200,102,98,2,31,1,1
16827,10,28737,9,380,88,292,2,30,1,1
15262,10,29,9,225,110,115,2,30,1,1
21785,10,24412,9,166,85,81,2,31,1,1
4662,26,15882,16,7534,2392,5142,25,25,14,11
8584,1242,8421,922,71,71,0,1,30,1,0
8020,26,1194,16,10420,3506,6914,33,274,18,15
15512,15,10974,11,194,128,66,4,31,3,1
8584,1238,15772,918,251,71,180,2,31,1,1
10893,1012,4982,746,70,70,0,1,5,1,0
13378,10,24021,9,231,90,141,2,30,1,1
12508,2590,4241,2009,70,70,0,1,5,1,0
13742,10,2442,9,199,102,97,2,30,1,1
12621,1808,19229,1378,70,70,0,2,8,2,0
22440,10,9182,9,200,102,98,2,31,1,1
4255,26,15556,16,4681,1774,2907,19,30,11,8
15169,15,2153,11,234,234,0,4,11,4,0
15242,10,15539,9,232,94,138,2,30,1,1
11183,15,11187,11,366,240,126,7,32,5,2
9411,15,11145,11,2100,1146,954,13,46,6,7
10902,26,10939,16,442,250,192,8,30,5,3
1112,26,10710,16,3615,435,3180,11,16,6,5
5638,26,21137,16,51588,40242,11346,107,418,53,54
10555,26,20295,16,645662,22326,623336,743,41,299,444
8797,10,13800,9,323,102,221,2,30,1,1
12405,2131,10763,1644,552,306,246,9,17,5,4
9037,15,8019,11,9540,2954,6586,18,88,8,10
22569,10,12524,9,476,121,355,4,40,2,2
19990,26,27690,16,1210,637,573,14,51,7,7
22352,10,11878,9,763,101,662,2,30,1,1
2744,1238,1922,918,889,126,763,2,30,1,1
8252,26,2009,16,4372,2402,1970,27,53,14,13
15557,10,19065,9,209,102,107,2,30,1,1
21425,10,4957,9,183,94,89,2,30,1,1
22120,10,1059,9,168,86,82,2,30,1,1
9834,15,19185,11,56951,28706,28245,236,174,116,120
18092,26,19587,16,5108,2834,2274,21,143,10,11
15980,10,14860,9,177,94,83,2,30,1,1
15697,10,12685,9,178,94,84,2,30,1,1
13112,1271,18564,951,924,924,0,3,30,3,0
5413,26,21831,16,9748,5209,4539,22,121,11,11
11060,26,22764,16,4400,1493,2907,19,30,11,8
13873,10,6400,9,183,102,81,2,31,1,1
21805,10,1806,9,182,102,80,2,31,1,1
9706,15,22042,11,1696,996,700,11,22,6,5
9517,26,15677,16,4695,859,3836,17,30,9,8
10327,287,23351,184,481,150,331,2,1200,1,1
10469,26,27172,16,1576,789,787,17,122,9,8
9136,10,4264,9,216,110,106,2,31,1,1
3728,1392,17861,1059,1806,1806,0,22,224,22,0
201,298,472,193,4279,2090,2189,16,15,8,8
2533,10,10634,9,220,90,130,2,30,1,1
10080,15,22254,11,520,246,274,9,25,5,4
6691,26,14079,16,1201,707,494,12,26,7,5
18466,26,9329,16,3802,1769,2033,15,135,7,8
22562,10,7009,9,199,102,97,2,30,1,1
4835,484,27252,317,844,152,692,4,1199,2,2
9757,15,16842,11,85306,4735,80571,120,22,55,65
10955,1429,7924,1084,70,70,0,1,5,1,0
21380,10,7789,9,182,86,96,2,30,1,1
857,26,481,16,5045,2005,3040,14,119,7,7
2744,1273,19618,953,908,126,782,2,31,1,1
22180,1252,23593,932,735,462,273,2,30,1,1
12680,26,14853,16,499,425,74,4,0,3,1
22417,10,12100,9,218,94,124,2,30,1,1
21369,42,27550,25,70,70,0,1,5,1,0
12348,26,23476,16,960,539,421,9,36,5,4
12116,10,4411,9,78,78,0,1,29,1,0
9369,26,10665,16,178347,31093,147254,290,446,140,150
19396,26,4441,16,443128,10267,432861,362,45,60,302
13805,10,7083,9,168,86,82,2,30,1,1
7699,10,8327,9,225,78,147,2,30,1,1
9507,10,27845,9,214,110,104,2,30,1,1
9083,26,11860,16,4534,909,3625,16,32,8,8
16832,10,15049,9,246,246,0,4,47,4,0
13884,10,4352,9,168,86,82,2,30,1,1
3793,26,4313,16,6393,1025,5368,18,27,9,9
13661,10,4241,9,164,84,80,2,31,1,1
17256,15,26089,11,5481,4758,723,15,15,8,7
4910,26,17819,16,3919,1099,2820,35,627,9,26
22696,10,7296,9,211,102,109,2,30,1,1
14162,10,15187,9,772,100,672,2,31,1,1
14611,10,23007,9,178,94,84,2,31,1,1
13783,10,5984,9,212,108,104,2,30,1,1
3622,26,689,16,7510,2040,5470,24,210,13,11
637,2135,10033,1648,207,118,89,2,1200,1,1
14008,10,7560,9,747,93,654,2,31,1,1
12553,1188,18667,877,70,70,0,2,7,2,0
21923,10,18596,9,198,101,97,2,31,1,1
9728,2272,1590,1759,1377,300,1077,6,1200,3,3
1198,10,10927,9,229,86,143,2,30,1,1
15907,10,6099,9,177,94,83,2,30,1,1
9418,10,22992,9,210,110,100,2,29,1,1
18733,10,23627,9,211,78,133,2,30,1,1
8210,2367,21194,1841,763,296,467,4,1200,2,2
21331,2264,4794,1753,66,66,0,2,7,2,0
13674,26,25428,16,3533,1045,2488,17,147,8,9
14441,10,10169,9,188,96,92,2,31,1,1
2918,183,11964,121,4695,2520,2175,22,19,13,9
5907,15,17416,11,78,78,0,1,5,1,0
12343,183,23473,121,3624,1910,1714,19,33,11,8
9021,10,6208,9,173,94,79,2,30,1,1
18403,15,385,11,35136,7862,27274,53,124,26,27
22557,10,4365,9,196,102,94,2,29,1,1
14245,10,13055,9,212,108,104,2,31,1,1
5195,10,16744,9,213,79,134,2,32,1,1
18438,10,10488,9,226,94,132,2,31,1,1
8117,26,10911,16,12993,3240,9753,36,24,18,18
14919,10,20019,9,268,89,179,4,45,2,2
11835,26,15745,16,5458,1390,4068,17,15,9,8
9199,10,25344,9,190,97,93,2,30,1,1
1140,15,3836,11,1384,648,736,9,15,5,4
8614,10,21006,9,210,102,108,2,30,1,1
20724,26,6207,16,1481,701,780,20,120,10,10
14581,10,16076,9,699,438,261,2,30,1,1
7013,26,8205,16,36435,28844,7591,65,396,35,30
10910,341,10213,217,582,270,312,8,32,4,4
16266,26,6725,16,11544,6888,4656,32,125,17,15
10120,26,16386,16,6448,2376,4072,22,2,10,12
4527,26,20325,16,7303,2206,5097,23,255,12,11
8893,26,25839,16,4116,972,3144,15,50,8,7
9427,10,14150,9,195,102,93,2,30,1,1
7192,10,19686,9,220,90,130,2,30,1,1
11180,26,19459,16,5481,3086,2395,26,49,13,13
15623,10,22821,9,170,87,83,2,31,1,1
8301,26,14670,16,7424,2381,5043,24,18,13,11
21618,10,25324,9,234,94,140,2,30,1,1
1341,26,4536,16,6981,948,6033,17,28,10,7
15524,10,9790,9,199,102,97,2,30,1,1
22349,10,22853,9,204,104,100,2,31,1,1
22265,10,8541,9,397,102,295,2,30,1,1
18221,26,9527,16,3647,1221,2426,13,135,6,7
10793,15,17972,11,3830,2255,1575,16,74,10,6
13847,10,3868,9,168,78,90,2,30,1,1
8927,10,16178,9,382,94,288,2,30,1,1
8775,10,19269,9,177,94,83,2,30,1,1
296,10,12048,9,78,78,0,1,30,1,0
18439,15,26784,11,180425,10839,169586,213,33,93,120
3722,15,28343,11,350,210,140,6,16,4,2
15212,10,20649,9,214,110,104,2,31,1,1
7330,26,4724,16,9153,4216,4937,29,331,16,13
13962,10,12459,9,279,94,185,2,30,1,1
8801,10,24383,9,204,104,100,2,30,1,1
21069,2422,12841,1884,66,66,0,2,7,2,0
12468,311,5254,203,70,70,0,2,8,2,0
11129,1378,15010,1048,70,70,0,1,5,1,0
9531,26,17965,16,8507,1945,6562,21,33,10,11
14397,10,23779,9,167,86,81,2,30,1,1
6281,26,9997,16,499,425,74,4,0,3,1
2941,10,12059,9,231,88,143,2,32,1,1
13393,26,23620,16,7210,2267,4943,22,15,12,10
14270,1228,11496,908,70,70,0,1,5,1,0
21387,1127,25007,831,66,66,0,2,8,2,0
7419,26,8066,16,173828,9311,164517,245,448,118,127
16951,255,25970,160,156,62,94,2,10,1,1
12496,801,27091,583,70,70,0,1,5,1,0
8795,10,2063,9,198,102,96,2,30,1,1
8821,15,17320,11,499,192,307,6,42,4,2
15562,10,6281,9,152,78,74,2,30,1,1
22159,10,4952,9,402,118,284,2,29,1,1
2395,15,9899,11,1100980,31101,1069879,1210,19,462,748
14282,10,8426,9,726,85,641,2,31,1,1
9833,26,28501,16,180,60,120,4,15,2,2
17287,26,6654,16,1437,736,701,15,28,7,8
11041,26,22755,16,110812,7779,103033,122,49,44,78
14969,10,14855,9,275,95,180,4,49,2,2
12553,26,16174,16,4931,957,3974,17,15,10,7
21041,15,16292,11,314,192,122,6,15,4,2
9466,10,9733,9,438,180,258,6,30,3,3
8884,26,10539,16,4524,779,3745,13,52,6,7
21862,10,6826,9,786,110,676,2,30,1,1
15368,26,1394,16,8022,2002,6020,20,16,11,9
8401,10,7228,9,166,85,81,2,31,1,1
15432,2175,22603,1680,66,66,0,1,5,1,0
14721,10,26365,9,336,110,226,2,29,1,1
637,294,9024,189,228,118,110,2,1200,1,1
14363,10,8580,9,184,94,90,2,30,1,1
7570,26,2548,16,234,234,0,4,12,4,0
21574,10,6619,9,186,95,91,2,30,1,1
14613,10,20475,9,210,102,108,2,30,1,1
2602,7,10967,7,146,60,86,2,10,1,1
14486,10,23983,9,177,94,83,2,29,1,1
4835,2366,8791,1840,1217,594,623,16,1764,10,6
1276,183,4233,121,3910,1805,2105,20,19,12,8
2777,10,24956,9,199,94,105,2,31,1,1
8533,26,9630,16,14668,3601,11067,34,19,19,15
9380,10,24452,9,756,95,661,2,31,1,1
9500,15,25830,11,1578,756,822,13,34,7,6
16827,26,14444,16,19057,9308,9749,111,307,53,58
8584,1632,12755,1254,78,78,0,1,30,1,0
8364,10,1022,9,249,94,155,2,30,1,1
21813,10,1258,9,179,94,85,2,29,1,1
22561,10,9801,9,193,102,91,2,30,1,1
21863,10,1576,9,325,102,223,2,30,1,1
18025,26,1189,16,7359,2050,5309,18,16,10,8
6605,15,1755,11,2093,825,1268,12,45,7,5
11073,26,15500,16,7847,1904,5943,21,361,10,11
8767,15,6368,11,378,192,186,7,41,4,3
18473,845,11621,623,1759,820,939,18,16,8,10
9186,26,22226,16,70,70,0,2,5,2,0
11121,15,28734,11,2825,716,2109,12,22,7,5
925,26,13090,16,5731,495,5236,14,15,7,7
2646,291,20322,187,192,192,0,4,1200,4,0
13499,183,24106,121,3428,1714,1714,16,32,8,8
15243,10,12964,9,199,102,97,2,30,1,1
10781,2858,27949,2217,66,66,0,1,5,1,0
11041,480,5964,314,70,70,0,1,4,1,0
6081,26,12282,16,618072,8505,609567,523,87,90,433
8777,10,19054,9,177,94,83,2,30,1,1
10123,26,4562,16,6349,1072,5277,18,21,10,8
21926,10,15294,9,239,86,153,2,29,1,1
18214,15,14702,11,2910,1439,1471,12,31,7,5
13918,10,1000,9,764,99,665,2,31,1,1
9581,10,21847,9,413,170,243,6,30,3,3
9175,10,3128,9,272,110,162,2,30,1,1
248,10,630,9,229,90,139,2,30,1,1
8395,26,24603,16,842887,22143,820744,866,19,314,552
22652,26,10467,16,92752,4519,88233,105,15,39,66
17506,10,6141,9,164,78,86,2,29,1,1
13789,10,5512,9,184,94,90,2,31,1,1
22671,10,7230,9,278,126,152,2,30,1,1
2724,1240,729,920,422,164,258,6,30,3,3
18471,26,14275,16,7282,1596,5686,21,79,11,10
14803,10,20338,9,200,102,98,2,33,1,1
7437,15,24943,11,1155,781,374,10,15,6,4
18875,26,6448,16,95311,21869,73442,140,62,61,79
14485,10,26511,9,192,98,94,2,30,1,1
14168,10,14117,9,250,86,164,4,30,2,2
5596,26,10417,16,1312,651,661,13,184,7,6
22113,10,19849,9,197,102,95,2,30,1,1
8806,26,7501,16,8607,3608,4999,25,256,14,11
2914,10,22752,9,168,78,90,2,30,1,1
15067,10,18775,9,212,110,102,2,30,1,1
14967,10,8756,9,177,94,83,2,30,1,1
10635,26,4355,16,14194,4643,9551,34,30,19,15
4811,10,16310,9,244,98,146,2,33,1,1
14094,26,19982,16,8447,2129,6318,26,250,15,11
21104,1933,7634,1476,66,66,0,2,8,2,0
16130,15,18646,11,1231,726,505,10,18,6,4
8359,15,17047,11,2807,587,2220,13,16,7,6
21134,2296,13311,1780,4687209,3850148,837061,4974,107,3004,1970
22311,15,28960,11,23382,3770,19612,48,45,24,24
2490,10,10434,9,214,82,132,2,33,1,1
11103,733,8218,525,70,70,0,2,8,2,0
8814,305,10341,199,8962,1625,7337,28,16,15,13
15272,10,91,9,198,102,96,2,30,1,1
9620,15,10699,11,5049,4344,705,11,30,6,5
14877,10,9983,9,197,102,95,2,30,1,1
22258,10,9370,9,210,110,100,2,30,1,1
8713,10,257,9,186,95,91,2,31,1,1
8740,10,10532,9,816,102,714,2,30,1,1
19448,26,10745,16,5103,2363,2740,11,120,6,5
16388,26,18814,16,4322,2383,1939,29,124,17,12
6584,26,3302,16,13275,10536,2739,50,101,27,23
11051,26,6035,16,7508,2350,5158,37,1323,21,16
17133,26,2366,16,5167,700,4467,16,14,7,9
21138,26,129,16,1786,172,1614,7,120,3,4
15642,10,13264,9,816,102,714,2,29,1,1
192,15,439,11,1535,652,883,9,16,5,4
11118,1778,12245,1356,70,70,0,2,8,2,0
15888,26,3083,16,7468,2225,5243,27,16,15,12
10896,1075,16517,788,70,70,0,2,8,2,0
11068,655,28947,457,66,66,0,1,5,1,0
17905,26,11367,16,248845,14935,233910,308,49,148,160
12785,1321,16284,997,612,306,306,10,14,5,5
14418,10,23582,9,196,102,94,2,30,1,1
2744,1360,22160,1032,910,126,784,2,30,1,1
18417,15,2886,11,644,256,388,8,124,5,3
20934,26,7145,16,7673,2645,5028,31,137,17,14
15308,15,13707,11,214,140,74,4,25,3,1
8777,10,1869,9,177,94,83,2,30,1,1
6866,15,19207,11,250076,10158,239918,315,24,146,169
22338,10,4748,9,166,85,81,2,31,1,1
9155,15,12115,11,2095,1010,1085,11,87,6,5
15256,10,11212,9,195,102,93,2,30,1,1
5595,26,23403,16,1310,649,661,13,184,7,6
12082,26,7398,16,1462,965,497,13,18,7,6
11935,15,23246,11,373926,8227,365699,379,143,130,249
3133,2301,4899,1785,330,330,0,6,3609,6,0
9411,2253,11290,1744,149,149,0,1,1200,1,0
14775,10,26179,9,216,94,122,2,30,1,1
1600,15,5769,11,722,300,422,11,158,5,6
8909,26,22019,16,2372,1143,1229,21,82,10,11
14332,10,4145,9,177,94,83,2,31,1,1
10948,2086,26119,1608,70,70,0,1,5,1,0
12313,26,20497,16,6384,1091,5293,18,30,10,8
8943,10,5734,9,166,86,80,2,30,1,1
9000,10,27951,9,168,78,90,2,30,1,1
22575,10,20174,9,197,102,95,2,33,1,1
22681,10,18883,9,199,102,97,2,30,1,1
22014,10,14940,9,338,110,228,2,30,1,1
22254,10,23372,9,194,99,95,2,30,1,1
22418,10,21491,9,193,102,91,2,30,1,1
12389,1013,1883,747,70,70,0,1,5,1,0
8493,26,8609,16,9303,2551,6752,33,16,18,15
9747,26,16149,16,2928,1448,1480,17,20,10,7
21045,26,26040,16,7444,1915,5529,28,16,16,12
18266,26,16105,16,5656,1936,3720,23,57,11,12
6618,26,25621,16,58423,25600,32823,86,138,40,46
9207,26,24395,16,5661,1526,4135,22,85,12,10
15046,10,1186,9,180,94,86,2,30,1,1
8862,10,12958,9,178,94,84,2,30,1,1
636,2569,26082,1994,3514,1874,1640,15,1200,8,7
21750,10,18014,9,216,110,106,2,30,1,1
15067,15,26570,11,118508,4979,113529,128,135,48,80
16021,3021,15401,2349,1367,664,703,16,1199,9,7
6180,26,20060,16,5041,817,4224,20,373,8,12
15315,26,6953,16,7862,1873,5989,20,15,11,9
14991,15,20496,11,34476,818,33658,35,104,9,26
22543,10,3245,9,390,105,285,4,42,2,2
1635,26,16856,16,15204,8747,6457,83,167,44,39
15420,10,29124,9,233,102,131,2,30,1,1
14057,10,16700,9,177,94,83,2,30,1,1
14229,10,11995,9,177,94,83,2,30,1,1
22124,10,20028,9,209,110,99,2,31,1,1
858,26,16122,16,4187235,99258,4087977,4375,28,1464,2911
9837,26,22118,16,19125,2345,16780,37,128,15,22
7801,26,19433,16,2897,728,2169,10,121,5,5
12805,2790,1978,2165,70,70,0,2,8,2,0
21630,10,20529,9,193,102,91,2,30,1,1
7177,26,16397,16,3999,2255,1744,37,1122,19,18
17006,234,20635,149,4706,2850,1856,44,6872,25,19
12201,26,29093,16,416,210,206,7,28,4,3
7255,15,5303,11,1052,612,440,10,15,5,5
5231,26,14824,16,12197,2338,9859,34,122,14,20
11674,26,5998,16,32774,3629,29145,52,26,27,25
6134,10,18147,9,223,86,137,2,30,1,1
8475,10,1530,9,195,102,93,2,30,1,1
12607,26,2597,16,499,425,74,4,0,3,1
15662,10,128,9,211,110,101,2,29,1,1
15313,10,23785,9,264,87,177,4,36,2,2
9646,18,20944,13,184,94,90,2,30,1,1
22083,10,321,9,200,102,98,2,33,1,1
20465,401,28817,260,829,583,246,9,15,5,4
7721,15,12943,11,436,222,214,7,19,4,3
15811,26,2281,16,3948,1290,2658,13,120,6,7
8457,26,19475,16,4783,2366,2417,16,203,8,8
10887,2037,3841,1565,70,70,0,2,8,2,0
7389,26,6943,16,4168,1128,3040,14,121,7,7
7193,26,568,16,2215,1412,803,19,38,10,9
11110,15,17683,11,27100,21684,5416,39,38,25,14
8650,15,26968,11,318,192,126,6,39,4,2
2744,1369,12430,1040,879,126,753,2,30,1,1
9148,10,9388,9,178,94,84,2,30,1,1
1963,10,7571,9,237,91,146,2,32,1,1
14466,10,19410,9,821,102,719,2,29,1,1
13678,10,27173,9,174,89,85,2,30,1,1
8616,26,315,16,2319947,69322,2250625,2464,70,870,1594
21838,10,2706,9,168,86,82,2,30,1,1
584,10,2238,9,404,259,145,3,32,2,1
21256,10,23793,9,200,102,98,2,33,1,1
6153,26,20703,16,11377,7703,3674,26,162,19,7
21220,10,17610,9,226,110,116,2,30,1,1
11179,2672,26431,2078,70,70,0,2,8,2,0
4945,26,16469,16,6981,948,6033,17,54,10,7
18472,2250,14680,1742,70,70,0,2,8,2,0
13682,26,1088,16,1403116,30089,1373027,1321,32,404,917
21328,10,24617,9,232,102,130,2,30,1,1
15239,26,28813,16,9160636,285656,8874980,9685,189,3160,6525
12802,281,19153,178,70,70,0,2,8,2,0
21817,10,28020,9,167,86,81,2,30,1,1
11130,26,20546,16,298527,11814,286713,310,37,107,203
13134,26,11058,16,7900,2042,5858,27,36,15,12
16243,10,6062,9,198,93,105,2,31,1,1
6076,10,3034,9,168,78,90,2,29,1,1
910,26,16254,16,5727,491,5236,14,15,7,7
15243,10,27284,9,701,88,613,2,30,1,1
21468,10,11378,9,264,102,162,2,31,1,1
15486,10,11299,9,193,102,91,2,30,1,1
21601,10,9587,9,321,102,219,2,30,1,1
13978,10,28039,9,184,94,90,2,31,1,1
20790,26,23958,16,4470,1597,2873,16,138,8,8
14058,10,19254,9,200,102,98,2,30,1,1
11092,26,15005,16,466,392,74,4,0,3,1
8763,15,26092,11,372,192,180,7,41,4,3
21329,10,4183,9,193,102,91,2,30,1,1
5879,26,21236,16,9045,1938,7107,21,16,12,9
15187,26,18058,16,8033,2013,6020,20,15,11,9
22152,10,7331,9,758,102,656,2,30,1,1
12803,26,15455,16,374,254,120,4,5,2,2
22694,10,7090,9,166,86,80,2,29,1,1
13314,26,23778,16,10546,2453,8093,28,15,16,12
15639,10,17627,9,1335,87,1248,4,32,2,2
2744,1248,9500,928,887,126,761,2,31,1,1
10834,1512,12206,1151,70,70,0,1,5,1,0
3397,26,12885,16,4239,2487,1752,19,16,11,8
4156,18,8445,13,184,94,90,2,30,1,1
12512,947,20613,699,70,70,0,1,4,1,0
21665,10,5796,9,188,96,92,2,30,1,1
9118,10,26540,9,753,94,659,2,30,1,1
9038,26,1106,16,6058,1037,5021,20,54,11,9
16447,15,15206,11,42086,9535,32551,48,21,19,29
8928,10,25100,9,184,94,90,2,31,1,1
15395,10,17428,9,193,102,91,2,30,1,1
3666,26,15008,16,6650,1556,5094,23,18,13,10
13379,280,7229,177,470,348,122,6,26,4,2
22233,10,19492,9,761,102,659,2,30,1,1
8676,10,3057,9,754,94,660,2,30,1,1
13650,10,6087,9,168,86,82,2,31,1,1
2744,1239,23842,919,1642,126,1516,4,31,2,2
8413,15,21393,11,133699,9415,124284,169,23,77,92
9411,2071,14096,1596,1716,1716,0,27,2188,27,0
7591,10,23156,9,221,75,146,2,30,1,1
11404,26,24150,16,8811,3668,5143,26,126,13,13
17952,15,17650,11,469946,11862,458084,482,68,173,309
15170,15,18848,11,234,234,0,4,12,4,0
8327,542,804,360,852,150,702,4,1200,2,2
22661,10,28141,9,202,103,99,2,31,1,1
12049,1935,9174,1478,70,70,0,2,8,2,0
7767,26,6946,16,50898,2733,48165,73,218,33,40
5043,26,3981,16,11418,1999,9419,28,22,13,15
8925,10,16939,9,201,86,115,2,30,1,1
7851,26,4296,16,22048,16451,5597,47,18,21,26
636,1855,20391,1415,502,150,352,2,1199,1,1
13983,10,16438,9,255,102,153,2,30,1,1
7404,26,20505,16,13769,11153,2616,30,361,16,14
12641,10,6145,9,167,78,89,2,30,1,1
15129,10,24825,9,199,102,97,2,30,1,1
15838,10,25948,9,711,87,624,2,31,1,1
9605,26,26030,16,5440,4368,1072,19,34,11,8
18283,15,18287,11,1313,738,575,10,152,6,4
4298,15,15634,11,1917,1468,449,10,20,6,4
15828,26,14725,16,7155,2151,5004,34,33,20,14
15255,26,11917,16,8942,1817,7125,23,77,13,10
3066,1833,8647,1395,2668,1950,718,16,7827,14,2
22194,10,16603,9,777,87,690,2,31,1,1
8379,1907,13674,1457,70,70,0,2,8,2,0
9506,10,8125,9,177,94,83,2,30,1,1
22612,26,6639,16,2494,1643,851,17,25,9,8
8210,280,21194,177,506,152,354,2,1200,1,1
11487,15,22996,11,79714,5592,74122,102,23,45,57
7272,10,19804,9,262,106,156,2,33,1,1
18515,3144,27965,2438,70,70,0,1,5,1,0
5706,26,14270,16,5591,3194,2397,16,122,8,8
15310,15,25054,11,2243,1548,695,11,46,7,4
21244,3080,1515,2393,312,132,180,6,7,3,3
15267,26,19899,16,7914,1925,5989,20,15,11,9
15358,10,10190,9,199,102,97,2,31,1,1
637,729,18506,522,150,150,0,1,1200,1,0
16102,10,25435,9,235,98,137,2,30,1,1
7038,26,15914,16,8958,1683,7275,24,23,10,14
10676,26,28505,16,4692,2882,1810,32,80,14,18
22658,10,26381,9,190,97,93,2,30,1,1
17360,26,26185,16,6264,1435,4829,21,15,11,10
15002,10,11739,9,184,102,82,2,30,1,1
12043,26,11972,16,3947,2796,1151,22,28,12,10
15072,15,22624,11,44136,2908,41228,56,135,25,31
22070,10,5010,9,1431,101,1330,4,50,2,2
7928,26,7643,16,180582,6020,174562,196,200,70,126
22138,10,10166,9,166,86,80,2,30,1,1
9872,1251,26294,931,269,78,191,2,30,1,1
21765,10,18687,9,212,108,104,2,31,1,1
22199,10,6871,9,196,94,102,2,30,1,1
2292,10,9412,9,217,87,130,2,30,1,1
15751,10,7134,9,757,102,655,2,30,1,1
11372,26,15398,16,13972,2550,11422,29,954,11,18
15300,10,19535,9,262,90,172,4,53,2,2
11725,26,6576,16,1444,723,721,15,198,8,7
2863,2001,21850,1531,146,84,62,2,30,1,1
15437,15,11522,11,2058,589,1469,10,45,6,4
22362,10,3586,9,728,102,626,2,30,1,1
21442,10,7655,9,194,99,95,2,30,1,1
12862,10,9771,9,168,78,90,2,30,1,1
13216,10,12363,9,70,70,0,1,30,1,0
21810,26,28614,16,24686,1935,22751,36,20,17,19
8332,10,28590,9,780,104,676,2,30,1,1
17157,26,5448,16,3439647,103607,3336040,3670,452,1291,2379
22368,10,1784,9,177,94,83,2,30,1,1
10364,2423,7894,1885,70,70,0,1,5,1,0
22602,10,15064,9,771,101,670,2,30,1,1
8499,10,16569,9,281,98,183,4,57,2,2
9411,1860,24074,1419,925,594,331,11,2335,10,1
7080,26,20969,16,4493,2566,1927,40,130,21,19
5427,26,8202,16,1350,689,661,14,18,8,6
9943,26,11458,16,25297,10467,14830,51,362,27,24
8556,10,15846,9,210,110,100,2,30,1,1
11418,26,5817,16,8376,6877,1499,27,31,15,12
19961,26,9239,16,3419,1275,2144,13,135,6,7
15221,10,6973,9,177,94,83,2,29,1,1
9782,15,6840,11,21873,2252,19621,27,21,10,17
15973,10,20259,9,199,102,97,2,30,1,1
11058,1753,23511,1338,206,136,70,4,13,3,1
8908,26,5855,16,16041,1805,14236,30,20,14,16
1366,10,4651,9,233,91,142,2,31,1,1
5606,2004,1220,1534,148,86,62,2,30,1,1
10524,216,22494,139,156,156,0,3,8,3,0
20678,26,19617,16,1369,670,699,17,141,9,8
14397,10,11859,9,167,86,81,2,29,1,1
13074,184,23851,122,146,60,86,2,10,1,1
13661,26,21983,16,9726,4743,4983,41,15,24,17
9751,26,14109,16,3947,2271,1676,22,140,13,9
10014,15,22712,11,207895,10483,197412,229,141,90,139
11048,10,23562,9,164,78,86,2,30,1,1
7362,10,26544,9,168,78,90,2,30,1,1
15266,26,20945,16,3986,2645,1341,18,18,10,8
15498,10,9589,9,196,102,94,2,30,1,1
9083,15,22227,11,2821387,64706,2756681,2277,183,418,1859
8797,26,10098,16,6304,1793,4511,29,255,15,14
3884,15,1466,11,7136,3526,3610,42,1239,21,21
14360,10,27089,9,194,102,92,2,30,1,1
18740,26,13656,16,71523,19991,51532,112,41,59,53
9401,10,24536,9,199,102,97,2,29,1,1
15142,26,7913,16,343737,9198,334539,348,80,121,227
12591,26,19098,16,499,425,74,4,0,3,1
11164,853,25160,628,70,70,0,1,4,1,0
8870,26,17970,16,513839,16341,497498,453,210,104,349
3356,26,6860,16,466,392,74,4,0,3,1
15981,26,4783,16,16413,6367,10046,60,17,28,32
4877,15,15268,11,1484,601,883,9,44,6,3
8770,10,12325,9,89,89,0,1,30,1,0
22529,10,28888,9,275,94,181,2,30,1,1
14613,10,14176,9,183,102,81,2,30,1,1
2863,2000,18454,1530,245,182,63,2,30,1,1
16353,15,13280,11,318,192,126,6,27,4,2
18371,26,12151,16,9188,3421,5767,43,83,19,24
12049,1935,19000,1478,70,70,0,1,5,1,0
11793,26,19502,16,1695880,25777,1670103,1423,118,264,1159
21800,26,2636,16,24984,2042,22942,41,32,19,22
22147,10,6809,9,765,102,663,2,30,1,1
19315,26,5572,16,6327,1143,5184,18,28,9,9
16027,26,6728,16,10068,3304,6764,28,36,17,11
636,2627,21194,2037,200,111,89,2,1200,1,1
3941,389,15048,252,138,78,60,2,5,1,1
22561,10,1390,9,778,103,675,2,31,1,1
12395,1,25314,1,70,70,0,1,5,1,0
3261,10,20116,9,207,86,121,2,30,1,1
13757,10,26611,9,184,94,90,2,29,1,1
10327,2840,24966,2204,528,528,0,9,1200,9,0
8258,23,0,0,8507,3320,5187,28,30,14,14
15200,15,8416,11,234,234,0,4,11,4,0
13696,15,14012,11,306,180,126,6,34,4,2
17137,26,5225,16,13120,8597,4523,34,17,18,16
4835,1419,22867,1079,858,858,0,14,1199,14,0
14543,10,13625,9,177,94,83,2,30,1,1
17664,15,7210,11,882,527,355,10,255,6,4
10790,26,195,16,1569,1044,525,14,94,9,5
20944,10,28279,9,643,88,555,2,30,1,1
2744,1452,16899,1105,890,126,764,2,31,1,1
14327,974,13803,720,70,70,0,2,8,2,0
1376,26,4720,16,5626,2487,3139,23,29,14,9
22421,10,16746,9,258,102,156,2,29,1,1
13661,26,5354,16,14030,7043,6987,32,123,18,14
14985,10,20743,9,749,89,660,2,30,1,1
21422,10,7485,9,232,110,122,2,30,1,1
6396,26,23138,16,8113,1626,6487,24,21,14,10
13652,26,16753,16,10151,2256,7895,32,39,17,15
15062,26,837,16,1857,1218,639,18,135,11,7
12989,26,23804,16,4581,1674,2907,19,29,11,8
12590,1315,8980,992,70,70,0,2,8,2,0
21964,10,15952,9,193,102,91,2,30,1,1
5496,26,16350,16,11179,7205,3974,47,136,26,21
18302,26,10509,16,6553,871,5682,19,45,9,10
6636,10,11164,9,168,78,90,2,30,1,1
19075,26,26627,16,23915,14776,9139,66,136,35,31
7485,26,12474,16,1340,760,580,14,39,8,6
7535,26,19903,16,8897,2184,6713,24,516,13,11
16367,26,6823,16,1867,1228,639,18,176,11,7
13712,10,17788,9,216,110,106,2,31,1,1
8839,15,17865,11,318,192,126,6,41,4,2
15428,593,29031,404,316,136,180,6,6,3,3
14806,10,27221,9,183,94,89,2,31,1,1
8954,26,9421,16,74171,1888,72283,72,126,18,54
21705,10,16667,9,259,118,141,2,30,1,1
14077,10,24418,9,220,90,130,2,30,1,1
22550,10,9930,9,180,94,86,2,30,1,1
9728,287,28557,184,1326,300,1026,6,1200,3,3
11203,15,17597,11,362,240,122,7,17,5,2
9654,26,9727,16,2259313,91208,2168105,2847,1409,1118,1729
5911,360,5743,231,280,214,66,2,30,1,1
15444,10,3133,9,198,94,104,2,31,1,1
12801,727,17427,520,70,70,0,2,7,2,0
14543,10,26945,9,182,94,88,2,30,1,1
10232,26,21955,16,10301,4593,5708,21,121,10,11
14896,10,6513,9,196,100,96,2,30,1,1
3727,26,13298,16,25205,2243,22962,41,149,17,24
4261,26,16674,16,3936219,107920,3828299,3880,132,1208,2672
14501,10,2904,9,199,102,97,2,30,1,1
22692,10,5348,9,177,94,83,2,30,1,1
5973,26,8876,16,10331,2157,8174,37,137,18,19
8712,26,984,16,5519,945,4574,15,23,8,7
5894,26,26538,16,78,78,0,1,5,1,0
19292,15,9299,11,2500,531,1969,11,75,6,5
8584,1237,7680,917,249,78,171,2,31,1,1
15217,26,27826,16,7890,1901,5989,20,15,11,9
5512,10,7947,9,394,80,314,4,29,2,2
14877,10,0,0,238,94,144,2,29,1,1
22676,10,27880,9,204,104,100,2,31,1,1
22019,10,25099,9,183,94,89,2,30,1,1
8392,10,24655,9,295,101,194,4,49,2,2
4243,15,11028,11,1614,1300,314,10,15,5,5
10351,26,10056,16,7950,2502,5448,38,16,22,16
15731,10,21381,9,177,94,83,2,30,1,1
12739,26,27081,16,21288,10113,11175,107,31,51,56
14188,10,11076,9,180,92,88,2,30,1,1
4076,15,23142,11,1507,454,1053,10,15,5,5
22060,10,6455,9,340,95,245,4,47,2,2
9828,15,6306,11,62,62,0,1,5,1,0
13854,15,17853,11,1638,1324,314,10,15,5,5
9152,26,5258,16,214,82,132,4,5,2,2
15499,10,11546,9,711,87,624,2,30,1,1
6250,2016,12569,1546,208,86,122,4,30,2,2
10801,885,17302,654,70,70,0,2,8,2,0
11111,2656,14311,2063,316,136,180,6,6,3,3
5434,26,7215,16,130,70,60,3,5,2,1
15187,10,22185,9,184,94,90,2,30,1,1
8770,10,23304,9,179,94,85,2,30,1,1
21784,10,12794,9,94,94,0,1,29,1,0
12373,954,12190,704,70,70,0,1,5,1,0
11209,26,14450,16,7439,1156,6283,19,75,11,8
1673,341,17793,217,274,150,124,4,60,2,2
11170,2714,37,2108,70,70,0,2,8,2,0
9434,15,10347,11,2032,600,1432,10,45,6,4
13350,15,23336,11,2269,1579,690,10,77,6,4
8162,305,5500,199,276,70,206,5,32,2,3
3872,10,17512,9,168,78,90,2,31,1,1
14662,10,24277,9,537,98,439,4,40,2,2
7788,26,5433,16,14281,2906,11375,15,122,4,11
1193,26,26066,16,70553,6471,64082,141,182,69,72
10526,15,13317,11,3389,2054,1335,19,25,11,8
11090,15,17825,11,366,240,126,7,25,5,2
8118,26,6084,16,3108,1711,1397,24,813,11,13
1644,26,2682,16,2601,1455,1146,18,15,8,10
15425,10,27981,9,763,101,662,2,31,1,1
21645,10,22817,9,349,91,258,2,30,1,1
14679,10,28274,9,198,101,97,2,31,1,1
14631,10,21399,9,770,102,668,2,31,1,1
6250,1984,8161,1514,148,86,62,2,30,1,1
14454,26,333,16,190,70,120,4,15,2,2
16375,26,7731,16,3924,1906,2018,26,170,14,12
15604,10,5387,9,711,87,624,2,30,1,1
13680,10,24202,9,196,94,102,2,30,1,1
15344,10,22057,9,195,102,93,2,30,1,1
10015,15,22218,11,514,246,268,9,42,5,4
15191,10,8904,9,183,94,89,2,30,1,1
13968,26,7627,16,9458,2227,7231,23,15,12,11
3967,10,15086,9,825,99,726,2,31,1,1
8190,26,10137,16,26609,2444,24165,45,21,21,24
13710,10,22338,9,209,110,99,2,30,1,1
8590,10,19919,9,198,102,96,2,32,1,1
11053,2100,25352,1619,70,70,0,1,5,1,0
4974,26,18060,16,4392,1164,3228,17,34,9,8
4645,26,8347,16,9766,3093,6673,37,270,21,16
7554,10,20223,9,237,91,146,2,32,1,1
21824,10,5328,9,299,93,206,4,35,2,2
14334,6,24553,6,252,60,192,5,14,2,3
8403,15,9575,11,1904818,59945,1844873,1747,162,498,1249
11265,2491,20772,1938,136,136,0,3,14,3,0
8868,26,23422,16,42430,4111,38319,79,130,42,37
3334,26,26875,16,12375,6777,5598,28,49,13,15
14662,10,14673,9,196,102,94,2,30,1,1
12304,26,14367,16,17494,6818,10676,46,46,25,21
9354,26,22025,16,3792,871,2921,16,121,7,9
11064,15,26701,11,366,240,126,7,25,5,2
15056,10,2435,9,177,94,83,2,29,1,1
20194,10,21577,9,306,306,0,4,47,4,0
22444,10,11042,9,179,94,85,2,30,1,1
15067,10,22465,9,178,94,84,2,30,1,1
17978,26,3833,16,6869,3351,3518,22,135,11,11
19875,10,17847,9,263,86,177,2,29,1,1
21348,10,23698,9,304,101,203,4,37,2,2
20392,10,27946,9,240,98,142,2,29,1,1
14575,26,6287,16,9006,2048,6958,36,121,18,18
2744,1620,21147,1242,887,126,761,2,31,1,1
21831,15,28720,11,18594,5204,13390,42,26,25,17
12598,26,12790,16,499,425,74,4,0,3,1
12555,10,23577,9,216,98,118,2,29,1,1
8370,10,1370,9,403,99,304,4,32,2,2
8888,10,12318,9,215,94,121,2,30,1,1
4835,2960,4290,2297,6029,3652,2377,79,3221,45,34
21811,26,28692,16,9221,2109,7112,28,32,15,13
19569,26,2193,16,92202,65396,26806,193,3454,68,125
18319,15,4330,11,17231,6415,10816,26,149,12,14
11188,26,24984,16,2149,1549,600,14,45,8,6
5334,10,16940,9,233,90,143,2,32,1,1
15799,26,9429,16,291104,18601,272503,413,77,186,227
15001,10,15330,9,190,97,93,2,31,1,1
8119,26,2540,16,2661,1558,1103,18,807,7,11
20577,26,3011,16,8712,3748,4964,51,255,23,28
9076,26,18698,16,2048821,56490,1992331,2082,44,522,1560
13274,26,28012,16,4728282,133897,4594385,4756,80,1650,3106
16510,15,21084,11,3791,2804,987,14,31,8,6
5548,26,15788,16,4160,2228,1932,25,159,13,12
22266,10,2180,9,249,94,155,2,30,1,1
1624,15,5870,11,3360,2260,1100,19,61,11,8
9728,2886,27912,2241,166,166,0,1,1199,1,0
2876,26,4569,16,5577,1390,4187,19,15,9,10
8439,295,21412,190,3132,815,2317,14,15,7,7
18169,15,666,11,1114,534,580,12,15,7,5
10836,26,13389,16,19093,3390,15703,26,126,10,16
7931,26,16614,16,36324,2308,34016,55,81,22,33
3827,232,15012,147,26914,4119,22795,85,539,41,44
9538,15,21796,11,306,180,126,6,26,4,2
14955,10,8528,9,177,94,83,2,29,1,1
16955,26,3319,16,4801,2506,2295,12,121,6,6
5056,10,16614,9,203,82,121,2,30,1,1
20390,40,7977,23,9557,4773,4784,84,199,48,36
1291,26,4318,16,4902,861,4041,15,16,7,8
12592,1772,26827,1352,492,306,186,8,15,5,3
15290,10,8202,9,184,94,90,2,30,1,1
13062,10,14102,9,86,86,0,1,30,1,0
13678,10,26601,9,179,94,85,2,30,1,1
5492,26,3683,16,5761,3561,2200,45,51,23,22
22410,10,18463,9,277,110,167,2,30,1,1
14402,10,17429,9,216,110,106,2,29,1,1
8000,26,24560,16,5619,885,4734,17,26,9,8
21714,10,26764,9,211,102,109,2,29,1,1
5594,10,17324,9,235,90,145,2,32,1,1
17869,10,4543,9,304,86,218,2,30,1,1
1207,26,12510,16,130,70,60,3,5,2,1
5711,15,26784,11,898,543,355,10,255,6,4
18158,15,26634,11,246733,5745,240988,246,144,80,166
9175,10,15694,9,94,94,0,1,30,1,0
19007,26,27092,16,4400,1493,2907,19,29,11,8
5340,26,6206,16,334,140,194,6,25,3,3
8584,1238,20479,918,234,78,156,2,30,1,1
15414,2551,21623,1982,70,70,0,1,5,1,0
2046,2963,20689,2300,460,150,310,2,1200,1,1
22573,10,8439,9,301,108,193,4,54,2,2
13960,10,23932,9,304,94,210,2,30,1,1
22512,10,16461,9,285,103,182,4,43,2,2
1923,26,7368,16,1155,728,427,11,26,7,4
16134,26,12957,16,2614,1689,925,18,21,10,8
8574,10,1091,9,252,102,150,2,30,1,1
11497,15,24577,11,4183,3603,580,14,15,8,6
8806,10,2144,9,402,118,284,2,30,1,1
15233,10,256,9,170,87,83,2,30,1,1
8908,10,28461,9,731,91,640,2,30,1,1
5394,10,19539,9,199,94,105,2,29,1,1
14531,26,24662,16,4510,1603,2907,19,27,11,8
9011,15,12242,11,4135,2587,1548,10,89,7,3
8400,26,14535,16,9622,3524,6098,59,916,29,30
868,26,21994,16,4945,431,4514,12,15,6,6
14175,183,24467,121,3527,1638,1889,18,18,11,7
20060,10,15544,9,86,86,0,1,30,1,0
636,1467,2585,1117,509,150,359,2,1199,1,1
1417,15,4912,11,2144,1519,625,9,29,6,3
456,26,1583,16,14579,1280,13299,25,16,9,16
22675,10,23641,9,193,102,91,2,30,1,1
521,10,28541,9,220,78,142,2,30,1,1
14237,10,9040,9,178,94,84,2,30,1,1
21224,10,22644,9,274,90,184,4,56,2,2
22316,10,13504,9,406,142,264,2,30,1,1
7209,26,5966,16,7144,4917,2227,36,561,18,18
8525,26,5180,16,137147,82203,54944,174,105,103,71
14883,10,7295,9,173,94,79,2,30,1,1
14684,10,17088,9,167,86,81,2,31,1,1
8018,10,22744,9,199,94,105,2,30,1,1
11198,3132,12147,2431,70,70,0,1,5,1,0
14289,26,24529,16,24362,8850,15512,52,47,32,20
9492,15,10549,11,4929,2773,2156,17,42,9,8
17148,26,6630,16,2109,420,1689,11,121,6,5
12954,15,5982,11,1515,481,1034,11,15,6,5
17599,26,25994,16,5853,2409,3444,35,80,16,19
13646,26,19616,16,31183,3879,27304,52,19,26,26
5241,26,26964,16,3589,1251,2338,15,20,9,6
16922,26,25950,16,4396,1489,2907,19,26,11,8
8695,26,7376,16,9047,1436,7611,22,27,10,12
11346,10,8805,9,224,94,130,2,29,1,1
11119,753,6494,541,70,70,0,1,5,1,0
22281,10,24405,9,325,102,223,2,29,1,1
22162,10,22643,9,728,102,626,2,30,1,1
14157,15,28605,11,6138,1242,4896,15,40,7,8
9162,10,4499,9,467,90,377,4,39,2,2
18975,26,17512,16,22449,19500,2949,53,21,31,22
8968,15,346,11,2553,1621,932,13,126,8,5
7195,26,15606,16,137754,15176,122578,229,99,106,123
11267,26,22853,16,7718,2030,5688,23,20,11,12
15178,10,16880,9,168,86,82,2,30,1,1
13425,26,17527,16,3663,1136,2527,13,136,6,7
10953,516,22323,340,70,70,0,1,5,1,0
9207,26,28743,16,4551,2388,2163,16,120,8,8
22128,10,7984,9,177,94,83,2,29,1,1
8727,15,12126,11,57215,680,56535,47,135,7,40
2744,1447,9453,1100,876,126,750,2,31,1,1
15827,10,14996,9,211,102,109,2,30,1,1
22009,10,14328,9,179,94,85,2,30,1,1
18159,15,26635,11,355862,9048,346814,358,163,116,242
16747,10,19632,9,167,78,89,2,30,1,1
18547,601,28828,412,70,70,0,2,8,2,0
7741,10,20473,9,825,99,726,2,31,1,1
18300,26,18914,16,8989,3335,5654,65,152,31,34
2744,1309,5521,986,886,126,760,2,30,1,1
9737,26,7438,16,1745,1068,677,18,95,10,8
532,247,0,0,3354,1792,1562,46,195,23,23
15397,10,26639,9,184,94,90,2,30,1,1
14580,10,24689,9,233,90,143,2,33,1,1
15237,15,29072,11,234,234,0,4,12,4,0
14729,10,9497,9,542,112,430,4,34,2,2
15528,10,28671,9,183,94,89,2,30,1,1
11711,26,12574,16,122,62,60,2,15,1,1
12776,1382,19494,1051,492,306,186,8,15,5,3
22198,10,25313,9,196,102,94,2,31,1,1
9164,10,14198,9,216,110,106,2,30,1,1
17076,26,4412,16,7259,842,6417,27,290,9,18
608,15,2450,11,103631,2766,100865,110,39,38,72
7863,26,3486,16,11108,3774,7334,28,230,13,15
9599,15,16777,11,4395,3599,796,15,34,8,7
13633,10,28628,9,183,94,89,2,30,1,1
4629,26,26696,16,6927,1883,5044,25,46,14,11
9742,15,28387,11,17837,3830,14007,27,24,12,15
9574,10,1057,9,789,102,687,2,30,1,1
4138,10,15361,9,217,90,127,2,30,1,1
8953,26,20624,16,34175,1680,32495,42,126,15,27
222,26,541,16,46743,4890,41853,69,23,35,34
10359,26,20810,16,143597,6963,136634,206,439,103,103
8721,10,12718,9,193,102,91,2,30,1,1
11003,15,26446,11,21570,1613,19957,33,54,16,17
10982,26,8062,16,11367,3820,7547,28,28,16,12
11137,15,14993,11,9902,8772,1130,18,35,10,8
12150,555,26042,371,552,306,246,9,142,5,4
2744,1308,25236,985,884,126,758,2,30,1,1
21245,10,23916,9,180,94,86,2,31,1,1
12302,26,14545,16,10139,3656,6483,29,128,14,15
16001,11,16026,10,70,70,0,2,8,2,0
10389,26,16951,16,5839,3609,2230,25,361,13,12
11200,2267,6923,1754,70,70,0,2,8,2,0
7366,15,14548,11,5066,4404,662,11,30,6,5
21129,630,4204,436,66,66,0,2,8,2,0
15407,10,14781,9,214,102,112,2,29,1,1
15962,10,12223,9,761,100,661,2,30,1,1
21822,10,7718,9,177,94,83,2,30,1,1
4917,10,23926,9,199,94,105,2,31,1,1
9147,10,7880,9,267,110,157,2,30,1,1
15747,10,18609,9,177,94,83,2,30,1,1
22012,10,18138,9,178,94,84,2,29,1,1
15196,15,1681,11,234,234,0,4,12,4,0
5160,26,880,16,7352,3452,3900,18,15,10,8
5283,15,10569,11,1504,926,578,15,36,9,6
6250,2018,22207,1548,602,86,516,2,30,1,1
22420,10,7313,9,303,94,209,4,32,2,2
21415,10,1019,9,179,94,85,2,30,1,1
12516,15,27659,11,154478,6934,147544,194,24,86,108
8502,15,10959,11,1193,703,490,8,18,5,3
9161,10,292,9,209,110,99,2,30,1,1
12604,26,17152,16,8115,1962,6153,24,18,14,10
22348,10,3011,9,184,94,90,2,30,1,1
10007,10,6224,9,234,234,0,4,47,4,0
13645,10,5530,9,177,94,83,2,29,1,1
13228,26,24454,16,7548,2583,4965,26,362,12,14
10990,26,2607,16,8830,1950,6880,27,25,14,13
12563,2635,10226,2045,70,70,0,1,5,1,0
21178,2197,18300,1701,66,66,0,2,7,2,0
21385,26,7502,16,5060,3367,1693,21,102,12,9
22649,10,17455,9,197,102,95,2,30,1,1
13980,10,25664,9,994,86,908,2,30,1,1
13977,10,21492,9,194,94,100,2,30,1,1
12491,1541,7146,1174,70,70,0,2,7,2,0
14912,10,16644,9,760,97,663,2,30,1,1
17044,15,13539,11,4635,1572,3063,12,15,7,5
10904,2171,25742,1677,70,70,0,2,8,2,0
15929,10,14861,9,756,95,661,2,31,1,1
7277,26,22124,16,512213,34626,477587,741,147,283,458
21303,10,570,9,244,94,150,2,31,1,1
8586,10,16224,9,185,102,83,2,30,1,1
922,26,17326,16,6331,837,5494,19,28,10,9
8898,10,7286,9,178,94,84,2,30,1,1
12334,26,16810,16,8879,2420,6459,32,255,17,15
8443,10,17150,9,199,102,97,2,29,1,1
10953,15,24425,11,60441,6260,54181,79,29,35,44
10555,26,9499,16,7211,823,6388,16,15,10,6
5057,10,8930,9,168,78,90,2,30,1,1
1951,10,7492,9,225,87,138,2,31,1,1
12299,15,24791,11,1517,481,1036,11,15,6,5
14323,10,909,9,177,94,83,2,29,1,1
15880,10,25330,9,216,98,118,2,30,1,1
5293,10,16873,9,414,268,146,3,32,2,1
6479,15,28384,11,808,480,328,13,158,9,4
636,2650,9374,2058,324,150,174,2,1199,1,1
15512,10,14416,9,351,94,257,2,30,1,1
21374,2839,2087,2203,66,66,0,2,8,2,0
9728,280,8126,177,161,161,0,2,1200,2,0
6485,26,10909,16,9737,6695,3042,45,81,24,21
14976,26,10531,16,7018,2751,4267,24,39,11,13
6630,26,9787,16,10265,2118,8147,23,81,13,10
6300,26,25063,16,5378,1512,3866,20,16,11,9
11837,15,22769,11,1996,691,1305,10,359,6,4
11861,15,4622,11,3247,1730,1517,12,36,7,5
11297,26,3421,16,24712,9272,15440,65,136,34,31
14567,10,12966,9,275,86,189,2,29,1,1
11923,26,12309,16,15099,7828,7271,45,92,24,21
8210,42,21194,25,152,152,0,1,1200,1,0
21619,10,10411,9,257,110,147,2,30,1,1
8512,26,1387,16,61954,10029,51925,114,82,50,64
15382,26,21410,16,8020,2000,6020,20,16,11,9
22712,10,11346,9,228,94,134,2,30,1,1
9039,26,2365,16,31715,20427,11288,103,54,54,49
16021,2627,26569,2037,528,528,0,9,1199,9,0
11306,15,22880,11,259496,6676,252820,249,28,74,175
3690,10,25884,9,199,94,105,2,30,1,1
2296,10,9436,9,247,98,149,2,32,1,1
22470,10,6159,9,338,110,228,2,29,1,1
14033,26,24397,16,63319,6716,56603,91,19,45,46
21837,10,5045,9,212,110,102,2,30,1,1
14273,876,23021,645,320,140,180,6,6,3,3
15998,142,25383,101,156,156,0,3,8,3,0
15344,10,23320,9,183,94,89,2,30,1,1
5102,26,21067,16,5236,1549,3687,19,29,11,8
637,3035,27097,2360,221,111,110,2,1200,1,1
15223,10,6751,9,199,102,97,2,31,1,1
14897,10,4391,9,183,94,89,2,30,1,1
5314,18,2496,13,184,94,90,2,30,1,1
5463,10,17103,9,398,255,143,3,33,2,1
12004,1611,13513,1233,70,70,0,2,8,2,0
9704,26,12478,16,408090,25873,382217,748,137,354,394
8889,15,23460,11,2367,557,1810,10,82,6,4
13747,10,10359,9,188,96,92,2,30,1,1
14956,10,3027,9,170,87,83,2,30,1,1
21232,10,14686,9,206,105,101,2,31,1,1
11005,26,13016,16,4692,2376,2316,30,47,16,14
2195,10,8902,9,240,98,142,2,30,1,1
17435,10,16813,9,260,86,174,2,30,1,1
11076,3038,8761,2362,70,70,0,1,4,1,0
22382,10,3857,9,289,102,187,2,30,1,1
15905,26,10581,16,13048,4976,8072,40,140,18,22
1574,10,5659,9,240,98,142,2,30,1,1
9619,10,11041,9,772,100,672,2,31,1,1
9710,26,21947,16,11116,4583,6533,39,256,19,20
11708,15,8790,11,432,240,192,8,100,5,3
10563,26,14231,16,75323,6054,69269,110,38,52,58
17942,26,26523,16,21205,1711,19494,32,1806,11,21
14146,10,13390,9,747,93,654,2,30,1,1
13921,10,14308,9,170,87,83,2,31,1,1
14299,10,17282,9,196,102,94,2,33,1,1
14549,10,20667,9,177,94,83,2,29,1,1
12773,26,20837,16,360,360,0,7,4,7,0
15223,26,15939,16,1327,918,409,10,26,6,4
22196,10,4085,9,86,86,0,1,60,1,0
22010,10,3313,9,749,94,655,2,31,1,1
18454,2404,23431,1870,258,70,188,4,8,2,2
8177,26,7091,16,6644134,184008,6460126,6659,204,2197,4462
22321,10,10748,9,368,95,273,4,61,2,2
14551,10,7461,9,184,94,90,2,30,1,1
8210,301,21194,195,158,158,0,1,1200,1,0
14195,26,3749,16,8426,4752,3674,37,122,18,19
9,18,19094,13,184,94,90,2,30,1,1
13656,10,2262,9,196,102,94,2,30,1,1
14122,10,21106,9,199,102,97,2,29,1,1
15475,10,17948,9,768,99,669,2,30,1,1
8606,26,21197,16,3721809,103604,3618205,3808,156,1281,2527
15236,26,17096,16,7900,3324,4576,28,139,13,15
22012,10,18086,9,183,94,89,2,30,1,1
5652,26,13278,16,3146,766,2380,10,120,5,5
10862,2040,20316,1567,70,70,0,2,7,2,0
14456,10,11598,9,181,94,87,2,30,1,1
15048,10,28325,9,198,102,96,2,30,1,1
10803,1087,18333,797,70,70,0,2,8,2,0
9534,346,21943,220,378,180,198,7,54,4,3
2868,26,21878,16,5515,1388,4127,18,15,9,9
8761,10,10209,9,180,94,86,2,30,1,1
8975,15,9135,11,1469,979,490,10,125,6,4
9439,26,13052,16,6697,1606,5091,23,36,13,10
9028,15,18292,11,5205,1474,3731,9,88,5,4
21311,10,17221,9,194,102,92,2,31,1,1
5538,233,24381,148,5551,1338,4213,28,1323,11,17
9089,26,16339,16,19134,7361,11773,40,148,19,21
8062,26,3950,16,7320,1817,5503,41,106,16,25
15964,10,26052,9,190,97,93,2,30,1,1
10550,26,25294,16,7211,823,6388,16,15,10,6
21995,10,28805,9,241,98,143,2,30,1,1
22193,10,2642,9,321,97,224,4,57,2,2
22336,15,27429,11,2500,531,1969,11,76,6,5
17187,676,2952,475,138,78,60,2,6,1,1
10054,15,25294,11,9219616,105865,9113751,7687,120,1487,6200
8706,10,23324,9,198,110,88,2,30,1,1
12722,617,4967,425,320,140,180,6,5,3,3
14542,10,4938,9,193,102,91,2,29,1,1
21231,10,5609,9,186,95,91,2,31,1,1
11076,15,6240,11,27904,14100,13804,46,34,24,22
14309,1549,6060,1180,70,70,0,1,5,1,0
8639,15,22601,11,388,262,126,7,29,5,2
9044,26,22657,16,1087632,32231,1055401,1112,53,334,778
8210,280,21194,177,863,363,500,4,1200,2,2
5347,420,24439,273,170706,9877,160829,260,46,110,150
15670,10,25095,9,193,102,91,2,30,1,1
10954,1353,10344,1026,70,70,0,2,8,2,0
21731,10,11907,9,243,94,149,2,30,1,1
973,15,25865,11,318,192,126,6,26,4,2
22064,10,24683,9,785,110,675,2,30,1,1
8237,26,29034,16,8468,2867,5601,23,144,10,13
9177,10,3142,9,199,102,97,2,30,1,1
11004,2804,19063,2175,70,70,0,2,7,2,0
9411,1116,5196,821,132,132,0,3,1200,3,0
8858,10,8259,9,208,106,102,2,30,1,1
3904,26,2684,16,1461,980,481,11,25,7,4
9359,10,13105,9,749,94,655,2,30,1,1
21932,1277,1538,957,924,924,0,3,30,3,0
22232,10,12471,9,589,91,498,4,54,2,2
21843,10,2157,9,517,179,338,6,62,3,3
14285,10,24782,9,101,101,0,2,34,2,0
9050,26,9719,16,7488,1598,5890,25,50,13,12
8649,10,21583,9,172,88,84,2,30,1,1
18474,2969,22434,2305,70,70,0,2,8,2,0
19921,26,27645,16,119850,11021,108829,134,95,50,84
15126,10,8093,9,166,86,80,2,29,1,1
7953,15,20822,11,11976,6928,5048,25,24,14,11
6643,26,22206,16,466,392,74,4,0,3,1
14917,10,13486,9,260,102,158,2,30,1,1
8003,26,20883,16,4398,1491,2907,19,27,11,8
13681,10,7569,9,168,86,82,2,31,1,1
22104,10,7349,9,211,102,109,2,30,1,1
11975,15,5086,11,5259,1904,3355,30,15,23,7
9346,10,9965,9,199,102,97,2,30,1,1
8684,26,21534,16,103941,6635,97306,158,76,81,77
9010,15,16653,11,3215,2272,943,15,38,9,6
18089,26,26602,16,8589,2809,5780,30,16,15,15
9213,26,277,16,7912,3269,4643,23,96,12,11
7026,15,5367,11,1052,612,440,10,15,5,5
12951,26,20907,16,18716,8002,10714,100,945,51,49
22444,10,340,9,209,102,107,2,30,1,1
9618,15,21998,11,4994,855,4139,14,21,7,7
5524,26,9813,16,27886,17603,10283,138,462,76,62
22339,10,25120,9,196,100,96,2,31,1,1
19813,26,881,16,6095,1965,4130,26,46,15,11
21838,10,2891,9,250,86,164,4,30,2,2
636,3102,5600,2410,228,118,110,2,1200,1,1
21186,842,20398,620,66,66,0,2,7,2,0
4342,26,4123,16,416,210,206,7,27,4,3
15860,26,356,16,5612,733,4879,16,15,9,7
14891,10,16005,9,184,94,90,2,31,1,1
10687,15,10092,11,454,262,192,8,37,5,3
15341,10,26219,9,210,110,100,2,30,1,1
5274,26,27790,16,335190,17497,317693,449,42,211,238
4379,26,19378,16,7636,3367,4269,24,319,13,11
21391,10,19561,9,267,94,173,4,59,2,2
9401,10,10517,9,199,102,97,2,29,1,1
3949,18,2809,13,184,94,90,2,30,1,1
3325,10,14073,9,263,104,159,2,30,1,1
8394,10,27331,9,179,94,85,2,30,1,1
8375,10,3439,9,216,94,122,2,29,1,1
21503,10,19371,9,176,90,86,2,31,1,1
9144,26,26489,16,7227,4437,2790,29,271,16,13
13515,26,20230,16,3894,969,2925,20,153,9,11
18291,15,8406,11,3606,2572,1034,14,151,8,6
16021,1039,2554,763,353,166,187,2,1200,1,1
10787,2796,1352,2169,70,70,0,2,8,2,0
10497,26,19584,16,6286,1494,4792,22,16,11,11
7762,26,6887,16,16131,4542,11589,45,139,21,24
21271,26,112,16,4360,2142,2218,15,120,7,8
7256,26,24338,16,6697,1606,5091,23,17,13,10
16021,2898,2170,2251,132,132,0,3,1199,3,0
13675,10,19377,9,179,94,85,2,30,1,1
13845,10,10257,9,152,78,74,2,29,1,1
8584,1238,18275,918,234,71,163,2,31,1,1
6674,26,10201,16,17592,11518,6074,51,248,26,25
9716,15,8763,11,132,132,0,2,8,2,0
10983,3157,3732,2447,316,136,180,6,5,3,3
17897,26,11786,16,19224,2358,16866,38,28,15,23
7715,234,16953,149,3113,1395,1718,20,3608,8,12
7111,15,29079,11,1115,534,581,12,15,7,5
12244,26,15730,16,214,140,74,4,20,3,1
5526,26,25679,16,7542,1235,6307,23,15,12,11
5899,26,18158,16,65667,5371,60296,89,85,36,53
22058,10,10049,9,356,118,238,2,30,1,1
18007,183,26558,121,3504,1790,1714,17,32,9,8
6859,26,18930,16,13919,3349,10570,46,120,25,21
12386,26,17180,16,10583,1889,8694,28,251,10,18
8760,15,12944,11,25430,15577,9853,37,41,19,18
14938,10,3468,9,168,86,82,2,30,1,1
9278,10,24506,9,811,94,717,2,31,1,1
22415,10,25316,9,198,94,104,2,30,1,1
21653,10,20305,9,204,204,0,3,46,3,0
9664,10,3123,9,183,94,89,2,30,1,1
14329,1537,25834,1171,320,140,180,6,5,3,3
8480,26,1837,16,3185,2263,922,18,25,9,9
9687,26,12803,16,38667,3344,35323,56,210,24,32
10819,26,26770,16,6218,4326,1892,31,124,17,14
13950,10,13140,9,176,90,86,2,31,1,1
9567,15,14074,11,23470,2457,21013,31,22,13,18
15052,10,3815,9,209,110,99,2,29,1,1
14555,10,2888,9,177,94,83,2,29,1,1
4044,26,4559,16,1633,1038,595,14,34,8,6
8346,10,7810,9,309,118,191,2,30,1,1
15603,10,5251,9,283,101,182,4,38,2,2
15896,10,22920,9,196,94,102,2,30,1,1
9545,10,21952,9,200,90,110,2,30,1,1
15384,2043,7553,1570,70,70,0,1,5,1,0
1194,26,21527,16,293424,16379,277045,410,93,193,217
13722,10,24091,9,196,102,94,2,30,1,1
18818,15,6753,11,254,128,126,5,15,3,2
21763,10,24939,9,258,110,148,2,30,1,1
3494,26,27560,16,9348,1018,8330,22,256,11,11
21863,10,16755,9,182,102,80,2,30,1,1
15108,26,21423,16,215863,14423,201440,245,105,95,150
5493,26,5339,16,516080,28328,487752,660,95,305,355
7082,15,15875,11,233914,10359,223555,294,442,136,158
15087,10,16104,9,1165,94,1071,2,30,1,1
21535,10,17259,9,194,99,95,2,31,1,1
15780,10,23985,9,177,94,83,2,30,1,1
8783,15,13343,11,314,192,122,6,42,4,2
7118,26,14817,16,6641,4617,2024,34,80,18,16
22200,10,26923,9,214,102,112,2,30,1,1
14336,26,948,16,10710,4573,6137,53,3376,31,22
5270,26,27616,16,692830,23263,669567,784,114,306,478
7864,26,20695,16,4565,1658,2907,19,28,11,8
18393,15,19523,11,374,192,182,7,61,4,3
9592,26,17633,16,1119,595,524,12,26,6,6
14020,10,5688,9,177,94,83,2,30,1,1
13135,26,9494,16,6854,2318,4536,20,16,11,9
22164,10,573,9,232,94,138,2,30,1,1
12458,405,3890,263,928,541,387,8,17,5,3
9038,15,3734,11,9921,2945,6976,19,88,8,11
14735,10,12973,9,184,94,90,2,30,1,1
6366,26,18488,16,4620,1713,2907,19,26,11,8
5696,10,470,9,86,86,0,1,30,1,0
6056,26,20964,16,16107,3200,12907,35,362,17,18
13801,10,24273,9,240,98,142,2,30,1,1
14374,10,26724,9,186,95,91,2,30,1,1
8353,10,16561,9,198,102,96,2,30,1,1
15424,26,19227,16,7374,2085,5289,33,270,18,15
21137,15,4205,11,314,192,122,6,15,4,2
15020,15,9462,11,1272,389,883,16,394,4,12
16021,1941,19721,1481,14689,8867,5822,93,3051,67,26
15100,10,22364,9,177,94,83,2,30,1,1
15067,10,13975,9,178,94,84,2,30,1,1
18473,15,16808,11,186,64,122,4,27,2,2
19680,26,23,16,8829,3335,5494,16,126,9,7
10525,26,18997,16,186117,12962,173155,249,143,83,166
11075,767,29132,555,70,70,0,2,8,2,0
4364,15,15746,11,5529,713,4816,15,15,8,7
11905,15,8191,11,1601,761,840,10,334,6,4
2713,10,19105,9,222,86,136,2,30,1,1
8771,10,12762,9,756,95,661,2,30,1,1
1063,26,18587,16,7573,1528,6045,22,33,11,11
9486,15,8006,11,306,180,126,6,41,4,2
9728,2528,16696,1964,161,161,0,1,1200,1,0
9464,10,12215,9,756,95,661,2,30,1,1
2744,1238,19843,918,874,126,748,2,30,1,1
14888,10,25150,9,242,118,124,2,30,1,1
9034,10,7222,9,194,102,92,2,30,1,1
11479,26,4907,16,22753,7559,15194,31,16,16,15
8847,10,289,9,170,87,83,2,30,1,1
9023,26,9977,16,6065,1045,5020,20,60,11,9
16508,8,21687,8,1316,442,874,15,16,7,8
21257,2783,6461,2160,66,66,0,1,5,1,0
8210,2937,21194,2278,152,152,0,1,1200,1,0
4775,15,26822,11,1213,471,742,10,255,6,4
9013,26,21557,16,6117,976,5141,21,72,10,11
5344,26,7032,16,28301,21778,6523,88,125,49,39
7520,15,9947,11,1119,388,731,9,223,5,4
10929,2417,4702,1881,66,66,0,1,5,1,0
3749,15,23194,11,6260,696,5564,17,16,9,8
19194,26,27195,16,8480,2451,6029,21,17,12,9
8429,10,5423,9,168,86,82,2,29,1,1
19792,26,24857,16,7955,2503,5452,33,16,19,14
11672,26,19001,16,41870,3567,38303,68,15,34,34
14505,10,25080,9,711,87,624,2,30,1,1
6984,26,14943,16,8158,2927,5231,25,85,15,10
2435,10,10097,9,231,88,143,2,32,1,1
17391,26,26966,16,27431,19413,8018,71,175,36,35
22449,10,5284,9,199,102,97,2,29,1,1
9174,10,12049,9,330,126,204,2,31,1,1
6250,1982,13666,1512,206,84,122,4,30,2,2
9136,10,17616,9,184,94,90,2,30,1,1
13124,26,3425,16,10046,3300,6746,23,61,14,9
12814,26,29108,16,9921,2236,7685,35,32,17,18
841,26,2125,16,13750,4934,8816,64,167,31,33
13862,10,13865,9,179,94,85,2,30,1,1
10990,2985,5127,2319,70,70,0,2,8,2,0
21933,10,20707,9,258,102,156,2,30,1,1
545,2256,0,0,62,62,0,1,0,1,0
10775,1472,0,0,66,66,0,1,0,1,0
301,2256,0,0,62,62,0,1,0,1,0
12681,1888,0,0,66,66,0,1,0,1,0
13474,2587,0,0,66,66,0,1,0,1,0
18020,2144,0,0,145,145,0,1,0,1,0
15694,1787,0,0,145,145,0,1,0,1,0
3207,1888,0,0,62,62,0,1,0,1,0
2315,1771,0,0,66,66,0,1,0,1,0
7950,1147,0,0,62,62,0,1,0,1,0
2759,1017,0,0,62,62,0,1,0,1,0
4200,1147,0,0,66,66,0,1,0,1,0
47,2611,0,0,145,145,0,1,0,1,0
5789,3216,0,0,62,62,0,1,0,1,0
16951,255,0,0,62,62,0,1,0,1,0
18501,797,0,0,66,66,0,1,0,1,0
11450,1686,0,0,60,60,0,1,0,1,0
14096,2587,0,0,66,66,0,1,0,1,0
567,460,0,0,100,100,0,1,0,1,0
16256,697,0,0,66,66,0,1,0,1,0
952,183,0,0,66,66,0,1,0,1,0
8285,2256,0,0,62,62,0,1,0,1,0
2688,1017,0,0,62,62,0,1,0,1,0
16827,509,0,0,66,66,0,1,0,1,0
19812,1017,0,0,62,62,0,1,0,1,0
7335,1072,0,0,60,60,0,1,0,1,0
21995,3216,0,0,66,66,0,1,0,1,0
9473,1017,0,0,66,66,0,1,0,1,0
20379,2587,0,0,62,62,0,1,0,1,0
12,447,0,0,60,60,0,1,0,1,0
1593,2486,0,0,66,66,0,1,0,1,0
17736,1147,0,0,62,62,0,1,0,1,0
3174,2611,0,0,62,62,0,1,0,1,0
4488,2144,0,0,62,62,0,1,0,1,0
17149,3216,0,0,66,66,0,1,0,1,0
804,2587,0,0,62,62,0,1,0,1,0
19408,1880,0,0,66,66,0,1,0,1,0
401,1215,0,0,66,66,0,1,0,1,0
14601,1017,0,0,66,66,0,1,0,1,0
16951,255,0,0,62,62,0,1,0,1,0
28,3216,0,0,145,145,0,1,0,1,0
823,1675,0,0,60,60,0,1,0,1,0
13735,1147,0,0,62,62,0,1,0,1,0
1232,509,0,0,62,62,0,1,0,1,0
164,2636,0,0,62,62,0,1,0,1,0
7949,315,0,0,60,60,0,1,0,1,0
0,0,0,0,98,98,0,1,0,1,0
2719,1147,0,0,66,66,0,1,0,1,0
1263,1147,0,0,62,62,0,1,0,1,0
19644,1888,0,0,66,66,0,1,0,1,0
6552,2093,0,0,145,145,0,1,0,1,0
17957,2256,0,0,66,66,0,1,0,1,0
11757,1888,0,0,66,66,0,1,0,1,0
476,183,0,0,66,66,0,1,0,1,0
18263,1888,0,0,66,66,0,1,0,1,0
10621,2486,0,0,66,66,0,1,0,1,0
9959,2938,0,0,62,62,0,1,0,1,0
7620,3216,0,0,146,146,0,1,0,1,0
1320,797,0,0,62,62,0,1,0,1,0
4350,155,0,0,62,62,0,1,0,1,0
1804,1777,0,0,60,60,0,1,0,1,0
11756,1771,0,0,66,66,0,1,0,1,0
13681,1888,0,0,145,145,0,1,0,1,0
7336,2256,0,0,146,146,0,1,0,1,0
1203,1880,0,0,66,66,0,1,0,1,0
12,641,0,0,158,158,0,1,0,1,0
14694,2836,0,0,66,66,0,1,0,1,0
12,439,0,0,60,60,0,1,0,1,0
2314,1147,0,0,62,62,0,1,0,1,0
15607,2256,0,0,62,62,0,1,0,1,0
20268,2938,0,0,62,62,0,1,0,1,0
12746,1888,0,0,62,62,0,1,0,1,0
16951,255,0,0,62,62,0,1,0,1,0
6723,2587,0,0,146,146,0,1,0,1,0
48,1215,0,0,62,62,0,1,0,1,0
5567,2256,0,0,146,146,0,1,0,1,0
8221,2587,0,0,62,62,0,1,0,1,0
2285,2486,0,0,72,72,0,1,0,1,0
16951,255,0,0,62,62,0,1,0,1,0
1656,1147,0,0,146,146,0,1,0,1,0
11677,2636,0,0,66,66,0,1,0,1,0
5626,1147,0,0,146,146,0,1,0,1,0
5261,2747,0,0,146,146,0,1,0,1,0
8,442,0,0,60,60,0,1,0,1,0
11480,1888,0,0,66,66,0,1,0,1,0
4490,1147,0,0,62,62,0,1,0,1,0
742,2486,0,0,146,146,0,1,0,1,0
18271,1771,0,0,66,66,0,1,0,1,0
20733,1880,0,0,66,66,0,1,0,1,0
16951,255,0,0,62,62,0,1,0,1,0
1271,2938,0,0,62,62,0,1,0,1,0
15643,2938,0,0,62,62,0,1,0,1,0
523,983,0,0,62,62,0,1,0,1,0
3380,2587,0,0,62,62,0,1,0,1,0
14246,2883,0,0,62,62,0,1,0,1,0
6651,1129,0,0,156,156,0,1,0,1,0
1658,2587,0,0,66,66,0,1,0,1,0
7425,3216,0,0,62,62,0,1,0,1,0
1804,1765,0,0,60,60,0,1,0,1,0
7339,237,0,0,60,60,0,1,0,1,0
14690,2883,0,0,146,146,0,1,0,1,0
3877,1472,0,0,62,62,0,1,0,1,0
4347,1147,0,0,62,62,0,1,0,1,0
1720,1827,0,0,66,66,0,1,0,1,0
16951,255,0,0,62,62,0,1,0,1,0
2584,1677,0,0,160,160,0,1,0,1,0
10940,1888,0,0,62,62,0,1,0,1,0
18089,3216,0,0,66,66,0,1,0,1,0
11559,797,0,0,66,66,0,1,0,1,0
9245,2938,0,0,66,66,0,1,0,1,0
2440,2587,0,0,62,62,0,1,0,1,0
11427,1771,0,0,146,146,0,1,0,1,0
7509,218,0,0,60,60,0,1,0,1,0
13807,1880,0,0,66,66,0,1,0,1,0
12,3143,0,0,66,66,0,1,0,1,0
6063,2938,0,0,62,62,0,1,0,1,0
11142,1017,0,0,66,66,0,1,0,1,0
11593,3216,0,0,62,62,0,1,0,1,0
17620,2587,0,0,66,66,0,1,0,1,0
360,3105,0,0,164,164,0,1,0,1,0
1038,1771,0,0,62,62,0,1,0,1,0
17681,3216,0,0,62,62,0,1,0,1,0
1222,2256,0,0,62,62,0,1,0,1,0
8583,1919,0,0,66,66,0,1,0,1,0
7653,1224,0,0,60,60,0,1,0,1,0
6846,8,0,0,74,74,0,1,0,1,0
14977,255,0,0,60,60,0,1,0,1,0
10475,6,0,0,60,60,0,1,0,1,0
9566,2587,0,0,62,62,0,1,0,1,0
22448,1017,0,0,66,66,0,1,0,1,0
20745,1880,0,0,66,66,0,1,0,1,0
4841,3216,0,0,66,66,0,1,0,1,0
3193,2852,0,0,62,62,0,1,0,1,0
6877,3202,0,0,66,66,0,1,0,1,0
20777,1147,0,0,66,66,0,1,0,1,0
2102,3216,0,0,62,62,0,1,0,1,0
152,3216,0,0,66,66,0,1,0,1,0
7339,170,0,0,60,60,0,1,0,1,0
21425,3051,0,0,66,66,0,1,0,1,0
22268,1771,0,0,66,66,0,1,0,1,0
11453,1147,0,0,62,62,0,1,0,1,0
1957,3212,0,0,66,66,0,1,0,1,0
1877,1147,0,0,146,146,0,1,0,1,0
3010,2602,0,0,148,148,0,1,0,1,0
12,1932,0,0,82,82,0,1,0,1,0
1615,155,0,0,62,62,0,1,0,1,0
8171,1073,0,0,60,60,0,1,0,1,0
2092,155,0,0,66,66,0,1,0,1,0
19786,1147,0,0,62,62,0,1,0,1,0
16493,2636,0,0,146,146,0,1,0,1,0
12,312,0,0,60,60,0,1,0,1,0
803,1888,0,0,62,62,0,1,0,1,0
22169,245,0,0,60,60,0,1,0,1,0
6649,697,0,0,74,74,0,1,0,1,0
10933,1215,0,0,62,62,0,1,0,1,0
34,1471,0,0,159,159,0,1,0,1,0
737,7,0,0,60,60,0,1,0,1,0
19565,2587,0,0,66,66,0,1,0,1,0
7082,1539,0,0,66,66,0,1,0,1,0
18,1792,0,0,62,62,0,1,0,1,0
2548,874,0,0,60,60,0,1,0,1,0
3153,1017,0,0,62,62,0,1,0,1,0
11029,1888,0,0,62,62,0,1,0,1,0
360,3105,0,0,441,441,0,1,0,1,0
12995,3216,0,0,66,66,0,1,0,1,0
16910,2587,0,0,66,66,0,1,0,1,0
1502,2676,0,0,66,66,0,1,0,1,0
6708,1017,0,0,62,62,0,1,0,1,0
16941,1147,0,0,62,62,0,1,0,1,0
18319,2241,0,0,66,66,0,1,0,1,0
2847,2636,0,0,146,146,0,1,0,1,0
21908,1797,0,0,62,62,0,1,0,1,0
17111,2759,0,0,62,62,0,1,0,1,0
2660,1888,0,0,62,62,0,1,0,1,0
7575,104,0,0,60,60,0,1,0,1,0
9737,3216,0,0,62,62,0,1,0,1,0
800,2883,0,0,66,66,0,1,0,1,0
11964,1147,0,0,66,66,0,1,0,1,0
17624,1880,0,0,66,66,0,1,0,1,0
425,1771,0,0,66,66,0,1,0,1,0
16020,2938,0,0,66,66,0,1,0,1,0
11442,2883,0,0,66,66,0,1,0,1,0
8422,2256,0,0,66,66,0,1,0,1,0
12,526,0,0,74,74,0,1,0,1,0
16951,255,0,0,62,62,0,1,0,1,0
395,2695,0,0,62,62,0,1,0,1,0
2325,3216,0,0,62,62,0,1,0,1,0
732,1590,0,0,62,62,0,1,0,1,0
15882,1888,0,0,62,62,0,1,0,1,0
8171,1073,0,0,60,60,0,1,0,1,0
10600,1888,0,0,72,72,0,1,0,1,0
2584,1677,0,0,160,160,0,1,0,1,0
1604,1,0,0,62,62,0,1,0,1,0
7950,1147,0,0,62,62,0,1,0,1,0
1375,1147,0,0,62,62,0,1,0,1,0
3160,697,0,0,145,145,0,1,0,1,0
13483,104,0,0,60,60,0,1,0,1,0
8358,1771,0,0,62,62,0,1,0,1,0
16951,255,0,0,62,62,0,1,0,1,0
3186,2938,0,0,62,62,0,1,0,1,0
2401,2934,0,0,145,145,0,1,0,1,0
2601,104,0,0,60,60,0,1,0,1,0
16951,255,0,0,62,62,0,1,0,1,0
2616,1210,0,0,62,62,0,1,0,1,0
15286,1147,0,0,62,62,0,1,0,1,0
8443,2636,0,0,66,66,0,1,0,1,0
19820,2787,0,0,60,60,0,1,0,1,0
3006,2636,0,0,146,146,0,1,0,1,0
13847,1017,0,0,66,66,0,1,0,1,0
1448,2587,0,0,62,62,0,1,0,1,0
16660,1804,0,0,62,62,0,1,0,1,0
10367,1888,0,0,66,66,0,1,0,1,0
10119,1093,0,0,62,62,0,1,0,1,0
17709,2587,0,0,66,66,0,1,0,1,0
16951,255,0,0,62,62,0,1,0,1,0
14807,2205,0,0,62,62,0,1,0,1,0
20891,1147,0,0,62,62,0,1,0,1,0
17733,1804,0,0,66,66,0,1,0,1,0
14306,1589,0,0,66,66,0,1,0,1,0
15072,1476,0,0,146,146,0,1,0,1,0
6506,697,0,0,62,62,0,1,0,1,0
2510,2486,0,0,62,62,0,1,0,1,0
9781,1804,0,0,66,66,0,1,0,1,0
17677,2747,0,0,62,62,0,1,0,1,0
12621,1888,0,0,66,66,0,1,0,1,0
166,2486,0,0,62,62,0,1,0,1,0
6722,1719,0,0,146,146,0,1,0,1,0
263,1771,0,0,66,66,0,1,0,1,0
7000,2370,0,0,74,74,0,1,0,1,0
21143,1771,0,0,62,62,0,1,0,1,0
1509,1888,0,0,66,66,0,1,0,1,0
3848,1017,0,0,62,62,0,1,0,1,0
313,1215,0,0,62,62,0,1,0,1,0
3520,2256,0,0,62,62,0,1,0,1,0
1475,2636,0,0,62,62,0,1,0,1,0
2543,1795,0,0,62,62,0,1,0,1,0
1525,1444,0,0,145,145,0,1,0,1,0
18789,1827,0,0,62,62,0,1,0,1,0
9504,1888,0,0,66,66,0,1,0,1,0
11174,2521,0,0,62,62,0,1,0,1,0
16951,255,0,0,62,62,0,1,0,1,0
950,406,0,0,60,60,0,1,0,1,0
1553,2636,0,0,66,66,0,1,0,1,0
11834,183,0,0,60,60,0,1,0,1,0
8228,2587,0,0,66,66,0,1,0,1,0
160,1888,0,0,62,62,0,1,0,1,0
144,3216,0,0,66,66,0,1,0,1,0
2065,1017,0,0,62,62,0,1,0,1,0
19586,2256,0,0,66,66,0,1,0,1,0
12,2247,0,0,83,83,0,1,0,1,0
3849,2938,0,0,66,66,0,1,0,1,0
3005,1771,0,0,66,66,0,1,0,1,0
18614,1054,0,0,66,66,0,1,0,1,0
9057,1147,0,0,66,66,0,1,0,1,0
4803,2820,0,0,148,148,0,1,0,1,0
5,3216,0,0,62,62,0,1,0,1,0
91,2938,0,0,72,72,0,1,0,1,0
18778,2611,0,0,66,66,0,1,0,1,0
11653,3216,0,0,62,62,0,1,0,1,0
15035,104,0,0,60,60,0,1,0,1,0
1608,2477,0,0,60,60,0,1,0,1,0
12,3116,0,0,1484,1484,0,1,0,1,0
22217,1215,0,0,62,62,0,1,0,1,0
20842,3216,0,0,62,62,0,1,0,1,0
16558,1017,0,0,66,66,0,1,0,1,0
13190,1017,0,0,66,66,0,1,0,1,0
612,139,0,0,60,60,0,1,0,1,0
4206,1771,0,0,62,62,0,1,0,1,0
6831,2256,0,0,66,66,0,1,0,1,0
12,2346,0,0,332,332,0,1,0,1,0
6049,255,0,0,60,60,0,1,0,1,0
18789,1827,0,0,66,66,0,1,0,1,0
2763,1017,0,0,62,62,0,1,0,1,0
4496,1147,0,0,62,62,0,1,0,1,0
627,1215,0,0,66,66,0,1,0,1,0
2301,1946,0,0,60,60,0,1,0,1,0
588,2611,0,0,78,78,0,1,0,1,0
20504,1147,0,0,146,146,0,1,0,1,0
14058,2938,0,0,74,74,0,1,0,1,0
1535,2256,0,0,66,66,0,1,0,1,0
823,721,0,0,60,60,0,1,0,1,0
650,2820,0,0,139,139,0,1,0,1,0
12875,1147,0,0,66,66,0,1,0,1,0
1130,1888,0,0,62,62,0,1,0,1,0
7846,1215,0,0,62,62,0,1,0,1,0
9679,2636,0,0,66,66,0,1,0,1,0
8830,1888,0,0,66,66,0,1,0,1,0
1352,155,0,0,66,66,0,1,0,1,0
10670,2573,0,0,66,66,0,1,0,1,0
196,1771,0,0,66,66,0,1,0,1,0
17984,2256,0,0,62,62,0,1,0,1,0
16951,255,0,0,62,62,0,1,0,1,0
16478,248,0,0,60,60,0,1,0,1,0
9717,1017,0,0,62,62,0,1,0,1,0
375,3216,0,0,62,62,0,1,0,1,0
838,2256,0,0,66,66,0,1,0,1,0
1982,3216,0,0,62,62,0,1,0,1,0
22217,1215,0,0,66,66,0,1,0,1,0
7382,2636,0,0,62,62,0,1,0,1,0
14722,1888,0,0,66,66,0,1,0,1,0
5574,3,0,0,60,60,0,1,0,1,0
2157,3072,0,0,60,60,0,1,0,1,0
7335,1070,0,0,60,60,0,1,0,1,0
3257,1147,0,0,62,62,0,1,0,1,0
5968,3216,0,0,62,62,0,1,0,1,0
588,2611,0,0,78,78,0,1,0,1,0
21481,2604,0,0,66,66,0,1,0,1,0
20684,1202,0,0,159,159,0,1,0,1,0
18243,2733,0,0,66,66,0,1,0,1,0
766,3269,0,0,157,157,0,1,0,1,0
3489,2256,0,0,62,62,0,1,0,1,0
0,0,0,0,60,60,0,1,0,1,0
2865,1017,0,0,62,62,0,1,0,1,0
16844,2938,0,0,66,66,0,1,0,1,0
15987,697,0,0,62,62,0,1,0,1,0
12711,1888,0,0,66,66,0,1,0,1,0
4961,2256,0,0,66,66,0,1,0,1,0
17765,2382,0,0,66,66,0,1,0,1,0
20664,2733,0,0,62,62,0,1,0,1,0
2331,1017,0,0,146,146,0,1,0,1,0
13762,1936,0,0,66,66,0,1,0,1,0
3172,1147,0,0,146,146,0,1,0,1,0
4353,1888,0,0,62,62,0,1,0,1,0
297,2256,0,0,78,78,0,1,0,1,0
5690,104,0,0,60,60,0,1,0,1,0
3129,578,0,0,157,157,0,1,0,1,0
2462,2587,0,0,146,146,0,1,0,1,0
326,1888,0,0,62,62,0,1,0,1,0
375,3216,0,0,62,62,0,1,0,1,0
9248,2573,0,0,66,66,0,1,0,1,0
15007,1482,0,0,66,66,0,1,0,1,0
17136,2636,0,0,66,66,0,1,0,1,0
18211,1771,0,0,66,66,0,1,0,1,0
9706,1888,0,0,62,62,0,1,0,1,0
6439,1017,0,0,62,62,0,1,0,1,0
3851,2883,0,0,66,66,0,1,0,1,0
1411,1017,0,0,66,66,0,1,0,1,0
8756,2938,0,0,78,78,0,1,0,1,0
42,2938,0,0,62,62,0,1,0,1,0
1940,1590,0,0,62,62,0,1,0,1,0
162,2938,0,0,146,146,0,1,0,1,0
7344,2636,0,0,62,62,0,1,0,1,0
4357,255,0,0,60,60,0,1,0,1,0
15278,2587,0,0,66,66,0,1,0,1,0
16084,1147,0,0,66,66,0,1,0,1,0
7729,104,0,0,60,60,0,1,0,1,0
7335,1070,0,0,60,60,0,1,0,1,0
16951,255,0,0,62,62,0,1,0,1,0
20659,2953,0,0,62,62,0,1,0,1,0
9141,2938,0,0,62,62,0,1,0,1,0
7803,7,0,0,60,60,0,1,0,1,0
6133,10,0,0,60,60,0,1,0,1,0
9857,2938,0,0,66,66,0,1,0,1,0
11048,2953,0,0,66,66,0,1,0,1,0
2366,1147,0,0,146,146,0,1,0,1,0
17373,155,0,0,66,66,0,1,0,1,0
22447,1179,0,0,72,72,0,1,0,1,0
497,2220,0,0,66,66,0,1,0,1,0
2198,1017,0,0,62,62,0,1,0,1,0
14764,1880,0,0,66,66,0,1,0,1,0
129,1472,0,0,62,62,0,1,0,1,0
1929,3212,0,0,66,66,0,1,0,1,0
14722,1771,0,0,62,62,0,1,0,1,0
8782,1472,0,0,62,62,0,1,0,1,0
482,1888,0,0,66,66,0,1,0,1,0
326,1888,0,0,62,62,0,1,0,1,0
356,2380,0,0,62,62,0,1,0,1,0
1309,1017,0,0,62,62,0,1,0,1,0
108,183,0,0,60,60,0,1,0,1,0
7949,314,0,0,60,60,0,1,0,1,0
22412,2953,0,0,66,66,0,1,0,1,0
63,2256,0,0,146,146,0,1,0,1,0
5781,2093,0,0,157,157,0,1,0,1,0
12614,2636,0,0,66,66,0,1,0,1,0
414,3188,0,0,62,62,0,1,0,1,0
20838,2883,0,0,66,66,0,1,0,1,0
13529,914,0,0,66,66,0,1,0,1,0
1239,2144,0,0,62,62,0,1,0,1,0
9122,1827,0,0,66,66,0,1,0,1,0
17329,1771,0,0,66,66,0,1,0,1,0
20179,544,0,0,66,66,0,1,0,1,0
11719,3216,0,0,62,62,0,1,0,1,0
16478,17,0,0,60,60,0,1,0,1,0
2215,775,0,0,62,62,0,1,0,1,0
16951,255,0,0,62,62,0,1,0,1,0
6169,3051,0,0,66,66,0,1,0,1,0
1476,1771,0,0,62,62,0,1,0,1,0
17903,1147,0,0,62,62,0,1,0,1,0
11661,3216,0,0,62,62,0,1,0,1,0
9563,1215,0,0,66,66,0,1,0,1,0
16920,2587,0,0,66,66,0,1,0,1,0
16827,509,0,0,66,66,0,1,0,1,0
1371,2883,0,0,62,62,0,1,0,1,0
12078,3139,0,0,62,62,0,1,0,1,0
11411,383,0,0,66,66,0,1,0,1,0
16951,255,0,0,62,62,0,1,0,1,0
18547,1017,0,0,66,66,0,1,0,1,0
2948,1888,0,0,62,62,0,1,0,1,0
12,3227,0,0,60,60,0,1,0,1,0
22223,155,0,0,66,66,0,1,0,1,0
1283,509,0,0,62,62,0,1,0,1,0
12596,2587,0,0,62,62,0,1,0,1,0
9214,3257,0,0,60,60,0,1,0,1,0
1924,1054,0,0,66,66,0,1,0,1,0
259,1472,0,0,66,66,0,1,0,1,0
20013,2486,0,0,145,145,0,1,0,1,0
9859,2587,0,0,70,70,0,1,0,1,0
636,980,0,0,146,146,0,1,0,1,0
18632,1147,0,0,66,66,0,1,0,1,0
10154,1472,0,0,62,62,0,1,0,1,0
6439,2256,0,0,66,66,0,1,0,1,0
22718,1771,0,0,62,62,0,1,0,1,0
6177,1804,0,0,146,146,0,1,0,1,0
21352,1147,0,0,62,62,0,1,0,1,0
19003,2097,0,0,66,66,0,1,0,1,0
2666,1017,0,0,66,66,0,1,0,1,0
16951,255,0,0,62,62,0,1,0,1,0
11094,1017,0,0,62,62,0,1,0,1,0
2157,3072,0,0,60,60,0,1,0,1,0
18814,1147,0,0,66,66,0,1,0,1,0
6263,1017,0,0,66,66,0,1,0,1,0
19705,2636,0,0,62,62,0,1,0,1,0
13710,2235,0,0,62,62,0,1,0,1,0
8143,2587,0,0,146,146,0,1,0,1,0
639,2104,0,0,143,143,0,1,0,1,0
7016,7,0,0,60,60,0,1,0,1,0
745,1017,0,0,66,66,0,1,0,1,0
19343,804,0,0,62,62,0,1,0,1,0
7561,1804,0,0,62,62,0,1,0,1,0
3242,2440,0,0,66,66,0,1,0,1,0
2861,1215,0,0,66,66,0,1,0,1,0
11892,2739,0,0,66,66,0,1,0,1,0
16047,1888,0,0,62,62,0,1,0,1,0
8680,2675,0,0,162,162,0,1,0,1,0
22214,2938,0,0,78,78,0,1,0,1,0
22223,155,0,0,66,66,0,1,0,1,0
6922,1589,0,0,62,62,0,1,0,1,0
10940,1888,0,0,62,62,0,1,0,1,0
14215,2205,0,0,66,66,0,1,0,1,0
8743,2938,0,0,66,66,0,1,0,1,0
6454,2256,0,0,62,62,0,1,0,1,0
2658,1147,0,0,62,62,0,1,0,1,0
1914,2256,0,0,62,62,0,1,0,1,0
16715,697,0,0,66,66,0,1,0,1,0
18832,1888,0,0,62,62,0,1,0,1,0
1475,2636,0,0,62,62,0,1,0,1,0
4504,2486,0,0,62,62,0,1,0,1,0
1853,2938,0,0,62,62,0,1,0,1,0
845,280,0,0,66,66,0,1,0,1,0
7131,2587,0,0,62,62,0,1,0,1,0
2781,280,0,0,62,62,0,1,0,1,0
17557,2938,0,0,62,62,0,1,0,1,0
1804,2921,0,0,60,60,0,1,0,1,0
4182,2610,0,0,60,60,0,1,0,1,0
2223,1017,0,0,62,62,0,1,0,1,0
1178,1167,0,0,62,62,0,1,0,1,0
2482,3216,0,0,66,66,0,1,0,1,0
3164,1147,0,0,62,62,0,1,0,1,0
18377,2938,0,0,74,74,0,1,0,1,0
14612,3216,0,0,62,62,0,1,0,1,0
1407,1888,0,0,66,66,0,1,0,1,0
7339,2845,0,0,60,60,0,1,0,1,0
2406,1215,0,0,62,62,0,1,0,1,0
1850,3216,0,0,66,66,0,1,0,1,0
16444,2881,0,0,90,90,0,1,0,1,0
19164,1017,0,0,62,62,0,1,0,1,0
24,3216,0,0,62,62,0,1,0,1,0
7339,237,0,0,60,60,0,1,0,1,0
612,21,0,0,60,60,0,1,0,1,0
360,3105,0,0,451,451,0,1,0,1,0
20004,1147,0,0,66,66,0,1,0,1,0
18925,2550,0,0,66,66,0,1,0,1,0
17409,1147,0,0,146,146,0,1,0,1,0
2190,7,0,0,60,60,0,1,0,1,0
13304,1147,0,0,66,66,0,1,0,1,0
22093,432,0,0,66,66,0,1,0,1,0
164,2636,0,0,62,62,0,1,0,1,0
15854,2611,0,0,66,66,0,1,0,1,0
10396,1147,0,0,62,62,0,1,0,1,0
16477,3,0,0,60,60,0,1,0,1,0
22227,1888,0,0,66,66,0,1,0,1,0
7339,2845,0,0,60,60,0,1,0,1,0
10078,2256,0,0,66,66,0,1,0,1,0
8952,1147,0,0,66,66,0,1,0,1,0
1860,3139,0,0,62,62,0,1,0,1,0
19820,2787,0,0,60,60,0,1,0,1,0
18047,1880,0,0,62,62,0,1,0,1,0
3127,3216,0,0,62,62,0,1,0,1,0
7090,1936,0,0,74,74,0,1,0,1,0
2591,465,0,0,148,148,0,1,0,1,0
2968,1888,0,0,62,62,0,1,0,1,0
13878,1147,0,0,146,146,0,1,0,1,0
1244,1167,0,0,62,62,0,1,0,1,0
17945,2486,0,0,107,107,0,1,0,1,0
4319,1147,0,0,62,62,0,1,0,1,0
6787,7,0,0,60,60,0,1,0,1,0
10952,2256,0,0,62,62,0,1,0,1,0
9291,2587,0,0,62,62,0,1,0,1,0
18100,125,0,0,145,145,0,1,0,1,0
2802,1888,0,0,66,66,0,1,0,1,0
1274,1888,0,0,62,62,0,1,0,1,0
17467,2943,0,0,66,66,0,1,0,1,0
1855,1,0,0,62,62,0,1,0,1,0
8065,1147,0,0,66,66,0,1,0,1,0
18,2938,0,0,62,62,0,1,0,1,0
20639,3216,0,0,66,66,0,1,0,1,0
16275,2938,0,0,66,66,0,1,0,1,0
856,2256,0,0,62,62,0,1,0,1,0
12,1055,0,0,97,97,0,1,0,1,0
612,38,0,0,60,60,0,1,0,1,0
19587,2256,0,0,62,62,0,1,0,1,0
19224,7,0,0,60,60,0,1,0,1,0
360,3105,0,0,1290,1290,0,1,0,1,0
1576,2938,0,0,60,60,0,1,0,1,0
2972,2636,0,0,62,62,0,1,0,1,0
17372,2953,0,0,66,66,0,1,0,1,0
3233,1472,0,0,62,62,0,1,0,1,0
15401,1017,0,0,66,66,0,1,0,1,0
13662,983,0,0,66,66,0,1,0,1,0
16951,255,0,0,62,62,0,1,0,1,0
21,1147,0,0,146,146,0,1,0,1,0
21,1147,0,0,62,62,0,1,0,1,0
9972,3216,0,0,62,62,0,1,0,1,0
18042,1888,0,0,66,66,0,1,0,1,0
1730,1017,0,0,62,62,0,1,0,1,0
22430,2587,0,0,66,66,0,1,0,1,0
3316,1888,0,0,66,66,0,1,0,1,0
12,1001,0,0,66,66,0,1,0,1,0
6552,2093,0,0,145,145,0,1,0,1,0
3679,2486,0,0,145,145,0,1,0,1,0
14630,2636,0,0,146,146,0,1,0,1,0
202,899,0,0,62,62,0,1,0,1,0
733,1804,0,0,62,62,0,1,0,1,0
6194,2787,0,0,60,60,0,1,0,1,0
7339,140,0,0,60,60,0,1,0,1,0
612,399,0,0,60,60,0,1,0,1,0
778,1888,0,0,146,146,0,1,0,1,0
1589,2883,0,0,62,62,0,1,0,1,0
497,82,0,0,66,66,0,1,0,1,0
499,187,0,0,345,345,0,1,0,1,0
8667,509,0,0,66,66,0,1,0,1,0
580,2636,0,0,66,66,0,1,0,1,0
14980,1771,0,0,66,66,0,1,0,1,0
22406,1472,0,0,66,66,0,1,0,1,0
12483,1147,0,0,66,66,0,1,0,1,0
16951,255,0,0,62,62,0,1,0,1,0
1804,304,0,0,60,60,0,1,0,1,0
12,2568,0,0,331,331,0,1,0,1,0
13278,2256,0,0,66,66,0,1,0,1,0
14096,2587,0,0,62,62,0,1,0,1,0
14911,1804,0,0,62,62,0,1,0,1,0
3851,2883,0,0,62,62,0,1,0,1,0
6232,509,0,0,62,62,0,1,0,1,0
1986,1215,0,0,62,62,0,1,0,1,0
2711,3041,0,0,146,146,0,1,0,1,0
16805,3242,0,0,74,74,0,1,0,1,0
239,1888,0,0,66,66,0,1,0,1,0
12412,3216,0,0,66,66,0,1,0,1,0
12925,1827,0,0,66,66,0,1,0,1,0
6376,2899,0,0,74,74,0,1,0,1,0
16764,2938,0,0,66,66,0,1,0,1,0
16321,3216,0,0,66,66,0,1,0,1,0
19,1773,0,0,62,62,0,1,0,1,0
15251,1888,0,0,66,66,0,1,0,1,0
7335,1072,0,0,60,60,0,1,0,1,0
3168,1888,0,0,62,62,0,1,0,1,0
1752,3216,0,0,66,66,0,1,0,1,0
440,2587,0,0,62,62,0,1,0,1,0
12116,3212,0,0,62,62,0,1,0,1,0
2097,1888,0,0,62,62,0,1,0,1,0
16951,255,0,0,62,62,0,1,0,1,0
16951,255,0,0,62,62,0,1,0,1,0
19806,1017,0,0,66,66,0,1,0,1,0
20695,2938,0,0,66,66,0,1,0,1,0
10211,2938,0,0,66,66,0,1,0,1,0
5473,3139,0,0,66,66,0,1,0,1,0
438,2636,0,0,62,62,0,1,0,1,0
1265,1215,0,0,62,62,0,1,0,1,0
21206,1888,0,0,66,66,0,1,0,1,0
13010,1147,0,0,62,62,0,1,0,1,0
1732,1147,0,0,62,62,0,1,0,1,0
1355,1017,0,0,66,66,0,1,0,1,0
5688,1017,0,0,66,66,0,1,0,1,0
4724,1804,0,0,62,62,0,1,0,1,0
5947,7,0,0,60,60,0,1,0,1,0
11173,1880,0,0,66,66,0,1,0,1,0
16951,255,0,0,62,62,0,1,0,1,0
8084,2938,0,0,74,74,0,1,0,1,0
2697,2587,0,0,62,62,0,1,0,1,0
17323,1376,0,0,62,62,0,1,0,1,0
17636,2587,0,0,62,62,0,1,0,1,0
20752,10,0,0,73,73,0,1,0,1,0
19766,1771,0,0,66,66,0,1,0,1,0
3201,2938,0,0,60,60,0,1,0,1,0
14726,1880,0,0,62,62,0,1,0,1,0
5454,1888,0,0,62,62,0,1,0,1,0
6165,8,0,0,74,74,0,1,0,1,0
16951,255,0,0,62,62,0,1,0,1,0
612,2562,0,0,60,60,0,1,0,1,0
21980,509,0,0,62,62,0,1,0,1,0
11218,104,0,0,60,60,0,1,0,1,0
16894,2943,0,0,66,66,0,1,0,1,0
12,1932,0,0,82,82,0,1,0,1,0
16951,255,0,0,62,62,0,1,0,1,0
15444,812,0,0,66,66,0,1,0,1,0
1320,1888,0,0,62,62,0,1,0,1,0
3048,2256,0,0,66,66,0,1,0,1,0
1734,2538,0,0,146,146,0,1,0,1,0
4344,3216,0,0,62,62,0,1,0,1,0
1745,1888,0,0,146,146,0,1,0,1,0
2200,2573,0,0,62,62,0,1,0,1,0
21066,2611,0,0,62,62,0,1,0,1,0
1409,459,0,0,72,72,0,1,0,1,0
1700,1147,0,0,62,62,0,1,0,1,0
19349,983,0,0,66,66,0,1,0,1,0
20994,697,0,0,66,66,0,1,0,1,0
8025,2604,0,0,62,62,0,1,0,1,0
11308,2256,0,0,66,66,0,1,0,1,0
1493,1888,0,0,66,66,0,1,0,1,0
1281,2543,0,0,60,60,0,1,0,1,0
16951,255,0,0,62,62,0,1,0,1,0
2036,1888,0,0,66,66,0,1,0,1,0
367,1017,0,0,62,62,0,1,0,1,0
3940,1017,0,0,66,66,0,1,0,1,0
11121,509,0,0,66,66,0,1,0,1,0
20711,2256,0,0,62,62,0,1,0,1,0
13845,983,0,0,66,66,0,1,0,1,0
16537,2636,0,0,66,66,0,1,0,1,0
17350,2545,0,0,74,74,0,1,0,1,0
431,2587,0,0,62,62,0,1,0,1,0
3714,1017,0,0,62,62,0,1,0,1,0
20772,1804,0,0,66,66,0,1,0,1,0
20834,2636,0,0,66,66,0,1,0,1,0
2823,1771,0,0,66,66,0,1,0,1,0
496,1317,0,0,66,66,0,1,0,1,0
10615,432,0,0,66,66,0,1,0,1,0
16951,255,0,0,62,62,0,1,0,1,0
6863,7,0,0,60,60,0,1,0,1,0
8970,3216,0,0,62,62,0,1,0,1,0
12377,1017,0,0,62,62,0,1,0,1,0
2611,2883,0,0,66,66,0,1,0,1,0
637,2856,0,0,146,146,0,1,0,1,0
18376,2883,0,0,66,66,0,1,0,1,0
22046,1888,0,0,62,62,0,1,0,1,0
8164,2727,0,0,60,60,0,1,0,1,0
159,2636,0,0,62,62,0,1,0,1,0
20935,2604,0,0,66,66,0,1,0,1,0
16990,509,0,0,62,62,0,1,0,1,0
538,1888,0,0,62,62,0,1,0,1,0
12010,1147,0,0,62,62,0,1,0,1,0
20755,1147,0,0,66,66,0,1,0,1,0
16687,1888,0,0,66,66,0,1,0,1,0
1911,2587,0,0,62,62,0,1,0,1,0
2906,1888,0,0,62,62,0,1,0,1,0
15254,2636,0,0,62,62,0,1,0,1,0
8264,1147,0,0,66,66,0,1,0,1,0
587,1888,0,0,62,62,0,1,0,1,0
2125,2587,0,0,66,66,0,1,0,1,0
8043,1888,0,0,62,62,0,1,0,1,0
639,1748,0,0,143,143,0,1,0,1,0
6733,2573,0,0,72,72,0,1,0,1,0
16444,2881,0,0,90,90,0,1,0,1,0
20659,2953,0,0,66,66,0,1,0,1,0
14694,2836,0,0,66,66,0,1,0,1,0
13146,3216,0,0,62,62,0,1,0,1,0
3021,1472,0,0,66,66,0,1,0,1,0
844,1,0,0,62,62,0,1,0,1,0
17,1642,0,0,66,66,0,1,0,1,0
16951,255,0,0,62,62,0,1,0,1,0
1234,983,0,0,66,66,0,1,0,1,0
11508,1472,0,0,66,66,0,1,0,1,0
16951,255,0,0,62,62,0,1,0,1,0
7663,3216,0,0,62,62,0,1,0,1,0
823,1141,0,0,60,60,0,1,0,1,0
1617,1827,0,0,62,62,0,1,0,1,0
1683,7,0,0,60,60,0,1,0,1,0
10620,805,0,0,62,62,0,1,0,1,0
411,2636,0,0,62,62,0,1,0,1,0
1646,2636,0,0,62,62,0,1,0,1,0
2380,2256,0,0,62,62,0,1,0,1,0
6651,1129,0,0,156,156,0,1,0,1,0
13666,1147,0,0,66,66,0,1,0,1,0
3166,1,0,0,146,146,0,1,0,1,0
433,1224,0,0,60,60,0,1,0,1,0
1330,697,0,0,62,62,0,1,0,1,0
1164,3216,0,0,62,62,0,1,0,1,0
0,0,0,0,98,98,0,1,0,1,0
12342,1880,0,0,66,66,0,1,0,1,0
16951,255,0,0,62,62,0,1,0,1,0
12195,3212,0,0,66,66,0,1,0,1,0
12590,1147,0,0,66,66,0,1,0,1,0
11593,3216,0,0,62,62,0,1,0,1,0
1704,1215,0,0,62,62,0,1,0,1,0
22683,10,0,0,88,88,0,1,0,1,0
615,2252,0,0,66,66,0,1,0,1,0
17458,1147,0,0,66,66,0,1,0,1,0
1558,7,0,0,60,60,0,1,0,1,0
2649,1215,0,0,62,62,0,1,0,1,0
8,442,0,0,60,60,0,1,0,1,0
2135,1147,0,0,62,62,0,1,0,1,0
19603,3216,0,0,66,66,0,1,0,1,0
639,376,0,0,143,143,0,1,0,1,0
99,1462,0,0,62,62,0,1,0,1,0
1363,2883,0,0,66,66,0,1,0,1,0
17803,2587,0,0,66,66,0,1,0,1,0
592,1054,0,0,66,66,0,1,0,1,0
432,1771,0,0,62,62,0,1,0,1,0
19845,2938,0,0,66,66,0,1,0,1,0
13336,280,0,0,62,62,0,1,0,1,0
773,2611,0,0,62,62,0,1,0,1,0
19898,3216,0,0,62,62,0,1,0,1,0
823,2746,0,0,60,60,0,1,0,1,0
17607,2636,0,0,66,66,0,1,0,1,0
2787,1147,0,0,62,62,0,1,0,1,0
7881,956,0,0,62,62,0,1,0,1,0
3724,1147,0,0,66,66,0,1,0,1,0
7335,1070,0,0,60,60,0,1,0,1,0
345,1763,0,0,66,66,0,1,0,1,0
1966,2636,0,0,62,62,0,1,0,1,0
18401,1472,0,0,66,66,0,1,0,1,0
6166,1367,0,0,145,145,0,1,0,1,0
7335,1072,0,0,60,60,0,1,0,1,0
5186,1888,0,0,62,62,0,1,0,1,0
19407,3216,0,0,66,66,0,1,0,1,0
10163,1017,0,0,66,66,0,1,0,1,0
12,207,0,0,320,320,0,1,0,1,0
18,3216,0,0,62,62,0,1,0,1,0
8860,255,0,0,60,60,0,1,0,1,0
2726,1888,0,0,62,62,0,1,0,1,0
12,1055,0,0,97,97,0,1,0,1,0
1249,1215,0,0,66,66,0,1,0,1,0
1498,1215,0,0,62,62,0,1,0,1,0
3481,1147,0,0,62,62,0,1,0,1,0
1329,2636,0,0,66,66,0,1,0,1,0
2581,1215,0,0,66,66,0,1,0,1,0
16951,255,0,0,62,62,0,1,0,1,0
2157,3072,0,0,60,60,0,1,0,1,0
675,1888,0,0,66,66,0,1,0,1,0
2304,1215,0,0,62,62,0,1,0,1,0
8214,255,0,0,60,60,0,1,0,1,0
5436,2587,0,0,62,62,0,1,0,1,0
421,2587,0,0,66,66,0,1,0,1,0
5220,1147,0,0,62,62,0,1,0,1,0
18279,155,0,0,66,66,0,1,0,1,0
7335,1070,0,0,60,60,0,1,0,1,0
8222,2611,0,0,62,62,0,1,0,1,0
17058,1017,0,0,66,66,0,1,0,1,0
1875,1017,0,0,62,62,0,1,0,1,0
19236,7,0,0,60,60,0,1,0,1,0
19728,509,0,0,66,66,0,1,0,1,0
10575,1771,0,0,66,66,0,1,0,1,0
4047,1017,0,0,62,62,0,1,0,1,0
89,2739,0,0,146,146,0,1,0,1,0
19705,2636,0,0,62,62,0,1,0,1,0
17803,2636,0,0,62,62,0,1,0,1,0
2970,1472,0,0,62,62,0,1,0,1,0
636,280,0,0,146,146,0,1,0,1,0
572,1888,0,0,66,66,0,1,0,1,0
129,1472,0,0,66,66,0,1,0,1,0
16230,2266,0,0,148,148,0,1,0,1,0
17024,2205,0,0,66,66,0,1,0,1,0
6278,2938,0,0,66,66,0,1,0,1,0
13158,2883,0,0,66,66,0,1,0,1,0
10689,1215,0,0,62,62,0,1,0,1,0
8794,1771,0,0,66,66,0,1,0,1,0
7517,2938,0,0,62,62,0,1,0,1,0
14982,2636,0,0,62,62,0,1,0,1,0
15254,2636,0,0,146,146,0,1,0,1,0
353,797,0,0,62,62,0,1,0,1,0
17811,1880,0,0,66,66,0,1,0,1,0
18190,1472,0,0,62,62,0,1,0,1,0
12,3116,0,0,1484,1484,0,1,0,1,0
2824,1149,0,0,148,148,0,1,0,1,0
14306,1589,0,0,66,66,0,1,0,1,0
360,3105,0,0,214,214,0,1,0,1,0
15794,983,0,0,62,62,0,1,0,1,0
6233,1646,0,0,60,60,0,1,0,1,0
810,1017,0,0,66,66,0,1,0,1,0
11489,2587,0,0,62,62,0,1,0,1,0
2361,1147,0,0,62,62,0,1,0,1,0
16951,255,0,0,62,62,0,1,0,1,0
21381,3216,0,0,66,66,0,1,0,1,0
6552,2093,0,0,145,145,0,1,0,1,0
19104,1888,0,0,66,66,0,1,0,1,0
639,2266,0,0,159,159,0,1,0,1,0
10081,2353,0,0,62,62,0,1,0,1,0
24,1787,0,0,139,139,0,1,0,1,0
20721,3139,0,0,66,66,0,1,0,1,0
2748,2636,0,0,62,62,0,1,0,1,0
2431,1771,0,0,62,62,0,1,0,1,0
3061,1888,0,0,62,62,0,1,0,1,0
20857,2587,0,0,66,66,0,1,0,1,0
17365,2938,0,0,62,62,0,1,0,1,0
612,399,0,0,60,60,0,1,0,1,0
20,362,0,0,148,148,0,1,0,1,0
412,1147,0,0,62,62,0,1,0,1,0
6552,2093,0,0,145,145,0,1,0,1,0
2438,2486,0,0,160,160,0,1,0,1,0
3664,509,0,0,66,66,0,1,0,1,0
2577,2256,0,0,146,146,0,1,0,1,0
17644,1880,0,0,66,66,0,1,0,1,0
17400,2587,0,0,66,66,0,1,0,1,0
3191,509,0,0,62,62,0,1,0,1,0
1696,1888,0,0,62,62,0,1,0,1,0
7303,609,0,0,60,60,0,1,0,1,0
16582,2205,0,0,66,66,0,1,0,1,0
12,3165,0,0,100,100,0,1,0,1,0
844,2938,0,0,146,146,0,1,0,1,0
15917,847,0,0,66,66,0,1,0,1,0
12232,7,0,0,60,60,0,1,0,1,0
8171,1073,0,0,60,60,0,1,0,1,0
18547,1017,0,0,62,62,0,1,0,1,0
9906,1017,0,0,62,62,0,1,0,1,0
3242,2440,0,0,66,66,0,1,0,1,0
22468,201,0,0,78,78,0,1,0,1,0
21766,1888,0,0,62,62,0,1,0,1,0
800,2883,0,0,66,66,0,1,0,1,0
19898,3216,0,0,62,62,0,1,0,1,0
16444,2881,0,0,90,90,0,1,0,1,0
10582,2256,0,0,62,62,0,1,0,1,0
5894,7,0,0,60,60,0,1,0,1,0
16951,255,0,0,62,62,0,1,0,1,0
5626,1147,0,0,62,62,0,1,0,1,0
18873,2486,0,0,62,62,0,1,0,1,0
9781,1804,0,0,66,66,0,1,0,1,0
13697,2938,0,0,78,78,0,1,0,1,0
20538,2778,0,0,66,66,0,1,0,1,0
8266,491,0,0,146,146,0,1,0,1,0
8074,1147,0,0,62,62,0,1,0,1,0
12870,1804,0,0,66,66,0,1,0,1,0
557,1215,0,0,62,62,0,1,0,1,0
2759,1017,0,0,60,60,0,1,0,1,0
1827,1804,0,0,66,66,0,1,0,1,0
11729,2883,0,0,66,66,0,1,0,1,0
13282,1771,0,0,66,66,0,1,0,1,0
2746,3216,0,0,62,62,0,1,0,1,0
1984,2256,0,0,66,66,0,1,0,1,0
8583,1919,0,0,66,66,0,1,0,1,0
16951,255,0,0,62,62,0,1,0,1,0
20183,1147,0,0,62,62,0,1,0,1,0
12,3116,0,0,642,642,0,1,0,1,0
7339,141,0,0,60,60,0,1,0,1,0
13093,1936,0,0,145,145,0,1,0,1,0
8023,2587,0,0,62,62,0,1,0,1,0
13578,2636,0,0,62,62,0,1,0,1,0
8706,2587,0,0,66,66,0,1,0,1,0
9253,1472,0,0,62,62,0,1,0,1,0
16951,255,0,0,62,62,0,1,0,1,0
9240,2938,0,0,66,66,0,1,0,1,0
657,2471,0,0,139,139,0,1,0,1,0
3111,1482,0,0,62,62,0,1,0,1,0
15859,3139,0,0,66,66,0,1,0,1,0
5186,1888,0,0,62,62,0,1,0,1,0
2672,1147,0,0,62,62,0,1,0,1,0
18903,1147,0,0,66,66,0,1,0,1,0
76,2883,0,0,66,66,0,1,0,1,0
22272,1472,0,0,66,66,0,1,0,1,0
1843,38,0,0,60,60,0,1,0,1,0
16729,459,0,0,78,78,0,1,0,1,0
2402,2256,0,0,146,146,0,1,0,1,0
1577,829,0,0,62,62,0,1,0,1,0
18275,10,0,0,88,88,0,1,0,1,0
1374,1888,0,0,62,62,0,1,0,1,0
20136,1147,0,0,62,62,0,1,0,1,0
15450,1472,0,0,62,62,0,1,0,1,0
15735,2256,0,0,62,62,0,1,0,1,0
19913,1880,0,0,62,62,0,1,0,1,0
1526,775,0,0,62,62,0,1,0,1,0
10540,2943,0,0,100,100,0,1,0,1,0
16951,255,0,0,62,62,0,1,0,1,0
8,442,0,0,60,60,0,1,0,1,0
263,805,0,0,66,66,0,1,0,1,0
15158,1086,0,0,66,66,0,1,0,1,0
15908,3139,0,0,66,66,0,1,0,1,0
2543,1795,0,0,62,62,0,1,0,1,0
2945,3216,0,0,62,62,0,1,0,1,0
1502,2676,0,0,66,66,0,1,0,1,0
16951,255,0,0,62,62,0,1,0,1,0
17889,3139,0,0,66,66,0,1,0,1,0
13547,1147,0,0,62,62,0,1,0,1,0
19913,1880,0,0,66,66,0,1,0,1,0
10514,2747,0,0,62,62,0,1,0,1,0
4813,1086,0,0,62,62,0,1,0,1,0
962,1771,0,0,66,66,0,1,0,1,0
1449,1771,0,0,66,66,0,1,0,1,0
1934,2587,0,0,66,66,0,1,0,1,0
2348,3139,0,0,62,62,0,1,0,1,0
17129,3216,0,0,62,62,0,1,0,1,0
16076,1472,0,0,66,66,0,1,0,1,0
10419,2611,0,0,74,74,0,1,0,1,0
22482,2587,0,0,66,66,0,1,0,1,0
274,9,0,0,60,60,0,1,0,1,0
18660,2975,0,0,62,62,0,1,0,1,0
3894,697,0,0,62,62,0,1,0,1,0
10068,1017,0,0,62,62,0,1,0,1,0
1127,308,0,0,62,62,0,1,0,1,0
14493,308,0,0,66,66,0,1,0,1,0
6682,2256,0,0,62,62,0,1,0,1,0
18879,2587,0,0,66,66,0,1,0,1,0
2334,432,0,0,62,62,0,1,0,1,0
16951,255,0,0,62,62,0,1,0,1,0
373,1147,0,0,62,62,0,1,0,1,0
2969,1804,0,0,66,66,0,1,0,1,0
19130,2787,0,0,62,62,0,1,0,1,0
2549,1771,0,0,62,62,0,1,0,1,0
16951,255,0,0,62,62,0,1,0,1,0
6229,2938,0,0,78,78,0,1,0,1,0
7339,140,0,0,60,60,0,1,0,1,0
18406,1804,0,0,66,66,0,1,0,1,0
18117,3216,0,0,62,62,0,1,0,1,0
2540,2256,0,0,146,146,0,1,0,1,0
13666,1147,0,0,66,66,0,1,0,1,0
7949,314,0,0,60,60,0,1,0,1,0
14244,2883,0,0,66,66,0,1,0,1,0
2605,1147,0,0,62,62,0,1,0,1,0
1518,93,0,0,62,62,0,1,0,1,0
4099,2477,0,0,62,62,0,1,0,1,0
20407,5,0,0,60,60,0,1,0,1,0
2155,2636,0,0,62,62,0,1,0,1,0
9679,2636,0,0,62,62,0,1,0,1,0
7335,1069,0,0,60,60,0,1,0,1,0
2359,1017,0,0,66,66,0,1,0,1,0
2726,1888,0,0,62,62,0,1,0,1,0
22701,2256,0,0,66,66,0,1,0,1,0
20727,2938,0,0,66,66,0,1,0,1,0
10419,2611,0,0,74,74,0,1,0,1,0
22046,1827,0,0,66,66,0,1,0,1,0
16720,2587,0,0,62,62,0,1,0,1,0
17045,1472,0,0,66,66,0,1,0,1,0
2846,2953,0,0,146,146,0,1,0,1,0
11847,3212,0,0,66,66,0,1,0,1,0
11893,2636,0,0,66,66,0,1,0,1,0
18843,2587,0,0,62,62,0,1,0,1,0
11357,1017,0,0,66,66,0,1,0,1,0
3007,1215,0,0,62,62,0,1,0,1,0
1831,460,0,0,62,62,0,1,0,1,0
22482,2256,0,0,62,62,0,1,0,1,0
3493,7,0,0,60,60,0,1,0,1,0
8164,2727,0,0,60,60,0,1,0,1,0
10403,509,0,0,66,66,0,1,0,1,0
16951,255,0,0,62,62,0,1,0,1,0
12,2553,0,0,82,82,0,1,0,1,0
6898,1880,0,0,62,62,0,1,0,1,0
6699,1771,0,0,62,62,0,1,0,1,0
3670,2266,0,0,148,148,0,1,0,1,0
11268,1215,0,0,62,62,0,1,0,1,0
1820,1147,0,0,62,62,0,1,0,1,0
7373,2587,0,0,66,66,0,1,0,1,0
14637,93,0,0,66,66,0,1,0,1,0
3038,1888,0,0,62,62,0,1,0,1,0
6673,2558,0,0,62,62,0,1,0,1,0
10930,2486,0,0,146,146,0,1,0,1,0
16951,255,0,0,62,62,0,1,0,1,0
29,1888,0,0,62,62,0,1,0,1,0
1483,1147,0,0,146,146,0,1,0,1,0
5108,697,0,0,74,74,0,1,0,1,0
3477,2256,0,0,66,66,0,1,0,1,0
1606,465,0,0,159,159,0,1,0,1,0
1161,3216,0,0,62,62,0,1,0,1,0
639,2820,0,0,143,143,0,1,0,1,0
2610,1888,0,0,66,66,0,1,0,1,0
13456,1797,0,0,62,62,0,1,0,1,0
20754,1888,0,0,66,66,0,1,0,1,0
7335,1070,0,0,60,60,0,1,0,1,0
15987,697,0,0,66,66,0,1,0,1,0
16951,255,0,0,62,62,0,1,0,1,0
2471,1215,0,0,66,66,0,1,0,1,0
588,2611,0,0,78,78,0,1,0,1,0
15111,3051,0,0,145,145,0,1,0,1,0
10427,1017,0,0,66,66,0,1,0,1,0
19871,1017,0,0,66,66,0,1,0,1,0
21390,155,0,0,66,66,0,1,0,1,0
14826,1215,0,0,66,66,0,1,0,1,0
6448,2883,0,0,146,146,0,1,0,1,0
17161,1215,0,0,66,66,0,1,0,1,0
16951,255,0,0,62,62,0,1,0,1,0
1591,1888,0,0,62,62,0,1,0,1,0
7273,1888,0,0,62,62,0,1,0,1,0
15796,23,0,0,82,82,0,1,0,1,0
20893,1888,0,0,66,66,0,1,0,1,0
14967,2587,0,0,66,66,0,1,0,1,0
3730,1207,0,0,143,143,0,1,0,1,0
3482,631,0,0,78,78,0,1,0,1,0
6232,509,0,0,66,66,0,1,0,1,0
14641,2587,0,0,66,66,0,1,0,1,0
12342,1880,0,0,66,66,0,1,0,1,0
596,3216,0,0,145,145,0,1,0,1,0
8171,1073,0,0,60,60,0,1,0,1,0
1716,2636,0,0,62,62,0,1,0,1,0
2045,1147,0,0,62,62,0,1,0,1,0
17954,3139,0,0,66,66,0,1,0,1,0
13645,1827,0,0,62,62,0,1,0,1,0
60,1888,0,0,62,62,0,1,0,1,0
15540,1771,0,0,66,66,0,1,0,1,0
15099,1590,0,0,62,62,0,1,0,1,0
0,0,0,0,82,82,0,1,0,1,0
14329,2852,0,0,62,62,0,1,0,1,0
12849,2144,0,0,66,66,0,1,0,1,0
2299,146,0,0,60,60,0,1,0,1,0
7064,2587,0,0,62,62,0,1,0,1,0
1974,1147,0,0,62,62,0,1,0,1,0
16727,178,0,0,60,60,0,1,0,1,0
12229,1054,0,0,66,66,0,1,0,1,0
12055,3113,0,0,66,66,0,1,0,1,0
8171,1074,0,0,60,60,0,1,0,1,0
186,2486,0,0,66,66,0,1,0,1,0
16451,1472,0,0,62,62,0,1,0,1,0
16830,2943,0,0,66,66,0,1,0,1,0
1330,697,0,0,62,62,0,1,0,1,0
17821,2587,0,0,66,66,0,1,0,1,0
16407,1017,0,0,146,146,0,1,0,1,0
15660,1215,0,0,62,62,0,1,0,1,0
2658,1147,0,0,66,66,0,1,0,1,0
4978,2611,0,0,62,62,0,1,0,1,0
497,2220,0,0,220,220,0,1,0,1,0
436,3216,0,0,62,62,0,1,0,1,0
17459,2953,0,0,66,66,0,1,0,1,0
2114,1472,0,0,146,146,0,1,0,1,0
9673,2256,0,0,66,66,0,1,0,1,0
3022,1880,0,0,66,66,0,1,0,1,0
16951,255,0,0,62,62,0,1,0,1,0
5145,697,0,0,146,146,0,1,0,1,0
1463,7,0,0,60,60,0,1,0,1,0
3264,2636,0,0,62,62,0,1,0,1,0
3268,1888,0,0,62,62,0,1,0,1,0
17526,983,0,0,66,66,0,1,0,1,0
2721,1888,0,0,66,66,0,1,0,1,0
1591,1888,0,0,62,62,0,1,0,1,0
2622,7,0,0,60,60,0,1,0,1,0
1282,1147,0,0,146,146,0,1,0,1,0
52,674,0,0,146,146,0,1,0,1,0
5094,1888,0,0,62,62,0,1,0,1,0
14844,2256,0,0,66,66,0,1,0,1,0
20003,2558,0,0,62,62,0,1,0,1,0
664,1147,0,0,62,62,0,1,0,1,0
8121,2256,0,0,62,62,0,1,0,1,0
16951,255,0,0,62,62,0,1,0,1,0
9397,1771,0,0,66,66,0,1,0,1,0
11268,1215,0,0,62,62,0,1,0,1,0
20953,1472,0,0,62,62,0,1,0,1,0
12,151,0,0,135,135,0,1,0,1,0
2632,1936,0,0,62,62,0,1,0,1,0
9369,2154,0,0,66,66,0,1,0,1,0
3172,1147,0,0,62,62,0,1,0,1,0
8989,1147,0,0,62,62,0,1,0,1,0
3027,1880,0,0,62,62,0,1,0,1,0
3220,2432,0,0,159,159,0,1,0,1,0
16951,255,0,0,62,62,0,1,0,1,0
9351,2256,0,0,74,74,0,1,0,1,0
4000,2636,0,0,62,62,0,1,0,1,0
1737,3216,0,0,66,66,0,1,0,1,0
9128,3216,0,0,66,66,0,1,0,1,0
17200,1880,0,0,66,66,0,1,0,1,0
612,271,0,0,60,60,0,1,0,1,0
2748,2636,0,0,62,62,0,1,0,1,0
16951,255,0,0,62,62,0,1,0,1,0
13411,1472,0,0,62,62,0,1,0,1,0
22227,1888,0,0,66,66,0,1,0,1,0
16951,255,0,0,62,62,0,1,0,1,0
763,1888,0,0,62,62,0,1,0,1,0
3319,2611,0,0,66,66,0,1,0,1,0
945,1590,0,0,72,72,0,1,0,1,0
6309,2938,0,0,60,60,0,1,0,1,0
6700,2787,0,0,109,109,0,1,0,1,0
8043,1888,0,0,62,62,0,1,0,1,0
10462,280,0,0,66,66,0,1,0,1,0
7339,170,0,0,60,60,0,1,0,1,0
1698,1147,0,0,146,146,0,1,0,1,0
8093,2256,0,0,62,62,0,1,0,1,0
20802,2256,0,0,66,66,0,1,0,1,0
12,658,0,0,131,131,0,1,0,1,0
13710,2883,0,0,66,66,0,1,0,1,0
8168,2938,0,0,62,62,0,1,0,1,0
2415,2093,0,0,146,146,0,1,0,1,0
15263,1147,0,0,66,66,0,1,0,1,0
499,187,0,0,601,601,0,1,0,1,0
17449,2611,0,0,66,66,0,1,0,1,0
103,562,0,0,66,66,0,1,0,1,0
16703,2608,0,0,66,66,0,1,0,1,0
7835,255,0,0,60,60,0,1,0,1,0
16951,255,0,0,62,62,0,1,0,1,0
5067,1147,0,0,66,66,0,1,0,1,0
2068,31,0,0,60,60,0,1,0,1,0
7694,1,0,0,62,62,0,1,0,1,0
9706,1888,0,0,66,66,0,1,0,1,0
16951,255,0,0,62,62,0,1,0,1,0
16951,255,0,0,62,62,0,1,0,1,0
497,1050,0,0,60,60,0,1,0,1,0
15368,2883,0,0,62,62,0,1,0,1,0
10474,2477,0,0,72,72,0,1,0,1,0
0,0,0,0,98,98,0,1,0,1,0
16951,255,0,0,62,62,0,1,0,1,0
14982,2636,0,0,66,66,0,1,0,1,0
13336,280,0,0,66,66,0,1,0,1,0
22046,1888,0,0,62,62,0,1,0,1,0
12961,255,0,0,60,60,0,1,0,1,0
4969,255,0,0,60,60,0,1,0,1,0
1322,280,0,0,62,62,0,1,0,1,0
575,2205,0,0,74,74,0,1,0,1,0
3853,1539,0,0,62,62,0,1,0,1,0
13238,1880,0,0,66,66,0,1,0,1,0
7335,1072,0,0,60,60,0,1,0,1,0
16275,2938,0,0,66,66,0,1,0,1,0
6106,2587,0,0,66,66,0,1,0,1,0
3061,1888,0,0,66,66,0,1,0,1,0
15007,1482,0,0,66,66,0,1,0,1,0
12,2247,0,0,83,83,0,1,0,1,0
9819,2883,0,0,66,66,0,1,0,1,0
9222,1787,0,0,148,148,0,1,0,1,0
5051,2930,0,0,62,62,0,1,0,1,0
15694,1515,0,0,145,145,0,1,0,1,0
2259,2636,0,0,66,66,0,1,0,1,0
6651,1129,0,0,156,156,0,1,0,1,0
5422,1888,0,0,66,66,0,1,0,1,0
17456,2587,0,0,62,62,0,1,0,1,0
8773,1147,0,0,66,66,0,1,0,1,0
8970,3216,0,0,66,66,0,1,0,1,0
3186,2938,0,0,62,62,0,1,0,1,0
15859,3139,0,0,66,66,0,1,0,1,0
240,2205,0,0,62,62,0,1,0,1,0
10052,3057,0,0,66,66,0,1,0,1,0
20501,1771,0,0,66,66,0,1,0,1,0
5332,3216,0,0,62,62,0,1,0,1,0
20786,1147,0,0,66,66,0,1,0,1,0
16861,983,0,0,66,66,0,1,0,1,0
497,653,0,0,220,220,0,1,0,1,0
16951,255,0,0,62,62,0,1,0,1,0
8667,509,0,0,62,62,0,1,0,1,0
13801,155,0,0,66,66,0,1,0,1,0
3213,1472,0,0,62,62,0,1,0,1,0
13074,181,0,0,60,60,0,1,0,1,0
22414,1017,0,0,146,146,0,1,0,1,0
11750,2611,0,0,66,66,0,1,0,1,0
597,1017,0,0,62,62,0,1,0,1,0
19943,155,0,0,66,66,0,1,0,1,0
6443,3216,0,0,145,145,0,1,0,1,0
6862,1215,0,0,62,62,0,1,0,1,0
10172,2587,0,0,66,66,0,1,0,1,0
13270,1147,0,0,146,146,0,1,0,1,0
2019,3216,0,0,62,62,0,1,0,1,0
19130,2787,0,0,62,62,0,1,0,1,0
577,2611,0,0,78,78,0,1,0,1,0
3062,7,0,0,60,60,0,1,0,1,0
16256,697,0,0,62,62,0,1,0,1,0
21243,2587,0,0,66,66,0,1,0,1,0
13662,983,0,0,66,66,0,1,0,1,0
1234,983,0,0,66,66,0,1,0,1,0
13858,2747,0,0,66,66,0,1,0,1,0
7425,3216,0,0,62,62,0,1,0,1,0
12391,2382,0,0,66,66,0,1,0,1,0
14101,1017,0,0,62,62,0,1,0,1,0
12,1420,0,0,82,82,0,1,0,1,0
5327,1888,0,0,62,62,0,1,0,1,0
13093,1936,0,0,62,62,0,1,0,1,0
372,2636,0,0,66,66,0,1,0,1,0
16951,255,0,0,62,62,0,1,0,1,0
14575,2953,0,0,66,66,0,1,0,1,0
9444,1888,0,0,62,62,0,1,0,1,0
497,1610,0,0,66,66,0,1,0,1,0
14076,1888,0,0,66,66,0,1,0,1,0
4488,2144,0,0,62,62,0,1,0,1,0
20437,2938,0,0,74,74,0,1,0,1,0
16951,255,0,0,62,62,0,1,0,1,0
16582,2205,0,0,66,66,0,1,0,1,0
21718,3216,0,0,66,66,0,1,0,1,0
4764,226,0,0,60,60,0,1,0,1,0
636,2938,0,0,100,100,0,1,0,1,0
101,1771,0,0,66,66,0,1,0,1,0
2023,2953,0,0,66,66,0,1,0,1,0
3223,383,0,0,66,66,0,1,0,1,0
18542,2938,0,0,62,62,0,1,0,1,0
16144,1397,0,0,66,66,0,1,0,1,0
17620,2587,0,0,66,66,0,1,0,1,0
1508,1147,0,0,62,62,0,1,0,1,0
11988,1147,0,0,66,66,0,1,0,1,0
569,1147,0,0,62,62,0,1,0,1,0
12190,2587,0,0,66,66,0,1,0,1,0
17803,2636,0,0,66,66,0,1,0,1,0
13630,697,0,0,66,66,0,1,0,1,0
12799,1462,0,0,66,66,0,1,0,1,0
24,3216,0,0,62,62,0,1,0,1,0
13365,1827,0,0,146,146,0,1,0,1,0
773,2611,0,0,62,62,0,1,0,1,0
2084,1471,0,0,145,145,0,1,0,1,0
20370,1771,0,0,66,66,0,1,0,1,0
16660,1804,0,0,66,66,0,1,0,1,0
16022,3139,0,0,66,66,0,1,0,1,0
2717,2256,0,0,62,62,0,1,0,1,0
1884,509,0,0,66,66,0,1,0,1,0
1957,3212,0,0,62,62,0,1,0,1,0
641,1834,0,0,159,159,0,1,0,1,0
5424,1017,0,0,62,62,0,1,0,1,0
9870,2938,0,0,78,78,0,1,0,1,0
9348,3216,0,0,66,66,0,1,0,1,0
16659,1771,0,0,66,66,0,1,0,1,0
1914,2256,0,0,62,62,0,1,0,1,0
19031,2256,0,0,66,66,0,1,0,1,0
16951,255,0,0,62,62,0,1,0,1,0
7335,1070,0,0,60,60,0,1,0,1,0
18,2573,0,0,62,62,0,1,0,1,0
8164,2729,0,0,60,60,0,1,0,1,0
1382,2587,0,0,66,66,0,1,0,1,0
7141,3216,0,0,72,72,0,1,0,1,0
6294,1017,0,0,62,62,0,1,0,1,0
3060,1888,0,0,72,72,0,1,0,1,0
16951,255,0,0,62,62,0,1,0,1,0
22093,432,0,0,66,66,0,1,0,1,0
8680,2675,0,0,162,162,0,1,0,1,0
2361,1147,0,0,66,66,0,1,0,1,0
8171,1073,0,0,60,60,0,1,0,1,0
16951,255,0,0,62,62,0,1,0,1,0
1654,1936,0,0,145,145,0,1,0,1,0
16656,2953,0,0,66,66,0,1,0,1,0
10514,2747,0,0,66,66,0,1,0,1,0
6839,2573,0,0,145,145,0,1,0,1,0
360,3105,0,0,967,967,0,1,0,1,0
11369,2836,0,0,66,66,0,1,0,1,0
3152,2587,0,0,62,62,0,1,0,1,0
408,3216,0,0,62,62,0,1,0,1,0
1770,6,0,0,60,60,0,1,0,1,0
0,0,0,0,98,98,0,1,0,1,0
22537,2382,0,0,62,62,0,1,0,1,0
14753,3139,0,0,66,66,0,1,0,1,0
10106,2883,0,0,66,66,0,1,0,1,0
10211,2938,0,0,66,66,0,1,0,1,0
11756,1771,0,0,66,66,0,1,0,1,0
11778,432,0,0,62,62,0,1,0,1,0
8963,1147,0,0,66,66,0,1,0,1,0
2430,2938,0,0,62,62,0,1,0,1,0
3114,2883,0,0,66,66,0,1,0,1,0
18415,2587,0,0,66,66,0,1,0,1,0
1804,3191,0,0,60,60,0,1,0,1,0
15457,1017,0,0,62,62,0,1,0,1,0
13792,1472,0,0,66,66,0,1,0,1,0
7270,1472,0,0,62,62,0,1,0,1,0
1740,2073,0,0,66,66,0,1,0,1,0
9461,1888,0,0,66,66,0,1,0,1,0
1725,1017,0,0,62,62,0,1,0,1,0
348,2256,0,0,78,78,0,1,0,1,0
75,1147,0,0,146,146,0,1,0,1,0
823,1487,0,0,60,60,0,1,0,1,0
20735,2778,0,0,78,78,0,1,0,1,0
6220,1804,0,0,146,146,0,1,0,1,0
4047,1017,0,0,66,66,0,1,0,1,0
3079,2486,0,0,145,145,0,1,0,1,0
1905,280,0,0,66,66,0,1,0,1,0
18955,2500,0,0,66,66,0,1,0,1,0
17129,3216,0,0,66,66,0,1,0,1,0
365,1147,0,0,62,62,0,1,0,1,0
12037,1888,0,0,62,62,0,1,0,1,0
13404,1888,0,0,62,62,0,1,0,1,0
13539,104,0,0,60,60,0,1,0,1,0
453,1797,0,0,66,66,0,1,0,1,0
1383,3216,0,0,62,62,0,1,0,1,0
13146,3216,0,0,62,62,0,1,0,1,0
11029,1888,0,0,62,62,0,1,0,1,0
19315,3212,0,0,66,66,0,1,0,1,0
1965,1888,0,0,62,62,0,1,0,1,0
16951,255,0,0,62,62,0,1,0,1,0
1551,2953,0,0,62,62,0,1,0,1,0
6374,255,0,0,60,60,0,1,0,1,0
17456,357,0,0,66,66,0,1,0,1,0
20735,2778,0,0,78,78,0,1,0,1,0
21980,509,0,0,62,62,0,1,0,1,0
11778,432,0,0,62,62,0,1,0,1,0
2750,1147,0,0,62,62,0,1,0,1,0
11428,3216,0,0,62,62,0,1,0,1,0
20602,1147,0,0,66,66,0,1,0,1,0
1804,1195,0,0,60,60,0,1,0,1,0
615,18,0,0,90,90,0,1,0,1,0
3088,1804,0,0,62,62,0,1,0,1,0
10775,2938,0,0,62,62,0,1,0,1,0
17636,2587,0,0,66,66,0,1,0,1,0
21552,1215,0,0,62,62,0,1,0,1,0
16951,255,0,0,62,62,0,1,0,1,0
17393,2938,0,0,66,66,0,1,0,1,0
2259,2636,0,0,62,62,0,1,0,1,0
2906,1888,0,0,62,62,0,1,0,1,0
1864,2938,0,0,62,62,0,1,0,1,0
15817,2611,0,0,66,66,0,1,0,1,0
19,1773,0,0,62,62,0,1,0,1,0
1500,3216,0,0,62,62,0,1,0,1,0
9438,1017,0,0,62,62,0,1,0,1,0
1318,2636,0,0,66,66,0,1,0,1,0
2600,3216,0,0,62,62,0,1,0,1,0
5521,1215,0,0,62,62,0,1,0,1,0
15735,2256,0,0,62,62,0,1,0,1,0
22707,252,0,0,62,62,0,1,0,1,0
4115,939,0,0,62,62,0,1,0,1,0
22200,2573,0,0,66,66,0,1,0,1,0
16951,255,0,0,62,62,0,1,0,1,0
2796,1017,0,0,62,62,0,1,0,1,0
597,1017,0,0,66,66,0,1,0,1,0
1444,509,0,0,62,62,0,1,0,1,0
0,0,0,0,98,98,0,1,0,1,0
1387,1771,0,0,66,66,0,1,0,1,0
7425,3216,0,0,62,62,0,1,0,1,0
2762,1147,0,0,66,66,0,1,0,1,0
20712,2702,0,0,66,66,0,1,0,1,0
20006,1215,0,0,62,62,0,1,0,1,0
16951,255,0,0,62,62,0,1,0,1,0
18789,1827,0,0,66,66,0,1,0,1,0
1984,2256,0,0,66,66,0,1,0,1,0
18217,2587,0,0,66,66,0,1,0,1,0
2301,1946,0,0,60,60,0,1,0,1,0
1467,3139,0,0,62,62,0,1,0,1,0
13093,1771,0,0,62,62,0,1,0,1,0
20907,1017,0,0,146,146,0,1,0,1,0
1984,2587,0,0,146,146,0,1,0,1,0
22432,1054,0,0,66,66,0,1,0,1,0
9768,2587,0,0,66,66,0,1,0,1,0
11442,2883,0,0,66,66,0,1,0,1,0
14,2380,0,0,62,62,0,1,0,1,0
12,2247,0,0,83,83,0,1,0,1,0
1330,2943,0,0,62,62,0,1,0,1,0
11364,3139,0,0,66,66,0,1,0,1,0
4617,1147,0,0,66,66,0,1,0,1,0
16284,1880,0,0,66,66,0,1,0,1,0
8370,2604,0,0,62,62,0,1,0,1,0
744,2587,0,0,62,62,0,1,0,1,0
8651,509,0,0,66,66,0,1,0,1,0
18,3216,0,0,62,62,0,1,0,1,0
541,1804,0,0,66,66,0,1,0,1,0
16008,2938,0,0,62,62,0,1,0,1,0
19093,2573,0,0,62,62,0,1,0,1,0
8093,2256,0,0,62,62,0,1,0,1,0
1861,1147,0,0,66,66,0,1,0,1,0
3098,2573,0,0,66,66,0,1,0,1,0
2035,1147,0,0,146,146,0,1,0,1,0
3816,1017,0,0,146,146,0,1,0,1,0
2098,374,0,0,60,60,0,1,0,1,0
9764,2587,0,0,66,66,0,1,0,1,0
20042,697,0,0,62,62,0,1,0,1,0
12,3146,0,0,332,332,0,1,0,1,0
2756,459,0,0,62,62,0,1,0,1,0
17004,2587,0,0,66,66,0,1,0,1,0
3492,7,0,0,60,60,0,1,0,1,0
9614,3105,0,0,86,86,0,1,0,1,0
125,1017,0,0,62,62,0,1,0,1,0
16951,255,0,0,62,62,0,1,0,1,0
21327,1827,0,0,62,62,0,1,0,1,0
9253,1472,0,0,66,66,0,1,0,1,0
388,1888,0,0,62,62,0,1,0,1,0
19343,804,0,0,66,66,0,1,0,1,0
4597,1147,0,0,62,62,0,1,0,1,0
11261,2601,0,0,62,62,0,1,0,1,0
381,2883,0,0,146,146,0,1,0,1,0
19321,3252,0,0,66,66,0,1,0,1,0
8363,1147,0,0,66,66,0,1,0,1,0
7888,1147,0,0,62,62,0,1,0,1,0
16951,255,0,0,62,62,0,1,0,1,0
7326,1649,0,0,60,60,0,1,0,1,0
1651,1147,0,0,62,62,0,1,0,1,0
20244,2938,0,0,62,62,0,1,0,1,0
16537,2636,0,0,62,62,0,1,0,1,0
11461,308,0,0,62,62,0,1,0,1,0
17765,2382,0,0,66,66,0,1,0,1,0
5033,1017,0,0,146,146,0,1,0,1,0
2009,2636,0,0,66,66,0,1,0,1,0
6334,41,0,0,60,60,0,1,0,1,0
8697,1215,0,0,62,62,0,1,0,1,0
189,7,0,0,60,60,0,1,0,1,0
9780,1054,0,0,62,62,0,1,0,1,0
20877,2587,0,0,62,62,0,1,0,1,0
8164,2727,0,0,60,60,0,1,0,1,0
7326,180,0,0,60,60,0,1,0,1,0
8983,1888,0,0,62,62,0,1,0,1,0
1901,7,0,0,60,60,0,1,0,1,0
10978,797,0,0,62,62,0,1,0,1,0
14376,1888,0,0,66,66,0,1,0,1,0
16727,174,0,0,60,60,0,1,0,1,0
2374,1147,0,0,146,146,0,1,0,1,0
19694,697,0,0,146,146,0,1,0,1,0
21046,1147,0,0,62,62,0,1,0,1,0
3543,2938,0,0,66,66,0,1,0,1,0
22463,2817,0,0,66,66,0,1,0,1,0
9225,1472,0,0,62,62,0,1,0,1,0
4680,2587,0,0,66,66,0,1,0,1,0
1711,2853,0,0,145,145,0,1,0,1,0
13361,1804,0,0,66,66,0,1,0,1,0
19295,3216,0,0,66,66,0,1,0,1,0
8171,1073,0,0,60,60,0,1,0,1,0
10212,1771,0,0,66,66,0,1,0,1,0
14910,2235,0,0,66,66,0,1,0,1,0
1464,1147,0,0,62,62,0,1,0,1,0
16951,255,0,0,62,62,0,1,0,1,0
6651,1129,0,0,156,156,0,1,0,1,0
1596,3139,0,0,66,66,0,1,0,1,0
15035,104,0,0,60,60,0,1,0,1,0
360,3105,0,0,1273,1273,0,1,0,1,0
10737,1147,0,0,66,66,0,1,0,1,0
20283,983,0,0,66,66,0,1,0,1,0
20348,1880,0,0,66,66,0,1,0,1,0
12,1932,0,0,82,82,0,1,0,1,0
20223,1147,0,0,66,66,0,1,0,1,0
22161,2256,0,0,66,66,0,1,0,1,0
18,2266,0,0,145,145,0,1,0,1,0
1227,509,0,0,66,66,0,1,0,1,0
18053,2256,0,0,66,66,0,1,0,1,0
14890,2695,0,0,66,66,0,1,0,1,0
2280,2486,0,0,148,148,0,1,0,1,0
16951,255,0,0,62,62,0,1,0,1,0
18993,697,0,0,146,146,0,1,0,1,0
14722,1888,0,0,62,62,0,1,0,1,0
4711,2256,0,0,62,62,0,1,0,1,0
669,2636,0,0,62,62,0,1,0,1,0
19786,1147,0,0,62,62,0,1,0,1,0
13500,1771,0,0,146,146,0,1,0,1,0
5256,2256,0,0,66,66,0,1,0,1,0
387,1147,0,0,62,62,0,1,0,1,0
11572,427,0,0,62,62,0,1,0,1,0
17016,3212,0,0,62,62,0,1,0,1,0
9057,1147,0,0,66,66,0,1,0,1,0
2383,1888,0,0,62,62,0,1,0,1,0
16951,255,0,0,62,62,0,1,0,1,0
3031,2611,0,0,62,62,0,1,0,1,0
21953,1147,0,0,66,66,0,1,0,1,0
1729,2104,0,0,148,148,0,1,0,1,0
8327,3014,0,0,146,146,0,1,0,1,0
14505,2312,0,0,78,78,0,1,0,1,0
17618,2573,0,0,74,74,0,1,0,1,0
2339,1771,0,0,66,66,0,1,0,1,0
7335,1072,0,0,60,60,0,1,0,1,0
4445,2883,0,0,146,146,0,1,0,1,0
1485,1888,0,0,62,62,0,1,0,1,0
18955,2500,0,0,66,66,0,1,0,1,0
3180,1771,0,0,62,62,0,1,0,1,0
2984,1589,0,0,62,62,0,1,0,1,0
1525,1444,0,0,145,145,0,1,0,1,0
14969,1017,0,0,66,66,0,1,0,1,0
10639,1017,0,0,66,66,0,1,0,1,0
8753,1787,0,0,157,157,0,1,0,1,0
2828,2587,0,0,146,146,0,1,0,1,0
7756,2256,0,0,66,66,0,1,0,1,0
17898,2883,0,0,66,66,0,1,0,1,0
22382,2256,0,0,62,62,0,1,0,1,0
8349,983,0,0,62,62,0,1,0,1,0
2269,899,0,0,62,62,0,1,0,1,0
398,2636,0,0,66,66,0,1,0,1,0
1753,509,0,0,66,66,0,1,0,1,0
12,207,0,0,187,187,0,1,0,1,0
9208,1017,0,0,66,66,0,1,0,1,0
17017,432,0,0,62,62,0,1,0,1,0
7191,1,0,0,62,62,0,1,0,1,0
16827,509,0,0,66,66,0,1,0,1,0
11003,2256,0,0,66,66,0,1,0,1,0
17569,2154,0,0,74,74,0,1,0,1,0
16951,255,0,0,62,62,0,1,0,1,0
21900,280,0,0,66,66,0,1,0,1,0
6383,2883,0,0,62,62,0,1,0,1,0
16951,255,0,0,62,62,0,1,0,1,0
19567,155,0,0,66,66,0,1,0,1,0
1983,2144,0,0,66,66,0,1,0,1,0
464,1888,0,0,66,66,0,1,0,1,0
16648,7,0,0,60,60,0,1,0,1,0
8492,2093,0,0,157,157,0,1,0,1,0
19133,983,0,0,66,66,0,1,0,1,0
7,12,0,0,346,346,0,1,0,1,0
12590,1147,0,0,62,62,0,1,0,1,0
22525,2883,0,0,62,62,0,1,0,1,0
18843,2587,0,0,62,62,0,1,0,1,0
360,3105,0,0,1103,1103,0,1,0,1,0
14892,1017,0,0,62,62,0,1,0,1,0
4053,697,0,0,62,62,0,1,0,1,0
2648,3216,0,0,62,62,0,1,0,1,0
2717,2256,0,0,62,62,0,1,0,1,0
17987,2853,0,0,66,66,0,1,0,1,0
17225,1147,0,0,66,66,0,1,0,1,0
12,2568,0,0,331,331,0,1,0,1,0
595,1215,0,0,62,62,0,1,0,1,0
10762,2601,0,0,146,146,0,1,0,1,0
6651,1129,0,0,156,156,0,1,0,1,0
14856,2256,0,0,66,66,0,1,0,1,0
11268,1215,0,0,62,62,0,1,0,1,0
6067,1888,0,0,62,62,0,1,0,1,0
16951,255,0,0,62,62,0,1,0,1,0
12248,1017,0,0,146,146,0,1,0,1,0
2480,2588,0,0,60,60,0,1,0,1,0
15905,1147,0,0,62,62,0,1,0,1,0
4606,2587,0,0,66,66,0,1,0,1,0
16951,255,0,0,62,62,0,1,0,1,0
3020,1147,0,0,62,62,0,1,0,1,0
6533,1215,0,0,62,62,0,1,0,1,0
3230,2587,0,0,66,66,0,1,0,1,0
12,2784,0,0,82,82,0,1,0,1,0
1363,2883,0,0,62,62,0,1,0,1,0
1401,2938,0,0,62,62,0,1,0,1,0
10396,2038,0,0,100,100,0,1,0,1,0
12,2553,0,0,82,82,0,1,0,1,0
1930,509,0,0,62,62,0,1,0,1,0
10651,1147,0,0,66,66,0,1,0,1,0
2721,1888,0,0,66,66,0,1,0,1,0
2548,2149,0,0,60,60,0,1,0,1,0
14543,3212,0,0,62,62,0,1,0,1,0
2238,2587,0,0,66,66,0,1,0,1,0
1542,1888,0,0,62,62,0,1,0,1,0
1774,1017,0,0,62,62,0,1,0,1,0
5515,7,0,0,60,60,0,1,0,1,0
6581,2975,0,0,66,66,0,1,0,1,0
12030,2611,0,0,74,74,0,1,0,1,0
2254,1472,0,0,66,66,0,1,0,1,0
20212,1888,0,0,66,66,0,1,0,1,0
22208,2611,0,0,66,66,0,1,0,1,0
16951,255,0,0,62,62,0,1,0,1,0
2984,1589,0,0,66,66,0,1,0,1,0
1843,38,0,0,60,60,0,1,0,1,0
20926,2382,0,0,62,62,0,1,0,1,0
7326,180,0,0,60,60,0,1,0,1,0
416,797,0,0,66,66,0,1,0,1,0
20927,1017,0,0,62,62,0,1,0,1,0
4598,1147,0,0,146,146,0,1,0,1,0
12606,2636,0,0,66,66,0,1,0,1,0
6106,2587,0,0,66,66,0,1,0,1,0
2699,2587,0,0,62,62,0,1,0,1,0
10227,509,0,0,62,62,0,1,0,1,0
2584,1677,0,0,160,160,0,1,0,1,0
16951,255,0,0,62,62,0,1,0,1,0
16951,255,0,0,62,62,0,1,0,1,0
16451,1472,0,0,62,62,0,1,0,1,0
10387,3216,0,0,66,66,0,1,0,1,0
810,1017,0,0,66,66,0,1,0,1,0
9939,1880,0,0,66,66,0,1,0,1,0
16951,255,0,0,62,62,0,1,0,1,0
12495,126,0,0,139,139,0,1,0,1,0
7335,1070,0,0,60,60,0,1,0,1,0
22321,2587,0,0,66,66,0,1,0,1,0
3988,697,0,0,74,74,0,1,0,1,0
6828,344,0,0,159,159,0,1,0,1,0
8,873,0,0,60,60,0,1,0,1,0
276,9,0,0,60,60,0,1,0,1,0
4282,2587,0,0,146,146,0,1,0,1,0
16951,255,0,0,62,62,0,1,0,1,0
20682,2587,0,0,62,62,0,1,0,1,0
16951,255,0,0,62,62,0,1,0,1,0
3953,2144,0,0,62,62,0,1,0,1,0
14667,1147,0,0,146,146,0,1,0,1,0
17480,3139,0,0,66,66,0,1,0,1,0
2921,509,0,0,66,66,0,1,0,1,0
2966,2256,0,0,66,66,0,1,0,1,0
14722,1888,0,0,66,66,0,1,0,1,0
7339,170,0,0,60,60,0,1,0,1,0
13487,1017,0,0,62,62,0,1,0,1,0
20410,1804,0,0,66,66,0,1,0,1,0
22059,280,0,0,62,62,0,1,0,1,0
96,2256,0,0,66,66,0,1,0,1,0
18,2256,0,0,146,146,0,1,0,1,0
6571,1,0,0,62,62,0,1,0,1,0
1372,1086,0,0,146,146,0,1,0,1,0
1897,1827,0,0,62,62,0,1,0,1,0
10761,2938,0,0,78,78,0,1,0,1,0
328,1017,0,0,66,66,0,1,0,1,0
1473,561,0,0,62,62,0,1,0,1,0
18652,697,0,0,66,66,0,1,0,1,0
22570,1017,0,0,66,66,0,1,0,1,0
10300,1215,0,0,66,66,0,1,0,1,0
16951,255,0,0,62,62,0,1,0,1,0
6288,2154,0,0,74,74,0,1,0,1,0
10490,1017,0,0,62,62,0,1,0,1,0
577,2611,0,0,62,62,0,1,0,1,0
72,7,0,0,60,60,0,1,0,1,0
13440,2587,0,0,66,66,0,1,0,1,0
19810,3216,0,0,66,66,0,1,0,1,0
1903,2587,0,0,146,146,0,1,0,1,0
22111,1797,0,0,74,74,0,1,0,1,0
1703,3139,0,0,66,66,0,1,0,1,0
711,2938,0,0,66,66,0,1,0,1,0
16844,2938,0,0,66,66,0,1,0,1,0
360,3105,0,0,1306,1306,0,1,0,1,0
8415,1797,0,0,66,66,0,1,0,1,0
1525,1444,0,0,145,145,0,1,0,1,0
11364,3139,0,0,66,66,0,1,0,1,0
158,1147,0,0,62,62,0,1,0,1,0
15287,2382,0,0,66,66,0,1,0,1,0
15793,2747,0,0,66,66,0,1,0,1,0
8312,861,0,0,157,157,0,1,0,1,0
7298,1017,0,0,62,62,0,1,0,1,0
3516,7,0,0,60,60,0,1,0,1,0
4285,1147,0,0,66,66,0,1,0,1,0
1758,2256,0,0,66,66,0,1,0,1,0
343,1054,0,0,66,66,0,1,0,1,0
16951,255,0,0,62,62,0,1,0,1,0
13259,1737,0,0,66,66,0,1,0,1,0
497,995,0,0,60,60,0,1,0,1,0
1940,7,0,0,60,60,0,1,0,1,0
1868,3216,0,0,62,62,0,1,0,1,0
22093,432,0,0,66,66,0,1,0,1,0
2925,2883,0,0,62,62,0,1,0,1,0
3099,1147,0,0,66,66,0,1,0,1,0
21476,1147,0,0,62,62,0,1,0,1,0
13813,2486,0,0,66,66,0,1,0,1,0
21279,2256,0,0,62,62,0,1,0,1,0
20764,2938,0,0,62,62,0,1,0,1,0
3624,1147,0,0,66,66,0,1,0,1,0
27,2938,0,0,72,72,0,1,0,1,0
21551,3216,0,0,62,62,0,1,0,1,0
13532,2636,0,0,66,66,0,1,0,1,0
13167,1386,0,0,62,62,0,1,0,1,0
16951,255,0,0,62,62,0,1,0,1,0
16951,255,0,0,62,62,0,1,0,1,0
1584,2154,0,0,66,66,0,1,0,1,0
2431,1771,0,0,62,62,0,1,0,1,0
6318,104,0,0,60,60,0,1,0,1,0
345,1763,0,0,62,62,0,1,0,1,0
8970,280,0,0,66,66,0,1,0,1,0
16951,255,0,0,62,62,0,1,0,1,0
15391,509,0,0,66,66,0,1,0,1,0
7327,2256,0,0,62,62,0,1,0,1,0
1745,1888,0,0,146,146,0,1,0,1,0
1804,1777,0,0,60,60,0,1,0,1,0
856,2256,0,0,62,62,0,1,0,1,0
2285,2486,0,0,72,72,0,1,0,1,0
1290,2587,0,0,62,62,0,1,0,1,0
0,0,0,0,70,70,0,1,0,1,0
13190,1017,0,0,62,62,0,1,0,1,0
21312,1147,0,0,146,146,0,1,0,1,0
16951,255,0,0,62,62,0,1,0,1,0
6751,18,0,0,234,234,0,1,0,1,0
1693,2938,0,0,72,72,0,1,0,1,0
10475,6,0,0,60,60,0,1,0,1,0
16280,1472,0,0,62,62,0,1,0,1,0
8782,1472,0,0,66,66,0,1,0,1,0
5709,1215,0,0,62,62,0,1,0,1,0
1330,804,0,0,62,62,0,1,0,1,0
3065,3117,0,0,62,62,0,1,0,1,0
17475,983,0,0,62,62,0,1,0,1,0
630,2636,0,0,66,66,0,1,0,1,0
18271,1771,0,0,62,62,0,1,0,1,0
20664,2733,0,0,62,62,0,1,0,1,0
7326,180,0,0,60,60,0,1,0,1,0
16199,3216,0,0,70,70,0,1,0,1,0
3101,1888,0,0,62,62,0,1,0,1,0
1479,1147,0,0,146,146,0,1,0,1,0
1145,1215,0,0,66,66,0,1,0,1,0
17373,155,0,0,66,66,0,1,0,1,0
20659,697,0,0,62,62,0,1,0,1,0
1976,509,0,0,62,62,0,1,0,1,0
14473,2778,0,0,74,74,0,1,0,1,0
9282,1054,0,0,66,66,0,1,0,1,0
7985,318,0,0,60,60,0,1,0,1,0
22091,1215,0,0,62,62,0,1,0,1,0
5272,2587,0,0,62,62,0,1,0,1,0
3664,509,0,0,66,66,0,1,0,1,0
9630,2883,0,0,62,62,0,1,0,1,0
13301,3216,0,0,62,62,0,1,0,1,0
19873,2883,0,0,66,66,0,1,0,1,0
2382,1763,0,0,66,66,0,1,0,1,0
2442,2695,0,0,66,66,0,1,0,1,0
844,2938,0,0,146,146,0,1,0,1,0
299,1888,0,0,62,62,0,1,0,1,0
12831,1147,0,0,66,66,0,1,0,1,0
12516,1795,0,0,60,60,0,1,0,1,0
6350,1147,0,0,146,146,0,1,0,1,0
16951,255,0,0,62,62,0,1,0,1,0
13847,1215,0,0,66,66,0,1,0,1,0
2398,7,0,0,60,60,0,1,0,1,0
360,3105,0,0,893,893,0,1,0,1,0
2301,1946,0,0,60,60,0,1,0,1,0
17691,1888,0,0,62,62,0,1,0,1,0
8012,983,0,0,66,66,0,1,0,1,0
19,2379,0,0,62,62,0,1,0,1,0
19482,1888,0,0,66,66,0,1,0,1,0
1773,2883,0,0,66,66,0,1,0,1,0
10689,1215,0,0,62,62,0,1,0,1,0
10952,2256,0,0,66,66,0,1,0,1,0
16951,255,0,0,62,62,0,1,0,1,0
3601,2573,0,0,62,62,0,1,0,1,0
12,151,0,0,135,135,0,1,0,1,0
2757,2587,0,0,66,66,0,1,0,1,0
12507,1017,0,0,66,66,0,1,0,1,0
11009,1147,0,0,66,66,0,1,0,1,0
2311,2611,0,0,62,62,0,1,0,1,0
2273,1017,0,0,66,66,0,1,0,1,0
12,1978,0,0,74,74,0,1,0,1,0
12195,3212,0,0,62,62,0,1,0,1,0
8171,1073,0,0,60,60,0,1,0,1,0
11678,1106,0,0,66,66,0,1,0,1,0
360,3105,0,0,156,156,0,1,0,1,0
1330,697,0,0,62,62,0,1,0,1,0
3955,1472,0,0,62,62,0,1,0,1,0
1911,2587,0,0,146,146,0,1,0,1,0
14910,2235,0,0,66,66,0,1,0,1,0
1965,1888,0,0,62,62,0,1,0,1,0
4040,1771,0,0,146,146,0,1,0,1,0
15966,1888,0,0,66,66,0,1,0,1,0
16941,1147,0,0,62,62,0,1,0,1,0
4252,7,0,0,60,60,0,1,0,1,0
19,2587,0,0,62,62,0,1,0,1,0
4956,2636,0,0,66,66,0,1,0,1,0
1615,155,0,0,146,146,0,1,0,1,0
13779,1147,0,0,62,62,0,1,0,1,0
9473,1017,0,0,62,62,0,1,0,1,0
1320,797,0,0,62,62,0,1,0,1,0
21379,1017,0,0,66,66,0,1,0,1,0
8171,1073,0,0,60,60,0,1,0,1,0
18318,1147,0,0,62,62,0,1,0,1,0
17924,263,0,0,66,66,0,1,0,1,0
19006,3216,0,0,66,66,0,1,0,1,0
10010,2747,0,0,66,66,0,1,0,1,0
16951,255,0,0,62,62,0,1,0,1,0
2132,1888,0,0,62,62,0,1,0,1,0
8877,674,0,0,66,66,0,1,0,1,0
1741,1215,0,0,62,62,0,1,0,1,0
577,2611,0,0,78,78,0,1,0,1,0
10267,2883,0,0,66,66,0,1,0,1,0
360,3105,0,0,217,217,0,1,0,1,0
1406,1804,0,0,66,66,0,1,0,1,0
3894,697,0,0,62,62,0,1,0,1,0
3570,3270,0,0,162,162,0,1,0,1,0
2348,3139,0,0,66,66,0,1,0,1,0
19729,2747,0,0,62,62,0,1,0,1,0
7335,1070,0,0,60,60,0,1,0,1,0
20497,2636,0,0,62,62,0,1,0,1,0
15072,697,0,0,146,146,0,1,0,1,0
1723,2636,0,0,66,66,0,1,0,1,0
9214,3256,0,0,60,60,0,1,0,1,0
5,1903,0,0,66,66,0,1,0,1,0
9093,1215,0,0,66,66,0,1,0,1,0
672,1147,0,0,66,66,0,1,0,1,0
2827,2636,0,0,146,146,0,1,0,1,0
12,2461,0,0,81,81,0,1,0,1,0
17987,2853,0,0,66,66,0,1,0,1,0
2564,1017,0,0,146,146,0,1,0,1,0
24,1787,0,0,139,139,0,1,0,1,0
1804,2921,0,0,60,60,0,1,0,1,0
8952,1147,0,0,66,66,0,1,0,1,0
3143,2938,0,0,74,74,0,1,0,1,0
7335,1070,0,0,60,60,0,1,0,1,0
3876,1923,0,0,62,62,0,1,0,1,0
15694,1202,0,0,145,145,0,1,0,1,0
14948,2256,0,0,66,66,0,1,0,1,0
7273,1,0,0,62,62,0,1,0,1,0
16951,255,0,0,62,62,0,1,0,1,0
1802,804,0,0,62,62,0,1,0,1,0
2861,1215,0,0,62,62,0,1,0,1,0
16951,255,0,0,62,62,0,1,0,1,0
2917,1167,0,0,62,62,0,1,0,1,0
11461,2611,0,0,74,74,0,1,0,1,0
1611,2611,0,0,66,66,0,1,0,1,0
16951,255,0,0,62,62,0,1,0,1,0
5,1903,0,0,66,66,0,1,0,1,0
11597,2930,0,0,66,66,0,1,0,1,0
490,2573,0,0,62,62,0,1,0,1,0
13336,280,0,0,66,66,0,1,0,1,0
2676,1147,0,0,66,66,0,1,0,1,0
3770,1771,0,0,66,66,0,1,0,1,0
2400,2587,0,0,62,62,0,1,0,1,0
9214,3256,0,0,60,60,0,1,0,1,0
1943,1017,0,0,62,62,0,1,0,1,0
10737,1147,0,0,66,66,0,1,0,1,0
8817,1888,0,0,74,74,0,1,0,1,0
20219,2154,0,0,66,66,0,1,0,1,0
13282,2379,0,0,66,66,0,1,0,1,0
190,2938,0,0,78,78,0,1,0,1,0
21264,1147,0,0,62,62,0,1,0,1,0
652,2926,0,0,100,100,0,1,0,1,0
11637,983,0,0,66,66,0,1,0,1,0
2764,2587,0,0,146,146,0,1,0,1,0
13552,3051,0,0,62,62,0,1,0,1,0
16951,255,0,0,62,62,0,1,0,1,0
6368,1017,0,0,62,62,0,1,0,1,0
2925,2883,0,0,62,62,0,1,0,1,0
16642,2702,0,0,62,62,0,1,0,1,0
5569,6,0,0,60,60,0,1,0,1,0
10602,2380,0,0,62,62,0,1,0,1,0
14992,2611,0,0,66,66,0,1,0,1,0
13785,509,0,0,66,66,0,1,0,1,0
11411,383,0,0,66,66,0,1,0,1,0
7083,3,0,0,60,60,0,1,0,1,0
1281,2543,0,0,60,60,0,1,0,1,0
4374,1017,0,0,62,62,0,1,0,1,0
274,9,0,0,60,60,0,1,0,1,0
5207,2938,0,0,62,62,0,1,0,1,0
9224,2256,0,0,62,62,0,1,0,1,0
19688,1017,0,0,66,66,0,1,0,1,0
14984,3139,0,0,66,66,0,1,0,1,0
15286,1147,0,0,146,146,0,1,0,1,0
18,2256,0,0,62,62,0,1,0,1,0
7523,1147,0,0,62,62,0,1,0,1,0
3903,1888,0,0,62,62,0,1,0,1,0
1037,2883,0,0,66,66,0,1,0,1,0
9710,1017,0,0,62,62,0,1,0,1,0
4221,2636,0,0,146,146,0,1,0,1,0
3242,2440,0,0,62,62,0,1,0,1,0
373,1147,0,0,62,62,0,1,0,1,0
3443,1888,0,0,62,62,0,1,0,1,0
12,1028,0,0,83,83,0,1,0,1,0
8422,2256,0,0,66,66,0,1,0,1,0
75,1147,0,0,62,62,0,1,0,1,0
20325,10,0,0,88,88,0,1,0,1,0
84,1147,0,0,66,66,0,1,0,1,0
0,0,0,0,60,60,0,1,0,1,0
15154,3216,0,0,62,62,0,1,0,1,0
1728,3216,0,0,62,62,0,1,0,1,0
2562,1287,0,0,62,62,0,1,0,1,0
16951,255,0,0,62,62,0,1,0,1,0
16951,255,0,0,62,62,0,1,0,1,0
17702,1147,0,0,146,146,0,1,0,1,0
60,1888,0,0,62,62,0,1,0,1,0
20788,2938,0,0,66,66,0,1,0,1,0
844,2581,0,0,62,62,0,1,0,1,0
16919,1771,0,0,66,66,0,1,0,1,0
20682,2587,0,0,66,66,0,1,0,1,0
9908,2938,0,0,62,62,0,1,0,1,0
1445,2486,0,0,62,62,0,1,0,1,0
11640,1215,0,0,62,62,0,1,0,1,0
823,136,0,0,60,60,0,1,0,1,0
16951,255,0,0,62,62,0,1,0,1,0
1618,1017,0,0,66,66,0,1,0,1,0
16444,2881,0,0,90,90,0,1,0,1,0
21066,2611,0,0,62,62,0,1,0,1,0
18589,1771,0,0,66,66,0,1,0,1,0
2987,7,0,0,60,60,0,1,0,1,0
2966,2256,0,0,66,66,0,1,0,1,0
8645,2883,0,0,66,66,0,1,0,1,0
2850,1792,0,0,62,62,0,1,0,1,0
13074,181,0,0,60,60,0,1,0,1,0
17329,1771,0,0,62,62,0,1,0,1,0
13,460,0,0,62,62,0,1,0,1,0
4325,12,0,0,60,60,0,1,0,1,0
2771,1017,0,0,146,146,0,1,0,1,0
727,137,0,0,62,62,0,1,0,1,0
19428,242,0,0,145,145,0,1,0,1,0
12915,1215,0,0,62,62,0,1,0,1,0
11429,2573,0,0,66,66,0,1,0,1,0
16951,255,0,0,62,62,0,1,0,1,0
5224,1147,0,0,146,146,0,1,0,1,0
640,1737,0,0,146,146,0,1,0,1,0
14257,2154,0,0,74,74,0,1,0,1,0
14621,2883,0,0,66,66,0,1,0,1,0
12,3227,0,0,131,131,0,1,0,1,0
75,1147,0,0,62,62,0,1,0,1,0
20048,1797,0,0,66,66,0,1,0,1,0
16329,2587,0,0,66,66,0,1,0,1,0
9710,1017,0,0,62,62,0,1,0,1,0
22234,2636,0,0,62,62,0,1,0,1,0
18086,2938,0,0,66,66,0,1,0,1,0
1133,2938,0,0,78,78,0,1,0,1,0
561,509,0,0,66,66,0,1,0,1,0
17216,983,0,0,146,146,0,1,0,1,0
11535,790,0,0,70,70,0,1,0,1,0
16951,255,0,0,62,62,0,1,0,1,0
14140,3216,0,0,62,62,0,1,0,1,0
3894,697,0,0,62,62,0,1,0,1,0
13666,1147,0,0,66,66,0,1,0,1,0
20989,3212,0,0,66,66,0,1,0,1,0
1790,1054,0,0,146,146,0,1,0,1,0
1546,1147,0,0,62,62,0,1,0,1,0
1525,1444,0,0,145,145,0,1,0,1,0
19602,2550,0,0,66,66,0,1,0,1,0
20772,1804,0,0,66,66,0,1,0,1,0
19913,1880,0,0,66,66,0,1,0,1,0
21267,2587,0,0,66,66,0,1,0,1,0
8065,1147,0,0,62,62,0,1,0,1,0
1274,1888,0,0,62,62,0,1,0,1,0
19612,1771,0,0,66,66,0,1,0,1,0
16731,1086,0,0,66,66,0,1,0,1,0
2670,2938,0,0,62,62,0,1,0,1,0
1804,1762,0,0,60,60,0,1,0,1,0
17069,1017,0,0,146,146,0,1,0,1,0
21072,1771,0,0,66,66,0,1,0,1,0
2611,2883,0,0,62,62,0,1,0,1,0
540,1888,0,0,62,62,0,1,0,1,0
12711,1888,0,0,66,66,0,1,0,1,0
1804,2921,0,0,60,60,0,1,0,1,0
16951,255,0,0,62,62,0,1,0,1,0
646,2938,0,0,62,62,0,1,0,1,0
1595,983,0,0,62,62,0,1,0,1,0
7536,2587,0,0,66,66,0,1,0,1,0
25,1771,0,0,146,146,0,1,0,1,0
16951,255,0,0,62,62,0,1,0,1,0
15970,2938,0,0,146,146,0,1,0,1,0
6815,3216,0,0,62,62,0,1,0,1,0
21802,1888,0,0,66,66,0,1,0,1,0
16839,697,0,0,146,146,0,1,0,1,0
1767,2486,0,0,143,143,0,1,0,1,0
1282,1147,0,0,62,62,0,1,0,1,0
15790,2601,0,0,66,66,0,1,0,1,0
10052,3057,0,0,62,62,0,1,0,1,0
6994,2023,0,0,145,145,0,1,0,1,0
16951,255,0,0,62,62,0,1,0,1,0
16727,179,0,0,60,60,0,1,0,1,0
18237,1086,0,0,66,66,0,1,0,1,0
6436,2486,0,0,156,156,0,1,0,1,0
16951,255,0,0,62,62,0,1,0,1,0
2376,2938,0,0,109,109,0,1,0,1,0
1361,2636,0,0,66,66,0,1,0,1,0
65,2938,0,0,146,146,0,1,0,1,0
16951,255,0,0,62,62,0,1,0,1,0
16630,2636,0,0,62,62,0,1,0,1,0
1324,2587,0,0,66,66,0,1,0,1,0
17624,1880,0,0,62,62,0,1,0,1,0
1894,2587,0,0,146,146,0,1,0,1,0
2285,7,0,0,60,60,0,1,0,1,0
10867,1888,0,0,66,66,0,1,0,1,0
2089,1771,0,0,62,62,0,1,0,1,0
15736,2938,0,0,66,66,0,1,0,1,0
450,126,0,0,136,136,0,1,0,1,0
16951,255,0,0,62,62,0,1,0,1,0
17734,1804,0,0,62,62,0,1,0,1,0
11722,1147,0,0,66,66,0,1,0,1,0
20137,1880,0,0,66,66,0,1,0,1,0
11518,2953,0,0,66,66,0,1,0,1,0
2752,2611,0,0,72,72,0,1,0,1,0
1403,2486,0,0,66,66,0,1,0,1,0
6110,1771,0,0,62,62,0,1,0,1,0
12,658,0,0,60,60,0,1,0,1,0
16951,255,0,0,62,62,0,1,0,1,0
11661,3216,0,0,62,62,0,1,0,1,0
9429,2509,0,0,66,66,0,1,0,1,0
3851,2883,0,0,66,66,0,1,0,1,0
1516,2953,0,0,62,62,0,1,0,1,0
17577,255,0,0,60,60,0,1,0,1,0
13036,1827,0,0,62,62,0,1,0,1,0
8164,2725,0,0,60,60,0,1,0,1,0
1178,1167,0,0,62,62,0,1,0,1,0
19786,1147,0,0,146,146,0,1,0,1,0
7032,2938,0,0,74,74,0,1,0,1,0
9603,3139,0,0,62,62,0,1,0,1,0
761,2256,0,0,66,66,0,1,0,1,0
15588,1147,0,0,66,66,0,1,0,1,0
16112,2611,0,0,66,66,0,1,0,1,0
16780,2883,0,0,66,66,0,1,0,1,0
20260,2587,0,0,62,62,0,1,0,1,0
13580,3051,0,0,66,66,0,1,0,1,0
1615,155,0,0,62,62,0,1,0,1,0
13154,1215,0,0,62,62,0,1,0,1,0
17310,1017,0,0,146,146,0,1,0,1,0
14462,3216,0,0,66,66,0,1,0,1,0
2856,2695,0,0,62,62,0,1,0,1,0
17578,418,0,0,62,62,0,1,0,1,0
2153,2611,0,0,62,62,0,1,0,1,0
360,3105,0,0,503,503,0,1,0,1,0
3201,2938,0,0,60,60,0,1,0,1,0
6369,2608,0,0,62,62,0,1,0,1,0
16951,255,0,0,62,62,0,1,0,1,0
754,155,0,0,62,62,0,1,0,1,0
7304,1147,0,0,62,62,0,1,0,1,0
1886,3139,0,0,66,66,0,1,0,1,0
1820,1147,0,0,62,62,0,1,0,1,0
7326,180,0,0,60,60,0,1,0,1,0
11680,697,0,0,66,66,0,1,0,1,0
6831,2256,0,0,66,66,0,1,0,1,0
1976,509,0,0,66,66,0,1,0,1,0
10530,672,0,0,139,139,0,1,0,1,0
1801,983,0,0,62,62,0,1,0,1,0
693,2611,0,0,62,62,0,1,0,1,0
4151,2636,0,0,146,146,0,1,0,1,0
10984,2938,0,0,66,66,0,1,0,1,0
632,2154,0,0,62,62,0,1,0,1,0
22580,1215,0,0,62,62,0,1,0,1,0
21615,1017,0,0,66,66,0,1,0,1,0
1437,3216,0,0,66,66,0,1,0,1,0
2778,3216,0,0,66,66,0,1,0,1,0
18788,2975,0,0,66,66,0,1,0,1,0
16989,847,0,0,66,66,0,1,0,1,0
16537,2636,0,0,66,66,0,1,0,1,0
16845,1888,0,0,62,62,0,1,0,1,0
6960,1147,0,0,62,62,0,1,0,1,0
3543,2938,0,0,66,66,0,1,0,1,0
2510,2486,0,0,62,62,0,1,0,1,0
4154,2256,0,0,78,78,0,1,0,1,0
5787,983,0,0,62,62,0,1,0,1,0
17372,2953,0,0,66,66,0,1,0,1,0
10276,3216,0,0,66,66,0,1,0,1,0
14845,3139,0,0,62,62,0,1,0,1,0
588,2611,0,0,62,62,0,1,0,1,0
11930,2883,0,0,66,66,0,1,0,1,0
10414,2587,0,0,66,66,0,1,0,1,0
10602,2380,0,0,66,66,0,1,0,1,0
5220,1147,0,0,62,62,0,1,0,1,0
16099,2883,0,0,66,66,0,1,0,1,0
15808,1888,0,0,62,62,0,1,0,1,0
5627,2240,0,0,145,145,0,1,0,1,0
19462,2883,0,0,62,62,0,1,0,1,0
2807,2256,0,0,62,62,0,1,0,1,0
12,1596,0,0,89,89,0,1,0,1,0
6595,1167,0,0,146,146,0,1,0,1,0
1547,2636,0,0,62,62,0,1,0,1,0
6063,2938,0,0,62,62,0,1,0,1,0
397,2852,0,0,66,66,0,1,0,1,0
11951,3216,0,0,66,66,0,1,0,1,0
20553,1888,0,0,66,66,0,1,0,1,0
16951,255,0,0,62,62,0,1,0,1,0
16951,255,0,0,62,62,0,1,0,1,0
4851,1215,0,0,66,66,0,1,0,1,0
21498,2636,0,0,66,66,0,1,0,1,0
12146,1861,0,0,66,66,0,1,0,1,0
2219,2636,0,0,66,66,0,1,0,1,0
19872,1086,0,0,66,66,0,1,0,1,0
12,658,0,0,131,131,0,1,0,1,0
22690,2938,0,0,72,72,0,1,0,1,0
16030,2883,0,0,66,66,0,1,0,1,0
21277,983,0,0,66,66,0,1,0,1,0
84,1147,0,0,66,66,0,1,0,1,0
19902,1017,0,0,66,66,0,1,0,1,0
21587,2938,0,0,78,78,0,1,0,1,0
20857,2587,0,0,66,66,0,1,0,1,0
22030,3139,0,0,66,66,0,1,0,1,0
9679,2636,0,0,66,66,0,1,0,1,0
14722,1771,0,0,62,62,0,1,0,1,0
3032,2587,0,0,66,66,0,1,0,1,0
720,2205,0,0,66,66,0,1,0,1,0
2762,1147,0,0,66,66,0,1,0,1,0
2680,510,0,0,62,62,0,1,0,1,0
190,2938,0,0,78,78,0,1,0,1,0
9614,3105,0,0,86,86,0,1,0,1,0
19428,242,0,0,145,145,0,1,0,1,0
2320,2587,0,0,62,62,0,1,0,1,0
155,3216,0,0,62,62,0,1,0,1,0
15179,797,0,0,66,66,0,1,0,1,0
4027,1472,0,0,146,146,0,1,0,1,0
11450,245,0,0,60,60,0,1,0,1,0
6673,2558,0,0,62,62,0,1,0,1,0
3735,1936,0,0,74,74,0,1,0,1,0
21143,1771,0,0,66,66,0,1,0,1,0
11411,383,0,0,66,66,0,1,0,1,0
2098,374,0,0,60,60,0,1,0,1,0
13651,1215,0,0,66,66,0,1,0,1,0
8877,674,0,0,66,66,0,1,0,1,0
1994,2953,0,0,62,62,0,1,0,1,0
12033,2587,0,0,66,66,0,1,0,1,0
11981,1106,0,0,66,66,0,1,0,1,0
21146,1147,0,0,62,62,0,1,0,1,0
10462,280,0,0,62,62,0,1,0,1,0
20243,1703,0,0,66,66,0,1,0,1,0
31,1888,0,0,62,62,0,1,0,1,0
12796,1771,0,0,62,62,0,1,0,1,0
21201,3216,0,0,66,66,0,1,0,1,0
16951,255,0,0,62,62,0,1,0,1,0
664,1147,0,0,66,66,0,1,0,1,0
16951,255,0,0,62,62,0,1,0,1,0
497,3013,0,0,66,66,0,1,0,1,0
2939,1804,0,0,146,146,0,1,0,1,0
16972,3216,0,0,66,66,0,1,0,1,0
16951,255,0,0,62,62,0,1,0,1,0
1804,304,0,0,60,60,0,1,0,1,0
21,3269,0,0,159,159,0,1,0,1,0
10214,3188,0,0,66,66,0,1,0,1,0
3193,2852,0,0,62,62,0,1,0,1,0
12146,1861,0,0,62,62,0,1,0,1,0
20060,2938,0,0,66,66,0,1,0,1,0
3064,2938,0,0,60,60,0,1,0,1,0
2954,2205,0,0,66,66,0,1,0,1,0
15694,344,0,0,145,145,0,1,0,1,0
11737,1147,0,0,66,66,0,1,0,1,0
160,1888,0,0,62,62,0,1,0,1,0
2848,2883,0,0,146,146,0,1,0,1,0
1584,2154,0,0,62,62,0,1,0,1,0
15158,1086,0,0,66,66,0,1,0,1,0
6117,1147,0,0,66,66,0,1,0,1,0
1804,1025,0,0,60,60,0,1,0,1,0
3139,1771,0,0,62,62,0,1,0,1,0
1496,3216,0,0,62,62,0,1,0,1,0
300,2938,0,0,66,66,0,1,0,1,0
14023,1590,0,0,66,66,0,1,0,1,0
8164,2727,0,0,60,60,0,1,0,1,0
2663,1215,0,0,66,66,0,1,0,1,0
3184,2587,0,0,62,62,0,1,0,1,0
3204,3117,0,0,146,146,0,1,0,1,0
16951,255,0,0,62,62,0,1,0,1,0
11988,1147,0,0,66,66,0,1,0,1,0
5186,1888,0,0,62,62,0,1,0,1,0
684,2938,0,0,62,62,0,1,0,1,0
12045,1797,0,0,66,66,0,1,0,1,0
2671,1147,0,0,62,62,0,1,0,1,0
1827,1804,0,0,66,66,0,1,0,1,0
12895,2573,0,0,66,66,0,1,0,1,0
11892,2739,0,0,66,66,0,1,0,1,0
16951,255,0,0,62,62,0,1,0,1,0
3074,2892,0,0,169,169,0,1,0,1,0
22683,10,0,0,88,88,0,1,0,1,0
11068,2587,0,0,62,62,0,1,0,1,0
5598,3216,0,0,66,66,0,1,0,1,0
5465,1771,0,0,146,146,0,1,0,1,0
16,7,0,0,60,60,0,1,0,1,0
19181,2154,0,0,66,66,0,1,0,1,0
6129,104,0,0,60,60,0,1,0,1,0
3256,1017,0,0,62,62,0,1,0,1,0
22201,2836,0,0,66,66,0,1,0,1,0
11596,713,0,0,62,62,0,1,0,1,0
823,434,0,0,60,60,0,1,0,1,0
17573,1017,0,0,62,62,0,1,0,1,0
20006,1215,0,0,66,66,0,1,0,1,0
17336,1327,0,0,62,62,0,1,0,1,0
21629,1888,0,0,66,66,0,1,0,1,0
16951,255,0,0,62,62,0,1,0,1,0
13036,1827,0,0,66,66,0,1,0,1,0
2506,3145,0,0,148,148,0,1,0,1,0
1411,1017,0,0,62,62,0,1,0,1,0
22030,3139,0,0,62,62,0,1,0,1,0
10784,847,0,0,66,66,0,1,0,1,0
8164,2727,0,0,60,60,0,1,0,1,0
3228,3139,0,0,66,66,0,1,0,1,0
13643,2573,0,0,66,66,0,1,0,1,0
14072,1147,0,0,62,62,0,1,0,1,0
6895,104,0,0,60,60,0,1,0,1,0
17,532,0,0,66,66,0,1,0,1,0
5446,2256,0,0,146,146,0,1,0,1,0
9583,3216,0,0,66,66,0,1,0,1,0
13792,1472,0,0,66,66,0,1,0,1,0
3260,1017,0,0,66,66,0,1,0,1,0
15694,333,0,0,145,145,0,1,0,1,0
6506,936,0,0,62,62,0,1,0,1,0
6229,2938,0,0,78,78,0,1,0,1,0
0,0,0,0,98,98,0,1,0,1,0
11880,1086,0,0,62,62,0,1,0,1,0
15694,1787,0,0,145,145,0,1,0,1,0
14023,1590,0,0,62,62,0,1,0,1,0
15882,1888,0,0,62,62,0,1,0,1,0
2660,1147,0,0,146,146,0,1,0,1,0
20565,2379,0,0,78,78,0,1,0,1,0
22065,1017,0,0,66,66,0,1,0,1,0
18023,2256,0,0,66,66,0,1,0,1,0
1804,375,0,0,60,60,0,1,0,1,0
13122,1054,0,0,66,66,0,1,0,1,0
10706,2636,0,0,66,66,0,1,0,1,0
18615,2611,0,0,62,62,0,1,0,1,0
20953,1472,0,0,62,62,0,1,0,1,0
17395,2256,0,0,66,66,0,1,0,1,0
3004,2256,0,0,62,62,0,1,0,1,0
93,1017,0,0,66,66,0,1,0,1,0
19105,509,0,0,66,66,0,1,0,1,0
12,1768,0,0,161,161,0,1,0,1,0
636,280,0,0,146,146,0,1,0,1,0
232,1771,0,0,62,62,0,1,0,1,0
20644,2573,0,0,66,66,0,1,0,1,0
249,1880,0,0,66,66,0,1,0,1,0
2122,3216,0,0,62,62,0,1,0,1,0
11508,1472,0,0,62,62,0,1,0,1,0
16951,255,0,0,62,62,0,1,0,1,0
2466,2587,0,0,62,62,0,1,0,1,0
326,1888,0,0,62,62,0,1,0,1,0
22704,1017,0,0,66,66,0,1,0,1,0
499,187,0,0,1093,1093,0,1,0,1,0
1161,3216,0,0,62,62,0,1,0,1,0
6303,3,0,0,60,60,0,1,0,1,0
6050,2938,0,0,66,66,0,1,0,1,0
3113,1017,0,0,66,66,0,1,0,1,0
3498,1804,0,0,62,62,0,1,0,1,0
14892,1017,0,0,62,62,0,1,0,1,0
5266,2636,0,0,62,62,0,1,0,1,0
20314,3139,0,0,62,62,0,1,0,1,0
7339,334,0,0,60,60,0,1,0,1,0
16951,255,0,0,62,62,0,1,0,1,0
18203,2601,0,0,62,62,0,1,0,1,0
9563,1215,0,0,66,66,0,1,0,1,0
7339,140,0,0,60,60,0,1,0,1,0
7536,2587,0,0,62,62,0,1,0,1,0
20443,1888,0,0,62,62,0,1,0,1,0
1722,2432,0,0,159,159,0,1,0,1,0
2659,2611,0,0,78,78,0,1,0,1,0
16951,255,0,0,62,62,0,1,0,1,0
5761,697,0,0,74,74,0,1,0,1,0
10401,2256,0,0,66,66,0,1,0,1,0
21446,2256,0,0,62,62,0,1,0,1,0
84,1147,0,0,62,62,0,1,0,1,0
10983,1888,0,0,66,66,0,1,0,1,0
20842,3216,0,0,62,62,0,1,0,1,0
2548,2677,0,0,60,60,0,1,0,1,0
42,2938,0,0,62,62,0,1,0,1,0
1899,2256,0,0,146,146,0,1,0,1,0
1146,1472,0,0,62,62,0,1,0,1,0
5640,7,0,0,60,60,0,1,0,1,0
592,1054,0,0,66,66,0,1,0,1,0
7809,7,0,0,60,60,0,1,0,1,0
816,2587,0,0,146,146,0,1,0,1,0
16951,255,0,0,62,62,0,1,0,1,0
7846,1215,0,0,62,62,0,1,0,1,0
1336,2438,0,0,143,143,0,1,0,1,0
703,2883,0,0,66,66,0,1,0,1,0
12010,1147,0,0,62,62,0,1,0,1,0
4099,2477,0,0,62,62,0,1,0,1,0
3071,7,0,0,60,60,0,1,0,1,0
7590,2820,0,0,148,148,0,1,0,1,0
7226,1147,0,0,66,66,0,1,0,1,0
15694,1515,0,0,145,145,0,1,0,1,0
2442,2695,0,0,66,66,0,1,0,1,0
14393,1804,0,0,146,146,0,1,0,1,0
3724,1147,0,0,66,66,0,1,0,1,0
14493,308,0,0,62,62,0,1,0,1,0
497,227,0,0,220,220,0,1,0,1,0
15694,1515,0,0,145,145,0,1,0,1,0
7906,1147,0,0,62,62,0,1,0,1,0
10993,1017,0,0,66,66,0,1,0,1,0
18836,1147,0,0,66,66,0,1,0,1,0
158,1147,0,0,146,146,0,1,0,1,0
11757,1888,0,0,66,66,0,1,0,1,0
22030,1282,0,0,66,66,0,1,0,1,0
12870,1804,0,0,62,62,0,1,0,1,0
12,929,0,0,83,83,0,1,0,1,0
7949,314,0,0,60,60,0,1,0,1,0
12185,1880,0,0,66,66,0,1,0,1,0
2055,427,0,0,62,62,0,1,0,1,0
17803,2636,0,0,66,66,0,1,0,1,0
15254,2636,0,0,62,62,0,1,0,1,0
20552,3216,0,0,62,62,0,1,0,1,0
22,3145,0,0,148,148,0,1,0,1,0
9673,2256,0,0,66,66,0,1,0,1,0
4230,2938,0,0,145,145,0,1,0,1,0
16119,2611,0,0,62,62,0,1,0,1,0
1453,1147,0,0,62,62,0,1,0,1,0
18488,697,0,0,145,145,0,1,0,1,0
1795,2836,0,0,66,66,0,1,0,1,0
2625,2256,0,0,146,146,0,1,0,1,0
3096,491,0,0,148,148,0,1,0,1,0
9471,2382,0,0,66,66,0,1,0,1,0
20664,2733,0,0,62,62,0,1,0,1,0
6228,2604,0,0,66,66,0,1,0,1,0
10396,1147,0,0,66,66,0,1,0,1,0
21537,1086,0,0,62,62,0,1,0,1,0
1401,2938,0,0,62,62,0,1,0,1,0
19686,2587,0,0,66,66,0,1,0,1,0
16951,255,0,0,62,62,0,1,0,1,0
21420,1017,0,0,66,66,0,1,0,1,0
2892,1804,0,0,62,62,0,1,0,1,0
10276,3216,0,0,62,62,0,1,0,1,0
13330,2636,0,0,66,66,0,1,0,1,0
2222,1017,0,0,62,62,0,1,0,1,0
17596,1017,0,0,66,66,0,1,0,1,0
1554,697,0,0,62,62,0,1,0,1,0
17873,2235,0,0,66,66,0,1,0,1,0
583,7,0,0,60,60,0,1,0,1,0
16464,3139,0,0,66,66,0,1,0,1,0
3075,3216,0,0,62,62,0,1,0,1,0
7326,1649,0,0,60,60,0,1,0,1,0
10283,2256,0,0,62,62,0,1,0,1,0
21327,1827,0,0,66,66,0,1,0,1,0
12,2346,0,0,332,332,0,1,0,1,0
18042,1888,0,0,66,66,0,1,0,1,0
12796,1771,0,0,62,62,0,1,0,1,0
2603,983,0,0,66,66,0,1,0,1,0
16951,255,0,0,62,62,0,1,0,1,0
676,1711,0,0,146,146,0,1,0,1,0
3988,697,0,0,74,74,0,1,0,1,0
2978,1472,0,0,66,66,0,1,0,1,0
1389,6,0,0,60,60,0,1,0,1,0
15790,2601,0,0,66,66,0,1,0,1,0
1860,3139,0,0,62,62,0,1,0,1,0
13443,1888,0,0,66,66,0,1,0,1,0
21541,1888,0,0,74,74,0,1,0,1,0
18788,2975,0,0,62,62,0,1,0,1,0
16464,3139,0,0,62,62,0,1,0,1,0
542,2587,0,0,66,66,0,1,0,1,0
16287,3216,0,0,66,66,0,1,0,1,0
12611,2938,0,0,66,66,0,1,0,1,0
14696,2938,0,0,62,62,0,1,0,1,0
7375,1594,0,0,74,74,0,1,0,1,0
704,1147,0,0,66,66,0,1,0,1,0
8171,1073,0,0,60,60,0,1,0,1,0
374,1147,0,0,62,62,0,1,0,1,0
31,263,0,0,72,72,0,1,0,1,0
21641,1147,0,0,66,66,0,1,0,1,0
5699,2938,0,0,74,74,0,1,0,1,0
7344,2636,0,0,62,62,0,1,0,1,0
4504,2486,0,0,62,62,0,1,0,1,0
1551,2953,0,0,66,66,0,1,0,1,0
7530,2953,0,0,66,66,0,1,0,1,0
1439,2573,0,0,62,62,0,1,0,1,0
962,1771,0,0,62,62,0,1,0,1,0
12423,2144,0,0,66,66,0,1,0,1,0
360,3105,0,0,918,918,0,1,0,1,0
9859,2587,0,0,74,74,0,1,0,1,0
763,1888,0,0,62,62,0,1,0,1,0
17024,2205,0,0,66,66,0,1,0,1,0
21143,1147,0,0,62,62,0,1,0,1,0
499,187,0,0,345,345,0,1,0,1,0
16569,201,0,0,146,146,0,1,0,1,0
8171,1073,0,0,60,60,0,1,0,1,0
2049,1215,0,0,66,66,0,1,0,1,0
16951,255,0,0,62,62,0,1,0,1,0
16083,1771,0,0,66,66,0,1,0,1,0
9382,255,0,0,60,60,0,1,0,1,0
12957,956,0,0,66,66,0,1,0,1,0
2718,1888,0,0,62,62,0,1,0,1,0
2493,3216,0,0,66,66,0,1,0,1,0
17323,2636,0,0,66,66,0,1,0,1,0
7624,2938,0,0,62,62,0,1,0,1,0
20877,2587,0,0,66,66,0,1,0,1,0
16479,2433,0,0,60,60,0,1,0,1,0
1402,2938,0,0,62,62,0,1,0,1,0
10770,1888,0,0,66,66,0,1,0,1,0
20039,1936,0,0,145,145,0,1,0,1,0
11196,1215,0,0,66,66,0,1,0,1,0
279,6,0,0,60,60,0,1,0,1,0
16214,3216,0,0,66,66,0,1,0,1,0
7335,1070,0,0,60,60,0,1,0,1,0
17222,2938,0,0,66,66,0,1,0,1,0
10203,2883,0,0,66,66,0,1,0,1,0
1281,2543,0,0,60,60,0,1,0,1,0
9714,2938,0,0,66,66,0,1,0,1,0
2482,3216,0,0,66,66,0,1,0,1,0
8275,1017,0,0,146,146,0,1,0,1,0
2043,7,0,0,60,60,0,1,0,1,0
9438,3139,0,0,146,146,0,1,0,1,0
3163,3046,0,0,100,100,0,1,0,1,0
11435,1792,0,0,70,70,0,1,0,1,0
706,2587,0,0,66,66,0,1,0,1,0
21267,2587,0,0,62,62,0,1,0,1,0
20840,1880,0,0,62,62,0,1,0,1,0
2851,2695,0,0,74,74,0,1,0,1,0
3115,1804,0,0,62,62,0,1,0,1,0
2502,2587,0,0,62,62,0,1,0,1,0
1502,2697,0,0,66,66,0,1,0,1,0
1318,2636,0,0,66,66,0,1,0,1,0
7507,2587,0,0,66,66,0,1,0,1,0
226,1147,0,0,146,146,0,1,0,1,0
14745,2883,0,0,66,66,0,1,0,1,0
2609,357,0,0,66,66,0,1,0,1,0
692,2611,0,0,66,66,0,1,0,1,0
11158,1880,0,0,66,66,0,1,0,1,0
18821,2604,0,0,66,66,0,1,0,1,0
19943,155,0,0,66,66,0,1,0,1,0
16951,255,0,0,62,62,0,1,0,1,0
1121,2636,0,0,66,66,0,1,0,1,0
450,126,0,0,136,136,0,1,0,1,0
18501,797,0,0,66,66,0,1,0,1,0
3184,2587,0,0,146,146,0,1,0,1,0
566,1017,0,0,62,62,0,1,0,1,0
12,972,0,0,83,83,0,1,0,1,0
285,1763,0,0,66,66,0,1,0,1,0
7697,1147,0,0,62,62,0,1,0,1,0
9511,1888,0,0,66,66,0,1,0,1,0
1618,1017,0,0,62,62,0,1,0,1,0
2906,1888,0,0,62,62,0,1,0,1,0
1525,1444,0,0,145,145,0,1,0,1,0
8133,1888,0,0,62,62,0,1,0,1,0
19743,406,0,0,60,60,0,1,0,1,0
1851,1771,0,0,62,62,0,1,0,1,0
8171,1073,0,0,60,60,0,1,0,1,0
20659,1771,0,0,146,146,0,1,0,1,0
18298,12,0,0,60,60,0,1,0,1,0
2087,3216,0,0,62,62,0,1,0,1,0
3150,1472,0,0,66,66,0,1,0,1,0
16896,2581,0,0,66,66,0,1,0,1,0
11094,1017,0,0,66,66,0,1,0,1,0
3466,242,0,0,143,143,0,1,0,1,0
8164,2728,0,0,60,60,0,1,0,1,0
1548,2611,0,0,62,62,0,1,0,1,0
1710,1017,0,0,62,62,0,1,0,1,0
21636,1888,0,0,66,66,0,1,0,1,0
7628,1721,0,0,60,60,0,1,0,1,0
2320,2587,0,0,62,62,0,1,0,1,0
3163,2360,0,0,100,100,0,1,0,1,0
243,2587,0,0,66,66,0,1,0,1,0
18362,1167,0,0,62,62,0,1,0,1,0
15588,2144,0,0,62,62,0,1,0,1,0
5626,1147,0,0,62,62,0,1,0,1,0
3955,1472,0,0,66,66,0,1,0,1,0
2548,2572,0,0,60,60,0,1,0,1,0
2084,1471,0,0,145,145,0,1,0,1,0
18053,2256,0,0,62,62,0,1,0,1,0
2833,1888,0,0,62,62,0,1,0,1,0
17188,1086,0,0,62,62,0,1,0,1,0
18376,1493,0,0,66,66,0,1,0,1,0
6480,7,0,0,60,60,0,1,0,1,0
8444,2636,0,0,66,66,0,1,0,1,0
16951,255,0,0,62,62,0,1,0,1,0
3416,2587,0,0,62,62,0,1,0,1,0
5294,1147,0,0,146,146,0,1,0,1,0
16633,1880,0,0,66,66,0,1,0,1,0
10335,2205,0,0,66,66,0,1,0,1,0
3060,1888,0,0,72,72,0,1,0,1,0
2955,391,0,0,60,60,0,1,0,1,0
12269,2570,0,0,145,145,0,1,0,1,0
7,12,0,0,346,346,0,1,0,1,0
17740,1888,0,0,62,62,0,1,0,1,0
2648,3216,0,0,62,62,0,1,0,1,0
4073,1017,0,0,62,62,0,1,0,1,0
20458,2636,0,0,62,62,0,1,0,1,0
18686,509,0,0,66,66,0,1,0,1,0
20515,2587,0,0,62,62,0,1,0,1,0
16621,1906,0,0,66,66,0,1,0,1,0
8977,1215,0,0,62,62,0,1,0,1,0
1776,280,0,0,146,146,0,1,0,1,0
10513,3216,0,0,66,66,0,1,0,1,0
18424,2938,0,0,62,62,0,1,0,1,0
360,3105,0,0,1345,1345,0,1,0,1,0
1218,983,0,0,62,62,0,1,0,1,0
636,453,0,0,107,107,0,1,0,1,0
21979,1539,0,0,66,66,0,1,0,1,0
3201,2938,0,0,60,60,0,1,0,1,0
18,3216,0,0,109,109,0,1,0,1,0
3164,1147,0,0,146,146,0,1,0,1,0
12914,255,0,0,60,60,0,1,0,1,0
2175,1888,0,0,145,145,0,1,0,1,0
83,2938,0,0,146,146,0,1,0,1,0
360,3105,0,0,1118,1118,0,1,0,1,0
20216,1771,0,0,66,66,0,1,0,1,0
16949,2636,0,0,62,62,0,1,0,1,0
6376,2899,0,0,74,74,0,1,0,1,0
12096,2587,0,0,66,66,0,1,0,1,0
9360,1215,0,0,62,62,0,1,0,1,0
10490,1017,0,0,66,66,0,1,0,1,0
740,1017,0,0,66,66,0,1,0,1,0
21001,3216,0,0,62,62,0,1,0,1,0
1387,1771,0,0,66,66,0,1,0,1,0
13807,1880,0,0,62,62,0,1,0,1,0
17,215,0,0,66,66,0,1,0,1,0
18213,1017,0,0,62,62,0,1,0,1,0
19135,1771,0,0,146,146,0,1,0,1,0
7038,1215,0,0,62,62,0,1,0,1,0
12,846,0,0,60,60,0,1,0,1,0
12116,3212,0,0,66,66,0,1,0,1,0
3179,3269,0,0,148,148,0,1,0,1,0
2368,3216,0,0,62,62,0,1,0,1,0
17889,3139,0,0,62,62,0,1,0,1,0
7335,1070,0,0,60,60,0,1,0,1,0
23,2256,0,0,62,62,0,1,0,1,0
2138,1215,0,0,66,66,0,1,0,1,0
1783,2587,0,0,62,62,0,1,0,1,0
12,3140,0,0,199,199,0,1,0,1,0
9214,3257,0,0,60,60,0,1,0,1,0
16951,255,0,0,62,62,0,1,0,1,0
1804,3211,0,0,60,60,0,1,0,1,0
16951,255,0,0,62,62,0,1,0,1,0
41,697,0,0,62,62,0,1,0,1,0
5990,1147,0,0,62,62,0,1,0,1,0
2390,1880,0,0,62,62,0,1,0,1,0
16141,983,0,0,66,66,0,1,0,1,0
20929,2256,0,0,66,66,0,1,0,1,0
1188,1539,0,0,146,146,0,1,0,1,0
14967,2587,0,0,62,62,0,1,0,1,0
20406,5,0,0,60,60,0,1,0,1,0
9538,1147,0,0,62,62,0,1,0,1,0
14058,2938,0,0,74,74,0,1,0,1,0
659,1054,0,0,62,62,0,1,0,1,0
16087,2587,0,0,66,66,0,1,0,1,0
11029,1888,0,0,62,62,0,1,0,1,0
16985,1827,0,0,70,70,0,1,0,1,0
4079,1147,0,0,66,66,0,1,0,1,0
7748,1771,0,0,62,62,0,1,0,1,0
1804,2232,0,0,60,60,0,1,0,1,0
12,2211,0,0,74,74,0,1,0,1,0
1620,2883,0,0,62,62,0,1,0,1,0
12,258,0,0,66,66,0,1,0,1,0
10475,6,0,0,60,60,0,1,0,1,0
20923,1888,0,0,66,66,0,1,0,1,0
6809,1472,0,0,146,146,0,1,0,1,0
15694,333,0,0,145,145,0,1,0,1,0
3807,2610,0,0,60,60,0,1,0,1,0
1804,1762,0,0,60,60,0,1,0,1,0
16951,255,0,0,62,62,0,1,0,1,0
16951,255,0,0,62,62,0,1,0,1,0
3254,2382,0,0,66,66,0,1,0,1,0
2211,2567,0,0,66,66,0,1,0,1,0
7326,1649,0,0,60,60,0,1,0,1,0
11357,1017,0,0,66,66,0,1,0,1,0
11482,1804,0,0,62,62,0,1,0,1,0
2060,1888,0,0,62,62,0,1,0,1,0
12291,2256,0,0,62,62,0,1,0,1,0
16951,255,0,0,62,62,0,1,0,1,0
10706,2636,0,0,66,66,0,1,0,1,0
55,2938,0,0,145,145,0,1,0,1,0
12067,1215,0,0,62,62,0,1,0,1,0
2765,3216,0,0,62,62,0,1,0,1,0
6556,2587,0,0,62,62,0,1,0,1,0
778,1888,0,0,146,146,0,1,0,1,0
677,3216,0,0,66,66,0,1,0,1,0
16951,255,0,0,62,62,0,1,0,1,0
19590,2256,0,0,62,62,0,1,0,1,0
1324,2587,0,0,66,66,0,1,0,1,0
11632,308,0,0,66,66,0,1,0,1,0
16951,255,0,0,62,62,0,1,0,1,0
1825,460,0,0,66,66,0,1,0,1,0
7339,152,0,0,60,60,0,1,0,1,0
2592,7,0,0,60,60,0,1,0,1,0
6651,1129,0,0,156,156,0,1,0,1,0
3049,1215,0,0,66,66,0,1,0,1,0
8918,2587,0,0,62,62,0,1,0,1,0
16284,1880,0,0,66,66,0,1,0,1,0
5573,7,0,0,60,60,0,1,0,1,0
19559,1154,0,0,62,62,0,1,0,1,0
10293,2883,0,0,66,66,0,1,0,1,0
2289,437,0,0,62,62,0,1,0,1,0
14169,2938,0,0,66,66,0,1,0,1,0
15525,1017,0,0,146,146,0,1,0,1,0
7888,1147,0,0,146,146,0,1,0,1,0
22613,1215,0,0,62,62,0,1,0,1,0
14577,2883,0,0,66,66,0,1,0,1,0
13440,2587,0,0,66,66,0,1,0,1,0
3430,1472,0,0,66,66,0,1,0,1,0
3984,1819,0,0,74,74,0,1,0,1,0
6243,2938,0,0,62,62,0,1,0,1,0
612,3131,0,0,60,60,0,1,0,1,0
945,1590,0,0,72,72,0,1,0,1,0
7339,170,0,0,60,60,0,1,0,1,0
2465,459,0,0,145,145,0,1,0,1,0
60,2382,0,0,62,62,0,1,0,1,0
1804,192,0,0,60,60,0,1,0,1,0
7555,397,0,0,60,60,0,1,0,1,0
99,1462,0,0,62,62,0,1,0,1,0
16064,1147,0,0,146,146,0,1,0,1,0
101,1771,0,0,62,62,0,1,0,1,0
6889,1888,0,0,62,62,0,1,0,1,0
1271,2938,0,0,62,62,0,1,0,1,0
7335,1070,0,0,60,60,0,1,0,1,0
8523,2587,0,0,62,62,0,1,0,1,0
7335,1072,0,0,60,60,0,1,0,1,0
11755,1827,0,0,62,62,0,1,0,1,0
6993,3216,0,0,62,62,0,1,0,1,0
16951,255,0,0,62,62,0,1,0,1,0
1913,2573,0,0,62,62,0,1,0,1,0
360,3105,0,0,982,982,0,1,0,1,0
756,1147,0,0,62,62,0,1,0,1,0
20345,2883,0,0,62,62,0,1,0,1,0
12421,1792,0,0,62,62,0,1,0,1,0
4143,1,0,0,146,146,0,1,0,1,0
1213,2695,0,0,62,62,0,1,0,1,0
15593,1804,0,0,66,66,0,1,0,1,0
12,3116,0,0,1484,1484,0,1,0,1,0
9614,3105,0,0,86,86,0,1,0,1,0
6872,41,0,0,60,60,0,1,0,1,0
10605,2587,0,0,66,66,0,1,0,1,0
10261,427,0,0,66,66,0,1,0,1,0
21,437,0,0,146,146,0,1,0,1,0
15140,427,0,0,78,78,0,1,0,1,0
11712,2938,0,0,66,66,0,1,0,1,0
8970,3216,0,0,66,66,0,1,0,1,0
2410,3216,0,0,62,62,0,1,0,1,0
9504,1771,0,0,62,62,0,1,0,1,0
16951,255,0,0,62,62,0,1,0,1,0
615,18,0,0,90,90,0,1,0,1,0
20917,1472,0,0,66,66,0,1,0,1,0
17409,2636,0,0,66,66,0,1,0,1,0
497,995,0,0,60,60,0,1,0,1,0
22684,509,0,0,66,66,0,1,0,1,0
17176,2938,0,0,66,66,0,1,0,1,0
2214,1367,0,0,60,60,0,1,0,1,0
15657,2636,0,0,62,62,0,1,0,1,0
7032,2938,0,0,74,74,0,1,0,1,0
2529,1017,0,0,66,66,0,1,0,1,0
4070,697,0,0,66,66,0,1,0,1,0
16951,255,0,0,62,62,0,1,0,1,0
12,3074,0,0,320,320,0,1,0,1,0
11640,1147,0,0,66,66,0,1,0,1,0
7283,3216,0,0,62,62,0,1,0,1,0
1814,1147,0,0,62,62,0,1,0,1,0
5498,2636,0,0,62,62,0,1,0,1,0
3691,983,0,0,62,62,0,1,0,1,0
21776,2938,0,0,66,66,0,1,0,1,0
19269,3216,0,0,62,62,0,1,0,1,0
6815,3216,0,0,62,62,0,1,0,1,0
11427,1017,0,0,62,62,0,1,0,1,0
369,1472,0,0,62,62,0,1,0,1,0
16951,255,0,0,62,62,0,1,0,1,0
6292,1017,0,0,62,62,0,1,0,1,0
19156,1017,0,0,66,66,0,1,0,1,0
21313,1086,0,0,62,62,0,1,0,1,0
2590,1804,0,0,62,62,0,1,0,1,0
5822,104,0,0,60,60,0,1,0,1,0
1611,2611,0,0,66,66,0,1,0,1,0
5267,155,0,0,62,62,0,1,0,1,0
10367,1888,0,0,66,66,0,1,0,1,0
2976,1888,0,0,62,62,0,1,0,1,0
2389,3216,0,0,66,66,0,1,0,1,0
8553,3216,0,0,62,62,0,1,0,1,0
12049,1147,0,0,62,62,0,1,0,1,0
731,2256,0,0,66,66,0,1,0,1,0
4073,1017,0,0,62,62,0,1,0,1,0
6733,2573,0,0,72,72,0,1,0,1,0
496,321,0,0,66,66,0,1,0,1,0
1657,1888,0,0,62,62,0,1,0,1,0
22417,1771,0,0,66,66,0,1,0,1,0
479,3147,0,0,66,66,0,1,0,1,0
16214,3216,0,0,66,66,0,1,0,1,0
22589,300,0,0,62,62,0,1,0,1,0
1329,2636,0,0,66,66,0,1,0,1,0
18865,1147,0,0,66,66,0,1,0,1,0
1666,1804,0,0,62,62,0,1,0,1,0
1800,1771,0,0,62,62,0,1,0,1,0
411,2636,0,0,62,62,0,1,0,1,0
11450,1686,0,0,60,60,0,1,0,1,0
1449,1771,0,0,62,62,0,1,0,1,0
683,1017,0,0,62,62,0,1,0,1,0
1499,1147,0,0,62,62,0,1,0,1,0
2141,1888,0,0,62,62,0,1,0,1,0
1982,3216,0,0,62,62,0,1,0,1,0
639,2432,0,0,143,143,0,1,0,1,0
3053,310,0,0,145,145,0,1,0,1,0
13532,2636,0,0,62,62,0,1,0,1,0
10052,3057,0,0,66,66,0,1,0,1,0
3223,383,0,0,66,66,0,1,0,1,0
655,1219,0,0,139,139,0,1,0,1,0
20553,1888,0,0,66,66,0,1,0,1,0
1445,1539,0,0,62,62,0,1,0,1,0
5620,1017,0,0,146,146,0,1,0,1,0
8349,983,0,0,66,66,0,1,0,1,0
16951,255,0,0,62,62,0,1,0,1,0
12326,255,0,0,60,60,0,1,0,1,0
360,3105,0,0,1262,1262,0,1,0,1,0
13074,181,0,0,60,60,0,1,0,1,0
13630,697,0,0,66,66,0,1,0,1,0
321,3216,0,0,62,62,0,1,0,1,0
21,3216,0,0,62,62,0,1,0,1,0
3049,1215,0,0,66,66,0,1,0,1,0
7213,357,0,0,62,62,0,1,0,1,0
16951,255,0,0,62,62,0,1,0,1,0
9243,1224,0,0,62,62,0,1,0,1,0
20733,1880,0,0,66,66,0,1,0,1,0
13282,1771,0,0,66,66,0,1,0,1,0
16328,2953,0,0,66,66,0,1,0,1,0
12,2520,0,0,97,97,0,1,0,1,0
16779,2256,0,0,62,62,0,1,0,1,0
3049,1215,0,0,62,62,0,1,0,1,0
289,1472,0,0,62,62,0,1,0,1,0
1913,2573,0,0,145,145,0,1,0,1,0
18498,1771,0,0,62,62,0,1,0,1,0
16951,255,0,0,62,62,0,1,0,1,0
8415,1797,0,0,66,66,0,1,0,1,0
1710,1017,0,0,62,62,0,1,0,1,0
2005,2587,0,0,146,146,0,1,0,1,0
7339,140,0,0,60,60,0,1,0,1,0
196,1771,0,0,66,66,0,1,0,1,0
7517,2938,0,0,62,62,0,1,0,1,0
21313,1086,0,0,66,66,0,1,0,1,0
266,1086,0,0,62,62,0,1,0,1,0
3785,2477,0,0,60,60,0,1,0,1,0
4826,2573,0,0,66,66,0,1,0,1,0
2635,411,0,0,145,145,0,1,0,1,0
17822,2938,0,0,62,62,0,1,0,1,0
12552,1147,0,0,66,66,0,1,0,1,0
1242,1017,0,0,62,62,0,1,0,1,0
2358,1147,0,0,146,146,0,1,0,1,0
684,2938,0,0,62,62,0,1,0,1,0
1962,2608,0,0,62,62,0,1,0,1,0
4807,1017,0,0,66,66,0,1,0,1,0
1131,2938,0,0,62,62,0,1,0,1,0
12384,2256,0,0,66,66,0,1,0,1,0
12198,1017,0,0,66,66,0,1,0,1,0
85,2587,0,0,62,62,0,1,0,1,0
19407,3216,0,0,62,62,0,1,0,1,0
2217,2883,0,0,66,66,0,1,0,1,0
9877,1888,0,0,62,62,0,1,0,1,0
17091,1147,0,0,62,62,0,1,0,1,0
3124,1771,0,0,146,146,0,1,0,1,0
16014,2636,0,0,66,66,0,1,0,1,0
22468,201,0,0,78,78,0,1,0,1,0
16951,255,0,0,62,62,0,1,0,1,0
259,1472,0,0,62,62,0,1,0,1,0
16951,255,0,0,62,62,0,1,0,1,0
16951,255,0,0,62,62,0,1,0,1,0
6918,280,0,0,146,146,0,1,0,1,0
21084,1147,0,0,62,62,0,1,0,1,0
16951,255,0,0,62,62,0,1,0,1,0
20822,2256,0,0,62,62,0,1,0,1,0
3380,2587,0,0,62,62,0,1,0,1,0
360,3105,0,0,1262,1262,0,1,0,1,0
16951,255,0,0,62,62,0,1,0,1,0
16558,1017,0,0,62,62,0,1,0,1,0
21016,1147,0,0,66,66,0,1,0,1,0
22046,1888,0,0,62,62,0,1,0,1,0
844,2938,0,0,146,146,0,1,0,1,0
19826,2883,0,0,62,62,0,1,0,1,0
7335,1070,0,0,60,60,0,1,0,1,0
16951,255,0,0,62,62,0,1,0,1,0
1335,7,0,0,60,60,0,1,0,1,0
19369,2938,0,0,66,66,0,1,0,1,0
19130,2787,0,0,62,62,0,1,0,1,0
347,2587,0,0,66,66,0,1,0,1,0
12078,3139,0,0,62,62,0,1,0,1,0
15263,1147,0,0,66,66,0,1,0,1,0
20053,2587,0,0,66,66,0,1,0,1,0
14577,2883,0,0,66,66,0,1,0,1,0
5491,2486,0,0,148,148,0,1,0,1,0
2427,1017,0,0,62,62,0,1,0,1,0
152,3216,0,0,66,66,0,1,0,1,0
6937,7,0,0,60,60,0,1,0,1,0
21291,2938,0,0,74,74,0,1,0,1,0
9614,3105,0,0,86,86,0,1,0,1,0
8043,1888,0,0,62,62,0,1,0,1,0
22457,1888,0,0,66,66,0,1,0,1,0
20067,1888,0,0,66,66,0,1,0,1,0
196,1771,0,0,66,66,0,1,0,1,0
2365,1472,0,0,62,62,0,1,0,1,0
17811,1880,0,0,66,66,0,1,0,1,0
4309,2587,0,0,62,62,0,1,0,1,0
5549,7,0,0,60,60,0,1,0,1,0
3380,2587,0,0,146,146,0,1,0,1,0
13697,2938,0,0,78,78,0,1,0,1,0
693,2256,0,0,66,66,0,1,0,1,0
9938,1804,0,0,62,62,0,1,0,1,0
16951,255,0,0,62,62,0,1,0,1,0
1804,375,0,0,60,60,0,1,0,1,0
8285,2256,0,0,62,62,0,1,0,1,0
13465,2587,0,0,62,62,0,1,0,1,0
16951,255,0,0,62,62,0,1,0,1,0
16568,1215,0,0,62,62,0,1,0,1,0
1928,1804,0,0,62,62,0,1,0,1,0
20306,775,0,0,66,66,0,1,0,1,0
15539,1771,0,0,62,62,0,1,0,1,0
12,447,0,0,60,60,0,1,0,1,0
3574,2938,0,0,74,74,0,1,0,1,0
21599,2636,0,0,66,66,0,1,0,1,0
1343,2154,0,0,62,62,0,1,0,1,0
20840,1880,0,0,62,62,0,1,0,1,0
10775,2938,0,0,145,145,0,1,0,1,0
7326,1649,0,0,60,60,0,1,0,1,0
16727,176,0,0,60,60,0,1,0,1,0
20231,1771,0,0,62,62,0,1,0,1,0
19901,2587,0,0,66,66,0,1,0,1,0
1884,509,0,0,66,66,0,1,0,1,0
2367,2953,0,0,146,146,0,1,0,1,0
3058,3262,0,0,60,60,0,1,0,1,0
1704,1215,0,0,62,62,0,1,0,1,0
3255,509,0,0,146,146,0,1,0,1,0
18332,1017,0,0,66,66,0,1,0,1,0
66,1147,0,0,62,62,0,1,0,1,0
17858,1763,0,0,62,62,0,1,0,1,0
19870,1888,0,0,62,62,0,1,0,1,0
16338,2636,0,0,66,66,0,1,0,1,0
1700,1147,0,0,146,146,0,1,0,1,0
15997,2938,0,0,66,66,0,1,0,1,0
12,972,0,0,83,83,0,1,0,1,0
8795,1215,0,0,66,66,0,1,0,1,0
16951,255,0,0,62,62,0,1,0,1,0
497,995,0,0,91,91,0,1,0,1,0
4711,2256,0,0,62,62,0,1,0,1,0
22091,1215,0,0,62,62,0,1,0,1,0
1663,2953,0,0,66,66,0,1,0,1,0
16951,255,0,0,62,62,0,1,0,1,0
2302,1472,0,0,62,62,0,1,0,1,0
10799,2636,0,0,66,66,0,1,0,1,0
2061,3216,0,0,62,62,0,1,0,1,0
3032,2587,0,0,62,62,0,1,0,1,0
2865,1017,0,0,62,62,0,1,0,1,0
8168,2938,0,0,62,62,0,1,0,1,0
370,2938,0,0,62,62,0,1,0,1,0
5276,2256,0,0,62,62,0,1,0,1,0
16951,255,0,0,62,62,0,1,0,1,0
16029,308,0,0,66,66,0,1,0,1,0
1248,1017,0,0,62,62,0,1,0,1,0
326,1888,0,0,62,62,0,1,0,1,0
11340,1215,0,0,62,62,0,1,0,1,0
9479,3216,0,0,66,66,0,1,0,1,0
9271,2636,0,0,62,62,0,1,0,1,0
22293,1017,0,0,66,66,0,1,0,1,0
2659,2611,0,0,78,78,0,1,0,1,0
2751,1147,0,0,62,62,0,1,0,1,0
10474,2776,0,0,136,136,0,1,0,1,0
16951,255,0,0,62,62,0,1,0,1,0
20571,1771,0,0,62,62,0,1,0,1,0
1525,1444,0,0,145,145,0,1,0,1,0
2850,1792,0,0,62,62,0,1,0,1,0
4000,2636,0,0,146,146,0,1,0,1,0
2901,1017,0,0,62,62,0,1,0,1,0
10103,509,0,0,66,66,0,1,0,1,0
18117,3216,0,0,62,62,0,1,0,1,0
2473,2636,0,0,62,62,0,1,0,1,0
19278,1147,0,0,66,66,0,1,0,1,0
19644,1888,0,0,66,66,0,1,0,1,0
1252,3216,0,0,62,62,0,1,0,1,0
14363,2587,0,0,62,62,0,1,0,1,0
21990,2611,0,0,62,62,0,1,0,1,0
2497,3216,0,0,62,62,0,1,0,1,0
14805,2587,0,0,62,62,0,1,0,1,0
22382,2256,0,0,66,66,0,1,0,1,0
4756,7,0,0,60,60,0,1,0,1,0
16548,459,0,0,66,66,0,1,0,1,0
9788,1771,0,0,66,66,0,1,0,1,0
2504,1147,0,0,62,62,0,1,0,1,0
1804,927,0,0,60,60,0,1,0,1,0
2501,3216,0,0,66,66,0,1,0,1,0
7339,2845,0,0,60,60,0,1,0,1,0
16951,255,0,0,62,62,0,1,0,1,0
7339,170,0,0,60,60,0,1,0,1,0
1688,2256,0,0,62,62,0,1,0,1,0
12493,3216,0,0,66,66,0,1,0,1,0
19462,2883,0,0,66,66,0,1,0,1,0
0,0,0,0,98,98,0,1,0,1,0
2236,2611,0,0,62,62,0,1,0,1,0
2071,1888,0,0,62,62,0,1,0,1,0
16951,255,0,0,62,62,0,1,0,1,0
16951,255,0,0,62,62,0,1,0,1,0
844,3252,0,0,146,146,0,1,0,1,0
15643,2938,0,0,62,62,0,1,0,1,0
7537,1086,0,0,62,62,0,1,0,1,0
637,3216,0,0,146,146,0,1,0,1,0
16233,909,0,0,66,66,0,1,0,1,0
4931,1054,0,0,146,146,0,1,0,1,0
8121,2256,0,0,146,146,0,1,0,1,0
21923,1888,0,0,66,66,0,1,0,1,0
21632,2256,0,0,62,62,0,1,0,1,0
1793,2256,0,0,62,62,0,1,0,1,0
0,0,0,0,70,70,0,1,0,1,0
1125,1215,0,0,62,62,0,1,0,1,0
3228,3139,0,0,62,62,0,1,0,1,0
1821,2256,0,0,62,62,0,1,0,1,0
6243,2938,0,0,62,62,0,1,0,1,0
9906,1017,0,0,66,66,0,1,0,1,0
16951,255,0,0,62,62,0,1,0,1,0
12,2681,0,0,97,97,0,1,0,1,0
6783,7,0,0,60,60,0,1,0,1,0
5881,7,0,0,60,60,0,1,0,1,0
1395,2938,0,0,66,66,0,1,0,1,0
2566,308,0,0,66,66,0,1,0,1,0
20325,10,0,0,88,88,0,1,0,1,0
13146,3216,0,0,62,62,0,1,0,1,0
19931,2235,0,0,66,66,0,1,0,1,0
6581,2975,0,0,66,66,0,1,0,1,0
7030,1215,0,0,62,62,0,1,0,1,0
13291,1215,0,0,62,62,0,1,0,1,0
8795,1215,0,0,62,62,0,1,0,1,0
20048,1797,0,0,66,66,0,1,0,1,0
16030,2883,0,0,66,66,0,1,0,1,0
15072,697,0,0,146,146,0,1,0,1,0
1330,918,0,0,62,62,0,1,0,1,0
1757,1880,0,0,146,146,0,1,0,1,0
13487,1017,0,0,66,66,0,1,0,1,0
778,1888,0,0,146,146,0,1,0,1,0
16951,255,0,0,62,62,0,1,0,1,0
2510,2486,0,0,62,62,0,1,0,1,0
600,1147,0,0,66,66,0,1,0,1,0
5266,2636,0,0,62,62,0,1,0,1,0
2057,1147,0,0,62,62,0,1,0,1,0
1197,1147,0,0,62,62,0,1,0,1,0
12767,697,0,0,62,62,0,1,0,1,0
7661,1771,0,0,62,62,0,1,0,1,0
10081,2353,0,0,62,62,0,1,0,1,0
8883,2938,0,0,62,62,0,1,0,1,0
4593,2256,0,0,62,62,0,1,0,1,0
20228,2486,0,0,148,148,0,1,0,1,0
10396,1147,0,0,66,66,0,1,0,1,0
2368,3216,0,0,62,62,0,1,0,1,0
16951,255,0,0,62,62,0,1,0,1,0
7273,1,0,0,62,62,0,1,0,1,0
276,9,0,0,60,60,0,1,0,1,0
15221,2486,0,0,62,62,0,1,0,1,0
3457,3216,0,0,62,62,0,1,0,1,0
2416,2938,0,0,62,62,0,1,0,1,0
1285,1771,0,0,62,62,0,1,0,1,0
16951,255,0,0,62,62,0,1,0,1,0
2726,2938,0,0,62,62,0,1,0,1,0
2352,2587,0,0,62,62,0,1,0,1,0
6935,3216,0,0,66,66,0,1,0,1,0
2041,2256,0,0,66,66,0,1,0,1,0
11621,2747,0,0,66,66,0,1,0,1,0
21166,1017,0,0,146,146,0,1,0,1,0
2996,2573,0,0,62,62,0,1,0,1,0
16368,2256,0,0,62,62,0,1,0,1,0
7792,2587,0,0,66,66,0,1,0,1,0
1439,2573,0,0,62,62,0,1,0,1,0
16951,255,0,0,62,62,0,1,0,1,0
636,280,0,0,146,146,0,1,0,1,0
19840,2256,0,0,66,66,0,1,0,1,0
2071,1888,0,0,62,62,0,1,0,1,0
16951,255,0,0,62,62,0,1,0,1,0
318,308,0,0,66,66,0,1,0,1,0
16951,255,0,0,62,62,0,1,0,1,0
10582,2256,0,0,66,66,0,1,0,1,0
10474,2938,0,0,72,72,0,1,0,1,0
12,2880,0,0,97,97,0,1,0,1,0
4476,7,0,0,60,60,0,1,0,1,0
16648,7,0,0,60,60,0,1,0,1,0
17716,2883,0,0,66,66,0,1,0,1,0
483,1017,0,0,62,62,0,1,0,1,0
7326,1649,0,0,60,60,0,1,0,1,0
13950,2587,0,0,66,66,0,1,0,1,0
7084,2938,0,0,62,62,0,1,0,1,0
16951,255,0,0,62,62,0,1,0,1,0
7792,2587,0,0,62,62,0,1,0,1,0
18068,1888,0,0,66,66,0,1,0,1,0
11310,1888,0,0,66,66,0,1,0,1,0
2746,3216,0,0,62,62,0,1,0,1,0
3075,3216,0,0,66,66,0,1,0,1,0
16265,2587,0,0,66,66,0,1,0,1,0
13576,3216,0,0,66,66,0,1,0,1,0
4356,1472,0,0,66,66,0,1,0,1,0
21773,2573,0,0,66,66,0,1,0,1,0
17456,2587,0,0,66,66,0,1,0,1,0
636,2379,0,0,146,146,0,1,0,1,0
11,7,0,0,60,60,0,1,0,1,0
1718,2256,0,0,62,62,0,1,0,1,0
350,1147,0,0,66,66,0,1,0,1,0
19411,2604,0,0,66,66,0,1,0,1,0
2084,1471,0,0,145,145,0,1,0,1,0
12,929,0,0,83,83,0,1,0,1,0
735,1147,0,0,66,66,0,1,0,1,0
193,2256,0,0,66,66,0,1,0,1,0
8171,1073,0,0,60,60,0,1,0,1,0
16951,255,0,0,62,62,0,1,0,1,0
360,3105,0,0,364,364,0,1,0,1,0
1330,804,0,0,62,62,0,1,0,1,0
3685,2703,0,0,145,145,0,1,0,1,0
10141,3216,0,0,145,145,0,1,0,1,0
12268,2587,0,0,62,62,0,1,0,1,0
8503,1147,0,0,62,62,0,1,0,1,0
4496,1147,0,0,146,146,0,1,0,1,0
11737,1147,0,0,66,66,0,1,0,1,0
18925,2550,0,0,66,66,0,1,0,1,0
18741,1086,0,0,66,66,0,1,0,1,0
677,3216,0,0,66,66,0,1,0,1,0
9693,2205,0,0,62,62,0,1,0,1,0
10346,3026,0,0,100,100,0,1,0,1,0
1106,1147,0,0,62,62,0,1,0,1,0
14714,1888,0,0,62,62,0,1,0,1,0
14808,1017,0,0,66,66,0,1,0,1,0
713,2938,0,0,66,66,0,1,0,1,0
432,1771,0,0,62,62,0,1,0,1,0
16951,255,0,0,62,62,0,1,0,1,0
17716,2883,0,0,66,66,0,1,0,1,0
302,3216,0,0,62,62,0,1,0,1,0
1663,2953,0,0,66,66,0,1,0,1,0
6815,3216,0,0,62,62,0,1,0,1,0
22135,1147,0,0,66,66,0,1,0,1,0
16022,3139,0,0,66,66,0,1,0,1,0
4540,1804,0,0,66,66,0,1,0,1,0
15369,2382,0,0,66,66,0,1,0,1,0
16951,255,0,0,62,62,0,1,0,1,0
360,3105,0,0,1188,1188,0,1,0,1,0
10600,1888,0,0,72,72,0,1,0,1,0
497,1610,0,0,119,119,0,1,0,1,0
14592,2256,0,0,62,62,0,1,0,1,0
2084,1471,0,0,145,145,0,1,0,1,0
16657,2587,0,0,66,66,0,1,0,1,0
17740,1888,0,0,62,62,0,1,0,1,0
1525,1444,0,0,145,145,0,1,0,1,0
16951,255,0,0,62,62,0,1,0,1,0
777,1017,0,0,66,66,0,1,0,1,0
39,2778,0,0,62,62,0,1,0,1,0
5841,1901,0,0,157,157,0,1,0,1,0
8,2758,0,0,60,60,0,1,0,1,0
2118,1771,0,0,62,62,0,1,0,1,0
20811,2953,0,0,66,66,0,1,0,1,0
19130,2787,0,0,62,62,0,1,0,1,0
10264,3216,0,0,66,66,0,1,0,1,0
2256,2636,0,0,62,62,0,1,0,1,0
1716,2636,0,0,66,66,0,1,0,1,0
10033,1215,0,0,66,66,0,1,0,1,0
21551,3216,0,0,146,146,0,1,0,1,0
2664,2256,0,0,66,66,0,1,0,1,0
17300,2611,0,0,66,66,0,1,0,1,0
22486,2379,0,0,66,66,0,1,0,1,0
9938,1804,0,0,62,62,0,1,0,1,0
10458,2883,0,0,66,66,0,1,0,1,0
22683,10,0,0,88,88,0,1,0,1,0
610,146,0,0,60,60,0,1,0,1,0
19996,3117,0,0,66,66,0,1,0,1,0
16951,255,0,0,62,62,0,1,0,1,0
5610,2573,0,0,62,62,0,1,0,1,0
3426,2205,0,0,146,146,0,1,0,1,0
13443,2587,0,0,66,66,0,1,0,1,0
6181,1771,0,0,62,62,0,1,0,1,0
18094,510,0,0,66,66,0,1,0,1,0
3531,7,0,0,60,60,0,1,0,1,0
6651,1129,0,0,156,156,0,1,0,1,0
360,3105,0,0,64,64,0,1,0,1,0
3058,3262,0,0,60,60,0,1,0,1,0
1944,1880,0,0,66,66,0,1,0,1,0
774,983,0,0,62,62,0,1,0,1,0
18486,1771,0,0,62,62,0,1,0,1,0
9243,1224,0,0,62,62,0,1,0,1,0
7653,1224,0,0,60,60,0,1,0,1,0
1966,2636,0,0,66,66,0,1,0,1,0
9466,2486,0,0,143,143,0,1,0,1,0
657,1167,0,0,100,100,0,1,0,1,0
14140,3216,0,0,62,62,0,1,0,1,0
9877,1888,0,0,62,62,0,1,0,1,0
2546,2587,0,0,62,62,0,1,0,1,0
360,2277,0,0,109,109,0,1,0,1,0
1289,1771,0,0,66,66,0,1,0,1,0
12057,2256,0,0,146,146,0,1,0,1,0
1266,7,0,0,60,60,0,1,0,1,0
1932,2256,0,0,62,62,0,1,0,1,0
3570,1942,0,0,162,162,0,1,0,1,0
3242,2573,0,0,145,145,0,1,0,1,0
18217,2587,0,0,62,62,0,1,0,1,0
9095,1147,0,0,66,66,0,1,0,1,0
16261,1888,0,0,66,66,0,1,0,1,0
1492,2587,0,0,66,66,0,1,0,1,0
2410,3216,0,0,62,62,0,1,0,1,0
4060,1748,0,0,159,159,0,1,0,1,0
7326,1649,0,0,60,60,0,1,0,1,0
16951,255,0,0,62,62,0,1,0,1,0
14808,1017,0,0,66,66,0,1,0,1,0
3119,7,0,0,60,60,0,1,0,1,0
8,1873,0,0,60,60,0,1,0,1,0
1621,7,0,0,60,60,0,1,0,1,0
22235,2953,0,0,66,66,0,1,0,1,0
17555,1147,0,0,62,62,0,1,0,1,0
7076,1888,0,0,62,62,0,1,0,1,0
7957,2587,0,0,62,62,0,1,0,1,0
16350,1215,0,0,62,62,0,1,0,1,0
21079,1215,0,0,62,62,0,1,0,1,0
6647,1215,0,0,62,62,0,1,0,1,0
18,242,0,0,146,146,0,1,0,1,0
4091,1017,0,0,62,62,0,1,0,1,0
12809,2836,0,0,62,62,0,1,0,1,0
6506,936,0,0,62,62,0,1,0,1,0
16200,2938,0,0,62,62,0,1,0,1,0
1268,1224,0,0,60,60,0,1,0,1,0
5407,1888,0,0,66,66,0,1,0,1,0
17670,3212,0,0,66,66,0,1,0,1,0
12276,1367,0,0,60,60,0,1,0,1,0
12337,3139,0,0,66,66,0,1,0,1,0
13473,1017,0,0,62,62,0,1,0,1,0
828,7,0,0,60,60,0,1,0,1,0
18685,1771,0,0,62,62,0,1,0,1,0
9944,1,0,0,62,62,0,1,0,1,0
16727,174,0,0,60,60,0,1,0,1,0
13468,2587,0,0,66,66,0,1,0,1,0
14667,1147,0,0,62,62,0,1,0,1,0
7141,3216,0,0,72,72,0,1,0,1,0
6929,183,0,0,60,60,0,1,0,1,0
19198,2883,0,0,66,66,0,1,0,1,0
19006,3216,0,0,62,62,0,1,0,1,0
845,280,0,0,62,62,0,1,0,1,0
636,280,0,0,62,62,0,1,0,1,0
1671,26,0,0,60,60,0,1,0,1,0
9614,3105,0,0,86,86,0,1,0,1,0
15522,6,0,0,60,60,0,1,0,1,0
6889,1888,0,0,62,62,0,1,0,1,0
17467,2943,0,0,66,66,0,1,0,1,0
16951,255,0,0,62,62,0,1,0,1,0
16145,2144,0,0,66,66,0,1,0,1,0
19806,1017,0,0,66,66,0,1,0,1,0
514,1589,0,0,66,66,0,1,0,1,0
2983,1147,0,0,146,146,0,1,0,1,0
18221,2883,0,0,66,66,0,1,0,1,0
2295,1472,0,0,66,66,0,1,0,1,0
1604,1,0,0,66,66,0,1,0,1,0
1836,491,0,0,148,148,0,1,0,1,0
396,233,0,0,146,146,0,1,0,1,0
18964,956,0,0,66,66,0,1,0,1,0
12,2346,0,0,332,332,0,1,0,1,0
696,7,0,0,60,60,0,1,0,1,0
1588,1703,0,0,62,62,0,1,0,1,0
11942,1804,0,0,66,66,0,1,0,1,0
2125,2587,0,0,66,66,0,1,0,1,0
14889,804,0,0,146,146,0,1,0,1,0
5153,1017,0,0,66,66,0,1,0,1,0
612,714,0,0,60,60,0,1,0,1,0
5449,2747,0,0,146,146,0,1,0,1,0
2672,1147,0,0,62,62,0,1,0,1,0
3639,104,0,0,60,60,0,1,0,1,0
18970,1017,0,0,66,66,0,1,0,1,0
11663,2883,0,0,62,62,0,1,0,1,0
17135,797,0,0,66,66,0,1,0,1,0
8034,2836,0,0,62,62,0,1,0,1,0
2679,1147,0,0,62,62,0,1,0,1,0
6571,1,0,0,62,62,0,1,0,1,0
390,432,0,0,66,66,0,1,0,1,0
12083,1771,0,0,66,66,0,1,0,1,0
3244,2611,0,0,66,66,0,1,0,1,0
6727,2256,0,0,66,66,0,1,0,1,0
326,1888,0,0,62,62,0,1,0,1,0
16951,255,0,0,62,62,0,1,0,1,0
7799,362,0,0,159,159,0,1,0,1,0
11916,3216,0,0,62,62,0,1,0,1,0
2726,2938,0,0,62,62,0,1,0,1,0
19408,1880,0,0,66,66,0,1,0,1,0
18267,697,0,0,62,62,0,1,0,1,0
543,1771,0,0,62,62,0,1,0,1,0
12,447,0,0,60,60,0,1,0,1,0
16951,255,0,0,62,62,0,1,0,1,0
16951,255,0,0,62,62,0,1,0,1,0
13129,2256,0,0,66,66,0,1,0,1,0
2799,1017,0,0,62,62,0,1,0,1,0
350,1147,0,0,66,66,0,1,0,1,0
1591,1888,0,0,62,62,0,1,0,1,0
17248,255,0,0,60,60,0,1,0,1,0
15213,3216,0,0,62,62,0,1,0,1,0
5285,3,0,0,60,60,0,1,0,1,0
12320,2256,0,0,62,62,0,1,0,1,0
21555,2587,0,0,66,66,0,1,0,1,0
2459,1771,0,0,66,66,0,1,0,1,0
1687,2636,0,0,66,66,0,1,0,1,0
324,3139,0,0,62,62,0,1,0,1,0
12766,3216,0,0,66,66,0,1,0,1,0
15966,1147,0,0,62,62,0,1,0,1,0
12,3074,0,0,320,320,0,1,0,1,0
7498,1804,0,0,146,146,0,1,0,1,0
59,1147,0,0,62,62,0,1,0,1,0
12995,3216,0,0,66,66,0,1,0,1,0
13,460,0,0,66,66,0,1,0,1,0
20497,2636,0,0,66,66,0,1,0,1,0
17212,509,0,0,66,66,0,1,0,1,0
12,2352,0,0,85,85,0,1,0,1,0
18333,1147,0,0,66,66,0,1,0,1,0
21476,1147,0,0,66,66,0,1,0,1,0
1591,1888,0,0,62,62,0,1,0,1,0
2032,1472,0,0,62,62,0,1,0,1,0
1450,1017,0,0,62,62,0,1,0,1,0
19247,983,0,0,66,66,0,1,0,1,0
16951,255,0,0,62,62,0,1,0,1,0
21501,2587,0,0,66,66,0,1,0,1,0
16464,3139,0,0,66,66,0,1,0,1,0
2680,510,0,0,66,66,0,1,0,1,0
14228,6,0,0,60,60,0,1,0,1,0
17855,2636,0,0,62,62,0,1,0,1,0
5738,3216,0,0,62,62,0,1,0,1,0
13456,1797,0,0,66,66,0,1,0,1,0
580,2636,0,0,62,62,0,1,0,1,0
1161,3216,0,0,62,62,0,1,0,1,0
12268,2587,0,0,66,66,0,1,0,1,0
9374,2938,0,0,66,66,0,1,0,1,0
1342,697,0,0,62,62,0,1,0,1,0
3255,509,0,0,62,62,0,1,0,1,0
12854,1147,0,0,62,62,0,1,0,1,0
20244,2938,0,0,62,62,0,1,0,1,0
8024,22,0,0,60,60,0,1,0,1,0
393,3212,0,0,146,146,0,1,0,1,0
10163,1017,0,0,66,66,0,1,0,1,0
436,3216,0,0,66,66,0,1,0,1,0
14957,2256,0,0,62,62,0,1,0,1,0
5896,3027,0,0,62,62,0,1,0,1,0
5010,255,0,0,60,60,0,1,0,1,0
22033,2611,0,0,66,66,0,1,0,1,0
1407,1888,0,0,66,66,0,1,0,1,0
16951,255,0,0,62,62,0,1,0,1,0
19892,2938,0,0,74,74,0,1,0,1,0
1737,3216,0,0,66,66,0,1,0,1,0
624,2587,0,0,66,66,0,1,0,1,0
3876,1923,0,0,62,62,0,1,0,1,0
1450,1017,0,0,62,62,0,1,0,1,0
3691,983,0,0,62,62,0,1,0,1,0
21923,1888,0,0,66,66,0,1,0,1,0
13346,1880,0,0,66,66,0,1,0,1,0
1801,983,0,0,62,62,0,1,0,1,0
10964,1802,0,0,66,66,0,1,0,1,0
9908,2938,0,0,66,66,0,1,0,1,0
7099,1147,0,0,62,62,0,1,0,1,0
844,344,0,0,146,146,0,1,0,1,0
7375,1594,0,0,74,74,0,1,0,1,0
9583,3216,0,0,66,66,0,1,0,1,0
13071,1017,0,0,146,146,0,1,0,1,0
7266,12,0,0,60,60,0,1,0,1,0
20639,3216,0,0,66,66,0,1,0,1,0
14194,3216,0,0,66,66,0,1,0,1,0
21594,2938,0,0,62,62,0,1,0,1,0
21620,1017,0,0,66,66,0,1,0,1,0
21341,1086,0,0,66,66,0,1,0,1,0
2132,1888,0,0,62,62,0,1,0,1,0
17051,427,0,0,62,62,0,1,0,1,0
197,1017,0,0,62,62,0,1,0,1,0
14543,3212,0,0,62,62,0,1,0,1,0
6478,2938,0,0,62,62,0,1,0,1,0
15214,2486,0,0,62,62,0,1,0,1,0
6555,2587,0,0,66,66,0,1,0,1,0
21620,1017,0,0,62,62,0,1,0,1,0
13194,2587,0,0,146,146,0,1,0,1,0
679,3216,0,0,66,66,0,1,0,1,0
27,1215,0,0,62,62,0,1,0,1,0
22613,1215,0,0,62,62,0,1,0,1,0
6050,2938,0,0,66,66,0,1,0,1,0
20853,1017,0,0,62,62,0,1,0,1,0
16951,255,0,0,62,62,0,1,0,1,0
1791,7,0,0,60,60,0,1,0,1,0
13645,1827,0,0,66,66,0,1,0,1,0
20468,2611,0,0,66,66,0,1,0,1,0
1303,1795,0,0,60,60,0,1,0,1,0
1981,1086,0,0,62,62,0,1,0,1,0
11995,2144,0,0,66,66,0,1,0,1,0
1271,2938,0,0,62,62,0,1,0,1,0
11056,1215,0,0,60,60,0,1,0,1,0
14473,2778,0,0,74,74,0,1,0,1,0
453,1797,0,0,66,66,0,1,0,1,0
12,96,0,0,85,85,0,1,0,1,0
16951,255,0,0,62,62,0,1,0,1,0
20455,2256,0,0,62,62,0,1,0,1,0
18042,847,0,0,66,66,0,1,0,1,0
21078,2587,0,0,146,146,0,1,0,1,0
3457,3216,0,0,62,62,0,1,0,1,0
15519,1,0,0,66,66,0,1,0,1,0
12,3140,0,0,60,60,0,1,0,1,0
13167,1386,0,0,66,66,0,1,0,1,0
19003,2097,0,0,66,66,0,1,0,1,0
9990,1215,0,0,66,66,0,1,0,1,0
17300,2611,0,0,62,62,0,1,0,1,0
13010,1147,0,0,62,62,0,1,0,1,0
16951,255,0,0,62,62,0,1,0,1,0
12,3165,0,0,100,100,0,1,0,1,0
16849,1936,0,0,66,66,0,1,0,1,0
11659,1792,0,0,62,62,0,1,0,1,0
360,3105,0,0,252,252,0,1,0,1,0
1617,1827,0,0,62,62,0,1,0,1,0
10756,3216,0,0,66,66,0,1,0,1,0
10346,1428,0,0,100,100,0,1,0,1,0
21208,2573,0,0,62,62,0,1,0,1,0
5502,1017,0,0,146,146,0,1,0,1,0
11949,2256,0,0,62,62,0,1,0,1,0
20162,2747,0,0,66,66,0,1,0,1,0
3095,3216,0,0,62,62,0,1,0,1,0
15140,427,0,0,78,78,0,1,0,1,0
11308,2256,0,0,62,62,0,1,0,1,0
20571,1771,0,0,66,66,0,1,0,1,0
3590,1880,0,0,62,62,0,1,0,1,0
19996,3117,0,0,62,62,0,1,0,1,0
6669,1215,0,0,66,66,0,1,0,1,0
11282,2362,0,0,62,62,0,1,0,1,0
21390,155,0,0,62,62,0,1,0,1,0
1040,2636,0,0,62,62,0,1,0,1,0
603,1888,0,0,62,62,0,1,0,1,0
2519,2587,0,0,146,146,0,1,0,1,0
4711,2256,0,0,62,62,0,1,0,1,0
3012,3145,0,0,150,150,0,1,0,1,0
20994,697,0,0,66,66,0,1,0,1,0
7653,1224,0,0,60,60,0,1,0,1,0
10756,3216,0,0,62,62,0,1,0,1,0
2635,411,0,0,145,145,0,1,0,1,0
284,3139,0,0,66,66,0,1,0,1,0
17459,2953,0,0,66,66,0,1,0,1,0
4680,2587,0,0,66,66,0,1,0,1,0
11749,1147,0,0,62,62,0,1,0,1,0
3976,1017,0,0,146,146,0,1,0,1,0
8553,3216,0,0,62,62,0,1,0,1,0
10773,3216,0,0,62,62,0,1,0,1,0
7569,3216,0,0,62,62,0,1,0,1,0
2635,411,0,0,145,145,0,1,0,1,0
5511,2856,0,0,137,137,0,1,0,1,0
13790,1215,0,0,66,66,0,1,0,1,0
7984,1017,0,0,66,66,0,1,0,1,0
364,280,0,0,66,66,0,1,0,1,0
9924,2709,0,0,62,62,0,1,0,1,0
10138,1017,0,0,146,146,0,1,0,1,0
823,436,0,0,60,60,0,1,0,1,0
303,3216,0,0,62,62,0,1,0,1,0
331,2739,0,0,66,66,0,1,0,1,0
16951,255,0,0,62,62,0,1,0,1,0
17016,2938,0,0,62,62,0,1,0,1,0
10223,2587,0,0,66,66,0,1,0,1,0
7335,1070,0,0,60,60,0,1,0,1,0
17144,2636,0,0,66,66,0,1,0,1,0
13578,2636,0,0,66,66,0,1,0,1,0
1375,1147,0,0,62,62,0,1,0,1,0
360,3105,0,0,164,164,0,1,0,1,0
16951,255,0,0,62,62,0,1,0,1,0
14637,93,0,0,62,62,0,1,0,1,0
8855,1017,0,0,62,62,0,1,0,1,0
497,615,0,0,66,66,0,1,0,1,0
16951,255,0,0,62,62,0,1,0,1,0
7335,1070,0,0,60,60,0,1,0,1,0
12,2553,0,0,82,82,0,1,0,1,0
12190,2587,0,0,62,62,0,1,0,1,0
22707,252,0,0,62,62,0,1,0,1,0
5094,1888,0,0,62,62,0,1,0,1,0
249,1880,0,0,66,66,0,1,0,1,0
244,1054,0,0,66,66,0,1,0,1,0
11640,1215,0,0,62,62,0,1,0,1,0
21277,983,0,0,66,66,0,1,0,1,0
3876,1923,0,0,62,62,0,1,0,1,0
283,308,0,0,62,62,0,1,0,1,0
2576,1147,0,0,66,66,0,1,0,1,0
19,3216,0,0,62,62,0,1,0,1,0
3187,2636,0,0,62,62,0,1,0,1,0
13129,2256,0,0,62,62,0,1,0,1,0
9102,2938,0,0,62,62,0,1,0,1,0
5634,391,0,0,60,60,0,1,0,1,0
2015,3216,0,0,62,62,0,1,0,1,0
16951,255,0,0,62,62,0,1,0,1,0
2672,1147,0,0,146,146,0,1,0,1,0
9603,3139,0,0,66,66,0,1,0,1,0
21156,3216,0,0,62,62,0,1,0,1,0
19419,2953,0,0,66,66,0,1,0,1,0
6663,3125,0,0,148,148,0,1,0,1,0
1478,146,0,0,60,60,0,1,0,1,0
9563,1215,0,0,62,62,0,1,0,1,0
2283,3216,0,0,66,66,0,1,0,1,0
19225,2486,0,0,62,62,0,1,0,1,0
16951,255,0,0,62,62,0,1,0,1,0
6815,3216,0,0,62,62,0,1,0,1,0
6288,2154,0,0,74,74,0,1,0,1,0
763,1888,0,0,62,62,0,1,0,1,0
9264,1482,0,0,66,66,0,1,0,1,0
702,1017,0,0,66,66,0,1,0,1,0
12276,1367,0,0,60,60,0,1,0,1,0
16951,255,0,0,62,62,0,1,0,1,0
16951,255,0,0,62,62,0,1,0,1,0
13036,1827,0,0,66,66,0,1,0,1,0
15607,2256,0,0,66,66,0,1,0,1,0
7302,2604,0,0,66,66,0,1,0,1,0
2005,2587,0,0,62,62,0,1,0,1,0
163,2205,0,0,62,62,0,1,0,1,0
7339,152,0,0,60,60,0,1,0,1,0
20838,2883,0,0,66,66,0,1,0,1,0
16951,255,0,0,62,62,0,1,0,1,0
18218,1,0,0,62,62,0,1,0,1,0
340,2938,0,0,145,145,0,1,0,1,0
16076,1472,0,0,66,66,0,1,0,1,0
358,509,0,0,66,66,0,1,0,1,0
16951,255,0,0,62,62,0,1,0,1,0
32,1147,0,0,146,146,0,1,0,1,0
243,2587,0,0,66,66,0,1,0,1,0
1333,1472,0,0,66,66,0,1,0,1,0
2454,577,0,0,60,60,0,1,0,1,0
2518,146,0,0,60,60,0,1,0,1,0
18211,1771,0,0,62,62,0,1,0,1,0
16399,1472,0,0,62,62,0,1,0,1,0
360,3105,0,0,1292,1292,0,1,0,1,0
20243,1703,0,0,66,66,0,1,0,1,0
1892,1771,0,0,66,66,0,1,0,1,0
12619,2636,0,0,66,66,0,1,0,1,0
5535,41,0,0,60,60,0,1,0,1,0
9614,3105,0,0,86,86,0,1,0,1,0
4563,2205,0,0,62,62,0,1,0,1,0
4262,7,0,0,60,60,0,1,0,1,0
2287,2636,0,0,62,62,0,1,0,1,0
3876,1923,0,0,62,62,0,1,0,1,0
14505,2312,0,0,78,78,0,1,0,1,0
18741,1086,0,0,62,62,0,1,0,1,0
18491,1147,0,0,66,66,0,1,0,1,0
10595,509,0,0,66,66,0,1,0,1,0
16951,255,0,0,62,62,0,1,0,1,0
12586,1804,0,0,66,66,0,1,0,1,0
16951,255,0,0,62,62,0,1,0,1,0
5908,2587,0,0,66,66,0,1,0,1,0
2590,1804,0,0,66,66,0,1,0,1,0
2563,3216,0,0,62,62,0,1,0,1,0
5753,163,0,0,62,62,0,1,0,1,0
13074,185,0,0,60,60,0,1,0,1,0
19003,2097,0,0,66,66,0,1,0,1,0
4496,1147,0,0,62,62,0,1,0,1,0
1681,1888,0,0,62,62,0,1,0,1,0
7072,7,0,0,60,60,0,1,0,1,0
1453,2205,0,0,146,146,0,1,0,1,0
2214,1367,0,0,60,60,0,1,0,1,0
41,2938,0,0,62,62,0,1,0,1,0
9877,1888,0,0,62,62,0,1,0,1,0
3202,7,0,0,60,60,0,1,0,1,0
1847,2953,0,0,66,66,0,1,0,1,0
6832,1215,0,0,62,62,0,1,0,1,0
8830,1888,0,0,66,66,0,1,0,1,0
10474,1,0,0,72,72,0,1,0,1,0
1713,1147,0,0,146,146,0,1,0,1,0
2608,2883,0,0,66,66,0,1,0,1,0
18198,7,0,0,60,60,0,1,0,1,0
3624,1147,0,0,62,62,0,1,0,1,0
7304,1147,0,0,62,62,0,1,0,1,0
16951,255,0,0,62,62,0,1,0,1,0
7997,1147,0,0,62,62,0,1,0,1,0
11453,1147,0,0,66,66,0,1,0,1,0
22226,1017,0,0,62,62,0,1,0,1,0
19000,245,0,0,60,60,0,1,0,1,0
636,2820,0,0,148,148,0,1,0,1,0
1121,2636,0,0,66,66,0,1,0,1,0
293,1771,0,0,62,62,0,1,0,1,0
1284,1147,0,0,62,62,0,1,0,1,0
17323,2636,0,0,62,62,0,1,0,1,0
1255,1017,0,0,146,146,0,1,0,1,0
7380,2486,0,0,145,145,0,1,0,1,0
14215,2205,0,0,66,66,0,1,0,1,0
572,1888,0,0,62,62,0,1,0,1,0
11029,1888,0,0,62,62,0,1,0,1,0
11342,2256,0,0,146,146,0,1,0,1,0
16287,3216,0,0,66,66,0,1,0,1,0
16444,2881,0,0,90,90,0,1,0,1,0
8073,2938,0,0,145,145,0,1,0,1,0
4463,1054,0,0,66,66,0,1,0,1,0
22134,1202,0,0,148,148,0,1,0,1,0
19057,1888,0,0,62,62,0,1,0,1,0
16951,255,0,0,62,62,0,1,0,1,0
4285,1147,0,0,62,62,0,1,0,1,0
14948,2256,0,0,66,66,0,1,0,1,0
1804,3092,0,0,60,60,0,1,0,1,0
17466,804,0,0,66,66,0,1,0,1,0
1329,2636,0,0,66,66,0,1,0,1,0
16951,255,0,0,62,62,0,1,0,1,0
12,2537,0,0,60,60,0,1,0,1,0
12,2461,0,0,81,81,0,1,0,1,0
8970,280,0,0,66,66,0,1,0,1,0
17799,1888,0,0,62,62,0,1,0,1,0
497,1050,0,0,60,60,0,1,0,1,0
17333,2938,0,0,66,66,0,1,0,1,0
1662,1147,0,0,66,66,0,1,0,1,0
536,3216,0,0,62,62,0,1,0,1,0
2616,1210,0,0,62,62,0,1,0,1,0
10506,201,0,0,100,100,0,1,0,1,0
2273,1017,0,0,62,62,0,1,0,1,0
21918,1154,0,0,62,62,0,1,0,1,0
12678,1827,0,0,66,66,0,1,0,1,0
8171,1073,0,0,60,60,0,1,0,1,0
3065,3117,0,0,62,62,0,1,0,1,0
74,3216,0,0,66,66,0,1,0,1,0
14023,1888,0,0,66,66,0,1,0,1,0
20557,3216,0,0,62,62,0,1,0,1,0
13479,1472,0,0,66,66,0,1,0,1,0
1133,2938,0,0,78,78,0,1,0,1,0
11009,1147,0,0,66,66,0,1,0,1,0
9245,2938,0,0,66,66,0,1,0,1,0
10646,1880,0,0,66,66,0,1,0,1,0
9157,1888,0,0,66,66,0,1,0,1,0
5896,3027,0,0,62,62,0,1,0,1,0
16951,255,0,0,62,62,0,1,0,1,0
17907,2256,0,0,66,66,0,1,0,1,0
2284,1472,0,0,62,62,0,1,0,1,0
10474,1,0,0,72,72,0,1,0,1,0
7226,1147,0,0,62,62,0,1,0,1,0
8038,2953,0,0,62,62,0,1,0,1,0
2095,1471,0,0,145,145,0,1,0,1,0
113,2587,0,0,146,146,0,1,0,1,0
10716,2938,0,0,66,66,0,1,0,1,0
16951,255,0,0,62,62,0,1,0,1,0
22403,2604,0,0,66,66,0,1,0,1,0
2659,2611,0,0,78,78,0,1,0,1,0
2952,7,0,0,60,60,0,1,0,1,0
1626,2883,0,0,62,62,0,1,0,1,0
2752,2611,0,0,72,72,0,1,0,1,0
22510,2611,0,0,78,78,0,1,0,1,0
7339,335,0,0,60,60,0,1,0,1,0
18068,1888,0,0,66,66,0,1,0,1,0
612,271,0,0,60,60,0,1,0,1,0
1865,1017,0,0,66,66,0,1,0,1,0
1391,1827,0,0,146,146,0,1,0,1,0
18263,1888,0,0,66,66,0,1,0,1,0
1745,1888,0,0,146,146,0,1,0,1,0
7335,1070,0,0,60,60,0,1,0,1,0
7509,218,0,0,60,60,0,1,0,1,0
21599,2636,0,0,66,66,0,1,0,1,0
16023,2256,0,0,62,62,0,1,0,1,0
9058,104,0,0,60,60,0,1,0,1,0
2264,1147,0,0,66,66,0,1,0,1,0
10487,562,0,0,100,100,0,1,0,1,0
21084,1771,0,0,62,62,0,1,0,1,0
11174,2521,0,0,62,62,0,1,0,1,0
612,714,0,0,60,60,0,1,0,1,0
16731,1086,0,0,66,66,0,1,0,1,0
10960,2938,0,0,66,66,0,1,0,1,0
8010,323,0,0,60,60,0,1,0,1,0
13361,1804,0,0,66,66,0,1,0,1,0
290,3216,0,0,62,62,0,1,0,1,0
344,2587,0,0,66,66,0,1,0,1,0
21587,2938,0,0,78,78,0,1,0,1,0
21653,1147,0,0,66,66,0,1,0,1,0
10582,2256,0,0,66,66,0,1,0,1,0
8,1873,0,0,60,60,0,1,0,1,0
17606,1888,0,0,66,66,0,1,0,1,0
8002,715,0,0,66,66,0,1,0,1,0
16951,255,0,0,62,62,0,1,0,1,0
15294,1880,0,0,66,66,0,1,0,1,0
12190,2587,0,0,66,66,0,1,0,1,0
688,1483,0,0,143,143,0,1,0,1,0
2512,1888,0,0,62,62,0,1,0,1,0
3693,1888,0,0,62,62,0,1,0,1,0
20335,1888,0,0,66,66,0,1,0,1,0
17262,1472,0,0,66,66,0,1,0,1,0
9566,2587,0,0,66,66,0,1,0,1,0
3577,2495,0,0,145,145,0,1,0,1,0
22482,2256,0,0,146,146,0,1,0,1,0
2285,2486,0,0,72,72,0,1,0,1,0
861,1888,0,0,62,62,0,1,0,1,0
9738,1147,0,0,66,66,0,1,0,1,0
1413,1888,0,0,62,62,0,1,0,1,0
3619,1888,0,0,62,62,0,1,0,1,0
6169,3051,0,0,62,62,0,1,0,1,0
546,7,0,0,60,60,0,1,0,1,0
11729,2883,0,0,66,66,0,1,0,1,0
7956,2587,0,0,74,74,0,1,0,1,0
12107,2883,0,0,62,62,0,1,0,1,0
683,1017,0,0,66,66,0,1,0,1,0
4724,1804,0,0,66,66,0,1,0,1,0
18970,1017,0,0,62,62,0,1,0,1,0
128,391,0,0,62,62,0,1,0,1,0
4790,1888,0,0,62,62,0,1,0,1,0
3165,7,0,0,60,60,0,1,0,1,0
12,1768,0,0,161,161,0,1,0,1,0
3034,7,0,0,60,60,0,1,0,1,0
1677,1215,0,0,62,62,0,1,0,1,0
8117,2587,0,0,146,146,0,1,0,1,0
22525,2883,0,0,66,66,0,1,0,1,0
2853,2611,0,0,66,66,0,1,0,1,0
1254,2587,0,0,146,146,0,1,0,1,0
5540,1054,0,0,146,146,0,1,0,1,0
3115,1804,0,0,62,62,0,1,0,1,0
8920,1771,0,0,62,62,0,1,0,1,0
17827,2256,0,0,66,66,0,1,0,1,0
523,983,0,0,66,66,0,1,0,1,0
16951,255,0,0,62,62,0,1,0,1,0
1470,3139,0,0,66,66,0,1,0,1,0
16951,255,0,0,62,62,0,1,0,1,0
18836,1147,0,0,62,62,0,1,0,1,0
8830,1888,0,0,66,66,0,1,0,1,0
5033,1017,0,0,62,62,0,1,0,1,0
18039,1771,0,0,66,66,0,1,0,1,0
360,3105,0,0,164,164,0,1,0,1,0
14160,2256,0,0,66,66,0,1,0,1,0
11627,1017,0,0,62,62,0,1,0,1,0
1239,2144,0,0,62,62,0,1,0,1,0
18957,3216,0,0,66,66,0,1,0,1,0
14447,2148,0,0,62,62,0,1,0,1,0
15166,1147,0,0,66,66,0,1,0,1,0
1718,3051,0,0,62,62,0,1,0,1,0
12291,2256,0,0,66,66,0,1,0,1,0
3416,2587,0,0,66,66,0,1,0,1,0
10736,1017,0,0,62,62,0,1,0,1,0
3072,1888,0,0,66,66,0,1,0,1,0
1388,3216,0,0,62,62,0,1,0,1,0
11180,1940,0,0,66,66,0,1,0,1,0
804,2587,0,0,66,66,0,1,0,1,0
10059,2256,0,0,62,62,0,1,0,1,0
3060,1888,0,0,72,72,0,1,0,1,0
0,0,0,0,98,98,0,1,0,1,0
4344,3216,0,0,62,62,0,1,0,1,0
16951,255,0,0,62,62,0,1,0,1,0
7273,2440,0,0,62,62,0,1,0,1,0
20911,3139,0,0,66,66,0,1,0,1,0
1799,2883,0,0,62,62,0,1,0,1,0
5705,1100,0,0,74,74,0,1,0,1,0
1121,2636,0,0,66,66,0,1,0,1,0
7460,1771,0,0,66,66,0,1,0,1,0
3239,2486,0,0,148,148,0,1,0,1,0
21291,2938,0,0,74,74,0,1,0,1,0
9293,104,0,0,60,60,0,1,0,1,0
612,183,0,0,60,60,0,1,0,1,0
16951,255,0,0,62,62,0,1,0,1,0
17660,2073,0,0,66,66,0,1,0,1,0
2833,1888,0,0,62,62,0,1,0,1,0
1769,1763,0,0,66,66,0,1,0,1,0
540,1888,0,0,66,66,0,1,0,1,0
3922,7,0,0,60,60,0,1,0,1,0
21436,1771,0,0,62,62,0,1,0,1,0
3054,697,0,0,62,62,0,1,0,1,0
17757,2636,0,0,66,66,0,1,0,1,0
52,3026,0,0,146,146,0,1,0,1,0
9222,1787,0,0,148,148,0,1,0,1,0
20476,1017,0,0,66,66,0,1,0,1,0
1607,1215,0,0,62,62,0,1,0,1,0
8651,2919,0,0,66,66,0,1,0,1,0
16633,1880,0,0,66,66,0,1,0,1,0
2135,1147,0,0,66,66,0,1,0,1,0
863,1224,0,0,60,60,0,1,0,1,0
21766,1888,0,0,66,66,0,1,0,1,0
165,2205,0,0,66,66,0,1,0,1,0
19419,2953,0,0,66,66,0,1,0,1,0
1452,1398,0,0,145,145,0,1,0,1,0
7339,2845,0,0,60,60,0,1,0,1,0
18614,1054,0,0,66,66,0,1,0,1,0
3116,2636,0,0,62,62,0,1,0,1,0
19766,1771,0,0,66,66,0,1,0,1,0
126,7,0,0,60,60,0,1,0,1,0
16951,255,0,0,62,62,0,1,0,1,0
2400,2587,0,0,66,66,0,1,0,1,0
17051,427,0,0,62,62,0,1,0,1,0
12877,1397,0,0,66,66,0,1,0,1,0
15694,1787,0,0,145,145,0,1,0,1,0
7771,1147,0,0,146,146,0,1,0,1,0
19137,2883,0,0,62,62,0,1,0,1,0
2747,3111,0,0,753,753,0,1,0,1,0
17262,1472,0,0,62,62,0,1,0,1,0
1022,146,0,0,60,60,0,1,0,1,0
14776,2938,0,0,62,62,0,1,0,1,0
3050,1804,0,0,66,66,0,1,0,1,0
11880,1086,0,0,66,66,0,1,0,1,0
3876,1923,0,0,62,62,0,1,0,1,0
7335,1070,0,0,60,60,0,1,0,1,0
3109,2611,0,0,72,72,0,1,0,1,0
20863,3139,0,0,66,66,0,1,0,1,0
14776,2938,0,0,62,62,0,1,0,1,0
2084,1471,0,0,145,145,0,1,0,1,0
522,7,0,0,60,60,0,1,0,1,0
19567,155,0,0,66,66,0,1,0,1,0
472,1888,0,0,66,66,0,1,0,1,0
636,362,0,0,143,143,0,1,0,1,0
1940,1590,0,0,66,66,0,1,0,1,0
7335,1072,0,0,60,60,0,1,0,1,0
1677,1215,0,0,62,62,0,1,0,1,0
486,1771,0,0,62,62,0,1,0,1,0
15519,1,0,0,66,66,0,1,0,1,0
844,2938,0,0,146,146,0,1,0,1,0
1374,1888,0,0,62,62,0,1,0,1,0
12,929,0,0,83,83,0,1,0,1,0
4631,1888,0,0,66,66,0,1,0,1,0
18925,2550,0,0,66,66,0,1,0,1,0
577,2611,0,0,78,78,0,1,0,1,0
1604,1,0,0,66,66,0,1,0,1,0
22293,1017,0,0,62,62,0,1,0,1,0
20911,3139,0,0,62,62,0,1,0,1,0
12673,1215,0,0,66,66,0,1,0,1,0
16838,2938,0,0,66,66,0,1,0,1,0
21999,1147,0,0,66,66,0,1,0,1,0
4319,1147,0,0,146,146,0,1,0,1,0
1811,1147,0,0,62,62,0,1,0,1,0
1227,509,0,0,66,66,0,1,0,1,0
19482,1888,0,0,66,66,0,1,0,1,0
16951,255,0,0,62,62,0,1,0,1,0
3072,1888,0,0,66,66,0,1,0,1,0
2781,280,0,0,66,66,0,1,0,1,0
2808,7,0,0,60,60,0,1,0,1,0
16951,255,0,0,62,62,0,1,0,1,0
9586,1147,0,0,66,66,0,1,0,1,0
20833,2824,0,0,62,62,0,1,0,1,0
515,1888,0,0,62,62,0,1,0,1,0
8318,2636,0,0,146,146,0,1,0,1,0
498,2587,0,0,62,62,0,1,0,1,0
18240,1017,0,0,62,62,0,1,0,1,0
9426,2938,0,0,78,78,0,1,0,1,0
2253,1017,0,0,146,146,0,1,0,1,0
7273,1167,0,0,62,62,0,1,0,1,0
16951,255,0,0,62,62,0,1,0,1,0
14505,2312,0,0,78,78,0,1,0,1,0
17745,1888,0,0,66,66,0,1,0,1,0
2595,2883,0,0,62,62,0,1,0,1,0
17733,1804,0,0,66,66,0,1,0,1,0
6355,2256,0,0,146,146,0,1,0,1,0
2366,1147,0,0,62,62,0,1,0,1,0
1230,983,0,0,62,62,0,1,0,1,0
21552,1215,0,0,66,66,0,1,0,1,0
16951,255,0,0,62,62,0,1,0,1,0
844,2938,0,0,146,146,0,1,0,1,0
426,1147,0,0,62,62,0,1,0,1,0
1315,1472,0,0,146,146,0,1,0,1,0
52,2166,0,0,146,146,0,1,0,1,0
1547,2636,0,0,62,62,0,1,0,1,0
6324,1147,0,0,62,62,0,1,0,1,0
10895,3117,0,0,62,62,0,1,0,1,0
9590,1215,0,0,66,66,0,1,0,1,0
2554,1083,0,0,159,159,0,1,0,1,0
303,3216,0,0,62,62,0,1,0,1,0
16951,255,0,0,62,62,0,1,0,1,0
7429,255,0,0,60,60,0,1,0,1,0
1513,1771,0,0,62,62,0,1,0,1,0
1611,2611,0,0,66,66,0,1,0,1,0
13364,1215,0,0,66,66,0,1,0,1,0
16077,2256,0,0,62,62,0,1,0,1,0
11247,1017,0,0,62,62,0,1,0,1,0
3001,357,0,0,62,62,0,1,0,1,0
16951,255,0,0,62,62,0,1,0,1,0
1576,2938,0,0,60,60,0,1,0,1,0
6394,1017,0,0,62,62,0,1,0,1,0
8098,2787,0,0,146,146,0,1,0,1,0
20410,1804,0,0,62,62,0,1,0,1,0
7335,1070,0,0,60,60,0,1,0,1,0
18249,1771,0,0,66,66,0,1,0,1,0
2090,1017,0,0,66,66,0,1,0,1,0
2312,1017,0,0,66,66,0,1,0,1,0
16825,1804,0,0,66,66,0,1,0,1,0
10216,3051,0,0,62,62,0,1,0,1,0
6692,1888,0,0,66,66,0,1,0,1,0
636,3252,0,0,146,146,0,1,0,1,0
14376,1888,0,0,66,66,0,1,0,1,0
21834,1797,0,0,66,66,0,1,0,1,0
1274,1888,0,0,62,62,0,1,0,1,0
10564,2587,0,0,62,62,0,1,0,1,0
18,3216,0,0,62,62,0,1,0,1,0
8810,1472,0,0,62,62,0,1,0,1,0
12,658,0,0,60,60,0,1,0,1,0
11605,697,0,0,146,146,0,1,0,1,0
636,280,0,0,146,146,0,1,0,1,0
15796,23,0,0,85,85,0,1,0,1,0
1774,1017,0,0,146,146,0,1,0,1,0
3318,1888,0,0,66,66,0,1,0,1,0
2253,1017,0,0,62,62,0,1,0,1,0
5527,1017,0,0,62,62,0,1,0,1,0
727,137,0,0,66,66,0,1,0,1,0
21632,2256,0,0,66,66,0,1,0,1,0
16333,3216,0,0,66,66,0,1,0,1,0
159,2636,0,0,66,66,0,1,0,1,0
11033,2235,0,0,66,66,0,1,0,1,0
454,263,0,0,70,70,0,1,0,1,0
20174,1797,0,0,62,62,0,1,0,1,0
6395,1215,0,0,62,62,0,1,0,1,0
22448,1017,0,0,62,62,0,1,0,1,0
1433,1017,0,0,66,66,0,1,0,1,0
8534,2636,0,0,66,66,0,1,0,1,0
21118,631,0,0,145,145,0,1,0,1,0
20570,2256,0,0,62,62,0,1,0,1,0
29,1888,0,0,62,62,0,1,0,1,0
2671,1147,0,0,146,146,0,1,0,1,0
2619,1017,0,0,62,62,0,1,0,1,0
16703,847,0,0,66,66,0,1,0,1,0
15854,2611,0,0,66,66,0,1,0,1,0
5040,2636,0,0,62,62,0,1,0,1,0
12,2499,0,0,74,74,0,1,0,1,0
2526,357,0,0,62,62,0,1,0,1,0
13580,3051,0,0,66,66,0,1,0,1,0
1614,1797,0,0,66,66,0,1,0,1,0
2327,139,0,0,60,60,0,1,0,1,0
7270,1472,0,0,62,62,0,1,0,1,0
17596,1017,0,0,66,66,0,1,0,1,0
1202,3216,0,0,62,62,0,1,0,1,0
2447,2486,0,0,148,148,0,1,0,1,0
6395,1215,0,0,62,62,0,1,0,1,0
3525,1147,0,0,62,62,0,1,0,1,0
462,1472,0,0,62,62,0,1,0,1,0
6355,2256,0,0,62,62,0,1,0,1,0
17372,383,0,0,66,66,0,1,0,1,0
12088,1472,0,0,66,66,0,1,0,1,0
472,1888,0,0,66,66,0,1,0,1,0
5436,2587,0,0,146,146,0,1,0,1,0
524,7,0,0,60,60,0,1,0,1,0
1730,1017,0,0,146,146,0,1,0,1,0
6663,2602,0,0,145,145,0,1,0,1,0
3541,1017,0,0,146,146,0,1,0,1,0
16951,255,0,0,62,62,0,1,0,1,0
360,3105,0,0,1063,1063,0,1,0,1,0
16951,255,0,0,62,62,0,1,0,1,0
8989,1147,0,0,62,62,0,1,0,1,0
3318,1888,0,0,66,66,0,1,0,1,0
7883,2636,0,0,66,66,0,1,0,1,0
9019,1802,0,0,62,62,0,1,0,1,0
12,1818,0,0,60,60,0,1,0,1,0
16951,255,0,0,62,62,0,1,0,1,0
2612,1017,0,0,146,146,0,1,0,1,0
17936,2883,0,0,66,66,0,1,0,1,0
360,3105,0,0,342,342,0,1,0,1,0
1525,1444,0,0,145,145,0,1,0,1,0
21178,2256,0,0,62,62,0,1,0,1,0
18993,2581,0,0,146,146,0,1,0,1,0
11949,2256,0,0,66,66,0,1,0,1,0
2271,6,0,0,60,60,0,1,0,1,0
18225,1472,0,0,66,66,0,1,0,1,0
1461,983,0,0,66,66,0,1,0,1,0
13580,3051,0,0,66,66,0,1,0,1,0
282,1054,0,0,62,62,0,1,0,1,0
1974,1147,0,0,62,62,0,1,0,1,0
13801,155,0,0,66,66,0,1,0,1,0
16951,255,0,0,62,62,0,1,0,1,0
269,509,0,0,66,66,0,1,0,1,0
388,797,0,0,62,62,0,1,0,1,0
20123,2587,0,0,146,146,0,1,0,1,0
2726,1215,0,0,62,62,0,1,0,1,0
16951,255,0,0,62,62,0,1,0,1,0
7589,2573,0,0,74,74,0,1,0,1,0
1401,2938,0,0,62,62,0,1,0,1,0
3441,2636,0,0,66,66,0,1,0,1,0
16951,255,0,0,62,62,0,1,0,1,0
5108,697,0,0,74,74,0,1,0,1,0
1476,1771,0,0,62,62,0,1,0,1,0
15896,2938,0,0,66,66,0,1,0,1,0
51,366,0,0,66,66,0,1,0,1,0
7326,1649,0,0,60,60,0,1,0,1,0
15,183,0,0,74,74,0,1,0,1,0
1035,1599,0,0,110,110,0,1,0,1,0
2105,110,0,0,104,104,0,1,0,1,0
16985,1827,0,0,74,74,0,1,0,1,0
1133,1771,0,0,66,66,0,1,0,1,0
18415,2587,0,0,66,66,0,1,0,1,0
21025,1888,0,0,66,66,0,1,0,1,0
14338,245,0,0,60,60,0,1,0,1,0
20820,3242,0,0,66,66,0,1,0,1,0
16951,255,0,0,62,62,0,1,0,1,0
2590,1804,0,0,66,66,0,1,0,1,0
16951,255,0,0,62,62,0,1,0,1,0
12,251,0,0,60,60,0,1,0,1,0
2448,280,0,0,62,62,0,1,0,1,0
21001,3216,0,0,66,66,0,1,0,1,0
12,3116,0,0,90,90,0,1,0,1,0
12619,2636,0,0,66,66,0,1,0,1,0
5891,1472,0,0,62,62,0,1,0,1,0
2167,1147,0,0,62,62,0,1,0,1,0
14781,1017,0,0,62,62,0,1,0,1,0
10939,280,0,0,66,66,0,1,0,1,0
17606,1888,0,0,66,66,0,1,0,1,0
7435,2154,0,0,72,72,0,1,0,1,0
11822,155,0,0,66,66,0,1,0,1,0
15373,427,0,0,62,62,0,1,0,1,0
19,1773,0,0,62,62,0,1,0,1,0
21743,427,0,0,62,62,0,1,0,1,0
3427,2587,0,0,146,146,0,1,0,1,0
11450,245,0,0,60,60,0,1,0,1,0
6381,2558,0,0,62,62,0,1,0,1,0
19730,280,0,0,146,146,0,1,0,1,0
15278,2587,0,0,62,62,0,1,0,1,0
2027,3216,0,0,66,66,0,1,0,1,0
17954,3139,0,0,62,62,0,1,0,1,0
702,1017,0,0,66,66,0,1,0,1,0
2143,155,0,0,62,62,0,1,0,1,0
2582,5,0,0,60,60,0,1,0,1,0
18,1147,0,0,62,62,0,1,0,1,0
1804,768,0,0,60,60,0,1,0,1,0
4490,1147,0,0,62,62,0,1,0,1,0
8760,1017,0,0,66,66,0,1,0,1,0
13645,1827,0,0,66,66,0,1,0,1,0
12,985,0,0,66,66,0,1,0,1,0
16951,255,0,0,62,62,0,1,0,1,0
13404,1888,0,0,62,62,0,1,0,1,0
3651,1017,0,0,62,62,0,1,0,1,0
3543,2938,0,0,66,66,0,1,0,1,0
13071,1017,0,0,62,62,0,1,0,1,0
11892,2739,0,0,62,62,0,1,0,1,0
13,460,0,0,66,66,0,1,0,1,0
21596,263,0,0,66,66,0,1,0,1,0
14865,2697,0,0,62,62,0,1,0,1,0
8171,1073,0,0,60,60,0,1,0,1,0
6426,1147,0,0,62,62,0,1,0,1,0
115,2587,0,0,146,146,0,1,0,1,0
7326,1649,0,0,60,60,0,1,0,1,0
7339,141,0,0,60,60,0,1,0,1,0
17827,2256,0,0,66,66,0,1,0,1,0
16951,255,0,0,62,62,0,1,0,1,0
1539,2938,0,0,62,62,0,1,0,1,0
16951,255,0,0,62,62,0,1,0,1,0
18995,1207,0,0,143,143,0,1,0,1,0
5145,697,0,0,146,146,0,1,0,1,0
14363,2587,0,0,62,62,0,1,0,1,0
6269,2477,0,0,60,60,0,1,0,1,0
1965,1888,0,0,62,62,0,1,0,1,0
3000,3216,0,0,62,62,0,1,0,1,0
9361,2604,0,0,66,66,0,1,0,1,0
1268,1224,0,0,60,60,0,1,0,1,0
19159,1888,0,0,66,66,0,1,0,1,0
1997,1771,0,0,66,66,0,1,0,1,0
0,0,0,0,98,98,0,1,0,1,0
22226,1017,0,0,66,66,0,1,0,1,0
5639,2836,0,0,62,62,0,1,0,1,0
19649,509,0,0,66,66,0,1,0,1,0
17858,1763,0,0,62,62,0,1,0,1,0
1837,6,0,0,60,60,0,1,0,1,0
22579,2853,0,0,66,66,0,1,0,1,0
6146,146,0,0,60,60,0,1,0,1,0
13487,1017,0,0,66,66,0,1,0,1,0
7631,1804,0,0,62,62,0,1,0,1,0
1670,3216,0,0,66,66,0,1,0,1,0
2214,1367,0,0,60,60,0,1,0,1,0
21614,1763,0,0,146,146,0,1,0,1,0
18,2256,0,0,62,62,0,1,0,1,0
13243,1147,0,0,66,66,0,1,0,1,0
612,714,0,0,60,60,0,1,0,1,0
13452,2581,0,0,66,66,0,1,0,1,0
19034,1147,0,0,62,62,0,1,0,1,0
2139,2938,0,0,62,62,0,1,0,1,0
4150,7,0,0,60,60,0,1,0,1,0
37,2486,0,0,62,62,0,1,0,1,0
2631,1017,0,0,62,62,0,1,0,1,0
21390,155,0,0,66,66,0,1,0,1,0
577,2611,0,0,78,78,0,1,0,1,0
22135,1147,0,0,66,66,0,1,0,1,0
5278,2256,0,0,62,62,0,1,0,1,0
2297,1147,0,0,66,66,0,1,0,1,0
14459,2905,0,0,62,62,0,1,0,1,0
2973,2636,0,0,146,146,0,1,0,1,0
3076,7,0,0,60,60,0,1,0,1,0
2562,1287,0,0,62,62,0,1,0,1,0
1626,2883,0,0,146,146,0,1,0,1,0
13940,1086,0,0,66,66,0,1,0,1,0
2806,7,0,0,60,60,0,1,0,1,0
8363,1147,0,0,66,66,0,1,0,1,0
22090,1861,0,0,66,66,0,1,0,1,0
16951,255,0,0,62,62,0,1,0,1,0
12979,2587,0,0,66,66,0,1,0,1,0
19874,1771,0,0,66,66,0,1,0,1,0
7326,1649,0,0,60,60,0,1,0,1,0
9248,2573,0,0,66,66,0,1,0,1,0
12,1369,0,0,60,60,0,1,0,1,0
22683,10,0,0,88,88,0,1,0,1,0
20745,1880,0,0,66,66,0,1,0,1,0
12,1727,0,0,60,60,0,1,0,1,0
1804,1168,0,0,60,60,0,1,0,1,0
14066,1147,0,0,66,66,0,1,0,1,0
13236,1804,0,0,66,66,0,1,0,1,0
12050,2611,0,0,66,66,0,1,0,1,0
17200,1880,0,0,62,62,0,1,0,1,0
11682,2953,0,0,62,62,0,1,0,1,0
18144,1147,0,0,66,66,0,1,0,1,0
6750,3216,0,0,62,62,0,1,0,1,0
9799,1215,0,0,66,66,0,1,0,1,0
1436,1830,0,0,139,139,0,1,0,1,0
3983,1589,0,0,62,62,0,1,0,1,0
497,737,0,0,66,66,0,1,0,1,0
18609,2587,0,0,146,146,0,1,0,1,0
3876,1923,0,0,62,62,0,1,0,1,0
11964,1147,0,0,66,66,0,1,0,1,0
18541,1147,0,0,66,66,0,1,0,1,0
17821,2587,0,0,62,62,0,1,0,1,0
17596,1017,0,0,62,62,0,1,0,1,0
16951,255,0,0,62,62,0,1,0,1,0
2185,1147,0,0,62,62,0,1,0,1,0
12096,2587,0,0,66,66,0,1,0,1,0
12,3074,0,0,187,187,0,1,0,1,0
9486,1888,0,0,66,66,0,1,0,1,0
1133,2938,0,0,78,78,0,1,0,1,0
4597,1147,0,0,62,62,0,1,0,1,0
15032,1888,0,0,66,66,0,1,0,1,0
8171,1073,0,0,60,60,0,1,0,1,0
6651,1129,0,0,156,156,0,1,0,1,0
11354,3212,0,0,66,66,0,1,0,1,0
20277,2611,0,0,66,66,0,1,0,1,0
16951,255,0,0,62,62,0,1,0,1,0
17449,2611,0,0,66,66,0,1,0,1,0
2828,2587,0,0,62,62,0,1,0,1,0
19314,2938,0,0,66,66,0,1,0,1,0
9245,2938,0,0,66,66,0,1,0,1,0
20659,2953,0,0,66,66,0,1,0,1,0
1582,2587,0,0,66,66,0,1,0,1,0
63,2256,0,0,62,62,0,1,0,1,0
9482,1888,0,0,66,66,0,1,0,1,0
2087,3216,0,0,62,62,0,1,0,1,0
16951,255,0,0,62,62,0,1,0,1,0
14601,1017,0,0,66,66,0,1,0,1,0
1435,280,0,0,62,62,0,1,0,1,0
18,2256,0,0,62,62,0,1,0,1,0
6063,2938,0,0,62,62,0,1,0,1,0
15360,1936,0,0,145,145,0,1,0,1,0
2840,2587,0,0,62,62,0,1,0,1,0
22152,1215,0,0,62,62,0,1,0,1,0
9852,1017,0,0,62,62,0,1,0,1,0
18225,1472,0,0,66,66,0,1,0,1,0
16951,255,0,0,62,62,0,1,0,1,0
1839,983,0,0,62,62,0,1,0,1,0
1203,1880,0,0,66,66,0,1,0,1,0
12,1380,0,0,82,82,0,1,0,1,0
2746,3216,0,0,62,62,0,1,0,1,0
3023,3216,0,0,62,62,0,1,0,1,0
17136,2256,0,0,70,70,0,1,0,1,0
944,2636,0,0,62,62,0,1,0,1,0
636,280,0,0,146,146,0,1,0,1,0
433,1224,0,0,60,60,0,1,0,1,0
10755,2883,0,0,62,62,0,1,0,1,0
3209,2611,0,0,62,62,0,1,0,1,0
17269,2938,0,0,62,62,0,1,0,1,0
13190,1017,0,0,66,66,0,1,0,1,0
16951,255,0,0,62,62,0,1,0,1,0
12799,1462,0,0,66,66,0,1,0,1,0
9226,3216,0,0,62,62,0,1,0,1,0
16951,255,0,0,62,62,0,1,0,1,0
2613,7,0,0,60,60,0,1,0,1,0
20742,2611,0,0,62,62,0,1,0,1,0
2184,2938,0,0,62,62,0,1,0,1,0
13126,2587,0,0,66,66,0,1,0,1,0
2412,2093,0,0,145,145,0,1,0,1,0
4047,1017,0,0,66,66,0,1,0,1,0
7697,1147,0,0,146,146,0,1,0,1,0
3216,2636,0,0,146,146,0,1,0,1,0
14890,2695,0,0,66,66,0,1,0,1,0
2155,2636,0,0,62,62,0,1,0,1,0
20418,432,0,0,146,146,0,1,0,1,0
4010,939,0,0,62,62,0,1,0,1,0
636,991,0,0,146,146,0,1,0,1,0
19234,2636,0,0,66,66,0,1,0,1,0
163,2205,0,0,62,62,0,1,0,1,0
21327,1827,0,0,66,66,0,1,0,1,0
18237,1086,0,0,66,66,0,1,0,1,0
8653,3051,0,0,62,62,0,1,0,1,0
5310,1827,0,0,146,146,0,1,0,1,0
2066,1804,0,0,146,146,0,1,0,1,0
612,374,0,0,60,60,0,1,0,1,0
19428,242,0,0,145,145,0,1,0,1,0
5288,1017,0,0,146,146,0,1,0,1,0
16951,255,0,0,62,62,0,1,0,1,0
1277,1827,0,0,146,146,0,1,0,1,0
17873,2235,0,0,66,66,0,1,0,1,0
9499,2205,0,0,66,66,0,1,0,1,0
15099,1590,0,0,62,62,0,1,0,1,0
17957,697,0,0,66,66,0,1,0,1,0
1258,2382,0,0,62,62,0,1,0,1,0
1804,2103,0,0,60,60,0,1,0,1,0
12,2346,0,0,332,332,0,1,0,1,0
16951,255,0,0,62,62,0,1,0,1,0
21636,1888,0,0,62,62,0,1,0,1,0
5016,8,0,0,60,60,0,1,0,1,0
713,2938,0,0,66,66,0,1,0,1,0
18802,1147,0,0,66,66,0,1,0,1,0
1760,3216,0,0,62,62,0,1,0,1,0
1374,1888,0,0,62,62,0,1,0,1,0
9781,2256,0,0,66,66,0,1,0,1,0
22589,300,0,0,66,66,0,1,0,1,0
16951,255,0,0,62,62,0,1,0,1,0
148,1771,0,0,62,62,0,1,0,1,0
392,1147,0,0,62,62,0,1,0,1,0
12995,3216,0,0,66,66,0,1,0,1,0
12,3140,0,0,199,199,0,1,0,1,0
266,1086,0,0,66,66,0,1,0,1,0
11941,2604,0,0,66,66,0,1,0,1,0
6938,1147,0,0,66,66,0,1,0,1,0
18,1147,0,0,62,62,0,1,0,1,0
8667,509,0,0,66,66,0,1,0,1,0
13278,2256,0,0,62,62,0,1,0,1,0
6309,2938,0,0,60,60,0,1,0,1,0
16951,255,0,0,62,62,0,1,0,1,0
1372,1086,0,0,62,62,0,1,0,1,0
6581,2975,0,0,62,62,0,1,0,1,0
2945,3216,0,0,62,62,0,1,0,1,0
1842,2587,0,0,146,146,0,1,0,1,0
5306,7,0,0,60,60,0,1,0,1,0
1330,697,0,0,62,62,0,1,0,1,0
425,1771,0,0,62,62,0,1,0,1,0
19436,1880,0,0,66,66,0,1,0,1,0
14446,2695,0,0,66,66,0,1,0,1,0
7916,1493,0,0,62,62,0,1,0,1,0
2719,1147,0,0,66,66,0,1,0,1,0
11214,1017,0,0,66,66,0,1,0,1,0
10532,1147,0,0,62,62,0,1,0,1,0
12,447,0,0,60,60,0,1,0,1,0
11048,2953,0,0,66,66,0,1,0,1,0
19,2938,0,0,62,62,0,1,0,1,0
9706,1888,0,0,66,66,0,1,0,1,0
1330,697,0,0,62,62,0,1,0,1,0
1823,2573,0,0,62,62,0,1,0,1,0
20348,1880,0,0,62,62,0,1,0,1,0
16951,255,0,0,62,62,0,1,0,1,0
6506,697,0,0,62,62,0,1,0,1,0
10346,2678,0,0,100,100,0,1,0,1,0
617,1888,0,0,66,66,0,1,0,1,0
3632,2256,0,0,66,66,0,1,0,1,0
16882,280,0,0,146,146,0,1,0,1,0
2135,1147,0,0,66,66,0,1,0,1,0
3163,537,0,0,100,100,0,1,0,1,0
11925,2953,0,0,146,146,0,1,0,1,0
1588,1703,0,0,66,66,0,1,0,1,0
16951,255,0,0,62,62,0,1,0,1,0
536,3216,0,0,62,62,0,1,0,1,0
1311,1017,0,0,62,62,0,1,0,1,0
2505,3000,0,0,146,146,0,1,0,1,0
22575,2938,0,0,66,66,0,1,0,1,0
3098,2573,0,0,66,66,0,1,0,1,0
1692,2587,0,0,62,62,0,1,0,1,0
344,2587,0,0,66,66,0,1,0,1,0
496,2481,0,0,66,66,0,1,0,1,0
12248,1017,0,0,62,62,0,1,0,1,0
12122,2611,0,0,66,66,0,1,0,1,0
16951,255,0,0,62,62,0,1,0,1,0
5157,1472,0,0,146,146,0,1,0,1,0
16951,255,0,0,62,62,0,1,0,1,0
9156,255,0,0,60,60,0,1,0,1,0
3015,1804,0,0,146,146,0,1,0,1,0
7030,1215,0,0,62,62,0,1,0,1,0
17350,2545,0,0,74,74,0,1,0,1,0
14505,2312,0,0,78,78,0,1,0,1,0
11988,1147,0,0,62,62,0,1,0,1,0
12,447,0,0,60,60,0,1,0,1,0
311,3216,0,0,66,66,0,1,0,1,0
18735,2587,0,0,66,66,0,1,0,1,0
18,2938,0,0,62,62,0,1,0,1,0
15588,2144,0,0,62,62,0,1,0,1,0
778,1888,0,0,146,146,0,1,0,1,0
7144,3216,0,0,62,62,0,1,0,1,0
360,3105,0,0,233,233,0,1,0,1,0
20569,2256,0,0,66,66,0,1,0,1,0
15987,697,0,0,66,66,0,1,0,1,0
6637,104,0,0,60,60,0,1,0,1,0
16951,255,0,0,62,62,0,1,0,1,0
2818,2587,0,0,66,66,0,1,0,1,0
22468,201,0,0,78,78,0,1,0,1,0
3191,509,0,0,62,62,0,1,0,1,0
16951,255,0,0,62,62,0,1,0,1,0
16951,255,0,0,62,62,0,1,0,1,0
16951,255,0,0,62,62,0,1,0,1,0
7720,3216,0,0,62,62,0,1,0,1,0
17902,672,0,0,143,143,0,1,0,1,0
1256,1888,0,0,62,62,0,1,0,1,0
5473,3139,0,0,66,66,0,1,0,1,0
17319,1147,0,0,66,66,0,1,0,1,0
16504,2573,0,0,145,145,0,1,0,1,0
18042,847,0,0,66,66,0,1,0,1,0
17994,3216,0,0,72,72,0,1,0,1,0
221,1147,0,0,62,62,0,1,0,1,0
2055,427,0,0,62,62,0,1,0,1,0
6877,3202,0,0,66,66,0,1,0,1,0
20926,2382,0,0,62,62,0,1,0,1,0
19718,2486,0,0,66,66,0,1,0,1,0
14982,2636,0,0,66,66,0,1,0,1,0
17692,1147,0,0,66,66,0,1,0,1,0
1542,1888,0,0,66,66,0,1,0,1,0
328,1017,0,0,66,66,0,1,0,1,0
11337,1017,0,0,146,146,0,1,0,1,0
1804,192,0,0,60,60,0,1,0,1,0
1330,697,0,0,62,62,0,1,0,1,0
17045,1472,0,0,66,66,0,1,0,1,0
12995,1017,0,0,66,66,0,1,0,1,0
16951,255,0,0,62,62,0,1,0,1,0
14140,3216,0,0,62,62,0,1,0,1,0
0,0,0,0,98,98,0,1,0,1,0
636,1792,0,0,62,62,0,1,0,1,0
20,1472,0,0,146,146,0,1,0,1,0
253,280,0,0,62,62,0,1,0,1,0
12957,956,0,0,62,62,0,1,0,1,0
1232,509,0,0,62,62,0,1,0,1,0
13294,1167,0,0,66,66,0,1,0,1,0
2295,1472,0,0,66,66,0,1,0,1,0
482,1888,0,0,66,66,0,1,0,1,0
13896,1147,0,0,146,146,0,1,0,1,0
1720,1827,0,0,62,62,0,1,0,1,0
1158,460,0,0,62,62,0,1,0,1,0
21551,3216,0,0,62,62,0,1,0,1,0
13697,2938,0,0,78,78,0,1,0,1,0
21904,2938,0,0,66,66,0,1,0,1,0
2859,1147,0,0,62,62,0,1,0,1,0
1804,3191,0,0,60,60,0,1,0,1,0
19175,1763,0,0,66,66,0,1,0,1,0
3181,7,0,0,60,60,0,1,0,1,0
7335,1070,0,0,60,60,0,1,0,1,0
10540,804,0,0,100,100,0,1,0,1,0
14742,1888,0,0,66,66,0,1,0,1,0
4491,1147,0,0,66,66,0,1,0,1,0
9939,1880,0,0,62,62,0,1,0,1,0
12611,1888,0,0,66,66,0,1,0,1,0
19872,1086,0,0,66,66,0,1,0,1,0
14033,1215,0,0,62,62,0,1,0,1,0
12831,1147,0,0,66,66,0,1,0,1,0
487,7,0,0,60,60,0,1,0,1,0
24,1787,0,0,139,139,0,1,0,1,0
6061,2587,0,0,146,146,0,1,0,1,0
16951,255,0,0,62,62,0,1,0,1,0
223,1017,0,0,62,62,0,1,0,1,0
1517,1771,0,0,62,62,0,1,0,1,0
19406,1086,0,0,66,66,0,1,0,1,0
11207,1154,0,0,66,66,0,1,0,1,0
12,492,0,0,66,66,0,1,0,1,0
2902,2587,0,0,146,146,0,1,0,1,0
16119,2611,0,0,62,62,0,1,0,1,0
16951,255,0,0,62,62,0,1,0,1,0
2361,1147,0,0,66,66,0,1,0,1,0
5186,1888,0,0,62,62,0,1,0,1,0
399,1888,0,0,66,66,0,1,0,1,0
22091,1215,0,0,62,62,0,1,0,1,0
14621,2883,0,0,66,66,0,1,0,1,0
13666,3216,0,0,66,66,0,1,0,1,0
6050,2938,0,0,62,62,0,1,0,1,0
6651,1129,0,0,156,156,0,1,0,1,0
3443,1888,0,0,62,62,0,1,0,1,0
16951,255,0,0,62,62,0,1,0,1,0
1957,3212,0,0,66,66,0,1,0,1,0
20037,1888,0,0,66,66,0,1,0,1,0
21766,1888,0,0,66,66,0,1,0,1,0
21854,2587,0,0,66,66,0,1,0,1,0
1346,2205,0,0,66,66,0,1,0,1,0
16951,255,0,0,62,62,0,1,0,1,0
13087,2495,0,0,159,159,0,1,0,1,0
16951,255,0,0,62,62,0,1,0,1,0
21301,1017,0,0,62,62,0,1,0,1,0
2290,1472,0,0,66,66,0,1,0,1,0
1881,1147,0,0,146,146,0,1,0,1,0
2084,1471,0,0,145,145,0,1,0,1,0
2515,2938,0,0,62,62,0,1,0,1,0
16951,255,0,0,62,62,0,1,0,1,0
16093,3216,0,0,66,66,0,1,0,1,0
15213,3216,0,0,62,62,0,1,0,1,0
5498,2636,0,0,62,62,0,1,0,1,0
4117,1472,0,0,146,146,0,1,0,1,0
18479,1888,0,0,66,66,0,1,0,1,0
19621,847,0,0,66,66,0,1,0,1,0
2605,1147,0,0,66,66,0,1,0,1,0
22214,2938,0,0,78,78,0,1,0,1,0
18089,3216,0,0,66,66,0,1,0,1,0
68,2938,0,0,62,62,0,1,0,1,0
2685,3216,0,0,62,62,0,1,0,1,0
6649,697,0,0,74,74,0,1,0,1,0
1419,1017,0,0,62,62,0,1,0,1,0
12227,1215,0,0,62,62,0,1,0,1,0
16321,3216,0,0,66,66,0,1,0,1,0
10163,1017,0,0,66,66,0,1,0,1,0
19105,509,0,0,62,62,0,1,0,1,0
81,7,0,0,60,60,0,1,0,1,0
1916,7,0,0,60,60,0,1,0,1,0
6700,2938,0,0,109,109,0,1,0,1,0
12,2247,0,0,83,83,0,1,0,1,0
729,1147,0,0,62,62,0,1,0,1,0
1275,1147,0,0,146,146,0,1,0,1,0
18686,509,0,0,66,66,0,1,0,1,0
20842,3216,0,0,62,62,0,1,0,1,0
1800,1771,0,0,146,146,0,1,0,1,0
16951,255,0,0,62,62,0,1,0,1,0
16014,2636,0,0,62,62,0,1,0,1,0
11501,2256,0,0,62,62,0,1,0,1,0
7906,1147,0,0,146,146,0,1,0,1,0
15140,427,0,0,78,78,0,1,0,1,0
2897,1888,0,0,62,62,0,1,0,1,0
20358,2256,0,0,66,66,0,1,0,1,0
14439,1827,0,0,66,66,0,1,0,1,0
0,0,0,0,60,60,0,1,0,1,0
14694,3216,0,0,66,66,0,1,0,1,0
15840,3216,0,0,66,66,0,1,0,1,0
2239,2256,0,0,62,62,0,1,0,1,0
283,308,0,0,62,62,0,1,0,1,0
261,1147,0,0,66,66,0,1,0,1,0
12,1028,0,0,61,61,0,1,0,1,0
2847,2636,0,0,62,62,0,1,0,1,0
16951,255,0,0,62,62,0,1,0,1,0
4491,7,0,0,60,60,0,1,0,1,0
2721,2953,0,0,74,74,0,1,0,1,0
2081,1903,0,0,145,145,0,1,0,1,0
20853,1017,0,0,62,62,0,1,0,1,0
16951,255,0,0,62,62,0,1,0,1,0
15021,509,0,0,66,66,0,1,0,1,0
5825,983,0,0,66,66,0,1,0,1,0
7335,1070,0,0,60,60,0,1,0,1,0
18778,2611,0,0,66,66,0,1,0,1,0
3058,3262,0,0,60,60,0,1,0,1,0
16951,255,0,0,62,62,0,1,0,1,0
11838,104,0,0,60,60,0,1,0,1,0
19449,3216,0,0,66,66,0,1,0,1,0
2335,2486,0,0,62,62,0,1,0,1,0
1984,2256,0,0,66,66,0,1,0,1,0
190,2938,0,0,78,78,0,1,0,1,0
5527,1017,0,0,62,62,0,1,0,1,0
2185,1147,0,0,62,62,0,1,0,1,0
423,2587,0,0,62,62,0,1,0,1,0
2725,1017,0,0,66,66,0,1,0,1,0
20411,1215,0,0,62,62,0,1,0,1,0
17822,2938,0,0,62,62,0,1,0,1,0
2579,2573,0,0,62,62,0,1,0,1,0
6973,1888,0,0,62,62,0,1,0,1,0
21579,1880,0,0,62,62,0,1,0,1,0
187,1795,0,0,60,60,0,1,0,1,0
16043,1147,0,0,62,62,0,1,0,1,0
2617,2938,0,0,62,62,0,1,0,1,0
2433,2938,0,0,62,62,0,1,0,1,0
14013,2256,0,0,66,66,0,1,0,1,0
16990,509,0,0,66,66,0,1,0,1,0
450,126,0,0,136,136,0,1,0,1,0
18,3216,0,0,62,62,0,1,0,1,0
1415,2883,0,0,66,66,0,1,0,1,0
2157,3072,0,0,60,60,0,1,0,1,0
462,1472,0,0,62,62,0,1,0,1,0
7336,2256,0,0,62,62,0,1,0,1,0
16951,255,0,0,62,62,0,1,0,1,0
2421,280,0,0,146,146,0,1,0,1,0
7326,1649,0,0,60,60,0,1,0,1,0
16119,2611,0,0,62,62,0,1,0,1,0
0,0,0,0,70,70,0,1,0,1,0
7335,1070,0,0,60,60,0,1,0,1,0
2001,2256,0,0,66,66,0,1,0,1,0
4218,1215,0,0,62,62,0,1,0,1,0
1150,1017,0,0,66,66,0,1,0,1,0
11823,1888,0,0,66,66,0,1,0,1,0
11901,255,0,0,60,60,0,1,0,1,0
7694,1,0,0,62,62,0,1,0,1,0
360,3105,0,0,814,814,0,1,0,1,0
2276,1147,0,0,66,66,0,1,0,1,0
735,1147,0,0,66,66,0,1,0,1,0
668,7,0,0,60,60,0,1,0,1,0
16646,3216,0,0,66,66,0,1,0,1,0
20764,2938,0,0,66,66,0,1,0,1,0
12,972,0,0,83,83,0,1,0,1,0
8171,1073,0,0,60,60,0,1,0,1,0
15479,2587,0,0,62,62,0,1,0,1,0
10305,2938,0,0,66,66,0,1,0,1,0
1792,2938,0,0,62,62,0,1,0,1,0
18052,1017,0,0,146,146,0,1,0,1,0
6677,1888,0,0,62,62,0,1,0,1,0
1463,7,0,0,60,60,0,1,0,1,0
10212,1771,0,0,62,62,0,1,0,1,0
16951,255,0,0,62,62,0,1,0,1,0
16951,255,0,0,62,62,0,1,0,1,0
17607,2636,0,0,66,66,0,1,0,1,0
21084,1147,0,0,66,66,0,1,0,1,0
2687,2587,0,0,66,66,0,1,0,1,0
636,2938,0,0,146,146,0,1,0,1,0
17578,418,0,0,62,62,0,1,0,1,0
663,1888,0,0,62,62,0,1,0,1,0
13301,3216,0,0,62,62,0,1,0,1,0
9214,3256,0,0,60,60,0,1,0,1,0
16951,255,0,0,62,62,0,1,0,1,0
636,280,0,0,62,62,0,1,0,1,0
2655,3216,0,0,62,62,0,1,0,1,0
12823,1472,0,0,66,66,0,1,0,1,0
3775,7,0,0,60,60,0,1,0,1,0
19559,1154,0,0,66,66,0,1,0,1,0
2967,7,0,0,60,60,0,1,0,1,0
7336,2256,0,0,62,62,0,1,0,1,0
8114,2550,0,0,62,62,0,1,0,1,0
2756,459,0,0,62,62,0,1,0,1,0
3152,2587,0,0,62,62,0,1,0,1,0
1714,1888,0,0,62,62,0,1,0,1,0
13071,1017,0,0,62,62,0,1,0,1,0
129,1472,0,0,66,66,0,1,0,1,0
7335,1070,0,0,60,60,0,1,0,1,0
266,1086,0,0,66,66,0,1,0,1,0
11734,2938,0,0,146,146,0,1,0,1,0
4516,983,0,0,66,66,0,1,0,1,0
1349,3216,0,0,62,62,0,1,0,1,0
11781,2587,0,0,66,66,0,1,0,1,0
388,1888,0,0,62,62,0,1,0,1,0
3762,2938,0,0,66,66,0,1,0,1,0
4353,1888,0,0,62,62,0,1,0,1,0
2504,1147,0,0,62,62,0,1,0,1,0
497,3013,0,0,66,66,0,1,0,1,0
17252,2938,0,0,74,74,0,1,0,1,0
13389,1804,0,0,66,66,0,1,0,1,0
10996,1147,0,0,62,62,0,1,0,1,0
5551,1804,0,0,62,62,0,1,0,1,0
16951,255,0,0,62,62,0,1,0,1,0
2221,2587,0,0,62,62,0,1,0,1,0
14072,1147,0,0,62,62,0,1,0,1,0
17440,1147,0,0,66,66,0,1,0,1,0
15072,2943,0,0,146,146,0,1,0,1,0
11460,1017,0,0,62,62,0,1,0,1,0
12933,263,0,0,66,66,0,1,0,1,0
1845,2883,0,0,66,66,0,1,0,1,0
16951,255,0,0,62,62,0,1,0,1,0
14839,1804,0,0,66,66,0,1,0,1,0
20322,2611,0,0,66,66,0,1,0,1,0
20076,1880,0,0,66,66,0,1,0,1,0
2217,2883,0,0,66,66,0,1,0,1,0
11540,1472,0,0,66,66,0,1,0,1,0
11820,2611,0,0,78,78,0,1,0,1,0
12493,3216,0,0,66,66,0,1,0,1,0
1320,797,0,0,62,62,0,1,0,1,0
17091,1147,0,0,146,146,0,1,0,1,0
1825,460,0,0,66,66,0,1,0,1,0
2022,2587,0,0,146,146,0,1,0,1,0
7326,1649,0,0,60,60,0,1,0,1,0
2413,2093,0,0,146,146,0,1,0,1,0
7335,1070,0,0,60,60,0,1,0,1,0
7339,170,0,0,60,60,0,1,0,1,0
17336,1327,0,0,62,62,0,1,0,1,0
3656,2636,0,0,146,146,0,1,0,1,0
2618,7,0,0,60,60,0,1,0,1,0
7663,3216,0,0,62,62,0,1,0,1,0
2612,1017,0,0,62,62,0,1,0,1,0
1067,2883,0,0,62,62,0,1,0,1,0
19225,2486,0,0,62,62,0,1,0,1,0
16845,1888,0,0,62,62,0,1,0,1,0
10448,2883,0,0,66,66,0,1,0,1,0
2312,1017,0,0,62,62,0,1,0,1,0
20162,2747,0,0,66,66,0,1,0,1,0
11663,2883,0,0,66,66,0,1,0,1,0
3082,7,0,0,60,60,0,1,0,1,0
14909,2883,0,0,66,66,0,1,0,1,0
1304,2256,0,0,66,66,0,1,0,1,0
2521,2636,0,0,66,66,0,1,0,1,0
2528,2636,0,0,66,66,0,1,0,1,0
427,1215,0,0,62,62,0,1,0,1,0
8276,2023,0,0,161,161,0,1,0,1,0
11582,1147,0,0,66,66,0,1,0,1,0
3141,7,0,0,60,60,0,1,0,1,0
15041,1888,0,0,66,66,0,1,0,1,0
595,1215,0,0,62,62,0,1,0,1,0
11393,146,0,0,60,60,0,1,0,1,0
12,2375,0,0,66,66,0,1,0,1,0
8161,996,0,0,143,143,0,1,0,1,0
9987,2587,0,0,66,66,0,1,0,1,0
629,3225,0,0,60,60,0,1,0,1,0
17660,2073,0,0,62,62,0,1,0,1,0
4784,7,0,0,60,60,0,1,0,1,0
14317,1888,0,0,66,66,0,1,0,1,0
0,0,0,0,98,98,0,1,0,1,0
12611,2938,0,0,66,66,0,1,0,1,0
14489,3216,0,0,66,66,0,1,0,1,0
6687,1017,0,0,66,66,0,1,0,1,0
2517,245,0,0,60,60,0,1,0,1,0
3319,2611,0,0,66,66,0,1,0,1,0
20329,1880,0,0,62,62,0,1,0,1,0
20268,2938,0,0,62,62,0,1,0,1,0
22321,2587,0,0,66,66,0,1,0,1,0
360,3105,0,0,933,933,0,1,0,1,0
2122,3216,0,0,62,62,0,1,0,1,0
4866,453,0,0,146,146,0,1,0,1,0
838,2256,0,0,62,62,0,1,0,1,0
16951,255,0,0,62,62,0,1,0,1,0
7387,7,0,0,60,60,0,1,0,1,0
14194,3216,0,0,62,62,0,1,0,1,0
3030,2256,0,0,62,62,0,1,0,1,0
21592,847,0,0,66,66,0,1,0,1,0
16951,255,0,0,62,62,0,1,0,1,0
17339,509,0,0,66,66,0,1,0,1,0
4967,1026,0,0,60,60,0,1,0,1,0
1868,3216,0,0,62,62,0,1,0,1,0
137,3268,0,0,66,66,0,1,0,1,0
14764,1880,0,0,62,62,0,1,0,1,0
2850,1792,0,0,62,62,0,1,0,1,0
8043,1888,0,0,62,62,0,1,0,1,0
16444,2881,0,0,90,90,0,1,0,1,0
16951,255,0,0,62,62,0,1,0,1,0
16743,3139,0,0,62,62,0,1,0,1,0
773,2611,0,0,62,62,0,1,0,1,0
11678,1106,0,0,66,66,0,1,0,1,0
16951,255,0,0,62,62,0,1,0,1,0
2352,2587,0,0,62,62,0,1,0,1,0
1964,983,0,0,66,66,0,1,0,1,0
1330,697,0,0,62,62,0,1,0,1,0
16951,255,0,0,62,62,0,1,0,1,0
4309,2587,0,0,62,62,0,1,0,1,0
13552,2636,0,0,62,62,0,1,0,1,0
15328,2256,0,0,62,62,0,1,0,1,0
2917,1167,0,0,62,62,0,1,0,1,0
5350,697,0,0,74,74,0,1,0,1,0
9140,1017,0,0,66,66,0,1,0,1,0
271,3216,0,0,62,62,0,1,0,1,0
12310,1880,0,0,62,62,0,1,0,1,0
16951,255,0,0,62,62,0,1,0,1,0
16951,255,0,0,62,62,0,1,0,1,0
16951,255,0,0,62,62,0,1,0,1,0
1804,1777,0,0,60,60,0,1,0,1,0
1681,1888,0,0,62,62,0,1,0,1,0
6677,797,0,0,62,62,0,1,0,1,0
21995,3216,0,0,66,66,0,1,0,1,0
1482,1888,0,0,62,62,0,1,0,1,0
1773,2883,0,0,66,66,0,1,0,1,0
6555,2587,0,0,66,66,0,1,0,1,0
15694,1202,0,0,145,145,0,1,0,1,0
18903,1147,0,0,66,66,0,1,0,1,0
1290,2587,0,0,62,62,0,1,0,1,0
20358,2256,0,0,66,66,0,1,0,1,0
21301,2938,0,0,66,66,0,1,0,1,0
17644,1880,0,0,66,66,0,1,0,1,0
14066,1147,0,0,66,66,0,1,0,1,0
11347,2256,0,0,62,62,0,1,0,1,0
16951,255,0,0,62,62,0,1,0,1,0
1289,1771,0,0,62,62,0,1,0,1,0
16951,255,0,0,62,62,0,1,0,1,0
14294,1771,0,0,60,60,0,1,0,1,0
17758,2883,0,0,66,66,0,1,0,1,0
20332,1147,0,0,62,62,0,1,0,1,0
11429,2573,0,0,66,66,0,1,0,1,0
15278,2587,0,0,66,66,0,1,0,1,0
9283,3216,0,0,62,62,0,1,0,1,0
14459,2905,0,0,62,62,0,1,0,1,0
151,1017,0,0,62,62,0,1,0,1,0
16951,255,0,0,62,62,0,1,0,1,0
17740,1888,0,0,62,62,0,1,0,1,0
6224,12,0,0,60,60,0,1,0,1,0
20162,3216,0,0,62,62,0,1,0,1,0
8010,323,0,0,60,60,0,1,0,1,0
3253,7,0,0,60,60,0,1,0,1,0
1783,2587,0,0,62,62,0,1,0,1,0
9273,6,0,0,60,60,0,1,0,1,0
8171,1073,0,0,60,60,0,1,0,1,0
2579,2573,0,0,62,62,0,1,0,1,0
6042,2883,0,0,66,66,0,1,0,1,0
844,2938,0,0,146,146,0,1,0,1,0
15158,1086,0,0,62,62,0,1,0,1,0
22357,1906,0,0,62,62,0,1,0,1,0
19870,1888,0,0,62,62,0,1,0,1,0
11602,2256,0,0,66,66,0,1,0,1,0
12,2199,0,0,97,97,0,1,0,1,0
2482,3216,0,0,66,66,0,1,0,1,0
2380,2256,0,0,146,146,0,1,0,1,0
7569,3216,0,0,62,62,0,1,0,1,0
22447,1179,0,0,72,72,0,1,0,1,0
1104,7,0,0,60,60,0,1,0,1,0
18461,2379,0,0,74,74,0,1,0,1,0
2312,1017,0,0,66,66,0,1,0,1,0
19,1773,0,0,62,62,0,1,0,1,0
100,2611,0,0,62,62,0,1,0,1,0
41,2938,0,0,62,62,0,1,0,1,0
1986,1215,0,0,62,62,0,1,0,1,0
16951,255,0,0,62,62,0,1,0,1,0
7326,1649,0,0,60,60,0,1,0,1,0
21146,1147,0,0,146,146,0,1,0,1,0
12662,1147,0,0,66,66,0,1,0,1,0
2857,7,0,0,60,60,0,1,0,1,0
16444,2881,0,0,90,90,0,1,0,1,0
13813,2486,0,0,66,66,0,1,0,1,0
9691,1019,0,0,66,66,0,1,0,1,0
12229,1054,0,0,66,66,0,1,0,1,0
21579,1880,0,0,146,146,0,1,0,1,0
1576,2938,0,0,60,60,0,1,0,1,0
1423,1888,0,0,62,62,0,1,0,1,0
9429,2509,0,0,62,62,0,1,0,1,0
11637,983,0,0,62,62,0,1,0,1,0
2897,1888,0,0,145,145,0,1,0,1,0
17555,1147,0,0,62,62,0,1,0,1,0
11052,2697,0,0,74,74,0,1,0,1,0
10386,2938,0,0,66,66,0,1,0,1,0
21132,1827,0,0,66,66,0,1,0,1,0
2014,1888,0,0,62,62,0,1,0,1,0
18,1147,0,0,146,146,0,1,0,1,0
2791,983,0,0,66,66,0,1,0,1,0
29,1888,0,0,62,62,0,1,0,1,0
2239,2256,0,0,62,62,0,1,0,1,0
243,2587,0,0,62,62,0,1,0,1,0
17692,1147,0,0,66,66,0,1,0,1,0
1248,1017,0,0,62,62,0,1,0,1,0
2180,7,0,0,60,60,0,1,0,1,0
1804,768,0,0,60,60,0,1,0,1,0
157,1147,0,0,66,66,0,1,0,1,0
18887,3216,0,0,70,70,0,1,0,1,0
16844,2938,0,0,66,66,0,1,0,1,0
7748,1771,0,0,146,146,0,1,0,1,0
6651,1129,0,0,156,156,0,1,0,1,0
0,0,0,0,70,70,0,1,0,1,0
10165,1147,0,0,66,66,0,1,0,1,0
10414,2587,0,0,62,62,0,1,0,1,0
2379,1147,0,0,62,62,0,1,0,1,0
1771,1147,0,0,62,62,0,1,0,1,0
20335,1888,0,0,66,66,0,1,0,1,0
12877,1397,0,0,66,66,0,1,0,1,0
7273,1888,0,0,62,62,0,1,0,1,0
20389,3139,0,0,66,66,0,1,0,1,0
21816,2587,0,0,62,62,0,1,0,1,0
1804,3211,0,0,60,60,0,1,0,1,0
9246,113,0,0,84,84,0,1,0,1,0
421,2587,0,0,66,66,0,1,0,1,0
3107,1147,0,0,62,62,0,1,0,1,0
19200,1215,0,0,66,66,0,1,0,1,0
21132,1827,0,0,62,62,0,1,0,1,0
16885,983,0,0,62,62,0,1,0,1,0
20786,1147,0,0,66,66,0,1,0,1,0
22174,3216,0,0,66,66,0,1,0,1,0
22468,201,0,0,78,78,0,1,0,1,0
6348,1,0,0,62,62,0,1,0,1,0
18452,775,0,0,66,66,0,1,0,1,0
6496,1215,0,0,62,62,0,1,0,1,0
20053,2587,0,0,66,66,0,1,0,1,0
2915,1017,0,0,62,62,0,1,0,1,0
20751,10,0,0,74,74,0,1,0,1,0
8358,1771,0,0,66,66,0,1,0,1,0
496,870,0,0,66,66,0,1,0,1,0
21541,1888,0,0,74,74,0,1,0,1,0
100,2611,0,0,62,62,0,1,0,1,0
17273,1888,0,0,66,66,0,1,0,1,0
12,443,0,0,297,297,0,1,0,1,0
4445,2883,0,0,62,62,0,1,0,1,0
8682,1792,0,0,62,62,0,1,0,1,0
778,1888,0,0,146,146,0,1,0,1,0
10491,1147,0,0,62,62,0,1,0,1,0
3953,2144,0,0,62,62,0,1,0,1,0
10555,797,0,0,66,66,0,1,0,1,0
31,263,0,0,72,72,0,1,0,1,0
10475,6,0,0,60,60,0,1,0,1,0
9551,3139,0,0,62,62,0,1,0,1,0
15726,2587,0,0,62,62,0,1,0,1,0
12,2346,0,0,199,199,0,1,0,1,0
14248,1472,0,0,66,66,0,1,0,1,0
17855,2636,0,0,62,62,0,1,0,1,0
17395,2256,0,0,66,66,0,1,0,1,0
1550,2256,0,0,62,62,0,1,0,1,0
2926,2587,0,0,146,146,0,1,0,1,0
364,280,0,0,62,62,0,1,0,1,0
1892,1771,0,0,62,62,0,1,0,1,0
6663,1590,0,0,109,109,0,1,0,1,0
1281,2543,0,0,60,60,0,1,0,1,0
1850,3216,0,0,66,66,0,1,0,1,0
2543,1795,0,0,145,145,0,1,0,1,0
1374,1888,0,0,62,62,0,1,0,1,0
1309,1017,0,0,62,62,0,1,0,1,0
5422,1888,0,0,66,66,0,1,0,1,0
14582,1147,0,0,62,62,0,1,0,1,0
3012,2023,0,0,150,150,0,1,0,1,0
2796,1017,0,0,66,66,0,1,0,1,0
21979,1539,0,0,66,66,0,1,0,1,0
16951,255,0,0,62,62,0,1,0,1,0
10267,2883,0,0,62,62,0,1,0,1,0
21010,2382,0,0,66,66,0,1,0,1,0
7335,1072,0,0,60,60,0,1,0,1,0
3988,697,0,0,74,74,0,1,0,1,0
5699,2938,0,0,74,74,0,1,0,1,0
80,2587,0,0,146,146,0,1,0,1,0
1281,2543,0,0,60,60,0,1,0,1,0
2377,2934,0,0,145,145,0,1,0,1,0
2452,2587,0,0,66,66,0,1,0,1,0
498,2587,0,0,62,62,0,1,0,1,0
2027,3216,0,0,66,66,0,1,0,1,0
9854,2587,0,0,146,146,0,1,0,1,0
745,1017,0,0,66,66,0,1,0,1,0
9146,1888,0,0,66,66,0,1,0,1,0
16951,255,0,0,62,62,0,1,0,1,0
190,2938,0,0,78,78,0,1,0,1,0
10630,2636,0,0,66,66,0,1,0,1,0
16656,2953,0,0,66,66,0,1,0,1,0
7846,1215,0,0,62,62,0,1,0,1,0
2546,2587,0,0,62,62,0,1,0,1,0
499,187,0,0,345,345,0,1,0,1,0
7462,1804,0,0,66,66,0,1,0,1,0
12711,1888,0,0,66,66,0,1,0,1,0
2515,1147,0,0,146,146,0,1,0,1,0
7808,2938,0,0,109,109,0,1,0,1,0
1977,1,0,0,66,66,0,1,0,1,0
2609,357,0,0,62,62,0,1,0,1,0
2106,16,0,0,60,60,0,1,0,1,0
1262,1147,0,0,62,62,0,1,0,1,0
13193,983,0,0,66,66,0,1,0,1,0
16444,2881,0,0,90,90,0,1,0,1,0
8475,1017,0,0,66,66,0,1,0,1,0
11373,1086,0,0,66,66,0,1,0,1,0
1795,2836,0,0,66,66,0,1,0,1,0
16844,2938,0,0,66,66,0,1,0,1,0
13270,1147,0,0,62,62,0,1,0,1,0
15925,308,0,0,66,66,0,1,0,1,0
65,2154,0,0,62,62,0,1,0,1,0
10857,2883,0,0,66,66,0,1,0,1,0
16951,255,0,0,62,62,0,1,0,1,0
6001,1147,0,0,66,66,0,1,0,1,0
17954,3139,0,0,66,66,0,1,0,1,0
22681,146,0,0,60,60,0,1,0,1,0
2327,1147,0,0,66,66,0,1,0,1,0
672,1147,0,0,66,66,0,1,0,1,0
16099,2883,0,0,62,62,0,1,0,1,0
20260,2587,0,0,66,66,0,1,0,1,0
8228,2587,0,0,66,66,0,1,0,1,0
530,400,1966,259,497,497,0,1,0,1,0
12,207,0,0,320,320,0,1,0,1,0
12185,1880,0,0,62,62,0,1,0,1,0
677,3216,0,0,62,62,0,1,0,1,0
1530,2587,0,0,66,66,0,1,0,1,0
497,3089,0,0,161,161,0,1,0,1,0
16951,255,0,0,62,62,0,1,0,1,0
711,2938,0,0,66,66,0,1,0,1,0
1382,2587,0,0,66,66,0,1,0,1,0
2254,1472,0,0,66,66,0,1,0,1,0
9397,1771,0,0,66,66,0,1,0,1,0
14722,1888,0,0,66,66,0,1,0,1,0
10630,2636,0,0,66,66,0,1,0,1,0
636,280,0,0,146,146,0,1,0,1,0
3004,2256,0,0,66,66,0,1,0,1,0
20335,1888,0,0,62,62,0,1,0,1,0
11530,2256,0,0,62,62,0,1,0,1,0
3142,2587,0,0,62,62,0,1,0,1,0
3743,3216,0,0,145,145,0,1,0,1,0
19510,2938,0,0,74,74,0,1,0,1,0
12,2453,0,0,97,97,0,1,0,1,0
496,321,0,0,66,66,0,1,0,1,0
12804,2938,0,0,62,62,0,1,0,1,0
18067,1804,0,0,62,62,0,1,0,1,0
15588,1147,0,0,66,66,0,1,0,1,0
8171,1073,0,0,60,60,0,1,0,1,0
9351,2256,0,0,70,70,0,1,0,1,0
1264,2256,0,0,66,66,0,1,0,1,0
16951,255,0,0,62,62,0,1,0,1,0
9944,1,0,0,62,62,0,1,0,1,0
16733,1129,0,0,148,148,0,1,0,1,0
17,210,0,0,66,66,0,1,0,1,0
580,2636,0,0,66,66,0,1,0,1,0
21629,1888,0,0,66,66,0,1,0,1,0
16477,1017,0,0,62,62,0,1,0,1,0
6903,2587,0,0,62,62,0,1,0,1,0
21588,1147,0,0,66,66,0,1,0,1,0
4117,1472,0,0,62,62,0,1,0,1,0
16951,255,0,0,62,62,0,1,0,1,0
1090,7,0,0,60,60,0,1,0,1,0
18,2486,0,0,145,145,0,1,0,1,0
1718,2256,0,0,62,62,0,1,0,1,0
15286,1147,0,0,62,62,0,1,0,1,0
800,2883,0,0,62,62,0,1,0,1,0
14969,1017,0,0,66,66,0,1,0,1,0
1346,2205,0,0,66,66,0,1,0,1,0
1902,2836,0,0,62,62,0,1,0,1,0
19454,1017,0,0,62,62,0,1,0,1,0
10605,2587,0,0,66,66,0,1,0,1,0
16951,255,0,0,62,62,0,1,0,1,0
15446,983,0,0,70,70,0,1,0,1,0
9122,1827,0,0,66,66,0,1,0,1,0
237,7,0,0,60,60,0,1,0,1,0
16951,255,0,0,62,62,0,1,0,1,0
2833,1888,0,0,62,62,0,1,0,1,0
8171,1073,0,0,60,60,0,1,0,1,0
14199,2256,0,0,66,66,0,1,0,1,0
1856,1827,0,0,146,146,0,1,0,1,0
12840,2573,0,0,66,66,0,1,0,1,0
1628,3216,0,0,62,62,0,1,0,1,0
16951,255,0,0,62,62,0,1,0,1,0
636,280,0,0,146,146,0,1,0,1,0
636,280,0,0,62,62,0,1,0,1,0
5694,2441,0,0,146,146,0,1,0,1,0
22683,10,0,0,88,88,0,1,0,1,0
10978,1888,0,0,62,62,0,1,0,1,0
19538,697,0,0,66,66,0,1,0,1,0
1813,1880,0,0,66,66,0,1,0,1,0
16951,255,0,0,62,62,0,1,0,1,0
2394,1017,0,0,62,62,0,1,0,1,0
3234,1147,0,0,146,146,0,1,0,1,0
745,2486,0,0,146,146,0,1,0,1,0
2062,7,0,0,60,60,0,1,0,1,0
20187,2938,0,0,146,146,0,1,0,1,0
16951,255,0,0,62,62,0,1,0,1,0
260,2636,0,0,66,66,0,1,0,1,0
20,3216,0,0,62,62,0,1,0,1,0
18,1147,0,0,62,62,0,1,0,1,0
4388,1147,0,0,62,62,0,1,0,1,0
823,2116,0,0,60,60,0,1,0,1,0
14113,1017,0,0,146,146,0,1,0,1,0
9707,1888,0,0,66,66,0,1,0,1,0
8706,2587,0,0,66,66,0,1,0,1,0
1532,7,0,0,60,60,0,1,0,1,0
17422,1936,0,0,62,62,0,1,0,1,0
18319,2241,0,0,66,66,0,1,0,1,0
12,3074,0,0,187,187,0,1,0,1,0
20911,3139,0,0,66,66,0,1,0,1,0
9705,2852,0,0,62,62,0,1,0,1,0
231,1054,0,0,62,62,0,1,0,1,0
2787,1147,0,0,62,62,0,1,0,1,0
17510,2604,0,0,62,62,0,1,0,1,0
9006,308,0,0,66,66,0,1,0,1,0
246,509,0,0,62,62,0,1,0,1,0
16370,2380,0,0,100,100,0,1,0,1,0
27,3216,0,0,145,145,0,1,0,1,0
1287,1017,0,0,146,146,0,1,0,1,0
1328,2205,0,0,66,66,0,1,0,1,0
12122,2611,0,0,66,66,0,1,0,1,0
19288,2587,0,0,62,62,0,1,0,1,0
13871,509,0,0,66,66,0,1,0,1,0
6243,2938,0,0,62,62,0,1,0,1,0
22463,2817,0,0,66,66,0,1,0,1,0
16177,280,0,0,62,62,0,1,0,1,0
13537,1888,0,0,62,62,0,1,0,1,0
11369,2836,0,0,62,62,0,1,0,1,0
16910,2587,0,0,66,66,0,1,0,1,0
5108,697,0,0,74,74,0,1,0,1,0
17,1706,0,0,66,66,0,1,0,1,0
10166,1147,0,0,66,66,0,1,0,1,0
10845,2611,0,0,74,74,0,1,0,1,0
12,3116,0,0,1484,1484,0,1,0,1,0
11582,1147,0,0,66,66,0,1,0,1,0
11681,1147,0,0,62,62,0,1,0,1,0
5471,797,0,0,66,66,0,1,0,1,0
367,1017,0,0,62,62,0,1,0,1,0
729,1147,0,0,62,62,0,1,0,1,0
19031,2256,0,0,66,66,0,1,0,1,0
2404,2256,0,0,62,62,0,1,0,1,0
12,3050,0,0,60,60,0,1,0,1,0
19649,509,0,0,62,62,0,1,0,1,0
14582,1147,0,0,62,62,0,1,0,1,0
2396,1147,0,0,62,62,0,1,0,1,0
5071,2611,0,0,62,62,0,1,0,1,0
275,9,0,0,60,60,0,1,0,1,0
12164,983,0,0,66,66,0,1,0,1,0
16951,255,0,0,62,62,0,1,0,1,0
2416,2938,0,0,62,62,0,1,0,1,0
4724,1444,0,0,145,145,0,1,0,1,0
16478,353,0,0,60,60,0,1,0,1,0
16951,255,0,0,62,62,0,1,0,1,0
17111,2759,0,0,66,66,0,1,0,1,0
15588,2144,0,0,62,62,0,1,0,1,0
17843,3216,0,0,66,66,0,1,0,1,0
1742,3216,0,0,145,145,0,1,0,1,0
666,1017,0,0,62,62,0,1,0,1,0
6815,3216,0,0,62,62,0,1,0,1,0
2433,2938,0,0,62,62,0,1,0,1,0
21236,1903,0,0,62,62,0,1,0,1,0
4356,1472,0,0,66,66,0,1,0,1,0
20042,697,0,0,146,146,0,1,0,1,0
16257,1147,0,0,62,62,0,1,0,1,0
17004,2587,0,0,66,66,0,1,0,1,0
1670,3216,0,0,66,66,0,1,0,1,0
12895,2573,0,0,62,62,0,1,0,1,0
5153,1017,0,0,66,66,0,1,0,1,0
16951,255,0,0,62,62,0,1,0,1,0
21851,1827,0,0,66,66,0,1,0,1,0
488,2587,0,0,62,62,0,1,0,1,0
6306,1017,0,0,62,62,0,1,0,1,0
5302,1539,0,0,146,146,0,1,0,1,0
19686,2587,0,0,66,66,0,1,0,1,0
15694,344,0,0,145,145,0,1,0,1,0
9632,1017,0,0,62,62,0,1,0,1,0
14978,1215,0,0,66,66,0,1,0,1,0
10776,1147,0,0,66,66,0,1,0,1,0
19321,3252,0,0,66,66,0,1,0,1,0
20268,2938,0,0,62,62,0,1,0,1,0
18489,2938,0,0,62,62,0,1,0,1,0
1913,2573,0,0,62,62,0,1,0,1,0
13871,509,0,0,66,66,0,1,0,1,0
4978,2611,0,0,66,66,0,1,0,1,0
18666,3216,0,0,62,62,0,1,0,1,0
16951,255,0,0,62,62,0,1,0,1,0
10009,1462,0,0,62,62,0,1,0,1,0
18743,1888,0,0,62,62,0,1,0,1,0
9383,1147,0,0,66,66,0,1,0,1,0
2548,2996,0,0,60,60,0,1,0,1,0
14459,2905,0,0,62,62,0,1,0,1,0
11923,1147,0,0,62,62,0,1,0,1,0
9264,1539,0,0,66,66,0,1,0,1,0
8537,509,0,0,66,66,0,1,0,1,0
9707,1888,0,0,66,66,0,1,0,1,0
2964,1888,0,0,62,62,0,1,0,1,0
16951,255,0,0,62,62,0,1,0,1,0
4568,1017,0,0,62,62,0,1,0,1,0
16951,255,0,0,62,62,0,1,0,1,0
17043,1792,0,0,66,66,0,1,0,1,0
12227,1215,0,0,62,62,0,1,0,1,0
8150,3167,0,0,74,74,0,1,0,1,0
1738,2573,0,0,62,62,0,1,0,1,0
639,2486,0,0,143,143,0,1,0,1,0
7115,1147,0,0,146,146,0,1,0,1,0
9214,3256,0,0,60,60,0,1,0,1,0
21293,1147,0,0,62,62,0,1,0,1,0
11461,308,0,0,66,66,0,1,0,1,0
12994,263,0,0,78,78,0,1,0,1,0
1498,1215,0,0,66,66,0,1,0,1,0
1740,2073,0,0,66,66,0,1,0,1,0
15917,847,0,0,66,66,0,1,0,1,0
6850,1147,0,0,62,62,0,1,0,1,0
12804,2938,0,0,62,62,0,1,0,1,0
15896,2587,0,0,66,66,0,1,0,1,0
1898,2695,0,0,62,62,0,1,0,1,0
11165,158,0,0,66,66,0,1,0,1,0
5563,3139,0,0,62,62,0,1,0,1,0
21999,2587,0,0,66,66,0,1,0,1,0
11500,1771,0,0,62,62,0,1,0,1,0
18,3216,0,0,62,62,0,1,0,1,0
21718,3216,0,0,66,66,0,1,0,1,0
8209,1017,0,0,146,146,0,1,0,1,0
21904,2938,0,0,66,66,0,1,0,1,0
15158,1888,0,0,66,66,0,1,0,1,0
13479,1472,0,0,66,66,0,1,0,1,0
9987,2587,0,0,62,62,0,1,0,1,0
5962,2587,0,0,66,66,0,1,0,1,0
1350,1804,0,0,146,146,0,1,0,1,0
0,0,0,0,98,98,0,1,0,1,0
14962,2636,0,0,62,62,0,1,0,1,0
21284,1215,0,0,66,66,0,1,0,1,0
16794,1472,0,0,66,66,0,1,0,1,0
1804,1195,0,0,60,60,0,1,0,1,0
2397,2256,0,0,62,62,0,1,0,1,0
16951,255,0,0,62,62,0,1,0,1,0
8228,2587,0,0,66,66,0,1,0,1,0
228,1771,0,0,62,62,0,1,0,1,0
14592,2256,0,0,62,62,0,1,0,1,0
2450,2938,0,0,62,62,0,1,0,1,0
409,1827,0,0,62,62,0,1,0,1,0
13337,1215,0,0,66,66,0,1,0,1,0
9426,2938,0,0,78,78,0,1,0,1,0
17957,2256,0,0,66,66,0,1,0,1,0
11364,3139,0,0,66,66,0,1,0,1,0
15293,2587,0,0,62,62,0,1,0,1,0
7373,2587,0,0,62,62,0,1,0,1,0
17683,983,0,0,66,66,0,1,0,1,0
2925,2883,0,0,146,146,0,1,0,1,0
20273,2883,0,0,66,66,0,1,0,1,0
758,3216,0,0,62,62,0,1,0,1,0
14088,2883,0,0,66,66,0,1,0,1,0
15694,333,0,0,145,145,0,1,0,1,0
1427,2611,0,0,62,62,0,1,0,1,0
12469,3216,0,0,66,66,0,1,0,1,0
7981,2938,0,0,62,62,0,1,0,1,0
1934,2587,0,0,66,66,0,1,0,1,0
1911,2587,0,0,62,62,0,1,0,1,0
6478,2938,0,0,62,62,0,1,0,1,0
263,805,0,0,66,66,0,1,0,1,0
12809,2573,0,0,66,66,0,1,0,1,0
552,1888,0,0,66,66,0,1,0,1,0
8074,1147,0,0,62,62,0,1,0,1,0
13979,1936,0,0,74,74,0,1,0,1,0
14393,1804,0,0,62,62,0,1,0,1,0
8795,1215,0,0,66,66,0,1,0,1,0
18225,3139,0,0,66,66,0,1,0,1,0
12507,1017,0,0,66,66,0,1,0,1,0
8171,1073,0,0,60,60,0,1,0,1,0
479,3147,0,0,66,66,0,1,0,1,0
19486,1888,0,0,66,66,0,1,0,1,0
6513,1771,0,0,66,66,0,1,0,1,0
636,2856,0,0,139,139,0,1,0,1,0
4578,983,0,0,146,146,0,1,0,1,0
612,183,0,0,60,60,0,1,0,1,0
16162,2587,0,0,62,62,0,1,0,1,0
10119,1093,0,0,66,66,0,1,0,1,0
7335,1070,0,0,60,60,0,1,0,1,0
10772,1482,0,0,66,66,0,1,0,1,0
2662,2938,0,0,62,62,0,1,0,1,0
20150,2934,0,0,159,159,0,1,0,1,0
432,1771,0,0,62,62,0,1,0,1,0
9194,2256,0,0,74,74,0,1,0,1,0
6723,2587,0,0,62,62,0,1,0,1,0
6727,2256,0,0,66,66,0,1,0,1,0
153,3216,0,0,66,66,0,1,0,1,0
7804,308,0,0,62,62,0,1,0,1,0
2501,3216,0,0,66,66,0,1,0,1,0
20989,3212,0,0,66,66,0,1,0,1,0
286,1147,0,0,66,66,0,1,0,1,0
497,2220,0,0,119,119,0,1,0,1,0
18094,510,0,0,66,66,0,1,0,1,0
2529,1017,0,0,66,66,0,1,0,1,0
1804,2265,0,0,60,60,0,1,0,1,0
2655,3216,0,0,62,62,0,1,0,1,0
720,2205,0,0,66,66,0,1,0,1,0
17,2802,0,0,66,66,0,1,0,1,0
7949,314,0,0,60,60,0,1,0,1,0
823,198,0,0,60,60,0,1,0,1,0
588,2611,0,0,78,78,0,1,0,1,0
12746,2235,0,0,62,62,0,1,0,1,0
16951,255,0,0,62,62,0,1,0,1,0
9214,3256,0,0,60,60,0,1,0,1,0
5570,1017,0,0,62,62,0,1,0,1,0
9471,2382,0,0,66,66,0,1,0,1,0
17016,2938,0,0,66,66,0,1,0,1,0
10799,2636,0,0,66,66,0,1,0,1,0
12,447,0,0,60,60,0,1,0,1,0
6948,1147,0,0,146,146,0,1,0,1,0
6880,2587,0,0,146,146,0,1,0,1,0
14023,1888,0,0,66,66,0,1,0,1,0
5893,255,0,0,60,60,0,1,0,1,0
20506,1017,0,0,66,66,0,1,0,1,0
2293,460,0,0,66,66,0,1,0,1,0
360,3105,0,0,1053,1053,0,1,0,1,0
1294,2587,0,0,66,66,0,1,0,1,0
7064,2587,0,0,62,62,0,1,0,1,0
16863,2587,0,0,62,62,0,1,0,1,0
497,337,0,0,66,66,0,1,0,1,0
490,2573,0,0,62,62,0,1,0,1,0
1411,1017,0,0,66,66,0,1,0,1,0
16951,255,0,0,62,62,0,1,0,1,0
13960,1017,0,0,146,146,0,1,0,1,0
648,221,0,0,100,100,0,1,0,1,0
16525,509,0,0,66,66,0,1,0,1,0
2132,1888,0,0,62,62,0,1,0,1,0
1537,6,0,0,60,60,0,1,0,1,0
3535,3139,0,0,62,62,0,1,0,1,0
709,1017,0,0,62,62,0,1,0,1,0
19325,1888,0,0,66,66,0,1,0,1,0
636,409,0,0,143,143,0,1,0,1,0
15391,509,0,0,62,62,0,1,0,1,0
6308,2883,0,0,62,62,0,1,0,1,0
2688,1017,0,0,62,62,0,1,0,1,0
5824,104,0,0,60,60,0,1,0,1,0
12,1856,0,0,118,118,0,1,0,1,0
18995,1888,0,0,145,145,0,1,0,1,0
2407,1215,0,0,62,62,0,1,0,1,0
1330,697,0,0,62,62,0,1,0,1,0
12050,2611,0,0,66,66,0,1,0,1,0
16813,804,0,0,66,66,0,1,0,1,0
7373,2587,0,0,66,66,0,1,0,1,0
9852,1017,0,0,146,146,0,1,0,1,0
1388,3216,0,0,62,62,0,1,0,1,0
1238,1054,0,0,62,62,0,1,0,1,0
14838,2836,0,0,66,66,0,1,0,1,0
12291,2256,0,0,66,66,0,1,0,1,0
12204,2256,0,0,66,66,0,1,0,1,0
18821,2604,0,0,66,66,0,1,0,1,0
12767,697,0,0,62,62,0,1,0,1,0
652,131,0,0,100,100,0,1,0,1,0
6229,2938,0,0,78,78,0,1,0,1,0
19428,242,0,0,145,145,0,1,0,1,0
21776,2938,0,0,66,66,0,1,0,1,0
12203,1763,0,0,66,66,0,1,0,1,0
7335,1072,0,0,60,60,0,1,0,1,0
9243,1224,0,0,62,62,0,1,0,1,0
1672,2144,0,0,62,62,0,1,0,1,0
16951,255,0,0,62,62,0,1,0,1,0
1240,333,0,0,143,143,0,1,0,1,0
14050,1888,0,0,66,66,0,1,0,1,0
8680,1942,0,0,162,162,0,1,0,1,0
16951,255,0,0,62,62,0,1,0,1,0
22430,2587,0,0,62,62,0,1,0,1,0
2649,1215,0,0,62,62,0,1,0,1,0
21312,1147,0,0,62,62,0,1,0,1,0
1850,3216,0,0,66,66,0,1,0,1,0
3132,2587,0,0,62,62,0,1,0,1,0
9222,1787,0,0,148,148,0,1,0,1,0
1433,1017,0,0,66,66,0,1,0,1,0
2432,1880,0,0,62,62,0,1,0,1,0
10486,1861,0,0,66,66,0,1,0,1,0
8344,2787,0,0,60,60,0,1,0,1,0
22485,2256,0,0,66,66,0,1,0,1,0
19573,509,0,0,66,66,0,1,0,1,0
16182,2883,0,0,66,66,0,1,0,1,0
10149,1861,0,0,66,66,0,1,0,1,0
6329,2587,0,0,62,62,0,1,0,1,0
16951,255,0,0,62,62,0,1,0,1,0
16845,1888,0,0,62,62,0,1,0,1,0
14339,1215,0,0,66,66,0,1,0,1,0
16928,3139,0,0,66,66,0,1,0,1,0
16951,255,0,0,62,62,0,1,0,1,0
3193,2852,0,0,62,62,0,1,0,1,0
417,2938,0,0,62,62,0,1,0,1,0
16333,3216,0,0,66,66,0,1,0,1,0
3983,1589,0,0,62,62,0,1,0,1,0
5359,1017,0,0,62,62,0,1,0,1,0
2086,1017,0,0,62,62,0,1,0,1,0
9400,2256,0,0,62,62,0,1,0,1,0
7339,2845,0,0,60,60,0,1,0,1,0
14968,1147,0,0,62,62,0,1,0,1,0
16951,255,0,0,62,62,0,1,0,1,0
673,3216,0,0,62,62,0,1,0,1,0
6698,255,0,0,60,60,0,1,0,1,0
22685,2938,0,0,146,146,0,1,0,1,0
1823,2573,0,0,62,62,0,1,0,1,0
1206,1017,0,0,62,62,0,1,0,1,0
5581,7,0,0,60,60,0,1,0,1,0
1330,918,0,0,62,62,0,1,0,1,0
6449,356,0,0,62,62,0,1,0,1,0
11982,3027,0,0,66,66,0,1,0,1,0
2469,2495,0,0,146,146,0,1,0,1,0
246,509,0,0,146,146,0,1,0,1,0
2641,2256,0,0,146,146,0,1,0,1,0
12,2364,0,0,66,66,0,1,0,1,0
8,2890,0,0,1090,1090,0,1,0,1,0
10474,2938,0,0,72,72,0,1,0,1,0
2087,3216,0,0,145,145,0,1,0,1,0
6394,1017,0,0,62,62,0,1,0,1,0
167,1147,0,0,66,66,0,1,0,1,0
3035,2587,0,0,146,146,0,1,0,1,0
3876,1923,0,0,62,62,0,1,0,1,0
7729,104,0,0,60,60,0,1,0,1,0
13930,1888,0,0,66,66,0,1,0,1,0
20822,2256,0,0,66,66,0,1,0,1,0
2372,509,0,0,66,66,0,1,0,1,0
16951,255,0,0,62,62,0,1,0,1,0
12,2461,0,0,81,81,0,1,0,1,0
3118,1888,0,0,62,62,0,1,0,1,0
1887,2256,0,0,62,62,0,1,0,1,0
3848,1017,0,0,66,66,0,1,0,1,0
16444,2881,0,0,90,90,0,1,0,1,0
8117,2587,0,0,62,62,0,1,0,1,0
11735,2883,0,0,146,146,0,1,0,1,0
16863,2587,0,0,146,146,0,1,0,1,0
11435,1792,0,0,74,74,0,1,0,1,0
1330,697,0,0,62,62,0,1,0,1,0
11878,2938,0,0,74,74,0,1,0,1,0
8002,715,0,0,66,66,0,1,0,1,0
716,7,0,0,60,60,0,1,0,1,0
13501,2440,0,0,66,66,0,1,0,1,0
2928,3216,0,0,62,62,0,1,0,1,0
15840,3216,0,0,66,66,0,1,0,1,0
15368,2883,0,0,66,66,0,1,0,1,0
2146,7,0,0,60,60,0,1,0,1,0
20891,1147,0,0,66,66,0,1,0,1,0
2960,2587,0,0,62,62,0,1,0,1,0
17414,2587,0,0,66,66,0,1,0,1,0
22406,1472,0,0,66,66,0,1,0,1,0
325,2587,0,0,62,62,0,1,0,1,0
7082,1539,0,0,66,66,0,1,0,1,0
19452,983,0,0,66,66,0,1,0,1,0
2337,2093,0,0,148,148,0,1,0,1,0
16951,255,0,0,62,62,0,1,0,1,0
19489,1017,0,0,62,62,0,1,0,1,0
17333,2938,0,0,66,66,0,1,0,1,0
16951,255,0,0,62,62,0,1,0,1,0
16951,255,0,0,62,62,0,1,0,1,0
11878,2938,0,0,74,74,0,1,0,1,0
7273,1167,0,0,62,62,0,1,0,1,0
17589,1147,0,0,66,66,0,1,0,1,0
391,3216,0,0,62,62,0,1,0,1,0
8114,2550,0,0,62,62,0,1,0,1,0
2382,1763,0,0,66,66,0,1,0,1,0
6903,2587,0,0,62,62,0,1,0,1,0
3321,2587,0,0,62,62,0,1,0,1,0
16951,255,0,0,62,62,0,1,0,1,0
1681,1888,0,0,62,62,0,1,0,1,0
10584,2256,0,0,62,62,0,1,0,1,0
16951,255,0,0,62,62,0,1,0,1,0
11003,2256,0,0,66,66,0,1,0,1,0
12823,1472,0,0,66,66,0,1,0,1,0
8773,1147,0,0,62,62,0,1,0,1,0
15905,1147,0,0,146,146,0,1,0,1,0
218,2174,0,0,62,62,0,1,0,1,0
5225,2382,0,0,62,62,0,1,0,1,0
10261,427,0,0,66,66,0,1,0,1,0
2505,3000,0,0,62,62,0,1,0,1,0
636,280,0,0,146,146,0,1,0,1,0
1277,1054,0,0,66,66,0,1,0,1,0
17579,2587,0,0,66,66,0,1,0,1,0
12,1420,0,0,82,82,0,1,0,1,0
15735,2256,0,0,62,62,0,1,0,1,0
21001,3216,0,0,66,66,0,1,0,1,0
375,3216,0,0,62,62,0,1,0,1,0
14087,3216,0,0,66,66,0,1,0,1,0
1494,2852,0,0,66,66,0,1,0,1,0
2809,1472,0,0,66,66,0,1,0,1,0
12030,2611,0,0,74,74,0,1,0,1,0
2413,1771,0,0,62,62,0,1,0,1,0
19349,983,0,0,66,66,0,1,0,1,0
19011,1215,0,0,62,62,0,1,0,1,0
19573,509,0,0,66,66,0,1,0,1,0
697,2587,0,0,66,66,0,1,0,1,0
15179,797,0,0,66,66,0,1,0,1,0
7961,715,0,0,62,62,0,1,0,1,0
3147,2587,0,0,62,62,0,1,0,1,0
15896,2938,0,0,66,66,0,1,0,1,0
2322,697,0,0,62,62,0,1,0,1,0
18,1147,0,0,62,62,0,1,0,1,0
19688,1017,0,0,66,66,0,1,0,1,0
1824,2853,0,0,62,62,0,1,0,1,0
10474,2938,0,0,72,72,0,1,0,1,0
3853,1539,0,0,62,62,0,1,0,1,0
14962,2636,0,0,62,62,0,1,0,1,0
16951,255,0,0,62,62,0,1,0,1,0
15402,3188,0,0,62,62,0,1,0,1,0
12849,2144,0,0,62,62,0,1,0,1,0
9990,1215,0,0,66,66,0,1,0,1,0
2442,2695,0,0,66,66,0,1,0,1,0
10172,2587,0,0,66,66,0,1,0,1,0
777,1017,0,0,66,66,0,1,0,1,0
8682,1792,0,0,145,145,0,1,0,1,0
4319,1147,0,0,62,62,0,1,0,1,0
649,1771,0,0,66,66,0,1,0,1,0
2874,1804,0,0,146,146,0,1,0,1,0
16951,255,0,0,62,62,0,1,0,1,0
11207,1154,0,0,66,66,0,1,0,1,0
6687,1017,0,0,62,62,0,1,0,1,0
5085,983,0,0,62,62,0,1,0,1,0
16727,178,0,0,60,60,0,1,0,1,0
10473,2636,0,0,62,62,0,1,0,1,0
12809,2836,0,0,66,66,0,1,0,1,0
17214,1888,0,0,66,66,0,1,0,1,0
20754,1888,0,0,66,66,0,1,0,1,0
3968,2938,0,0,74,74,0,1,0,1,0
333,1017,0,0,62,62,0,1,0,1,0
15251,1888,0,0,62,62,0,1,0,1,0
5551,1804,0,0,62,62,0,1,0,1,0
15732,1906,0,0,66,66,0,1,0,1,0
698,2256,0,0,62,62,0,1,0,1,0
10475,6,0,0,60,60,0,1,0,1,0
21456,2256,0,0,62,62,0,1,0,1,0
19130,2787,0,0,62,62,0,1,0,1,0
16951,255,0,0,62,62,0,1,0,1,0
0,0,0,0,98,98,0,1,0,1,0
14802,1215,0,0,62,62,0,1,0,1,0
10487,3037,0,0,100,100,0,1,0,1,0
8164,2725,0,0,60,60,0,1,0,1,0
2924,1771,0,0,66,66,0,1,0,1,0
10602,2380,0,0,66,66,0,1,0,1,0
7750,2747,0,0,146,146,0,1,0,1,0
9781,1804,0,0,62,62,0,1,0,1,0
3081,2354,0,0,60,60,0,1,0,1,0
7881,3216,0,0,66,66,0,1,0,1,0
11056,1215,0,0,60,60,0,1,0,1,0
85,2587,0,0,66,66,0,1,0,1,0
5804,255,0,0,60,60,0,1,0,1,0
20002,2256,0,0,66,66,0,1,0,1,0
17455,1147,0,0,62,62,0,1,0,1,0
22575,2938,0,0,66,66,0,1,0,1,0
13317,509,0,0,66,66,0,1,0,1,0
12,3227,0,0,85,85,0,1,0,1,0
7981,2938,0,0,62,62,0,1,0,1,0
17136,2636,0,0,66,66,0,1,0,1,0
11266,1147,0,0,66,66,0,1,0,1,0
9426,2938,0,0,78,78,0,1,0,1,0
1517,1771,0,0,66,66,0,1,0,1,0
9426,2938,0,0,78,78,0,1,0,1,0
2929,1771,0,0,66,66,0,1,0,1,0
15732,1906,0,0,66,66,0,1,0,1,0
5658,2938,0,0,62,62,0,1,0,1,0
15140,427,0,0,78,78,0,1,0,1,0
5094,1888,0,0,62,62,0,1,0,1,0
20277,2611,0,0,62,62,0,1,0,1,0
2051,2587,0,0,66,66,0,1,0,1,0
5962,2587,0,0,66,66,0,1,0,1,0
12925,1827,0,0,62,62,0,1,0,1,0
2201,2256,0,0,66,66,0,1,0,1,0
3415,2587,0,0,62,62,0,1,0,1,0
8581,1017,0,0,66,66,0,1,0,1,0
5071,2611,0,0,66,66,0,1,0,1,0
2428,7,0,0,60,60,0,1,0,1,0
11142,1017,0,0,66,66,0,1,0,1,0
2311,2611,0,0,62,62,0,1,0,1,0
290,3216,0,0,66,66,0,1,0,1,0
18046,1017,0,0,62,62,0,1,0,1,0
2309,427,0,0,62,62,0,1,0,1,0
18997,2587,0,0,146,146,0,1,0,1,0
1813,1880,0,0,66,66,0,1,0,1,0
2449,1037,0,0,60,60,0,1,0,1,0
21636,1888,0,0,66,66,0,1,0,1,0
15152,406,0,0,60,60,0,1,0,1,0
9860,427,0,0,62,62,0,1,0,1,0
17770,1017,0,0,66,66,0,1,0,1,0
21445,2901,0,0,66,66,0,1,0,1,0
6928,183,0,0,60,60,0,1,0,1,0
19996,3117,0,0,66,66,0,1,0,1,0
5256,2256,0,0,66,66,0,1,0,1,0
8422,2256,0,0,62,62,0,1,0,1,0
19353,2587,0,0,62,62,0,1,0,1,0
16630,2636,0,0,66,66,0,1,0,1,0
3078,2938,0,0,145,145,0,1,0,1,0
12995,1017,0,0,66,66,0,1,0,1,0
644,2486,0,0,139,139,0,1,0,1,0
1538,2883,0,0,62,62,0,1,0,1,0
545,2256,0,0,66,66,0,1,0,1,0
11951,3216,0,0,62,62,0,1,0,1,0
301,2256,0,0,66,66,0,1,0,1,0
1324,2587,0,0,62,62,0,1,0,1,0
13093,1215,0,0,66,66,0,1,0,1,0
16161,308,0,0,146,146,0,1,0,1,0
14745,2883,0,0,66,66,0,1,0,1,0
11682,2953,0,0,62,62,0,1,0,1,0
8651,509,0,0,62,62,0,1,0,1,0
14088,2883,0,0,66,66,0,1,0,1,0
1578,3216,0,0,145,145,0,1,0,1,0
639,2820,0,0,143,143,0,1,0,1,0
4367,1147,0,0,66,66,0,1,0,1,0
98,2608,0,0,145,145,0,1,0,1,0
684,2938,0,0,62,62,0,1,0,1,0
4079,1147,0,0,66,66,0,1,0,1,0
2853,2611,0,0,66,66,0,1,0,1,0
5294,1147,0,0,62,62,0,1,0,1,0
1302,2953,0,0,62,62,0,1,0,1,0
7273,1888,0,0,62,62,0,1,0,1,0
2449,1037,0,0,60,60,0,1,0,1,0
223,1017,0,0,62,62,0,1,0,1,0
13630,143,0,0,60,60,0,1,0,1,0
11440,2205,0,0,62,62,0,1,0,1,0
16951,255,0,0,62,62,0,1,0,1,0
636,1792,0,0,62,62,0,1,0,1,0
12,2903,0,0,78,78,0,1,0,1,0
11686,3216,0,0,66,66,0,1,0,1,0
13432,1017,0,0,66,66,0,1,0,1,0
1538,2883,0,0,62,62,0,1,0,1,0
3184,2587,0,0,62,62,0,1,0,1,0
14795,2636,0,0,66,66,0,1,0,1,0
2619,1017,0,0,62,62,0,1,0,1,0
12955,2205,0,0,66,66,0,1,0,1,0
7339,170,0,0,60,60,0,1,0,1,0
1883,1147,0,0,66,66,0,1,0,1,0
16029,308,0,0,62,62,0,1,0,1,0
496,109,0,0,66,66,0,1,0,1,0
11054,1147,0,0,66,66,0,1,0,1,0
3245,1737,0,0,62,62,0,1,0,1,0
1070,2953,0,0,62,62,0,1,0,1,0
8913,1888,0,0,62,62,0,1,0,1,0
8534,2636,0,0,66,66,0,1,0,1,0
558,1017,0,0,66,66,0,1,0,1,0
7273,344,0,0,159,159,0,1,0,1,0
8760,1017,0,0,66,66,0,1,0,1,0
15790,2601,0,0,66,66,0,1,0,1,0
564,2256,0,0,66,66,0,1,0,1,0
19695,805,0,0,62,62,0,1,0,1,0
2586,104,0,0,60,60,0,1,0,1,0
19586,2256,0,0,66,66,0,1,0,1,0
2274,2836,0,0,74,74,0,1,0,1,0
4182,2610,0,0,60,60,0,1,0,1,0
1020,2938,0,0,62,62,0,1,0,1,0
333,1017,0,0,62,62,0,1,0,1,0
16370,2550,0,0,100,100,0,1,0,1,0
5789,3216,0,0,62,62,0,1,0,1,0
18859,1771,0,0,66,66,0,1,0,1,0
9214,3257,0,0,60,60,0,1,0,1,0
1402,2938,0,0,62,62,0,1,0,1,0
15327,2256,0,0,62,62,0,1,0,1,0
22226,1017,0,0,66,66,0,1,0,1,0
1625,280,0,0,146,146,0,1,0,1,0
1525,1444,0,0,145,145,0,1,0,1,0
16951,255,0,0,62,62,0,1,0,1,0
19,2587,0,0,62,62,0,1,0,1,0
5030,6,0,0,60,60,0,1,0,1,0
2432,1880,0,0,62,62,0,1,0,1,0
20433,1507,0,0,185,185,0,1,0,1,0
13093,1936,0,0,62,62,0,1,0,1,0
16008,2938,0,0,62,62,0,1,0,1,0
497,653,0,0,220,220,0,1,0,1,0
21277,983,0,0,62,62,0,1,0,1,0
360,3105,0,0,431,431,0,1,0,1,0
15859,3139,0,0,66,66,0,1,0,1,0
569,1147,0,0,62,62,0,1,0,1,0
16022,3139,0,0,62,62,0,1,0,1,0
2084,1471,0,0,145,145,0,1,0,1,0
6231,1147,0,0,66,66,0,1,0,1,0
360,3105,0,0,491,491,0,1,0,1,0
632,2154,0,0,62,62,0,1,0,1,0
351,797,0,0,62,62,0,1,0,1,0
1182,2256,0,0,66,66,0,1,0,1,0
4463,1054,0,0,62,62,0,1,0,1,0
1707,1804,0,0,62,62,0,1,0,1,0
15072,697,0,0,146,146,0,1,0,1,0
473,2156,0,0,146,146,0,1,0,1,0
20413,509,0,0,62,62,0,1,0,1,0
12321,1017,0,0,66,66,0,1,0,1,0
16621,1906,0,0,66,66,0,1,0,1,0
12,3116,0,0,1484,1484,0,1,0,1,0
9466,1083,0,0,143,143,0,1,0,1,0
552,1888,0,0,66,66,0,1,0,1,0
9006,308,0,0,62,62,0,1,0,1,0
636,1667,0,0,100,100,0,1,0,1,0
19898,3216,0,0,145,145,0,1,0,1,0
11026,2938,0,0,66,66,0,1,0,1,0
21,1147,0,0,62,62,0,1,0,1,0
21834,1797,0,0,66,66,0,1,0,1,0
1930,509,0,0,62,62,0,1,0,1,0
18321,1472,0,0,66,66,0,1,0,1,0
708,2938,0,0,62,62,0,1,0,1,0
3007,1215,0,0,62,62,0,1,0,1,0
1285,267,0,0,60,60,0,1,0,1,0
10223,2587,0,0,62,62,0,1,0,1,0
2994,7,0,0,60,60,0,1,0,1,0
9428,1888,0,0,66,66,0,1,0,1,0
18,2938,0,0,62,62,0,1,0,1,0
239,1888,0,0,62,62,0,1,0,1,0
7997,1147,0,0,62,62,0,1,0,1,0
16951,255,0,0,62,62,0,1,0,1,0
9928,2486,0,0,66,66,0,1,0,1,0
1983,2144,0,0,66,66,0,1,0,1,0
5742,255,0,0,60,60,0,1,0,1,0
15479,2587,0,0,62,62,0,1,0,1,0
2461,1888,0,0,62,62,0,1,0,1,0
20682,2587,0,0,66,66,0,1,0,1,0
13509,2883,0,0,66,66,0,1,0,1,0
21146,1147,0,0,62,62,0,1,0,1,0
4291,1476,0,0,145,145,0,1,0,1,0
1294,2587,0,0,66,66,0,1,0,1,0
2494,1147,0,0,146,146,0,1,0,1,0
15841,1017,0,0,62,62,0,1,0,1,0
7125,2256,0,0,66,66,0,1,0,1,0
11914,2604,0,0,62,62,0,1,0,1,0
11056,1215,0,0,60,60,0,1,0,1,0
6456,1147,0,0,66,66,0,1,0,1,0
1498,1215,0,0,66,66,0,1,0,1,0
19157,1771,0,0,66,66,0,1,0,1,0
16023,2256,0,0,66,66,0,1,0,1,0
13074,185,0,0,60,60,0,1,0,1,0
14962,1147,0,0,62,62,0,1,0,1,0
16951,255,0,0,62,62,0,1,0,1,0
4010,939,0,0,66,66,0,1,0,1,0
689,3216,0,0,66,66,0,1,0,1,0
16469,245,0,0,60,60,0,1,0,1,0
4833,201,0,0,72,72,0,1,0,1,0
443,1771,0,0,66,66,0,1,0,1,0
1716,2636,0,0,66,66,0,1,0,1,0
18808,2747,0,0,66,66,0,1,0,1,0
17273,1888,0,0,66,66,0,1,0,1,0
9438,1017,0,0,66,66,0,1,0,1,0
612,2562,0,0,60,60,0,1,0,1,0
4504,2486,0,0,62,62,0,1,0,1,0
16951,255,0,0,62,62,0,1,0,1,0
14795,2636,0,0,66,66,0,1,0,1,0
16951,255,0,0,62,62,0,1,0,1,0
612,139,0,0,60,60,0,1,0,1,0
149,3139,0,0,66,66,0,1,0,1,0
10141,3216,0,0,62,62,0,1,0,1,0
11719,3216,0,0,66,66,0,1,0,1,0
8264,1147,0,0,66,66,0,1,0,1,0
5749,146,0,0,60,60,0,1,0,1,0
18230,1149,0,0,148,148,0,1,0,1,0
358,509,0,0,66,66,0,1,0,1,0
756,1147,0,0,62,62,0,1,0,1,0
2549,1771,0,0,62,62,0,1,0,1,0
1496,3216,0,0,145,145,0,1,0,1,0
9486,1888,0,0,62,62,0,1,0,1,0
12918,1888,0,0,62,62,0,1,0,1,0
17,209,0,0,66,66,0,1,0,1,0
7756,2256,0,0,66,66,0,1,0,1,0
2008,2256,0,0,66,66,0,1,0,1,0
6506,697,0,0,62,62,0,1,0,1,0
2223,1017,0,0,62,62,0,1,0,1,0
496,2386,0,0,66,66,0,1,0,1,0
1896,2587,0,0,146,146,0,1,0,1,0
12,971,0,0,97,97,0,1,0,1,0
6323,1017,0,0,146,146,0,1,0,1,0
7339,170,0,0,60,60,0,1,0,1,0
1333,1472,0,0,66,66,0,1,0,1,0
20156,1444,0,0,145,145,0,1,0,1,0
43,1830,0,0,136,136,0,1,0,1,0
17821,2587,0,0,66,66,0,1,0,1,0
5422,1888,0,0,66,66,0,1,0,1,0
4826,2573,0,0,66,66,0,1,0,1,0
20314,3139,0,0,62,62,0,1,0,1,0
4262,7,0,0,60,60,0,1,0,1,0
7502,3216,0,0,62,62,0,1,0,1,0
4347,1147,0,0,146,146,0,1,0,1,0
16951,255,0,0,62,62,0,1,0,1,0
6042,2883,0,0,66,66,0,1,0,1,0
22037,1888,0,0,66,66,0,1,0,1,0
16951,255,0,0,62,62,0,1,0,1,0
16951,255,0,0,62,62,0,1,0,1,0
21920,1215,0,0,62,62,0,1,0,1,0
1939,7,0,0,60,60,0,1,0,1,0
1330,804,0,0,62,62,0,1,0,1,0
19,1773,0,0,62,62,0,1,0,1,0
3639,2611,0,0,62,62,0,1,0,1,0
16478,393,0,0,60,60,0,1,0,1,0
20162,3216,0,0,62,62,0,1,0,1,0
20653,427,0,0,66,66,0,1,0,1,0
16444,2881,0,0,90,90,0,1,0,1,0
1330,697,0,0,62,62,0,1,0,1,0
13012,3212,0,0,66,66,0,1,0,1,0
1327,1017,0,0,146,146,0,1,0,1,0
7988,2256,0,0,146,146,0,1,0,1,0
17188,1086,0,0,66,66,0,1,0,1,0
11106,2256,0,0,66,66,0,1,0,1,0
588,2611,0,0,78,78,0,1,0,1,0
13552,3051,0,0,62,62,0,1,0,1,0
2799,1017,0,0,62,62,0,1,0,1,0
8952,1147,0,0,66,66,0,1,0,1,0
4344,3216,0,0,62,62,0,1,0,1,0
16951,255,0,0,62,62,0,1,0,1,0
543,1771,0,0,66,66,0,1,0,1,0
10475,6,0,0,60,60,0,1,0,1,0
14958,2636,0,0,66,66,0,1,0,1,0
19096,1327,0,0,66,66,0,1,0,1,0
17568,2256,0,0,66,66,0,1,0,1,0
1164,3216,0,0,62,62,0,1,0,1,0
11121,509,0,0,66,66,0,1,0,1,0
483,1017,0,0,66,66,0,1,0,1,0
12825,2938,0,0,66,66,0,1,0,1,0
19644,1888,0,0,62,62,0,1,0,1,0
10487,2418,0,0,100,100,0,1,0,1,0
9102,2938,0,0,66,66,0,1,0,1,0
132,1472,0,0,62,62,0,1,0,1,0
5189,1017,0,0,62,62,0,1,0,1,0
20286,3216,0,0,66,66,0,1,0,1,0
9426,2938,0,0,78,78,0,1,0,1,0
18542,2938,0,0,62,62,0,1,0,1,0
2765,3216,0,0,66,66,0,1,0,1,0
2928,3216,0,0,66,66,0,1,0,1,0
22033,2611,0,0,66,66,0,1,0,1,0
16794,1472,0,0,66,66,0,1,0,1,0
2281,1086,0,0,66,66,0,1,0,1,0
629,3225,0,0,60,60,0,1,0,1,0
3420,2256,0,0,62,62,0,1,0,1,0
16951,255,0,0,62,62,0,1,0,1,0
1594,1017,0,0,62,62,0,1,0,1,0
2717,2256,0,0,62,62,0,1,0,1,0
13443,2587,0,0,66,66,0,1,0,1,0
7339,170,0,0,60,60,0,1,0,1,0
9486,1888,0,0,66,66,0,1,0,1,0
19827,383,0,0,66,66,0,1,0,1,0
10211,2938,0,0,66,66,0,1,0,1,0
16951,255,0,0,62,62,0,1,0,1,0
12245,3216,0,0,62,62,0,1,0,1,0
365,1147,0,0,66,66,0,1,0,1,0
3818,7,0,0,60,60,0,1,0,1,0
21,3216,0,0,62,62,0,1,0,1,0
2902,2587,0,0,62,62,0,1,0,1,0
17310,1017,0,0,62,62,0,1,0,1,0
17135,797,0,0,66,66,0,1,0,1,0
3984,1819,0,0,74,74,0,1,0,1,0
1793,2256,0,0,146,146,0,1,0,1,0
4826,2573,0,0,66,66,0,1,0,1,0
14393,1804,0,0,62,62,0,1,0,1,0
19845,2938,0,0,66,66,0,1,0,1,0
3570,3270,0,0,162,162,0,1,0,1,0
11636,1215,0,0,66,66,0,1,0,1,0
962,1771,0,0,66,66,0,1,0,1,0
863,1224,0,0,60,60,0,1,0,1,0
307,2938,0,0,66,66,0,1,0,1,0
2084,1471,0,0,145,145,0,1,0,1,0
11450,245,0,0,60,60,0,1,0,1,0
3457,3216,0,0,62,62,0,1,0,1,0
19016,983,0,0,66,66,0,1,0,1,0
6506,697,0,0,62,62,0,1,0,1,0
16951,255,0,0,62,62,0,1,0,1,0
4961,2256,0,0,66,66,0,1,0,1,0
10212,1771,0,0,66,66,0,1,0,1,0
2284,1472,0,0,62,62,0,1,0,1,0
20898,2256,0,0,66,66,0,1,0,1,0
10474,1179,0,0,72,72,0,1,0,1,0
9582,2587,0,0,146,146,0,1,0,1,0
13732,1147,0,0,62,62,0,1,0,1,0
3005,1771,0,0,66,66,0,1,0,1,0
1804,927,0,0,60,60,0,1,0,1,0
5318,2938,0,0,62,62,0,1,0,1,0
1161,3216,0,0,62,62,0,1,0,1,0
9768,2587,0,0,66,66,0,1,0,1,0
21455,155,0,0,66,66,0,1,0,1,0
8222,2611,0,0,62,62,0,1,0,1,0
21562,3216,0,0,62,62,0,1,0,1,0
16033,1482,0,0,66,66,0,1,0,1,0
1551,2953,0,0,66,66,0,1,0,1,0
1981,1086,0,0,62,62,0,1,0,1,0
20037,1888,0,0,66,66,0,1,0,1,0
1795,2836,0,0,66,66,0,1,0,1,0
3254,2382,0,0,66,66,0,1,0,1,0
5942,1472,0,0,62,62,0,1,0,1,0
6651,1129,0,0,156,156,0,1,0,1,0
13871,509,0,0,62,62,0,1,0,1,0
1734,2538,0,0,146,146,0,1,0,1,0
9093,1215,0,0,66,66,0,1,0,1,0
240,2820,0,0,159,159,0,1,0,1,0
1154,1590,0,0,62,62,0,1,0,1,0
5153,1017,0,0,66,66,0,1,0,1,0
11428,2573,0,0,62,62,0,1,0,1,0
21918,1154,0,0,66,66,0,1,0,1,0
8098,1224,0,0,146,146,0,1,0,1,0
3109,2611,0,0,72,72,0,1,0,1,0
20777,1147,0,0,66,66,0,1,0,1,0
1767,2486,0,0,143,143,0,1,0,1,0
62,1888,0,0,62,62,0,1,0,1,0
612,21,0,0,60,60,0,1,0,1,0
10346,748,0,0,100,100,0,1,0,1,0
261,1147,0,0,66,66,0,1,0,1,0
16951,255,0,0,62,62,0,1,0,1,0
21084,1147,0,0,66,66,0,1,0,1,0
19315,3212,0,0,66,66,0,1,0,1,0
3903,1888,0,0,62,62,0,1,0,1,0
20923,1888,0,0,62,62,0,1,0,1,0
11026,2938,0,0,66,66,0,1,0,1,0
7626,2604,0,0,62,62,0,1,0,1,0
4175,2433,0,0,60,60,0,1,0,1,0
5310,1827,0,0,62,62,0,1,0,1,0
1796,2587,0,0,62,62,0,1,0,1,0
186,2486,0,0,62,62,0,1,0,1,0
17043,1792,0,0,66,66,0,1,0,1,0
1757,1880,0,0,62,62,0,1,0,1,0
2249,1539,0,0,146,146,0,1,0,1,0
1419,1017,0,0,62,62,0,1,0,1,0
17380,1147,0,0,66,66,0,1,0,1,0
1423,1888,0,0,62,62,0,1,0,1,0
20002,2256,0,0,66,66,0,1,0,1,0
18861,3117,0,0,146,146,0,1,0,1,0
9214,3256,0,0,60,60,0,1,0,1,0
2084,1471,0,0,145,145,0,1,0,1,0
19175,1763,0,0,62,62,0,1,0,1,0
21615,1017,0,0,62,62,0,1,0,1,0
2444,7,0,0,60,60,0,1,0,1,0
16951,255,0,0,62,62,0,1,0,1,0
11632,308,0,0,66,66,0,1,0,1,0
18420,255,0,0,60,60,0,1,0,1,0
2803,1888,0,0,66,66,0,1,0,1,0
11559,797,0,0,62,62,0,1,0,1,0
3101,1888,0,0,62,62,0,1,0,1,0
1427,2611,0,0,62,62,0,1,0,1,0
8695,983,0,0,62,62,0,1,0,1,0
7636,2587,0,0,62,62,0,1,0,1,0
7589,2573,0,0,74,74,0,1,0,1,0
11712,2938,0,0,62,62,0,1,0,1,0
5540,1054,0,0,62,62,0,1,0,1,0
14446,2695,0,0,66,66,0,1,0,1,0
1805,1017,0,0,62,62,0,1,0,1,0
17336,1327,0,0,62,62,0,1,0,1,0
16008,2938,0,0,62,62,0,1,0,1,0
16951,255,0,0,62,62,0,1,0,1,0
12,1977,0,0,74,74,0,1,0,1,0
7956,2587,0,0,74,74,0,1,0,1,0
11736,2256,0,0,66,66,0,1,0,1,0
9900,3216,0,0,66,66,0,1,0,1,0
2170,1147,0,0,62,62,0,1,0,1,0
298,1888,0,0,62,62,0,1,0,1,0
11923,1147,0,0,66,66,0,1,0,1,0
11653,3216,0,0,66,66,0,1,0,1,0
18903,1147,0,0,62,62,0,1,0,1,0
1792,2938,0,0,62,62,0,1,0,1,0
47,2611,0,0,62,62,0,1,0,1,0
2676,1147,0,0,62,62,0,1,0,1,0
15457,1017,0,0,62,62,0,1,0,1,0
13473,1017,0,0,66,66,0,1,0,1,0
12887,2545,0,0,62,62,0,1,0,1,0
245,1147,0,0,146,146,0,1,0,1,0
7339,141,0,0,60,60,0,1,0,1,0
21079,1215,0,0,66,66,0,1,0,1,0
16951,255,0,0,62,62,0,1,0,1,0
15294,1880,0,0,62,62,0,1,0,1,0
13479,1472,0,0,66,66,0,1,0,1,0
12,3146,0,0,332,332,0,1,0,1,0
17683,983,0,0,62,62,0,1,0,1,0
19174,1017,0,0,66,66,0,1,0,1,0
17214,1888,0,0,66,66,0,1,0,1,0
2548,2077,0,0,60,60,0,1,0,1,0
16621,1906,0,0,66,66,0,1,0,1,0
2647,1210,0,0,66,66,0,1,0,1,0
483,1017,0,0,66,66,0,1,0,1,0
1154,1590,0,0,66,66,0,1,0,1,0
3221,1017,0,0,66,66,0,1,0,1,0
7949,315,0,0,60,60,0,1,0,1,0
11354,3212,0,0,66,66,0,1,0,1,0
7456,1771,0,0,66,66,0,1,0,1,0
19133,983,0,0,66,66,0,1,0,1,0
13282,1771,0,0,66,66,0,1,0,1,0
743,1147,0,0,66,66,0,1,0,1,0
14577,2883,0,0,66,66,0,1,0,1,0
16951,255,0,0,62,62,0,1,0,1,0
9225,1472,0,0,66,66,0,1,0,1,0
1674,2883,0,0,62,62,0,1,0,1,0
12388,2256,0,0,62,62,0,1,0,1,0
244,1054,0,0,66,66,0,1,0,1,0
2084,1471,0,0,145,145,0,1,0,1,0
5067,1147,0,0,62,62,0,1,0,1,0
765,2938,0,0,62,62,0,1,0,1,0
12955,2205,0,0,62,62,0,1,0,1,0
13088,1357,0,0,143,143,0,1,0,1,0
2580,2853,0,0,60,60,0,1,0,1,0
16951,255,0,0,62,62,0,1,0,1,0
2123,7,0,0,60,60,0,1,0,1,0
19411,2604,0,0,66,66,0,1,0,1,0
0,0,0,0,98,98,0,1,0,1,0
19677,2486,0,0,148,148,0,1,0,1,0
14802,1215,0,0,66,66,0,1,0,1,0
7615,1147,0,0,62,62,0,1,0,1,0
1433,1017,0,0,62,62,0,1,0,1,0
11080,509,0,0,62,62,0,1,0,1,0
2198,1017,0,0,62,62,0,1,0,1,0
12,2461,0,0,81,81,0,1,0,1,0
16951,255,0,0,62,62,0,1,0,1,0
1575,2938,0,0,62,62,0,1,0,1,0
248,1054,0,0,62,62,0,1,0,1,0
3386,1888,0,0,62,62,0,1,0,1,0
6165,8,0,0,74,74,0,1,0,1,0
20325,10,0,0,88,88,0,1,0,1,0
14891,1017,0,0,146,146,0,1,0,1,0
12321,1017,0,0,66,66,0,1,0,1,0
3418,2787,0,0,60,60,0,1,0,1,0
4833,201,0,0,72,72,0,1,0,1,0
15976,1017,0,0,62,62,0,1,0,1,0
2236,2611,0,0,62,62,0,1,0,1,0
19870,1888,0,0,62,62,0,1,0,1,0
1866,7,0,0,60,60,0,1,0,1,0
1804,375,0,0,60,60,0,1,0,1,0
423,7,0,0,60,60,0,1,0,1,0
16219,3216,0,0,66,66,0,1,0,1,0
3110,2953,0,0,62,62,0,1,0,1,0
12088,1472,0,0,66,66,0,1,0,1,0
2649,1215,0,0,62,62,0,1,0,1,0
21953,1147,0,0,66,66,0,1,0,1,0
6651,1129,0,0,156,156,0,1,0,1,0
374,1147,0,0,62,62,0,1,0,1,0
5803,245,0,0,60,60,0,1,0,1,0
19057,1888,0,0,62,62,0,1,0,1,0
18808,2747,0,0,66,66,0,1,0,1,0
202,899,0,0,66,66,0,1,0,1,0
8331,1147,0,0,62,62,0,1,0,1,0
5544,2938,0,0,62,62,0,1,0,1,0
3137,2587,0,0,62,62,0,1,0,1,0
2591,362,0,0,148,148,0,1,0,1,0
7,12,0,0,346,346,0,1,0,1,0
8164,2726,0,0,60,60,0,1,0,1,0
11472,104,0,0,60,60,0,1,0,1,0
11736,2256,0,0,66,66,0,1,0,1,0
15353,1771,0,0,62,62,0,1,0,1,0
7339,140,0,0,60,60,0,1,0,1,0
21455,155,0,0,66,66,0,1,0,1,0
12681,1888,0,0,66,66,0,1,0,1,0
7653,1224,0,0,60,60,0,1,0,1,0
13089,1017,0,0,62,62,0,1,0,1,0
20811,2953,0,0,66,66,0,1,0,1,0
20851,2636,0,0,66,66,0,1,0,1,0
18685,1771,0,0,66,66,0,1,0,1,0
3022,1880,0,0,66,66,0,1,0,1,0
1902,2836,0,0,66,66,0,1,0,1,0
7509,218,0,0,60,60,0,1,0,1,0
16951,255,0,0,62,62,0,1,0,1,0
360,3105,0,0,1163,1163,0,1,0,1,0
2316,1147,0,0,146,146,0,1,0,1,0
19793,509,0,0,66,66,0,1,0,1,0
2223,1017,0,0,62,62,0,1,0,1,0
3150,1472,0,0,62,62,0,1,0,1,0
7949,314,0,0,60,60,0,1,0,1,0
21125,1147,0,0,66,66,0,1,0,1,0
7310,1147,0,0,62,62,0,1,0,1,0
21918,1154,0,0,66,66,0,1,0,1,0
16478,317,0,0,60,60,0,1,0,1,0
11878,2938,0,0,74,74,0,1,0,1,0
1940,1590,0,0,66,66,0,1,0,1,0
377,509,0,0,66,66,0,1,0,1,0
1596,3139,0,0,62,62,0,1,0,1,0
5402,899,0,0,62,62,0,1,0,1,0
13294,1167,0,0,62,62,0,1,0,1,0
1465,509,0,0,62,62,0,1,0,1,0
13456,1797,0,0,66,66,0,1,0,1,0
1622,2604,0,0,62,62,0,1,0,1,0
1662,1147,0,0,62,62,0,1,0,1,0
5473,3139,0,0,62,62,0,1,0,1,0
21999,2587,0,0,66,66,0,1,0,1,0
12037,1888,0,0,62,62,0,1,0,1,0
273,1367,0,0,60,60,0,1,0,1,0
2629,1147,0,0,66,66,0,1,0,1,0
12,207,0,0,320,320,0,1,0,1,0
5540,1054,0,0,62,62,0,1,0,1,0
10475,2587,0,0,66,66,0,1,0,1,0
19901,2587,0,0,66,66,0,1,0,1,0
2367,2953,0,0,62,62,0,1,0,1,0
21949,2883,0,0,62,62,0,1,0,1,0
16350,1215,0,0,62,62,0,1,0,1,0
16951,255,0,0,62,62,0,1,0,1,0
7540,2938,0,0,66,66,0,1,0,1,0
13468,2587,0,0,66,66,0,1,0,1,0
3221,1017,0,0,62,62,0,1,0,1,0
1586,2587,0,0,146,146,0,1,0,1,0
16951,255,0,0,62,62,0,1,0,1,0
60,2382,0,0,62,62,0,1,0,1,0
17618,2573,0,0,70,70,0,1,0,1,0
2001,2256,0,0,66,66,0,1,0,1,0
16951,255,0,0,62,62,0,1,0,1,0
18147,1888,0,0,66,66,0,1,0,1,0
1663,2953,0,0,62,62,0,1,0,1,0
7707,697,0,0,146,146,0,1,0,1,0
17681,3216,0,0,62,62,0,1,0,1,0
11583,2256,0,0,66,66,0,1,0,1,0
0,0,0,0,102,102,0,1,0,1,0
11106,2256,0,0,62,62,0,1,0,1,0
18089,3216,0,0,66,66,0,1,0,1,0
2327,1147,0,0,66,66,0,1,0,1,0
5497,1804,0,0,66,66,0,1,0,1,0
4099,2477,0,0,62,62,0,1,0,1,0
15039,1017,0,0,146,146,0,1,0,1,0
15694,1515,0,0,145,145,0,1,0,1,0
16321,3216,0,0,62,62,0,1,0,1,0
3048,2256,0,0,66,66,0,1,0,1,0
16951,255,0,0,62,62,0,1,0,1,0
3666,7,0,0,60,60,0,1,0,1,0
11207,1154,0,0,66,66,0,1,0,1,0
22116,2604,0,0,66,66,0,1,0,1,0
22095,2205,0,0,66,66,0,1,0,1,0
2461,1888,0,0,62,62,0,1,0,1,0
1548,2611,0,0,62,62,0,1,0,1,0
823,750,0,0,60,60,0,1,0,1,0
7335,1070,0,0,60,60,0,1,0,1,0
20699,2697,0,0,78,78,0,1,0,1,0
16830,1888,0,0,66,66,0,1,0,1,0
7804,308,0,0,62,62,0,1,0,1,0
15214,2486,0,0,66,66,0,1,0,1,0
2584,1677,0,0,160,160,0,1,0,1,0
11518,1888,0,0,62,62,0,1,0,1,0
16951,255,0,0,62,62,0,1,0,1,0
7502,3216,0,0,62,62,0,1,0,1,0
17469,509,0,0,62,62,0,1,0,1,0
1517,1771,0,0,66,66,0,1,0,1,0
1455,1880,0,0,62,62,0,1,0,1,0
13723,2256,0,0,66,66,0,1,0,1,0
11347,2256,0,0,66,66,0,1,0,1,0
8,2792,0,0,66,66,0,1,0,1,0
21456,2256,0,0,66,66,0,1,0,1,0
2694,1888,0,0,62,62,0,1,0,1,0
16280,1472,0,0,62,62,0,1,0,1,0
18249,1771,0,0,66,66,0,1,0,1,0
20571,1771,0,0,66,66,0,1,0,1,0
8098,1795,0,0,146,146,0,1,0,1,0
16951,255,0,0,62,62,0,1,0,1,0
4441,2573,0,0,146,146,0,1,0,1,0
9632,1017,0,0,66,66,0,1,0,1,0
2660,1888,0,0,62,62,0,1,0,1,0
14856,2256,0,0,66,66,0,1,0,1,0
21773,2573,0,0,66,66,0,1,0,1,0
6355,2256,0,0,62,62,0,1,0,1,0
19734,2953,0,0,62,62,0,1,0,1,0
12184,1215,0,0,66,66,0,1,0,1,0
19486,1888,0,0,66,66,0,1,0,1,0
11144,3216,0,0,62,62,0,1,0,1,0
58,2432,0,0,159,159,0,1,0,1,0
11048,2953,0,0,62,62,0,1,0,1,0
7335,1070,0,0,60,60,0,1,0,1,0
18240,1017,0,0,66,66,0,1,0,1,0
693,2256,0,0,66,66,0,1,0,1,0
8,2935,0,0,1514,1514,0,1,0,1,0
4563,2205,0,0,62,62,0,1,0,1,0
10462,280,0,0,66,66,0,1,0,1,0
2748,3197,0,0,145,145,0,1,0,1,0
360,3105,0,0,1275,1275,0,1,0,1,0
7690,1888,0,0,62,62,0,1,0,1,0
8475,1017,0,0,66,66,0,1,0,1,0
2970,1472,0,0,62,62,0,1,0,1,0
3574,2938,0,0,74,74,0,1,0,1,0
14699,983,0,0,66,66,0,1,0,1,0
16050,2256,0,0,66,66,0,1,0,1,0
78,2636,0,0,62,62,0,1,0,1,0
360,3105,0,0,901,901,0,1,0,1,0
285,1763,0,0,66,66,0,1,0,1,0
497,2220,0,0,220,220,0,1,0,1,0
16951,255,0,0,62,62,0,1,0,1,0
19820,2787,0,0,60,60,0,1,0,1,0
2566,308,0,0,66,66,0,1,0,1,0
8327,3193,0,0,146,146,0,1,0,1,0
8164,2728,0,0,60,60,0,1,0,1,0
9400,146,0,0,60,60,0,1,0,1,0
18626,1215,0,0,62,62,0,1,0,1,0
7425,7,0,0,60,60,0,1,0,1,0
15694,344,0,0,145,145,0,1,0,1,0
10401,1888,0,0,62,62,0,1,0,1,0
2023,2486,0,0,148,148,0,1,0,1,0
20535,509,0,0,62,62,0,1,0,1,0
6805,280,0,0,62,62,0,1,0,1,0
12610,3216,0,0,66,66,0,1,0,1,0
16951,255,0,0,62,62,0,1,0,1,0
19840,2256,0,0,62,62,0,1,0,1,0
13845,983,0,0,62,62,0,1,0,1,0
8171,1073,0,0,60,60,0,1,0,1,0
16951,255,0,0,62,62,0,1,0,1,0
2750,1147,0,0,62,62,0,1,0,1,0
9264,1539,0,0,62,62,0,1,0,1,0
360,3105,0,0,902,902,0,1,0,1,0
1887,2256,0,0,66,66,0,1,0,1,0
291,1147,0,0,66,66,0,1,0,1,0
1307,7,0,0,60,60,0,1,0,1,0
844,2938,0,0,146,146,0,1,0,1,0
5836,225,0,0,60,60,0,1,0,1,0
3140,7,0,0,60,60,0,1,0,1,0
9818,1771,0,0,62,62,0,1,0,1,0
20515,2587,0,0,62,62,0,1,0,1,0
18067,1804,0,0,62,62,0,1,0,1,0
17456,357,0,0,66,66,0,1,0,1,0
16275,2938,0,0,66,66,0,1,0,1,0
2810,1017,0,0,62,62,0,1,0,1,0
2122,3216,0,0,62,62,0,1,0,1,0
2897,1888,0,0,62,62,0,1,0,1,0
9214,3256,0,0,60,60,0,1,0,1,0
8,2758,0,0,60,60,0,1,0,1,0
15470,510,0,0,62,62,0,1,0,1,0
16478,245,0,0,60,60,0,1,0,1,0
1853,2938,0,0,62,62,0,1,0,1,0
19347,3216,0,0,66,66,0,1,0,1,0
8,1873,0,0,60,60,0,1,0,1,0
7344,2636,0,0,146,146,0,1,0,1,0
1937,1215,0,0,66,66,0,1,0,1,0
2553,146,0,0,60,60,0,1,0,1,0
1320,1888,0,0,62,62,0,1,0,1,0
2789,1054,0,0,146,146,0,1,0,1,0
19728,509,0,0,66,66,0,1,0,1,0
1996,1771,0,0,146,146,0,1,0,1,0
19247,983,0,0,62,62,0,1,0,1,0
14101,1017,0,0,62,62,0,1,0,1,0
22580,1215,0,0,62,62,0,1,0,1,0
21139,3216,0,0,66,66,0,1,0,1,0
497,2220,0,0,220,220,0,1,0,1,0
12586,1804,0,0,66,66,0,1,0,1,0
10790,2587,0,0,62,62,0,1,0,1,0
8276,2495,0,0,161,161,0,1,0,1,0
11677,2636,0,0,66,66,0,1,0,1,0
19325,1888,0,0,66,66,0,1,0,1,0
1480,1888,0,0,66,66,0,1,0,1,0
219,3188,0,0,62,62,0,1,0,1,0
20076,1880,0,0,62,62,0,1,0,1,0
636,280,0,0,62,62,0,1,0,1,0
6552,2093,0,0,145,145,0,1,0,1,0
10154,1472,0,0,66,66,0,1,0,1,0
11480,1888,0,0,66,66,0,1,0,1,0
323,1,0,0,62,62,0,1,0,1,0
28,3216,0,0,62,62,0,1,0,1,0
1782,280,0,0,146,146,0,1,0,1,0
128,391,0,0,62,62,0,1,0,1,0
9369,2154,0,0,66,66,0,1,0,1,0
6243,2938,0,0,62,62,0,1,0,1,0
16951,255,0,0,62,62,0,1,0,1,0
9154,3139,0,0,66,66,0,1,0,1,0
3120,1147,0,0,62,62,0,1,0,1,0
20163,2636,0,0,62,62,0,1,0,1,0
20003,2558,0,0,66,66,0,1,0,1,0
1390,1880,0,0,146,146,0,1,0,1,0
12234,7,0,0,60,60,0,1,0,1,0
730,7,0,0,60,60,0,1,0,1,0
20501,1771,0,0,66,66,0,1,0,1,0
2016,2883,0,0,62,62,0,1,0,1,0
1133,1771,0,0,66,66,0,1,0,1,0
20735,2778,0,0,78,78,0,1,0,1,0
2748,2636,0,0,146,146,0,1,0,1,0
2493,3216,0,0,66,66,0,1,0,1,0
18,3216,0,0,62,62,0,1,0,1,0
2630,1287,0,0,66,66,0,1,0,1,0
18151,1147,0,0,66,66,0,1,0,1,0
1860,3139,0,0,62,62,0,1,0,1,0
13317,509,0,0,66,66,0,1,0,1,0
12688,1804,0,0,62,62,0,1,0,1,0
16951,255,0,0,62,62,0,1,0,1,0
5988,104,0,0,60,60,0,1,0,1,0
2446,7,0,0,60,60,0,1,0,1,0
3997,2256,0,0,62,62,0,1,0,1,0
16779,2256,0,0,66,66,0,1,0,1,0
2019,3216,0,0,62,62,0,1,0,1,0
9392,2256,0,0,66,66,0,1,0,1,0
1725,1017,0,0,66,66,0,1,0,1,0
20162,3216,0,0,62,62,0,1,0,1,0
3997,2256,0,0,66,66,0,1,0,1,0
11461,2611,0,0,74,74,0,1,0,1,0
6506,697,0,0,62,62,0,1,0,1,0
1249,1215,0,0,62,62,0,1,0,1,0
16951,255,0,0,62,62,0,1,0,1,0
1816,1215,0,0,66,66,0,1,0,1,0
16731,1086,0,0,66,66,0,1,0,1,0
6073,2883,0,0,62,62,0,1,0,1,0
14339,1215,0,0,62,62,0,1,0,1,0
2660,1888,0,0,62,62,0,1,0,1,0
18,3216,0,0,62,62,0,1,0,1,0
1986,1215,0,0,62,62,0,1,0,1,0
2578,510,0,0,66,66,0,1,0,1,0
21981,2695,0,0,62,62,0,1,0,1,0
7765,1880,0,0,62,62,0,1,0,1,0
11659,1792,0,0,62,62,0,1,0,1,0
3137,2587,0,0,62,62,0,1,0,1,0
11744,697,0,0,66,66,0,1,0,1,0
2215,775,0,0,62,62,0,1,0,1,0
601,3216,0,0,66,66,0,1,0,1,0
17136,2256,0,0,74,74,0,1,0,1,0
13093,1771,0,0,62,62,0,1,0,1,0
6426,2205,0,0,62,62,0,1,0,1,0
2313,2883,0,0,62,62,0,1,0,1,0
9877,1888,0,0,62,62,0,1,0,1,0
20861,2144,0,0,66,66,0,1,0,1,0
1475,2636,0,0,62,62,0,1,0,1,0
497,995,0,0,91,91,0,1,0,1,0
16951,255,0,0,62,62,0,1,0,1,0
21920,1215,0,0,62,62,0,1,0,1,0
16439,3216,0,0,66,66,0,1,0,1,0
7929,2587,0,0,62,62,0,1,0,1,0
1301,1507,0,0,148,148,0,1,0,1,0
2170,1147,0,0,62,62,0,1,0,1,0
11450,1686,0,0,60,60,0,1,0,1,0
9764,2587,0,0,66,66,0,1,0,1,0
10283,2256,0,0,66,66,0,1,0,1,0
12746,2235,0,0,62,62,0,1,0,1,0
7191,1,0,0,62,62,0,1,0,1,0
2332,7,0,0,60,60,0,1,0,1,0
1333,1472,0,0,62,62,0,1,0,1,0
360,3105,0,0,944,944,0,1,0,1,0
19295,3216,0,0,62,62,0,1,0,1,0
123,2739,0,0,62,62,0,1,0,1,0
9461,1167,0,0,62,62,0,1,0,1,0
8327,2235,0,0,146,146,0,1,0,1,0
7335,1070,0,0,60,60,0,1,0,1,0
3471,465,0,0,159,159,0,1,0,1,0
1523,465,0,0,159,159,0,1,0,1,0
807,3216,0,0,66,66,0,1,0,1,0
18319,2241,0,0,62,62,0,1,0,1,0
19502,3212,0,0,62,62,0,1,0,1,0
15446,983,0,0,74,74,0,1,0,1,0
19827,383,0,0,66,66,0,1,0,1,0
11995,2144,0,0,66,66,0,1,0,1,0
2199,2636,0,0,62,62,0,1,0,1,0
2317,2486,0,0,143,143,0,1,0,1,0
8,1814,0,0,1514,1514,0,1,0,1,0
13206,3139,0,0,66,66,0,1,0,1,0
3189,2883,0,0,62,62,0,1,0,1,0
4408,2883,0,0,62,62,0,1,0,1,0
9260,805,0,0,66,66,0,1,0,1,0
16951,255,0,0,62,62,0,1,0,1,0
20306,775,0,0,66,66,0,1,0,1,0
2335,2486,0,0,62,62,0,1,0,1,0
15640,1471,0,0,146,146,0,1,0,1,0
16894,2943,0,0,66,66,0,1,0,1,0
19857,2587,0,0,66,66,0,1,0,1,0
9283,3216,0,0,66,66,0,1,0,1,0
8,2758,0,0,60,60,0,1,0,1,0
13732,1147,0,0,66,66,0,1,0,1,0
2304,1215,0,0,62,62,0,1,0,1,0
16951,255,0,0,62,62,0,1,0,1,0
9795,1147,0,0,62,62,0,1,0,1,0
8584,1017,0,0,66,66,0,1,0,1,0
9504,1771,0,0,66,66,0,1,0,1,0
8782,1472,0,0,66,66,0,1,0,1,0
18,2938,0,0,62,62,0,1,0,1,0
19698,3212,0,0,66,66,0,1,0,1,0
7949,314,0,0,60,60,0,1,0,1,0
3708,7,0,0,60,60,0,1,0,1,0
12316,2938,0,0,62,62,0,1,0,1,0
13627,104,0,0,60,60,0,1,0,1,0
5895,1147,0,0,62,62,0,1,0,1,0
1912,1472,0,0,62,62,0,1,0,1,0
8,380,0,0,74,74,0,1,0,1,0
19,2379,0,0,62,62,0,1,0,1,0
2536,1167,0,0,62,62,0,1,0,1,0
16119,909,0,0,66,66,0,1,0,1,0
719,1482,0,0,62,62,0,1,0,1,0
6165,8,0,0,74,74,0,1,0,1,0
497,2220,0,0,66,66,0,1,0,1,0
2109,364,0,0,60,60,0,1,0,1,0
21425,3051,0,0,62,62,0,1,0,1,0
18666,3216,0,0,62,62,0,1,0,1,0
12,929,0,0,83,83,0,1,0,1,0
20119,1054,0,0,66,66,0,1,0,1,0
1840,6,0,0,60,60,0,1,0,1,0
13793,509,0,0,66,66,0,1,0,1,0
16951,255,0,0,62,62,0,1,0,1,0
3321,2587,0,0,62,62,0,1,0,1,0
1542,1888,0,0,66,66,0,1,0,1,0
11787,1019,0,0,66,66,0,1,0,1,0
5249,1017,0,0,62,62,0,1,0,1,0
20990,1017,0,0,66,66,0,1,0,1,0
17864,1147,0,0,62,62,0,1,0,1,0
7734,2587,0,0,62,62,0,1,0,1,0
3807,2610,0,0,60,60,0,1,0,1,0
16941,3212,0,0,62,62,0,1,0,1,0
12596,2587,0,0,66,66,0,1,0,1,0
1964,983,0,0,66,66,0,1,0,1,0
2997,509,0,0,146,146,0,1,0,1,0
813,2104,0,0,143,143,0,1,0,1,0
22103,2608,0,0,62,62,0,1,0,1,0
17,2652,0,0,66,66,0,1,0,1,0
612,21,0,0,60,60,0,1,0,1,0
6198,1471,0,0,146,146,0,1,0,1,0
16448,1017,0,0,66,66,0,1,0,1,0
2664,2256,0,0,66,66,0,1,0,1,0
12,972,0,0,83,83,0,1,0,1,0
619,2636,0,0,62,62,0,1,0,1,0
19104,1888,0,0,66,66,0,1,0,1,0
8114,2550,0,0,62,62,0,1,0,1,0
8843,1147,0,0,66,66,0,1,0,1,0
515,1888,0,0,66,66,0,1,0,1,0
16951,255,0,0,62,62,0,1,0,1,0
2055,2856,0,0,137,137,0,1,0,1,0
397,2852,0,0,66,66,0,1,0,1,0
14144,1086,0,0,66,66,0,1,0,1,0
5825,983,0,0,62,62,0,1,0,1,0
20176,2256,0,0,66,66,0,1,0,1,0
8327,2938,0,0,146,146,0,1,0,1,0
2439,344,0,0,148,148,0,1,0,1,0
1284,1147,0,0,62,62,0,1,0,1,0
12565,3216,0,0,66,66,0,1,0,1,0
12,1380,0,0,82,82,0,1,0,1,0
16951,255,0,0,62,62,0,1,0,1,0
16951,255,0,0,62,62,0,1,0,1,0
7335,1071,0,0,60,60,0,1,0,1,0
15019,2883,0,0,62,62,0,1,0,1,0
12,2461,0,0,81,81,0,1,0,1,0
16478,164,0,0,60,60,0,1,0,1,0
21641,1147,0,0,62,62,0,1,0,1,0
7393,104,0,0,60,60,0,1,0,1,0
4021,2205,0,0,62,62,0,1,0,1,0
10813,2587,0,0,66,66,0,1,0,1,0
9961,2587,0,0,66,66,0,1,0,1,0
2902,2587,0,0,62,62,0,1,0,1,0
3189,2883,0,0,62,62,0,1,0,1,0
1631,1888,0,0,62,62,0,1,0,1,0
16951,255,0,0,62,62,0,1,0,1,0
16849,1936,0,0,66,66,0,1,0,1,0
21629,1888,0,0,66,66,0,1,0,1,0
14593,1215,0,0,62,62,0,1,0,1,0
17579,2587,0,0,62,62,0,1,0,1,0
6571,1,0,0,62,62,0,1,0,1,0
944,2636,0,0,62,62,0,1,0,1,0
17051,2611,0,0,62,62,0,1,0,1,0
603,1888,0,0,62,62,0,1,0,1,0
9614,3105,0,0,86,86,0,1,0,1,0
6506,936,0,0,62,62,0,1,0,1,0
1723,2636,0,0,66,66,0,1,0,1,0
17691,1888,0,0,62,62,0,1,0,1,0
20370,1771,0,0,66,66,0,1,0,1,0
3245,1737,0,0,62,62,0,1,0,1,0
713,2938,0,0,66,66,0,1,0,1,0
18437,2938,0,0,62,62,0,1,0,1,0
17542,2938,0,0,74,74,0,1,0,1,0
6073,2883,0,0,62,62,0,1,0,1,0
5968,3216,0,0,62,62,0,1,0,1,0
20413,509,0,0,146,146,0,1,0,1,0
17212,509,0,0,62,62,0,1,0,1,0
16727,176,0,0,60,60,0,1,0,1,0
3116,2636,0,0,62,62,0,1,0,1,0
14844,2256,0,0,62,62,0,1,0,1,0
10736,1017,0,0,66,66,0,1,0,1,0
2861,1215,0,0,66,66,0,1,0,1,0
269,509,0,0,62,62,0,1,0,1,0
2288,2256,0,0,62,62,0,1,0,1,0
659,1054,0,0,66,66,0,1,0,1,0
1755,2587,0,0,62,62,0,1,0,1,0
1570,1888,0,0,146,146,0,1,0,1,0
0,0,0,0,98,98,0,1,0,1,0
15196,2587,0,0,62,62,0,1,0,1,0
19452,983,0,0,62,62,0,1,0,1,0
17657,1827,0,0,66,66,0,1,0,1,0
18321,2379,0,0,66,66,0,1,0,1,0
6426,2205,0,0,62,62,0,1,0,1,0
3139,1771,0,0,146,146,0,1,0,1,0
21816,2587,0,0,146,146,0,1,0,1,0
1719,7,0,0,60,60,0,1,0,1,0
1723,2636,0,0,66,66,0,1,0,1,0
7375,1594,0,0,74,74,0,1,0,1,0
723,2587,0,0,62,62,0,1,0,1,0
16951,255,0,0,62,62,0,1,0,1,0
1582,2587,0,0,62,62,0,1,0,1,0
18788,2975,0,0,66,66,0,1,0,1,0
14505,2312,0,0,78,78,0,1,0,1,0
8547,983,0,0,66,66,0,1,0,1,0
1588,1703,0,0,66,66,0,1,0,1,0
3316,1888,0,0,66,66,0,1,0,1,0
93,1017,0,0,66,66,0,1,0,1,0
12809,2573,0,0,62,62,0,1,0,1,0
4374,1017,0,0,62,62,0,1,0,1,0
11981,1106,0,0,66,66,0,1,0,1,0
9282,1054,0,0,62,62,0,1,0,1,0
636,2312,0,0,100,100,0,1,0,1,0
21301,2938,0,0,62,62,0,1,0,1,0
15572,1147,0,0,62,62,0,1,0,1,0
348,2256,0,0,78,78,0,1,0,1,0
16951,255,0,0,62,62,0,1,0,1,0
2494,1147,0,0,62,62,0,1,0,1,0
16715,697,0,0,66,66,0,1,0,1,0
14481,3216,0,0,66,66,0,1,0,1,0
17268,2953,0,0,66,66,0,1,0,1,0
9857,2938,0,0,66,66,0,1,0,1,0
20893,1888,0,0,66,66,0,1,0,1,0
2973,2636,0,0,62,62,0,1,0,1,0
17620,2587,0,0,66,66,0,1,0,1,0
3183,1771,0,0,62,62,0,1,0,1,0
10214,3188,0,0,66,66,0,1,0,1,0
5407,1888,0,0,66,66,0,1,0,1,0
10305,2938,0,0,66,66,0,1,0,1,0
15021,509,0,0,66,66,0,1,0,1,0
1132,16,0,0,60,60,0,1,0,1,0
20176,2256,0,0,66,66,0,1,0,1,0
35,7,0,0,60,60,0,1,0,1,0
2413,1771,0,0,62,62,0,1,0,1,0
20750,10,0,0,72,72,0,1,0,1,0
18,1147,0,0,146,146,0,1,0,1,0
17016,2938,0,0,66,66,0,1,0,1,0
22570,1017,0,0,66,66,0,1,0,1,0
11875,2256,0,0,66,66,0,1,0,1,0
2103,155,0,0,62,62,0,1,0,1,0
2703,2953,0,0,62,62,0,1,0,1,0
15228,1017,0,0,66,66,0,1,0,1,0
8989,1147,0,0,146,146,0,1,0,1,0
541,1804,0,0,62,62,0,1,0,1,0
328,1017,0,0,62,62,0,1,0,1,0
3205,1219,0,0,145,145,0,1,0,1,0
2316,1147,0,0,62,62,0,1,0,1,0
1745,1888,0,0,146,146,0,1,0,1,0
16951,255,0,0,62,62,0,1,0,1,0
10009,1462,0,0,66,66,0,1,0,1,0
1607,1215,0,0,62,62,0,1,0,1,0
2301,1946,0,0,60,60,0,1,0,1,0
16896,2581,0,0,66,66,0,1,0,1,0
2528,2636,0,0,62,62,0,1,0,1,0
18225,3139,0,0,66,66,0,1,0,1,0
2335,2486,0,0,62,62,0,1,0,1,0
13206,3139,0,0,66,66,0,1,0,1,0
18963,2477,0,0,78,78,0,1,0,1,0
5416,3139,0,0,146,146,0,1,0,1,0
8645,2883,0,0,66,66,0,1,0,1,0
1994,2953,0,0,146,146,0,1,0,1,0
6761,5,0,0,60,60,0,1,0,1,0
18275,10,0,0,88,88,0,1,0,1,0
5709,1215,0,0,62,62,0,1,0,1,0
17526,983,0,0,62,62,0,1,0,1,0
14910,2235,0,0,66,66,0,1,0,1,0
13070,1872,0,0,66,66,0,1,0,1,0
1409,459,0,0,72,72,0,1,0,1,0
5895,1147,0,0,62,62,0,1,0,1,0
9140,1017,0,0,66,66,0,1,0,1,0
16951,255,0,0,62,62,0,1,0,1,0
3075,1215,0,0,62,62,0,1,0,1,0
9214,3256,0,0,60,60,0,1,0,1,0
2962,146,0,0,60,60,0,1,0,1,0
20308,2938,0,0,74,74,0,1,0,1,0
7273,1888,0,0,62,62,0,1,0,1,0
123,2739,0,0,66,66,0,1,0,1,0
17,1910,0,0,66,66,0,1,0,1,0
13320,1215,0,0,66,66,0,1,0,1,0
16951,255,0,0,62,62,0,1,0,1,0
19234,2636,0,0,62,62,0,1,0,1,0
496,982,0,0,66,66,0,1,0,1,0
13901,1888,0,0,146,146,0,1,0,1,0
3120,1147,0,0,62,62,0,1,0,1,0
1552,1083,0,0,168,168,0,1,0,1,0
15072,697,0,0,146,146,0,1,0,1,0
2614,2587,0,0,146,146,0,1,0,1,0
12299,2256,0,0,66,66,0,1,0,1,0
612,25,0,0,60,60,0,1,0,1,0
685,2587,0,0,62,62,0,1,0,1,0
8220,1880,0,0,62,62,0,1,0,1,0
20332,1147,0,0,62,62,0,1,0,1,0
2820,1147,0,0,62,62,0,1,0,1,0
4833,201,0,0,72,72,0,1,0,1,0
2655,3216,0,0,62,62,0,1,0,1,0
1505,1804,0,0,62,62,0,1,0,1,0
12384,2256,0,0,62,62,0,1,0,1,0
1534,2256,0,0,62,62,0,1,0,1,0
1270,1147,0,0,146,146,0,1,0,1,0
7335,1070,0,0,60,60,0,1,0,1,0
10474,2938,0,0,72,72,0,1,0,1,0
2396,1147,0,0,62,62,0,1,0,1,0
16951,255,0,0,62,62,0,1,0,1,0
7636,2587,0,0,62,62,0,1,0,1,0
2319,1215,0,0,62,62,0,1,0,1,0
9788,1771,0,0,66,66,0,1,0,1,0
22537,2382,0,0,66,66,0,1,0,1,0
2056,1936,0,0,62,62,0,1,0,1,0
19826,2883,0,0,66,66,0,1,0,1,0
2410,3216,0,0,62,62,0,1,0,1,0
5835,225,0,0,60,60,0,1,0,1,0
20428,983,0,0,66,66,0,1,0,1,0
22457,1888,0,0,62,62,0,1,0,1,0
1358,2023,0,0,148,148,0,1,0,1,0
18879,2587,0,0,66,66,0,1,0,1,0
339,104,0,0,60,60,0,1,0,1,0
6585,1215,0,0,66,66,0,1,0,1,0
16043,1147,0,0,66,66,0,1,0,1,0
6699,1771,0,0,62,62,0,1,0,1,0
20002,2256,0,0,62,62,0,1,0,1,0
1304,2256,0,0,66,66,0,1,0,1,0
15106,3216,0,0,62,62,0,1,0,1,0
14621,2883,0,0,62,62,0,1,0,1,0
3064,2938,0,0,60,60,0,1,0,1,0
16951,255,0,0,62,62,0,1,0,1,0
2597,1771,0,0,66,66,0,1,0,1,0
21834,1797,0,0,62,62,0,1,0,1,0
17091,1147,0,0,62,62,0,1,0,1,0
15846,1539,0,0,62,62,0,1,0,1,0
20749,10,0,0,77,77,0,1,0,1,0
7273,1888,0,0,145,145,0,1,0,1,0
20411,1215,0,0,62,62,0,1,0,1,0
7326,180,0,0,60,60,0,1,0,1,0
14088,2883,0,0,66,66,0,1,0,1,0
3770,1771,0,0,62,62,0,1,0,1,0
16951,255,0,0,62,62,0,1,0,1,0
17212,509,0,0,66,66,0,1,0,1,0
6231,1147,0,0,62,62,0,1,0,1,0
801,7,0,0,60,60,0,1,0,1,0
1925,7,0,0,60,60,0,1,0,1,0
6015,126,0,0,139,139,0,1,0,1,0
16951,255,0,0,62,62,0,1,0,1,0
21481,2604,0,0,66,66,0,1,0,1,0
582,1147,0,0,66,66,0,1,0,1,0
7099,1147,0,0,146,146,0,1,0,1,0
1992,3216,0,0,66,66,0,1,0,1,0
12,3227,0,0,60,60,0,1,0,1,0
18,2256,0,0,146,146,0,1,0,1,0
406,1888,0,0,66,66,0,1,0,1,0
17176,2938,0,0,66,66,0,1,0,1,0
22235,2953,0,0,66,66,0,1,0,1,0
631,2154,0,0,66,66,0,1,0,1,0
1755,2587,0,0,62,62,0,1,0,1,0
334,3216,0,0,66,66,0,1,0,1,0
6708,1017,0,0,62,62,0,1,0,1,0
1701,2587,0,0,62,62,0,1,0,1,0
11427,1771,0,0,62,62,0,1,0,1,0
8954,104,0,0,60,60,0,1,0,1,0
8865,3216,0,0,62,62,0,1,0,1,0
5767,2938,0,0,62,62,0,1,0,1,0
16249,1888,0,0,146,146,0,1,0,1,0
20721,3139,0,0,66,66,0,1,0,1,0
652,1,0,0,100,100,0,1,0,1,0
11838,2205,0,0,66,66,0,1,0,1,0
8918,2587,0,0,62,62,0,1,0,1,0
9369,2154,0,0,66,66,0,1,0,1,0
11141,2256,0,0,66,66,0,1,0,1,0
14228,6,0,0,60,60,0,1,0,1,0
16548,459,0,0,66,66,0,1,0,1,0
6269,2477,0,0,60,60,0,1,0,1,0
2081,3216,0,0,62,62,0,1,0,1,0
16659,1771,0,0,62,62,0,1,0,1,0
5914,2587,0,0,146,146,0,1,0,1,0
17901,2117,0,0,62,62,0,1,0,1,0
1281,2543,0,0,60,60,0,1,0,1,0
3532,7,0,0,60,60,0,1,0,1,0
1419,1017,0,0,146,146,0,1,0,1,0
9348,3216,0,0,66,66,0,1,0,1,0
10401,1888,0,0,62,62,0,1,0,1,0
5074,6,0,0,60,60,0,1,0,1,0
19826,2883,0,0,66,66,0,1,0,1,0
2515,1147,0,0,62,62,0,1,0,1,0
1303,1795,0,0,60,60,0,1,0,1,0
1154,1590,0,0,66,66,0,1,0,1,0
1330,697,0,0,62,62,0,1,0,1,0
16920,2587,0,0,66,66,0,1,0,1,0
2626,2256,0,0,146,146,0,1,0,1,0
1525,1444,0,0,145,145,0,1,0,1,0
2293,460,0,0,66,66,0,1,0,1,0
3268,1888,0,0,66,66,0,1,0,1,0
844,2926,0,0,146,146,0,1,0,1,0
2167,1147,0,0,62,62,0,1,0,1,0
13537,1888,0,0,62,62,0,1,0,1,0
16951,255,0,0,62,62,0,1,0,1,0
17439,1771,0,0,66,66,0,1,0,1,0
8,2758,0,0,60,60,0,1,0,1,0
1873,1147,0,0,146,146,0,1,0,1,0
7615,1147,0,0,62,62,0,1,0,1,0
360,3105,0,0,927,927,0,1,0,1,0
10933,1215,0,0,62,62,0,1,0,1,0
7339,334,0,0,60,60,0,1,0,1,0
14694,2836,0,0,66,66,0,1,0,1,0
2473,2636,0,0,62,62,0,1,0,1,0
11906,509,0,0,66,66,0,1,0,1,0
1197,1147,0,0,62,62,0,1,0,1,0
2071,1888,0,0,62,62,0,1,0,1,0
2084,1471,0,0,145,145,0,1,0,1,0
6156,255,0,0,60,60,0,1,0,1,0
5544,2938,0,0,62,62,0,1,0,1,0
14489,3216,0,0,66,66,0,1,0,1,0
2723,2573,0,0,66,66,0,1,0,1,0
11981,1106,0,0,62,62,0,1,0,1,0
16951,255,0,0,62,62,0,1,0,1,0
3035,2587,0,0,62,62,0,1,0,1,0
7949,316,0,0,60,60,0,1,0,1,0
20004,1147,0,0,62,62,0,1,0,1,0
5202,3216,0,0,145,145,0,1,0,1,0
160,1888,0,0,62,62,0,1,0,1,0
978,1888,0,0,66,66,0,1,0,1,0
7335,1072,0,0,60,60,0,1,0,1,0
18147,1888,0,0,66,66,0,1,0,1,0
353,797,0,0,62,62,0,1,0,1,0
5497,1804,0,0,62,62,0,1,0,1,0
12421,1792,0,0,66,66,0,1,0,1,0
16951,255,0,0,62,62,0,1,0,1,0
1962,2608,0,0,62,62,0,1,0,1,0
13710,2235,0,0,62,62,0,1,0,1,0
2926,2587,0,0,62,62,0,1,0,1,0
5011,2477,0,0,60,60,0,1,0,1,0
1278,1147,0,0,146,146,0,1,0,1,0
12,3074,0,0,320,320,0,1,0,1,0
300,2938,0,0,66,66,0,1,0,1,0
2061,3216,0,0,62,62,0,1,0,1,0
1343,2154,0,0,62,62,0,1,0,1,0
8,2758,0,0,60,60,0,1,0,1,0
14455,3139,0,0,66,66,0,1,0,1,0
16951,255,0,0,62,62,0,1,0,1,0
4122,3216,0,0,66,66,0,1,0,1,0
2749,2636,0,0,66,66,0,1,0,1,0
11500,1771,0,0,66,66,0,1,0,1,0
2322,697,0,0,62,62,0,1,0,1,0
7460,1771,0,0,66,66,0,1,0,1,0
1471,2144,0,0,62,62,0,1,0,1,0
1230,983,0,0,146,146,0,1,0,1,0
15796,18,0,0,90,90,0,1,0,1,0
823,2424,0,0,60,60,0,1,0,1,0
16951,255,0,0,62,62,0,1,0,1,0
3570,3270,0,0,162,162,0,1,0,1,0
1215,2938,0,0,62,62,0,1,0,1,0
22289,1215,0,0,66,66,0,1,0,1,0
19728,509,0,0,66,66,0,1,0,1,0
652,2678,0,0,100,100,0,1,0,1,0
18887,3216,0,0,74,74,0,1,0,1,0
13723,2256,0,0,66,66,0,1,0,1,0
13364,1215,0,0,66,66,0,1,0,1,0
11460,1017,0,0,66,66,0,1,0,1,0
4290,2636,0,0,66,66,0,1,0,1,0
16020,2938,0,0,66,66,0,1,0,1,0
11951,3216,0,0,66,66,0,1,0,1,0
684,2938,0,0,62,62,0,1,0,1,0
639,242,0,0,143,143,0,1,0,1,0
11820,2611,0,0,78,78,0,1,0,1,0
16951,255,0,0,62,62,0,1,0,1,0
5839,1507,0,0,157,157,0,1,0,1,0
1554,697,0,0,62,62,0,1,0,1,0
7339,157,0,0,60,60,0,1,0,1,0
13847,1215,0,0,66,66,0,1,0,1,0
11949,2256,0,0,66,66,0,1,0,1,0
13643,2573,0,0,66,66,0,1,0,1,0
210,1147,0,0,62,62,0,1,0,1,0
13012,3212,0,0,66,66,0,1,0,1,0
18166,2097,0,0,66,66,0,1,0,1,0
13547,1147,0,0,146,146,0,1,0,1,0
22499,2611,0,0,66,66,0,1,0,1,0
2219,2636,0,0,66,66,0,1,0,1,0
985,2938,0,0,66,66,0,1,0,1,0
306,1147,0,0,62,62,0,1,0,1,0
3054,697,0,0,62,62,0,1,0,1,0
1215,2938,0,0,62,62,0,1,0,1,0
22510,2611,0,0,78,78,0,1,0,1,0
2352,2587,0,0,146,146,0,1,0,1,0
0,0,0,0,60,60,0,1,0,1,0
17372,383,0,0,66,66,0,1,0,1,0
9630,2883,0,0,66,66,0,1,0,1,0
3017,1880,0,0,66,66,0,1,0,1,0
16951,255,0,0,62,62,0,1,0,1,0
7509,218,0,0,60,60,0,1,0,1,0
2725,1017,0,0,66,66,0,1,0,1,0
11174,2521,0,0,62,62,0,1,0,1,0
5040,2636,0,0,66,66,0,1,0,1,0
21990,2611,0,0,62,62,0,1,0,1,0
15694,1202,0,0,145,145,0,1,0,1,0
60,1888,0,0,62,62,0,1,0,1,0
6651,1129,0,0,156,156,0,1,0,1,0
36,1804,0,0,66,66,0,1,0,1,0
2279,1147,0,0,62,62,0,1,0,1,0
15694,1787,0,0,145,145,0,1,0,1,0
22302,1880,0,0,66,66,0,1,0,1,0
6651,1129,0,0,156,156,0,1,0,1,0
19902,1017,0,0,66,66,0,1,0,1,0
17716,2883,0,0,66,66,0,1,0,1,0
22,3216,0,0,62,62,0,1,0,1,0
14228,6,0,0,60,60,0,1,0,1,0
22645,3113,0,0,66,66,0,1,0,1,0
774,983,0,0,62,62,0,1,0,1,0
13022,2938,0,0,66,66,0,1,0,1,0
1670,3216,0,0,62,62,0,1,0,1,0
10993,1017,0,0,66,66,0,1,0,1,0
2931,7,0,0,60,60,0,1,0,1,0
15846,1539,0,0,66,66,0,1,0,1,0
27,1215,0,0,62,62,0,1,0,1,0
12,3146,0,0,60,60,0,1,0,1,0
20317,1771,0,0,66,66,0,1,0,1,0
16951,255,0,0,62,62,0,1,0,1,0
18735,2587,0,0,66,66,0,1,0,1,0
74,3216,0,0,66,66,0,1,0,1,0
360,3105,0,0,164,164,0,1,0,1,0
18,3216,0,0,62,62,0,1,0,1,0
10272,348,0,0,60,60,0,1,0,1,0
10386,2938,0,0,66,66,0,1,0,1,0
7002,1215,0,0,62,62,0,1,0,1,0
10601,1215,0,0,66,66,0,1,0,1,0
3918,7,0,0,60,60,0,1,0,1,0
2523,3216,0,0,146,146,0,1,0,1,0
15204,1147,0,0,66,66,0,1,0,1,0
14978,1215,0,0,66,66,0,1,0,1,0
12,2568,0,0,60,60,0,1,0,1,0
11653,3216,0,0,66,66,0,1,0,1,0
19353,2587,0,0,66,66,0,1,0,1,0
17129,3216,0,0,66,66,0,1,0,1,0
19873,2883,0,0,66,66,0,1,0,1,0
1995,1472,0,0,62,62,0,1,0,1,0
1539,2938,0,0,62,62,0,1,0,1,0
2500,411,0,0,145,145,0,1,0,1,0
784,2636,0,0,66,66,0,1,0,1,0
11942,1804,0,0,66,66,0,1,0,1,0
16047,1888,0,0,62,62,0,1,0,1,0
0,0,0,0,98,98,0,1,0,1,0
645,1476,0,0,146,146,0,1,0,1,0
5011,2477,0,0,60,60,0,1,0,1,0
2280,1147,0,0,62,62,0,1,0,1,0
3870,1215,0,0,62,62,0,1,0,1,0
6233,1646,0,0,60,60,0,1,0,1,0
3050,1804,0,0,66,66,0,1,0,1,0
14957,2256,0,0,66,66,0,1,0,1,0
16951,255,0,0,62,62,0,1,0,1,0
423,2587,0,0,62,62,0,1,0,1,0
1525,1444,0,0,145,145,0,1,0,1,0
20556,1147,0,0,66,66,0,1,0,1,0
7515,1804,0,0,66,66,0,1,0,1,0
2274,2836,0,0,74,74,0,1,0,1,0
636,280,0,0,146,146,0,1,0,1,0
2045,1147,0,0,146,146,0,1,0,1,0
2273,1017,0,0,66,66,0,1,0,1,0
6651,1129,0,0,156,156,0,1,0,1,0
94,2256,0,0,62,62,0,1,0,1,0
1677,1215,0,0,62,62,0,1,0,1,0
17412,1771,0,0,66,66,0,1,0,1,0
16951,255,0,0,62,62,0,1,0,1,0
18955,2500,0,0,62,62,0,1,0,1,0
19406,1086,0,0,62,62,0,1,0,1,0
22701,2256,0,0,62,62,0,1,0,1,0
7707,697,0,0,146,146,0,1,0,1,0
15158,1888,0,0,62,62,0,1,0,1,0
16703,847,0,0,62,62,0,1,0,1,0
15052,847,0,0,62,62,0,1,0,1,0
3507,1804,0,0,62,62,0,1,0,1,0
10259,1054,0,0,66,66,0,1,0,1,0
10786,3216,0,0,66,66,0,1,0,1,0
11755,1827,0,0,66,66,0,1,0,1,0
17373,155,0,0,66,66,0,1,0,1,0
4257,7,0,0,60,60,0,1,0,1,0
10393,3216,0,0,66,66,0,1,0,1,0
16265,2587,0,0,66,66,0,1,0,1,0
1818,1147,0,0,62,62,0,1,0,1,0
462,1472,0,0,62,62,0,1,0,1,0
2799,1017,0,0,146,146,0,1,0,1,0
16192,3216,0,0,66,66,0,1,0,1,0
552,1888,0,0,66,66,0,1,0,1,0
1499,1147,0,0,62,62,0,1,0,1,0
16951,255,0,0,62,62,0,1,0,1,0
13236,1804,0,0,66,66,0,1,0,1,0
14294,1771,0,0,66,66,0,1,0,1,0
16951,255,0,0,62,62,0,1,0,1,0
8651,2919,0,0,62,62,0,1,0,1,0
18,1147,0,0,62,62,0,1,0,1,0
16951,255,0,0,62,62,0,1,0,1,0
11261,2601,0,0,62,62,0,1,0,1,0
2582,5,0,0,60,60,0,1,0,1,0
1281,2543,0,0,60,60,0,1,0,1,0
7339,152,0,0,60,60,0,1,0,1,0
4787,1483,0,0,145,145,0,1,0,1,0
90,376,0,0,148,148,0,1,0,1,0
7913,3216,0,0,145,145,0,1,0,1,0
360,3105,0,0,1012,1012,0,1,0,1,0
1777,2573,0,0,62,62,0,1,0,1,0
17099,1472,0,0,66,66,0,1,0,1,0
0,0,0,0,98,98,0,1,0,1,0
16951,255,0,0,62,62,0,1,0,1,0
19240,3117,0,0,62,62,0,1,0,1,0
5327,1888,0,0,62,62,0,1,0,1,0
4206,1771,0,0,146,146,0,1,0,1,0
16951,255,0,0,62,62,0,1,0,1,0
18,2256,0,0,146,146,0,1,0,1,0
9650,460,0,0,66,66,0,1,0,1,0
24,2256,0,0,62,62,0,1,0,1,0
612,225,0,0,60,60,0,1,0,1,0
7911,548,0,0,146,146,0,1,0,1,0
17318,1147,0,0,62,62,0,1,0,1,0
6439,1017,0,0,66,66,0,1,0,1,0
6233,1646,0,0,60,60,0,1,0,1,0
763,1888,0,0,62,62,0,1,0,1,0
6552,2093,0,0,145,145,0,1,0,1,0
3422,2154,0,0,62,62,0,1,0,1,0
17691,1888,0,0,62,62,0,1,0,1,0
2101,3216,0,0,66,66,0,1,0,1,0
14874,1147,0,0,66,66,0,1,0,1,0
10786,3216,0,0,62,62,0,1,0,1,0
1473,1017,0,0,66,66,0,1,0,1,0
19449,3216,0,0,66,66,0,1,0,1,0
2832,1017,0,0,62,62,0,1,0,1,0
2803,1872,0,0,62,62,0,1,0,1,0
1804,192,0,0,60,60,0,1,0,1,0
2005,2587,0,0,62,62,0,1,0,1,0
1141,7,0,0,60,60,0,1,0,1,0
2316,1147,0,0,62,62,0,1,0,1,0
614,983,0,0,62,62,0,1,0,1,0
1281,2543,0,0,60,60,0,1,0,1,0
2985,1147,0,0,62,62,0,1,0,1,0
360,3105,0,0,164,164,0,1,0,1,0
5085,983,0,0,62,62,0,1,0,1,0
36,1804,0,0,62,62,0,1,0,1,0
360,3105,0,0,68,68,0,1,0,1,0
12320,2256,0,0,66,66,0,1,0,1,0
7326,180,0,0,60,60,0,1,0,1,0
8065,1147,0,0,66,66,0,1,0,1,0
16951,255,0,0,62,62,0,1,0,1,0
345,1763,0,0,66,66,0,1,0,1,0
1900,2938,0,0,62,62,0,1,0,1,0
16951,255,0,0,62,62,0,1,0,1,0
22030,3139,0,0,66,66,0,1,0,1,0
1127,509,0,0,62,62,0,1,0,1,0
4544,2256,0,0,62,62,0,1,0,1,0
12979,2587,0,0,66,66,0,1,0,1,0
20524,2938,0,0,74,74,0,1,0,1,0
754,155,0,0,66,66,0,1,0,1,0
2051,2587,0,0,66,66,0,1,0,1,0
7326,180,0,0,60,60,0,1,0,1,0
1279,509,0,0,62,62,0,1,0,1,0
6097,346,0,0,60,60,0,1,0,1,0
299,1888,0,0,62,62,0,1,0,1,0
8276,1017,0,0,62,62,0,1,0,1,0
15011,1763,0,0,66,66,0,1,0,1,0
4100,1017,0,0,62,62,0,1,0,1,0
1675,3216,0,0,66,66,0,1,0,1,0
3069,2604,0,0,146,146,0,1,0,1,0
1525,1444,0,0,145,145,0,1,0,1,0
13666,3216,0,0,66,66,0,1,0,1,0
2099,2256,0,0,62,62,0,1,0,1,0
9768,1215,0,0,66,66,0,1,0,1,0
1361,2636,0,0,66,66,0,1,0,1,0
17670,3212,0,0,66,66,0,1,0,1,0
4944,1880,0,0,62,62,0,1,0,1,0
2281,1086,0,0,62,62,0,1,0,1,0
11257,3216,0,0,62,62,0,1,0,1,0
18275,10,0,0,88,88,0,1,0,1,0
17409,1147,0,0,62,62,0,1,0,1,0
630,2636,0,0,66,66,0,1,0,1,0
14505,2312,0,0,78,78,0,1,0,1,0
12854,1147,0,0,62,62,0,1,0,1,0
360,3105,0,0,1097,1097,0,1,0,1,0
12,2346,0,0,199,199,0,1,0,1,0
3101,2382,0,0,62,62,0,1,0,1,0
14339,1215,0,0,66,66,0,1,0,1,0
16951,255,0,0,62,62,0,1,0,1,0
15196,2587,0,0,62,62,0,1,0,1,0
2348,3139,0,0,66,66,0,1,0,1,0
447,2883,0,0,62,62,0,1,0,1,0
1534,2256,0,0,66,66,0,1,0,1,0
12,1974,0,0,74,74,0,1,0,1,0
16941,1147,0,0,62,62,0,1,0,1,0
13852,1017,0,0,66,66,0,1,0,1,0
12268,2256,0,0,66,66,0,1,0,1,0
406,2587,0,0,62,62,0,1,0,1,0
12,641,0,0,158,158,0,1,0,1,0
3234,2587,0,0,146,146,0,1,0,1,0
210,1147,0,0,62,62,0,1,0,1,0
8335,2938,0,0,66,66,0,1,0,1,0
1130,1888,0,0,66,66,0,1,0,1,0
17803,2587,0,0,62,62,0,1,0,1,0
16920,2587,0,0,62,62,0,1,0,1,0
13547,1147,0,0,62,62,0,1,0,1,0
6797,465,0,0,145,145,0,1,0,1,0
5851,2856,0,0,157,157,0,1,0,1,0
158,1147,0,0,62,62,0,1,0,1,0
496,1607,0,0,66,66,0,1,0,1,0
12,1000,0,0,97,97,0,1,0,1,0
12195,3212,0,0,66,66,0,1,0,1,0
21425,3051,0,0,66,66,0,1,0,1,0
7941,145,0,0,145,145,0,1,0,1,0
151,1017,0,0,62,62,0,1,0,1,0
2071,1888,0,0,62,62,0,1,0,1,0
18466,1017,0,0,66,66,0,1,0,1,0
15997,2938,0,0,66,66,0,1,0,1,0
633,2471,0,0,148,148,0,1,0,1,0
22704,1017,0,0,66,66,0,1,0,1,0
20484,2938,0,0,145,145,0,1,0,1,0
9264,1482,0,0,62,62,0,1,0,1,0
1259,1482,0,0,146,146,0,1,0,1,0
11080,509,0,0,62,62,0,1,0,1,0
19898,3216,0,0,62,62,0,1,0,1,0
2009,2636,0,0,62,62,0,1,0,1,0
20340,1147,0,0,62,62,0,1,0,1,0
12874,2558,0,0,66,66,0,1,0,1,0
8920,1771,0,0,62,62,0,1,0,1,0
2424,2853,0,0,62,62,0,1,0,1,0
9426,1919,0,0,62,62,0,1,0,1,0
3077,2636,0,0,62,62,0,1,0,1,0
9945,2636,0,0,66,66,0,1,0,1,0
7339,170,0,0,60,60,0,1,0,1,0
6898,1880,0,0,62,62,0,1,0,1,0
16951,255,0,0,62,62,0,1,0,1,0
15154,1147,0,0,66,66,0,1,0,1,0
3240,7,0,0,60,60,0,1,0,1,0
6169,3051,0,0,66,66,0,1,0,1,0
7326,1649,0,0,60,60,0,1,0,1,0
17342,2587,0,0,66,66,0,1,0,1,0
19198,2883,0,0,66,66,0,1,0,1,0
2547,1017,0,0,62,62,0,1,0,1,0
9158,1215,0,0,66,66,0,1,0,1,0
615,18,0,0,90,90,0,1,0,1,0
21044,2587,0,0,66,66,0,1,0,1,0
2802,1888,0,0,66,66,0,1,0,1,0
8865,3216,0,0,66,66,0,1,0,1,0
12337,3139,0,0,62,62,0,1,0,1,0
10772,1482,0,0,66,66,0,1,0,1,0
21267,1017,0,0,66,66,0,1,0,1,0
2832,1017,0,0,62,62,0,1,0,1,0
1464,1147,0,0,62,62,0,1,0,1,0
12684,1017,0,0,62,62,0,1,0,1,0
11800,1880,0,0,66,66,0,1,0,1,0
21381,3216,0,0,66,66,0,1,0,1,0
16985,1827,0,0,74,74,0,1,0,1,0
2681,2938,0,0,66,66,0,1,0,1,0
3507,1804,0,0,62,62,0,1,0,1,0
19437,2256,0,0,66,66,0,1,0,1,0
19278,1147,0,0,62,62,0,1,0,1,0
3262,2587,0,0,146,146,0,1,0,1,0
12,1768,0,0,130,130,0,1,0,1,0
6447,255,0,0,60,60,0,1,0,1,0
5610,2573,0,0,62,62,0,1,0,1,0
10475,6,0,0,60,60,0,1,0,1,0
2214,1367,0,0,60,60,0,1,0,1,0
776,1397,0,0,62,62,0,1,0,1,0
7339,170,0,0,60,60,0,1,0,1,0
360,3105,0,0,68,68,0,1,0,1,0
3143,2938,0,0,74,74,0,1,0,1,0
16951,255,0,0,62,62,0,1,0,1,0
17843,3216,0,0,66,66,0,1,0,1,0
2960,2587,0,0,66,66,0,1,0,1,0
360,3105,0,0,1292,1292,0,1,0,1,0
6832,1215,0,0,62,62,0,1,0,1,0
2252,1147,0,0,62,62,0,1,0,1,0
22704,1017,0,0,62,62,0,1,0,1,0
495,2256,0,0,66,66,0,1,0,1,0
4454,2587,0,0,146,146,0,1,0,1,0
11026,1771,0,0,66,66,0,1,0,1,0
3413,2934,0,0,145,145,0,1,0,1,0
1577,829,0,0,62,62,0,1,0,1,0
2820,1147,0,0,146,146,0,1,0,1,0
18865,1147,0,0,66,66,0,1,0,1,0
14978,1215,0,0,62,62,0,1,0,1,0
2502,2587,0,0,146,146,0,1,0,1,0
7339,237,0,0,60,60,0,1,0,1,0
6577,2636,0,0,146,146,0,1,0,1,0
1800,1771,0,0,62,62,0,1,0,1,0
1442,2953,0,0,66,66,0,1,0,1,0
3046,2587,0,0,62,62,0,1,0,1,0
2041,2256,0,0,62,62,0,1,0,1,0
12799,1462,0,0,62,62,0,1,0,1,0
8,2935,0,0,1514,1514,0,1,0,1,0
10776,1147,0,0,62,62,0,1,0,1,0
17957,697,0,0,66,66,0,1,0,1,0
22321,2587,0,0,62,62,0,1,0,1,0
18808,2747,0,0,66,66,0,1,0,1,0
15328,2256,0,0,62,62,0,1,0,1,0
14244,2883,0,0,62,62,0,1,0,1,0
17997,1472,0,0,66,66,0,1,0,1,0
18936,1147,0,0,62,62,0,1,0,1,0
16527,983,0,0,66,66,0,1,0,1,0
5924,2604,0,0,62,62,0,1,0,1,0
63,2256,0,0,62,62,0,1,0,1,0
16951,255,0,0,62,62,0,1,0,1,0
497,653,0,0,220,220,0,1,0,1,0
1804,768,0,0,60,60,0,1,0,1,0
10259,1054,0,0,66,66,0,1,0,1,0
1351,2938,0,0,62,62,0,1,0,1,0
10532,1147,0,0,66,66,0,1,0,1,0
13126,2587,0,0,62,62,0,1,0,1,0
7633,1147,0,0,62,62,0,1,0,1,0
11650,1888,0,0,62,62,0,1,0,1,0
8370,2604,0,0,62,62,0,1,0,1,0
9583,3216,0,0,62,62,0,1,0,1,0
1461,983,0,0,66,66,0,1,0,1,0
1935,1147,0,0,62,62,0,1,0,1,0
464,1888,0,0,66,66,0,1,0,1,0
14697,2938,0,0,66,66,0,1,0,1,0
13074,185,0,0,60,60,0,1,0,1,0
21949,2883,0,0,62,62,0,1,0,1,0
18068,1888,0,0,66,66,0,1,0,1,0
9788,1771,0,0,66,66,0,1,0,1,0
16093,3216,0,0,66,66,0,1,0,1,0
250,2587,0,0,62,62,0,1,0,1,0
10261,427,0,0,66,66,0,1,0,1,0
5227,3,0,0,60,60,0,1,0,1,0
9768,1215,0,0,66,66,0,1,0,1,0
21653,1147,0,0,66,66,0,1,0,1,0
1244,1167,0,0,66,66,0,1,0,1,0
13012,1804,0,0,62,62,0,1,0,1,0
5454,1888,0,0,66,66,0,1,0,1,0
4956,2636,0,0,66,66,0,1,0,1,0
7084,2938,0,0,62,62,0,1,0,1,0
7691,146,0,0,60,60,0,1,0,1,0
8221,2587,0,0,146,146,0,1,0,1,0
1804,1195,0,0,60,60,0,1,0,1,0
17300,2611,0,0,66,66,0,1,0,1,0
16951,255,0,0,62,62,0,1,0,1,0
10346,201,0,0,100,100,0,1,0,1,0
6889,1888,0,0,62,62,0,1,0,1,0
21824,3216,0,0,66,66,0,1,0,1,0
146,2486,0,0,66,66,0,1,0,1,0
7119,1147,0,0,146,146,0,1,0,1,0
2946,3216,0,0,62,62,0,1,0,1,0
1494,2852,0,0,66,66,0,1,0,1,0
2289,437,0,0,62,62,0,1,0,1,0
351,797,0,0,66,66,0,1,0,1,0
13529,914,0,0,62,62,0,1,0,1,0
7213,357,0,0,62,62,0,1,0,1,0
6177,1804,0,0,62,62,0,1,0,1,0
1688,2256,0,0,66,66,0,1,0,1,0
3663,7,0,0,60,60,0,1,0,1,0
15997,2938,0,0,66,66,0,1,0,1,0
2685,3216,0,0,62,62,0,1,0,1,0
7888,1147,0,0,62,62,0,1,0,1,0
9271,2636,0,0,66,66,0,1,0,1,0
5471,797,0,0,66,66,0,1,0,1,0
18414,2636,0,0,66,66,0,1,0,1,0
15358,2205,0,0,66,66,0,1,0,1,0
2796,1017,0,0,66,66,0,1,0,1,0
11650,1888,0,0,62,62,0,1,0,1,0
1236,2256,0,0,66,66,0,1,0,1,0
21066,2611,0,0,62,62,0,1,0,1,0
5942,1472,0,0,62,62,0,1,0,1,0
12561,3139,0,0,62,62,0,1,0,1,0
2002,2587,0,0,146,146,0,1,0,1,0
6874,1472,0,0,66,66,0,1,0,1,0
1893,3212,0,0,146,146,0,1,0,1,0
2366,1147,0,0,62,62,0,1,0,1,0
10227,509,0,0,66,66,0,1,0,1,0
3070,1888,0,0,62,62,0,1,0,1,0
2467,2853,0,0,72,72,0,1,0,1,0
7507,2587,0,0,66,66,0,1,0,1,0
5167,2636,0,0,62,62,0,1,0,1,0
8,2758,0,0,60,60,0,1,0,1,0
3139,1771,0,0,62,62,0,1,0,1,0
2061,3216,0,0,62,62,0,1,0,1,0
9819,2883,0,0,66,66,0,1,0,1,0
20833,2824,0,0,66,66,0,1,0,1,0
1541,1771,0,0,66,66,0,1,0,1,0
16951,255,0,0,62,62,0,1,0,1,0
15678,1771,0,0,62,62,0,1,0,1,0
16951,255,0,0,62,62,0,1,0,1,0
18377,2938,0,0,74,74,0,1,0,1,0
2921,509,0,0,62,62,0,1,0,1,0
229,362,0,0,145,145,0,1,0,1,0
823,3088,0,0,60,60,0,1,0,1,0
19698,3212,0,0,66,66,0,1,0,1,0
9614,3105,0,0,86,86,0,1,0,1,0
13389,1804,0,0,62,62,0,1,0,1,0
16989,847,0,0,66,66,0,1,0,1,0
12,2553,0,0,82,82,0,1,0,1,0
2339,1771,0,0,62,62,0,1,0,1,0
9444,1888,0,0,66,66,0,1,0,1,0
554,2256,0,0,66,66,0,1,0,1,0
2699,2587,0,0,62,62,0,1,0,1,0
2244,7,0,0,60,60,0,1,0,1,0
12,443,0,0,669,669,0,1,0,1,0
16663,2587,0,0,62,62,0,1,0,1,0
14962,1147,0,0,62,62,0,1,0,1,0
15694,1787,0,0,145,145,0,1,0,1,0
41,697,0,0,62,62,0,1,0,1,0
11921,3125,0,0,159,159,0,1,0,1,0
3004,2256,0,0,66,66,0,1,0,1,0
1593,2486,0,0,66,66,0,1,0,1,0
11340,1215,0,0,62,62,0,1,0,1,0
27,2938,0,0,72,72,0,1,0,1,0
635,1530,0,0,107,107,0,1,0,1,0
1390,1880,0,0,62,62,0,1,0,1,0
19810,3216,0,0,66,66,0,1,0,1,0
5094,1888,0,0,145,145,0,1,0,1,0
3088,1804,0,0,146,146,0,1,0,1,0
21341,1086,0,0,62,62,0,1,0,1,0
18995,1888,0,0,145,145,0,1,0,1,0
1459,15,0,0,60,60,0,1,0,1,0
2132,1888,0,0,62,62,0,1,0,1,0
7064,2587,0,0,146,146,0,1,0,1,0
3579,1147,0,0,62,62,0,1,0,1,0
360,3105,0,0,1302,1302,0,1,0,1,0
11800,1880,0,0,62,62,0,1,0,1,0
1773,2604,0,0,62,62,0,1,0,1,0
16780,2883,0,0,62,62,0,1,0,1,0
11559,797,0,0,66,66,0,1,0,1,0
1535,2256,0,0,66,66,0,1,0,1,0
17668,2256,0,0,66,66,0,1,0,1,0
11587,1472,0,0,62,62,0,1,0,1,0
9540,3139,0,0,66,66,0,1,0,1,0
14699,983,0,0,66,66,0,1,0,1,0
21824,3216,0,0,66,66,0,1,0,1,0
14531,2205,0,0,66,66,0,1,0,1,0
3252,1888,0,0,62,62,0,1,0,1,0
12561,3139,0,0,62,62,0,1,0,1,0
1828,3216,0,0,145,145,0,1,0,1,0
2543,1795,0,0,62,62,0,1,0,1,0
7950,1147,0,0,146,146,0,1,0,1,0
8327,2938,0,0,146,146,0,1,0,1,0
7530,2953,0,0,66,66,0,1,0,1,0
3035,2587,0,0,62,62,0,1,0,1,0
440,2587,0,0,62,62,0,1,0,1,0
11880,1086,0,0,66,66,0,1,0,1,0
7607,2604,0,0,62,62,0,1,0,1,0
20834,2636,0,0,66,66,0,1,0,1,0
806,1797,0,0,66,66,0,1,0,1,0
464,1888,0,0,66,66,0,1,0,1,0
1804,1058,0,0,60,60,0,1,0,1,0
6496,1215,0,0,62,62,0,1,0,1,0
2014,1888,0,0,62,62,0,1,0,1,0
15540,1771,0,0,66,66,0,1,0,1,0
320,1804,0,0,62,62,0,1,0,1,0
16951,255,0,0,62,62,0,1,0,1,0
18702,344,0,0,145,145,0,1,0,1,0
22430,2587,0,0,66,66,0,1,0,1,0
8,2890,0,0,578,578,0,1,0,1,0
137,3268,0,0,62,62,0,1,0,1,0
1473,561,0,0,62,62,0,1,0,1,0
1453,1147,0,0,62,62,0,1,0,1,0
18447,3216,0,0,62,62,0,1,0,1,0
11308,2256,0,0,66,66,0,1,0,1,0
21476,1147,0,0,66,66,0,1,0,1,0
13291,1215,0,0,62,62,0,1,0,1,0
16951,255,0,0,62,62,0,1,0,1,0
12320,2256,0,0,66,66,0,1,0,1,0
19510,2938,0,0,74,74,0,1,0,1,0
1265,1215,0,0,62,62,0,1,0,1,0
16885,983,0,0,66,66,0,1,0,1,0
21267,1017,0,0,66,66,0,1,0,1,0
22095,2205,0,0,66,66,0,1,0,1,0
19175,1763,0,0,66,66,0,1,0,1,0
649,1771,0,0,62,62,0,1,0,1,0
18203,2601,0,0,66,66,0,1,0,1,0
574,2636,0,0,66,66,0,1,0,1,0
10401,2256,0,0,66,66,0,1,0,1,0
10264,3216,0,0,66,66,0,1,0,1,0
8592,2938,0,0,66,66,0,1,0,1,0
16834,509,0,0,66,66,0,1,0,1,0
18,2070,0,0,157,157,0,1,0,1,0
9214,3256,0,0,60,60,0,1,0,1,0
18614,1054,0,0,62,62,0,1,0,1,0
4593,2256,0,0,66,66,0,1,0,1,0
7327,2256,0,0,146,146,0,1,0,1,0
1944,1880,0,0,62,62,0,1,0,1,0
22468,201,0,0,78,78,0,1,0,1,0
9928,2486,0,0,66,66,0,1,0,1,0
1669,1147,0,0,62,62,0,1,0,1,0
1687,2636,0,0,62,62,0,1,0,1,0
1804,1025,0,0,60,60,0,1,0,1,0
3254,1147,0,0,62,62,0,1,0,1,0
18271,1771,0,0,66,66,0,1,0,1,0
2591,2611,0,0,72,72,0,1,0,1,0
377,509,0,0,66,66,0,1,0,1,0
13074,185,0,0,60,60,0,1,0,1,0
1756,2587,0,0,62,62,0,1,0,1,0
16951,255,0,0,62,62,0,1,0,1,0
7949,315,0,0,60,60,0,1,0,1,0
7523,1147,0,0,62,62,0,1,0,1,0
1666,1804,0,0,66,66,0,1,0,1,0
16951,255,0,0,62,62,0,1,0,1,0
7569,3216,0,0,62,62,0,1,0,1,0
368,3216,0,0,62,62,0,1,0,1,0
4290,2636,0,0,66,66,0,1,0,1,0
4099,2477,0,0,62,62,0,1,0,1,0
7004,2636,0,0,62,62,0,1,0,1,0
12045,1797,0,0,66,66,0,1,0,1,0
9519,2587,0,0,62,62,0,1,0,1,0
9429,2509,0,0,66,66,0,1,0,1,0
2394,1017,0,0,62,62,0,1,0,1,0
6727,2256,0,0,62,62,0,1,0,1,0
15288,1147,0,0,62,62,0,1,0,1,0
9253,1472,0,0,66,66,0,1,0,1,0
2311,2611,0,0,62,62,0,1,0,1,0
16951,255,0,0,62,62,0,1,0,1,0
1973,2883,0,0,66,66,0,1,0,1,0
10974,2883,0,0,62,62,0,1,0,1,0
311,3216,0,0,62,62,0,1,0,1,0
10475,6,0,0,60,60,0,1,0,1,0
15607,2256,0,0,66,66,0,1,0,1,0
16112,2611,0,0,66,66,0,1,0,1,0
12,1932,0,0,82,82,0,1,0,1,0
18415,2587,0,0,62,62,0,1,0,1,0
15694,1515,0,0,145,145,0,1,0,1,0
6723,2587,0,0,62,62,0,1,0,1,0
10246,3117,0,0,66,66,0,1,0,1,0
6451,2938,0,0,62,62,0,1,0,1,0
11614,2023,0,0,148,148,0,1,0,1,0
10401,1888,0,0,62,62,0,1,0,1,0
2176,2256,0,0,62,62,0,1,0,1,0
13074,175,0,0,60,60,0,1,0,1,0
1361,2636,0,0,62,62,0,1,0,1,0
2309,427,0,0,62,62,0,1,0,1,0
20231,1771,0,0,62,62,0,1,0,1,0
16951,255,0,0,62,62,0,1,0,1,0
8651,2919,0,0,66,66,0,1,0,1,0
16951,255,0,0,62,62,0,1,0,1,0
636,280,0,0,62,62,0,1,0,1,0
12,3140,0,0,199,199,0,1,0,1,0
22046,1827,0,0,66,66,0,1,0,1,0
2851,2695,0,0,74,74,0,1,0,1,0
19051,2938,0,0,62,62,0,1,0,1,0
20329,1880,0,0,66,66,0,1,0,1,0
16192,3216,0,0,62,62,0,1,0,1,0
2597,1771,0,0,62,62,0,1,0,1,0
2219,2636,0,0,62,62,0,1,0,1,0
1779,2295,0,0,148,148,0,1,0,1,0
121,2256,0,0,62,62,0,1,0,1,0
6308,2883,0,0,146,146,0,1,0,1,0
17051,2611,0,0,62,62,0,1,0,1,0
20037,1888,0,0,62,62,0,1,0,1,0
2628,3216,0,0,66,66,0,1,0,1,0
12,2568,0,0,331,331,0,1,0,1,0
103,562,0,0,66,66,0,1,0,1,0
16951,255,0,0,62,62,0,1,0,1,0
21084,1771,0,0,66,66,0,1,0,1,0
555,2205,0,0,62,62,0,1,0,1,0
2191,2256,0,0,66,66,0,1,0,1,0
6650,2938,0,0,145,145,0,1,0,1,0
2253,1017,0,0,62,62,0,1,0,1,0
1423,1888,0,0,62,62,0,1,0,1,0
9238,7,0,0,60,60,0,1,0,1,0
2121,3216,0,0,66,66,0,1,0,1,0
475,137,0,0,66,66,0,1,0,1,0
6459,1215,0,0,62,62,0,1,0,1,0
4254,3139,0,0,146,146,0,1,0,1,0
10387,3216,0,0,66,66,0,1,0,1,0
398,2636,0,0,66,66,0,1,0,1,0
20933,1017,0,0,66,66,0,1,0,1,0
2921,509,0,0,66,66,0,1,0,1,0
3114,2883,0,0,66,66,0,1,0,1,0
2611,2883,0,0,66,66,0,1,0,1,0
14807,2205,0,0,66,66,0,1,0,1,0
22200,2573,0,0,66,66,0,1,0,1,0
18214,2836,0,0,62,62,0,1,0,1,0
8680,2675,0,0,162,162,0,1,0,1,0
11023,1147,0,0,62,62,0,1,0,1,0
5908,2587,0,0,62,62,0,1,0,1,0
3091,2938,0,0,62,62,0,1,0,1,0
2440,2587,0,0,62,62,0,1,0,1,0
9945,2636,0,0,66,66,0,1,0,1,0
16951,255,0,0,62,62,0,1,0,1,0
2492,1472,0,0,62,62,0,1,0,1,0
19,2587,0,0,62,62,0,1,0,1,0
2367,2953,0,0,62,62,0,1,0,1,0
2538,2938,0,0,62,62,0,1,0,1,0
8,1873,0,0,60,60,0,1,0,1,0
3072,1888,0,0,66,66,0,1,0,1,0
3099,1147,0,0,66,66,0,1,0,1,0
3682,7,0,0,60,60,0,1,0,1,0
0,0,0,0,185,185,0,1,0,1,0
3095,3216,0,0,62,62,0,1,0,1,0
1738,2573,0,0,62,62,0,1,0,1,0
16951,255,0,0,62,62,0,1,0,1,0
1117,1476,0,0,100,100,0,1,0,1,0
16777,1017,0,0,66,66,0,1,0,1,0
7003,2975,0,0,62,62,0,1,0,1,0
3094,3216,0,0,62,62,0,1,0,1,0
11923,1147,0,0,66,66,0,1,0,1,0
1423,1888,0,0,62,62,0,1,0,1,0
7335,1070,0,0,60,60,0,1,0,1,0
20829,1888,0,0,62,62,0,1,0,1,0
16765,2587,0,0,62,62,0,1,0,1,0
1247,233,0,0,148,148,0,1,0,1,0
6919,2587,0,0,146,146,0,1,0,1,0
20293,3139,0,0,66,66,0,1,0,1,0
21352,1147,0,0,66,66,0,1,0,1,0
11663,2883,0,0,66,66,0,1,0,1,0
1368,1888,0,0,145,145,0,1,0,1,0
6308,2883,0,0,62,62,0,1,0,1,0
20602,1147,0,0,62,62,0,1,0,1,0
14530,1147,0,0,62,62,0,1,0,1,0
2580,2853,0,0,62,62,0,1,0,1,0
1226,1147,0,0,66,66,0,1,0,1,0
18802,2636,0,0,62,62,0,1,0,1,0
15694,1515,0,0,145,145,0,1,0,1,0
15401,1017,0,0,66,66,0,1,0,1,0
533,1888,0,0,66,66,0,1,0,1,0
615,250,0,0,60,60,0,1,0,1,0
20777,1147,0,0,66,66,0,1,0,1,0
373,1147,0,0,62,62,0,1,0,1,0
162,2938,0,0,146,146,0,1,0,1,0
16951,255,0,0,62,62,0,1,0,1,0
16448,1017,0,0,66,66,0,1,0,1,0
412,1147,0,0,62,62,0,1,0,1,0
14332,3212,0,0,66,66,0,1,0,1,0
3131,2587,0,0,146,146,0,1,0,1,0
2308,3216,0,0,66,66,0,1,0,1,0
6,13,0,0,346,346,0,1,0,1,0
1282,1147,0,0,62,62,0,1,0,1,0
1693,2938,0,0,72,72,0,1,0,1,0
14123,2938,0,0,145,145,0,1,0,1,0
803,1888,0,0,62,62,0,1,0,1,0
321,3216,0,0,62,62,0,1,0,1,0
7624,2938,0,0,62,62,0,1,0,1,0
1804,3211,0,0,60,60,0,1,0,1,0
11026,2938,0,0,66,66,0,1,0,1,0
1494,2852,0,0,66,66,0,1,0,1,0
1989,1771,0,0,62,62,0,1,0,1,0
10859,1800,0,0,66,66,0,1,0,1,0
11023,1147,0,0,66,66,0,1,0,1,0
250,2587,0,0,66,66,0,1,0,1,0
784,2636,0,0,62,62,0,1,0,1,0
2449,1037,0,0,60,60,0,1,0,1,0
4498,2495,0,0,159,159,0,1,0,1,0
1591,1888,0,0,62,62,0,1,0,1,0
12,2445,0,0,135,135,0,1,0,1,0
1760,3216,0,0,62,62,0,1,0,1,0
16144,1397,0,0,66,66,0,1,0,1,0
8817,1888,0,0,74,74,0,1,0,1,0
57,491,0,0,146,146,0,1,0,1,0
409,1827,0,0,62,62,0,1,0,1,0
20630,1804,0,0,66,66,0,1,0,1,0
8472,2938,0,0,66,66,0,1,0,1,0
1242,1017,0,0,62,62,0,1,0,1,0
1428,2636,0,0,62,62,0,1,0,1,0
7550,2938,0,0,62,62,0,1,0,1,0
13208,1215,0,0,62,62,0,1,0,1,0
1707,1804,0,0,62,62,0,1,0,1,0
16951,255,0,0,62,62,0,1,0,1,0
15736,2938,0,0,66,66,0,1,0,1,0
20742,2611,0,0,62,62,0,1,0,1,0
11616,2611,0,0,66,66,0,1,0,1,0
190,2938,0,0,78,78,0,1,0,1,0
319,2256,0,0,62,62,0,1,0,1,0
21072,1771,0,0,66,66,0,1,0,1,0
16951,255,0,0,62,62,0,1,0,1,0
2097,1888,0,0,62,62,0,1,0,1,0
16368,2256,0,0,66,66,0,1,0,1,0
6454,2256,0,0,62,62,0,1,0,1,0
20565,2379,0,0,78,78,0,1,0,1,0
4420,1147,0,0,66,66,0,1,0,1,0
2543,1795,0,0,62,62,0,1,0,1,0
59,1147,0,0,62,62,0,1,0,1,0
11029,1888,0,0,62,62,0,1,0,1,0
1720,1827,0,0,66,66,0,1,0,1,0
1037,2883,0,0,66,66,0,1,0,1,0
13093,1771,0,0,62,62,0,1,0,1,0
17864,2743,0,0,66,66,0,1,0,1,0
19099,346,0,0,60,60,0,1,0,1,0
1989,1771,0,0,146,146,0,1,0,1,0
16765,2587,0,0,62,62,0,1,0,1,0
2765,3216,0,0,66,66,0,1,0,1,0
14874,1147,0,0,66,66,0,1,0,1,0
13238,1880,0,0,66,66,0,1,0,1,0
233,1147,0,0,66,66,0,1,0,1,0
6233,1646,0,0,60,60,0,1,0,1,0
11661,3216,0,0,62,62,0,1,0,1,0
2922,7,0,0,60,60,0,1,0,1,0
10214,3188,0,0,62,62,0,1,0,1,0
3143,2938,0,0,74,74,0,1,0,1,0
2633,1888,0,0,66,66,0,1,0,1,0
11518,1888,0,0,66,66,0,1,0,1,0
14248,1472,0,0,66,66,0,1,0,1,0
17618,2573,0,0,74,74,0,1,0,1,0
13193,983,0,0,62,62,0,1,0,1,0
8171,1073,0,0,60,60,0,1,0,1,0
14096,2587,0,0,66,66,0,1,0,1,0
1669,1147,0,0,146,146,0,1,0,1,0
6233,1646,0,0,60,60,0,1,0,1,0
13443,1888,0,0,66,66,0,1,0,1,0
14967,2587,0,0,66,66,0,1,0,1,0
7337,1017,0,0,62,62,0,1,0,1,0
1145,1215,0,0,62,62,0,1,0,1,0
16668,2256,0,0,66,66,0,1,0,1,0
2726,2938,0,0,62,62,0,1,0,1,0
9707,1888,0,0,66,66,0,1,0,1,0
21125,1147,0,0,66,66,0,1,0,1,0
12317,1147,0,0,146,146,0,1,0,1,0
1605,2604,0,0,146,146,0,1,0,1,0
12316,2938,0,0,62,62,0,1,0,1,0
1226,1147,0,0,66,66,0,1,0,1,0
1761,2486,0,0,140,140,0,1,0,1,0
2991,2104,0,0,159,159,0,1,0,1,0
21066,2611,0,0,62,62,0,1,0,1,0
20046,2604,0,0,146,146,0,1,0,1,0
1811,1147,0,0,66,66,0,1,0,1,0
16076,1472,0,0,66,66,0,1,0,1,0
2068,31,0,0,60,60,0,1,0,1,0
636,280,0,0,62,62,0,1,0,1,0
2522,515,0,0,145,145,0,1,0,1,0
323,1,0,0,66,66,0,1,0,1,0
16951,255,0,0,62,62,0,1,0,1,0
22090,1861,0,0,62,62,0,1,0,1,0
2281,1086,0,0,66,66,0,1,0,1,0
8,230,0,0,78,78,0,1,0,1,0
1924,1054,0,0,62,62,0,1,0,1,0
15694,344,0,0,145,145,0,1,0,1,0
7509,218,0,0,60,60,0,1,0,1,0
571,2824,0,0,74,74,0,1,0,1,0
15228,1017,0,0,66,66,0,1,0,1,0
2191,2256,0,0,66,66,0,1,0,1,0
10475,6,0,0,60,60,0,1,0,1,0
17333,2938,0,0,66,66,0,1,0,1,0
2631,1017,0,0,146,146,0,1,0,1,0
560,1017,0,0,62,62,0,1,0,1,0
10424,2362,0,0,145,145,0,1,0,1,0
5580,7,0,0,60,60,0,1,0,1,0
16877,1482,0,0,62,62,0,1,0,1,0
2603,983,0,0,66,66,0,1,0,1,0
12,443,0,0,152,152,0,1,0,1,0
14302,255,0,0,60,60,0,1,0,1,0
14722,1888,0,0,66,66,0,1,0,1,0
2677,1763,0,0,62,62,0,1,0,1,0
4770,697,0,0,62,62,0,1,0,1,0
3192,1147,0,0,146,146,0,1,0,1,0
13762,1936,0,0,66,66,0,1,0,1,0
14992,2611,0,0,66,66,0,1,0,1,0
2450,2938,0,0,62,62,0,1,0,1,0
2430,2938,0,0,62,62,0,1,0,1,0
1330,918,0,0,145,145,0,1,0,1,0
6960,1147,0,0,62,62,0,1,0,1,0
17323,2636,0,0,66,66,0,1,0,1,0
15072,2581,0,0,146,146,0,1,0,1,0
8164,2724,0,0,60,60,0,1,0,1,0
6233,1646,0,0,60,60,0,1,0,1,0
317,2587,0,0,62,62,0,1,0,1,0
15138,2256,0,0,66,66,0,1,0,1,0
12,417,0,0,74,74,0,1,0,1,0
16256,697,0,0,66,66,0,1,0,1,0
7335,1070,0,0,60,60,0,1,0,1,0
9191,983,0,0,62,62,0,1,0,1,0
3940,1017,0,0,66,66,0,1,0,1,0
2288,2256,0,0,62,62,0,1,0,1,0
16951,255,0,0,62,62,0,1,0,1,0
809,2883,0,0,66,66,0,1,0,1,0
15894,3216,0,0,66,66,0,1,0,1,0
5521,1215,0,0,62,62,0,1,0,1,0
7867,2636,0,0,62,62,0,1,0,1,0
360,3105,0,0,315,315,0,1,0,1,0
1445,2486,0,0,62,62,0,1,0,1,0
2512,1888,0,0,62,62,0,1,0,1,0
13208,1215,0,0,66,66,0,1,0,1,0
2151,3216,0,0,66,66,0,1,0,1,0
16951,255,0,0,62,62,0,1,0,1,0
15976,1017,0,0,62,62,0,1,0,1,0
8645,2883,0,0,62,62,0,1,0,1,0
16951,255,0,0,62,62,0,1,0,1,0
428,2852,0,0,66,66,0,1,0,1,0
3117,1507,0,0,159,159,0,1,0,1,0
8034,2836,0,0,66,66,0,1,0,1,0
16231,1888,0,0,62,62,0,1,0,1,0
1934,2587,0,0,66,66,0,1,0,1,0
3174,2611,0,0,62,62,0,1,0,1,0
18832,1888,0,0,66,66,0,1,0,1,0
21537,1086,0,0,62,62,0,1,0,1,0
21044,2587,0,0,62,62,0,1,0,1,0
2893,1804,0,0,66,66,0,1,0,1,0
14839,1804,0,0,66,66,0,1,0,1,0
1804,927,0,0,60,60,0,1,0,1,0
8213,1147,0,0,66,66,0,1,0,1,0
16444,2881,0,0,90,90,0,1,0,1,0
4239,6,0,0,60,60,0,1,0,1,0
9191,983,0,0,66,66,0,1,0,1,0
499,187,0,0,1093,1093,0,1,0,1,0
17677,2747,0,0,66,66,0,1,0,1,0
6948,1147,0,0,62,62,0,1,0,1,0
16951,255,0,0,62,62,0,1,0,1,0
13294,1167,0,0,66,66,0,1,0,1,0
20317,1771,0,0,66,66,0,1,0,1,0
16951,255,0,0,62,62,0,1,0,1,0
7335,1069,0,0,60,60,0,1,0,1,0
21192,2256,0,0,62,62,0,1,0,1,0
2706,2440,0,0,62,62,0,1,0,1,0
1249,1215,0,0,66,66,0,1,0,1,0
1597,2587,0,0,62,62,0,1,0,1,0
3903,1888,0,0,62,62,0,1,0,1,0
14479,3139,0,0,62,62,0,1,0,1,0
18342,1215,0,0,66,66,0,1,0,1,0
16951,255,0,0,62,62,0,1,0,1,0
16951,255,0,0,62,62,0,1,0,1,0
1900,2938,0,0,62,62,0,1,0,1,0
3940,1017,0,0,66,66,0,1,0,1,0
3543,2938,0,0,66,66,0,1,0,1,0
578,697,0,0,146,146,0,1,0,1,0
12599,2154,0,0,74,74,0,1,0,1,0
13154,1215,0,0,62,62,0,1,0,1,0
16951,255,0,0,62,62,0,1,0,1,0
10474,1179,0,0,72,72,0,1,0,1,0
20325,10,0,0,88,88,0,1,0,1,0
10555,797,0,0,66,66,0,1,0,1,0
9530,1017,0,0,62,62,0,1,0,1,0
11066,255,0,0,60,60,0,1,0,1,0
495,2256,0,0,62,62,0,1,0,1,0
93,1017,0,0,62,62,0,1,0,1,0
18376,1493,0,0,66,66,0,1,0,1,0
21498,2636,0,0,62,62,0,1,0,1,0
2955,391,0,0,60,60,0,1,0,1,0
2450,2938,0,0,62,62,0,1,0,1,0
17660,2073,0,0,66,66,0,1,0,1,0
5769,1147,0,0,62,62,0,1,0,1,0
2819,1147,0,0,62,62,0,1,0,1,0
11180,1940,0,0,66,66,0,1,0,1,0
14246,2883,0,0,66,66,0,1,0,1,0
10165,1147,0,0,66,66,0,1,0,1,0
9361,2604,0,0,66,66,0,1,0,1,0
4516,983,0,0,66,66,0,1,0,1,0
436,3216,0,0,66,66,0,1,0,1,0
2044,7,0,0,60,60,0,1,0,1,0
3447,7,0,0,60,60,0,1,0,1,0
64,1888,0,0,145,145,0,1,0,1,0
5327,1888,0,0,62,62,0,1,0,1,0
18377,2938,0,0,74,74,0,1,0,1,0
3180,1771,0,0,66,66,0,1,0,1,0
66,1147,0,0,62,62,0,1,0,1,0
1584,2154,0,0,66,66,0,1,0,1,0
8472,2938,0,0,66,66,0,1,0,1,0
1281,2543,0,0,60,60,0,1,0,1,0
8706,2587,0,0,66,66,0,1,0,1,0
5634,391,0,0,60,60,0,1,0,1,0
1705,1147,0,0,146,146,0,1,0,1,0
19103,1017,0,0,66,66,0,1,0,1,0
1257,7,0,0,60,60,0,1,0,1,0
12,2784,0,0,82,82,0,1,0,1,0
13012,1804,0,0,62,62,0,1,0,1,0
21243,2587,0,0,66,66,0,1,0,1,0
12614,2636,0,0,66,66,0,1,0,1,0
3988,697,0,0,74,74,0,1,0,1,0
18185,1017,0,0,62,62,0,1,0,1,0
11781,2587,0,0,66,66,0,1,0,1,0
2582,5,0,0,60,60,0,1,0,1,0
1272,1147,0,0,62,62,0,1,0,1,0
8581,1017,0,0,62,62,0,1,0,1,0
784,2636,0,0,66,66,0,1,0,1,0
360,3105,0,0,585,585,0,1,0,1,0
16951,255,0,0,62,62,0,1,0,1,0
2492,1472,0,0,62,62,0,1,0,1,0
277,1539,0,0,66,66,0,1,0,1,0
1920,1017,0,0,62,62,0,1,0,1,0
10010,2747,0,0,66,66,0,1,0,1,0
16951,255,0,0,62,62,0,1,0,1,0
13236,1804,0,0,66,66,0,1,0,1,0
6229,2938,0,0,78,78,0,1,0,1,0
11678,1106,0,0,66,66,0,1,0,1,0
2108,797,0,0,62,62,0,1,0,1,0
2495,1825,0,0,66,66,0,1,0,1,0
16033,1482,0,0,62,62,0,1,0,1,0
233,1147,0,0,62,62,0,1,0,1,0
16951,255,0,0,62,62,0,1,0,1,0
9637,697,0,0,146,146,0,1,0,1,0
1104,7,0,0,60,60,0,1,0,1,0
7431,983,0,0,62,62,0,1,0,1,0
2412,2093,0,0,145,145,0,1,0,1,0
10123,1795,0,0,60,60,0,1,0,1,0
5332,3216,0,0,62,62,0,1,0,1,0
15401,1017,0,0,62,62,0,1,0,1,0
19698,3212,0,0,62,62,0,1,0,1,0
263,1771,0,0,62,62,0,1,0,1,0
13465,2587,0,0,146,146,0,1,0,1,0
1511,1937,0,0,145,145,0,1,0,1,0
16951,255,0,0,62,62,0,1,0,1,0
2014,1888,0,0,62,62,0,1,0,1,0
15593,1804,0,0,66,66,0,1,0,1,0
16145,2144,0,0,62,62,0,1,0,1,0
5353,2550,0,0,146,146,0,1,0,1,0
16951,255,0,0,62,62,0,1,0,1,0
18671,2604,0,0,66,66,0,1,0,1,0
16554,491,0,0,148,148,0,1,0,1,0
5761,697,0,0,74,74,0,1,0,1,0
18,3216,0,0,62,62,0,1,0,1,0
5694,2486,0,0,143,143,0,1,0,1,0
11277,2636,0,0,146,146,0,1,0,1,0
17409,2636,0,0,66,66,0,1,0,1,0
7335,1072,0,0,60,60,0,1,0,1,0
12325,183,0,0,66,66,0,1,0,1,0
4454,2587,0,0,62,62,0,1,0,1,0
4200,1147,0,0,66,66,0,1,0,1,0
6072,2486,0,0,145,145,0,1,0,1,0
1887,2256,0,0,66,66,0,1,0,1,0
10620,805,0,0,66,66,0,1,0,1,0
2809,1472,0,0,66,66,0,1,0,1,0
22363,1888,0,0,74,74,0,1,0,1,0
7456,1771,0,0,66,66,0,1,0,1,0
13359,2256,0,0,70,70,0,1,0,1,0
7273,1,0,0,62,62,0,1,0,1,0
823,482,0,0,60,60,0,1,0,1,0
17339,509,0,0,62,62,0,1,0,1,0
18359,1472,0,0,66,66,0,1,0,1,0
11878,2938,0,0,74,74,0,1,0,1,0
2127,2938,0,0,62,62,0,1,0,1,0
10059,2256,0,0,146,146,0,1,0,1,0
252,280,0,0,66,66,0,1,0,1,0
7726,344,0,0,159,159,0,1,0,1,0
18185,1017,0,0,66,66,0,1,0,1,0
4544,2256,0,0,66,66,0,1,0,1,0
28,3216,0,0,62,62,0,1,0,1,0
3693,1888,0,0,62,62,0,1,0,1,0
3099,1147,0,0,62,62,0,1,0,1,0
8276,2495,0,0,161,161,0,1,0,1,0
9140,1017,0,0,62,62,0,1,0,1,0
14753,3139,0,0,62,62,0,1,0,1,0
4983,2636,0,0,146,146,0,1,0,1,0
19543,3216,0,0,62,62,0,1,0,1,0
2184,983,0,0,146,146,0,1,0,1,0
494,3197,0,0,145,145,0,1,0,1,0
16951,255,0,0,62,62,0,1,0,1,0
20,1472,0,0,62,62,0,1,0,1,0
1377,1147,0,0,62,62,0,1,0,1,0
9945,2636,0,0,66,66,0,1,0,1,0
7265,460,0,0,62,62,0,1,0,1,0
12146,1861,0,0,66,66,0,1,0,1,0
14013,2256,0,0,66,66,0,1,0,1,0
16951,255,0,0,62,62,0,1,0,1,0
360,3105,0,0,437,437,0,1,0,1,0
16678,2205,0,0,62,62,0,1,0,1,0
12955,2205,0,0,66,66,0,1,0,1,0
15657,2636,0,0,66,66,0,1,0,1,0
3238,697,0,0,66,66,0,1,0,1,0
1598,2205,0,0,62,62,0,1,0,1,0
12310,1880,0,0,62,62,0,1,0,1,0
16951,255,0,0,62,62,0,1,0,1,0
16951,255,0,0,62,62,0,1,0,1,0
2762,1147,0,0,66,66,0,1,0,1,0
1855,1,0,0,62,62,0,1,0,1,0
2150,104,0,0,60,60,0,1,0,1,0
11941,2604,0,0,66,66,0,1,0,1,0
15450,1472,0,0,66,66,0,1,0,1,0
9157,1888,0,0,66,66,0,1,0,1,0
21592,847,0,0,66,66,0,1,0,1,0
1771,1147,0,0,62,62,0,1,0,1,0
704,1147,0,0,62,62,0,1,0,1,0
13022,2938,0,0,66,66,0,1,0,1,0
3221,1017,0,0,66,66,0,1,0,1,0
582,1147,0,0,66,66,0,1,0,1,0
3167,2938,0,0,145,145,0,1,0,1,0
14892,1017,0,0,146,146,0,1,0,1,0
2612,1017,0,0,62,62,0,1,0,1,0
10010,2747,0,0,62,62,0,1,0,1,0
7339,152,0,0,60,60,0,1,0,1,0
1804,3191,0,0,60,60,0,1,0,1,0
2045,1147,0,0,62,62,0,1,0,1,0
15154,1147,0,0,62,62,0,1,0,1,0
14244,2883,0,0,66,66,0,1,0,1,0
16284,1880,0,0,66,66,0,1,0,1,0
6922,1589,0,0,62,62,0,1,0,1,0
2003,2938,0,0,62,62,0,1,0,1,0
5535,155,0,0,62,62,0,1,0,1,0
17422,1936,0,0,62,62,0,1,0,1,0
16287,3216,0,0,62,62,0,1,0,1,0
12,1420,0,0,82,82,0,1,0,1,0
1964,983,0,0,66,66,0,1,0,1,0
12,1174,0,0,131,131,0,1,0,1,0
13074,181,0,0,60,60,0,1,0,1,0
2729,1888,0,0,66,66,0,1,0,1,0
12,2784,0,0,82,82,0,1,0,1,0
11621,2747,0,0,62,62,0,1,0,1,0
20553,1888,0,0,66,66,0,1,0,1,0
5212,1888,0,0,62,62,0,1,0,1,0
1525,1444,0,0,145,145,0,1,0,1,0
21174,1147,0,0,66,66,0,1,0,1,0
388,797,0,0,62,62,0,1,0,1,0
18767,2144,0,0,62,62,0,1,0,1,0
18373,1888,0,0,66,66,0,1,0,1,0
9461,1888,0,0,66,66,0,1,0,1,0
19,3216,0,0,62,62,0,1,0,1,0
2084,1471,0,0,145,145,0,1,0,1,0
18151,1147,0,0,66,66,0,1,0,1,0
19603,3216,0,0,66,66,0,1,0,1,0
7004,2636,0,0,62,62,0,1,0,1,0
1900,2938,0,0,62,62,0,1,0,1,0
612,15,0,0,60,60,0,1,0,1,0
1898,2695,0,0,62,62,0,1,0,1,0
256,3216,0,0,62,62,0,1,0,1,0
18221,2883,0,0,62,62,0,1,0,1,0
2404,2256,0,0,66,66,0,1,0,1,0
20794,2573,0,0,66,66,0,1,0,1,0
639,3269,0,0,143,143,0,1,0,1,0
18019,3269,0,0,145,145,0,1,0,1,0
5990,1147,0,0,62,62,0,1,0,1,0
6192,1804,0,0,66,66,0,1,0,1,0
482,1888,0,0,66,66,0,1,0,1,0
220,2934,0,0,145,145,0,1,0,1,0
0,0,0,0,98,98,0,1,0,1,0
17717,2938,0,0,66,66,0,1,0,1,0
3822,1017,0,0,62,62,0,1,0,1,0
18023,2256,0,0,66,66,0,1,0,1,0
18271,1771,0,0,146,146,0,1,0,1,0
13576,3216,0,0,66,66,0,1,0,1,0
6904,2938,0,0,66,66,0,1,0,1,0
16368,2256,0,0,66,66,0,1,0,1,0
18858,2154,0,0,66,66,0,1,0,1,0
1330,918,0,0,62,62,0,1,0,1,0
1352,155,0,0,62,62,0,1,0,1,0
11914,2604,0,0,66,66,0,1,0,1,0
16726,233,0,0,148,148,0,1,0,1,0
22537,2382,0,0,66,66,0,1,0,1,0
13793,509,0,0,66,66,0,1,0,1,0
11536,697,0,0,74,74,0,1,0,1,0
21641,1147,0,0,66,66,0,1,0,1,0
3433,6,0,0,60,60,0,1,0,1,0
2186,7,0,0,60,60,0,1,0,1,0
2297,1147,0,0,66,66,0,1,0,1,0
16951,255,0,0,62,62,0,1,0,1,0
5048,1017,0,0,62,62,0,1,0,1,0
513,3216,0,0,145,145,0,1,0,1,0
2632,1936,0,0,62,62,0,1,0,1,0
19719,2486,0,0,145,145,0,1,0,1,0
17004,2587,0,0,66,66,0,1,0,1,0
17091,697,0,0,66,66,0,1,0,1,0
19820,2787,0,0,60,60,0,1,0,1,0
514,1589,0,0,66,66,0,1,0,1,0
15254,255,0,0,60,60,0,1,0,1,0
18964,956,0,0,66,66,0,1,0,1,0
7339,170,0,0,60,60,0,1,0,1,0
12,3146,0,0,199,199,0,1,0,1,0
2810,1017,0,0,62,62,0,1,0,1,0
7293,1771,0,0,62,62,0,1,0,1,0
8,442,0,0,60,60,0,1,0,1,0
12389,983,0,0,66,66,0,1,0,1,0
2986,139,0,0,60,60,0,1,0,1,0
9658,2697,0,0,146,146,0,1,0,1,0
11540,1472,0,0,66,66,0,1,0,1,0
9194,2256,0,0,70,70,0,1,0,1,0
18,2938,0,0,62,62,0,1,0,1,0
19892,2938,0,0,74,74,0,1,0,1,0
1524,2604,0,0,66,66,0,1,0,1,0
11489,2587,0,0,66,66,0,1,0,1,0
6165,8,0,0,74,74,0,1,0,1,0
1845,2883,0,0,66,66,0,1,0,1,0
16951,255,0,0,62,62,0,1,0,1,0
20411,1215,0,0,62,62,0,1,0,1,0
2199,2636,0,0,62,62,0,1,0,1,0
16951,255,0,0,62,62,0,1,0,1,0
5694,1158,0,0,146,146,0,1,0,1,0
13100,3216,0,0,66,66,0,1,0,1,0
12978,1147,0,0,62,62,0,1,0,1,0
15497,1215,0,0,62,62,0,1,0,1,0
19,1147,0,0,62,62,0,1,0,1,0
60,2382,0,0,62,62,0,1,0,1,0
9157,1888,0,0,66,66,0,1,0,1,0
21143,1147,0,0,62,62,0,1,0,1,0
2545,1017,0,0,62,62,0,1,0,1,0
8341,2587,0,0,146,146,0,1,0,1,0
6309,2938,0,0,60,60,0,1,0,1,0
2584,1677,0,0,160,160,0,1,0,1,0
15519,1,0,0,66,66,0,1,0,1,0
10458,2883,0,0,66,66,0,1,0,1,0
20727,2938,0,0,66,66,0,1,0,1,0
6310,1472,0,0,62,62,0,1,0,1,0
18859,1771,0,0,66,66,0,1,0,1,0
2467,2853,0,0,72,72,0,1,0,1,0
16951,255,0,0,62,62,0,1,0,1,0
17466,804,0,0,66,66,0,1,0,1,0
1980,2144,0,0,62,62,0,1,0,1,0
12243,1215,0,0,66,66,0,1,0,1,0
17,2515,0,0,129,129,0,1,0,1,0
3972,1147,0,0,62,62,0,1,0,1,0
2844,2938,0,0,62,62,0,1,0,1,0
6292,1017,0,0,62,62,0,1,0,1,0
6651,1129,0,0,156,156,0,1,0,1,0
8330,1017,0,0,62,62,0,1,0,1,0
18686,509,0,0,66,66,0,1,0,1,0
11003,2256,0,0,62,62,0,1,0,1,0
6506,936,0,0,62,62,0,1,0,1,0
10491,1147,0,0,146,146,0,1,0,1,0
9426,2938,0,0,78,78,0,1,0,1,0
14030,2235,0,0,66,66,0,1,0,1,0
12,3146,0,0,332,332,0,1,0,1,0
2263,2636,0,0,62,62,0,1,0,1,0
5738,3216,0,0,62,62,0,1,0,1,0
352,2953,0,0,66,66,0,1,0,1,0
12,3227,0,0,131,131,0,1,0,1,0
10295,1888,0,0,66,66,0,1,0,1,0
16951,255,0,0,62,62,0,1,0,1,0
497,653,0,0,220,220,0,1,0,1,0
360,3105,0,0,1162,1162,0,1,0,1,0
9093,1215,0,0,62,62,0,1,0,1,0
9273,6,0,0,60,60,0,1,0,1,0
9614,3105,0,0,86,86,0,1,0,1,0
5346,7,0,0,60,60,0,1,0,1,0
1982,3216,0,0,62,62,0,1,0,1,0
14612,3216,0,0,62,62,0,1,0,1,0
5294,1147,0,0,62,62,0,1,0,1,0
2972,2636,0,0,62,62,0,1,0,1,0
240,2205,0,0,62,62,0,1,0,1,0
17907,2256,0,0,62,62,0,1,0,1,0
1631,1888,0,0,62,62,0,1,0,1,0
2096,2486,0,0,146,146,0,1,0,1,0
19428,242,0,0,145,145,0,1,0,1,0
10013,2587,0,0,66,66,0,1,0,1,0
21854,2587,0,0,66,66,0,1,0,1,0
11545,1017,0,0,66,66,0,1,0,1,0
15099,1590,0,0,62,62,0,1,0,1,0
4115,939,0,0,62,62,0,1,0,1,0
12033,2587,0,0,66,66,0,1,0,1,0
2548,3133,0,0,60,60,0,1,0,1,0
20742,2611,0,0,62,62,0,1,0,1,0
2413,2093,0,0,146,146,0,1,0,1,0
12,2903,0,0,78,78,0,1,0,1,0
7607,2604,0,0,62,62,0,1,0,1,0
1719,7,0,0,60,60,0,1,0,1,0
18279,155,0,0,66,66,0,1,0,1,0
16444,2881,0,0,90,90,0,1,0,1,0
5521,1215,0,0,62,62,0,1,0,1,0
19122,146,0,0,60,60,0,1,0,1,0
7435,2154,0,0,72,72,0,1,0,1,0
10458,2883,0,0,62,62,0,1,0,1,0
1758,2256,0,0,66,66,0,1,0,1,0
18,3190,0,0,518,518,0,1,0,1,0
2680,510,0,0,66,66,0,1,0,1,0
3191,509,0,0,146,146,0,1,0,1,0
5381,1054,0,0,66,66,0,1,0,1,0
11875,2256,0,0,62,62,0,1,0,1,0
18401,1472,0,0,66,66,0,1,0,1,0
16527,983,0,0,62,62,0,1,0,1,0
2604,1888,0,0,66,66,0,1,0,1,0
22227,1888,0,0,66,66,0,1,0,1,0
5189,1017,0,0,66,66,0,1,0,1,0
7032,2938,0,0,74,74,0,1,0,1,0
13320,3216,0,0,66,66,0,1,0,1,0
14889,2943,0,0,146,146,0,1,0,1,0
16978,2205,0,0,62,62,0,1,0,1,0
13330,2636,0,0,66,66,0,1,0,1,0
21046,1147,0,0,62,62,0,1,0,1,0
19240,3117,0,0,66,66,0,1,0,1,0
1597,2587,0,0,66,66,0,1,0,1,0
1804,768,0,0,60,60,0,1,0,1,0
1804,1701,0,0,60,60,0,1,0,1,0
22610,1215,0,0,62,62,0,1,0,1,0
22457,1888,0,0,66,66,0,1,0,1,0
612,225,0,0,60,60,0,1,0,1,0
71,3216,0,0,62,62,0,1,0,1,0
3041,1147,0,0,62,62,0,1,0,1,0
3207,1888,0,0,62,62,0,1,0,1,0
6165,8,0,0,74,74,0,1,0,1,0
15672,3216,0,0,62,62,0,1,0,1,0
6810,3216,0,0,145,145,0,1,0,1,0
12516,1795,0,0,60,60,0,1,0,1,0
16951,255,0,0,62,62,0,1,0,1,0
12185,1880,0,0,66,66,0,1,0,1,0
16951,255,0,0,62,62,0,1,0,1,0
20504,1147,0,0,62,62,0,1,0,1,0
1468,1493,0,0,62,62,0,1,0,1,0
22217,1215,0,0,66,66,0,1,0,1,0
1804,2232,0,0,60,60,0,1,0,1,0
636,1677,0,0,157,157,0,1,0,1,0
21959,1771,0,0,66,66,0,1,0,1,0
16951,255,0,0,62,62,0,1,0,1,0
16951,255,0,0,62,62,0,1,0,1,0
1353,1888,0,0,62,62,0,1,0,1,0
271,3216,0,0,62,62,0,1,0,1,0
7589,2573,0,0,74,74,0,1,0,1,0
12,3140,0,0,199,199,0,1,0,1,0
3233,1472,0,0,62,62,0,1,0,1,0
15882,3051,0,0,62,62,0,1,0,1,0
1608,2477,0,0,60,60,0,1,0,1,0
360,3105,0,0,1004,1004,0,1,0,1,0
1254,1590,0,0,62,62,0,1,0,1,0
1067,2883,0,0,66,66,0,1,0,1,0
17099,1472,0,0,66,66,0,1,0,1,0
11680,697,0,0,66,66,0,1,0,1,0
11282,2362,0,0,62,62,0,1,0,1,0
7949,316,0,0,60,60,0,1,0,1,0
21043,3216,0,0,66,66,0,1,0,1,0
16703,847,0,0,66,66,0,1,0,1,0
7293,146,0,0,60,60,0,1,0,1,0
19906,1888,0,0,66,66,0,1,0,1,0
12045,1797,0,0,66,66,0,1,0,1,0
16957,2256,0,0,62,62,0,1,0,1,0
11240,2636,0,0,66,66,0,1,0,1,0
9146,1888,0,0,66,66,0,1,0,1,0
17413,1936,0,0,74,74,0,1,0,1,0
4173,1147,0,0,66,66,0,1,0,1,0
20785,1215,0,0,66,66,0,1,0,1,0
3441,2636,0,0,66,66,0,1,0,1,0
16659,1771,0,0,66,66,0,1,0,1,0
2302,1472,0,0,62,62,0,1,0,1,0
22223,155,0,0,62,62,0,1,0,1,0
16545,2256,0,0,62,62,0,1,0,1,0
19428,242,0,0,145,145,0,1,0,1,0
6551,7,0,0,60,60,0,1,0,1,0
16794,1472,0,0,66,66,0,1,0,1,0
12276,1367,0,0,60,60,0,1,0,1,0
2778,3216,0,0,66,66,0,1,0,1,0
33,1638,0,0,145,145,0,1,0,1,0
7076,1888,0,0,62,62,0,1,0,1,0
16951,255,0,0,62,62,0,1,0,1,0
16951,255,0,0,62,62,0,1,0,1,0
5067,1147,0,0,66,66,0,1,0,1,0
16951,255,0,0,62,62,0,1,0,1,0
18377,2938,0,0,74,74,0,1,0,1,0
1750,2883,0,0,66,66,0,1,0,1,0
18297,1017,0,0,66,66,0,1,0,1,0
1507,2669,0,0,145,145,0,1,0,1,0
2041,2256,0,0,66,66,0,1,0,1,0
22037,1888,0,0,62,62,0,1,0,1,0
12086,1147,0,0,62,62,0,1,0,1,0
18820,255,0,0,60,60,0,1,0,1,0
16951,255,0,0,62,62,0,1,0,1,0
18042,847,0,0,62,62,0,1,0,1,0
17822,2938,0,0,62,62,0,1,0,1,0
10646,1880,0,0,62,62,0,1,0,1,0
1892,1771,0,0,66,66,0,1,0,1,0
2803,1872,0,0,62,62,0,1,0,1,0
14479,3139,0,0,66,66,0,1,0,1,0
4040,1771,0,0,62,62,0,1,0,1,0
158,1147,0,0,62,62,0,1,0,1,0
11757,1888,0,0,66,66,0,1,0,1,0
12,1596,0,0,89,89,0,1,0,1,0
1509,1888,0,0,66,66,0,1,0,1,0
1178,1167,0,0,62,62,0,1,0,1,0
1465,509,0,0,66,66,0,1,0,1,0
9819,2883,0,0,66,66,0,1,0,1,0
6291,2602,0,0,148,148,0,1,0,1,0
6687,1017,0,0,66,66,0,1,0,1,0
9253,2587,0,0,66,66,0,1,0,1,0
7000,2370,0,0,74,74,0,1,0,1,0
18,2256,0,0,62,62,0,1,0,1,0
1525,1444,0,0,145,145,0,1,0,1,0
16951,255,0,0,62,62,0,1,0,1,0
1020,2938,0,0,62,62,0,1,0,1,0
360,3105,0,0,159,159,0,1,0,1,0
20364,3139,0,0,62,62,0,1,0,1,0
10960,2938,0,0,66,66,0,1,0,1,0
9693,2205,0,0,66,66,0,1,0,1,0
2924,7,0,0,60,60,0,1,0,1,0
3601,2573,0,0,62,62,0,1,0,1,0
16077,2256,0,0,62,62,0,1,0,1,0
0,0,0,0,98,98,0,1,0,1,0
12,1380,0,0,82,82,0,1,0,1,0
2897,1888,0,0,62,62,0,1,0,1,0
13630,697,0,0,62,62,0,1,0,1,0
20565,2379,0,0,78,78,0,1,0,1,0
74,3216,0,0,66,66,0,1,0,1,0
14865,2697,0,0,62,62,0,1,0,1,0
360,3105,0,0,877,877,0,1,0,1,0
3714,1017,0,0,62,62,0,1,0,1,0
1264,2256,0,0,62,62,0,1,0,1,0
9225,1472,0,0,66,66,0,1,0,1,0
8,2758,0,0,60,60,0,1,0,1,0
12086,1147,0,0,66,66,0,1,0,1,0
20,3216,0,0,62,62,0,1,0,1,0
15189,1147,0,0,66,66,0,1,0,1,0
18214,2836,0,0,66,66,0,1,0,1,0
2976,1888,0,0,62,62,0,1,0,1,0
11982,3027,0,0,66,66,0,1,0,1,0
14637,93,0,0,66,66,0,1,0,1,0
20332,1147,0,0,146,146,0,1,0,1,0
4738,146,0,0,60,60,0,1,0,1,0
17314,3212,0,0,66,66,0,1,0,1,0
1402,2938,0,0,62,62,0,1,0,1,0
20659,1771,0,0,62,62,0,1,0,1,0
3386,1888,0,0,62,62,0,1,0,1,0
251,155,0,0,66,66,0,1,0,1,0
9349,242,0,0,148,148,0,1,0,1,0
14667,1147,0,0,62,62,0,1,0,1,0
9764,2587,0,0,62,62,0,1,0,1,0
17380,1147,0,0,66,66,0,1,0,1,0
18898,2587,0,0,66,66,0,1,0,1,0
632,2154,0,0,62,62,0,1,0,1,0
4367,1147,0,0,66,66,0,1,0,1,0
11357,3216,0,0,66,66,0,1,0,1,0
14169,2938,0,0,66,66,0,1,0,1,0
344,2587,0,0,62,62,0,1,0,1,0
20289,2256,0,0,146,146,0,1,0,1,0
2853,2611,0,0,66,66,0,1,0,1,0
16951,255,0,0,62,62,0,1,0,1,0
11545,1017,0,0,66,66,0,1,0,1,0
29,1888,0,0,62,62,0,1,0,1,0
1177,2587,0,0,146,146,0,1,0,1,0
16951,255,0,0,62,62,0,1,0,1,0
17022,2636,0,0,66,66,0,1,0,1,0
2526,357,0,0,66,66,0,1,0,1,0
10859,1800,0,0,66,66,0,1,0,1,0
18609,2587,0,0,62,62,0,1,0,1,0
0,0,0,0,98,98,0,1,0,1,0
18406,1804,0,0,62,62,0,1,0,1,0
18047,1880,0,0,62,62,0,1,0,1,0
16951,255,0,0,62,62,0,1,0,1,0
1525,1444,0,0,145,145,0,1,0,1,0
13732,1147,0,0,66,66,0,1,0,1,0
17668,2256,0,0,66,66,0,1,0,1,0
2084,1471,0,0,145,145,0,1,0,1,0
7339,2845,0,0,60,60,0,1,0,1,0
16861,983,0,0,66,66,0,1,0,1,0
19094,2049,0,0,145,145,0,1,0,1,0
3268,1888,0,0,66,66,0,1,0,1,0
1258,2382,0,0,62,62,0,1,0,1,0
2180,7,0,0,60,60,0,1,0,1,0
16951,255,0,0,62,62,0,1,0,1,0
68,2938,0,0,62,62,0,1,0,1,0
22235,2953,0,0,62,62,0,1,0,1,0
12,3227,0,0,100,100,0,1,0,1,0
9253,2587,0,0,62,62,0,1,0,1,0
16328,2953,0,0,66,66,0,1,0,1,0
612,225,0,0,60,60,0,1,0,1,0
9146,1888,0,0,66,66,0,1,0,1,0
7985,318,0,0,60,60,0,1,0,1,0
0,0,0,0,164,164,0,2,0,2,0
5753,163,0,0,62,62,0,1,0,1,0
12388,2256,0,0,146,146,0,1,0,1,0
3473,7,0,0,60,60,0,1,0,1,0
636,1888,0,0,146,146,0,1,0,1,0
16951,255,0,0,62,62,0,1,0,1,0
8114,2550,0,0,62,62,0,1,0,1,0
2031,1147,0,0,146,146,0,1,0,1,0
17,2970,0,0,129,129,0,1,0,1,0
1938,1147,0,0,62,62,0,1,0,1,0
18547,1017,0,0,66,66,0,1,0,1,0
731,2256,0,0,66,66,0,1,0,1,0
20695,2938,0,0,66,66,0,1,0,1,0
21174,2938,0,0,62,62,0,1,0,1,0
612,21,0,0,60,60,0,1,0,1,0
5048,1017,0,0,146,146,0,1,0,1,0
1422,16,0,0,60,60,0,1,0,1,0
1802,804,0,0,62,62,0,1,0,1,0
2658,1147,0,0,66,66,0,1,0,1,0
1766,1827,0,0,62,62,0,1,0,1,0
1371,2883,0,0,66,66,0,1,0,1,0
1318,2636,0,0,62,62,0,1,0,1,0
1328,2205,0,0,66,66,0,1,0,1,0
21264,1147,0,0,62,62,0,1,0,1,0
17570,1771,0,0,62,62,0,1,0,1,0
1593,2486,0,0,62,62,0,1,0,1,0
5828,3051,0,0,146,146,0,1,0,1,0
8276,2023,0,0,161,161,0,1,0,1,0
22468,201,0,0,78,78,0,1,0,1,0
13411,1472,0,0,66,66,0,1,0,1,0
5189,1017,0,0,66,66,0,1,0,1,0
18832,1888,0,0,66,66,0,1,0,1,0
4816,1888,0,0,62,62,0,1,0,1,0
674,1147,0,0,66,66,0,1,0,1,0
16951,255,0,0,62,62,0,1,0,1,0
8,1873,0,0,60,60,0,1,0,1,0
3118,1888,0,0,62,62,0,1,0,1,0
17058,1017,0,0,66,66,0,1,0,1,0
13908,2256,0,0,62,62,0,1,0,1,0
7294,2587,0,0,146,146,0,1,0,1,0
12,2247,0,0,83,83,0,1,0,1,0
6042,2883,0,0,66,66,0,1,0,1,0
5165,1147,0,0,146,146,0,1,0,1,0
1744,2917,0,0,146,146,0,1,0,1,0
3976,1017,0,0,62,62,0,1,0,1,0
10335,2205,0,0,66,66,0,1,0,1,0
16951,255,0,0,62,62,0,1,0,1,0
12083,1215,0,0,66,66,0,1,0,1,0
0,0,0,0,74,74,0,1,0,1,0
2550,7,0,0,60,60,0,1,0,1,0
16951,255,0,0,62,62,0,1,0,1,0
15154,3216,0,0,66,66,0,1,0,1,0
2725,1017,0,0,62,62,0,1,0,1,0
13900,2587,0,0,66,66,0,1,0,1,0
12,2686,0,0,97,97,0,1,0,1,0
11847,3212,0,0,66,66,0,1,0,1,0
12,538,0,0,66,66,0,1,0,1,0
12,2199,0,0,97,97,0,1,0,1,0
360,3105,0,0,935,935,0,1,0,1,0
6651,1129,0,0,156,156,0,1,0,1,0
5381,1054,0,0,62,62,0,1,0,1,0
1357,2636,0,0,146,146,0,1,0,1,0
3002,1936,0,0,62,62,0,1,0,1,0
6919,2587,0,0,62,62,0,1,0,1,0
16477,1017,0,0,66,66,0,1,0,1,0
11681,1147,0,0,66,66,0,1,0,1,0
1540,2256,0,0,66,66,0,1,0,1,0
20468,2611,0,0,66,66,0,1,0,1,0
1664,280,0,0,66,66,0,1,0,1,0
18767,2144,0,0,66,66,0,1,0,1,0
17561,2636,0,0,66,66,0,1,0,1,0
7,12,0,0,594,594,0,1,0,1,0
391,3216,0,0,66,66,0,1,0,1,0
360,3105,0,0,240,240,0,1,0,1,0
2303,437,0,0,66,66,0,1,0,1,0
17903,1147,0,0,66,66,0,1,0,1,0
11142,1215,0,0,66,66,0,1,0,1,0
545,2256,0,0,66,66,0,1,0,1,0
4724,1804,0,0,66,66,0,1,0,1,0
10393,3216,0,0,66,66,0,1,0,1,0
9313,2938,0,0,146,146,0,1,0,1,0
5145,1883,0,0,146,146,0,1,0,1,0
16951,255,0,0,62,62,0,1,0,1,0
3570,1942,0,0,162,162,0,1,0,1,0
5327,1888,0,0,62,62,0,1,0,1,0
20059,2587,0,0,62,62,0,1,0,1,0
14257,2154,0,0,74,74,0,1,0,1,0
17158,697,0,0,66,66,0,1,0,1,0
13900,2587,0,0,66,66,0,1,0,1,0
16432,2154,0,0,66,66,0,1,0,1,0
353,797,0,0,62,62,0,1,0,1,0
1728,3216,0,0,66,66,0,1,0,1,0
1142,1215,0,0,62,62,0,1,0,1,0
19,1773,0,0,62,62,0,1,0,1,0
8856,2573,0,0,66,66,0,1,0,1,0
3278,435,0,0,60,60,0,1,0,1,0
8171,1073,0,0,60,60,0,1,0,1,0
15438,255,0,0,60,60,0,1,0,1,0
16951,255,0,0,62,62,0,1,0,1,0
7335,1072,0,0,60,60,0,1,0,1,0
2862,1147,0,0,66,66,0,1,0,1,0
10419,2611,0,0,70,70,0,1,0,1,0
21236,1903,0,0,62,62,0,1,0,1,0
445,213,0,0,862,862,0,1,0,1,0
5968,1215,0,0,62,62,0,1,0,1,0
8010,323,0,0,60,60,0,1,0,1,0
16951,255,0,0,62,62,0,1,0,1,0
15657,2636,0,0,66,66,0,1,0,1,0
7335,1072,0,0,60,60,0,1,0,1,0
693,2256,0,0,66,66,0,1,0,1,0
21,2256,0,0,62,62,0,1,0,1,0
639,344,0,0,143,143,0,1,0,1,0
19181,2154,0,0,66,66,0,1,0,1,0
2580,2853,0,0,60,60,0,1,0,1,0
15345,1215,0,0,66,66,0,1,0,1,0
1976,509,0,0,66,66,0,1,0,1,0
438,2636,0,0,62,62,0,1,0,1,0
10474,1,0,0,72,72,0,1,0,1,0
20989,3212,0,0,66,66,0,1,0,1,0
12,2359,0,0,66,66,0,1,0,1,0
1373,1147,0,0,62,62,0,1,0,1,0
601,3216,0,0,66,66,0,1,0,1,0
16834,509,0,0,66,66,0,1,0,1,0
2141,1888,0,0,62,62,0,1,0,1,0
16171,1367,0,0,60,60,0,1,0,1,0
9226,3216,0,0,66,66,0,1,0,1,0
12,1023,0,0,112,112,0,1,0,1,0
17579,2587,0,0,66,66,0,1,0,1,0
15736,2938,0,0,66,66,0,1,0,1,0
671,7,0,0,60,60,0,1,0,1,0
334,3216,0,0,66,66,0,1,0,1,0
1298,1147,0,0,62,62,0,1,0,1,0
12,2784,0,0,82,82,0,1,0,1,0
20745,1880,0,0,66,66,0,1,0,1,0
16830,2943,0,0,66,66,0,1,0,1,0
14155,2360,0,0,66,66,0,1,0,1,0
2056,1936,0,0,62,62,0,1,0,1,0
9273,6,0,0,60,60,0,1,0,1,0
20846,2486,0,0,66,66,0,1,0,1,0
18615,2611,0,0,62,62,0,1,0,1,0
1158,460,0,0,62,62,0,1,0,1,0
16951,255,0,0,62,62,0,1,0,1,0
10860,2144,0,0,66,66,0,1,0,1,0
2084,1471,0,0,145,145,0,1,0,1,0
443,1771,0,0,66,66,0,1,0,1,0
2549,1771,0,0,146,146,0,1,0,1,0
4356,1472,0,0,66,66,0,1,0,1,0
2807,2256,0,0,62,62,0,1,0,1,0
1980,2144,0,0,62,62,0,1,0,1,0
8071,1763,0,0,146,146,0,1,0,1,0
16261,1888,0,0,62,62,0,1,0,1,0
2176,2256,0,0,62,62,0,1,0,1,0
17735,2938,0,0,66,66,0,1,0,1,0
17997,1472,0,0,62,62,0,1,0,1,0
10758,2256,0,0,62,62,0,1,0,1,0
11337,1017,0,0,62,62,0,1,0,1,0
15694,1515,0,0,145,145,0,1,0,1,0
2985,1147,0,0,62,62,0,1,0,1,0
470,2587,0,0,66,66,0,1,0,1,0
3181,899,0,0,62,62,0,1,0,1,0
19057,1888,0,0,62,62,0,1,0,1,0
22223,1589,0,0,62,62,0,1,0,1,0
20755,1147,0,0,62,62,0,1,0,1,0
6513,1771,0,0,62,62,0,1,0,1,0
320,1804,0,0,62,62,0,1,0,1,0
9383,1147,0,0,62,62,0,1,0,1,0
4318,7,0,0,60,60,0,1,0,1,0
6117,1147,0,0,62,62,0,1,0,1,0
16951,255,0,0,62,62,0,1,0,1,0
14076,1888,0,0,66,66,0,1,0,1,0
11640,1147,0,0,66,66,0,1,0,1,0
1142,1215,0,0,62,62,0,1,0,1,0
10013,2587,0,0,66,66,0,1,0,1,0
2751,1147,0,0,62,62,0,1,0,1,0
13474,2587,0,0,62,62,0,1,0,1,0
1354,2611,0,0,66,66,0,1,0,1,0
7981,2938,0,0,62,62,0,1,0,1,0
19258,3216,0,0,62,62,0,1,0,1,0
1456,7,0,0,60,60,0,1,0,1,0
16951,255,0,0,62,62,0,1,0,1,0
16951,255,0,0,62,62,0,1,0,1,0
22093,3216,0,0,62,62,0,1,0,1,0
1512,2938,0,0,62,62,0,1,0,1,0
16951,255,0,0,62,62,0,1,0,1,0
395,2695,0,0,62,62,0,1,0,1,0
1473,1017,0,0,66,66,0,1,0,1,0
1701,2587,0,0,62,62,0,1,0,1,0
20785,1215,0,0,66,66,0,1,0,1,0
11540,1472,0,0,66,66,0,1,0,1,0
275,9,0,0,60,60,0,1,0,1,0
3109,2611,0,0,72,72,0,1,0,1,0
10475,6,0,0,60,60,0,1,0,1,0
863,1224,0,0,60,60,0,1,0,1,0
257,7,0,0,60,60,0,1,0,1,0
6689,1472,0,0,62,62,0,1,0,1,0
10396,3216,0,0,66,66,0,1,0,1,0
2632,1936,0,0,62,62,0,1,0,1,0
810,1017,0,0,62,62,0,1,0,1,0
8,2758,0,0,60,60,0,1,0,1,0
3968,2938,0,0,74,74,0,1,0,1,0
615,18,0,0,90,90,0,1,0,1,0
18626,1215,0,0,62,62,0,1,0,1,0
9714,2938,0,0,66,66,0,1,0,1,0
1804,1762,0,0,60,60,0,1,0,1,0
2671,1147,0,0,62,62,0,1,0,1,0
4117,1472,0,0,62,62,0,1,0,1,0
17314,3212,0,0,66,66,0,1,0,1,0
1501,1147,0,0,146,146,0,1,0,1,0
5249,1017,0,0,62,62,0,1,0,1,0
12874,2558,0,0,66,66,0,1,0,1,0
4563,2205,0,0,62,62,0,1,0,1,0
13908,2256,0,0,62,62,0,1,0,1,0
10506,804,0,0,100,100,0,1,0,1,0
3194,1688,0,0,66,66,0,1,0,1,0
3063,1787,0,0,159,159,0,1,0,1,0
17799,1888,0,0,66,66,0,1,0,1,0
12,2453,0,0,97,97,0,1,0,1,0
13070,1872,0,0,66,66,0,1,0,1,0
6651,1219,0,0,156,156,0,1,0,1,0
11450,186,0,0,60,60,0,1,0,1,0
19174,1017,0,0,66,66,0,1,0,1,0
16630,2636,0,0,66,66,0,1,0,1,0
2023,2104,0,0,159,159,0,1,0,1,0
11485,2438,0,0,143,143,0,1,0,1,0
4091,1017,0,0,66,66,0,1,0,1,0
20059,2587,0,0,66,66,0,1,0,1,0
19269,3216,0,0,66,66,0,1,0,1,0
4961,2256,0,0,66,66,0,1,0,1,0
16951,255,0,0,62,62,0,1,0,1,0
1525,1444,0,0,145,145,0,1,0,1,0
2576,1147,0,0,66,66,0,1,0,1,0
11916,3216,0,0,62,62,0,1,0,1,0
111,3139,0,0,62,62,0,1,0,1,0
1402,2938,0,0,62,62,0,1,0,1,0
3314,3216,0,0,145,145,0,1,0,1,0
16257,1147,0,0,146,146,0,1,0,1,0
14845,3139,0,0,66,66,0,1,0,1,0
2791,983,0,0,62,62,0,1,0,1,0
1752,3216,0,0,66,66,0,1,0,1,0
16033,1482,0,0,66,66,0,1,0,1,0
4868,2587,0,0,146,146,0,1,0,1,0
10346,2581,0,0,100,100,0,1,0,1,0
2478,1968,0,0,60,60,0,1,0,1,0
20364,3139,0,0,66,66,0,1,0,1,0
19437,2256,0,0,62,62,0,1,0,1,0
22208,2611,0,0,66,66,0,1,0,1,0
1383,3216,0,0,146,146,0,1,0,1,0
1804,1765,0,0,60,60,0,1,0,1,0
16533,2938,0,0,66,66,0,1,0,1,0
8117,2587,0,0,62,62,0,1,0,1,0
1505,1804,0,0,66,66,0,1,0,1,0
14228,6,0,0,60,60,0,1,0,1,0
1330,918,0,0,62,62,0,1,0,1,0
22579,2853,0,0,66,66,0,1,0,1,0
3415,2587,0,0,146,146,0,1,0,1,0
21979,1539,0,0,62,62,0,1,0,1,0
0,0,0,0,102,102,0,1,0,1,0
2892,1804,0,0,62,62,0,1,0,1,0
609,1147,0,0,62,62,0,1,0,1,0
12,312,0,0,60,60,0,1,0,1,0
1117,2943,0,0,100,100,0,1,0,1,0
1445,2486,0,0,62,62,0,1,0,1,0
17268,2953,0,0,66,66,0,1,0,1,0
29,1888,0,0,62,62,0,1,0,1,0
16951,255,0,0,62,62,0,1,0,1,0
2973,2636,0,0,62,62,0,1,0,1,0
10475,2587,0,0,62,62,0,1,0,1,0
14191,2587,0,0,66,66,0,1,0,1,0
2211,2567,0,0,66,66,0,1,0,1,0
9214,3256,0,0,60,60,0,1,0,1,0
3042,7,0,0,60,60,0,1,0,1,0
783,1888,0,0,62,62,0,1,0,1,0
2132,1888,0,0,62,62,0,1,0,1,0
360,3105,0,0,164,164,0,1,0,1,0
20300,2256,0,0,146,146,0,1,0,1,0
12887,2545,0,0,62,62,0,1,0,1,0
12,2359,0,0,66,66,0,1,0,1,0
1525,1444,0,0,145,145,0,1,0,1,0
16951,255,0,0,62,62,0,1,0,1,0
1229,1804,0,0,62,62,0,1,0,1,0
12936,1147,0,0,66,66,0,1,0,1,0
3074,1479,0,0,181,181,0,1,0,1,0
3639,2611,0,0,62,62,0,1,0,1,0
7607,3216,0,0,145,145,0,1,0,1,0
4182,2610,0,0,60,60,0,1,0,1,0
1714,1888,0,0,66,66,0,1,0,1,0
2003,2938,0,0,62,62,0,1,0,1,0
7339,170,0,0,60,60,0,1,0,1,0
16951,255,0,0,62,62,0,1,0,1,0
22268,1771,0,0,62,62,0,1,0,1,0
2761,2611,0,0,62,62,0,1,0,1,0
22223,1589,0,0,66,66,0,1,0,1,0
3153,1017,0,0,62,62,0,1,0,1,0
13686,3139,0,0,66,66,0,1,0,1,0
19164,1017,0,0,66,66,0,1,0,1,0
16703,2608,0,0,66,66,0,1,0,1,0
17898,2883,0,0,66,66,0,1,0,1,0
7917,2636,0,0,62,62,0,1,0,1,0
22272,1472,0,0,66,66,0,1,0,1,0
6846,8,0,0,74,74,0,1,0,1,0
2687,2587,0,0,66,66,0,1,0,1,0
367,1017,0,0,62,62,0,1,0,1,0
10386,2938,0,0,66,66,0,1,0,1,0
1804,3211,0,0,60,60,0,1,0,1,0
16951,255,0,0,62,62,0,1,0,1,0
16830,1888,0,0,66,66,0,1,0,1,0
10978,797,0,0,62,62,0,1,0,1,0
21599,2636,0,0,66,66,0,1,0,1,0
6459,1215,0,0,62,62,0,1,0,1,0
12887,2545,0,0,62,62,0,1,0,1,0
1020,2938,0,0,62,62,0,1,0,1,0
3017,1880,0,0,66,66,0,1,0,1,0
2387,2495,0,0,159,159,0,1,0,1,0
7056,2938,0,0,66,66,0,1,0,1,0
16814,2883,0,0,62,62,0,1,0,1,0
19502,3212,0,0,62,62,0,1,0,1,0
3875,921,0,0,60,60,0,1,0,1,0
17569,2154,0,0,74,74,0,1,0,1,0
638,2275,0,0,139,139,0,1,0,1,0
438,2636,0,0,62,62,0,1,0,1,0
752,2587,0,0,62,62,0,1,0,1,0
1471,2144,0,0,62,62,0,1,0,1,0
16951,255,0,0,62,62,0,1,0,1,0
493,274,0,0,145,145,0,1,0,1,0
12,1932,0,0,82,82,0,1,0,1,0
1937,1215,0,0,62,62,0,1,0,1,0
8276,2023,0,0,161,161,0,1,0,1,0
7537,1086,0,0,66,66,0,1,0,1,0
6533,1215,0,0,62,62,0,1,0,1,0
2563,3216,0,0,62,62,0,1,0,1,0
7730,1888,0,0,62,62,0,1,0,1,0
15204,1147,0,0,66,66,0,1,0,1,0
3943,1215,0,0,62,62,0,1,0,1,0
16668,2256,0,0,66,66,0,1,0,1,0
16083,1771,0,0,66,66,0,1,0,1,0
6451,2938,0,0,62,62,0,1,0,1,0
21,2256,0,0,62,62,0,1,0,1,0
16951,255,0,0,62,62,0,1,0,1,0
15593,1804,0,0,62,62,0,1,0,1,0
5684,1054,0,0,62,62,0,1,0,1,0
16951,255,0,0,62,62,0,1,0,1,0
7335,1070,0,0,60,60,0,1,0,1,0
8171,1073,0,0,60,60,0,1,0,1,0
62,1888,0,0,62,62,0,1,0,1,0
2548,1908,0,0,60,60,0,1,0,1,0
3070,1888,0,0,66,66,0,1,0,1,0
6067,1888,0,0,62,62,0,1,0,1,0
76,2883,0,0,66,66,0,1,0,1,0
275,9,0,0,60,60,0,1,0,1,0
22357,1906,0,0,66,66,0,1,0,1,0
3110,2953,0,0,62,62,0,1,0,1,0
17533,1771,0,0,66,66,0,1,0,1,0
11744,697,0,0,66,66,0,1,0,1,0
380,1215,0,0,66,66,0,1,0,1,0
16904,983,0,0,66,66,0,1,0,1,0
12809,2836,0,0,66,66,0,1,0,1,0
1461,983,0,0,66,66,0,1,0,1,0
3260,1017,0,0,66,66,0,1,0,1,0
3326,2573,0,0,145,145,0,1,0,1,0
12767,697,0,0,62,62,0,1,0,1,0
16951,255,0,0,62,62,0,1,0,1,0
2303,437,0,0,66,66,0,1,0,1,0
5425,1147,0,0,66,66,0,1,0,1,0
636,1202,0,0,146,146,0,1,0,1,0
10864,1771,0,0,66,66,0,1,0,1,0
20699,2697,0,0,78,78,0,1,0,1,0
3104,2093,0,0,145,145,0,1,0,1,0
16951,255,0,0,62,62,0,1,0,1,0
338,1771,0,0,66,66,0,1,0,1,0
9513,2587,0,0,66,66,0,1,0,1,0
590,2256,0,0,66,66,0,1,0,1,0
1236,2256,0,0,66,66,0,1,0,1,0
360,3105,0,0,627,627,0,1,0,1,0
2416,2938,0,0,62,62,0,1,0,1,0
16951,255,0,0,62,62,0,1,0,1,0
9504,1888,0,0,66,66,0,1,0,1,0
21279,2256,0,0,66,66,0,1,0,1,0
2670,2938,0,0,62,62,0,1,0,1,0
9812,3000,0,0,66,66,0,1,0,1,0
16951,255,0,0,62,62,0,1,0,1,0
13225,3216,0,0,62,62,0,1,0,1,0
20926,2382,0,0,62,62,0,1,0,1,0
8743,2938,0,0,66,66,0,1,0,1,0
616,139,0,0,60,60,0,1,0,1,0
3075,1215,0,0,62,62,0,1,0,1,0
4578,983,0,0,62,62,0,1,0,1,0
219,3188,0,0,66,66,0,1,0,1,0
20455,2256,0,0,62,62,0,1,0,1,0
2297,1147,0,0,66,66,0,1,0,1,0
20458,2636,0,0,62,62,0,1,0,1,0
2289,437,0,0,62,62,0,1,0,1,0
423,2587,0,0,62,62,0,1,0,1,0
7251,1792,0,0,145,145,0,1,0,1,0
18163,2256,0,0,66,66,0,1,0,1,0
12619,1888,0,0,66,66,0,1,0,1,0
274,9,0,0,60,60,0,1,0,1,0
5454,1888,0,0,66,66,0,1,0,1,0
3127,3216,0,0,62,62,0,1,0,1,0
21,509,0,0,62,62,0,1,0,1,0
12,2199,0,0,97,97,0,1,0,1,0
15287,2382,0,0,66,66,0,1,0,1,0
3247,3212,0,0,66,66,0,1,0,1,0
21399,1147,0,0,62,62,0,1,0,1,0
2497,3216,0,0,62,62,0,1,0,1,0
16743,3139,0,0,146,146,0,1,0,1,0
252,280,0,0,66,66,0,1,0,1,0
14033,1215,0,0,62,62,0,1,0,1,0
16951,255,0,0,62,62,0,1,0,1,0
16951,255,0,0,62,62,0,1,0,1,0
7518,2256,0,0,62,62,0,1,0,1,0
8584,1017,0,0,62,62,0,1,0,1,0
4053,697,0,0,62,62,0,1,0,1,0
10009,1462,0,0,66,66,0,1,0,1,0
18859,1771,0,0,66,66,0,1,0,1,0
2676,2938,0,0,62,62,0,1,0,1,0
1851,1771,0,0,146,146,0,1,0,1,0
11602,1804,0,0,62,62,0,1,0,1,0
10621,2486,0,0,66,66,0,1,0,1,0
11632,308,0,0,66,66,0,1,0,1,0
16471,1936,0,0,62,62,0,1,0,1,0
14838,2836,0,0,66,66,0,1,0,1,0
6846,8,0,0,74,74,0,1,0,1,0
2966,2256,0,0,62,62,0,1,0,1,0
1682,2256,0,0,62,62,0,1,0,1,0
22403,2604,0,0,62,62,0,1,0,1,0
18615,2611,0,0,62,62,0,1,0,1,0
573,7,0,0,60,60,0,1,0,1,0
3592,2581,0,0,146,146,0,1,0,1,0
10651,1147,0,0,66,66,0,1,0,1,0
9900,3216,0,0,66,66,0,1,0,1,0
8668,2256,0,0,66,66,0,1,0,1,0
1824,2853,0,0,62,62,0,1,0,1,0
2874,1804,0,0,62,62,0,1,0,1,0
2450,2938,0,0,62,62,0,1,0,1,0
612,714,0,0,60,60,0,1,0,1,0
2301,1946,0,0,60,60,0,1,0,1,0
12844,2256,0,0,66,66,0,1,0,1,0
2723,2573,0,0,62,62,0,1,0,1,0
12678,1827,0,0,66,66,0,1,0,1,0
12,207,0,0,320,320,0,1,0,1,0
2466,2587,0,0,62,62,0,1,0,1,0
672,1147,0,0,66,66,0,1,0,1,0
22161,2256,0,0,66,66,0,1,0,1,0
10762,2587,0,0,146,146,0,1,0,1,0
19502,3212,0,0,62,62,0,1,0,1,0
2628,3216,0,0,66,66,0,1,0,1,0
8,1814,0,0,1514,1514,0,1,0,1,0
9260,805,0,0,66,66,0,1,0,1,0
5212,1888,0,0,62,62,0,1,0,1,0
14575,2953,0,0,66,66,0,1,0,1,0
21352,1147,0,0,66,66,0,1,0,1,0
3242,2573,0,0,145,145,0,1,0,1,0
2403,7,0,0,60,60,0,1,0,1,0
8276,2486,0,0,160,160,0,1,0,1,0
8127,2256,0,0,146,146,0,1,0,1,0
1766,1827,0,0,62,62,0,1,0,1,0
3785,2477,0,0,60,60,0,1,0,1,0
2463,1147,0,0,62,62,0,1,0,1,0
823,911,0,0,60,60,0,1,0,1,0
2665,2256,0,0,62,62,0,1,0,1,0
15391,509,0,0,66,66,0,1,0,1,0
15157,1147,0,0,146,146,0,1,0,1,0
1890,1147,0,0,62,62,0,1,0,1,0
1106,1147,0,0,62,62,0,1,0,1,0
0,0,0,0,98,98,0,1,0,1,0
1553,2636,0,0,62,62,0,1,0,1,0
3014,2486,0,0,145,145,0,1,0,1,0
20786,1147,0,0,66,66,0,1,0,1,0
8165,509,0,0,146,146,0,1,0,1,0
15694,333,0,0,145,145,0,1,0,1,0
17787,2440,0,0,62,62,0,1,0,1,0
19874,1771,0,0,62,62,0,1,0,1,0
13847,1017,0,0,66,66,0,1,0,1,0
19857,2587,0,0,62,62,0,1,0,1,0
12,2419,0,0,85,85,0,1,0,1,0
10475,2587,0,0,66,66,0,1,0,1,0
12681,1888,0,0,66,66,0,1,0,1,0
2463,2604,0,0,146,146,0,1,0,1,0
13762,1936,0,0,66,66,0,1,0,1,0
1124,2256,0,0,146,146,0,1,0,1,0
22135,1147,0,0,66,66,0,1,0,1,0
17787,2440,0,0,66,66,0,1,0,1,0
6993,3216,0,0,62,62,0,1,0,1,0
2660,1147,0,0,62,62,0,1,0,1,0
0,0,0,0,70,70,0,1,0,1,0
7326,180,0,0,60,60,0,1,0,1,0
684,2938,0,0,62,62,0,1,0,1,0
2678,3216,0,0,62,62,0,1,0,1,0
228,1771,0,0,62,62,0,1,0,1,0
9299,1763,0,0,66,66,0,1,0,1,0
11744,697,0,0,66,66,0,1,0,1,0
1879,1017,0,0,62,62,0,1,0,1,0
4309,2587,0,0,146,146,0,1,0,1,0
3091,2938,0,0,62,62,0,1,0,1,0
16656,2953,0,0,66,66,0,1,0,1,0
16951,255,0,0,62,62,0,1,0,1,0
416,797,0,0,66,66,0,1,0,1,0
14087,3216,0,0,66,66,0,1,0,1,0
10775,1472,0,0,62,62,0,1,0,1,0
14911,1804,0,0,66,66,0,1,0,1,0
732,1590,0,0,62,62,0,1,0,1,0
1234,983,0,0,62,62,0,1,0,1,0
1343,2154,0,0,62,62,0,1,0,1,0
6649,697,0,0,74,74,0,1,0,1,0
4323,2049,0,0,145,145,0,1,0,1,0
19159,1888,0,0,62,62,0,1,0,1,0
6379,2938,0,0,62,62,0,1,0,1,0
14169,2938,0,0,66,66,0,1,0,1,0
0,0,0,0,82,82,0,1,0,1,0
7547,2953,0,0,66,66,0,1,0,1,0
352,2953,0,0,66,66,0,1,0,1,0
16951,255,0,0,62,62,0,1,0,1,0
19096,1327,0,0,66,66,0,1,0,1,0
1913,2573,0,0,62,62,0,1,0,1,0
2793,2636,0,0,62,62,0,1,0,1,0
9586,1147,0,0,62,62,0,1,0,1,0
12,3074,0,0,320,320,0,1,0,1,0
9812,3000,0,0,66,66,0,1,0,1,0
12874,2558,0,0,62,62,0,1,0,1,0
1780,2587,0,0,66,66,0,1,0,1,0
13230,2883,0,0,62,62,0,1,0,1,0
715,938,0,0,157,157,0,1,0,1,0
403,1147,0,0,62,62,0,1,0,1,0
17158,697,0,0,66,66,0,1,0,1,0
1374,1888,0,0,62,62,0,1,0,1,0
1664,280,0,0,62,62,0,1,0,1,0
12,2419,0,0,100,100,0,1,0,1,0
17395,2256,0,0,62,62,0,1,0,1,0
16951,255,0,0,62,62,0,1,0,1,0
3715,1147,0,0,146,146,0,1,0,1,0
9214,3256,0,0,60,60,0,1,0,1,0
9400,2256,0,0,66,66,0,1,0,1,0
16861,983,0,0,66,66,0,1,0,1,0
7997,1147,0,0,146,146,0,1,0,1,0
16813,804,0,0,66,66,0,1,0,1,0
16744,3216,0,0,72,72,0,1,0,1,0
3168,1888,0,0,62,62,0,1,0,1,0
7339,237,0,0,60,60,0,1,0,1,0
13686,3139,0,0,66,66,0,1,0,1,0
1796,2587,0,0,62,62,0,1,0,1,0
1241,280,0,0,146,146,0,1,0,1,0
1905,280,0,0,66,66,0,1,0,1,0
19806,1017,0,0,66,66,0,1,0,1,0
9614,3105,0,0,86,86,0,1,0,1,0
16941,3212,0,0,66,66,0,1,0,1,0
1628,3216,0,0,62,62,0,1,0,1,0
834,2883,0,0,62,62,0,1,0,1,0
22160,1149,0,0,145,145,0,1,0,1,0
18144,1147,0,0,66,66,0,1,0,1,0
12033,2587,0,0,66,66,0,1,0,1,0
1128,2938,0,0,66,66,0,1,0,1,0
10790,2587,0,0,66,66,0,1,0,1,0
17051,2611,0,0,62,62,0,1,0,1,0
298,1888,0,0,62,62,0,1,0,1,0
12532,2235,0,0,66,66,0,1,0,1,0
740,1017,0,0,66,66,0,1,0,1,0
22152,1215,0,0,62,62,0,1,0,1,0
22103,2608,0,0,66,66,0,1,0,1,0
14155,2360,0,0,66,66,0,1,0,1,0
12329,7,0,0,60,60,0,1,0,1,0
20162,2747,0,0,66,66,0,1,0,1,0
51,366,0,0,66,66,0,1,0,1,0
4790,1888,0,0,62,62,0,1,0,1,0
1823,2573,0,0,62,62,0,1,0,1,0
13447,1017,0,0,146,146,0,1,0,1,0
7949,314,0,0,60,60,0,1,0,1,0
14990,2587,0,0,62,62,0,1,0,1,0
7916,1493,0,0,62,62,0,1,0,1,0
16087,2587,0,0,66,66,0,1,0,1,0
5256,2256,0,0,66,66,0,1,0,1,0
8547,983,0,0,66,66,0,1,0,1,0
18461,2379,0,0,74,74,0,1,0,1,0
22468,201,0,0,78,78,0,1,0,1,0
13282,2379,0,0,66,66,0,1,0,1,0
1952,7,0,0,60,60,0,1,0,1,0
18,418,0,0,62,62,0,1,0,1,0
1481,1147,0,0,62,62,0,1,0,1,0
10267,2883,0,0,66,66,0,1,0,1,0
4491,1147,0,0,66,66,0,1,0,1,0
3095,3216,0,0,62,62,0,1,0,1,0
20364,3139,0,0,66,66,0,1,0,1,0
1905,280,0,0,62,62,0,1,0,1,0
11914,2604,0,0,66,66,0,1,0,1,0
2238,2587,0,0,66,66,0,1,0,1,0
463,2256,0,0,62,62,0,1,0,1,0
8,1873,0,0,60,60,0,1,0,1,0
12,3031,0,0,60,60,0,1,0,1,0
17758,2883,0,0,66,66,0,1,0,1,0
17881,1167,0,0,66,66,0,1,0,1,0
3058,3262,0,0,60,60,0,1,0,1,0
18067,1804,0,0,66,66,0,1,0,1,0
7564,2636,0,0,62,62,0,1,0,1,0
17455,1147,0,0,66,66,0,1,0,1,0
16951,255,0,0,62,62,0,1,0,1,0
2191,2256,0,0,66,66,0,1,0,1,0
7663,3216,0,0,62,62,0,1,0,1,0
6277,7,0,0,60,60,0,1,0,1,0
17111,2759,0,0,66,66,0,1,0,1,0
8695,983,0,0,62,62,0,1,0,1,0
1330,2943,0,0,62,62,0,1,0,1,0
14131,3212,0,0,66,66,0,1,0,1,0
16951,255,0,0,62,62,0,1,0,1,0
8,442,0,0,60,60,0,1,0,1,0
7,12,0,0,594,594,0,1,0,1,0
20552,3216,0,0,66,66,0,1,0,1,0
10123,1795,0,0,60,60,0,1,0,1,0
7564,2636,0,0,62,62,0,1,0,1,0
7000,2370,0,0,74,74,0,1,0,1,0
4024,2883,0,0,62,62,0,1,0,1,0
8168,2938,0,0,62,62,0,1,0,1,0
9005,104,0,0,60,60,0,1,0,1,0
5225,2382,0,0,62,62,0,1,0,1,0
360,3105,0,0,301,301,0,1,0,1,0
17476,2695,0,0,145,145,0,1,0,1,0
1625,280,0,0,62,62,0,1,0,1,0
17459,2953,0,0,66,66,0,1,0,1,0
2968,1888,0,0,62,62,0,1,0,1,0
9499,2205,0,0,62,62,0,1,0,1,0
648,2697,0,0,100,100,0,1,0,1,0
1124,2256,0,0,62,62,0,1,0,1,0
3143,2938,0,0,74,74,0,1,0,1,0
15882,3051,0,0,66,66,0,1,0,1,0
160,1888,0,0,62,62,0,1,0,1,0
14694,3216,0,0,66,66,0,1,0,1,0
9397,1771,0,0,66,66,0,1,0,1,0
15345,1215,0,0,66,66,0,1,0,1,0
2141,1888,0,0,62,62,0,1,0,1,0
3194,1688,0,0,62,62,0,1,0,1,0
19018,1936,0,0,66,66,0,1,0,1,0
19565,2587,0,0,66,66,0,1,0,1,0
7981,2938,0,0,62,62,0,1,0,1,0
20392,7,0,0,60,60,0,1,0,1,0
9313,2938,0,0,146,146,0,1,0,1,0
16951,255,0,0,62,62,0,1,0,1,0
16083,1771,0,0,66,66,0,1,0,1,0
19979,344,0,0,159,159,0,1,0,1,0
2718,1888,0,0,62,62,0,1,0,1,0
7339,140,0,0,60,60,0,1,0,1,0
6890,1086,0,0,66,66,0,1,0,1,0
13411,1472,0,0,66,66,0,1,0,1,0
15713,1936,0,0,66,66,0,1,0,1,0
36,1804,0,0,66,66,0,1,0,1,0
2982,2486,0,0,148,148,0,1,0,1,0
13900,2587,0,0,66,66,0,1,0,1,0
2055,427,0,0,62,62,0,1,0,1,0
22302,1880,0,0,62,62,0,1,0,1,0
20659,697,0,0,66,66,0,1,0,1,0
16112,2611,0,0,62,62,0,1,0,1,0
1444,509,0,0,146,146,0,1,0,1,0
9737,3216,0,0,66,66,0,1,0,1,0
21589,1771,0,0,62,62,0,1,0,1,0
16478,248,0,0,60,60,0,1,0,1,0
6323,1017,0,0,62,62,0,1,0,1,0
5278,2256,0,0,66,66,0,1,0,1,0
78,2636,0,0,146,146,0,1,0,1,0
7561,1804,0,0,62,62,0,1,0,1,0
4542,33,0,0,60,60,0,1,0,1,0
2535,1787,0,0,145,145,0,1,0,1,0
11686,3216,0,0,66,66,0,1,0,1,0
3106,1147,0,0,62,62,0,1,0,1,0
3632,2256,0,0,66,66,0,1,0,1,0
16853,2256,0,0,66,66,0,1,0,1,0
11583,2256,0,0,66,66,0,1,0,1,0
21089,2486,0,0,145,145,0,1,0,1,0
16427,2256,0,0,62,62,0,1,0,1,0
8,3259,0,0,66,66,0,1,0,1,0
10584,3216,0,0,66,66,0,1,0,1,0
16231,1888,0,0,62,62,0,1,0,1,0
0,0,0,0,98,98,0,1,0,1,0
8358,1771,0,0,66,66,0,1,0,1,0
8164,2727,0,0,60,60,0,1,0,1,0
17214,1888,0,0,66,66,0,1,0,1,0
1398,2261,0,0,60,60,0,1,0,1,0
1820,1147,0,0,62,62,0,1,0,1,0
636,280,0,0,62,62,0,1,0,1,0
17569,2154,0,0,74,74,0,1,0,1,0
16951,255,0,0,62,62,0,1,0,1,0
1913,2256,0,0,146,146,0,1,0,1,0
3002,1936,0,0,62,62,0,1,0,1,0
8171,1073,0,0,60,60,0,1,0,1,0
10475,6,0,0,60,60,0,1,0,1,0
8164,2726,0,0,60,60,0,1,0,1,0
497,615,0,0,66,66,0,1,0,1,0
1108,146,0,0,60,60,0,1,0,1,0
22152,1215,0,0,62,62,0,1,0,1,0
16951,255,0,0,62,62,0,1,0,1,0
577,2611,0,0,78,78,0,1,0,1,0
12325,183,0,0,66,66,0,1,0,1,0
4173,1147,0,0,66,66,0,1,0,1,0
16951,255,0,0,62,62,0,1,0,1,0
13845,983,0,0,66,66,0,1,0,1,0
5598,3216,0,0,62,62,0,1,0,1,0
1156,146,0,0,60,60,0,1,0,1,0
2414,2093,0,0,146,146,0,1,0,1,0
16657,2587,0,0,62,62,0,1,0,1,0
16951,255,0,0,62,62,0,1,0,1,0
3118,1888,0,0,62,62,0,1,0,1,0
11450,1686,0,0,60,60,0,1,0,1,0
615,2252,0,0,66,66,0,1,0,1,0
3415,2587,0,0,62,62,0,1,0,1,0
3054,697,0,0,62,62,0,1,0,1,0
2539,1129,0,0,143,143,0,1,0,1,0
6466,7,0,0,60,60,0,1,0,1,0
636,1635,0,0,146,146,0,1,0,1,0
10427,1017,0,0,66,66,0,1,0,1,0
7789,1804,0,0,62,62,0,1,0,1,0
159,2636,0,0,66,66,0,1,0,1,0
1138,1017,0,0,146,146,0,1,0,1,0
16972,3216,0,0,62,62,0,1,0,1,0
16951,255,0,0,62,62,0,1,0,1,0
6682,2256,0,0,62,62,0,1,0,1,0
16844,2938,0,0,66,66,0,1,0,1,0
1345,3216,0,0,145,145,0,1,0,1,0
7,12,0,0,346,346,0,1,0,1,0
20965,2953,0,0,66,66,0,1,0,1,0
289,1472,0,0,66,66,0,1,0,1,0
9959,2938,0,0,66,66,0,1,0,1,0
3651,1017,0,0,62,62,0,1,0,1,0
1222,2256,0,0,62,62,0,1,0,1,0
15896,2587,0,0,62,62,0,1,0,1,0
19225,2486,0,0,62,62,0,1,0,1,0
17982,1017,0,0,66,66,0,1,0,1,0
14033,1215,0,0,62,62,0,1,0,1,0
11682,1147,0,0,66,66,0,1,0,1,0
14191,2587,0,0,62,62,0,1,0,1,0
985,2938,0,0,66,66,0,1,0,1,0
16171,1367,0,0,60,60,0,1,0,1,0
2809,1472,0,0,66,66,0,1,0,1,0
6369,2608,0,0,62,62,0,1,0,1,0
2014,1888,0,0,62,62,0,1,0,1,0
1992,3216,0,0,66,66,0,1,0,1,0
21587,2938,0,0,78,78,0,1,0,1,0
11373,1086,0,0,66,66,0,1,0,1,0
10656,2883,0,0,66,66,0,1,0,1,0
2820,1147,0,0,62,62,0,1,0,1,0
17889,3139,0,0,66,66,0,1,0,1,0
3093,1147,0,0,62,62,0,1,0,1,0
2359,1017,0,0,66,66,0,1,0,1,0
11450,245,0,0,60,60,0,1,0,1,0
20772,1804,0,0,62,62,0,1,0,1,0
7460,1771,0,0,66,66,0,1,0,1,0
11425,2154,0,0,66,66,0,1,0,1,0
3535,3139,0,0,66,66,0,1,0,1,0
5664,1017,0,0,62,62,0,1,0,1,0
16338,2636,0,0,62,62,0,1,0,1,0
4070,697,0,0,66,66,0,1,0,1,0
18047,1880,0,0,146,146,0,1,0,1,0
2551,146,0,0,60,60,0,1,0,1,0
2678,3216,0,0,62,62,0,1,0,1,0
3481,1147,0,0,62,62,0,1,0,1,0
2201,2256,0,0,66,66,0,1,0,1,0
2229,697,0,0,62,62,0,1,0,1,0
10635,2876,0,0,66,66,0,1,0,1,0
7517,2938,0,0,62,62,0,1,0,1,0
1871,1017,0,0,62,62,0,1,0,1,0
6439,2256,0,0,66,66,0,1,0,1,0
1814,1147,0,0,66,66,0,1,0,1,0
1373,1147,0,0,66,66,0,1,0,1,0
6677,797,0,0,62,62,0,1,0,1,0
12268,2256,0,0,62,62,0,1,0,1,0
20468,2611,0,0,66,66,0,1,0,1,0
360,3105,0,0,1267,1267,0,1,0,1,0
1774,1017,0,0,62,62,0,1,0,1,0
15908,3139,0,0,62,62,0,1,0,1,0
17312,430,0,0,60,60,0,1,0,1,0
4420,1147,0,0,66,66,0,1,0,1,0
387,1147,0,0,62,62,0,1,0,1,0
18489,2938,0,0,62,62,0,1,0,1,0
13122,1054,0,0,66,66,0,1,0,1,0
8098,2477,0,0,146,146,0,1,0,1,0
2295,1472,0,0,62,62,0,1,0,1,0
2862,1147,0,0,62,62,0,1,0,1,0
16951,255,0,0,62,62,0,1,0,1,0
1496,3216,0,0,62,62,0,1,0,1,0
1436,2104,0,0,139,139,0,1,0,1,0
10123,1795,0,0,60,60,0,1,0,1,0
4488,2144,0,0,62,62,0,1,0,1,0
19157,1771,0,0,66,66,0,1,0,1,0
1182,2256,0,0,66,66,0,1,0,1,0
3770,1771,0,0,66,66,0,1,0,1,0
16941,3212,0,0,66,66,0,1,0,1,0
1092,1215,0,0,66,66,0,1,0,1,0
2493,3216,0,0,66,66,0,1,0,1,0
22030,1282,0,0,66,66,0,1,0,1,0
721,130,0,0,60,60,0,1,0,1,0
2498,2573,0,0,145,145,0,1,0,1,0
3441,2636,0,0,62,62,0,1,0,1,0
8736,255,0,0,60,60,0,1,0,1,0
2584,1677,0,0,160,160,0,1,0,1,0
18,1444,0,0,145,145,0,1,0,1,0
16951,255,0,0,62,62,0,1,0,1,0
187,1795,0,0,60,60,0,1,0,1,0
16951,255,0,0,62,62,0,1,0,1,0
3656,2636,0,0,62,62,0,1,0,1,0
2138,1215,0,0,62,62,0,1,0,1,0
14489,3216,0,0,66,66,0,1,0,1,0
381,2883,0,0,62,62,0,1,0,1,0
20742,2611,0,0,62,62,0,1,0,1,0
0,0,0,0,98,98,0,1,0,1,0
9568,2852,0,0,62,62,0,1,0,1,0
10246,3117,0,0,62,62,0,1,0,1,0
16951,255,0,0,62,62,0,1,0,1,0
76,2883,0,0,66,66,0,1,0,1,0
13767,326,0,0,62,62,0,1,0,1,0
2894,6,0,0,60,60,0,1,0,1,0
3223,383,0,0,62,62,0,1,0,1,0
21016,1147,0,0,62,62,0,1,0,1,0
6692,1888,0,0,66,66,0,1,0,1,0
11942,1804,0,0,62,62,0,1,0,1,0
9614,3105,0,0,86,86,0,1,0,1,0
9273,6,0,0,60,60,0,1,0,1,0
12516,1795,0,0,60,60,0,1,0,1,0
1755,2587,0,0,146,146,0,1,0,1,0
17664,2587,0,0,62,62,0,1,0,1,0
81,7,0,0,60,60,0,1,0,1,0
14248,1472,0,0,66,66,0,1,0,1,0
187,1795,0,0,60,60,0,1,0,1,0
16091,1771,0,0,66,66,0,1,0,1,0
7518,2256,0,0,146,146,0,1,0,1,0
7339,141,0,0,60,60,0,1,0,1,0
612,5,0,0,60,60,0,1,0,1,0
3968,2938,0,0,74,74,0,1,0,1,0
16951,255,0,0,62,62,0,1,0,1,0
7335,1072,0,0,60,60,0,1,0,1,0
20917,1472,0,0,66,66,0,1,0,1,0
659,1054,0,0,66,66,0,1,0,1,0
21312,1147,0,0,62,62,0,1,0,1,0
10575,1771,0,0,66,66,0,1,0,1,0
14341,1147,0,0,146,146,0,1,0,1,0
14131,3212,0,0,62,62,0,1,0,1,0
20785,1215,0,0,66,66,0,1,0,1,0
15482,2587,0,0,66,66,0,1,0,1,0
2084,1471,0,0,145,145,0,1,0,1,0
1510,339,0,0,62,62,0,1,0,1,0
2781,1804,0,0,146,146,0,1,0,1,0
12055,3113,0,0,66,66,0,1,0,1,0
12,2199,0,0,97,97,0,1,0,1,0
20861,2144,0,0,66,66,0,1,0,1,0
2346,2256,0,0,62,62,0,1,0,1,0
9614,3105,0,0,86,86,0,1,0,1,0
11247,1017,0,0,66,66,0,1,0,1,0
14969,1017,0,0,66,66,0,1,0,1,0
13951,2256,0,0,66,66,0,1,0,1,0
370,2938,0,0,62,62,0,1,0,1,0
2954,2205,0,0,62,62,0,1,0,1,0
2456,2486,0,0,157,157,0,1,0,1,0
11501,2256,0,0,66,66,0,1,0,1,0
2451,577,0,0,60,60,0,1,0,1,0
410,1771,0,0,66,66,0,1,0,1,0
3007,1215,0,0,62,62,0,1,0,1,0
21293,1147,0,0,62,62,0,1,0,1,0
21010,2382,0,0,66,66,0,1,0,1,0
2354,2747,0,0,62,62,0,1,0,1,0
16928,3139,0,0,62,62,0,1,0,1,0
5327,1888,0,0,62,62,0,1,0,1,0
14957,2256,0,0,66,66,0,1,0,1,0
12,929,0,0,83,83,0,1,0,1,0
2452,2587,0,0,66,66,0,1,0,1,0
1937,1215,0,0,66,66,0,1,0,1,0
1962,2608,0,0,62,62,0,1,0,1,0
18039,1771,0,0,66,66,0,1,0,1,0
16951,255,0,0,62,62,0,1,0,1,0
6110,1771,0,0,62,62,0,1,0,1,0
3428,465,0,0,148,148,0,1,0,1,0
2978,1472,0,0,66,66,0,1,0,1,0
4954,2611,0,0,62,62,0,1,0,1,0
2462,2587,0,0,62,62,0,1,0,1,0
16432,2154,0,0,66,66,0,1,0,1,0
16951,255,0,0,62,62,0,1,0,1,0
1535,2256,0,0,62,62,0,1,0,1,0
1607,1215,0,0,62,62,0,1,0,1,0
7339,140,0,0,60,60,0,1,0,1,0
16951,255,0,0,62,62,0,1,0,1,0
823,3061,0,0,60,60,0,1,0,1,0
19937,1054,0,0,66,66,0,1,0,1,0
186,2486,0,0,66,66,0,1,0,1,0
14641,2587,0,0,66,66,0,1,0,1,0
16951,255,0,0,62,62,0,1,0,1,0
16951,255,0,0,62,62,0,1,0,1,0
18632,1147,0,0,66,66,0,1,0,1,0
13792,1472,0,0,66,66,0,1,0,1,0
22690,2938,0,0,72,72,0,1,0,1,0
16951,255,0,0,62,62,0,1,0,1,0
113,2486,0,0,62,62,0,1,0,1,0
3186,2938,0,0,62,62,0,1,0,1,0
639,491,0,0,143,143,0,1,0,1,0
11125,2876,0,0,62,62,0,1,0,1,0
9466,861,0,0,143,143,0,1,0,1,0
2122,3216,0,0,145,145,0,1,0,1,0
0,0,0,0,98,98,0,1,0,1,0
17819,2938,0,0,78,78,0,1,0,1,0
1570,1888,0,0,146,146,0,1,0,1,0
10513,3216,0,0,62,62,0,1,0,1,0
16582,2205,0,0,62,62,0,1,0,1,0
2719,1147,0,0,62,62,0,1,0,1,0
1490,465,0,0,159,159,0,1,0,1,0
2660,1888,0,0,62,62,0,1,0,1,0
11893,2636,0,0,66,66,0,1,0,1,0
17997,1472,0,0,66,66,0,1,0,1,0
19892,2938,0,0,74,74,0,1,0,1,0
3088,1804,0,0,62,62,0,1,0,1,0
3064,7,0,0,60,60,0,1,0,1,0
1262,1147,0,0,146,146,0,1,0,1,0
7302,2604,0,0,62,62,0,1,0,1,0
8668,2256,0,0,66,66,0,1,0,1,0
9781,2256,0,0,62,62,0,1,0,1,0
2084,1471,0,0,145,145,0,1,0,1,0
2804,1804,0,0,146,146,0,1,0,1,0
14149,1147,0,0,66,66,0,1,0,1,0
2184,2938,0,0,62,62,0,1,0,1,0
3477,2256,0,0,66,66,0,1,0,1,0
1311,1017,0,0,146,146,0,1,0,1,0
12957,956,0,0,66,66,0,1,0,1,0
3228,3139,0,0,66,66,0,1,0,1,0
9426,2938,0,0,78,78,0,1,0,1,0
16951,255,0,0,62,62,0,1,0,1,0
17702,1147,0,0,62,62,0,1,0,1,0
17683,983,0,0,66,66,0,1,0,1,0
7382,2636,0,0,62,62,0,1,0,1,0
18671,2604,0,0,62,62,0,1,0,1,0
7748,1771,0,0,62,62,0,1,0,1,0
17758,2883,0,0,62,62,0,1,0,1,0
9260,805,0,0,66,66,0,1,0,1,0
15694,1787,0,0,145,145,0,1,0,1,0
14714,1888,0,0,62,62,0,1,0,1,0
16720,2587,0,0,62,62,0,1,0,1,0
19024,2938,0,0,78,78,0,1,0,1,0
14865,2697,0,0,62,62,0,1,0,1,0
120,2883,0,0,62,62,0,1,0,1,0
338,1771,0,0,62,62,0,1,0,1,0
861,1888,0,0,62,62,0,1,0,1,0
14228,6,0,0,60,60,0,1,0,1,0
14064,3216,0,0,66,66,0,1,0,1,0
2138,1215,0,0,66,66,0,1,0,1,0
3159,1472,0,0,62,62,0,1,0,1,0
10758,2256,0,0,66,66,0,1,0,1,0
1378,1888,0,0,62,62,0,1,0,1,0
19168,2486,0,0,106,106,0,1,0,1,0
9746,1215,0,0,66,66,0,1,0,1,0
3064,2938,0,0,60,60,0,1,0,1,0
698,2256,0,0,66,66,0,1,0,1,0
2694,1888,0,0,62,62,0,1,0,1,0
6166,1367,0,0,62,62,0,1,0,1,0
3075,3216,0,0,66,66,0,1,0,1,0
14750,2587,0,0,66,66,0,1,0,1,0
13330,2636,0,0,62,62,0,1,0,1,0
137,3268,0,0,66,66,0,1,0,1,0
11196,1215,0,0,66,66,0,1,0,1,0
12347,1,0,0,66,66,0,1,0,1,0
18660,2975,0,0,62,62,0,1,0,1,0
3762,2938,0,0,66,66,0,1,0,1,0
14045,3216,0,0,66,66,0,1,0,1,0
2030,2899,0,0,78,78,0,1,0,1,0
3023,3216,0,0,62,62,0,1,0,1,0
17393,2938,0,0,66,66,0,1,0,1,0
21537,1086,0,0,146,146,0,1,0,1,0
22229,308,0,0,146,146,0,1,0,1,0
497,2220,0,0,220,220,0,1,0,1,0
399,1888,0,0,66,66,0,1,0,1,0
17825,2853,0,0,62,62,0,1,0,1,0
8164,2725,0,0,60,60,0,1,0,1,0
427,1215,0,0,66,66,0,1,0,1,0
7,12,0,0,594,594,0,1,0,1,0
4481,1147,0,0,62,62,0,1,0,1,0
13295,2521,0,0,66,66,0,1,0,1,0
2856,2695,0,0,62,62,0,1,0,1,0
12507,2883,0,0,62,62,0,1,0,1,0
9568,2852,0,0,62,62,0,1,0,1,0
1387,7,0,0,60,60,0,1,0,1,0
9924,2587,0,0,62,62,0,1,0,1,0
21817,2205,0,0,62,62,0,1,0,1,0
5081,2611,0,0,62,62,0,1,0,1,0
17607,2636,0,0,62,62,0,1,0,1,0
1125,1215,0,0,62,62,0,1,0,1,0
1070,2953,0,0,62,62,0,1,0,1,0
17636,2587,0,0,66,66,0,1,0,1,0
658,145,0,0,143,143,0,1,0,1,0
20888,697,0,0,66,66,0,1,0,1,0
844,2154,0,0,146,146,0,1,0,1,0
13539,104,0,0,60,60,0,1,0,1,0
16200,2938,0,0,62,62,0,1,0,1,0
530,400,1966,259,498,498,0,1,0,1,0
21166,1017,0,0,62,62,0,1,0,1,0
16951,255,0,0,62,62,0,1,0,1,0
3211,2820,0,0,139,139,0,1,0,1,0
3166,1737,0,0,146,146,0,1,0,1,0
6493,1017,0,0,146,146,0,1,0,1,0
16951,255,0,0,62,62,0,1,0,1,0
6106,2587,0,0,66,66,0,1,0,1,0
160,1888,0,0,62,62,0,1,0,1,0
3570,2675,0,0,162,162,0,1,0,1,0
112,2778,0,0,66,66,0,1,0,1,0
5896,3027,0,0,62,62,0,1,0,1,0
13979,1936,0,0,74,74,0,1,0,1,0
21588,1147,0,0,62,62,0,1,0,1,0
2132,1888,0,0,62,62,0,1,0,1,0
3021,1472,0,0,62,62,0,1,0,1,0
615,2252,0,0,66,66,0,1,0,1,0
15211,2205,0,0,66,66,0,1,0,1,0
12684,1017,0,0,66,66,0,1,0,1,0
5571,7,0,0,60,60,0,1,0,1,0
1525,1444,0,0,145,145,0,1,0,1,0
8213,1147,0,0,62,62,0,1,0,1,0
18039,1771,0,0,62,62,0,1,0,1,0
8107,2486,0,0,66,66,0,1,0,1,0
2315,1771,0,0,66,66,0,1,0,1,0
1689,2938,0,0,145,145,0,1,0,1,0
1965,1888,0,0,62,62,0,1,0,1,0
8164,2725,0,0,60,60,0,1,0,1,0
40,145,0,0,148,148,0,1,0,1,0
19428,242,0,0,145,145,0,1,0,1,0
22357,1906,0,0,66,66,0,1,0,1,0
8010,324,0,0,60,60,0,1,0,1,0
10414,2587,0,0,66,66,0,1,0,1,0
2512,1888,0,0,62,62,0,1,0,1,0
4262,7,0,0,60,60,0,1,0,1,0
10785,255,0,0,60,60,0,1,0,1,0
21178,2256,0,0,62,62,0,1,0,1,0
16951,255,0,0,62,62,0,1,0,1,0
1265,1215,0,0,62,62,0,1,0,1,0
2964,1888,0,0,62,62,0,1,0,1,0
15778,1215,0,0,66,66,0,1,0,1,0
10033,1215,0,0,66,66,0,1,0,1,0
575,2205,0,0,70,70,0,1,0,1,0
1164,3216,0,0,62,62,0,1,0,1,0
2139,2938,0,0,62,62,0,1,0,1,0
16764,2938,0,0,66,66,0,1,0,1,0
125,1017,0,0,62,62,0,1,0,1,0
14386,255,0,0,60,60,0,1,0,1,0
260,2636,0,0,66,66,0,1,0,1,0
12,214,0,0,60,60,0,1,0,1,0
16047,7,0,0,60,60,0,1,0,1,0
2057,1147,0,0,62,62,0,1,0,1,0
2651,3216,0,0,66,66,0,1,0,1,0
14529,3216,0,0,62,62,0,1,0,1,0
6269,2477,0,0,60,60,0,1,0,1,0
13359,2256,0,0,74,74,0,1,0,1,0
1738,2573,0,0,62,62,0,1,0,1,0
128,391,0,0,62,62,0,1,0,1,0
3074,1479,0,0,171,171,0,1,0,1,0
12619,2636,0,0,66,66,0,1,0,1,0
2891,3216,0,0,62,62,0,1,0,1,0
5040,2636,0,0,66,66,0,1,0,1,0
7961,715,0,0,62,62,0,1,0,1,0
10078,2256,0,0,66,66,0,1,0,1,0
5186,1888,0,0,62,62,0,1,0,1,0
15069,2883,0,0,146,146,0,1,0,1,0
16029,308,0,0,66,66,0,1,0,1,0
16014,2636,0,0,66,66,0,1,0,1,0
94,2256,0,0,62,62,0,1,0,1,0
1297,2820,0,0,148,148,0,1,0,1,0
4544,2256,0,0,66,66,0,1,0,1,0
22468,201,0,0,78,78,0,1,0,1,0
16951,255,0,0,62,62,0,1,0,1,0
120,2883,0,0,62,62,0,1,0,1,0
18,2938,0,0,72,72,0,1,0,1,0
5769,1147,0,0,62,62,0,1,0,1,0
8171,1073,0,0,60,60,0,1,0,1,0
612,3131,0,0,60,60,0,1,0,1,0
17864,2743,0,0,66,66,0,1,0,1,0
10595,509,0,0,66,66,0,1,0,1,0
12844,2256,0,0,66,66,0,1,0,1,0
17881,1167,0,0,62,62,0,1,0,1,0
13785,509,0,0,62,62,0,1,0,1,0
16701,1017,0,0,62,62,0,1,0,1,0
3199,2636,0,0,66,66,0,1,0,1,0
2981,1880,0,0,62,62,0,1,0,1,0
7339,152,0,0,60,60,0,1,0,1,0
13710,2235,0,0,62,62,0,1,0,1,0
2904,2587,0,0,66,66,0,1,0,1,0
1794,2938,0,0,62,62,0,1,0,1,0
8856,2573,0,0,62,62,0,1,0,1,0
21192,2256,0,0,66,66,0,1,0,1,0
3065,3117,0,0,62,62,0,1,0,1,0
21904,2938,0,0,66,66,0,1,0,1,0
6439,1017,0,0,66,66,0,1,0,1,0
442,7,0,0,60,60,0,1,0,1,0
20306,775,0,0,66,66,0,1,0,1,0
19621,847,0,0,66,66,0,1,0,1,0
12,2221,0,0,60,60,0,1,0,1,0
1288,1397,0,0,66,66,0,1,0,1,0
11240,2636,0,0,66,66,0,1,0,1,0
11054,1147,0,0,62,62,0,1,0,1,0
14694,3216,0,0,66,66,0,1,0,1,0
2121,3216,0,0,62,62,0,1,0,1,0
1161,3216,0,0,62,62,0,1,0,1,0
15840,3216,0,0,66,66,0,1,0,1,0
27,1215,0,0,62,62,0,1,0,1,0
22037,1888,0,0,66,66,0,1,0,1,0
17022,2636,0,0,66,66,0,1,0,1,0
10983,1888,0,0,66,66,0,1,0,1,0
3244,2611,0,0,66,66,0,1,0,1,0
22091,1215,0,0,62,62,0,1,0,1,0
2263,2636,0,0,62,62,0,1,0,1,0
14023,1590,0,0,66,66,0,1,0,1,0
3584,2587,0,0,62,62,0,1,0,1,0
10960,2938,0,0,62,62,0,1,0,1,0
14950,1017,0,0,62,62,0,1,0,1,0
21681,2883,0,0,66,66,0,1,0,1,0
11029,1888,0,0,62,62,0,1,0,1,0
19953,2587,0,0,66,66,0,1,0,1,0
19667,1771,0,0,66,66,0,1,0,1,0
17339,509,0,0,66,66,0,1,0,1,0
14360,255,0,0,60,60,0,1,0,1,0
16951,255,0,0,62,62,0,1,0,1,0
1796,2587,0,0,146,146,0,1,0,1,0
17440,1147,0,0,66,66,0,1,0,1,0
12377,1017,0,0,62,62,0,1,0,1,0
538,1888,0,0,62,62,0,1,0,1,0
6761,5,0,0,60,60,0,1,0,1,0
239,1888,0,0,66,66,0,1,0,1,0
1817,1017,0,0,62,62,0,1,0,1,0
3000,3216,0,0,62,62,0,1,0,1,0
22510,2611,0,0,78,78,0,1,0,1,0
1398,2261,0,0,60,60,0,1,0,1,0
21436,1771,0,0,66,66,0,1,0,1,0
13468,2587,0,0,62,62,0,1,0,1,0
16951,255,0,0,62,62,0,1,0,1,0
5011,2477,0,0,60,60,0,1,0,1,0
12,1768,0,0,66,66,0,1,0,1,0
22682,2611,0,0,62,62,0,1,0,1,0
22690,1215,0,0,66,66,0,1,0,1,0
13291,1215,0,0,62,62,0,1,0,1,0
16720,2587,0,0,146,146,0,1,0,1,0
3091,2938,0,0,62,62,0,1,0,1,0
6938,1147,0,0,66,66,0,1,0,1,0
2830,7,0,0,60,60,0,1,0,1,0
4187,7,0,0,60,60,0,1,0,1,0
19428,242,0,0,145,145,0,1,0,1,0
3386,1888,0,0,62,62,0,1,0,1,0
18466,1017,0,0,66,66,0,1,0,1,0
11450,245,0,0,60,60,0,1,0,1,0
16141,983,0,0,66,66,0,1,0,1,0
360,3105,0,0,928,928,0,1,0,1,0
7335,1072,0,0,60,60,0,1,0,1,0
8882,255,0,0,60,60,0,1,0,1,0
1682,2256,0,0,62,62,0,1,0,1,0
11482,1804,0,0,146,146,0,1,0,1,0
16533,2938,0,0,66,66,0,1,0,1,0
6513,1771,0,0,66,66,0,1,0,1,0
16951,255,0,0,62,62,0,1,0,1,0
16951,255,0,0,62,62,0,1,0,1,0
2972,2636,0,0,146,146,0,1,0,1,0
6935,3216,0,0,66,66,0,1,0,1,0
360,3105,0,0,743,743,0,1,0,1,0
9214,3256,0,0,60,60,0,1,0,1,0
470,2587,0,0,66,66,0,1,0,1,0
22482,2587,0,0,62,62,0,1,0,1,0
4218,1215,0,0,62,62,0,1,0,1,0
21953,1147,0,0,66,66,0,1,0,1,0
18321,1472,0,0,62,62,0,1,0,1,0
8114,2550,0,0,62,62,0,1,0,1,0
3093,1147,0,0,62,62,0,1,0,1,0
21481,2604,0,0,66,66,0,1,0,1,0
10813,2587,0,0,62,62,0,1,0,1,0
16951,255,0,0,62,62,0,1,0,1,0
16951,255,0,0,62,62,0,1,0,1,0
2084,1471,0,0,145,145,0,1,0,1,0
3976,1017,0,0,62,62,0,1,0,1,0
8101,6,0,0,60,60,0,1,0,1,0
360,3105,0,0,1162,1162,0,1,0,1,0
16951,255,0,0,62,62,0,1,0,1,0
21110,1215,0,0,66,66,0,1,0,1,0
3199,2636,0,0,66,66,0,1,0,1,0
272,2486,0,0,62,62,0,1,0,1,0
334,3216,0,0,62,62,0,1,0,1,0
11834,183,0,0,60,60,0,1,0,1,0
15072,167,0,0,146,146,0,1,0,1,0
3807,2610,0,0,60,60,0,1,0,1,0
11916,3216,0,0,145,145,0,1,0,1,0
16390,2256,0,0,66,66,0,1,0,1,0
3735,1936,0,0,74,74,0,1,0,1,0
427,1215,0,0,66,66,0,1,0,1,0
7141,3216,0,0,72,72,0,1,0,1,0
6229,2938,0,0,78,78,0,1,0,1,0
10600,1888,0,0,72,72,0,1,0,1,0
14726,1880,0,0,66,66,0,1,0,1,0
2315,1771,0,0,62,62,0,1,0,1,0
1283,509,0,0,146,146,0,1,0,1,0
11238,2205,0,0,66,66,0,1,0,1,0
4540,1804,0,0,66,66,0,1,0,1,0
6533,1215,0,0,62,62,0,1,0,1,0
17371,2938,0,0,66,66,0,1,0,1,0
2372,509,0,0,62,62,0,1,0,1,0
1268,1224,0,0,60,60,0,1,0,1,0
12,200,0,0,100,100,0,1,0,1,0
9019,1802,0,0,62,62,0,1,0,1,0
985,2938,0,0,66,66,0,1,0,1,0
3031,2611,0,0,62,62,0,1,0,1,0
776,1397,0,0,66,66,0,1,0,1,0
14948,2256,0,0,62,62,0,1,0,1,0
12,2352,0,0,85,85,0,1,0,1,0
2379,1147,0,0,146,146,0,1,0,1,0
7707,697,0,0,62,62,0,1,0,1,0
6556,2587,0,0,62,62,0,1,0,1,0
7213,357,0,0,62,62,0,1,0,1,0
2229,697,0,0,62,62,0,1,0,1,0
19649,509,0,0,66,66,0,1,0,1,0
12925,1827,0,0,66,66,0,1,0,1,0
20013,2611,0,0,72,72,0,1,0,1,0
20641,1771,0,0,62,62,0,1,0,1,0
7038,7,0,0,60,60,0,1,0,1,0
17,2515,0,0,129,129,0,1,0,1,0
21980,509,0,0,146,146,0,1,0,1,0
19,1773,0,0,62,62,0,1,0,1,0
1388,3216,0,0,62,62,0,1,0,1,0
17371,2938,0,0,66,66,0,1,0,1,0
10630,2636,0,0,62,62,0,1,0,1,0
2845,1888,0,0,66,66,0,1,0,1,0
15882,3051,0,0,66,66,0,1,0,1,0
11778,432,0,0,146,146,0,1,0,1,0
11587,1472,0,0,66,66,0,1,0,1,0
2904,2587,0,0,66,66,0,1,0,1,0
16834,509,0,0,66,66,0,1,0,1,0
17,202,0,0,129,129,0,1,0,1,0
14397,3216,0,0,66,66,0,1,0,1,0
17444,1748,0,0,148,148,0,1,0,1,0
18023,2256,0,0,66,66,0,1,0,1,0
6166,1367,0,0,62,62,0,1,0,1,0
17412,1771,0,0,62,62,0,1,0,1,0
1978,1425,0,0,148,148,0,1,0,1,0
8680,3270,0,0,162,162,0,1,0,1,0
4285,1147,0,0,66,66,0,1,0,1,0
3247,3212,0,0,62,62,0,1,0,1,0
19617,2636,0,0,66,66,0,1,0,1,0
14120,1147,0,0,62,62,0,1,0,1,0
9985,1179,0,0,74,74,0,1,0,1,0
191,1215,0,0,62,62,0,1,0,1,0
1718,2256,0,0,146,146,0,1,0,1,0
12347,1,0,0,66,66,0,1,0,1,0
7339,140,0,0,60,60,0,1,0,1,0
2718,1888,0,0,145,145,0,1,0,1,0
10590,2256,0,0,146,146,0,1,0,1,0
13,460,0,0,62,62,0,1,0,1,0
45,308,0,0,62,62,0,1,0,1,0
8592,2938,0,0,62,62,0,1,0,1,0
2840,2587,0,0,62,62,0,1,0,1,0
4593,2256,0,0,66,66,0,1,0,1,0
18,2256,0,0,146,146,0,1,0,1,0
20829,1888,0,0,62,62,0,1,0,1,0
418,2256,0,0,66,66,0,1,0,1,0
15410,1792,0,0,66,66,0,1,0,1,0
595,1215,0,0,62,62,0,1,0,1,0
8063,134,0,0,60,60,0,1,0,1,0
19621,847,0,0,66,66,0,1,0,1,0
20283,983,0,0,62,62,0,1,0,1,0
22152,1804,0,0,62,62,0,1,0,1,0
4488,2144,0,0,62,62,0,1,0,1,0
13884,983,0,0,62,62,0,1,0,1,0
17225,1147,0,0,66,66,0,1,0,1,0
282,1054,0,0,66,66,0,1,0,1,0
360,3105,0,0,928,928,0,1,0,1,0
360,3105,0,0,686,686,0,1,0,1,0
1332,1147,0,0,66,66,0,1,0,1,0
18,3051,0,0,145,145,0,1,0,1,0
14838,2836,0,0,66,66,0,1,0,1,0
12662,1147,0,0,66,66,0,1,0,1,0
2669,2876,0,0,62,62,0,1,0,1,0
15450,1472,0,0,66,66,0,1,0,1,0
711,2938,0,0,66,66,0,1,0,1,0
7988,2256,0,0,62,62,0,1,0,1,0
5151,1888,0,0,146,146,0,1,0,1,0
7957,2587,0,0,62,62,0,1,0,1,0
12809,2573,0,0,66,66,0,1,0,1,0
10227,509,0,0,66,66,0,1,0,1,0
21379,1017,0,0,62,62,0,1,0,1,0
1877,1147,0,0,62,62,0,1,0,1,0
2060,1888,0,0,62,62,0,1,0,1,0
2847,2636,0,0,62,62,0,1,0,1,0
11501,2256,0,0,66,66,0,1,0,1,0
16951,255,0,0,62,62,0,1,0,1,0
17222,2938,0,0,66,66,0,1,0,1,0
16951,255,0,0,62,62,0,1,0,1,0
13767,326,0,0,66,66,0,1,0,1,0
10756,3216,0,0,66,66,0,1,0,1,0
12055,3113,0,0,62,62,0,1,0,1,0
2281,1147,0,0,62,62,0,1,0,1,0
21264,1147,0,0,146,146,0,1,0,1,0
1902,2836,0,0,66,66,0,1,0,1,0
19315,3212,0,0,62,62,0,1,0,1,0
8221,2587,0,0,62,62,0,1,0,1,0
2794,2856,0,0,137,137,0,1,0,1,0
14980,1771,0,0,66,66,0,1,0,1,0
3060,1888,0,0,72,72,0,1,0,1,0
16558,1017,0,0,66,66,0,1,0,1,0
16478,412,0,0,60,60,0,1,0,1,0
2828,2587,0,0,62,62,0,1,0,1,0
12,447,0,0,60,60,0,1,0,1,0
20585,1017,0,0,62,62,0,1,0,1,0
10584,2256,0,0,62,62,0,1,0,1,0
6413,2856,0,0,137,137,0,1,0,1,0
7792,2587,0,0,66,66,0,1,0,1,0
20293,3139,0,0,66,66,0,1,0,1,0
10708,1086,0,0,66,66,0,1,0,1,0
3123,2380,0,0,62,62,0,1,0,1,0
4375,7,0,0,60,60,0,1,0,1,0
7002,1215,0,0,62,62,0,1,0,1,0
17957,2256,0,0,66,66,0,1,0,1,0
12,1596,0,0,89,89,0,1,0,1,0
15495,1425,0,0,107,107,0,1,0,1,0
1601,1771,0,0,62,62,0,1,0,1,0
16951,255,0,0,62,62,0,1,0,1,0
10393,3216,0,0,62,62,0,1,0,1,0
733,1804,0,0,66,66,0,1,0,1,0
13847,1215,0,0,62,62,0,1,0,1,0
6278,2938,0,0,66,66,0,1,0,1,0
12619,1888,0,0,66,66,0,1,0,1,0
10974,2883,0,0,66,66,0,1,0,1,0
372,2636,0,0,66,66,0,1,0,1,0
13773,3212,0,0,66,66,0,1,0,1,0
3443,1888,0,0,62,62,0,1,0,1,0
12268,2256,0,0,66,66,0,1,0,1,0
7509,218,0,0,60,60,0,1,0,1,0
17578,418,0,0,62,62,0,1,0,1,0
9928,2486,0,0,62,62,0,1,0,1,0
17982,1017,0,0,66,66,0,1,0,1,0
778,1888,0,0,146,146,0,1,0,1,0
16951,255,0,0,62,62,0,1,0,1,0
11607,3216,0,0,145,145,0,1,0,1,0
3147,2587,0,0,66,66,0,1,0,1,0
19353,2587,0,0,66,66,0,1,0,1,0
8983,1888,0,0,66,66,0,1,0,1,0
20630,1804,0,0,62,62,0,1,0,1,0
497,653,0,0,220,220,0,1,0,1,0
2677,1763,0,0,62,62,0,1,0,1,0
2589,1202,0,0,159,159,0,1,0,1,0
360,3105,0,0,252,252,0,1,0,1,0
1959,1880,0,0,146,146,0,1,0,1,0
1687,2636,0,0,66,66,0,1,0,1,0
14191,2587,0,0,66,66,0,1,0,1,0
18053,2256,0,0,66,66,0,1,0,1,0
1133,2938,0,0,78,78,0,1,0,1,0
6451,2938,0,0,62,62,0,1,0,1,0
14479,3139,0,0,66,66,0,1,0,1,0
704,1147,0,0,66,66,0,1,0,1,0
612,225,0,0,60,60,0,1,0,1,0
2891,3216,0,0,66,66,0,1,0,1,0
4868,2587,0,0,62,62,0,1,0,1,0
16951,255,0,0,62,62,0,1,0,1,0
6233,1646,0,0,60,60,0,1,0,1,0
8171,1073,0,0,60,60,0,1,0,1,0
493,274,0,0,145,145,0,1,0,1,0
16951,255,0,0,62,62,0,1,0,1,0
16885,983,0,0,66,66,0,1,0,1,0
12978,1147,0,0,66,66,0,1,0,1,0
20497,2636,0,0,66,66,0,1,0,1,0
12,3074,0,0,320,320,0,1,0,1,0
17469,509,0,0,62,62,0,1,0,1,0
16951,255,0,0,62,62,0,1,0,1,0
7131,2587,0,0,62,62,0,1,0,1,0
28,3216,0,0,62,62,0,1,0,1,0
20958,1202,0,0,159,159,0,1,0,1,0
8250,3145,0,0,148,148,0,1,0,1,0
21262,1147,0,0,62,62,0,1,0,1,0
16951,255,0,0,62,62,0,1,0,1,0
16951,255,0,0,62,62,0,1,0,1,0
134,7,0,0,60,60,0,1,0,1,0
4240,2432,0,0,146,146,0,1,0,1,0
5301,1147,0,0,62,62,0,1,0,1,0
7273,1888,0,0,62,62,0,1,0,1,0
364,280,0,0,66,66,0,1,0,1,0
3467,242,0,0,146,146,0,1,0,1,0
13317,509,0,0,66,66,0,1,0,1,0
19573,509,0,0,66,66,0,1,0,1,0
21025,1888,0,0,66,66,0,1,0,1,0
9102,2938,0,0,66,66,0,1,0,1,0
10475,6,0,0,60,60,0,1,0,1,0
15470,510,0,0,66,66,0,1,0,1,0
4885,509,0,0,62,62,0,1,0,1,0
18489,2938,0,0,62,62,0,1,0,1,0
20283,983,0,0,66,66,0,1,0,1,0
7119,1147,0,0,62,62,0,1,0,1,0
12493,3216,0,0,62,62,0,1,0,1,0
360,3105,0,0,174,174,0,1,0,1,0
16951,255,0,0,62,62,0,1,0,1,0
1931,1771,0,0,146,146,0,1,0,1,0
16444,2881,0,0,90,90,0,1,0,1,0
19278,1147,0,0,66,66,0,1,0,1,0
12,2784,0,0,82,82,0,1,0,1,0
4469,7,0,0,60,60,0,1,0,1,0
3258,7,0,0,60,60,0,1,0,1,0
6677,797,0,0,62,62,0,1,0,1,0
564,2256,0,0,62,62,0,1,0,1,0
360,3105,0,0,68,68,0,1,0,1,0
10046,2636,0,0,66,66,0,1,0,1,0
14446,2695,0,0,62,62,0,1,0,1,0
18151,1147,0,0,66,66,0,1,0,1,0
1253,7,0,0,60,60,0,1,0,1,0
5011,2477,0,0,60,60,0,1,0,1,0
5402,899,0,0,62,62,0,1,0,1,0
14228,6,0,0,60,60,0,1,0,1,0
20179,544,0,0,66,66,0,1,0,1,0
21166,1017,0,0,62,62,0,1,0,1,0
1839,983,0,0,62,62,0,1,0,1,0
1623,3216,0,0,62,62,0,1,0,1,0
17542,2938,0,0,74,74,0,1,0,1,0
10293,2883,0,0,66,66,0,1,0,1,0
16951,255,0,0,62,62,0,1,0,1,0
9226,3216,0,0,66,66,0,1,0,1,0
4453,2883,0,0,146,146,0,1,0,1,0
2319,1215,0,0,62,62,0,1,0,1,0
10895,3117,0,0,66,66,0,1,0,1,0
16849,1936,0,0,66,66,0,1,0,1,0
18359,1472,0,0,62,62,0,1,0,1,0
17480,3139,0,0,66,66,0,1,0,1,0
10346,674,0,0,100,100,0,1,0,1,0
754,155,0,0,66,66,0,1,0,1,0
165,2205,0,0,62,62,0,1,0,1,0
16951,255,0,0,62,62,0,1,0,1,0
16951,255,0,0,62,62,0,1,0,1,0
16978,2205,0,0,66,66,0,1,0,1,0
1512,2938,0,0,62,62,0,1,0,1,0
18970,1017,0,0,66,66,0,1,0,1,0
118,2587,0,0,62,62,0,1,0,1,0
20456,2256,0,0,66,66,0,1,0,1,0
16951,255,0,0,62,62,0,1,0,1,0
2143,155,0,0,66,66,0,1,0,1,0
1131,2938,0,0,62,62,0,1,0,1,0
10380,1147,0,0,62,62,0,1,0,1,0
16990,509,0,0,66,66,0,1,0,1,0
15572,1147,0,0,62,62,0,1,0,1,0
1878,2256,0,0,146,146,0,1,0,1,0
16427,2256,0,0,62,62,0,1,0,1,0
13337,1215,0,0,62,62,0,1,0,1,0
12,1080,0,0,74,74,0,1,0,1,0
3876,1923,0,0,62,62,0,1,0,1,0
691,1967,0,0,74,74,0,1,0,1,0
8,1873,0,0,60,60,0,1,0,1,0
6229,2938,0,0,78,78,0,1,0,1,0
698,2256,0,0,66,66,0,1,0,1,0
9273,6,0,0,60,60,0,1,0,1,0
309,2486,0,0,66,66,0,1,0,1,0
18525,2438,0,0,148,148,0,1,0,1,0
2996,2573,0,0,62,62,0,1,0,1,0
295,1771,0,0,66,66,0,1,0,1,0
12854,1147,0,0,146,146,0,1,0,1,0
16780,2883,0,0,66,66,0,1,0,1,0
88,3216,0,0,66,66,0,1,0,1,0
1810,1539,0,0,62,62,0,1,0,1,0
636,280,0,0,62,62,0,1,0,1,0
2593,145,0,0,148,148,0,1,0,1,0
10896,1017,0,0,62,62,0,1,0,1,0
2975,1771,0,0,66,66,0,1,0,1,0
7390,1147,0,0,62,62,0,1,0,1,0
16951,255,0,0,62,62,0,1,0,1,0
11356,1215,0,0,66,66,0,1,0,1,0
2452,2587,0,0,62,62,0,1,0,1,0
16951,255,0,0,62,62,0,1,0,1,0
17561,2636,0,0,66,66,0,1,0,1,0
14505,2312,0,0,78,78,0,1,0,1,0
2038,1771,0,0,146,146,0,1,0,1,0
15896,2587,0,0,66,66,0,1,0,1,0
1263,1147,0,0,62,62,0,1,0,1,0
1753,509,0,0,66,66,0,1,0,1,0
1359,2256,0,0,146,146,0,1,0,1,0
20179,544,0,0,66,66,0,1,0,1,0
16951,255,0,0,62,62,0,1,0,1,0
10653,983,0,0,66,66,0,1,0,1,0
5888,3216,0,0,145,145,0,1,0,1,0
3207,1888,0,0,62,62,0,1,0,1,0
22701,2256,0,0,66,66,0,1,0,1,0
804,2587,0,0,66,66,0,1,0,1,0
1281,2543,0,0,60,60,0,1,0,1,0
5327,1888,0,0,62,62,0,1,0,1,0
776,1397,0,0,66,66,0,1,0,1,0
20067,1888,0,0,62,62,0,1,0,1,0
12,3146,0,0,332,332,0,1,0,1,0
758,3216,0,0,62,62,0,1,0,1,0
7339,140,0,0,60,60,0,1,0,1,0
16877,1482,0,0,62,62,0,1,0,1,0
9444,1888,0,0,66,66,0,1,0,1,0
6263,1017,0,0,66,66,0,1,0,1,0
1289,1771,0,0,66,66,0,1,0,1,0
2807,2256,0,0,62,62,0,1,0,1,0
22091,1215,0,0,62,62,0,1,0,1,0
639,409,0,0,143,143,0,1,0,1,0
14455,3139,0,0,66,66,0,1,0,1,0
2844,2938,0,0,62,62,0,1,0,1,0
13443,2587,0,0,66,66,0,1,0,1,0
16678,2205,0,0,66,66,0,1,0,1,0
7335,1070,0,0,60,60,0,1,0,1,0
103,562,0,0,62,62,0,1,0,1,0
16951,255,0,0,62,62,0,1,0,1,0
16951,255,0,0,62,62,0,1,0,1,0
2969,1804,0,0,66,66,0,1,0,1,0
3250,2820,0,0,145,145,0,1,0,1,0
11823,1888,0,0,66,66,0,1,0,1,0
846,7,0,0,60,60,0,1,0,1,0
111,3139,0,0,62,62,0,1,0,1,0
7283,3216,0,0,62,62,0,1,0,1,0
1932,2256,0,0,66,66,0,1,0,1,0
12655,2256,0,0,66,66,0,1,0,1,0
823,2679,0,0,60,60,0,1,0,1,0
10775,2938,0,0,62,62,0,1,0,1,0
663,1888,0,0,66,66,0,1,0,1,0
9079,1771,0,0,62,62,0,1,0,1,0
1669,1147,0,0,62,62,0,1,0,1,0
12227,1215,0,0,62,62,0,1,0,1,0
10448,2883,0,0,62,62,0,1,0,1,0
5761,697,0,0,74,74,0,1,0,1,0
820,146,0,0,60,60,0,1,0,1,0
13803,308,0,0,66,66,0,1,0,1,0
7056,2938,0,0,66,66,0,1,0,1,0
14043,1147,0,0,66,66,0,1,0,1,0
10952,2256,0,0,66,66,0,1,0,1,0
17542,2938,0,0,74,74,0,1,0,1,0
448,7,0,0,60,60,0,1,0,1,0
16951,255,0,0,62,62,0,1,0,1,0
636,280,0,0,62,62,0,1,0,1,0
685,2587,0,0,62,62,0,1,0,1,0
2604,1888,0,0,66,66,0,1,0,1,0
4370,3216,0,0,62,62,0,1,0,1,0
12096,2587,0,0,66,66,0,1,0,1,0
2558,2581,0,0,146,146,0,1,0,1,0
16951,255,0,0,62,62,0,1,0,1,0
12083,1771,0,0,66,66,0,1,0,1,0
15021,509,0,0,62,62,0,1,0,1,0
6576,2587,0,0,146,146,0,1,0,1,0
2097,1888,0,0,62,62,0,1,0,1,0
3021,1472,0,0,66,66,0,1,0,1,0
6609,1771,0,0,62,62,0,1,0,1,0
2548,3159,0,0,60,60,0,1,0,1,0
12,1380,0,0,82,82,0,1,0,1,0
612,378,0,0,60,60,0,1,0,1,0
17919,1017,0,0,62,62,0,1,0,1,0
17984,2256,0,0,66,66,0,1,0,1,0
15032,1888,0,0,62,62,0,1,0,1,0
12,2461,0,0,81,81,0,1,0,1,0
16050,2256,0,0,66,66,0,1,0,1,0
16529,2587,0,0,66,66,0,1,0,1,0
1842,2587,0,0,62,62,0,1,0,1,0
22510,2611,0,0,78,78,0,1,0,1,0
299,2953,0,0,66,66,0,1,0,1,0
2628,3216,0,0,66,66,0,1,0,1,0
658,491,0,0,143,143,0,1,0,1,0
6815,3216,0,0,62,62,0,1,0,1,0
6448,2883,0,0,62,62,0,1,0,1,0
2509,1147,0,0,62,62,0,1,0,1,0
5699,2938,0,0,74,74,0,1,0,1,0
10784,847,0,0,62,62,0,1,0,1,0
2303,437,0,0,62,62,0,1,0,1,0
12,658,0,0,100,100,0,1,0,1,0
17319,1147,0,0,66,66,0,1,0,1,0
232,1771,0,0,66,66,0,1,0,1,0
2084,1471,0,0,145,145,0,1,0,1,0
8171,1073,0,0,60,60,0,1,0,1,0
12949,3216,0,0,66,66,0,1,0,1,0
16272,1017,0,0,146,146,0,1,0,1,0
19269,3216,0,0,66,66,0,1,0,1,0
8276,2023,0,0,161,161,0,1,0,1,0
577,2611,0,0,78,78,0,1,0,1,0
15517,1792,0,0,62,62,0,1,0,1,0
16951,255,0,0,62,62,0,1,0,1,0
1804,1130,0,0,60,60,0,1,0,1,0
263,1771,0,0,66,66,0,1,0,1,0
7988,2256,0,0,62,62,0,1,0,1,0
19408,1880,0,0,66,66,0,1,0,1,0
1829,2938,0,0,145,145,0,1,0,1,0
1884,509,0,0,62,62,0,1,0,1,0
20811,2953,0,0,62,62,0,1,0,1,0
3056,233,0,0,148,148,0,1,0,1,0
9243,1224,0,0,62,62,0,1,0,1,0
1865,1017,0,0,66,66,0,1,0,1,0
2383,1888,0,0,62,62,0,1,0,1,0
2499,1472,0,0,66,66,0,1,0,1,0
297,2256,0,0,78,78,0,1,0,1,0
8164,2727,0,0,60,60,0,1,0,1,0
6552,2093,0,0,145,145,0,1,0,1,0
6761,5,0,0,60,60,0,1,0,1,0
1,2440,0,0,62,62,0,1,0,1,0
1773,2883,0,0,62,62,0,1,0,1,0
1330,697,0,0,62,62,0,1,0,1,0
2965,2587,0,0,66,66,0,1,0,1,0
18,1147,0,0,62,62,0,1,0,1,0
3871,2610,0,0,62,62,0,1,0,1,0
20755,1147,0,0,66,66,0,1,0,1,0
16261,1888,0,0,66,66,0,1,0,1,0
6056,1202,0,0,145,145,0,1,0,1,0
21381,3216,0,0,62,62,0,1,0,1,0
10689,1215,0,0,62,62,0,1,0,1,0
19590,2256,0,0,66,66,0,1,0,1,0
18486,1771,0,0,62,62,0,1,0,1,0
16951,255,0,0,62,62,0,1,0,1,0
12516,1795,0,0,60,60,0,1,0,1,0
6761,5,0,0,60,60,0,1,0,1,0
3001,357,0,0,62,62,0,1,0,1,0
3386,1888,0,0,62,62,0,1,0,1,0
8164,2726,0,0,60,60,0,1,0,1,0
5081,2611,0,0,62,62,0,1,0,1,0
1975,2241,0,0,62,62,0,1,0,1,0
20216,1771,0,0,66,66,0,1,0,1,0
2756,459,0,0,62,62,0,1,0,1,0
7502,3216,0,0,145,145,0,1,0,1,0
16951,255,0,0,62,62,0,1,0,1,0
15516,2256,0,0,62,62,0,1,0,1,0
15784,2636,0,0,66,66,0,1,0,1,0
1869,2104,0,0,143,143,0,1,0,1,0
2548,2237,0,0,60,60,0,1,0,1,0
20254,1590,0,0,109,109,0,1,0,1,0
19343,804,0,0,66,66,0,1,0,1,0
2383,1888,0,0,62,62,0,1,0,1,0
7335,1070,0,0,60,60,0,1,0,1,0
7273,1888,0,0,62,62,0,1,0,1,0
1142,1215,0,0,62,62,0,1,0,1,0
10154,1472,0,0,66,66,0,1,0,1,0
410,1771,0,0,66,66,0,1,0,1,0
1946,1147,0,0,62,62,0,1,0,1,0
12,2764,0,0,60,60,0,1,0,1,0
10506,167,0,0,100,100,0,1,0,1,0
16951,255,0,0,62,62,0,1,0,1,0
6395,1215,0,0,62,62,0,1,0,1,0
12870,1804,0,0,66,66,0,1,0,1,0
1628,3216,0,0,145,145,0,1,0,1,0
16951,255,0,0,62,62,0,1,0,1,0
21834,1147,0,0,66,66,0,1,0,1,0
16951,255,0,0,62,62,0,1,0,1,0
7339,237,0,0,60,60,0,1,0,1,0
21620,1017,0,0,66,66,0,1,0,1,0
3735,1936,0,0,74,74,0,1,0,1,0
414,3188,0,0,66,66,0,1,0,1,0
4057,6,0,0,60,60,0,1,0,1,0
2380,2256,0,0,62,62,0,1,0,1,0
16256,1482,0,0,66,66,0,1,0,1,0
6294,1017,0,0,62,62,0,1,0,1,0
5423,1017,0,0,66,66,0,1,0,1,0
3871,2610,0,0,62,62,0,1,0,1,0
10300,1215,0,0,66,66,0,1,0,1,0
240,2205,0,0,62,62,0,1,0,1,0
744,2587,0,0,62,62,0,1,0,1,0
22200,2573,0,0,66,66,0,1,0,1,0
15894,3216,0,0,66,66,0,1,0,1,0
3193,2852,0,0,62,62,0,1,0,1,0
17273,1888,0,0,66,66,0,1,0,1,0
17822,2938,0,0,62,62,0,1,0,1,0
1758,2256,0,0,66,66,0,1,0,1,0
7425,3216,0,0,62,62,0,1,0,1,0
16951,255,0,0,62,62,0,1,0,1,0
4481,1147,0,0,146,146,0,1,0,1,0
19937,1054,0,0,66,66,0,1,0,1,0
612,21,0,0,60,60,0,1,0,1,0
2598,1017,0,0,62,62,0,1,0,1,0
5266,2636,0,0,146,146,0,1,0,1,0
12483,1147,0,0,62,62,0,1,0,1,0
3905,3,0,0,60,60,0,1,0,1,0
6761,5,0,0,60,60,0,1,0,1,0
7719,2834,0,0,146,146,0,1,0,1,0
21908,1797,0,0,66,66,0,1,0,1,0
17575,2636,0,0,62,62,0,1,0,1,0
6506,697,0,0,62,62,0,1,0,1,0
12145,255,0,0,60,60,0,1,0,1,0
1789,2883,0,0,62,62,0,1,0,1,0
276,9,0,0,60,60,0,1,0,1,0
12067,1215,0,0,62,62,0,1,0,1,0
20088,983,0,0,66,66,0,1,0,1,0
496,1317,0,0,66,66,0,1,0,1,0
5040,2636,0,0,62,62,0,1,0,1,0
5670,1147,0,0,66,66,0,1,0,1,0
5267,155,0,0,62,62,0,1,0,1,0
2354,2747,0,0,66,66,0,1,0,1,0
19034,1147,0,0,62,62,0,1,0,1,0
13794,104,0,0,60,60,0,1,0,1,0
360,3105,0,0,164,164,0,1,0,1,0
2429,2883,0,0,66,66,0,1,0,1,0
16951,255,0,0,62,62,0,1,0,1,0
2544,1771,0,0,146,146,0,1,0,1,0
19667,1771,0,0,66,66,0,1,0,1,0
12203,1763,0,0,66,66,0,1,0,1,0
7273,1888,0,0,62,62,0,1,0,1,0
497,508,0,0,66,66,0,1,0,1,0
5033,1017,0,0,62,62,0,1,0,1,0
210,1147,0,0,146,146,0,1,0,1,0
16951,255,0,0,62,62,0,1,0,1,0
7949,314,0,0,60,60,0,1,0,1,0
10387,3216,0,0,62,62,0,1,0,1,0
2630,1287,0,0,66,66,0,1,0,1,0
2579,2573,0,0,62,62,0,1,0,1,0
2098,24,0,0,60,60,0,1,0,1,0
1254,1590,0,0,66,66,0,1,0,1,0
14505,2312,0,0,78,78,0,1,0,1,0
19057,1888,0,0,62,62,0,1,0,1,0
11677,2636,0,0,66,66,0,1,0,1,0
16951,255,0,0,62,62,0,1,0,1,0
13643,2573,0,0,66,66,0,1,0,1,0
1655,1906,0,0,146,146,0,1,0,1,0
1359,2256,0,0,62,62,0,1,0,1,0
19858,2154,0,0,66,66,0,1,0,1,0
1916,7,0,0,60,60,0,1,0,1,0
636,280,0,0,146,146,0,1,0,1,0
21,509,0,0,62,62,0,1,0,1,0
12621,1888,0,0,62,62,0,1,0,1,0
5784,2587,0,0,146,146,0,1,0,1,0
12,3227,0,0,131,131,0,1,0,1,0
1980,2144,0,0,145,145,0,1,0,1,0
1809,2883,0,0,146,146,0,1,0,1,0
16951,255,0,0,62,62,0,1,0,1,0
1302,2953,0,0,62,62,0,1,0,1,0
19314,2938,0,0,66,66,0,1,0,1,0
20340,1147,0,0,62,62,0,1,0,1,0
577,2611,0,0,78,78,0,1,0,1,0
11572,427,0,0,62,62,0,1,0,1,0
446,1880,0,0,62,62,0,1,0,1,0
4206,1771,0,0,62,62,0,1,0,1,0
12825,2938,0,0,66,66,0,1,0,1,0
16839,697,0,0,146,146,0,1,0,1,0
8680,1942,0,0,162,162,0,1,0,1,0
2543,1795,0,0,62,62,0,1,0,1,0
2985,1147,0,0,146,146,0,1,0,1,0
3159,1472,0,0,62,62,0,1,0,1,0
1360,1472,0,0,62,62,0,1,0,1,0
13012,1804,0,0,62,62,0,1,0,1,0
1876,465,0,0,159,159,0,1,0,1,0
16951,255,0,0,62,62,0,1,0,1,0
10487,2695,0,0,100,100,0,1,0,1,0
12946,2953,0,0,66,66,0,1,0,1,0
19718,2486,0,0,66,66,0,1,0,1,0
2515,2938,0,0,62,62,0,1,0,1,0
14194,3216,0,0,66,66,0,1,0,1,0
9214,3256,0,0,60,60,0,1,0,1,0
28,3216,0,0,62,62,0,1,0,1,0
360,3105,0,0,1288,1288,0,1,0,1,0
10295,1888,0,0,66,66,0,1,0,1,0
21,2953,0,0,146,146,0,1,0,1,0
19840,2256,0,0,66,66,0,1,0,1,0
3894,697,0,0,62,62,0,1,0,1,0
19798,1482,0,0,146,146,0,1,0,1,0
128,391,0,0,145,145,0,1,0,1,0
16951,255,0,0,62,62,0,1,0,1,0
2763,1017,0,0,146,146,0,1,0,1,0
20585,1017,0,0,62,62,0,1,0,1,0
9630,2883,0,0,66,66,0,1,0,1,0
7028,1830,0,0,148,148,0,1,0,1,0
1354,2611,0,0,66,66,0,1,0,1,0
6233,1646,0,0,60,60,0,1,0,1,0
13320,1215,0,0,66,66,0,1,0,1,0
612,26,0,0,60,60,0,1,0,1,0
2379,1147,0,0,62,62,0,1,0,1,0
4014,1147,0,0,146,146,0,1,0,1,0
13304,1147,0,0,66,66,0,1,0,1,0
541,1804,0,0,66,66,0,1,0,1,0
3001,357,0,0,62,62,0,1,0,1,0
2242,7,0,0,60,60,0,1,0,1,0
0,0,0,0,70,70,0,1,0,1,0
132,1472,0,0,62,62,0,1,0,1,0
15630,2587,0,0,62,62,0,1,0,1,0
2148,3216,0,0,145,145,0,1,0,1,0
13951,2256,0,0,66,66,0,1,0,1,0
17570,1771,0,0,66,66,0,1,0,1,0
12606,2636,0,0,62,62,0,1,0,1,0
6805,280,0,0,146,146,0,1,0,1,0
3443,1888,0,0,62,62,0,1,0,1,0
2280,1147,0,0,62,62,0,1,0,1,0
152,3216,0,0,66,66,0,1,0,1,0
7626,2604,0,0,62,62,0,1,0,1,0
4091,1017,0,0,66,66,0,1,0,1,0
1651,1147,0,0,146,146,0,1,0,1,0
2662,2938,0,0,66,66,0,1,0,1,0
3001,357,0,0,62,62,0,1,0,1,0
6952,1539,0,0,146,146,0,1,0,1,0
8171,1073,0,0,60,60,0,1,0,1,0
1973,2883,0,0,66,66,0,1,0,1,0
5767,2938,0,0,62,62,0,1,0,1,0
8581,1017,0,0,66,66,0,1,0,1,0
844,2498,0,0,146,146,0,1,0,1,0
2187,6,0,0,60,60,0,1,0,1,0
1932,2256,0,0,66,66,0,1,0,1,0
18235,1215,0,0,62,62,0,1,0,1,0
10293,2883,0,0,62,62,0,1,0,1,0
555,2205,0,0,62,62,0,1,0,1,0
1539,2938,0,0,62,62,0,1,0,1,0
1131,2938,0,0,62,62,0,1,0,1,0
5784,2587,0,0,62,62,0,1,0,1,0
22201,2836,0,0,66,66,0,1,0,1,0
2423,1017,0,0,62,62,0,1,0,1,0
10845,2611,0,0,74,74,0,1,0,1,0
1213,2695,0,0,62,62,0,1,0,1,0
1620,2883,0,0,146,146,0,1,0,1,0
14582,1147,0,0,62,62,0,1,0,1,0
5436,2587,0,0,62,62,0,1,0,1,0
16951,255,0,0,62,62,0,1,0,1,0
3462,3125,0,0,145,145,0,1,0,1,0
11602,1804,0,0,62,62,0,1,0,1,0
12299,1017,0,0,146,146,0,1,0,1,0
636,1202,0,0,157,157,0,1,0,1,0
6708,1017,0,0,66,66,0,1,0,1,0
615,250,0,0,60,60,0,1,0,1,0
13952,3216,0,0,66,66,0,1,0,1,0
260,2636,0,0,62,62,0,1,0,1,0
3850,1147,0,0,62,62,0,1,0,1,0
8788,2587,0,0,62,62,0,1,0,1,0
18704,2953,0,0,66,66,0,1,0,1,0
16444,2881,0,0,90,90,0,1,0,1,0
2276,1147,0,0,66,66,0,1,0,1,0
2407,1215,0,0,62,62,0,1,0,1,0
22591,1804,0,0,66,66,0,1,0,1,0
9622,2636,0,0,66,66,0,1,0,1,0
7883,2636,0,0,66,66,0,1,0,1,0
20013,2587,0,0,66,66,0,1,0,1,0
20552,3216,0,0,66,66,0,1,0,1,0
319,2256,0,0,62,62,0,1,0,1,0
7857,1147,0,0,146,146,0,1,0,1,0
10401,2256,0,0,62,62,0,1,0,1,0
1804,2513,0,0,60,60,0,1,0,1,0
18466,1017,0,0,66,66,0,1,0,1,0
22412,2953,0,0,62,62,0,1,0,1,0
286,1147,0,0,66,66,0,1,0,1,0
10895,3117,0,0,66,66,0,1,0,1,0
9603,3139,0,0,66,66,0,1,0,1,0
496,982,0,0,66,66,0,1,0,1,0
5705,1100,0,0,74,74,0,1,0,1,0
14061,1906,0,0,66,66,0,1,0,1,0
2084,1471,0,0,145,145,0,1,0,1,0
11450,245,0,0,60,60,0,1,0,1,0
14862,3265,0,0,142,142,0,1,0,1,0
16951,255,0,0,62,62,0,1,0,1,0
15189,1147,0,0,66,66,0,1,0,1,0
1264,2256,0,0,66,66,0,1,0,1,0
12342,1880,0,0,66,66,0,1,0,1,0
7335,1070,0,0,60,60,0,1,0,1,0
9407,3216,0,0,66,66,0,1,0,1,0
13074,181,0,0,60,60,0,1,0,1,0
823,1424,0,0,60,60,0,1,0,1,0
20428,983,0,0,66,66,0,1,0,1,0
1533,1017,0,0,62,62,0,1,0,1,0
18741,1086,0,0,66,66,0,1,0,1,0
62,1888,0,0,62,62,0,1,0,1,0
12132,2938,0,0,74,74,0,1,0,1,0
7476,1771,0,0,66,66,0,1,0,1,0
17740,1888,0,0,62,62,0,1,0,1,0
1252,3216,0,0,62,62,0,1,0,1,0
16951,255,0,0,62,62,0,1,0,1,0
12903,1215,0,0,62,62,0,1,0,1,0
17898,2883,0,0,66,66,0,1,0,1,0
3180,1771,0,0,66,66,0,1,0,1,0
9559,3216,0,0,66,66,0,1,0,1,0
16951,255,0,0,62,62,0,1,0,1,0
16951,255,0,0,62,62,0,1,0,1,0
2668,1017,0,0,146,146,0,1,0,1,0
10081,2353,0,0,62,62,0,1,0,1,0
17670,3212,0,0,66,66,0,1,0,1,0
3781,1054,0,0,62,62,0,1,0,1,0
12,2568,0,0,331,331,0,1,0,1,0
22152,1804,0,0,62,62,0,1,0,1,0
21816,2587,0,0,62,62,0,1,0,1,0
8171,1073,0,0,60,60,0,1,0,1,0
16951,255,0,0,62,62,0,1,0,1,0
1692,2587,0,0,62,62,0,1,0,1,0
22608,2256,0,0,66,66,0,1,0,1,0
11337,1017,0,0,62,62,0,1,0,1,0
4954,2611,0,0,62,62,0,1,0,1,0
11596,1804,0,0,66,66,0,1,0,1,0
2108,797,0,0,62,62,0,1,0,1,0
694,1147,0,0,62,62,0,1,0,1,0
1230,983,0,0,62,62,0,1,0,1,0
10933,1215,0,0,62,62,0,1,0,1,0
7038,1215,0,0,62,62,0,1,0,1,0
338,1771,0,0,66,66,0,1,0,1,0
10223,2587,0,0,66,66,0,1,0,1,0
12,1768,0,0,66,66,0,1,0,1,0
2822,7,0,0,60,60,0,1,0,1,0
5699,2938,0,0,74,74,0,1,0,1,0
16439,1147,0,0,62,62,0,1,0,1,0
13089,1017,0,0,66,66,0,1,0,1,0
12532,2235,0,0,66,66,0,1,0,1,0
11133,2747,0,0,66,66,0,1,0,1,0
2171,1539,0,0,146,146,0,1,0,1,0
1203,1880,0,0,66,66,0,1,0,1,0
11354,3212,0,0,62,62,0,1,0,1,0
2141,1888,0,0,62,62,0,1,0,1,0
2319,1215,0,0,62,62,0,1,0,1,0
3126,1685,0,0,145,145,0,1,0,1,0
21743,427,0,0,62,62,0,1,0,1,0
16951,255,0,0,62,62,0,1,0,1,0
2430,2938,0,0,62,62,0,1,0,1,0
16951,255,0,0,62,62,0,1,0,1,0
19545,1771,0,0,66,66,0,1,0,1,0
15882,1888,0,0,62,62,0,1,0,1,0
510,1771,0,0,66,66,0,1,0,1,0
16477,1017,0,0,66,66,0,1,0,1,0
571,2824,0,0,74,74,0,1,0,1,0
1679,1147,0,0,62,62,0,1,0,1,0
5726,1094,0,0,146,146,0,1,0,1,0
0,0,0,0,98,98,0,1,0,1,0
10896,1017,0,0,66,66,0,1,0,1,0
1351,2938,0,0,66,66,0,1,0,1,0
6459,1215,0,0,62,62,0,1,0,1,0
10301,697,0,0,66,66,0,1,0,1,0
11133,2747,0,0,66,66,0,1,0,1,0
21399,1147,0,0,62,62,0,1,0,1,0
1547,2636,0,0,146,146,0,1,0,1,0
16171,1367,0,0,60,60,0,1,0,1,0
5286,7,0,0,60,60,0,1,0,1,0
16727,178,0,0,60,60,0,1,0,1,0
7547,2953,0,0,66,66,0,1,0,1,0
19718,2486,0,0,62,62,0,1,0,1,0
4177,7,0,0,60,60,0,1,0,1,0
11930,2883,0,0,66,66,0,1,0,1,0
16951,255,0,0,62,62,0,1,0,1,0
12570,1888,0,0,66,66,0,1,0,1,0
149,3139,0,0,66,66,0,1,0,1,0
1311,1017,0,0,62,62,0,1,0,1,0
639,1471,0,0,143,143,0,1,0,1,0
1039,2636,0,0,66,66,0,1,0,1,0
1912,1472,0,0,62,62,0,1,0,1,0
1281,2543,0,0,60,60,0,1,0,1,0
22010,2205,0,0,66,66,0,1,0,1,0
12,1380,0,0,82,82,0,1,0,1,0
0,0,0,0,98,98,0,1,0,1,0
636,1202,0,0,143,143,0,1,0,1,0
15263,1147,0,0,62,62,0,1,0,1,0
20428,983,0,0,66,66,0,1,0,1,0
13129,2256,0,0,66,66,0,1,0,1,0
14844,2256,0,0,66,66,0,1,0,1,0
6181,1771,0,0,62,62,0,1,0,1,0
19776,1017,0,0,66,66,0,1,0,1,0
1292,2486,0,0,140,140,0,1,0,1,0
3465,242,0,0,145,145,0,1,0,1,0
680,697,0,0,66,66,0,1,0,1,0
7555,196,0,0,60,60,0,1,0,1,0
6816,1017,0,0,62,62,0,1,0,1,0
6506,697,0,0,62,62,0,1,0,1,0
612,183,0,0,60,60,0,1,0,1,0
15726,2587,0,0,62,62,0,1,0,1,0
17480,3139,0,0,62,62,0,1,0,1,0
4967,1026,0,0,60,60,0,1,0,1,0
19288,2587,0,0,62,62,0,1,0,1,0
16989,847,0,0,66,66,0,1,0,1,0
20833,2824,0,0,66,66,0,1,0,1,0
16951,255,0,0,62,62,0,1,0,1,0
16904,983,0,0,66,66,0,1,0,1,0
5579,7,0,0,60,60,0,1,0,1,0
4383,1771,0,0,62,62,0,1,0,1,0
8093,2256,0,0,146,146,0,1,0,1,0
8038,2953,0,0,62,62,0,1,0,1,0
20183,1147,0,0,62,62,0,1,0,1,0
2833,1888,0,0,62,62,0,1,0,1,0
2726,1215,0,0,62,62,0,1,0,1,0
823,1209,0,0,60,60,0,1,0,1,0
1236,2256,0,0,62,62,0,1,0,1,0
1679,1147,0,0,62,62,0,1,0,1,0
16099,2883,0,0,66,66,0,1,0,1,0
114,1017,0,0,62,62,0,1,0,1,0
2845,1888,0,0,66,66,0,1,0,1,0
14601,1017,0,0,66,66,0,1,0,1,0
433,1224,0,0,60,60,0,1,0,1,0
11260,2573,0,0,66,66,0,1,0,1,0
5544,2938,0,0,62,62,0,1,0,1,0
8756,2938,0,0,78,78,0,1,0,1,0
636,2820,0,0,143,143,0,1,0,1,0
1526,775,0,0,62,62,0,1,0,1,0
10427,1017,0,0,62,62,0,1,0,1,0
15793,2747,0,0,62,62,0,1,0,1,0
14675,7,0,0,60,60,0,1,0,1,0
4813,1086,0,0,146,146,0,1,0,1,0
1381,1472,0,0,146,146,0,1,0,1,0
788,2382,0,0,62,62,0,1,0,1,0
4041,2256,0,0,146,146,0,1,0,1,0
3260,1017,0,0,66,66,0,1,0,1,0
18267,697,0,0,66,66,0,1,0,1,0
2084,1471,0,0,145,145,0,1,0,1,0
1471,2144,0,0,62,62,0,1,0,1,0
3087,2256,0,0,62,62,0,1,0,1,0
3318,1888,0,0,66,66,0,1,0,1,0
1855,1,0,0,62,62,0,1,0,1,0
1423,1888,0,0,62,62,0,1,0,1,0
8810,1472,0,0,66,66,0,1,0,1,0
18957,3216,0,0,66,66,0,1,0,1,0
18321,2379,0,0,66,66,0,1,0,1,0
19349,983,0,0,62,62,0,1,0,1,0
19104,1888,0,0,66,66,0,1,0,1,0
21132,1827,0,0,66,66,0,1,0,1,0
20918,1771,0,0,66,66,0,1,0,1,0
317,2587,0,0,62,62,0,1,0,1,0
9208,1017,0,0,62,62,0,1,0,1,0
19612,1771,0,0,66,66,0,1,0,1,0
2793,2636,0,0,66,66,0,1,0,1,0
13793,509,0,0,66,66,0,1,0,1,0
20137,1880,0,0,66,66,0,1,0,1,0
7949,315,0,0,60,60,0,1,0,1,0
1620,2883,0,0,62,62,0,1,0,1,0
536,3216,0,0,145,145,0,1,0,1,0
11173,1880,0,0,66,66,0,1,0,1,0
8164,2729,0,0,60,60,0,1,0,1,0
2127,2938,0,0,62,62,0,1,0,1,0
4494,2636,0,0,62,62,0,1,0,1,0
2084,1471,0,0,145,145,0,1,0,1,0
52,3252,0,0,146,146,0,1,0,1,0
617,1888,0,0,66,66,0,1,0,1,0
14030,2235,0,0,66,66,0,1,0,1,0
5535,155,0,0,62,62,0,1,0,1,0
7690,1888,0,0,62,62,0,1,0,1,0
3584,2587,0,0,62,62,0,1,0,1,0
10033,1215,0,0,66,66,0,1,0,1,0
16951,255,0,0,62,62,0,1,0,1,0
2574,2934,0,0,145,145,0,1,0,1,0
21615,1017,0,0,66,66,0,1,0,1,0
7812,1147,0,0,66,66,0,1,0,1,0
6166,1367,0,0,62,62,0,1,0,1,0
301,2256,0,0,66,66,0,1,0,1,0
4037,7,0,0,60,60,0,1,0,1,0
14294,1771,0,0,66,66,0,1,0,1,0
7339,140,0,0,60,60,0,1,0,1,0
1946,1147,0,0,62,62,0,1,0,1,0
10514,2747,0,0,66,66,0,1,0,1,0
2851,2695,0,0,70,70,0,1,0,1,0
15369,2382,0,0,66,66,0,1,0,1,0
4490,1147,0,0,146,146,0,1,0,1,0
14131,3212,0,0,66,66,0,1,0,1,0
1728,3216,0,0,66,66,0,1,0,1,0
329,2739,0,0,66,66,0,1,0,1,0
14531,2205,0,0,66,66,0,1,0,1,0
17466,804,0,0,66,66,0,1,0,1,0
16951,255,0,0,62,62,0,1,0,1,0
12675,3139,0,0,146,146,0,1,0,1,0
16951,255,0,0,62,62,0,1,0,1,0
1804,2232,0,0,60,60,0,1,0,1,0
20,2953,0,0,146,146,0,1,0,1,0
18211,1771,0,0,66,66,0,1,0,1,0
17355,1147,0,0,62,62,0,1,0,1,0
20310,1147,0,0,62,62,0,1,0,1,0
1486,2432,0,0,148,148,0,1,0,1,0
639,2093,0,0,143,143,0,1,0,1,0
16951,255,0,0,62,62,0,1,0,1,0
6448,2883,0,0,62,62,0,1,0,1,0
612,2562,0,0,60,60,0,1,0,1,0
368,3216,0,0,62,62,0,1,0,1,0
388,1888,0,0,62,62,0,1,0,1,0
12,1970,0,0,112,112,0,1,0,1,0
16951,255,0,0,62,62,0,1,0,1,0
609,1147,0,0,62,62,0,1,0,1,0
16951,255,0,0,62,62,0,1,0,1,0
12,3116,0,0,78,78,0,1,0,1,0
1872,1771,0,0,62,62,0,1,0,1,0
12,443,0,0,352,352,0,1,0,1,0
16951,255,0,0,62,62,0,1,0,1,0
2119,7,0,0,60,60,0,1,0,1,0
10680,1888,0,0,62,62,0,1,0,1,0
949,2938,0,0,66,66,0,1,0,1,0
8443,2636,0,0,66,66,0,1,0,1,0
8171,1073,0,0,60,60,0,1,0,1,0
9392,2256,0,0,62,62,0,1,0,1,0
2499,1472,0,0,62,62,0,1,0,1,0
12570,1888,0,0,66,66,0,1,0,1,0
1206,1017,0,0,62,62,0,1,0,1,0
16951,255,0,0,62,62,0,1,0,1,0
1543,2195,0,0,554,554,0,1,0,1,0
10166,1147,0,0,66,66,0,1,0,1,0
6890,1086,0,0,62,62,0,1,0,1,0
8023,2587,0,0,146,146,0,1,0,1,0
2778,3216,0,0,62,62,0,1,0,1,0
7956,2587,0,0,74,74,0,1,0,1,0
10165,1147,0,0,62,62,0,1,0,1,0
16478,246,0,0,60,60,0,1,0,1,0
2269,899,0,0,66,66,0,1,0,1,0
3871,2610,0,0,62,62,0,1,0,1,0
3163,1828,0,0,100,100,0,1,0,1,0
2749,2636,0,0,66,66,0,1,0,1,0
18147,1888,0,0,66,66,0,1,0,1,0
5278,2256,0,0,66,66,0,1,0,1,0
5664,1017,0,0,62,62,0,1,0,1,0
2023,2953,0,0,66,66,0,1,0,1,0
13681,2444,0,0,62,62,0,1,0,1,0
14950,1017,0,0,62,62,0,1,0,1,0
16448,1017,0,0,66,66,0,1,0,1,0
16951,255,0,0,62,62,0,1,0,1,0
11752,1017,0,0,62,62,0,1,0,1,0
17691,1888,0,0,62,62,0,1,0,1,0
18225,3139,0,0,66,66,0,1,0,1,0
8680,3270,0,0,162,162,0,1,0,1,0
21279,2256,0,0,66,66,0,1,0,1,0
639,2486,0,0,143,143,0,1,0,1,0
17526,983,0,0,66,66,0,1,0,1,0
12,120,0,0,97,97,0,1,0,1,0
7758,2587,0,0,146,146,0,1,0,1,0
16951,255,0,0,62,62,0,1,0,1,0
16951,255,0,0,62,62,0,1,0,1,0
15482,2587,0,0,62,62,0,1,0,1,0
9095,1147,0,0,62,62,0,1,0,1,0
20918,1771,0,0,62,62,0,1,0,1,0
2430,2938,0,0,62,62,0,1,0,1,0
8292,255,0,0,60,60,0,1,0,1,0
15251,1888,0,0,66,66,0,1,0,1,0
6381,2558,0,0,62,62,0,1,0,1,0
2199,2636,0,0,146,146,0,1,0,1,0
61,2256,0,0,66,66,0,1,0,1,0
1997,1771,0,0,66,66,0,1,0,1,0
10475,6,0,0,60,60,0,1,0,1,0
41,697,0,0,62,62,0,1,0,1,0
20119,1054,0,0,66,66,0,1,0,1,0
16047,1888,0,0,62,62,0,1,0,1,0
16951,255,0,0,62,62,0,1,0,1,0
2030,2899,0,0,78,78,0,1,0,1,0
3123,2380,0,0,62,62,0,1,0,1,0
10493,1147,0,0,146,146,0,1,0,1,0
727,137,0,0,66,66,0,1,0,1,0
16569,2127,0,0,146,146,0,1,0,1,0
10448,2883,0,0,66,66,0,1,0,1,0
10974,2883,0,0,66,66,0,1,0,1,0
19454,1017,0,0,62,62,0,1,0,1,0
614,983,0,0,62,62,0,1,0,1,0
12347,1,0,0,66,66,0,1,0,1,0
16853,2256,0,0,62,62,0,1,0,1,0
17702,1147,0,0,62,62,0,1,0,1,0
17016,3212,0,0,62,62,0,1,0,1,0
7335,1070,0,0,60,60,0,1,0,1,0
17533,1771,0,0,62,62,0,1,0,1,0
1763,2587,0,0,146,146,0,1,0,1,0
1928,1804,0,0,62,62,0,1,0,1,0
2845,1888,0,0,66,66,0,1,0,1,0
10436,126,0,0,139,139,0,1,0,1,0
2825,1147,0,0,146,146,0,1,0,1,0
8475,1017,0,0,62,62,0,1,0,1,0
2206,2938,0,0,74,74,0,1,0,1,0
19428,242,0,0,145,145,0,1,0,1,0
1426,2486,0,0,146,146,0,1,0,1,0
10283,2256,0,0,66,66,0,1,0,1,0
3128,6,0,0,60,60,0,1,0,1,0
2475,2695,0,0,66,66,0,1,0,1,0
19399,1888,0,0,66,66,0,1,0,1,0
10615,432,0,0,62,62,0,1,0,1,0
16951,255,0,0,62,62,0,1,0,1,0
2314,1147,0,0,146,146,0,1,0,1,0
16951,255,0,0,62,62,0,1,0,1,0
387,1147,0,0,62,62,0,1,0,1,0
12,958,0,0,97,97,0,1,0,1,0
1842,2587,0,0,62,62,0,1,0,1,0
16546,2362,0,0,72,72,0,1,0,1,0
1525,1444,0,0,145,145,0,1,0,1,0
16951,255,0,0,62,62,0,1,0,1,0
10773,3216,0,0,62,62,0,1,0,1,0
788,2382,0,0,62,62,0,1,0,1,0
3890,1219,0,0,145,145,0,1,0,1,0
79,1147,0,0,146,146,0,1,0,1,0
2324,697,0,0,146,146,0,1,0,1,0
3175,3216,0,0,62,62,0,1,0,1,0
7906,1147,0,0,62,62,0,1,0,1,0
1067,2883,0,0,66,66,0,1,0,1,0
8,442,0,0,60,60,0,1,0,1,0
9614,3105,0,0,86,86,0,1,0,1,0
2003,2938,0,0,62,62,0,1,0,1,0
10617,2256,0,0,66,66,0,1,0,1,0
20314,3139,0,0,146,146,0,1,0,1,0
622,2938,0,0,62,62,0,1,0,1,0
12656,1017,0,0,62,62,0,1,0,1,0
18267,697,0,0,66,66,0,1,0,1,0
11453,1147,0,0,66,66,0,1,0,1,0
8682,1792,0,0,62,62,0,1,0,1,0
8165,509,0,0,62,62,0,1,0,1,0
12767,697,0,0,62,62,0,1,0,1,0
7911,125,0,0,146,146,0,1,0,1,0
16951,255,0,0,62,62,0,1,0,1,0
16529,2587,0,0,66,66,0,1,0,1,0
1906,2505,0,0,145,145,0,1,0,1,0
16633,1880,0,0,66,66,0,1,0,1,0
16951,255,0,0,62,62,0,1,0,1,0
1737,3216,0,0,62,62,0,1,0,1,0
4085,1888,0,0,62,62,0,1,0,1,0
695,672,0,0,157,157,0,1,0,1,0
10474,2803,0,0,136,136,0,1,0,1,0
16249,1888,0,0,62,62,0,1,0,1,0
20699,2697,0,0,78,78,0,1,0,1,0
1262,1147,0,0,62,62,0,1,0,1,0
6502,346,0,0,60,60,0,1,0,1,0
5639,2836,0,0,62,62,0,1,0,1,0
289,1472,0,0,66,66,0,1,0,1,0
10166,1147,0,0,62,62,0,1,0,1,0
944,2636,0,0,146,146,0,1,0,1,0
13074,185,0,0,60,60,0,1,0,1,0
10515,2295,0,0,139,139,0,1,0,1,0
7961,715,0,0,62,62,0,1,0,1,0
574,2636,0,0,66,66,0,1,0,1,0
4374,1017,0,0,146,146,0,1,0,1,0
12,3146,0,0,199,199,0,1,0,1,0
1046,308,0,0,62,62,0,1,0,1,0
14214,7,0,0,60,60,0,1,0,1,0
1285,1771,0,0,66,66,0,1,0,1,0
587,1888,0,0,62,62,0,1,0,1,0
1853,2938,0,0,62,62,0,1,0,1,0
8965,255,0,0,60,60,0,1,0,1,0
12358,2883,0,0,146,146,0,1,0,1,0
10939,280,0,0,62,62,0,1,0,1,0
3664,509,0,0,62,62,0,1,0,1,0
1525,1444,0,0,145,145,0,1,0,1,0
17747,3139,0,0,62,62,0,1,0,1,0
1263,1147,0,0,146,146,0,1,0,1,0
1972,146,0,0,60,60,0,1,0,1,0
4408,2883,0,0,62,62,0,1,0,1,0
10396,3216,0,0,62,62,0,1,0,1,0
1631,1888,0,0,62,62,0,1,0,1,0
18332,1017,0,0,62,62,0,1,0,1,0
3012,2495,0,0,150,150,0,1,0,1,0
1383,3216,0,0,62,62,0,1,0,1,0
1402,2938,0,0,62,62,0,1,0,1,0
10013,2587,0,0,66,66,0,1,0,1,0
3109,2611,0,0,72,72,0,1,0,1,0
420,1054,0,0,62,62,0,1,0,1,0
16957,2256,0,0,66,66,0,1,0,1,0
1285,1771,0,0,66,66,0,1,0,1,0
2548,1486,0,0,60,60,0,1,0,1,0
20506,1017,0,0,66,66,0,1,0,1,0
2009,2636,0,0,66,66,0,1,0,1,0
13510,2581,0,0,109,109,0,1,0,1,0
14511,2938,0,0,78,78,0,1,0,1,0
2906,1888,0,0,62,62,0,1,0,1,0
155,3216,0,0,66,66,0,1,0,1,0
3762,2938,0,0,66,66,0,1,0,1,0
491,2953,0,0,66,66,0,1,0,1,0
11518,2953,0,0,66,66,0,1,0,1,0
391,3216,0,0,66,66,0,1,0,1,0
19407,3216,0,0,66,66,0,1,0,1,0
13767,326,0,0,66,66,0,1,0,1,0
8682,1792,0,0,62,62,0,1,0,1,0
2852,7,0,0,60,60,0,1,0,1,0
12,207,0,0,320,320,0,1,0,1,0
7984,1017,0,0,66,66,0,1,0,1,0
11530,2256,0,0,66,66,0,1,0,1,0
8171,1073,0,0,60,60,0,1,0,1,0
7631,1804,0,0,66,66,0,1,0,1,0
20119,1054,0,0,62,62,0,1,0,1,0
8883,2938,0,0,62,62,0,1,0,1,0
16951,255,0,0,62,62,0,1,0,1,0
9939,1880,0,0,66,66,0,1,0,1,0
7326,1649,0,0,60,60,0,1,0,1,0
9438,1017,0,0,66,66,0,1,0,1,0
3624,1147,0,0,66,66,0,1,0,1,0
8865,3216,0,0,66,66,0,1,0,1,0
20834,2636,0,0,66,66,0,1,0,1,0
1732,1147,0,0,62,62,0,1,0,1,0
6478,2938,0,0,62,62,0,1,0,1,0
2035,1147,0,0,62,62,0,1,0,1,0
11158,1880,0,0,62,62,0,1,0,1,0
0,0,0,0,98,98,0,1,0,1,0
24,3216,0,0,62,62,0,1,0,1,0
10522,7,0,0,60,60,0,1,0,1,0
18957,3216,0,0,66,66,0,1,0,1,0
6376,2899,0,0,70,70,0,1,0,1,0
1330,697,0,0,62,62,0,1,0,1,0
1353,1888,0,0,62,62,0,1,0,1,0
2206,2938,0,0,74,74,0,1,0,1,0
16951,255,0,0,62,62,0,1,0,1,0
19157,1771,0,0,66,66,0,1,0,1,0
256,3216,0,0,62,62,0,1,0,1,0
17510,2604,0,0,66,66,0,1,0,1,0
11369,2836,0,0,66,66,0,1,0,1,0
14530,1147,0,0,146,146,0,1,0,1,0
7555,211,0,0,60,60,0,1,0,1,0
319,2256,0,0,62,62,0,1,0,1,0
2743,1054,0,0,62,62,0,1,0,1,0
642,2934,0,0,148,148,0,1,0,1,0
1409,459,0,0,72,72,0,1,0,1,0
6993,3216,0,0,62,62,0,1,0,1,0
19096,1327,0,0,62,62,0,1,0,1,0
6670,2486,0,0,134,134,0,1,0,1,0
4099,2477,0,0,62,62,0,1,0,1,0
6309,2938,0,0,60,60,0,1,0,1,0
6324,1147,0,0,146,146,0,1,0,1,0
1852,2747,0,0,62,62,0,1,0,1,0
3430,1472,0,0,62,62,0,1,0,1,0
15846,1539,0,0,66,66,0,1,0,1,0
19489,1017,0,0,62,62,0,1,0,1,0
9530,1017,0,0,66,66,0,1,0,1,0
11930,2883,0,0,66,66,0,1,0,1,0
2060,1888,0,0,62,62,0,1,0,1,0
22690,1215,0,0,62,62,0,1,0,1,0
1805,1017,0,0,66,66,0,1,0,1,0
14361,2636,0,0,66,66,0,1,0,1,0
9717,1017,0,0,62,62,0,1,0,1,0
1576,2938,0,0,60,60,0,1,0,1,0
19,2379,0,0,62,62,0,1,0,1,0
15211,2205,0,0,66,66,0,1,0,1,0
1952,7,0,0,60,60,0,1,0,1,0
16951,255,0,0,62,62,0,1,0,1,0
20933,1017,0,0,66,66,0,1,0,1,0
8092,423,0,0,60,60,0,1,0,1,0
14064,3216,0,0,66,66,0,1,0,1,0
15373,427,0,0,66,66,0,1,0,1,0
21596,263,0,0,66,66,0,1,0,1,0
16951,255,0,0,62,62,0,1,0,1,0
660,280,0,0,62,62,0,1,0,1,0
18086,2938,0,0,62,62,0,1,0,1,0
14950,1017,0,0,146,146,0,1,0,1,0
12321,1017,0,0,66,66,0,1,0,1,0
16951,255,0,0,62,62,0,1,0,1,0
15966,1888,0,0,66,66,0,1,0,1,0
1330,2943,0,0,62,62,0,1,0,1,0
2683,2938,0,0,66,66,0,1,0,1,0
17616,2611,0,0,66,66,0,1,0,1,0
12116,3212,0,0,66,66,0,1,0,1,0
1299,2636,0,0,62,62,0,1,0,1,0
8276,2023,0,0,161,161,0,1,0,1,0
16951,255,0,0,62,62,0,1,0,1,0
7335,1072,0,0,60,60,0,1,0,1,0
4456,1215,0,0,62,62,0,1,0,1,0
12656,1017,0,0,62,62,0,1,0,1,0
21594,2938,0,0,62,62,0,1,0,1,0
5301,1147,0,0,62,62,0,1,0,1,0
21959,1771,0,0,66,66,0,1,0,1,0
1374,1888,0,0,62,62,0,1,0,1,0
2497,3216,0,0,62,62,0,1,0,1,0
5423,1017,0,0,66,66,0,1,0,1,0
5631,1393,0,0,145,145,0,1,0,1,0
7327,2256,0,0,62,62,0,1,0,1,0
11575,2256,0,0,62,62,0,1,0,1,0
2084,1471,0,0,145,145,0,1,0,1,0
639,2049,0,0,143,143,0,1,0,1,0
3135,471,0,0,145,145,0,1,0,1,0
158,1147,0,0,62,62,0,1,0,1,0
18671,2604,0,0,66,66,0,1,0,1,0
625,2587,0,0,62,62,0,1,0,1,0
22510,2611,0,0,78,78,0,1,0,1,0
2660,1888,0,0,62,62,0,1,0,1,0
15410,1792,0,0,66,66,0,1,0,1,0
7720,3216,0,0,62,62,0,1,0,1,0
22208,2611,0,0,66,66,0,1,0,1,0
7984,1017,0,0,66,66,0,1,0,1,0
1992,3216,0,0,62,62,0,1,0,1,0
16951,255,0,0,62,62,0,1,0,1,0
13433,1462,0,0,66,66,0,1,0,1,0
15294,1880,0,0,66,66,0,1,0,1,0
11026,1771,0,0,66,66,0,1,0,1,0
577,2611,0,0,62,62,0,1,0,1,0
20060,2938,0,0,66,66,0,1,0,1,0
34,274,0,0,69,69,0,1,0,1,0
24,1783,0,0,140,140,0,1,0,1,0
17212,509,0,0,63,63,0,1,0,1,0
450,126,0,0,136,136,0,1,0,1,0
12,3140,0,0,199,199,0,1,0,1,0
2571,1710,0,0,155,155,0,1,0,1,0
43,376,0,0,67,67,0,1,0,1,0
16951,255,0,0,62,62,0,1,0,1,0
1221,7,0,0,60,60,0,1,0,1,0
10471,1017,0,0,66,66,0,1,0,1,0
20462,2625,0,0,63,63,0,1,0,1,0
16509,433,0,0,62,62,0,1,0,1,0
12887,2545,0,0,62,62,0,1,0,1,0
11468,2582,0,0,66,66,0,1,0,1,0
1971,3214,0,0,62,62,0,1,0,1,0
4304,1472,0,0,65,65,0,1,0,1,0
10388,3216,0,0,65,65,0,1,0,1,0
558,1017,0,0,65,65,0,1,0,1,0
27,3216,0,0,145,145,0,1,0,1,0
637,1684,0,0,144,144,0,1,0,1,0
6533,1215,0,0,62,62,0,1,0,1,0
21229,2578,0,0,63,63,0,1,0,1,0
11438,341,0,0,66,66,0,1,0,1,0
2829,1775,0,0,65,65,0,1,0,1,0
10081,2353,0,0,62,62,0,1,0,1,0
16951,255,0,0,62,62,0,1,0,1,0
696,7,0,0,60,60,0,1,0,1,0
2294,2860,0,0,67,67,0,1,0,1,0
2293,1472,0,0,62,62,0,1,0,1,0
7762,2587,0,0,63,63,0,1,0,1,0
2833,1888,0,0,62,62,0,1,0,1,0
5327,1888,0,0,62,62,0,1,0,1,0
20207,1776,0,0,65,65,0,1,0,1,0
2966,2256,0,0,64,64,0,1,0,1,0
7457,1771,0,0,66,66,0,1,0,1,0
11397,1104,0,0,66,66,0,1,0,1,0
18120,1888,0,0,66,66,0,1,0,1,0
257,2629,0,0,66,66,0,1,0,1,0
360,3105,0,0,1130,1130,0,1,0,1,0
17569,2154,0,0,74,74,0,1,0,1,0
7458,1771,0,0,66,66,0,1,0,1,0
16068,3189,0,0,66,66,0,1,0,1,0
10,2761,0,0,60,60,0,1,0,1,0
8582,1017,0,0,64,64,0,1,0,1,0
2084,1471,0,0,145,145,0,1,0,1,0
17640,1880,0,0,66,66,0,1,0,1,0
695,2256,0,0,64,64,0,1,0,1,0
17656,2076,0,0,66,66,0,1,0,1,0
3319,2602,0,0,64,64,0,1,0,1,0
747,1147,0,0,64,64,0,1,0,1,0
16951,255,0,0,62,62,0,1,0,1,0
16951,255,0,0,62,62,0,1,0,1,0
19957,2584,0,0,65,65,0,1,0,1,0
22146,3216,0,0,64,64,0,1,0,1,0
302,1187,0,0,63,63,0,1,0,1,0
1617,1888,0,0,62,62,0,1,0,1,0
1135,1215,0,0,62,62,0,1,0,1,0
18185,1017,0,0,64,64,0,1,0,1,0
8670,1807,0,0,62,62,0,1,0,1,0
0,0,0,0,166,166,0,1,0,1,0
1463,1017,0,0,64,64,0,1,0,1,0
16951,255,0,0,62,62,0,1,0,1,0
2088,386,0,0,60,60,0,1,0,1,0
19247,983,0,0,65,65,0,1,0,1,0
18328,1144,0,0,66,66,0,1,0,1,0
11354,3212,0,0,63,63,0,1,0,1,0
1591,1888,0,0,62,62,0,1,0,1,0
16951,255,0,0,62,62,0,1,0,1,0
21723,404,0,0,62,62,0,1,0,1,0
16861,983,0,0,66,66,0,1,0,1,0
3102,1888,0,0,62,62,0,1,0,1,0
3187,508,0,0,146,146,0,1,0,1,0
621,2269,0,0,75,75,0,1,0,1,0
219,3188,0,0,64,64,0,1,0,1,0
16287,3216,0,0,64,64,0,1,0,1,0
3648,2624,0,0,62,62,0,1,0,1,0
10630,2636,0,0,66,66,0,1,0,1,0
11934,3216,0,0,64,64,0,1,0,1,0
481,3127,0,0,66,66,0,1,0,1,0
14805,1016,0,0,66,66,0,1,0,1,0
349,2278,0,0,75,75,0,1,0,1,0
10472,2933,0,0,71,71,0,1,0,1,0
15694,333,0,0,145,145,0,1,0,1,0
535,481,0,0,84,84,0,1,0,1,0
16951,255,0,0,62,62,0,1,0,1,0
1713,7,0,0,60,60,0,1,0,1,0
2335,2486,0,0,62,62,0,1,0,1,0
4075,661,0,0,93,93,0,1,0,1,0
12,2456,0,0,89,89,0,1,0,1,0
2555,6,0,0,60,60,0,1,0,1,0
16288,2941,0,0,66,66,0,1,0,1,0
1833,3215,0,0,145,145,0,1,0,1,0
20850,1881,0,0,62,62,0,1,0,1,0
1525,1444,0,0,145,145,0,1,0,1,0
2687,505,0,0,65,65,0,1,0,1,0
21,1614,0,0,113,113,0,1,0,1,0
16951,255,0,0,62,62,0,1,0,1,0
18053,2256,0,0,66,66,0,1,0,1,0
22321,2587,0,0,65,65,0,1,0,1,0
21587,2938,0,0,77,77,0,1,0,1,0
15694,1515,0,0,145,145,0,1,0,1,0
14,534,0,0,66,66,0,1,0,1,0
12,447,0,0,60,60,0,1,0,1,0
6651,1129,0,0,156,156,0,1,0,1,0
10341,2210,0,0,66,66,0,1,0,1,0
15375,438,0,0,62,62,0,1,0,1,0
15909,3139,0,0,66,66,0,1,0,1,0
16951,255,0,0,62,62,0,1,0,1,0
1525,1444,0,0,145,145,0,1,0,1,0
1711,1017,0,0,62,62,0,1,0,1,0
12516,1795,0,0,60,60,0,1,0,1,0
14847,3157,0,0,74,74,0,1,0,1,0
21766,1888,0,0,66,66,0,1,0,1,0
21821,2587,0,0,133,133,0,1,0,1,0
3319,2604,0,0,64,64,0,1,0,1,0
15456,498,0,0,62,62,0,1,0,1,0
438,2636,0,0,62,62,0,1,0,1,0
9942,2644,0,0,65,65,0,1,0,1,0
6651,1129,0,0,156,156,0,1,0,1,0
7554,72,0,0,60,60,0,1,0,1,0
13556,854,0,0,66,66,0,1,0,1,0
2979,2256,0,0,66,66,0,1,0,1,0
612,191,0,0,60,60,0,1,0,1,0
16951,255,0,0,62,62,0,1,0,1,0
7339,140,0,0,60,60,0,1,0,1,0
2902,2587,0,0,62,62,0,1,0,1,0
18461,2379,0,0,74,74,0,1,0,1,0
19981,1116,0,0,66,66,0,1,0,1,0
5737,2938,0,0,67,67,0,1,0,1,0
16444,2881,0,0,90,90,0,1,0,1,0
15734,3190,0,0,63,63,0,1,0,1,0
22,2938,0,0,66,66,0,1,0,1,0
18100,95,0,0,122,122,0,1,0,1,0
12925,1827,0,0,62,62,0,1,0,1,0
2983,1147,0,0,146,146,0,1,0,1,0
16657,1883,0,0,66,66,0,1,0,1,0
1884,3145,0,0,65,65,0,1,0,1,0
2309,1017,0,0,62,62,0,1,0,1,0
2505,3000,0,0,88,88,0,1,0,1,0
274,9,0,0,60,60,0,1,0,1,0
13821,1199,0,0,65,65,0,1,0,1,0
3149,1472,0,0,65,65,0,1,0,1,0
496,987,0,0,76,76,0,1,0,1,0
18853,253,0,0,60,60,0,1,0,1,0
1154,1590,0,0,64,64,0,1,0,1,0
2641,1213,0,0,62,62,0,1,0,1,0
17189,3215,0,0,66,66,0,1,0,1,0
20413,497,0,0,146,146,0,1,0,1,0
9614,3105,0,0,86,86,0,1,0,1,0
2431,2938,0,0,62,62,0,1,0,1,0
8970,3216,0,0,62,62,0,1,0,1,0
12,1052,0,0,95,95,0,1,0,1,0
2720,1888,0,0,65,65,0,1,0,1,0
14172,2935,0,0,66,66,0,1,0,1,0
16951,255,0,0,62,62,0,1,0,1,0
2723,1888,0,0,64,64,0,1,0,1,0
3263,6,0,0,60,60,0,1,0,1,0
17503,2602,0,0,65,65,0,1,0,1,0
13686,3139,0,0,66,66,0,1,0,1,0
9737,3216,0,0,64,64,0,1,0,1,0
14363,2587,0,0,62,62,0,1,0,1,0
19870,1888,0,0,62,62,0,1,0,1,0
11652,697,0,0,95,95,0,1,0,1,0
11353,1017,0,0,65,65,0,1,0,1,0
1900,2587,0,0,146,146,0,1,0,1,0
3751,1859,0,0,68,68,0,1,0,1,0
3242,2573,0,0,145,145,0,1,0,1,0
1484,1152,0,0,145,145,0,1,0,1,0
3117,1480,0,0,62,62,0,1,0,1,0
762,1017,0,0,66,66,0,1,0,1,0
15560,1784,0,0,63,63,0,1,0,1,0
2290,1472,0,0,64,64,0,1,0,1,0
18897,2138,0,0,66,66,0,1,0,1,0
3730,1931,0,0,72,72,0,1,0,1,0
22223,2944,0,0,71,71,0,1,0,1,0
3121,1479,0,0,62,62,0,1,0,1,0
12293,1017,0,0,64,64,0,1,0,1,0
8171,1073,0,0,60,60,0,1,0,1,0
6506,697,0,0,62,62,0,1,0,1,0
12799,1462,0,0,65,65,0,1,0,1,0
20006,1215,0,0,65,65,0,1,0,1,0
2653,1017,0,0,146,146,0,1,0,1,0
2777,3216,0,0,66,66,0,1,0,1,0
2310,1215,0,0,62,62,0,1,0,1,0
698,1147,0,0,62,62,0,1,0,1,0
4309,2587,0,0,145,145,0,1,0,1,0
3094,3216,0,0,62,62,0,1,0,1,0
14023,1590,0,0,66,66,0,1,0,1,0
15539,1771,0,0,64,64,0,1,0,1,0
13178,1215,0,0,62,62,0,1,0,1,0
12039,3094,0,0,66,66,0,1,0,1,0
19589,2562,0,0,66,66,0,1,0,1,0
9,217,0,0,87,87,0,1,0,1,0
688,3216,0,0,66,66,0,1,0,1,0
14189,3216,0,0,62,62,0,1,0,1,0
8171,1073,0,0,60,60,0,1,0,1,0
9553,1147,0,0,63,63,0,1,0,1,0
18027,820,0,0,66,66,0,1,0,1,0
360,3105,0,0,161,161,0,1,0,1,0
17189,1087,0,0,66,66,0,1,0,1,0
1800,2926,0,0,60,60,0,1,0,1,0
1810,1880,0,0,65,65,0,1,0,1,0
12,141,0,0,123,123,0,1,0,1,0
5913,2587,0,0,62,62,0,1,0,1,0
10456,147,0,0,127,127,0,1,0,1,0
2293,1472,0,0,62,62,0,1,0,1,0
1431,1017,0,0,62,62,0,1,0,1,0
18089,2936,0,0,66,66,0,1,0,1,0
15796,18,0,0,89,89,0,1,0,1,0
14753,2938,0,0,62,62,0,1,0,1,0
3388,6,0,0,60,60,0,1,0,1,0
21157,1069,0,0,146,146,0,1,0,1,0
3010,2256,0,0,65,65,0,1,0,1,0
16124,3216,0,0,64,64,0,1,0,1,0
19563,3216,0,0,63,63,0,1,0,1,0
16478,283,0,0,60,60,0,1,0,1,0
2028,2587,0,0,64,64,0,1,0,1,0
1756,1880,0,0,146,146,0,1,0,1,0
1853,1,0,0,61,61,0,1,0,1,0
6649,697,0,0,74,74,0,1,0,1,0
3183,2620,0,0,63,63,0,1,0,1,0
12,3145,0,0,68,68,0,1,0,1,0
13,460,0,0,66,66,0,1,0,1,0
1902,2580,0,0,145,145,0,1,0,1,0
1236,2256,0,0,65,65,0,1,0,1,0
3107,3216,0,0,62,62,0,1,0,1,0
10459,780,0,0,100,100,0,1,0,1,0
16478,246,0,0,60,60,0,1,0,1,0
19428,242,0,0,145,145,0,1,0,1,0
1281,2543,0,0,60,60,0,1,0,1,0
2902,1888,0,0,62,62,0,1,0,1,0
9946,1,0,0,61,61,0,1,0,1,0
12616,1147,0,0,66,66,0,1,0,1,0
9214,3256,0,0,60,60,0,1,0,1,0
11985,1147,0,0,66,66,0,1,0,1,0
8576,1012,0,0,62,62,0,1,0,1,0
551,2256,0,0,62,62,0,1,0,1,0
2561,357,0,0,66,66,0,1,0,1,0
8591,2925,0,0,66,66,0,1,0,1,0
13217,2256,0,0,66,66,0,1,0,1,0
1537,2256,0,0,66,66,0,1,0,1,0
12296,2256,0,0,66,66,0,1,0,1,0
16951,255,0,0,62,62,0,1,0,1,0
2453,2587,0,0,62,62,0,1,0,1,0
13846,1016,0,0,65,65,0,1,0,1,0
3068,1888,0,0,66,66,0,1,0,1,0
2384,7,0,0,60,60,0,1,0,1,0
703,1005,0,0,79,79,0,1,0,1,0
21916,1850,0,0,66,66,0,1,0,1,0
5535,1804,0,0,62,62,0,1,0,1,0
7956,2587,0,0,64,64,0,1,0,1,0
16951,255,0,0,62,62,0,1,0,1,0
2121,3216,0,0,64,64,0,1,0,1,0
8,442,0,0,60,60,0,1,0,1,0
19353,2587,0,0,64,64,0,1,0,1,0
1342,2205,0,0,66,66,0,1,0,1,0
16951,255,0,0,62,62,0,1,0,1,0
2531,1017,0,0,65,65,0,1,0,1,0
16951,255,0,0,62,62,0,1,0,1,0
1768,2883,0,0,62,62,0,1,0,1,0
3857,1173,0,0,62,62,0,1,0,1,0
20344,8,0,0,81,81,0,1,0,1,0
21837,2938,0,0,66,66,0,1,0,1,0
6106,2587,0,0,66,66,0,1,0,1,0
21492,2594,0,0,66,66,0,1,0,1,0
20775,2586,0,0,64,64,0,1,0,1,0
2481,2587,0,0,60,60,0,1,0,1,0
20755,1147,0,0,62,62,0,1,0,1,0
445,2881,0,0,62,62,0,1,0,1,0
18987,1004,0,0,63,63,0,1,0,1,0
19,1773,0,0,62,62,0,1,0,1,0
301,801,0,0,64,64,0,1,0,1,0
261,1147,0,0,66,66,0,1,0,1,0
1839,1787,0,0,106,106,0,1,0,1,0
8171,1073,0,0,60,60,0,1,0,1,0
22178,1215,0,0,62,62,0,1,0,1,0
16504,1445,0,0,100,100,0,1,0,1,0
2199,6,0,0,60,60,0,1,0,1,0
577,2611,0,0,78,78,0,1,0,1,0
16951,255,0,0,62,62,0,1,0,1,0
13621,140,0,0,60,60,0,1,0,1,0
11180,1215,0,0,66,66,0,1,0,1,0
910,220,0,0,66,66,0,1,0,1,0
21066,2611,0,0,62,62,0,1,0,1,0
13181,994,0,0,62,62,0,1,0,1,0
15631,2590,0,0,62,62,0,1,0,1,0
16951,255,0,0,62,62,0,1,0,1,0
1901,2537,0,0,145,145,0,1,0,1,0
3976,1017,0,0,62,62,0,1,0,1,0
22119,1119,0,0,66,66,0,1,0,1,0
657,1478,0,0,145,145,0,1,0,1,0
680,2936,0,0,66,66,0,1,0,1,0
11755,1813,0,0,62,62,0,1,0,1,0
9614,3105,0,0,86,86,0,1,0,1,0
13845,987,0,0,62,62,0,1,0,1,0
16951,255,0,0,62,62,0,1,0,1,0
3415,2587,0,0,62,62,0,1,0,1,0
16951,255,0,0,62,62,0,1,0,1,0
16951,255,0,0,62,62,0,1,0,1,0
9658,2871,0,0,64,64,0,1,0,1,0
2658,1017,0,0,65,65,0,1,0,1,0
724,132,0,0,60,60,0,1,0,1,0
14865,2697,0,0,62,62,0,1,0,1,0
11450,245,0,0,60,60,0,1,0,1,0
2202,2574,0,0,62,62,0,1,0,1,0
14,215,0,0,116,116,0,1,0,1,0
6451,2938,0,0,62,62,0,1,0,1,0
18248,1017,0,0,66,66,0,1,0,1,0
1805,1186,0,0,60,60,0,1,0,1,0
8251,2531,0,0,153,153,0,1,0,1,0
12185,1880,0,0,66,66,0,1,0,1,0
1442,2579,0,0,62,62,0,1,0,1,0
16951,255,0,0,62,62,0,1,0,1,0
22042,466,0,0,101,101,0,1,0,1,0
19408,1880,0,0,66,66,0,1,0,1,0
193,2937,0,0,86,86,0,1,0,1,0
1281,2543,0,0,60,60,0,1,0,1,0
1512,2938,0,0,62,62,0,1,0,1,0
16951,255,0,0,62,62,0,1,0,1,0
3201,2938,0,0,60,60,0,1,0,1,0
2432,1771,0,0,62,62,0,1,0,1,0
1344,2171,0,0,63,63,0,1,0,1,0
1982,2253,0,0,65,65,0,1,0,1,0
1908,2547,0,0,145,145,0,1,0,1,0
10235,1044,0,0,66,66,0,1,0,1,0
1781,2576,0,0,62,62,0,1,0,1,0
2523,2938,0,0,62,62,0,1,0,1,0
16951,255,0,0,62,62,0,1,0,1,0
1460,505,0,0,62,62,0,1,0,1,0
21279,2256,0,0,66,66,0,1,0,1,0
2941,1159,0,0,62,62,0,1,0,1,0
15593,1804,0,0,66,66,0,1,0,1,0
20649,689,0,0,65,65,0,1,0,1,0
16951,255,0,0,62,62,0,1,0,1,0
1932,2256,0,0,66,66,0,1,0,1,0
2236,2611,0,0,62,62,0,1,0,1,0
10368,181,0,0,109,109,0,1,0,1,0
3344,1403,0,0,62,62,0,1,0,1,0
21550,3216,0,0,62,62,0,1,0,1,0
16951,255,0,0,62,62,0,1,0,1,0
2302,1017,0,0,65,65,0,1,0,1,0
16951,255,0,0,62,62,0,1,0,1,0
547,2256,0,0,66,66,0,1,0,1,0
12878,2553,0,0,64,64,0,1,0,1,0
389,436,0,0,66,66,0,1,0,1,0
11881,2256,0,0,65,65,0,1,0,1,0
17258,2938,0,0,62,62,0,1,0,1,0
1608,2477,0,0,60,60,0,1,0,1,0
8303,2533,0,0,154,154,0,1,0,1,0
1757,2577,0,0,146,146,0,1,0,1,0
637,2820,0,0,143,143,0,1,0,1,0
2157,3072,0,0,60,60,0,1,0,1,0
3080,7,0,0,60,60,0,1,0,1,0
4488,2144,0,0,62,62,0,1,0,1,0
8164,2726,0,0,60,60,0,1,0,1,0
17101,2625,0,0,64,64,0,1,0,1,0
260,1472,0,0,62,62,0,1,0,1,0
14722,1888,0,0,66,66,0,1,0,1,0
7956,2587,0,0,69,69,0,1,0,1,0
6913,7,0,0,60,60,0,1,0,1,0
7335,1072,0,0,60,60,0,1,0,1,0
9156,1888,0,0,66,66,0,1,0,1,0
15007,2883,0,0,62,62,0,1,0,1,0
6727,2256,0,0,65,65,0,1,0,1,0
7335,1070,0,0,60,60,0,1,0,1,0
14131,3212,0,0,63,63,0,1,0,1,0
7494,1801,0,0,139,139,0,1,0,1,0
17196,1472,0,0,63,63,0,1,0,1,0
3115,1802,0,0,62,62,0,1,0,1,0
8750,2938,0,0,65,65,0,1,0,1,0
12,3145,0,0,199,199,0,1,0,1,0
20314,9,0,0,84,84,0,1,0,1,0
3100,1796,0,0,146,146,0,1,0,1,0
7339,2845,0,0,60,60,0,1,0,1,0
19146,2112,0,0,97,97,0,1,0,1,0
20268,2938,0,0,62,62,0,1,0,1,0
4481,1147,0,0,146,146,0,1,0,1,0
8,442,0,0,60,60,0,1,0,1,0
10457,2883,0,0,66,66,0,1,0,1,0
6135,9,0,0,61,61,0,1,0,1,0
16749,735,0,0,66,66,0,1,0,1,0
18,3216,0,0,62,62,0,1,0,1,0
1736,3216,0,0,62,62,0,1,0,1,0
13456,1797,0,0,66,66,0,1,0,1,0
2292,456,0,0,65,65,0,1,0,1,0
17505,983,0,0,62,62,0,1,0,1,0
2522,2586,0,0,146,146,0,1,0,1,0
12030,2611,0,0,74,74,0,1,0,1,0
16710,2256,0,0,66,66,0,1,0,1,0
1804,363,0,0,60,60,0,1,0,1,0
539,1888,0,0,62,62,0,1,0,1,0
559,2256,0,0,66,66,0,1,0,1,0
18512,2938,0,0,62,62,0,1,0,1,0
20834,2836,0,0,66,66,0,1,0,1,0
12711,1888,0,0,66,66,0,1,0,1,0
11498,1774,0,0,62,62,0,1,0,1,0
7335,1070,0,0,60,60,0,1,0,1,0
6396,392,0,0,62,62,0,1,0,1,0
1271,280,0,0,113,113,0,1,0,1,0
21144,1147,0,0,62,62,0,1,0,1,0
636,280,0,0,146,146,0,1,0,1,0
802,1017,0,0,66,66,0,1,0,1,0
3639,2611,0,0,62,62,0,1,0,1,0
2269,1472,0,0,66,66,0,1,0,1,0
16951,255,0,0,62,62,0,1,0,1,0
8171,1073,0,0,60,60,0,1,0,1,0
11366,1072,0,0,65,65,0,1,0,1,0
18859,1771,0,0,66,66,0,1,0,1,0
543,1147,0,0,146,146,0,1,0,1,0
14752,2938,0,0,63,63,0,1,0,1,0
3221,1017,0,0,63,63,0,1,0,1,0
375,1147,0,0,62,62,0,1,0,1,0
9191,983,0,0,65,65,0,1,0,1,0
2412,1215,0,0,62,62,0,1,0,1,0
10475,6,0,0,60,60,0,1,0,1,0
22201,1215,0,0,65,65,0,1,0,1,0
7975,715,0,0,63,63,0,1,0,1,0
1962,2613,0,0,62,62,0,1,0,1,0
694,7,0,0,60,60,0,1,0,1,0
360,3105,0,0,481,481,0,1,0,1,0
1716,8,0,0,60,60,0,1,0,1,0
70,2629,0,0,62,62,0,1,0,1,0
2653,3216,0,0,62,62,0,1,0,1,0
10163,1017,0,0,66,66,0,1,0,1,0
21,3216,0,0,62,62,0,1,0,1,0
15876,892,0,0,64,64,0,1,0,1,0
593,1044,0,0,64,64,0,1,0,1,0
3583,1927,0,0,134,134,0,1,0,1,0
17410,2592,0,0,66,66,0,1,0,1,0
2500,3216,0,0,65,65,0,1,0,1,0
15667,1493,0,0,145,145,0,1,0,1,0
11359,3169,0,0,66,66,0,1,0,1,0
2782,1483,0,0,107,107,0,1,0,1,0
11247,1017,0,0,62,62,0,1,0,1,0
670,1464,0,0,144,144,0,1,0,1,0
13036,1168,0,0,63,63,0,1,0,1,0
20014,2564,0,0,66,66,0,1,0,1,0
20260,2938,0,0,62,62,0,1,0,1,0
12,2784,0,0,82,82,0,1,0,1,0
19282,2578,0,0,62,62,0,1,0,1,0
10051,3056,0,0,65,65,0,1,0,1,0
1355,1147,0,0,63,63,0,1,0,1,0
20878,2587,0,0,66,66,0,1,0,1,0
10432,1017,0,0,62,62,0,1,0,1,0
73,3216,0,0,65,65,0,1,0,1,0
21619,1017,0,0,62,62,0,1,0,1,0
2543,2667,0,0,61,61,0,1,0,1,0
10078,2267,0,0,65,65,0,1,0,1,0
14088,2883,0,0,66,66,0,1,0,1,0
10630,2636,0,0,62,62,0,1,0,1,0
2084,1471,0,0,145,145,0,1,0,1,0
1667,3216,0,0,65,65,0,1,0,1,0
16951,255,0,0,62,62,0,1,0,1,0
6555,2587,0,0,63,63,0,1,0,1,0
7626,2603,0,0,62,62,0,1,0,1,0
684,2938,0,0,62,62,0,1,0,1,0
12,982,0,0,69,69,0,1,0,1,0
16951,255,0,0,62,62,0,1,0,1,0
15414,2892,0,0,62,62,0,1,0,1,0
1745,1888,0,0,146,146,0,1,0,1,0
259,1472,0,0,64,64,0,1,0,1,0
17039,441,0,0,62,62,0,1,0,1,0
15944,308,0,0,66,66,0,1,0,1,0
4490,1147,0,0,62,62,0,1,0,1,0
13364,1826,0,0,145,145,0,1,0,1,0
14948,2256,0,0,62,62,0,1,0,1,0
1809,1000,0,0,62,62,0,1,0,1,0
8784,2938,0,0,64,64,0,1,0,1,0
6294,1017,0,0,62,62,0,1,0,1,0
16951,255,0,0,62,62,0,1,0,1,0
61,1888,0,0,62,62,0,1,0,1,0
9782,1796,0,0,66,66,0,1,0,1,0
19603,509,0,0,66,66,0,1,0,1,0
1661,2145,0,0,62,62,0,1,0,1,0
1804,1017,0,0,65,65,0,1,0,1,0
13312,2579,0,0,63,63,0,1,0,1,0
2504,1147,0,0,62,62,0,1,0,1,0
12,443,0,0,300,300,0,1,0,1,0
16951,255,0,0,62,62,0,1,0,1,0
19762,1017,0,0,66,66,0,1,0,1,0
1454,527,0,0,62,62,0,1,0,1,0
746,1603,0,0,61,61,0,1,0,1,0
12872,1805,0,0,62,62,0,1,0,1,0
60,1888,0,0,62,62,0,1,0,1,0
1846,3201,0,0,145,145,0,1,0,1,0
17881,1167,0,0,63,63,0,1,0,1,0
1371,2883,0,0,65,65,0,1,0,1,0
1473,1017,0,0,66,66,0,1,0,1,0
21616,1017,0,0,65,65,0,1,0,1,0
16951,255,0,0,62,62,0,1,0,1,0
3936,6,0,0,60,60,0,1,0,1,0
19,3216,0,0,62,62,0,1,0,1,0
252,280,0,0,63,63,0,1,0,1,0
16951,255,0,0,62,62,0,1,0,1,0
17808,2587,0,0,62,62,0,1,0,1,0
1921,1797,0,0,62,62,0,1,0,1,0
12,5,0,0,60,60,0,1,0,1,0
14082,3216,0,0,66,66,0,1,0,1,0
6219,493,0,0,65,65,0,1,0,1,0
624,2586,0,0,61,61,0,1,0,1,0
7049,2938,0,0,68,68,0,1,0,1,0
18811,2605,0,0,66,66,0,1,0,1,0
12494,3216,0,0,66,66,0,1,0,1,0
6761,5,0,0,60,60,0,1,0,1,0
9446,2457,0,0,66,66,0,1,0,1,0
354,797,0,0,62,62,0,1,0,1,0
6826,2256,0,0,65,65,0,1,0,1,0
1189,2256,0,0,65,65,0,1,0,1,0
19649,509,0,0,64,64,0,1,0,1,0
88,2621,0,0,146,146,0,1,0,1,0
431,1771,0,0,62,62,0,1,0,1,0
1416,465,0,0,71,71,0,1,0,1,0
6993,3216,0,0,62,62,0,1,0,1,0
14964,1147,0,0,62,62,0,1,0,1,0
13861,1006,0,0,64,64,0,1,0,1,0
3106,1147,0,0,62,62,0,1,0,1,0
19281,3216,0,0,66,66,0,1,0,1,0
16951,255,0,0,62,62,0,1,0,1,0
9244,6,0,0,60,60,0,1,0,1,0
22025,3149,0,0,66,66,0,1,0,1,0
17692,1147,0,0,65,65,0,1,0,1,0
2061,1461,0,0,145,145,0,1,0,1,0
1542,1888,0,0,66,66,0,1,0,1,0
7335,1072,0,0,60,60,0,1,0,1,0
8171,1073,0,0,60,60,0,1,0,1,0
509,2256,0,0,66,66,0,1,0,1,0
11055,1182,0,0,62,62,0,1,0,1,0
2662,2938,0,0,62,62,0,1,0,1,0
13470,1017,0,0,66,66,0,1,0,1,0
20388,1785,0,0,64,64,0,1,0,1,0
17484,371,0,0,65,65,0,1,0,1,0
1152,1573,0,0,65,65,0,1,0,1,0
1330,697,0,0,62,62,0,1,0,1,0
8939,1777,0,0,62,62,0,1,0,1,0
16732,2587,0,0,62,62,0,1,0,1,0
22278,1017,0,0,66,66,0,1,0,1,0
12925,1827,0,0,63,63,0,1,0,1,0
5172,1147,0,0,135,135,0,1,0,1,0
11162,1892,0,0,66,66,0,1,0,1,0
16951,255,0,0,62,62,0,1,0,1,0
611,166,0,0,60,60,0,1,0,1,0
12239,1034,0,0,63,63,0,1,0,1,0
7339,170,0,0,60,60,0,1,0,1,0
3247,1458,0,0,62,62,0,1,0,1,0
367,1017,0,0,62,62,0,1,0,1,0
1848,342,0,0,147,147,0,1,0,1,0
1136,1215,0,0,64,64,0,1,0,1,0
1994,2953,0,0,145,145,0,1,0,1,0
11029,1888,0,0,62,62,0,1,0,1,0
360,3105,0,0,484,484,0,1,0,1,0
2228,2587,0,0,63,63,0,1,0,1,0
1948,7,0,0,60,60,0,1,0,1,0
16847,1912,0,0,64,64,0,1,0,1,0
16951,255,0,0,62,62,0,1,0,1,0
8042,2256,0,0,62,62,0,1,0,1,0
17312,2624,0,0,64,64,0,1,0,1,0
0,0,0,0,98,98,0,1,0,1,0
19845,2883,0,0,66,66,0,1,0,1,0
16920,2587,0,0,66,66,0,1,0,1,0
2122,3216,0,0,62,62,0,1,0,1,0
1376,1888,0,0,62,62,0,1,0,1,0
9788,1771,0,0,66,66,0,1,0,1,0
12,1025,0,0,98,98,0,1,0,1,0
636,280,0,0,146,146,0,1,0,1,0
7339,170,0,0,60,60,0,1,0,1,0
1804,1762,0,0,60,60,0,1,0,1,0
16731,1086,0,0,66,66,0,1,0,1,0
14585,1147,0,0,62,62,0,1,0,1,0
19337,1888,0,0,66,66,0,1,0,1,0
4696,1829,0,0,66,66,0,1,0,1,0
7653,1224,0,0,60,60,0,1,0,1,0
3351,1409,0,0,62,62,0,1,0,1,0
8171,1073,0,0,60,60,0,1,0,1,0
2319,1215,0,0,62,62,0,1,0,1,0
9361,3216,0,0,66,66,0,1,0,1,0
1287,1147,0,0,62,62,0,1,0,1,0
12,2355,0,0,82,82,0,1,0,1,0
16832,509,0,0,66,66,0,1,0,1,0
449,1792,0,0,65,65,0,1,0,1,0
5682,1421,0,0,147,147,0,1,0,1,0
8171,1073,0,0,60,60,0,1,0,1,0
13467,2587,0,0,65,65,0,1,0,1,0
15173,3216,0,0,62,62,0,1,0,1,0
2073,1888,0,0,62,62,0,1,0,1,0
1681,1888,0,0,62,62,0,1,0,1,0
13408,1888,0,0,62,62,0,1,0,1,0
1810,1146,0,0,65,65,0,1,0,1,0
10768,1147,0,0,66,66,0,1,0,1,0
19944,1063,0,0,66,66,0,1,0,1,0
2285,2486,0,0,72,72,0,1,0,1,0
8043,1888,0,0,62,62,0,1,0,1,0
360,3105,0,0,1180,1180,0,1,0,1,0
638,1865,0,0,151,151,0,1,0,1,0
7339,170,0,0,60,60,0,1,0,1,0
360,3105,0,0,909,909,0,1,0,1,0
8093,2256,0,0,62,62,0,1,0,1,0
16849,1936,0,0,66,66,0,1,0,1,0
6533,1215,0,0,62,62,0,1,0,1,0
1158,460,0,0,62,62,0,1,0,1,0
16951,255,0,0,62,62,0,1,0,1,0
16951,255,0,0,62,62,0,1,0,1,0
615,250,0,0,60,60,0,1,0,1,0
2540,1796,0,0,62,62,0,1,0,1,0
19924,3189,0,0,63,63,0,1,0,1,0
16990,1823,0,0,73,73,0,1,0,1,0
12304,1054,0,0,146,146,0,1,0,1,0
6791,3216,0,0,62,62,0,1,0,1,0
3397,458,0,0,130,130,0,1,0,1,0
499,187,0,0,345,345,0,1,0,1,0
6684,1905,0,0,95,95,0,1,0,1,0
283,308,0,0,62,62,0,1,0,1,0
6427,2207,0,0,62,62,0,1,0,1,0
16951,255,0,0,62,62,0,1,0,1,0
863,1224,0,0,60,60,0,1,0,1,0
16951,255,0,0,62,62,0,1,0,1,0
290,3216,0,0,62,62,0,1,0,1,0
1552,7,0,0,60,60,0,1,0,1,0
11609,1801,0,0,65,65,0,1,0,1,0
17129,3216,0,0,63,63,0,1,0,1,0
1761,2486,0,0,140,140,0,1,0,1,0
8171,1073,0,0,60,60,0,1,0,1,0
11658,3216,0,0,63,63,0,1,0,1,0
1721,1215,0,0,62,62,0,1,0,1,0
5050,2627,0,0,66,66,0,1,0,1,0
7118,1147,0,0,146,146,0,1,0,1,0
2304,1215,0,0,62,62,0,1,0,1,0
10653,1150,0,0,65,65,0,1,0,1,0
1281,2543,0,0,60,60,0,1,0,1,0
1518,1147,0,0,62,62,0,1,0,1,0
14139,3215,0,0,62,62,0,1,0,1,0
570,1888,0,0,62,62,0,1,0,1,0
15790,2717,0,0,63,63,0,1,0,1,0
1067,2883,0,0,63,63,0,1,0,1,0
1132,2938,0,0,70,70,0,1,0,1,0
16951,255,0,0,62,62,0,1,0,1,0
2172,1147,0,0,73,73,0,1,0,1,0
9201,3189,0,0,63,63,0,1,0,1,0
13624,2591,0,0,66,66,0,1,0,1,0
21292,1150,0,0,62,62,0,1,0,1,0
12609,2636,0,0,66,66,0,1,0,1,0
18685,1771,0,0,65,65,0,1,0,1,0
17266,274,0,0,60,60,0,1,0,1,0
5417,752,0,0,69,69,0,1,0,1,0
6794,3216,0,0,62,62,0,1,0,1,0
5220,1147,0,0,63,63,0,1,0,1,0
9819,2883,0,0,66,66,0,1,0,1,0
11469,1771,0,0,62,62,0,1,0,1,0
1283,1496,0,0,147,147,0,1,0,1,0
22463,2817,0,0,66,66,0,1,0,1,0
16834,509,0,0,66,66,0,1,0,1,0
17186,2938,0,0,67,67,0,1,0,1,0
16483,166,0,0,65,65,0,1,0,1,0
10300,1215,0,0,66,66,0,1,0,1,0
14969,1179,0,0,63,63,0,1,0,1,0
7374,2594,0,0,65,65,0,1,0,1,0
15000,1767,0,0,65,65,0,1,0,1,0
22418,2594,0,0,66,66,0,1,0,1,0
9682,2231,0,0,64,64,0,1,0,1,0
3072,3194,0,0,65,65,0,1,0,1,0
0,0,0,0,98,98,0,1,0,1,0
3989,2237,0,0,65,65,0,1,0,1,0
4261,7,0,0,60,60,0,1,0,1,0
6946,1147,0,0,64,64,0,1,0,1,0
20429,2916,0,0,112,112,0,1,0,1,0
7653,1224,0,0,60,60,0,1,0,1,0
16951,255,0,0,62,62,0,1,0,1,0
2595,2883,0,0,62,62,0,1,0,1,0
6265,1147,0,0,62,62,0,1,0,1,0
46,2381,0,0,62,62,0,1,0,1,0
18498,813,0,0,66,66,0,1,0,1,0
0,0,0,0,98,98,0,1,0,1,0
2167,1889,0,0,145,145,0,1,0,1,0
1418,2486,0,0,64,64,0,1,0,1,0
13793,509,0,0,66,66,0,1,0,1,0
2848,2603,0,0,64,64,0,1,0,1,0
7801,332,0,0,105,105,0,1,0,1,0
16951,255,0,0,62,62,0,1,0,1,0
1298,1787,0,0,61,61,0,1,0,1,0
14918,1017,0,0,62,62,0,1,0,1,0
11450,245,0,0,60,60,0,1,0,1,0
10962,2929,0,0,62,62,0,1,0,1,0
11582,2256,0,0,63,63,0,1,0,1,0
18042,2256,0,0,66,66,0,1,0,1,0
21305,2934,0,0,73,73,0,1,0,1,0
19725,1017,0,0,66,66,0,1,0,1,0
13093,1936,0,0,94,94,0,1,0,1,0
19428,242,0,0,145,145,0,1,0,1,0
18065,548,0,0,66,66,0,1,0,1,0
7748,1881,0,0,62,62,0,1,0,1,0
2495,417,0,0,145,145,0,1,0,1,0
7254,1807,0,0,145,145,0,1,0,1,0
10797,2587,0,0,66,66,0,1,0,1,0
17419,1936,0,0,64,64,0,1,0,1,0
7461,1794,0,0,66,66,0,1,0,1,0
727,1469,0,0,62,62,0,1,0,1,0
1472,560,0,0,62,62,0,1,0,1,0
7523,2945,0,0,63,63,0,1,0,1,0
2933,3216,0,0,62,62,0,1,0,1,0
16901,2582,0,0,66,66,0,1,0,1,0
2833,1888,0,0,62,62,0,1,0,1,0
2781,1017,0,0,64,64,0,1,0,1,0
12,2444,0,0,93,93,0,1,0,1,0
2055,427,0,0,62,62,0,1,0,1,0
1182,2256,0,0,65,65,0,1,0,1,0
17907,2256,0,0,64,64,0,1,0,1,0
18,2938,0,0,62,62,0,1,0,1,0
12067,3127,0,0,63,63,0,1,0,1,0
1402,2938,0,0,62,62,0,1,0,1,0
5672,2938,0,0,66,66,0,1,0,1,0
277,1472,0,0,64,64,0,1,0,1,0
5073,2615,0,0,62,62,0,1,0,1,0
15840,3216,0,0,66,66,0,1,0,1,0
10526,801,0,0,85,85,0,1,0,1,0
10309,1888,0,0,66,66,0,1,0,1,0
5358,3201,0,0,62,62,0,1,0,1,0
19028,2938,0,0,75,75,0,1,0,1,0
15704,1516,0,0,139,139,0,1,0,1,0
16951,255,0,0,62,62,0,1,0,1,0
87,2596,0,0,145,145,0,1,0,1,0
190,1784,0,0,62,62,0,1,0,1,0
12,3074,0,0,320,320,0,1,0,1,0
539,1888,0,0,65,65,0,1,0,1,0
19225,2486,0,0,62,62,0,1,0,1,0
1850,3216,0,0,66,66,0,1,0,1,0
3612,2685,0,0,155,155,0,1,0,1,0
16043,1147,0,0,63,63,0,1,0,1,0
14944,1147,0,0,62,62,0,1,0,1,0
9706,1888,0,0,64,64,0,1,0,1,0
20873,2587,0,0,66,66,0,1,0,1,0
2497,1498,0,0,62,62,0,1,0,1,0
1983,2144,0,0,66,66,0,1,0,1,0
10214,3188,0,0,66,66,0,1,0,1,0
13068,1869,0,0,66,66,0,1,0,1,0
8074,1767,0,0,146,146,0,1,0,1,0
3150,2981,0,0,84,84,0,1,0,1,0
2255,1017,0,0,62,62,0,1,0,1,0
16951,255,0,0,62,62,0,1,0,1,0
6831,7,0,0,70,70,0,1,0,1,0
16789,2939,0,0,66,66,0,1,0,1,0
11207,1154,0,0,66,66,0,1,0,1,0
20260,2587,0,0,63,63,0,1,0,1,0
486,1024,0,0,64,64,0,1,0,1,0
1238,2272,0,0,62,62,0,1,0,1,0
19414,1880,0,0,66,66,0,1,0,1,0
15263,1147,0,0,65,65,0,1,0,1,0
8128,465,0,0,60,60,0,1,0,1,0
14577,2883,0,0,66,66,0,1,0,1,0
605,2253,0,0,66,66,0,1,0,1,0
17867,3174,0,0,63,63,0,1,0,1,0
2945,2617,0,0,146,146,0,1,0,1,0
15836,3148,0,0,65,65,0,1,0,1,0
22070,2607,0,0,66,66,0,1,0,1,0
15130,3216,0,0,62,62,0,1,0,1,0
19879,2901,0,0,68,68,0,1,0,1,0
16951,255,0,0,62,62,0,1,0,1,0
494,7,0,0,60,60,0,1,0,1,0
4557,2256,0,0,63,63,0,1,0,1,0
11662,1147,0,0,63,63,0,1,0,1,0
5071,2611,0,0,65,65,0,1,0,1,0
2431,1020,0,0,61,61,0,1,0,1,0
7589,2573,0,0,74,74,0,1,0,1,0
3236,2595,0,0,65,65,0,1,0,1,0
13845,983,0,0,65,65,0,1,0,1,0
13,2228,0,0,60,60,0,1,0,1,0
10800,2629,0,0,66,66,0,1,0,1,0
18170,2255,0,0,66,66,0,1,0,1,0
21524,1190,0,0,66,66,0,1,0,1,0
612,175,0,0,60,60,0,1,0,1,0
677,3216,0,0,63,63,0,1,0,1,0
2416,2938,0,0,62,62,0,1,0,1,0
19907,2938,0,0,73,73,0,1,0,1,0
19486,1888,0,0,66,66,0,1,0,1,0
1348,2864,0,0,90,90,0,1,0,1,0
1330,697,0,0,62,62,0,1,0,1,0
3385,2587,0,0,62,62,0,1,0,1,0
16058,308,0,0,84,84,0,1,0,1,0
360,3105,0,0,160,160,0,1,0,1,0
7339,140,0,0,60,60,0,1,0,1,0
1887,2256,0,0,63,63,0,1,0,1,0
2403,7,0,0,60,60,0,1,0,1,0
11133,2747,0,0,66,66,0,1,0,1,0
822,3,0,0,61,61,0,1,0,1,0
11919,3156,0,0,124,124,0,1,0,1,0
11174,2521,0,0,62,62,0,1,0,1,0
20802,697,0,0,64,64,0,1,0,1,0
1265,1216,0,0,61,61,0,1,0,1,0
2430,2938,0,0,62,62,0,1,0,1,0
19428,242,0,0,145,145,0,1,0,1,0
15098,3016,0,0,145,145,0,1,0,1,0
19023,2583,0,0,122,122,0,1,0,1,0
6679,1888,0,0,62,62,0,1,0,1,0
1374,1888,0,0,62,62,0,1,0,1,0
360,3105,0,0,880,880,0,1,0,1,0
12291,2256,0,0,64,64,0,1,0,1,0
18066,470,0,0,66,66,0,1,0,1,0
19096,1327,0,0,62,62,0,1,0,1,0
11479,139,0,0,60,60,0,1,0,1,0
18868,2587,0,0,64,64,0,1,0,1,0
19057,1888,0,0,62,62,0,1,0,1,0
20715,2600,0,0,62,62,0,1,0,1,0
14839,2675,0,0,63,63,0,1,0,1,0
13045,1003,0,0,62,62,0,1,0,1,0
7076,1888,0,0,62,62,0,1,0,1,0
12079,1170,0,0,64,64,0,1,0,1,0
15253,3210,0,0,62,62,0,1,0,1,0
1390,1862,0,0,146,146,0,1,0,1,0
16780,3201,0,0,69,69,0,1,0,1,0
11434,2579,0,0,67,67,0,1,0,1,0
6552,2093,0,0,145,145,0,1,0,1,0
16951,255,0,0,62,62,0,1,0,1,0
299,2948,0,0,66,66,0,1,0,1,0
11535,2947,0,0,66,66,0,1,0,1,0
12513,1764,0,0,60,60,0,1,0,1,0
19731,509,0,0,66,66,0,1,0,1,0
2660,1888,0,0,62,62,0,1,0,1,0
1860,2941,0,0,62,62,0,1,0,1,0
16951,255,0,0,62,62,0,1,0,1,0
16951,255,0,0,62,62,0,1,0,1,0
15882,3051,0,0,65,65,0,1,0,1,0
12804,2938,0,0,62,62,0,1,0,1,0
12,3140,0,0,199,199,0,1,0,1,0
2264,1017,0,0,62,62,0,1,0,1,0
12084,1175,0,0,63,63,0,1,0,1,0
3663,1006,0,0,62,62,0,1,0,1,0
17937,3139,0,0,62,62,0,1,0,1,0
1467,524,0,0,64,64,0,1,0,1,0
2504,1147,0,0,62,62,0,1,0,1,0
10292,2883,0,0,62,62,0,1,0,1,0
1944,1880,0,0,63,63,0,1,0,1,0
1532,756,0,0,62,62,0,1,0,1,0
379,1147,0,0,62,62,0,1,0,1,0
33,269,0,0,70,70,0,1,0,1,0
10387,3216,0,0,63,63,0,1,0,1,0
11521,1472,0,0,66,66,0,1,0,1,0
1797,1862,0,0,64,64,0,1,0,1,0
19832,2883,0,0,66,66,0,1,0,1,0
2973,2636,0,0,62,62,0,1,0,1,0
22209,177,0,0,64,64,0,1,0,1,0
19,1773,0,0,62,62,0,1,0,1,0
4180,2611,0,0,65,65,0,1,0,1,0
20804,2256,0,0,65,65,0,1,0,1,0
9444,2523,0,0,66,66,0,1,0,1,0
12512,1147,0,0,62,62,0,1,0,1,0
6692,1806,0,0,62,62,0,1,0,1,0
1274,1147,0,0,146,146,0,1,0,1,0
21251,990,0,0,65,65,0,1,0,1,0
20245,2938,0,0,62,62,0,1,0,1,0
12033,2587,0,0,66,66,0,1,0,1,0
4543,1147,0,0,63,63,0,1,0,1,0
20755,1147,0,0,62,62,0,1,0,1,0
7335,1070,0,0,60,60,0,1,0,1,0
1488,472,0,0,157,157,0,1,0,1,0
18331,1017,0,0,62,62,0,1,0,1,0
9426,2938,0,0,78,78,0,1,0,1,0
10393,3216,0,0,66,66,0,1,0,1,0
12602,2621,0,0,66,66,0,1,0,1,0
1423,1888,0,0,62,62,0,1,0,1,0
1802,803,0,0,61,61,0,1,0,1,0
13363,1215,0,0,66,66,0,1,0,1,0
2449,281,0,0,62,62,0,1,0,1,0
16990,509,0,0,62,62,0,1,0,1,0
22131,1800,0,0,68,68,0,1,0,1,0
18232,1124,0,0,116,116,0,1,0,1,0
3675,7,0,0,60,60,0,1,0,1,0
1517,1771,0,0,65,65,0,1,0,1,0
6431,2492,0,0,147,147,0,1,0,1,0
16951,255,0,0,62,62,0,1,0,1,0
13447,1465,0,0,66,66,0,1,0,1,0
5983,2587,0,0,66,66,0,1,0,1,0
10300,2916,0,0,66,66,0,1,0,1,0
18042,847,0,0,63,63,0,1,0,1,0
12,1047,0,0,93,93,0,1,0,1,0
28,3216,0,0,62,62,0,1,0,1,0
5544,1804,0,0,62,62,0,1,0,1,0
10372,2233,0,0,63,63,0,1,0,1,0
2371,2256,0,0,63,63,0,1,0,1,0
9471,2382,0,0,66,66,0,1,0,1,0
1591,1888,0,0,62,62,0,1,0,1,0
1593,2486,0,0,64,64,0,1,0,1,0
20306,775,0,0,66,66,0,1,0,1,0
11876,290,0,0,60,60,0,1,0,1,0
15530,1189,0,0,63,63,0,1,0,1,0
4560,2211,0,0,62,62,0,1,0,1,0
5376,2560,0,0,146,146,0,1,0,1,0
19820,2787,0,0,60,60,0,1,0,1,0
2153,1147,0,0,63,63,0,1,0,1,0
1584,2155,0,0,65,65,0,1,0,1,0
13871,509,0,0,64,64,0,1,0,1,0
81,2256,0,0,62,62,0,1,0,1,0
1779,2883,0,0,64,64,0,1,0,1,0
16951,255,0,0,62,62,0,1,0,1,0
21298,2938,0,0,67,67,0,1,0,1,0
17343,2580,0,0,67,67,0,1,0,1,0
8325,993,0,0,64,64,0,1,0,1,0
9494,1888,0,0,66,66,0,1,0,1,0
2088,1771,0,0,62,62,0,1,0,1,0
6662,2602,0,0,145,145,0,1,0,1,0
1402,2938,0,0,62,62,0,1,0,1,0
3955,1472,0,0,66,66,0,1,0,1,0
19456,986,0,0,65,65,0,1,0,1,0
969,1824,0,0,66,66,0,1,0,1,0
6153,39,0,0,69,69,0,1,0,1,0
11988,1147,0,0,66,66,0,1,0,1,0
1502,2688,0,0,66,66,0,1,0,1,0
1697,1147,0,0,146,146,0,1,0,1,0
360,3105,0,0,171,171,0,1,0,1,0
6496,1215,0,0,62,62,0,1,0,1,0
2346,2590,0,0,62,62,0,1,0,1,0
538,1888,0,0,62,62,0,1,0,1,0
1220,2256,0,0,62,62,0,1,0,1,0
15735,2256,0,0,62,62,0,1,0,1,0
1309,1017,0,0,62,62,0,1,0,1,0
4982,2634,0,0,141,141,0,1,0,1,0
2590,6,0,0,60,60,0,1,0,1,0
14068,3216,0,0,66,66,0,1,0,1,0
12483,1147,0,0,65,65,0,1,0,1,0
15458,1784,0,0,64,64,0,1,0,1,0
2272,2636,0,0,62,62,0,1,0,1,0
9214,3256,0,0,60,60,0,1,0,1,0
1554,465,0,0,159,159,0,1,0,1,0
14894,1804,0,0,62,62,0,1,0,1,0
16478,311,0,0,60,60,0,1,0,1,0
4147,5,0,0,87,87,0,1,0,1,0
7339,170,0,0,60,60,0,1,0,1,0
131,1471,0,0,62,62,0,1,0,1,0
6559,4,0,0,60,60,0,1,0,1,0
3398,2587,0,0,62,62,0,1,0,1,0
1714,1017,0,0,63,63,0,1,0,1,0
22186,1215,0,0,62,62,0,1,0,1,0
13,2367,0,0,65,65,0,1,0,1,0
19892,2938,0,0,74,74,0,1,0,1,0
21955,1772,0,0,65,65,0,1,0,1,0
812,2470,0,0,150,150,0,1,0,1,0
16985,199,0,0,61,61,0,1,0,1,0
18,3216,0,0,62,62,0,1,0,1,0
16951,255,0,0,62,62,0,1,0,1,0
18047,1880,0,0,62,62,0,1,0,1,0
2211,2636,0,0,64,64,0,1,0,1,0
6064,1194,0,0,134,134,0,1,0,1,0
13281,3216,0,0,62,62,0,1,0,1,0
1580,2883,0,0,62,62,0,1,0,1,0
0,0,0,0,98,98,0,1,0,1,0
20557,1771,0,0,62,62,0,1,0,1,0
19901,2587,0,0,66,66,0,1,0,1,0
2772,3216,0,0,63,63,0,1,0,1,0
12,2506,0,0,81,81,0,1,0,1,0
8646,2892,0,0,66,66,0,1,0,1,0
21151,1788,0,0,66,66,0,1,0,1,0
18524,223,0,0,60,60,0,1,0,1,0
1322,1017,0,0,146,146,0,1,0,1,0
7339,2845,0,0,60,60,0,1,0,1,0
3005,1923,0,0,62,62,0,1,0,1,0
2879,1017,0,0,62,62,0,1,0,1,0
12,1051,0,0,95,95,0,1,0,1,0
1975,2229,0,0,62,62,0,1,0,1,0
1804,375,0,0,60,60,0,1,0,1,0
2056,1936,0,0,62,62,0,1,0,1,0
488,2580,0,0,62,62,0,1,0,1,0
5715,1107,0,0,72,72,0,1,0,1,0
1803,940,0,0,60,60,0,1,0,1,0
1816,3212,0,0,61,61,0,1,0,1,0
3151,2587,0,0,62,62,0,1,0,1,0
6552,2093,0,0,145,145,0,1,0,1,0
16471,245,0,0,60,60,0,1,0,1,0
13468,1472,0,0,66,66,0,1,0,1,0
16951,255,0,0,62,62,0,1,0,1,0
3233,1472,0,0,62,62,0,1,0,1,0
6368,2183,0,0,67,67,0,1,0,1,0
9673,2256,0,0,66,66,0,1,0,1,0
2127,3216,0,0,86,86,0,1,0,1,0
1658,1147,0,0,146,146,0,1,0,1,0
6679,1876,0,0,62,62,0,1,0,1,0
17583,2636,0,0,63,63,0,1,0,1,0
12482,3216,0,0,66,66,0,1,0,1,0
18245,1017,0,0,66,66,0,1,0,1,0
1132,2938,0,0,74,74,0,1,0,1,0
20358,2256,0,0,66,66,0,1,0,1,0
16951,255,0,0,62,62,0,1,0,1,0
18484,3216,0,0,62,62,0,1,0,1,0
13450,2582,0,0,66,66,0,1,0,1,0
2499,1888,0,0,62,62,0,1,0,1,0
92,2619,0,0,62,62,0,1,0,1,0
1921,7,0,0,60,60,0,1,0,1,0
5767,2938,0,0,62,62,0,1,0,1,0
5313,1838,0,0,129,129,0,1,0,1,0
16951,255,0,0,62,62,0,1,0,1,0
11871,3212,0,0,66,66,0,1,0,1,0
3065,7,0,0,60,60,0,1,0,1,0
15379,3190,0,0,62,62,0,1,0,1,0
7929,2587,0,0,62,62,0,1,0,1,0
16951,255,0,0,62,62,0,1,0,1,0
19162,1017,0,0,62,62,0,1,0,1,0
16659,1771,0,0,66,66,0,1,0,1,0
14321,1780,0,0,64,64,0,1,0,1,0
19419,2953,0,0,66,66,0,1,0,1,0
9614,3105,0,0,86,86,0,1,0,1,0
14982,2634,0,0,62,62,0,1,0,1,0
9710,1017,0,0,63,63,0,1,0,1,0
826,179,0,0,60,60,0,1,0,1,0
2786,1481,0,0,101,101,0,1,0,1,0
14997,1810,0,0,66,66,0,1,0,1,0
702,1734,0,0,146,146,0,1,0,1,0
9273,6,0,0,60,60,0,1,0,1,0
19041,2577,0,0,104,104,0,1,0,1,0
6685,1840,0,0,62,62,0,1,0,1,0
108,2883,0,0,63,63,0,1,0,1,0
2191,2256,0,0,66,66,0,1,0,1,0
1879,441,0,0,156,156,0,1,0,1,0
19,3216,0,0,62,62,0,1,0,1,0
844,2938,0,0,146,146,0,1,0,1,0
1607,1784,0,0,64,64,0,1,0,1,0
10165,1147,0,0,66,66,0,1,0,1,0
6378,2567,0,0,62,62,0,1,0,1,0
1806,1023,0,0,60,60,0,1,0,1,0
1804,375,0,0,60,60,0,1,0,1,0
1401,2938,0,0,62,62,0,1,0,1,0
1668,2950,0,0,63,63,0,1,0,1,0
20953,1472,0,0,62,62,0,1,0,1,0
16967,1812,0,0,68,68,0,1,0,1,0
18377,2938,0,0,74,74,0,1,0,1,0
9971,2605,0,0,66,66,0,1,0,1,0
7981,2938,0,0,62,62,0,1,0,1,0
16120,2607,0,0,79,79,0,1,0,1,0
10390,1147,0,0,64,64,0,1,0,1,0
13782,1910,0,0,64,64,0,1,0,1,0
2132,1888,0,0,62,62,0,1,0,1,0
17821,2938,0,0,65,65,0,1,0,1,0
1962,2608,0,0,62,62,0,1,0,1,0
10232,488,0,0,65,65,0,1,0,1,0
709,2924,0,0,66,66,0,1,0,1,0
2007,2256,0,0,66,66,0,1,0,1,0
13789,212,0,0,66,66,0,1,0,1,0
9243,1224,0,0,62,62,0,1,0,1,0
9877,1888,0,0,62,62,0,1,0,1,0
3196,1017,0,0,64,64,0,1,0,1,0
18257,7,0,0,80,80,0,1,0,1,0
5912,1472,0,0,62,62,0,1,0,1,0
2501,2575,0,0,145,145,0,1,0,1,0
12,933,0,0,85,85,0,1,0,1,0
17027,2630,0,0,65,65,0,1,0,1,0
16951,255,0,0,62,62,0,1,0,1,0
19881,1790,0,0,62,62,0,1,0,1,0
683,1147,0,0,63,63,0,1,0,1,0
0,0,0,0,98,98,0,1,0,1,0
1360,1888,0,0,62,62,0,1,0,1,0
17803,2618,0,0,63,63,0,1,0,1,0
18239,1771,0,0,66,66,0,1,0,1,0
2572,2575,0,0,62,62,0,1,0,1,0
13035,222,0,0,68,68,0,1,0,1,0
2061,3216,0,0,62,62,0,1,0,1,0
1608,2477,0,0,60,60,0,1,0,1,0
20268,2938,0,0,62,62,0,1,0,1,0
2084,1471,0,0,145,145,0,1,0,1,0
12,3092,0,0,190,190,0,1,0,1,0
7956,2587,0,0,63,63,0,1,0,1,0
14327,1888,0,0,66,66,0,1,0,1,0
4250,6,0,0,60,60,0,1,0,1,0
6727,2256,0,0,65,65,0,1,0,1,0
7860,1273,0,0,62,62,0,1,0,1,0
9905,1884,0,0,63,63,0,1,0,1,0
11573,2256,0,0,62,62,0,1,0,1,0
22227,1888,0,0,66,66,0,1,0,1,0
2448,2486,0,0,149,149,0,1,0,1,0
1672,1147,0,0,62,62,0,1,0,1,0
22701,2256,0,0,66,66,0,1,0,1,0
8682,1792,0,0,120,120,0,1,0,1,0
13606,3216,0,0,66,66,0,1,0,1,0
0,0,0,0,179,179,0,1,0,1,0
2600,7,0,0,60,60,0,1,0,1,0
1804,1763,0,0,60,60,0,1,0,1,0
13183,992,0,0,62,62,0,1,0,1,0
1606,2478,0,0,60,60,0,1,0,1,0
9563,1215,0,0,66,66,0,1,0,1,0
13370,1804,0,0,66,66,0,1,0,1,0
273,8,0,0,60,60,0,1,0,1,0
606,2573,0,0,60,60,0,1,0,1,0
10844,2160,0,0,66,66,0,1,0,1,0
5508,1804,0,0,65,65,0,1,0,1,0
2679,2256,0,0,62,62,0,1,0,1,0
2297,2486,0,0,69,69,0,1,0,1,0
17439,1147,0,0,66,66,0,1,0,1,0
2308,428,0,0,62,62,0,1,0,1,0
7509,218,0,0,60,60,0,1,0,1,0
844,2938,0,0,146,146,0,1,0,1,0
7864,1147,0,0,146,146,0,1,0,1,0
1230,983,0,0,62,62,0,1,0,1,0
16951,255,0,0,62,62,0,1,0,1,0
413,1824,0,0,62,62,0,1,0,1,0
0,0,0,0,98,98,0,1,0,1,0
316,2941,0,0,66,66,0,1,0,1,0
2466,2587,0,0,62,62,0,1,0,1,0
14826,1816,0,0,65,65,0,1,0,1,0
15593,1804,0,0,66,66,0,1,0,1,0
0,0,0,0,98,98,0,1,0,1,0
1962,2608,0,0,62,62,0,1,0,1,0
20236,1742,0,0,63,63,0,1,0,1,0
14622,1147,0,0,62,62,0,1,0,1,0
10393,3216,0,0,66,66,0,1,0,1,0
786,1888,0,0,62,62,0,1,0,1,0
11046,1147,0,0,62,62,0,1,0,1,0
1814,1147,0,0,65,65,0,1,0,1,0
20315,1147,0,0,62,62,0,1,0,1,0
11663,2883,0,0,64,64,0,1,0,1,0
12276,2256,0,0,62,62,0,1,0,1,0
16633,1880,0,0,66,66,0,1,0,1,0
19428,242,0,0,145,145,0,1,0,1,0
18101,3216,0,0,64,64,0,1,0,1,0
21309,2256,0,0,65,65,0,1,0,1,0
639,2444,0,0,143,143,0,1,0,1,0
153,3216,0,0,63,63,0,1,0,1,0
360,3105,0,0,286,286,0,1,0,1,0
763,1888,0,0,62,62,0,1,0,1,0
19315,3212,0,0,62,62,0,1,0,1,0
3263,2634,0,0,62,62,0,1,0,1,0
6696,1810,0,0,63,63,0,1,0,1,0
9392,2256,0,0,63,63,0,1,0,1,0
9886,1886,0,0,62,62,0,1,0,1,0
17797,2540,0,0,62,62,0,1,0,1,0
21067,2607,0,0,73,73,0,1,0,1,0
20799,2949,0,0,66,66,0,1,0,1,0
352,797,0,0,62,62,0,1,0,1,0
17349,2938,0,0,66,66,0,1,0,1,0
11279,1886,0,0,66,66,0,1,0,1,0
1952,7,0,0,60,60,0,1,0,1,0
2266,1017,0,0,64,64,0,1,0,1,0
4154,2632,0,0,135,135,0,1,0,1,0
2066,1888,0,0,62,62,0,1,0,1,0
6381,2558,0,0,62,62,0,1,0,1,0
19840,2938,0,0,65,65,0,1,0,1,0
7425,3216,0,0,62,62,0,1,0,1,0
20197,2618,0,0,62,62,0,1,0,1,0
4262,7,0,0,60,60,0,1,0,1,0
16670,2591,0,0,62,62,0,1,0,1,0
1739,2550,0,0,146,146,0,1,0,1,0
16464,3139,0,0,65,65,0,1,0,1,0
4711,2256,0,0,62,62,0,1,0,1,0
18789,1826,0,0,66,66,0,1,0,1,0
1418,1017,0,0,62,62,0,1,0,1,0
5925,1477,0,0,76,76,0,1,0,1,0
18385,1484,0,0,66,66,0,1,0,1,0
1643,3216,0,0,63,63,0,1,0,1,0
4079,1147,0,0,66,66,0,1,0,1,0
1804,1764,0,0,60,60,0,1,0,1,0
2088,1471,0,0,145,145,0,1,0,1,0
1723,2636,0,0,66,66,0,1,0,1,0
11404,1109,0,0,64,64,0,1,0,1,0
12,1055,0,0,97,97,0,1,0,1,0
13610,3021,0,0,69,69,0,1,0,1,0
16951,255,0,0,62,62,0,1,0,1,0
1461,1505,0,0,62,62,0,1,0,1,0
19,513,0,0,62,62,0,1,0,1,0
10797,2587,0,0,66,66,0,1,0,1,0
4560,2256,0,0,63,63,0,1,0,1,0
2610,440,0,0,146,146,0,1,0,1,0
12233,1215,0,0,63,63,0,1,0,1,0
21499,2612,0,0,66,66,0,1,0,1,0
11967,1147,0,0,66,66,0,1,0,1,0
8010,323,0,0,60,60,0,1,0,1,0
612,188,0,0,60,60,0,1,0,1,0
2412,2093,0,0,145,145,0,1,0,1,0
588,2611,0,0,78,78,0,1,0,1,0
5413,962,0,0,64,64,0,1,0,1,0
20285,2938,0,0,67,67,0,1,0,1,0
4099,2477,0,0,62,62,0,1,0,1,0
7387,7,0,0,60,60,0,1,0,1,0
10392,3216,0,0,66,66,0,1,0,1,0
18225,3139,0,0,66,66,0,1,0,1,0
12,184,0,0,99,99,0,1,0,1,0
0,0,0,0,60,60,0,1,0,1,0
19009,1214,0,0,68,68,0,1,0,1,0
1667,1147,0,0,146,146,0,1,0,1,0
160,1888,0,0,62,62,0,1,0,1,0
12,3074,0,0,320,320,0,1,0,1,0
16951,255,0,0,62,62,0,1,0,1,0
11040,2947,0,0,63,63,0,1,0,1,0
4259,7,0,0,60,60,0,1,0,1,0
16951,255,0,0,62,62,0,1,0,1,0
16717,1055,0,0,64,64,0,1,0,1,0
9253,2587,0,0,65,65,0,1,0,1,0
11652,1858,0,0,62,62,0,1,0,1,0
20699,2697,0,0,78,78,0,1,0,1,0
637,397,0,0,143,143,0,1,0,1,0
1266,1219,0,0,60,60,0,1,0,1,0
2590,1802,0,0,65,65,0,1,0,1,0
1398,2261,0,0,60,60,0,1,0,1,0
18279,3157,0,0,65,65,0,1,0,1,0
12,207,0,0,320,320,0,1,0,1,0
19802,1017,0,0,66,66,0,1,0,1,0
5589,7,0,0,60,60,0,1,0,1,0
20230,1771,0,0,62,62,0,1,0,1,0
4812,1081,0,0,62,62,0,1,0,1,0
19822,2833,0,0,60,60,0,1,0,1,0
2544,2244,0,0,93,93,0,1,0,1,0
7456,3216,0,0,62,62,0,1,0,1,0
18964,950,0,0,67,67,0,1,0,1,0
9093,1215,0,0,65,65,0,1,0,1,0
2441,2938,0,0,62,62,0,1,0,1,0
7,12,0,0,346,346,0,1,0,1,0
8472,2938,0,0,66,66,0,1,0,1,0
18,1147,0,0,62,62,0,1,0,1,0
9563,1215,0,0,64,64,0,1,0,1,0
20382,1781,0,0,64,64,0,1,0,1,0
9590,2852,0,0,62,62,0,1,0,1,0
17036,1795,0,0,66,66,0,1,0,1,0
360,3105,0,0,1291,1291,0,1,0,1,0
12,2199,0,0,97,97,0,1,0,1,0
438,2587,0,0,62,62,0,1,0,1,0
1077,2951,0,0,137,137,0,1,0,1,0
6651,1129,0,0,156,156,0,1,0,1,0
14948,1017,0,0,146,146,0,1,0,1,0
3530,7,0,0,60,60,0,1,0,1,0
16951,255,0,0,62,62,0,1,0,1,0
12995,318,0,0,75,75,0,1,0,1,0
16951,255,0,0,62,62,0,1,0,1,0
13664,1079,0,0,66,66,0,1,0,1,0
16630,2636,0,0,66,66,0,1,0,1,0
1444,2209,0,0,146,146,0,1,0,1,0
3378,2587,0,0,62,62,0,1,0,1,0
1779,283,0,0,134,134,0,1,0,1,0
7335,1070,0,0,60,60,0,1,0,1,0
4329,1771,0,0,62,62,0,1,0,1,0
13,3068,0,0,176,176,0,1,0,1,0
7593,1804,0,0,63,63,0,1,0,1,0
3701,7,0,0,60,60,0,1,0,1,0
2977,374,0,0,60,60,0,1,0,1,0
13131,1262,0,0,89,89,0,1,0,1,0
12533,1797,0,0,61,61,0,1,0,1,0
8069,1147,0,0,63,63,0,1,0,1,0
14410,2648,0,0,62,62,0,1,0,1,0
14607,2883,0,0,66,66,0,1,0,1,0
6826,348,0,0,158,158,0,1,0,1,0
1718,2256,0,0,136,136,0,1,0,1,0
12,2199,0,0,97,97,0,1,0,1,0
17,2466,0,0,77,77,0,1,0,1,0
2009,2636,0,0,63,63,0,1,0,1,0
10879,3129,0,0,65,65,0,1,0,1,0
12899,2573,0,0,62,62,0,1,0,1,0
7326,1649,0,0,60,60,0,1,0,1,0
18635,2608,0,0,63,63,0,1,0,1,0
15099,1590,0,0,62,62,0,1,0,1,0
21,1901,0,0,64,64,0,1,0,1,0
20784,1147,0,0,66,66,0,1,0,1,0
2230,2581,0,0,66,66,0,1,0,1,0
22589,300,0,0,64,64,0,1,0,1,0
9614,3105,0,0,86,86,0,1,0,1,0
2632,1936,0,0,62,62,0,1,0,1,0
6059,2938,0,0,63,63,0,1,0,1,0
20833,2824,0,0,65,65,0,1,0,1,0
12,2784,0,0,82,82,0,1,0,1,0
1282,1888,0,0,62,62,0,1,0,1,0
8,2758,0,0,60,60,0,1,0,1,0
19802,1135,0,0,62,62,0,1,0,1,0
13663,2505,0,0,63,63,0,1,0,1,0
279,1773,0,0,90,90,0,1,0,1,0
1525,1444,0,0,145,145,0,1,0,1,0
20082,2936,0,0,89,89,0,1,0,1,0
1843,2880,0,0,65,65,0,1,0,1,0
16809,800,0,0,66,66,0,1,0,1,0
9426,2938,0,0,78,78,0,1,0,1,0
8810,1472,0,0,62,62,0,1,0,1,0
1289,1771,0,0,65,65,0,1,0,1,0
7339,170,0,0,60,60,0,1,0,1,0
18741,1086,0,0,66,66,0,1,0,1,0
497,2220,0,0,220,220,0,1,0,1,0
2890,6,0,0,60,60,0,1,0,1,0
19428,242,0,0,145,145,0,1,0,1,0
9618,2632,0,0,65,65,0,1,0,1,0
16951,255,0,0,62,62,0,1,0,1,0
17828,3204,0,0,65,65,0,1,0,1,0
16478,392,0,0,60,60,0,1,0,1,0
5699,2938,0,0,74,74,0,1,0,1,0
7614,2604,0,0,62,62,0,1,0,1,0
1367,1147,0,0,66,66,0,1,0,1,0
9657,2871,0,0,64,64,0,1,0,1,0
3197,1147,0,0,146,146,0,1,0,1,0
13801,155,0,0,66,66,0,1,0,1,0
307,3216,0,0,64,64,0,1,0,1,0
16951,255,0,0,62,62,0,1,0,1,0
6996,2632,0,0,62,62,0,1,0,1,0
844,2929,0,0,146,146,0,1,0,1,0
2765,393,0,0,62,62,0,1,0,1,0
1309,2587,0,0,62,62,0,1,0,1,0
20731,2938,0,0,66,66,0,1,0,1,0
9457,1017,0,0,66,66,0,1,0,1,0
5242,2311,0,0,64,64,0,1,0,1,0
17798,2636,0,0,66,66,0,1,0,1,0
19701,2616,0,0,91,91,0,1,0,1,0
6506,936,0,0,62,62,0,1,0,1,0
12,3110,0,0,326,326,0,1,0,1,0
12,2199,0,0,97,97,0,1,0,1,0
2874,1804,0,0,146,146,0,1,0,1,0
19235,9,0,0,61,61,0,1,0,1,0
7663,3216,0,0,62,62,0,1,0,1,0
3106,1147,0,0,62,62,0,1,0,1,0
16849,1936,0,0,66,66,0,1,0,1,0
1439,1017,0,0,146,146,0,1,0,1,0
10790,2587,0,0,65,65,0,1,0,1,0
22,1899,0,0,64,64,0,1,0,1,0
7991,18,0,0,60,60,0,1,0,1,0
16368,2256,0,0,64,64,0,1,0,1,0
10503,206,0,0,97,97,0,1,0,1,0
488,3159,0,0,65,65,0,1,0,1,0
1784,6,0,0,60,60,0,1,0,1,0
413,2925,0,0,62,62,0,1,0,1,0
8749,2938,0,0,71,71,0,1,0,1,0
3163,2938,0,0,136,136,0,1,0,1,0
1367,1147,0,0,62,62,0,1,0,1,0
19482,1017,0,0,62,62,0,1,0,1,0
3237,1017,0,0,64,64,0,1,0,1,0
1138,2646,0,0,65,65,0,1,0,1,0
499,187,0,0,1093,1093,0,1,0,1,0
332,1017,0,0,65,65,0,1,0,1,0
15908,3139,0,0,64,64,0,1,0,1,0
997,2938,0,0,64,64,0,1,0,1,0
102,1771,0,0,65,65,0,1,0,1,0
13085,1915,0,0,63,63,0,1,0,1,0
9723,2222,0,0,66,66,0,1,0,1,0
1206,1155,0,0,64,64,0,1,0,1,0
16951,255,0,0,62,62,0,1,0,1,0
360,3105,0,0,1287,1287,0,1,0,1,0
224,1147,0,0,64,64,0,1,0,1,0
3465,1853,0,0,62,62,0,1,0,1,0
16951,255,0,0,62,62,0,1,0,1,0
483,2577,0,0,63,63,0,1,0,1,0
22447,1179,0,0,72,72,0,1,0,1,0
5733,2938,0,0,67,67,0,1,0,1,0
10966,2911,0,0,62,62,0,1,0,1,0
22427,2910,0,0,66,66,0,1,0,1,0
3150,2587,0,0,63,63,0,1,0,1,0
16951,255,0,0,62,62,0,1,0,1,0
360,3105,0,0,164,164,0,1,0,1,0
13036,1827,0,0,63,63,0,1,0,1,0
7915,3215,0,0,144,144,0,1,0,1,0
16844,2938,0,0,66,66,0,1,0,1,0
612,143,0,0,60,60,0,1,0,1,0
20172,1493,0,0,129,129,0,1,0,1,0
3220,1147,0,0,62,62,0,1,0,1,0
2366,1147,0,0,62,62,0,1,0,1,0
4540,1804,0,0,66,66,0,1,0,1,0
16951,255,0,0,62,62,0,1,0,1,0
1330,697,0,0,62,62,0,1,0,1,0
11356,3215,0,0,66,66,0,1,0,1,0
10978,1888,0,0,62,62,0,1,0,1,0
16731,1104,0,0,100,100,0,1,0,1,0
3268,1888,0,0,62,62,0,1,0,1,0
6552,2093,0,0,145,145,0,1,0,1,0
6229,2938,0,0,78,78,0,1,0,1,0
1877,1017,0,0,62,62,0,1,0,1,0
1206,1017,0,0,62,62,0,1,0,1,0
8796,1147,0,0,66,66,0,1,0,1,0
9214,3257,0,0,60,60,0,1,0,1,0
536,3216,0,0,62,62,0,1,0,1,0
360,3105,0,0,447,447,0,1,0,1,0
16780,2883,0,0,62,62,0,1,0,1,0
8267,1017,0,0,146,146,0,1,0,1,0
14640,84,0,0,61,61,0,1,0,1,0
6725,2583,0,0,64,64,0,1,0,1,0
636,2113,0,0,116,116,0,1,0,1,0
16951,255,0,0,62,62,0,1,0,1,0
360,3105,0,0,164,164,0,1,0,1,0
5966,1840,0,0,112,112,0,1,0,1,0
12689,2938,0,0,64,64,0,1,0,1,0
2660,1888,0,0,62,62,0,1,0,1,0
2585,5,0,0,60,60,0,1,0,1,0
21918,1154,0,0,65,65,0,1,0,1,0
17538,989,0,0,62,62,0,1,0,1,0
1552,2883,0,0,62,62,0,1,0,1,0
13459,1472,0,0,66,66,0,1,0,1,0
15922,835,0,0,66,66,0,1,0,1,0
16951,255,0,0,62,62,0,1,0,1,0
32,657,0,0,151,151,0,1,0,1,0
21649,1147,0,0,66,66,0,1,0,1,0
7229,389,0,0,62,62,0,1,0,1,0
1756,1033,0,0,146,146,0,1,0,1,0
4860,2584,0,0,62,62,0,1,0,1,0
636,280,0,0,62,62,0,1,0,1,0
1253,997,0,0,146,146,0,1,0,1,0
1203,1880,0,0,66,66,0,1,0,1,0
13645,1827,0,0,62,62,0,1,0,1,0
9999,2587,0,0,66,66,0,1,0,1,0
1753,2499,0,0,141,141,0,1,0,1,0
1614,1800,0,0,65,65,0,1,0,1,0
10386,2938,0,0,66,66,0,1,0,1,0
22115,1215,0,0,62,62,0,1,0,1,0
6166,1367,0,0,62,62,0,1,0,1,0
2796,1017,0,0,65,65,0,1,0,1,0
12,2346,0,0,332,332,0,1,0,1,0
20294,3139,0,0,72,72,0,1,0,1,0
18496,761,0,0,93,93,0,1,0,1,0
2157,3072,0,0,60,60,0,1,0,1,0
566,3216,0,0,145,145,0,1,0,1,0
17,2483,0,0,141,141,0,1,0,1,0
1569,2197,0,0,64,64,0,1,0,1,0
2075,3216,0,0,62,62,0,1,0,1,0
18230,1211,0,0,62,62,0,1,0,1,0
148,3139,0,0,65,65,0,1,0,1,0
17,239,0,0,145,145,0,1,0,1,0
6304,2938,0,0,60,60,0,1,0,1,0
7230,3216,0,0,65,65,0,1,0,1,0
20734,1880,0,0,66,66,0,1,0,1,0
12186,3212,0,0,65,65,0,1,0,1,0
19806,1017,0,0,66,66,0,1,0,1,0
13060,2922,0,0,66,66,0,1,0,1,0
9214,3256,0,0,60,60,0,1,0,1,0
18916,3216,0,0,68,68,0,1,0,1,0
1665,1147,0,0,146,146,0,1,0,1,0
13036,1827,0,0,65,65,0,1,0,1,0
17167,1098,0,0,65,65,0,1,0,1,0
3692,1017,0,0,62,62,0,1,0,1,0
2062,1888,0,0,62,62,0,1,0,1,0
0,0,0,0,98,98,0,1,0,1,0
1957,3212,0,0,62,62,0,1,0,1,0
2723,2939,0,0,62,62,0,1,0,1,0
3711,1909,0,0,67,67,0,1,0,1,0
12491,125,0,0,135,135,0,1,0,1,0
1985,3216,0,0,63,63,0,1,0,1,0
376,797,0,0,62,62,0,1,0,1,0
2219,2636,0,0,62,62,0,1,0,1,0
12342,1880,0,0,66,66,0,1,0,1,0
7280,344,0,0,60,60,0,1,0,1,0
11345,1033,0,0,62,62,0,1,0,1,0
13122,1054,0,0,66,66,0,1,0,1,0
11543,1860,0,0,66,66,0,1,0,1,0
21855,1797,0,0,63,63,0,1,0,1,0
1354,2611,0,0,66,66,0,1,0,1,0
428,1217,0,0,61,61,0,1,0,1,0
3624,612,0,0,108,108,0,1,0,1,0
13732,1147,0,0,63,63,0,1,0,1,0
16799,809,0,0,66,66,0,1,0,1,0
15694,1787,0,0,145,145,0,1,0,1,0
19152,2173,0,0,66,66,0,1,0,1,0
2397,2934,0,0,145,145,0,1,0,1,0
6916,3211,0,0,66,66,0,1,0,1,0
1453,2636,0,0,62,62,0,1,0,1,0
720,2205,0,0,66,66,0,1,0,1,0
2200,2636,0,0,139,139,0,1,0,1,0
14852,2867,0,0,89,89,0,1,0,1,0
19031,2256,0,0,66,66,0,1,0,1,0
12874,2558,0,0,66,66,0,1,0,1,0
2956,2214,0,0,62,62,0,1,0,1,0
11343,1017,0,0,63,63,0,1,0,1,0
3833,1025,0,0,65,65,0,1,0,1,0
17041,1792,0,0,66,66,0,1,0,1,0
4965,2611,0,0,63,63,0,1,0,1,0
701,2595,0,0,64,64,0,1,0,1,0
6288,2154,0,0,74,74,0,1,0,1,0
75,1147,0,0,62,62,0,1,0,1,0
14087,3216,0,0,66,66,0,1,0,1,0
1571,823,0,0,62,62,0,1,0,1,0
8258,2524,0,0,156,156,0,1,0,1,0
16247,1888,0,0,62,62,0,1,0,1,0
16951,255,0,0,62,62,0,1,0,1,0
763,1888,0,0,62,62,0,1,0,1,0
13282,1771,0,0,66,66,0,1,0,1,0
16531,219,0,0,110,110,0,1,0,1,0
6233,1646,0,0,60,60,0,1,0,1,0
6605,1176,0,0,147,147,0,1,0,1,0
8225,2587,0,0,64,64,0,1,0,1,0
2588,6,0,0,60,60,0,1,0,1,0
19063,2233,0,0,66,66,0,1,0,1,0
1464,2167,0,0,93,93,0,1,0,1,0
8002,715,0,0,66,66,0,1,0,1,0
15062,150,0,0,123,123,0,1,0,1,0
5244,3,0,0,60,60,0,1,0,1,0
7339,237,0,0,60,60,0,1,0,1,0
16951,255,0,0,62,62,0,1,0,1,0
17200,1880,0,0,63,63,0,1,0,1,0
5327,1888,0,0,62,62,0,1,0,1,0
7326,1649,0,0,60,60,0,1,0,1,0
11672,1096,0,0,65,65,0,1,0,1,0
10446,1017,0,0,64,64,0,1,0,1,0
8164,2727,0,0,60,60,0,1,0,1,0
16951,255,0,0,62,62,0,1,0,1,0
360,3105,0,0,577,577,0,1,0,1,0
6533,1215,0,0,62,62,0,1,0,1,0
21953,1147,0,0,66,66,0,1,0,1,0
21444,3216,0,0,64,64,0,1,0,1,0
1240,1011,0,0,62,62,0,1,0,1,0
16087,2587,0,0,66,66,0,1,0,1,0
19753,509,0,0,66,66,0,1,0,1,0
1464,2459,0,0,103,103,0,1,0,1,0
1962,1147,0,0,62,62,0,1,0,1,0
844,2938,0,0,146,146,0,1,0,1,0
15089,1578,0,0,62,62,0,1,0,1,0
6552,2093,0,0,145,145,0,1,0,1,0
16951,255,0,0,62,62,0,1,0,1,0
20892,3139,0,0,66,66,0,1,0,1,0
16500,2410,0,0,63,63,0,1,0,1,0
129,7,0,0,60,60,0,1,0,1,0
352,797,0,0,62,62,0,1,0,1,0
19349,983,0,0,64,64,0,1,0,1,0
92,2256,0,0,62,62,0,1,0,1,0
521,635,0,0,64,64,0,1,0,1,0
2084,1471,0,0,145,145,0,1,0,1,0
12248,2587,0,0,62,62,0,1,0,1,0
18144,1147,0,0,66,66,0,1,0,1,0
1886,1023,0,0,62,62,0,1,0,1,0
1680,2902,0,0,65,65,0,1,0,1,0
2979,1893,0,0,62,62,0,1,0,1,0
16951,255,0,0,62,62,0,1,0,1,0
5744,230,0,0,60,60,0,1,0,1,0
20745,1880,0,0,66,66,0,1,0,1,0
16951,255,0,0,62,62,0,1,0,1,0
12084,1150,0,0,65,65,0,1,0,1,0
5186,1888,0,0,62,62,0,1,0,1,0
3176,2605,0,0,62,62,0,1,0,1,0
4356,1472,0,0,66,66,0,1,0,1,0
17758,2883,0,0,66,66,0,1,0,1,0
14480,3216,0,0,66,66,0,1,0,1,0
21694,3216,0,0,65,65,0,1,0,1,0
8164,2725,0,0,60,60,0,1,0,1,0
636,280,0,0,146,146,0,1,0,1,0
1957,1147,0,0,62,62,0,1,0,1,0
7126,1107,0,0,87,87,0,1,0,1,0
1367,1836,0,0,146,146,0,1,0,1,0
2307,1017,0,0,65,65,0,1,0,1,0
11240,1017,0,0,66,66,0,1,0,1,0
1812,1147,0,0,62,62,0,1,0,1,0
14608,3215,0,0,62,62,0,1,0,1,0
1804,1170,0,0,60,60,0,1,0,1,0
3035,2587,0,0,62,62,0,1,0,1,0
17979,343,0,0,66,66,0,1,0,1,0
15450,1472,0,0,63,63,0,1,0,1,0
9284,1767,0,0,81,81,0,1,0,1,0
18086,2938,0,0,65,65,0,1,0,1,0
130,1017,0,0,62,62,0,1,0,1,0
10458,2883,0,0,65,65,0,1,0,1,0
9214,3256,0,0,60,60,0,1,0,1,0
3217,2429,0,0,156,156,0,1,0,1,0
10664,1132,0,0,66,66,0,1,0,1,0
10473,2632,0,0,62,62,0,1,0,1,0
1545,795,0,0,62,62,0,1,0,1,0
16951,255,0,0,62,62,0,1,0,1,0
1547,2616,0,0,62,62,0,1,0,1,0
15072,697,0,0,146,146,0,1,0,1,0
275,9,0,0,60,60,0,1,0,1,0
2135,1167,0,0,64,64,0,1,0,1,0
7682,149,0,0,60,60,0,1,0,1,0
1729,1017,0,0,62,62,0,1,0,1,0
16214,3216,0,0,66,66,0,1,0,1,0
572,2218,0,0,71,71,0,1,0,1,0
1330,697,0,0,62,62,0,1,0,1,0
12870,1804,0,0,63,63,0,1,0,1,0
2404,2256,0,0,62,62,0,1,0,1,0
612,23,0,0,60,60,0,1,0,1,0
120,2486,0,0,62,62,0,1,0,1,0
19644,1888,0,0,64,64,0,1,0,1,0
10386,1888,0,0,63,63,0,1,0,1,0
22605,1215,0,0,62,62,0,1,0,1,0
8659,509,0,0,62,62,0,1,0,1,0
18903,1147,0,0,66,66,0,1,0,1,0
2906,1888,0,0,62,62,0,1,0,1,0
17033,1797,0,0,67,67,0,1,0,1,0
1844,2882,0,0,65,65,0,1,0,1,0
638,2936,0,0,146,146,0,1,0,1,0
2138,1215,0,0,62,62,0,1,0,1,0
1295,1782,0,0,63,63,0,1,0,1,0
9662,2636,0,0,66,66,0,1,0,1,0
20527,2336,0,0,73,73,0,1,0,1,0
18820,1147,0,0,66,66,0,1,0,1,0
12882,2549,0,0,63,63,0,1,0,1,0
2692,2587,0,0,63,63,0,1,0,1,0
19698,3212,0,0,65,65,0,1,0,1,0
20806,2256,0,0,66,66,0,1,0,1,0
1106,1147,0,0,62,62,0,1,0,1,0
6101,195,0,0,60,60,0,1,0,1,0
545,2256,0,0,66,66,0,1,0,1,0
7904,2636,0,0,62,62,0,1,0,1,0
6471,2926,0,0,62,62,0,1,0,1,0
12342,1880,0,0,66,66,0,1,0,1,0
3172,1771,0,0,65,65,0,1,0,1,0
12177,3212,0,0,62,62,0,1,0,1,0
13468,2587,0,0,63,63,0,1,0,1,0
16951,255,0,0,62,62,0,1,0,1,0
7335,1070,0,0,60,60,0,1,0,1,0
2590,104,0,0,60,60,0,1,0,1,0
11758,2611,0,0,67,67,0,1,0,1,0
2547,2573,0,0,60,60,0,1,0,1,0
14483,3216,0,0,66,66,0,1,0,1,0
15751,1524,0,0,115,115,0,1,0,1,0
2288,1472,0,0,65,65,0,1,0,1,0
19157,1770,0,0,66,66,0,1,0,1,0
1291,1147,0,0,62,62,0,1,0,1,0
21179,2256,0,0,62,62,0,1,0,1,0
3817,7,0,0,60,60,0,1,0,1,0
1820,1147,0,0,62,62,0,1,0,1,0
1441,2531,0,0,62,62,0,1,0,1,0
17584,2587,0,0,66,66,0,1,0,1,0
16951,255,0,0,62,62,0,1,0,1,0
8164,2728,0,0,60,60,0,1,0,1,0
1804,2921,0,0,60,60,0,1,0,1,0
22101,1827,0,0,68,68,0,1,0,1,0
3195,2848,0,0,71,71,0,1,0,1,0
8,1873,0,0,60,60,0,1,0,1,0
7524,2938,0,0,63,63,0,1,0,1,0
360,3105,0,0,936,936,0,1,0,1,0
17339,509,0,0,62,62,0,1,0,1,0
15694,333,0,0,145,145,0,1,0,1,0
16951,255,0,0,62,62,0,1,0,1,0
8221,2596,0,0,62,62,0,1,0,1,0
1802,798,0,0,61,61,0,1,0,1,0
5877,13,0,0,60,60,0,1,0,1,0
13120,1052,0,0,66,66,0,1,0,1,0
15785,2624,0,0,66,66,0,1,0,1,0
13034,2587,0,0,64,64,0,1,0,1,0
1931,1554,0,0,64,64,0,1,0,1,0
459,244,0,0,69,69,0,1,0,1,0
13871,509,0,0,64,64,0,1,0,1,0
22309,1883,0,0,66,66,0,1,0,1,0
2749,2623,0,0,66,66,0,1,0,1,0
17577,394,0,0,61,61,0,1,0,1,0
794,2648,0,0,64,64,0,1,0,1,0
21150,1804,0,0,65,65,0,1,0,1,0
1661,1147,0,0,146,146,0,1,0,1,0
9603,3139,0,0,66,66,0,1,0,1,0
13440,2587,0,0,66,66,0,1,0,1,0
8107,2494,0,0,65,65,0,1,0,1,0
7918,1147,0,0,62,62,0,1,0,1,0
13012,1804,0,0,62,62,0,1,0,1,0
6472,2938,0,0,62,62,0,1,0,1,0
432,2587,0,0,62,62,0,1,0,1,0
14056,1898,0,0,66,66,0,1,0,1,0
11859,202,0,0,63,63,0,1,0,1,0
21854,1824,0,0,65,65,0,1,0,1,0
11026,2938,0,0,66,66,0,1,0,1,0
21678,2884,0,0,66,66,0,1,0,1,0
5298,1147,0,0,62,62,0,1,0,1,0
2062,3216,0,0,62,62,0,1,0,1,0
16951,255,0,0,62,62,0,1,0,1,0
16630,1885,0,0,66,66,0,1,0,1,0
778,1888,0,0,146,146,0,1,0,1,0
6795,461,0,0,143,143,0,1,0,1,0
365,1147,0,0,64,64,0,1,0,1,0
20749,10,0,0,76,76,0,1,0,1,0
5540,1054,0,0,62,62,0,1,0,1,0
9864,1017,0,0,126,126,0,1,0,1,0
362,1215,0,0,64,64,0,1,0,1,0
20589,1052,0,0,62,62,0,1,0,1,0
8082,409,0,0,60,60,0,1,0,1,0
14507,2303,0,0,77,77,0,1,0,1,0
22504,2611,0,0,72,72,0,1,0,1,0
14071,1147,0,0,62,62,0,1,0,1,0
360,3105,0,0,863,863,0,1,0,1,0
377,3216,0,0,62,62,0,1,0,1,0
7830,2612,0,0,63,63,0,1,0,1,0
14621,2883,0,0,63,63,0,1,0,1,0
4087,1017,0,0,65,65,0,1,0,1,0
6277,1017,0,0,64,64,0,1,0,1,0
16951,255,0,0,62,62,0,1,0,1,0
2260,2636,0,0,62,62,0,1,0,1,0
2230,2587,0,0,64,64,0,1,0,1,0
13191,2256,0,0,66,66,0,1,0,1,0
1538,2256,0,0,66,66,0,1,0,1,0
2847,2902,0,0,146,146,0,1,0,1,0
1542,1888,0,0,65,65,0,1,0,1,0
2412,2093,0,0,145,145,0,1,0,1,0
16839,697,0,0,146,146,0,1,0,1,0
11737,1147,0,0,65,65,0,1,0,1,0
10893,1838,0,0,64,64,0,1,0,1,0
3788,2497,0,0,60,60,0,1,0,1,0
1575,2938,0,0,61,61,0,1,0,1,0
15159,1147,0,0,62,62,0,1,0,1,0
19157,1771,0,0,66,66,0,1,0,1,0
17023,2634,0,0,65,65,0,1,0,1,0
497,1605,0,0,66,66,0,1,0,1,0
3176,2587,0,0,146,146,0,1,0,1,0
9079,1771,0,0,82,82,0,1,0,1,0
7949,314,0,0,60,60,0,1,0,1,0
14844,2256,0,0,64,64,0,1,0,1,0
8308,1017,0,0,94,94,0,1,0,1,0
21066,2611,0,0,62,62,0,1,0,1,0
14132,3212,0,0,65,65,0,1,0,1,0
17629,1147,0,0,64,64,0,1,0,1,0
21049,2593,0,0,62,62,0,1,0,1,0
3229,1472,0,0,62,62,0,1,0,1,0
2432,1022,0,0,61,61,0,1,0,1,0
18340,1212,0,0,65,65,0,1,0,1,0
1423,1017,0,0,63,63,0,1,0,1,0
1424,15,0,0,60,60,0,1,0,1,0
1500,2674,0,0,65,65,0,1,0,1,0
1527,771,0,0,62,62,0,1,0,1,0
1330,697,0,0,62,62,0,1,0,1,0
5586,2892,0,0,62,62,0,1,0,1,0
1588,1703,0,0,63,63,0,1,0,1,0
5524,1017,0,0,146,146,0,1,0,1,0
1164,3216,0,0,62,62,0,1,0,1,0
14592,2256,0,0,62,62,0,1,0,1,0
3235,2585,0,0,145,145,0,1,0,1,0
702,1017,0,0,66,66,0,1,0,1,0
1020,2938,0,0,62,62,0,1,0,1,0
15021,1864,0,0,66,66,0,1,0,1,0
432,1222,0,0,60,60,0,1,0,1,0
7787,2587,0,0,72,72,0,1,0,1,0
17318,1138,0,0,71,71,0,1,0,1,0
4059,697,0,0,63,63,0,1,0,1,0
10464,2905,0,0,68,68,0,1,0,1,0
13564,3051,0,0,63,63,0,1,0,1,0
2832,7,0,0,60,60,0,1,0,1,0
8114,2550,0,0,62,62,0,1,0,1,0
7335,1070,0,0,60,60,0,1,0,1,0
16951,255,0,0,62,62,0,1,0,1,0
12325,224,0,0,62,62,0,1,0,1,0
3015,7,0,0,60,60,0,1,0,1,0
2387,2941,0,0,145,145,0,1,0,1,0
63,1147,0,0,146,146,0,1,0,1,0
16951,255,0,0,62,62,0,1,0,1,0
16951,255,0,0,62,62,0,1,0,1,0
3072,2486,0,0,145,145,0,1,0,1,0
747,2589,0,0,62,62,0,1,0,1,0
592,1147,0,0,66,66,0,1,0,1,0
42,1147,0,0,146,146,0,1,0,1,0
3249,1147,0,0,62,62,0,1,0,1,0
1677,1215,0,0,62,62,0,1,0,1,0
15254,2636,0,0,120,120,0,1,0,1,0
7281,432,0,0,61,61,0,1,0,1,0
4127,1147,0,0,66,66,0,1,0,1,0
17533,1771,0,0,64,64,0,1,0,1,0
1484,1147,0,0,62,62,0,1,0,1,0
5760,2560,0,0,83,83,0,1,0,1,0
3559,2938,0,0,70,70,0,1,0,1,0
16906,2585,0,0,66,66,0,1,0,1,0
13,212,0,0,61,61,0,1,0,1,0
3895,1555,0,0,62,62,0,1,0,1,0
17679,1886,0,0,62,62,0,1,0,1,0
11981,1106,0,0,64,64,0,1,0,1,0
17600,1833,0,0,62,62,0,1,0,1,0
10835,2603,0,0,71,71,0,1,0,1,0
19757,3214,0,0,66,66,0,1,0,1,0
2651,1888,0,0,63,63,0,1,0,1,0
16659,1771,0,0,62,62,0,1,0,1,0
13082,1017,0,0,64,64,0,1,0,1,0
4035,697,0,0,69,69,0,1,0,1,0
16069,2256,0,0,62,62,0,1,0,1,0
805,2403,0,0,60,60,0,1,0,1,0
1804,768,0,0,60,60,0,1,0,1,0
11,3228,0,0,84,84,0,1,0,1,0
20119,1054,0,0,65,65,0,1,0,1,0
19361,1884,0,0,66,66,0,1,0,1,0
2584,1677,0,0,160,160,0,1,0,1,0
1512,1771,0,0,62,62,0,1,0,1,0
1785,1767,0,0,63,63,0,1,0,1,0
13799,1215,0,0,66,66,0,1,0,1,0
2597,1771,0,0,62,62,0,1,0,1,0
1934,2587,0,0,66,66,0,1,0,1,0
1126,2940,0,0,86,86,0,1,0,1,0
3070,3169,0,0,64,64,0,1,0,1,0
14537,2210,0,0,65,65,0,1,0,1,0
1682,2256,0,0,62,62,0,1,0,1,0
9938,1834,0,0,62,62,0,1,0,1,0
4908,1048,0,0,60,60,0,1,0,1,0
13592,1856,0,0,64,64,0,1,0,1,0
1322,2945,0,0,62,62,0,1,0,1,0
17966,712,0,0,65,65,0,1,0,1,0
12,2461,0,0,81,81,0,1,0,1,0
9179,1017,0,0,66,66,0,1,0,1,0
6412,1215,0,0,62,62,0,1,0,1,0
7511,1801,0,0,66,66,0,1,0,1,0
10991,2256,0,0,62,62,0,1,0,1,0
5259,2256,0,0,66,66,0,1,0,1,0
18321,1472,0,0,64,64,0,1,0,1,0
11176,2656,0,0,68,68,0,1,0,1,0
7335,1070,0,0,60,60,0,1,0,1,0
3219,1888,0,0,62,62,0,1,0,1,0
6381,2900,0,0,62,62,0,1,0,1,0
1737,3216,0,0,63,63,0,1,0,1,0
7874,310,0,0,61,61,0,1,0,1,0
1809,396,0,0,61,61,0,1,0,1,0
7815,288,0,0,61,61,0,1,0,1,0
12137,3212,0,0,66,66,0,1,0,1,0
14790,3139,0,0,64,64,0,1,0,1,0
42,2948,0,0,139,139,0,1,0,1,0
6651,1129,0,0,156,156,0,1,0,1,0
9715,2615,0,0,66,66,0,1,0,1,0
20746,1880,0,0,66,66,0,1,0,1,0
13792,1472,0,0,66,66,0,1,0,1,0
5448,1747,0,0,146,146,0,1,0,1,0
20764,2256,0,0,64,64,0,1,0,1,0
13081,1024,0,0,62,62,0,1,0,1,0
13090,1358,0,0,140,140,0,1,0,1,0
19439,2256,0,0,62,62,0,1,0,1,0
2974,7,0,0,60,60,0,1,0,1,0
22218,2941,0,0,75,75,0,1,0,1,0
288,1765,0,0,66,66,0,1,0,1,0
19851,2191,0,0,64,64,0,1,0,1,0
17464,2946,0,0,66,66,0,1,0,1,0
2236,2610,0,0,62,62,0,1,0,1,0
2853,2611,0,0,66,66,0,1,0,1,0
8068,1147,0,0,64,64,0,1,0,1,0
3192,2636,0,0,63,63,0,1,0,1,0
99,1462,0,0,62,62,0,1,0,1,0
605,1215,0,0,63,63,0,1,0,1,0
3470,430,0,0,156,156,0,1,0,1,0
20116,613,0,0,102,102,0,1,0,1,0
8075,11,0,0,60,60,0,1,0,1,0
6699,1017,0,0,66,66,0,1,0,1,0
2540,2600,0,0,62,62,0,1,0,1,0
16951,255,0,0,62,62,0,1,0,1,0
2991,1771,0,0,66,66,0,1,0,1,0
10306,703,0,0,70,70,0,1,0,1,0
4577,2256,0,0,63,63,0,1,0,1,0
11029,1888,0,0,62,62,0,1,0,1,0
10598,1880,0,0,71,71,0,1,0,1,0
16951,255,0,0,62,62,0,1,0,1,0
4735,1747,0,0,80,80,0,1,0,1,0
235,2198,0,0,62,62,0,1,0,1,0
21816,2587,0,0,97,97,0,1,0,1,0
13746,1161,0,0,62,62,0,1,0,1,0
2513,3177,0,0,147,147,0,1,0,1,0
16951,255,0,0,62,62,0,1,0,1,0
639,1729,0,0,147,147,0,1,0,1,0
17091,1147,0,0,69,69,0,1,0,1,0
5749,147,0,0,60,60,0,1,0,1,0
2361,1147,0,0,65,65,0,1,0,1,0
2020,2888,0,0,67,67,0,1,0,1,0
20876,2587,0,0,62,62,0,1,0,1,0
2653,3216,0,0,63,63,0,1,0,1,0
13149,1379,0,0,79,79,0,1,0,1,0
1361,2636,0,0,66,66,0,1,0,1,0
19876,3216,0,0,62,62,0,1,0,1,0
352,797,0,0,62,62,0,1,0,1,0
20778,1147,0,0,66,66,0,1,0,1,0
7524,1141,0,0,62,62,0,1,0,1,0
2747,2256,0,0,62,62,0,1,0,1,0
1289,2501,0,0,118,118,0,1,0,1,0
14838,2836,0,0,66,66,0,1,0,1,0
1330,697,0,0,62,62,0,1,0,1,0
781,1888,0,0,62,62,0,1,0,1,0
19062,308,0,0,60,60,0,1,0,1,0
14416,3216,0,0,66,66,0,1,0,1,0
15543,2256,0,0,63,63,0,1,0,1,0
3649,63,0,0,60,60,0,1,0,1,0
8164,2725,0,0,60,60,0,1,0,1,0
11565,2256,0,0,62,62,0,1,0,1,0
1281,2543,0,0,60,60,0,1,0,1,0
22509,2611,0,0,77,77,0,1,0,1,0
5823,104,0,0,60,60,0,1,0,1,0
20893,1888,0,0,66,66,0,1,0,1,0
20364,3139,0,0,66,66,0,1,0,1,0
5067,1147,0,0,62,62,0,1,0,1,0
2136,7,0,0,60,60,0,1,0,1,0
2846,2629,0,0,62,62,0,1,0,1,0
16951,255,0,0,62,62,0,1,0,1,0
1554,1448,0,0,145,145,0,1,0,1,0
2303,1017,0,0,146,146,0,1,0,1,0
8348,2756,0,0,60,60,0,1,0,1,0
1800,1771,0,0,61,61,0,1,0,1,0
18848,1147,0,0,66,66,0,1,0,1,0
3497,2256,0,0,62,62,0,1,0,1,0
7326,180,0,0,60,60,0,1,0,1,0
14911,1804,0,0,64,64,0,1,0,1,0
3106,1147,0,0,62,62,0,1,0,1,0
2580,2853,0,0,60,60,0,1,0,1,0
10465,2908,0,0,68,68,0,1,0,1,0
18116,3216,0,0,62,62,0,1,0,1,0
13441,2586,0,0,66,66,0,1,0,1,0
146,1017,0,0,62,62,0,1,0,1,0
7517,2938,0,0,62,62,0,1,0,1,0
451,2970,0,0,63,63,0,1,0,1,0
10475,6,0,0,60,60,0,1,0,1,0
19618,841,0,0,66,66,0,1,0,1,0
1139,1886,0,0,62,62,0,1,0,1,0
612,19,0,0,60,60,0,1,0,1,0
12968,974,0,0,63,63,0,1,0,1,0
22093,432,0,0,66,66,0,1,0,1,0
16911,2587,0,0,66,66,0,1,0,1,0
2376,3216,0,0,62,62,0,1,0,1,0
16951,255,0,0,62,62,0,1,0,1,0
12685,1808,0,0,62,62,0,1,0,1,0
15154,3216,0,0,64,64,0,1,0,1,0
1506,7,0,0,60,60,0,1,0,1,0
0,0,0,0,98,98,0,1,0,1,0
699,1147,0,0,62,62,0,1,0,1,0
6402,1017,0,0,63,63,0,1,0,1,0
432,1222,0,0,60,60,0,1,0,1,0
8927,255,0,0,60,60,0,1,0,1,0
14637,93,0,0,62,62,0,1,0,1,0
6325,1147,0,0,146,146,0,1,0,1,0
12709,2243,0,0,63,63,0,1,0,1,0
3441,2636,0,0,63,63,0,1,0,1,0
13943,1072,0,0,81,81,0,1,0,1,0
8301,1005,0,0,62,62,0,1,0,1,0
12047,1795,0,0,66,66,0,1,0,1,0
9206,2256,0,0,74,74,0,1,0,1,0
16951,255,0,0,62,62,0,1,0,1,0
22137,1801,0,0,66,66,0,1,0,1,0
7949,314,0,0,60,60,0,1,0,1,0
1912,2575,0,0,145,145,0,1,0,1,0
1278,2522,0,0,142,142,0,1,0,1,0
6402,1215,0,0,62,62,0,1,0,1,0
19718,2486,0,0,64,64,0,1,0,1,0
13578,2636,0,0,64,64,0,1,0,1,0
16951,255,0,0,62,62,0,1,0,1,0
2078,1771,0,0,62,62,0,1,0,1,0
20997,2363,0,0,66,66,0,1,0,1,0
22302,1880,0,0,63,63,0,1,0,1,0
18,2938,0,0,62,62,0,1,0,1,0
7335,1072,0,0,60,60,0,1,0,1,0
3588,2583,0,0,62,62,0,1,0,1,0
16951,255,0,0,62,62,0,1,0,1,0
29,1888,0,0,62,62,0,1,0,1,0
7333,1067,0,0,60,60,0,1,0,1,0
8028,21,0,0,60,60,0,1,0,1,0
11450,245,0,0,60,60,0,1,0,1,0
1310,1017,0,0,62,62,0,1,0,1,0
12406,2191,0,0,64,64,0,1,0,1,0
20289,2256,0,0,146,146,0,1,0,1,0
6436,1017,0,0,65,65,0,1,0,1,0
6962,1886,0,0,62,62,0,1,0,1,0
14534,3212,0,0,62,62,0,1,0,1,0
13350,262,0,0,65,65,0,1,0,1,0
1806,1017,0,0,62,62,0,1,0,1,0
2967,381,0,0,60,60,0,1,0,1,0
18771,2607,0,0,66,66,0,1,0,1,0
11222,1152,0,0,66,66,0,1,0,1,0
4260,7,0,0,60,60,0,1,0,1,0
8171,1073,0,0,60,60,0,1,0,1,0
620,3246,0,0,143,143,0,1,0,1,0
12195,3212,0,0,65,65,0,1,0,1,0
29,262,0,0,71,71,0,1,0,1,0
2014,1888,0,0,62,62,0,1,0,1,0
2543,1792,0,0,62,62,0,1,0,1,0
2478,2597,0,0,146,146,0,1,0,1,0
9214,3256,0,0,60,60,0,1,0,1,0
1807,2883,0,0,146,146,0,1,0,1,0
0,0,0,0,98,98,0,1,0,1,0
21908,1798,0,0,62,62,0,1,0,1,0
15672,1210,0,0,92,92,0,1,0,1,0
12919,2221,0,0,66,66,0,1,0,1,0
2321,3216,0,0,62,62,0,1,0,1,0
16113,2611,0,0,65,65,0,1,0,1,0
9576,1174,0,0,66,66,0,1,0,1,0
3221,1472,0,0,62,62,0,1,0,1,0
2950,7,0,0,60,60,0,1,0,1,0
11776,430,0,0,62,62,0,1,0,1,0
2686,1017,0,0,62,62,0,1,0,1,0
16951,255,0,0,62,62,0,1,0,1,0
8760,3246,0,0,120,120,0,1,0,1,0
823,472,0,0,60,60,0,1,0,1,0
775,2608,0,0,62,62,0,1,0,1,0
10133,2601,0,0,66,66,0,1,0,1,0
48,339,0,0,64,64,0,1,0,1,0
6545,1215,0,0,62,62,0,1,0,1,0
1800,2925,0,0,60,60,0,1,0,1,0
1146,1480,0,0,62,62,0,1,0,1,0
22683,10,0,0,88,88,0,1,0,1,0
2809,7,0,0,60,60,0,1,0,1,0
14555,2225,0,0,64,64,0,1,0,1,0
2525,2576,0,0,145,145,0,1,0,1,0
16951,255,0,0,62,62,0,1,0,1,0
18201,1888,0,0,66,66,0,1,0,1,0
13978,3216,0,0,66,66,0,1,0,1,0
1317,2947,0,0,62,62,0,1,0,1,0
20553,1888,0,0,66,66,0,1,0,1,0
12,207,0,0,320,320,0,1,0,1,0
601,2636,0,0,62,62,0,1,0,1,0
3849,2926,0,0,66,66,0,1,0,1,0
5534,2517,0,0,116,116,0,1,0,1,0
16951,255,0,0,62,62,0,1,0,1,0
13279,2310,0,0,63,63,0,1,0,1,0
15505,1208,0,0,62,62,0,1,0,1,0
3137,1815,0,0,79,79,0,1,0,1,0
20699,3159,0,0,66,66,0,1,0,1,0
17526,983,0,0,66,66,0,1,0,1,0
19641,2636,0,0,64,64,0,1,0,1,0
8740,1787,0,0,154,154,0,1,0,1,0
2610,2883,0,0,62,62,0,1,0,1,0
4516,983,0,0,66,66,0,1,0,1,0
612,215,0,0,60,60,0,1,0,1,0
8171,1073,0,0,60,60,0,1,0,1,0
1324,800,0,0,62,62,0,1,0,1,0
674,1748,0,0,146,146,0,1,0,1,0
6725,2583,0,0,126,126,0,1,0,1,0
2654,3216,0,0,62,62,0,1,0,1,0
1465,985,0,0,65,65,0,1,0,1,0
11551,1935,0,0,94,94,0,1,0,1,0
16268,1885,0,0,63,63,0,1,0,1,0
10996,1147,0,0,62,62,0,1,0,1,0
771,1017,0,0,66,66,0,1,0,1,0
2363,1147,0,0,146,146,0,1,0,1,0
13329,1215,0,0,66,66,0,1,0,1,0
11450,1686,0,0,60,60,0,1,0,1,0
583,2197,0,0,72,72,0,1,0,1,0
1365,2458,0,0,109,109,0,1,0,1,0
15255,2632,0,0,62,62,0,1,0,1,0
1320,2946,0,0,90,90,0,1,0,1,0
14527,3216,0,0,62,62,0,1,0,1,0
2347,2587,0,0,62,62,0,1,0,1,0
4689,2256,0,0,62,62,0,1,0,1,0
11451,2214,0,0,62,62,0,1,0,1,0
1126,1215,0,0,62,62,0,1,0,1,0
10718,1173,0,0,64,64,0,1,0,1,0
12841,1147,0,0,64,64,0,1,0,1,0
14052,3216,0,0,66,66,0,1,0,1,0
8560,2938,0,0,63,63,0,1,0,1,0
360,3105,0,0,815,815,0,1,0,1,0
1838,3214,0,0,64,64,0,1,0,1,0
11667,3216,0,0,63,63,0,1,0,1,0
14545,1147,0,0,62,62,0,1,0,1,0
7602,1136,0,0,62,62,0,1,0,1,0
21,2256,0,0,62,62,0,1,0,1,0
2066,1888,0,0,62,62,0,1,0,1,0
16012,2938,0,0,63,63,0,1,0,1,0
9758,1197,0,0,64,64,0,1,0,1,0
14473,2778,0,0,74,74,0,1,0,1,0
1836,1771,0,0,146,146,0,1,0,1,0
16338,2636,0,0,63,63,0,1,0,1,0
31,263,0,0,72,72,0,1,0,1,0
8065,1147,0,0,66,66,0,1,0,1,0
2477,2581,0,0,145,145,0,1,0,1,0
11621,2747,0,0,64,64,0,1,0,1,0
636,280,0,0,146,146,0,1,0,1,0
9796,1215,0,0,66,66,0,1,0,1,0
7575,1116,0,0,62,62,0,1,0,1,0
21481,2604,0,0,66,66,0,1,0,1,0
3181,518,0,0,74,74,0,1,0,1,0
7349,1564,0,0,71,71,0,1,0,1,0
17266,1888,0,0,66,66,0,1,0,1,0
17319,2632,0,0,66,66,0,1,0,1,0
1131,2938,0,0,75,75,0,1,0,1,0
16951,255,0,0,62,62,0,1,0,1,0
11481,1776,0,0,64,64,0,1,0,1,0
10256,582,0,0,63,63,0,1,0,1,0
572,1888,0,0,63,63,0,1,0,1,0
11653,3216,0,0,65,65,0,1,0,1,0
16951,255,0,0,62,62,0,1,0,1,0
5716,1099,0,0,146,146,0,1,0,1,0
2728,1017,0,0,62,62,0,1,0,1,0
2971,2633,0,0,62,62,0,1,0,1,0
4286,2537,0,0,146,146,0,1,0,1,0
18815,263,0,0,60,60,0,1,0,1,0
7461,1799,0,0,66,66,0,1,0,1,0
18626,1213,0,0,62,62,0,1,0,1,0
21341,1086,0,0,62,62,0,1,0,1,0
844,2938,0,0,146,146,0,1,0,1,0
13389,1804,0,0,64,64,0,1,0,1,0
16975,2210,0,0,66,66,0,1,0,1,0
21481,2604,0,0,66,66,0,1,0,1,0
16951,255,0,0,62,62,0,1,0,1,0
6369,2608,0,0,62,62,0,1,0,1,0
16951,255,0,0,62,62,0,1,0,1,0
2471,1215,0,0,65,65,0,1,0,1,0
1423,1888,0,0,62,62,0,1,0,1,0
2667,1147,0,0,63,63,0,1,0,1,0
1920,2256,0,0,62,62,0,1,0,1,0
20750,10,0,0,73,73,0,1,0,1,0
19288,2587,0,0,73,73,0,1,0,1,0
17408,1934,0,0,73,73,0,1,0,1,0
8583,1017,0,0,62,62,0,1,0,1,0
1771,1147,0,0,62,62,0,1,0,1,0
1947,1881,0,0,65,65,0,1,0,1,0
22520,1017,0,0,64,64,0,1,0,1,0
4967,1026,0,0,60,60,0,1,0,1,0
1813,1147,0,0,65,65,0,1,0,1,0
12053,1791,0,0,66,66,0,1,0,1,0
16951,255,0,0,62,62,0,1,0,1,0
13959,2253,0,0,66,66,0,1,0,1,0
13762,1936,0,0,66,66,0,1,0,1,0
1881,1147,0,0,81,81,0,1,0,1,0
19955,1079,0,0,64,64,0,1,0,1,0
5067,1147,0,0,63,63,0,1,0,1,0
3075,3216,0,0,62,62,0,1,0,1,0
1591,1888,0,0,62,62,0,1,0,1,0
16951,255,0,0,62,62,0,1,0,1,0
5421,2580,0,0,146,146,0,1,0,1,0
6713,2568,0,0,68,68,0,1,0,1,0
2259,1472,0,0,62,62,0,1,0,1,0
3543,2938,0,0,66,66,0,1,0,1,0
17769,2393,0,0,66,66,0,1,0,1,0
1207,7,0,0,60,60,0,1,0,1,0
0,0,0,0,98,98,0,1,0,1,0
6233,1646,0,0,60,60,0,1,0,1,0
5684,1048,0,0,62,62,0,1,0,1,0
1288,1771,0,0,62,62,0,1,0,1,0
3103,1804,0,0,62,62,0,1,0,1,0
2223,2587,0,0,62,62,0,1,0,1,0
5547,29,0,0,60,60,0,1,0,1,0
7986,715,0,0,64,64,0,1,0,1,0
2433,2938,0,0,62,62,0,1,0,1,0
16951,255,0,0,62,62,0,1,0,1,0
20685,2710,0,0,71,71,0,1,0,1,0
7339,170,0,0,60,60,0,1,0,1,0
7928,1147,0,0,62,62,0,1,0,1,0
2431,2853,0,0,63,63,0,1,0,1,0
7898,959,0,0,62,62,0,1,0,1,0
1665,1147,0,0,146,146,0,1,0,1,0
21936,1150,0,0,66,66,0,1,0,1,0
8221,2587,0,0,62,62,0,1,0,1,0
2809,1017,0,0,95,95,0,1,0,1,0
14373,1888,0,0,66,66,0,1,0,1,0
8422,2256,0,0,62,62,0,1,0,1,0
12585,1147,0,0,62,62,0,1,0,1,0
7257,1,0,0,62,62,0,1,0,1,0
11575,2256,0,0,62,62,0,1,0,1,0
16112,2611,0,0,66,66,0,1,0,1,0
8010,323,0,0,60,60,0,1,0,1,0
1675,2946,0,0,68,68,0,1,0,1,0
21483,2609,0,0,65,65,0,1,0,1,0
11829,120,0,0,64,64,0,1,0,1,0
8043,1888,0,0,62,62,0,1,0,1,0
17,237,0,0,150,150,0,1,0,1,0
3101,3216,0,0,62,62,0,1,0,1,0
7629,1752,0,0,62,62,0,1,0,1,0
13124,1279,0,0,98,98,0,1,0,1,0
13643,2573,0,0,66,66,0,1,0,1,0
23,258,0,0,67,67,0,1,0,1,0
1287,1498,0,0,147,147,0,1,0,1,0
20781,1147,0,0,66,66,0,1,0,1,0
1588,1703,0,0,63,63,0,1,0,1,0
2771,2256,0,0,62,62,0,1,0,1,0
11027,1814,0,0,64,64,0,1,0,1,0
20069,1885,0,0,62,62,0,1,0,1,0
18542,3216,0,0,62,62,0,1,0,1,0
6889,1888,0,0,62,62,0,1,0,1,0
16956,246,0,0,61,61,0,1,0,1,0
16951,255,0,0,62,62,0,1,0,1,0
2906,2599,0,0,146,146,0,1,0,1,0
18832,1147,0,0,66,66,0,1,0,1,0
22091,1215,0,0,62,62,0,1,0,1,0
20877,1017,0,0,100,100,0,1,0,1,0
2183,7,0,0,60,60,0,1,0,1,0
316,2256,0,0,62,62,0,1,0,1,0
9603,3139,0,0,64,64,0,1,0,1,0
2578,2256,0,0,146,146,0,1,0,1,0
2121,3216,0,0,62,62,0,1,0,1,0
18,2961,0,0,137,137,0,1,0,1,0
10451,2883,0,0,63,63,0,1,0,1,0
6839,2573,0,0,144,144,0,1,0,1,0
17212,509,0,0,65,65,0,1,0,1,0
15789,2601,0,0,66,66,0,1,0,1,0
16041,7,0,0,60,60,0,1,0,1,0
693,7,0,0,60,60,0,1,0,1,0
1698,1147,0,0,146,146,0,1,0,1,0
16951,255,0,0,62,62,0,1,0,1,0
8114,2550,0,0,62,62,0,1,0,1,0
6410,2856,0,0,137,137,0,1,0,1,0
2984,1147,0,0,146,146,0,1,0,1,0
5427,3139,0,0,128,128,0,1,0,1,0
800,2883,0,0,66,66,0,1,0,1,0
1388,3216,0,0,62,62,0,1,0,1,0
10111,3054,0,0,62,62,0,1,0,1,0
3505,3167,0,0,64,64,0,1,0,1,0
11548,1472,0,0,66,66,0,1,0,1,0
32,516,0,0,62,62,0,1,0,1,0
6651,1129,0,0,156,156,0,1,0,1,0
1661,1147,0,0,62,62,0,1,0,1,0
2301,1946,0,0,60,60,0,1,0,1,0
717,2587,0,0,63,63,0,1,0,1,0
170,2924,0,0,147,147,0,1,0,1,0
11896,1169,0,0,63,63,0,1,0,1,0
1163,1017,0,0,114,114,0,1,0,1,0
13287,2442,0,0,66,66,0,1,0,1,0
9171,1216,0,0,65,65,0,1,0,1,0
14959,2636,0,0,65,65,0,1,0,1,0
1929,2587,0,0,65,65,0,1,0,1,0
12,312,0,0,60,60,0,1,0,1,0
16731,1089,0,0,71,71,0,1,0,1,0
10480,1167,0,0,68,68,0,1,0,1,0
11052,1208,0,0,60,60,0,1,0,1,0
18485,1776,0,0,62,62,0,1,0,1,0
2206,1017,0,0,62,62,0,1,0,1,0
275,1067,0,0,66,66,0,1,0,1,0
2244,2587,0,0,85,85,0,1,0,1,0
20699,2697,0,0,78,78,0,1,0,1,0
10600,1888,0,0,72,72,0,1,0,1,0
11602,1804,0,0,62,62,0,1,0,1,0
17871,1155,0,0,62,62,0,1,0,1,0
1208,1590,0,0,64,64,0,1,0,1,0
13630,697,0,0,66,66,0,1,0,1,0
1268,7,0,0,60,60,0,1,0,1,0
2750,1147,0,0,62,62,0,1,0,1,0
14030,2235,0,0,66,66,0,1,0,1,0
289,1472,0,0,63,63,0,1,0,1,0
16122,2883,0,0,63,63,0,1,0,1,0
18778,2611,0,0,66,66,0,1,0,1,0
14070,2915,0,0,70,70,0,1,0,1,0
7509,218,0,0,60,60,0,1,0,1,0
10661,2585,0,0,66,66,0,1,0,1,0
17873,2235,0,0,66,66,0,1,0,1,0
13361,1804,0,0,66,66,0,1,0,1,0
844,2938,0,0,146,146,0,1,0,1,0
14723,1821,0,0,63,63,0,1,0,1,0
1245,1017,0,0,62,62,0,1,0,1,0
2651,3216,0,0,62,62,0,1,0,1,0
1473,3150,0,0,65,65,0,1,0,1,0
9614,3105,0,0,86,86,0,1,0,1,0
9089,1147,0,0,62,62,0,1,0,1,0
3141,2587,0,0,62,62,0,1,0,1,0
3864,1506,0,0,62,62,0,1,0,1,0
19447,3216,0,0,66,66,0,1,0,1,0
2763,1017,0,0,146,146,0,1,0,1,0
16847,1915,0,0,64,64,0,1,0,1,0
2273,2636,0,0,63,63,0,1,0,1,0
19358,1884,0,0,66,66,0,1,0,1,0
1345,2939,0,0,64,64,0,1,0,1,0
16951,255,0,0,62,62,0,1,0,1,0
6233,1646,0,0,60,60,0,1,0,1,0
2056,1147,0,0,62,62,0,1,0,1,0
2830,2587,0,0,62,62,0,1,0,1,0
720,2205,0,0,66,66,0,1,0,1,0
16951,255,0,0,62,62,0,1,0,1,0
16402,2256,0,0,63,63,0,1,0,1,0
6691,1888,0,0,65,65,0,1,0,1,0
1804,2921,0,0,60,60,0,1,0,1,0
16029,308,0,0,65,65,0,1,0,1,0
5918,2594,0,0,108,108,0,1,0,1,0
11411,383,0,0,66,66,0,1,0,1,0
16951,255,0,0,62,62,0,1,0,1,0
22510,2611,0,0,78,78,0,1,0,1,0
1517,1771,0,0,65,65,0,1,0,1,0
1250,1010,0,0,146,146,0,1,0,1,0
1804,1769,0,0,60,60,0,1,0,1,0
19798,1481,0,0,144,144,0,1,0,1,0
22225,208,0,0,91,91,0,1,0,1,0
3162,2587,0,0,62,62,0,1,0,1,0
9614,3105,0,0,86,86,0,1,0,1,0
22501,2603,0,0,74,74,0,1,0,1,0
2615,1017,0,0,62,62,0,1,0,1,0
15942,308,0,0,66,66,0,1,0,1,0
19888,1884,0,0,63,63,0,1,0,1,0
1688,1215,0,0,62,62,0,1,0,1,0
729,3216,0,0,66,66,0,1,0,1,0
8,2758,0,0,60,60,0,1,0,1,0
21352,1147,0,0,66,66,0,1,0,1,0
20045,2604,0,0,144,144,0,1,0,1,0
2199,2256,0,0,71,71,0,1,0,1,0
565,1166,0,0,62,62,0,1,0,1,0
6191,1801,0,0,65,65,0,1,0,1,0
686,7,0,0,60,60,0,1,0,1,0
16985,1827,0,0,73,73,0,1,0,1,0
2138,1500,0,0,146,146,0,1,0,1,0
9676,1018,0,0,64,64,0,1,0,1,0
9614,3105,0,0,86,86,0,1,0,1,0
1416,6,0,0,60,60,0,1,0,1,0
7949,314,0,0,60,60,0,1,0,1,0
5259,2754,0,0,142,142,0,1,0,1,0
16951,255,0,0,62,62,0,1,0,1,0
1297,264,0,0,89,89,0,1,0,1,0
19615,2626,0,0,66,66,0,1,0,1,0
1648,3216,0,0,63,63,0,1,0,1,0
12907,1147,0,0,64,64,0,1,0,1,0
1459,1771,0,0,64,64,0,1,0,1,0
10172,2587,0,0,66,66,0,1,0,1,0
423,2587,0,0,62,62,0,1,0,1,0
2628,3216,0,0,66,66,0,1,0,1,0
12603,1147,0,0,62,62,0,1,0,1,0
15694,333,0,0,145,145,0,1,0,1,0
9253,1473,0,0,62,62,0,1,0,1,0
19,668,0,0,60,60,0,1,0,1,0
5278,2256,0,0,65,65,0,1,0,1,0
9512,2586,0,0,65,65,0,1,0,1,0
9256,1475,0,0,62,62,0,1,0,1,0
1666,1147,0,0,146,146,0,1,0,1,0
3619,2256,0,0,65,65,0,1,0,1,0
22683,10,0,0,88,88,0,1,0,1,0
12877,2554,0,0,65,65,0,1,0,1,0
360,3105,0,0,68,68,0,1,0,1,0
2306,431,0,0,63,63,0,1,0,1,0
11664,2660,0,0,66,66,0,1,0,1,0
18275,10,0,0,88,88,0,1,0,1,0
22666,15,0,0,82,82,0,1,0,1,0
5649,2156,0,0,152,152,0,1,0,1,0
18042,1886,0,0,65,65,0,1,0,1,0
19874,1771,0,0,65,65,0,1,0,1,0
423,2587,0,0,62,62,0,1,0,1,0
11540,1472,0,0,66,66,0,1,0,1,0
12617,2636,0,0,66,66,0,1,0,1,0
1813,1141,0,0,61,61,0,1,0,1,0
7425,3216,0,0,62,62,0,1,0,1,0
21144,1147,0,0,62,62,0,1,0,1,0
328,1017,0,0,66,66,0,1,0,1,0
7335,1070,0,0,60,60,0,1,0,1,0
1605,2605,0,0,133,133,0,1,0,1,0
2352,2587,0,0,62,62,0,1,0,1,0
16844,2938,0,0,66,66,0,1,0,1,0
234,1054,0,0,62,62,0,1,0,1,0
18963,3216,0,0,65,65,0,1,0,1,0
19870,1888,0,0,62,62,0,1,0,1,0
19263,3216,0,0,63,63,0,1,0,1,0
19968,2245,0,0,66,66,0,1,0,1,0
12,447,0,0,60,60,0,1,0,1,0
20496,2596,0,0,63,63,0,1,0,1,0
7981,2938,0,0,62,62,0,1,0,1,0
360,3105,0,0,303,303,0,1,0,1,0
1262,1147,0,0,62,62,0,1,0,1,0
2320,2256,0,0,62,62,0,1,0,1,0
6479,1215,0,0,62,62,0,1,0,1,0
523,7,0,0,60,60,0,1,0,1,0
2374,1147,0,0,62,62,0,1,0,1,0
1436,1017,0,0,65,65,0,1,0,1,0
5261,2256,0,0,66,66,0,1,0,1,0
382,797,0,0,62,62,0,1,0,1,0
14911,1804,0,0,64,64,0,1,0,1,0
8,2758,0,0,60,60,0,1,0,1,0
6195,3001,0,0,69,69,0,1,0,1,0
9207,1017,0,0,66,66,0,1,0,1,0
19419,2953,0,0,66,66,0,1,0,1,0
20340,1147,0,0,62,62,0,1,0,1,0
16951,255,0,0,62,62,0,1,0,1,0
19278,1147,0,0,63,63,0,1,0,1,0
642,1489,0,0,136,136,0,1,0,1,0
365,797,0,0,62,62,0,1,0,1,0
1568,1044,0,0,159,159,0,1,0,1,0
1354,2611,0,0,66,66,0,1,0,1,0
19772,509,0,0,66,66,0,1,0,1,0
263,1771,0,0,62,62,0,1,0,1,0
10221,3192,0,0,66,66,0,1,0,1,0
1982,3216,0,0,62,62,0,1,0,1,0
11977,2159,0,0,66,66,0,1,0,1,0
6279,1147,0,0,62,62,0,1,0,1,0
1925,7,0,0,60,60,0,1,0,1,0
2295,1472,0,0,64,64,0,1,0,1,0
17354,3194,0,0,66,66,0,1,0,1,0
2563,2943,0,0,145,145,0,1,0,1,0
21387,1796,0,0,62,62,0,1,0,1,0
7273,1,0,0,62,62,0,1,0,1,0
310,3216,0,0,62,62,0,1,0,1,0
15027,1480,0,0,91,91,0,1,0,1,0
8986,1147,0,0,62,62,0,1,0,1,0
252,280,0,0,66,66,0,1,0,1,0
2157,3072,0,0,60,60,0,1,0,1,0
3060,1888,0,0,69,69,0,1,0,1,0
17284,2209,0,0,66,66,0,1,0,1,0
19405,1881,0,0,66,66,0,1,0,1,0
16951,255,0,0,62,62,0,1,0,1,0
7754,700,0,0,130,130,0,1,0,1,0
19820,2787,0,0,60,60,0,1,0,1,0
4254,2931,0,0,135,135,0,1,0,1,0
5697,1137,0,0,120,120,0,1,0,1,0
19,2379,0,0,62,62,0,1,0,1,0
18319,2241,0,0,62,62,0,1,0,1,0
17541,1771,0,0,66,66,0,1,0,1,0
20455,2256,0,0,62,62,0,1,0,1,0
459,1030,0,0,62,62,0,1,0,1,0
2610,2883,0,0,66,66,0,1,0,1,0
18267,2587,0,0,62,62,0,1,0,1,0
1231,983,0,0,62,62,0,1,0,1,0
6442,2490,0,0,155,155,0,1,0,1,0
3237,2510,0,0,147,147,0,1,0,1,0
20501,1771,0,0,66,66,0,1,0,1,0
1233,509,0,0,62,62,0,1,0,1,0
2978,1891,0,0,62,62,0,1,0,1,0
22640,279,0,0,64,64,0,1,0,1,0
20745,1880,0,0,66,66,0,1,0,1,0
15781,3216,0,0,64,64,0,1,0,1,0
22237,1779,0,0,64,64,0,1,0,1,0
2911,2587,0,0,62,62,0,1,0,1,0
2828,2587,0,0,62,62,0,1,0,1,0
425,1147,0,0,62,62,0,1,0,1,0
2435,1880,0,0,62,62,0,1,0,1,0
8039,2256,0,0,146,146,0,1,0,1,0
1477,533,0,0,148,148,0,1,0,1,0
17447,2610,0,0,66,66,0,1,0,1,0
19,1773,0,0,62,62,0,1,0,1,0
1413,3216,0,0,64,64,0,1,0,1,0
17618,2574,0,0,69,69,0,1,0,1,0
18101,3216,0,0,64,64,0,1,0,1,0
16444,2881,0,0,90,90,0,1,0,1,0
3876,1923,0,0,62,62,0,1,0,1,0
3166,1472,0,0,62,62,0,1,0,1,0
21,3216,0,0,62,62,0,1,0,1,0
8171,1073,0,0,60,60,0,1,0,1,0
16951,255,0,0,62,62,0,1,0,1,0
10318,460,0,0,66,66,0,1,0,1,0
17213,1887,0,0,66,66,0,1,0,1,0
7457,1771,0,0,66,66,0,1,0,1,0
35,1804,0,0,65,65,0,1,0,1,0
3960,2162,0,0,62,62,0,1,0,1,0
14340,3212,0,0,66,66,0,1,0,1,0
637,474,0,0,127,127,0,1,0,1,0
7981,2938,0,0,62,62,0,1,0,1,0
2680,510,0,0,63,63,0,1,0,1,0
2068,31,0,0,60,60,0,1,0,1,0
11034,261,0,0,61,61,0,1,0,1,0
20684,2711,0,0,71,71,0,1,0,1,0
584,2611,0,0,78,78,0,1,0,1,0
9918,2938,0,0,66,66,0,1,0,1,0
10582,2256,0,0,64,64,0,1,0,1,0
2243,7,0,0,60,60,0,1,0,1,0
22620,2938,0,0,68,68,0,1,0,1,0
608,1888,0,0,63,63,0,1,0,1,0
11808,1882,0,0,63,63,0,1,0,1,0
19443,1883,0,0,66,66,0,1,0,1,0
17463,2947,0,0,66,66,0,1,0,1,0
5422,1888,0,0,66,66,0,1,0,1,0
13448,1465,0,0,66,66,0,1,0,1,0
20059,2587,0,0,65,65,0,1,0,1,0
19590,2587,0,0,66,66,0,1,0,1,0
802,1017,0,0,66,66,0,1,0,1,0
16076,1792,0,0,65,65,0,1,0,1,0
2702,2952,0,0,62,62,0,1,0,1,0
10475,6,0,0,60,60,0,1,0,1,0
14735,994,0,0,66,66,0,1,0,1,0
18239,1017,0,0,62,62,0,1,0,1,0
20119,1054,0,0,66,66,0,1,0,1,0
404,797,0,0,65,65,0,1,0,1,0
16951,255,0,0,62,62,0,1,0,1,0
17880,2467,0,0,88,88,0,1,0,1,0
13088,2499,0,0,154,154,0,1,0,1,0
16951,255,0,0,62,62,0,1,0,1,0
19159,1888,0,0,63,63,0,1,0,1,0
22293,1017,0,0,62,62,0,1,0,1,0
384,3216,0,0,62,62,0,1,0,1,0
2713,1888,0,0,62,62,0,1,0,1,0
414,2636,0,0,62,62,0,1,0,1,0
792,2491,0,0,146,146,0,1,0,1,0
1432,1017,0,0,62,62,0,1,0,1,0
2659,2611,0,0,78,78,0,1,0,1,0
11890,526,0,0,66,66,0,1,0,1,0
72,7,0,0,60,60,0,1,0,1,0
2263,1017,0,0,64,64,0,1,0,1,0
20380,1186,0,0,62,62,0,1,0,1,0
231,1147,0,0,146,146,0,1,0,1,0
1274,1888,0,0,62,62,0,1,0,1,0
14493,2179,0,0,64,64,0,1,0,1,0
5033,1017,0,0,136,136,0,1,0,1,0
3225,2587,0,0,146,146,0,1,0,1,0
1803,784,0,0,60,60,0,1,0,1,0
360,3105,0,0,932,932,0,1,0,1,0
17223,1144,0,0,66,66,0,1,0,1,0
2361,1147,0,0,66,66,0,1,0,1,0
3913,1499,0,0,64,64,0,1,0,1,0
238,2822,0,0,158,158,0,1,0,1,0
13074,185,0,0,60,60,0,1,0,1,0
5678,1161,0,0,65,65,0,1,0,1,0
16951,255,0,0,62,62,0,1,0,1,0
10385,1888,0,0,62,62,0,1,0,1,0
18039,1017,0,0,131,131,0,1,0,1,0
360,3105,0,0,244,244,0,1,0,1,0
16951,255,0,0,62,62,0,1,0,1,0
21551,3216,0,0,124,124,0,1,0,1,0
5327,1888,0,0,62,62,0,1,0,1,0
14965,1017,0,0,65,65,0,1,0,1,0
19588,1771,0,0,66,66,0,1,0,1,0
12299,2256,0,0,66,66,0,1,0,1,0
3440,1888,0,0,62,62,0,1,0,1,0
409,1812,0,0,63,63,0,1,0,1,0
1906,3174,0,0,147,147,0,1,0,1,0
20772,1804,0,0,63,63,0,1,0,1,0
1457,2866,0,0,66,66,0,1,0,1,0
9673,2256,0,0,66,66,0,1,0,1,0
1525,1444,0,0,145,145,0,1,0,1,0
612,183,0,0,60,60,0,1,0,1,0
12305,2256,0,0,66,66,0,1,0,1,0
7115,1147,0,0,146,146,0,1,0,1,0
22469,2256,0,0,62,62,0,1,0,1,0
1591,1888,0,0,62,62,0,1,0,1,0
20990,2382,0,0,65,65,0,1,0,1,0
1230,983,0,0,62,62,0,1,0,1,0
2826,2587,0,0,62,62,0,1,0,1,0
6350,1017,0,0,62,62,0,1,0,1,0
1401,2938,0,0,62,62,0,1,0,1,0
2397,3216,0,0,62,62,0,1,0,1,0
20843,1880,0,0,62,62,0,1,0,1,0
276,1472,0,0,62,62,0,1,0,1,0
3293,1888,0,0,66,66,0,1,0,1,0
20996,3214,0,0,66,66,0,1,0,1,0
2003,2938,0,0,62,62,0,1,0,1,0
9928,2486,0,0,62,62,0,1,0,1,0
125,1017,0,0,62,62,0,1,0,1,0
540,676,0,0,180,180,0,1,0,1,0
2361,1147,0,0,146,146,0,1,0,1,0
345,1763,0,0,62,62,0,1,0,1,0
1982,3216,0,0,62,62,0,1,0,1,0
7941,2587,0,0,62,62,0,1,0,1,0
3054,697,0,0,62,62,0,1,0,1,0
2450,2856,0,0,99,99,0,1,0,1,0
2543,1795,0,0,62,62,0,1,0,1,0
5067,1147,0,0,65,65,0,1,0,1,0
16657,2587,0,0,62,62,0,1,0,1,0
18912,1147,0,0,64,64,0,1,0,1,0
19428,242,0,0,145,145,0,1,0,1,0
3898,2938,0,0,69,69,0,1,0,1,0
4359,3216,0,0,62,62,0,1,0,1,0
7880,337,0,0,105,105,0,1,0,1,0
668,1147,0,0,66,66,0,1,0,1,0
12,1768,0,0,65,65,0,1,0,1,0
9610,3116,0,0,79,79,0,1,0,1,0
14005,2256,0,0,66,66,0,1,0,1,0
5443,774,0,0,67,67,0,1,0,1,0
3242,401,0,0,63,63,0,1,0,1,0
13248,1147,0,0,65,65,0,1,0,1,0
351,2952,0,0,69,69,0,1,0,1,0
12670,2252,0,0,65,65,0,1,0,1,0
19462,2883,0,0,64,64,0,1,0,1,0
2973,1472,0,0,62,62,0,1,0,1,0
645,705,0,0,62,62,0,1,0,1,0
23,1147,0,0,146,146,0,1,0,1,0
10635,1888,0,0,67,67,0,1,0,1,0
440,1235,0,0,60,60,0,1,0,1,0
16951,255,0,0,62,62,0,1,0,1,0
16844,2938,0,0,66,66,0,1,0,1,0
19234,1301,0,0,66,66,0,1,0,1,0
11640,1215,0,0,62,62,0,1,0,1,0
5590,2584,0,0,62,62,0,1,0,1,0
8114,2550,0,0,62,62,0,1,0,1,0
1681,1888,0,0,62,62,0,1,0,1,0
0,0,0,0,70,70,0,1,0,1,0
196,1771,0,0,66,66,0,1,0,1,0
4349,3202,0,0,76,76,0,1,0,1,0
343,292,0,0,66,66,0,1,0,1,0
20841,1880,0,0,62,62,0,1,0,1,0
17268,2939,0,0,62,62,0,1,0,1,0
9260,805,0,0,66,66,0,1,0,1,0
1514,1771,0,0,63,63,0,1,0,1,0
515,3150,0,0,153,153,0,1,0,1,0
4834,201,0,0,71,71,0,1,0,1,0
20871,2587,0,0,66,66,0,1,0,1,0
7335,1070,0,0,60,60,0,1,0,1,0
16731,1086,0,0,66,66,0,1,0,1,0
14270,1517,0,0,66,66,0,1,0,1,0
2945,2607,0,0,146,146,0,1,0,1,0
4801,1888,0,0,62,62,0,1,0,1,0
5011,2477,0,0,60,60,0,1,0,1,0
2322,1771,0,0,63,63,0,1,0,1,0
17344,488,0,0,66,66,0,1,0,1,0
247,1771,0,0,66,66,0,1,0,1,0
430,2587,0,0,62,62,0,1,0,1,0
21189,1017,0,0,127,127,0,1,0,1,0
263,3212,0,0,62,62,0,1,0,1,0
18240,1017,0,0,62,62,0,1,0,1,0
2976,1888,0,0,62,62,0,1,0,1,0
1423,1888,0,0,62,62,0,1,0,1,0
20869,3185,0,0,63,63,0,1,0,1,0
4848,207,0,0,70,70,0,1,0,1,0
20697,2698,0,0,77,77,0,1,0,1,0
18793,2683,0,0,66,66,0,1,0,1,0
4057,1017,0,0,62,62,0,1,0,1,0
3876,1923,0,0,62,62,0,1,0,1,0
15896,2587,0,0,62,62,0,1,0,1,0
18843,2587,0,0,62,62,0,1,0,1,0
4511,989,0,0,65,65,0,1,0,1,0
278,6,0,0,60,60,0,1,0,1,0
3097,2521,0,0,145,145,0,1,0,1,0
636,280,0,0,62,62,0,1,0,1,0
18319,2241,0,0,62,62,0,1,0,1,0
5265,2649,0,0,72,72,0,1,0,1,0
13850,1017,0,0,66,66,0,1,0,1,0
7335,1070,0,0,60,60,0,1,0,1,0
15279,1882,0,0,63,63,0,1,0,1,0
266,1086,0,0,66,66,0,1,0,1,0
499,187,0,0,679,679,0,1,0,1,0
7904,86,0,0,118,118,0,1,0,1,0
6052,2938,0,0,65,65,0,1,0,1,0
18377,2938,0,0,74,74,0,1,0,1,0
16464,3139,0,0,66,66,0,1,0,1,0
5485,2811,0,0,140,140,0,1,0,1,0
5851,1498,0,0,133,133,0,1,0,1,0
16951,255,0,0,62,62,0,1,0,1,0
19051,2071,0,0,107,107,0,1,0,1,0
16840,2938,0,0,66,66,0,1,0,1,0
7997,1147,0,0,62,62,0,1,0,1,0
10851,265,0,0,60,60,0,1,0,1,0
6963,1886,0,0,62,62,0,1,0,1,0
19644,1888,0,0,64,64,0,1,0,1,0
16951,255,0,0,62,62,0,1,0,1,0
16951,255,0,0,62,62,0,1,0,1,0
9453,1888,0,0,64,64,0,1,0,1,0
22239,1779,0,0,62,62,0,1,0,1,0
9570,1192,0,0,62,62,0,1,0,1,0
10860,1788,0,0,66,66,0,1,0,1,0
287,1147,0,0,66,66,0,1,0,1,0
18843,2587,0,0,62,62,0,1,0,1,0
1629,2881,0,0,145,145,0,1,0,1,0
1993,2256,0,0,66,66,0,1,0,1,0
15846,2611,0,0,66,66,0,1,0,1,0
18206,2612,0,0,62,62,0,1,0,1,0
17300,2611,0,0,63,63,0,1,0,1,0
8171,1073,0,0,60,60,0,1,0,1,0
16643,1836,0,0,66,66,0,1,0,1,0
22525,2381,0,0,62,62,0,1,0,1,0
8668,2256,0,0,66,66,0,1,0,1,0
9952,3,0,0,61,61,0,1,0,1,0
20785,1210,0,0,66,66,0,1,0,1,0
21327,1827,0,0,62,62,0,1,0,1,0
20,2256,0,0,62,62,0,1,0,1,0
18813,1147,0,0,66,66,0,1,0,1,0
1548,2949,0,0,62,62,0,1,0,1,0
7888,1147,0,0,62,62,0,1,0,1,0
17049,2612,0,0,62,62,0,1,0,1,0
0,0,0,0,98,98,0,1,0,1,0
1935,1147,0,0,62,62,0,1,0,1,0
7326,1649,0,0,60,60,0,1,0,1,0
0,0,0,0,101,101,0,1,0,1,0
7273,1888,0,0,62,62,0,1,0,1,0
4209,1181,0,0,63,63,0,1,0,1,0
1631,1888,0,0,62,62,0,1,0,1,0
2371,2946,0,0,129,129,0,1,0,1,0
2592,1017,0,0,62,62,0,1,0,1,0
10494,1167,0,0,69,69,0,1,0,1,0
22091,1215,0,0,62,62,0,1,0,1,0
2769,1017,0,0,146,146,0,1,0,1,0
18501,796,0,0,66,66,0,1,0,1,0
815,7,0,0,60,60,0,1,0,1,0
4408,2883,0,0,62,62,0,1,0,1,0
20864,2631,0,0,66,66,0,1,0,1,0
18858,267,0,0,60,60,0,1,0,1,0
22,2938,0,0,67,67,0,1,0,1,0
8528,991,0,0,66,66,0,1,0,1,0
19288,2587,0,0,63,63,0,1,0,1,0
12065,3124,0,0,64,64,0,1,0,1,0
10764,2938,0,0,96,96,0,1,0,1,0
9214,3256,0,0,60,60,0,1,0,1,0
5891,7,0,0,60,60,0,1,0,1,0
21720,2231,0,0,64,64,0,1,0,1,0
2319,1215,0,0,62,62,0,1,0,1,0
16951,255,0,0,62,62,0,1,0,1,0
2913,3216,0,0,66,66,0,1,0,1,0
3419,2587,0,0,90,90,0,1,0,1,0
684,954,0,0,152,152,0,1,0,1,0
6673,2938,0,0,128,128,0,1,0,1,0
1962,2608,0,0,62,62,0,1,0,1,0
21137,1771,0,0,62,62,0,1,0,1,0
22122,1799,0,0,70,70,0,1,0,1,0
3024,2256,0,0,66,66,0,1,0,1,0
10664,1884,0,0,62,62,0,1,0,1,0
2620,1017,0,0,146,146,0,1,0,1,0
21607,1147,0,0,63,63,0,1,0,1,0
4208,7,0,0,60,60,0,1,0,1,0
2602,1017,0,0,146,146,0,1,0,1,0
17912,1070,0,0,62,62,0,1,0,1,0
10475,6,0,0,60,60,0,1,0,1,0
17675,3213,0,0,64,64,0,1,0,1,0
14579,2883,0,0,66,66,0,1,0,1,0
2079,2256,0,0,63,63,0,1,0,1,0
18068,1888,0,0,66,66,0,1,0,1,0
11084,1017,0,0,78,78,0,1,0,1,0
18019,1017,0,0,62,62,0,1,0,1,0
14020,2246,0,0,66,66,0,1,0,1,0
14964,1157,0,0,62,62,0,1,0,1,0
5208,1222,0,0,146,146,0,1,0,1,0
2721,1215,0,0,62,62,0,1,0,1,0
16502,2584,0,0,145,145,0,1,0,1,0
7006,2635,0,0,62,62,0,1,0,1,0
11933,3163,0,0,119,119,0,1,0,1,0
2084,1471,0,0,145,145,0,1,0,1,0
16037,1147,0,0,62,62,0,1,0,1,0
3107,2951,0,0,62,62,0,1,0,1,0
4492,1147,0,0,62,62,0,1,0,1,0
9706,1888,0,0,66,66,0,1,0,1,0
6145,195,0,0,60,60,0,1,0,1,0
17677,2747,0,0,62,62,0,1,0,1,0
16769,1017,0,0,65,65,0,1,0,1,0
2181,1147,0,0,62,62,0,1,0,1,0
18377,2938,0,0,74,74,0,1,0,1,0
11518,2256,0,0,66,66,0,1,0,1,0
2039,2883,0,0,99,99,0,1,0,1,0
9222,1787,0,0,148,148,0,1,0,1,0
1907,2577,0,0,145,145,0,1,0,1,0
17596,1017,0,0,65,65,0,1,0,1,0
6857,322,0,0,154,154,0,1,0,1,0
10223,2587,0,0,63,63,0,1,0,1,0
19017,2935,0,0,77,77,0,1,0,1,0
2333,2486,0,0,62,62,0,1,0,1,0
367,1017,0,0,62,62,0,1,0,1,0
22426,2308,0,0,66,66,0,1,0,1,0
16951,255,0,0,62,62,0,1,0,1,0
6301,2938,0,0,61,61,0,1,0,1,0
16951,255,0,0,62,62,0,1,0,1,0
20476,2618,0,0,66,66,0,1,0,1,0
16951,255,0,0,62,62,0,1,0,1,0
4514,985,0,0,65,65,0,1,0,1,0
12,3140,0,0,199,199,0,1,0,1,0
4091,1017,0,0,66,66,0,1,0,1,0
17357,2938,0,0,66,66,0,1,0,1,0
14505,2312,0,0,78,78,0,1,0,1,0
20268,2930,0,0,62,62,0,1,0,1,0
10265,3216,0,0,65,65,0,1,0,1,0
13024,3212,0,0,66,66,0,1,0,1,0
1814,1147,0,0,62,62,0,1,0,1,0
1597,3216,0,0,145,145,0,1,0,1,0
22090,421,0,0,65,65,0,1,0,1,0
3149,1473,0,0,68,68,0,1,0,1,0
18958,3216,0,0,66,66,0,1,0,1,0
1946,1215,0,0,62,62,0,1,0,1,0
16951,255,0,0,62,62,0,1,0,1,0
3443,1888,0,0,62,62,0,1,0,1,0
1920,7,0,0,60,60,0,1,0,1,0
612,151,0,0,60,60,0,1,0,1,0
12585,1803,0,0,65,65,0,1,0,1,0
9795,1160,0,0,62,62,0,1,0,1,0
3091,7,0,0,60,60,0,1,0,1,0
12,1371,0,0,65,65,0,1,0,1,0
21767,435,0,0,62,62,0,1,0,1,0
8650,2914,0,0,66,66,0,1,0,1,0
11360,3163,0,0,66,66,0,1,0,1,0
3152,2587,0,0,62,62,0,1,0,1,0
7326,180,0,0,60,60,0,1,0,1,0
16951,255,0,0,62,62,0,1,0,1,0
12825,2938,0,0,66,66,0,1,0,1,0
5642,2841,0,0,62,62,0,1,0,1,0
2412,2093,0,0,145,145,0,1,0,1,0
8171,1073,0,0,60,60,0,1,0,1,0
12711,1888,0,0,66,66,0,1,0,1,0
18,2938,0,0,62,62,0,1,0,1,0
1709,1147,0,0,146,146,0,1,0,1,0
12,284,0,0,330,330,0,1,0,1,0
4955,2611,0,0,62,62,0,1,0,1,0
13049,111,0,0,64,64,0,1,0,1,0
20189,1147,0,0,62,62,0,1,0,1,0
542,1786,0,0,63,63,0,1,0,1,0
6229,2938,0,0,78,78,0,1,0,1,0
2917,1167,0,0,62,62,0,1,0,1,0
12289,2256,0,0,62,62,0,1,0,1,0
11601,702,0,0,115,115,0,1,0,1,0
7949,314,0,0,60,60,0,1,0,1,0
22468,201,0,0,78,78,0,1,0,1,0
11610,1802,0,0,62,62,0,1,0,1,0
2573,2572,0,0,61,61,0,1,0,1,0
15840,3216,0,0,66,66,0,1,0,1,0
2383,1147,0,0,62,62,0,1,0,1,0
754,155,0,0,64,64,0,1,0,1,0
10138,1834,0,0,63,63,0,1,0,1,0
19130,2787,0,0,62,62,0,1,0,1,0
73,3216,0,0,65,65,0,1,0,1,0
13473,1017,0,0,62,62,0,1,0,1,0
17543,2168,0,0,72,72,0,1,0,1,0
8,2758,0,0,60,60,0,1,0,1,0
1663,2953,0,0,66,66,0,1,0,1,0
22707,252,0,0,62,62,0,1,0,1,0
21599,2636,0,0,66,66,0,1,0,1,0
549,2256,0,0,64,64,0,1,0,1,0
1889,2256,0,0,146,146,0,1,0,1,0
9486,1888,0,0,65,65,0,1,0,1,0
2183,6,0,0,60,60,0,1,0,1,0
9614,3105,0,0,86,86,0,1,0,1,0
4848,2580,0,0,108,108,0,1,0,1,0
9906,2938,0,0,66,66,0,1,0,1,0
1620,2605,0,0,62,62,0,1,0,1,0
778,1888,0,0,146,146,0,1,0,1,0
12611,1147,0,0,63,63,0,1,0,1,0
11716,1147,0,0,66,66,0,1,0,1,0
2985,1472,0,0,66,66,0,1,0,1,0
1867,3139,0,0,63,63,0,1,0,1,0
2137,1147,0,0,65,65,0,1,0,1,0
17535,2619,0,0,63,63,0,1,0,1,0
1822,299,0,0,61,61,0,1,0,1,0
4022,2232,0,0,128,128,0,1,0,1,0
16830,2942,0,0,66,66,0,1,0,1,0
12,3141,0,0,331,331,0,1,0,1,0
11714,1005,0,0,62,62,0,1,0,1,0
4949,1025,0,0,60,60,0,1,0,1,0
12586,3148,0,0,62,62,0,1,0,1,0
21540,1090,0,0,62,62,0,1,0,1,0
17010,2603,0,0,66,66,0,1,0,1,0
9429,2509,0,0,63,63,0,1,0,1,0
3319,2611,0,0,66,66,0,1,0,1,0
22434,1017,0,0,96,96,0,1,0,1,0
21551,3216,0,0,130,130,0,1,0,1,0
4044,1012,0,0,66,66,0,1,0,1,0
20569,2262,0,0,62,62,0,1,0,1,0
4179,6,0,0,60,60,0,1,0,1,0
4370,1033,0,0,146,146,0,1,0,1,0
1691,1215,0,0,62,62,0,1,0,1,0
727,137,0,0,65,65,0,1,0,1,0
19173,2848,0,0,64,64,0,1,0,1,0
14984,2603,0,0,66,66,0,1,0,1,0
6651,1129,0,0,156,156,0,1,0,1,0
8088,2205,0,0,63,63,0,1,0,1,0
34,274,0,0,69,69,0,1,0,1,0
7266,1858,0,0,145,145,0,1,0,1,0
16237,2938,0,0,63,63,0,1,0,1,0
1455,1147,0,0,62,62,0,1,0,1,0
4548,2243,0,0,65,65,0,1,0,1,0
4327,1147,0,0,87,87,0,1,0,1,0
13845,999,0,0,66,66,0,1,0,1,0
22407,2601,0,0,66,66,0,1,0,1,0
6860,1215,0,0,62,62,0,1,0,1,0
16478,253,0,0,60,60,0,1,0,1,0
22510,2611,0,0,78,78,0,1,0,1,0
595,1215,0,0,62,62,0,1,0,1,0
595,3216,0,0,65,65,0,1,0,1,0
4472,2609,0,0,62,62,0,1,0,1,0
2288,2256,0,0,62,62,0,1,0,1,0
19928,2587,0,0,66,66,0,1,0,1,0
7612,3216,0,0,145,145,0,1,0,1,0
5276,6,0,0,60,60,0,1,0,1,0
6,12,0,0,346,346,0,1,0,1,0
15220,2486,0,0,62,62,0,1,0,1,0
2551,2584,0,0,62,62,0,1,0,1,0
2808,1017,0,0,62,62,0,1,0,1,0
836,1888,0,0,62,62,0,1,0,1,0
14767,2922,0,0,63,63,0,1,0,1,0
1265,1147,0,0,62,62,0,1,0,1,0
14505,2312,0,0,78,78,0,1,0,1,0
2280,1144,0,0,62,62,0,1,0,1,0
22046,1888,0,0,62,62,0,1,0,1,0
10940,1888,0,0,62,62,0,1,0,1,0
12972,1147,0,0,62,62,0,1,0,1,0
1624,2883,0,0,121,121,0,1,0,1,0
16049,2883,0,0,66,66,0,1,0,1,0
1401,2938,0,0,62,62,0,1,0,1,0
16951,255,0,0,62,62,0,1,0,1,0
10187,2587,0,0,66,66,0,1,0,1,0
823,759,0,0,60,60,0,1,0,1,0
129,1472,0,0,63,63,0,1,0,1,0
17339,509,0,0,66,66,0,1,0,1,0
21324,2256,0,0,64,64,0,1,0,1,0
2452,2490,0,0,153,153,0,1,0,1,0
11949,2256,0,0,65,65,0,1,0,1,0
252,280,0,0,63,63,0,1,0,1,0
5461,2719,0,0,125,125,0,1,0,1,0
16,523,0,0,64,64,0,1,0,1,0
3563,2938,0,0,71,71,0,1,0,1,0
16951,255,0,0,62,62,0,1,0,1,0
541,1793,0,0,62,62,0,1,0,1,0
5041,1017,0,0,62,62,0,1,0,1,0
15032,1888,0,0,64,64,0,1,0,1,0
21975,1574,0,0,62,62,0,1,0,1,0
17714,995,0,0,66,66,0,1,0,1,0
5848,3216,0,0,62,62,0,1,0,1,0
2906,1888,0,0,62,62,0,1,0,1,0
22638,2256,0,0,66,66,0,1,0,1,0
3111,2620,0,0,68,68,0,1,0,1,0
10143,1121,0,0,64,64,0,1,0,1,0
15623,2934,0,0,62,62,0,1,0,1,0
1186,480,0,0,63,63,0,1,0,1,0
19883,2587,0,0,66,66,0,1,0,1,0
338,1042,0,0,64,64,0,1,0,1,0
9532,2587,0,0,66,66,0,1,0,1,0
18,1147,0,0,62,62,0,1,0,1,0
10978,2938,0,0,66,66,0,1,0,1,0
16951,255,0,0,62,62,0,1,0,1,0
612,714,0,0,60,60,0,1,0,1,0
1180,2674,0,0,63,63,0,1,0,1,0
3091,2938,0,0,62,62,0,1,0,1,0
3756,1791,0,0,62,62,0,1,0,1,0
3037,1887,0,0,62,62,0,1,0,1,0
7898,1147,0,0,62,62,0,1,0,1,0
13825,1494,0,0,66,66,0,1,0,1,0
14715,1888,0,0,62,62,0,1,0,1,0
8815,3230,0,0,91,91,0,1,0,1,0
60,1888,0,0,62,62,0,1,0,1,0
10396,3216,0,0,63,63,0,1,0,1,0
1520,466,0,0,158,158,0,1,0,1,0
16951,255,0,0,62,62,0,1,0,1,0
12251,7,0,0,60,60,0,1,0,1,0
2774,280,0,0,72,72,0,1,0,1,0
1906,1017,0,0,62,62,0,1,0,1,0
1550,2625,0,0,64,64,0,1,0,1,0
360,3105,0,0,279,279,0,1,0,1,0
1131,1816,0,0,66,66,0,1,0,1,0
2586,1214,0,0,65,65,0,1,0,1,0
12507,1017,0,0,66,66,0,1,0,1,0
339,2256,0,0,73,73,0,1,0,1,0
5967,2581,0,0,70,70,0,1,0,1,0
9638,1017,0,0,65,65,0,1,0,1,0
18041,2256,0,0,66,66,0,1,0,1,0
8114,2554,0,0,62,62,0,1,0,1,0
11364,3139,0,0,66,66,0,1,0,1,0
22511,2319,0,0,66,66,0,1,0,1,0
2640,2250,0,0,145,145,0,1,0,1,0
16533,2938,0,0,66,66,0,1,0,1,0
11325,1215,0,0,62,62,0,1,0,1,0
4368,1113,0,0,64,64,0,1,0,1,0
9614,3105,0,0,86,86,0,1,0,1,0
13930,2587,0,0,66,66,0,1,0,1,0
20898,1888,0,0,65,65,0,1,0,1,0
16951,255,0,0,62,62,0,1,0,1,0
17459,2953,0,0,66,66,0,1,0,1,0
430,1771,0,0,62,62,0,1,0,1,0
13074,178,0,0,60,60,0,1,0,1,0
6677,797,0,0,62,62,0,1,0,1,0
17321,2634,0,0,65,65,0,1,0,1,0
12854,1147,0,0,72,72,0,1,0,1,0
6649,697,0,0,74,74,0,1,0,1,0
13786,509,0,0,62,62,0,1,0,1,0
16951,255,0,0,62,62,0,1,0,1,0
6170,2596,0,0,66,66,0,1,0,1,0
19820,2787,0,0,60,60,0,1,0,1,0
2756,1021,0,0,62,62,0,1,0,1,0
519,1888,0,0,65,65,0,1,0,1,0
10245,3216,0,0,65,65,0,1,0,1,0
7273,1888,0,0,62,62,0,1,0,1,0
441,2879,0,0,62,62,0,1,0,1,0
493,274,0,0,145,145,0,1,0,1,0
16984,1147,0,0,62,62,0,1,0,1,0
6815,3216,0,0,62,62,0,1,0,1,0
3638,2257,0,0,80,80,0,1,0,1,0
6576,1215,0,0,63,63,0,1,0,1,0
2084,1471,0,0,145,145,0,1,0,1,0
17803,2616,0,0,64,64,0,1,0,1,0
360,3105,0,0,1288,1288,0,1,0,1,0
17693,1147,0,0,65,65,0,1,0,1,0
1576,2938,0,0,60,60,0,1,0,1,0
2385,1147,0,0,62,62,0,1,0,1,0
16727,2943,0,0,66,66,0,1,0,1,0
16331,3216,0,0,66,66,0,1,0,1,0
0,0,0,0,70,70,0,1,0,1,0
16951,255,0,0,62,62,0,1,0,1,0
16563,1116,0,0,63,63,0,1,0,1,0
20405,5,0,0,60,60,0,1,0,1,0
2714,2945,0,0,62,62,0,1,0,1,0
12,2784,0,0,82,82,0,1,0,1,0
14990,1768,0,0,66,66,0,1,0,1,0
9226,3216,0,0,65,65,0,1,0,1,0
1930,509,0,0,62,62,0,1,0,1,0
11313,3216,0,0,64,64,0,1,0,1,0
0,0,0,0,98,98,0,1,0,1,0
16951,255,0,0,62,62,0,1,0,1,0
2098,374,0,0,60,60,0,1,0,1,0
10429,525,0,0,76,76,0,1,0,1,0
10709,1185,0,0,63,63,0,1,0,1,0
8171,1073,0,0,60,60,0,1,0,1,0
1733,1147,0,0,62,62,0,1,0,1,0
1330,697,0,0,62,62,0,1,0,1,0
3173,7,0,0,60,60,0,1,0,1,0
3586,2547,0,0,145,145,0,1,0,1,0
3591,2581,0,0,144,144,0,1,0,1,0
16,2569,0,0,65,65,0,1,0,1,0
11592,386,0,0,63,63,0,1,0,1,0
4528,1801,0,0,65,65,0,1,0,1,0
6394,1017,0,0,62,62,0,1,0,1,0
21390,155,0,0,66,66,0,1,0,1,0
3109,2611,0,0,72,72,0,1,0,1,0
7375,1594,0,0,74,74,0,1,0,1,0
2591,2865,0,0,63,63,0,1,0,1,0
13482,1017,0,0,63,63,0,1,0,1,0
1997,2256,0,0,66,66,0,1,0,1,0
11893,2635,0,0,66,66,0,1,0,1,0
3058,2226,0,0,80,80,0,1,0,1,0
3142,2587,0,0,62,62,0,1,0,1,0
360,3105,0,0,927,927,0,1,0,1,0
36,366,0,0,147,147,0,1,0,1,0
1508,340,0,0,62,62,0,1,0,1,0
6478,2938,0,0,62,62,0,1,0,1,0
8680,1884,0,0,155,155,0,1,0,1,0
1273,1147,0,0,146,146,0,1,0,1,0
8651,509,0,0,63,63,0,1,0,1,0
3243,1735,0,0,62,62,0,1,0,1,0
164,2636,0,0,62,62,0,1,0,1,0
20785,1214,0,0,66,66,0,1,0,1,0
1283,1147,0,0,62,62,0,1,0,1,0
575,1147,0,0,63,63,0,1,0,1,0
1804,927,0,0,60,60,0,1,0,1,0
16902,983,0,0,66,66,0,1,0,1,0
8164,2725,0,0,60,60,0,1,0,1,0
9248,103,0,0,81,81,0,1,0,1,0
1421,10,0,0,60,60,0,1,0,1,0
16951,255,0,0,62,62,0,1,0,1,0
360,3105,0,0,164,164,0,1,0,1,0
12,971,0,0,86,86,0,1,0,1,0
2157,3072,0,0,60,60,0,1,0,1,0
17315,2222,0,0,66,66,0,1,0,1,0
2070,408,0,0,61,61,0,1,0,1,0
10127,1017,0,0,64,64,0,1,0,1,0
2350,495,0,0,63,63,0,1,0,1,0
326,1888,0,0,62,62,0,1,0,1,0
333,1017,0,0,62,62,0,1,0,1,0
2972,509,0,0,119,119,0,1,0,1,0
9175,3181,0,0,63,63,0,1,0,1,0
11,439,0,0,60,60,0,1,0,1,0
9214,3256,0,0,60,60,0,1,0,1,0
16359,2579,0,0,87,87,0,1,0,1,0
1548,2949,0,0,62,62,0,1,0,1,0
8818,1147,0,0,66,66,0,1,0,1,0
2459,2695,0,0,66,66,0,1,0,1,0
613,2564,0,0,60,60,0,1,0,1,0
16951,255,0,0,62,62,0,1,0,1,0
1855,1,0,0,62,62,0,1,0,1,0
10036,2621,0,0,66,66,0,1,0,1,0
10293,2883,0,0,66,66,0,1,0,1,0
545,2256,0,0,66,66,0,1,0,1,0
1701,1147,0,0,146,146,0,1,0,1,0
3457,3216,0,0,62,62,0,1,0,1,0
14715,1888,0,0,62,62,0,1,0,1,0
22209,2612,0,0,65,65,0,1,0,1,0
1234,1156,0,0,64,64,0,1,0,1,0
2497,3216,0,0,62,62,0,1,0,1,0
1300,1791,0,0,60,60,0,1,0,1,0
1507,1888,0,0,66,66,0,1,0,1,0
12,652,0,0,139,139,0,1,0,1,0
0,0,0,0,70,70,0,1,0,1,0
20185,2233,0,0,66,66,0,1,0,1,0
776,2618,0,0,63,63,0,1,0,1,0
9245,2938,0,0,66,66,0,1,0,1,0
15707,2938,0,0,64,64,0,1,0,1,0
9225,1472,0,0,64,64,0,1,0,1,0
2084,1471,0,0,145,145,0,1,0,1,0
11003,1017,0,0,65,65,0,1,0,1,0
324,2256,0,0,72,72,0,1,0,1,0
636,280,0,0,62,62,0,1,0,1,0
18391,1472,0,0,66,66,0,1,0,1,0
612,714,0,0,60,60,0,1,0,1,0
16951,255,0,0,62,62,0,1,0,1,0
1804,1764,0,0,60,60,0,1,0,1,0
2817,2636,0,0,146,146,0,1,0,1,0
8096,2256,0,0,72,72,0,1,0,1,0
1323,1472,0,0,107,107,0,1,0,1,0
10295,2243,0,0,62,62,0,1,0,1,0
1912,2566,0,0,145,145,0,1,0,1,0
15878,2596,0,0,63,63,0,1,0,1,0
15882,1888,0,0,62,62,0,1,0,1,0
6561,1771,0,0,63,63,0,1,0,1,0
15972,308,0,0,66,66,0,1,0,1,0
11207,1154,0,0,66,66,0,1,0,1,0
9403,1771,0,0,66,66,0,1,0,1,0
16849,1936,0,0,66,66,0,1,0,1,0
1666,3216,0,0,62,62,0,1,0,1,0
9000,303,0,0,62,62,0,1,0,1,0
15,3216,0,0,62,62,0,1,0,1,0
15009,935,0,0,64,64,0,1,0,1,0
10582,2256,0,0,62,62,0,1,0,1,0
2606,1892,0,0,65,65,0,1,0,1,0
103,562,0,0,64,64,0,1,0,1,0
14064,2925,0,0,72,72,0,1,0,1,0
10099,3055,0,0,64,64,0,1,0,1,0
534,1888,0,0,66,66,0,1,0,1,0
16444,2881,0,0,90,90,0,1,0,1,0
178,1789,0,0,60,60,0,1,0,1,0
8328,3000,0,0,132,132,0,1,0,1,0
5699,1130,0,0,111,111,0,1,0,1,0
9543,3139,0,0,64,64,0,1,0,1,0
3191,2861,0,0,62,62,0,1,0,1,0
16951,255,0,0,62,62,0,1,0,1,0
21592,1781,0,0,62,62,0,1,0,1,0
16537,2636,0,0,63,63,0,1,0,1,0
16951,255,0,0,62,62,0,1,0,1,0
17411,1147,0,0,62,62,0,1,0,1,0
1734,2539,0,0,146,146,0,1,0,1,0
1825,460,0,0,66,66,0,1,0,1,0
21424,1776,0,0,62,62,0,1,0,1,0
660,4,0,0,79,79,0,1,0,1,0
7326,180,0,0,60,60,0,1,0,1,0
9173,1216,0,0,65,65,0,1,0,1,0
6807,2256,0,0,66,66,0,1,0,1,0
1289,1537,0,0,62,62,0,1,0,1,0
21590,2938,0,0,68,68,0,1,0,1,0
16939,3202,0,0,66,66,0,1,0,1,0
9578,2857,0,0,62,62,0,1,0,1,0
12316,1880,0,0,62,62,0,1,0,1,0
7339,237,0,0,60,60,0,1,0,1,0
2416,2938,0,0,62,62,0,1,0,1,0
17325,1147,0,0,65,65,0,1,0,1,0
5287,1018,0,0,146,146,0,1,0,1,0
9550,3180,0,0,66,66,0,1,0,1,0
9566,2587,0,0,66,66,0,1,0,1,0
159,2636,0,0,65,65,0,1,0,1,0
1264,2256,0,0,66,66,0,1,0,1,0
22046,1827,0,0,66,66,0,1,0,1,0
2896,1017,0,0,62,62,0,1,0,1,0
6692,1017,0,0,64,64,0,1,0,1,0
16779,817,0,0,66,66,0,1,0,1,0
2927,7,0,0,60,60,0,1,0,1,0
1737,3216,0,0,63,63,0,1,0,1,0
17623,2587,0,0,66,66,0,1,0,1,0
2691,2587,0,0,64,64,0,1,0,1,0
34,2628,0,0,63,63,0,1,0,1,0
17579,2587,0,0,62,62,0,1,0,1,0
3671,7,0,0,60,60,0,1,0,1,0
1662,1147,0,0,62,62,0,1,0,1,0
9214,3256,0,0,60,60,0,1,0,1,0
3060,1888,0,0,67,67,0,1,0,1,0
414,3188,0,0,63,63,0,1,0,1,0
160,1888,0,0,62,62,0,1,0,1,0
15015,2602,0,0,89,89,0,1,0,1,0
3146,1771,0,0,62,62,0,1,0,1,0
37,1929,0,0,128,128,0,1,0,1,0
1885,2256,0,0,146,146,0,1,0,1,0
12,2784,0,0,82,82,0,1,0,1,0
3402,6,0,0,60,60,0,1,0,1,0
2331,1017,0,0,66,66,0,1,0,1,0
1423,1888,0,0,62,62,0,1,0,1,0
4571,2256,0,0,62,62,0,1,0,1,0
2469,2938,0,0,62,62,0,1,0,1,0
6670,2495,0,0,124,124,0,1,0,1,0
2625,2256,0,0,146,146,0,1,0,1,0
17395,2256,0,0,65,65,0,1,0,1,0
17903,1147,0,0,63,63,0,1,0,1,0
476,2164,0,0,155,155,0,1,0,1,0
22357,1906,0,0,62,62,0,1,0,1,0
195,1198,0,0,62,62,0,1,0,1,0
21594,2631,0,0,66,66,0,1,0,1,0
24,1771,0,0,145,145,0,1,0,1,0
12,929,0,0,83,83,0,1,0,1,0
1822,1147,0,0,62,62,0,1,0,1,0
2928,1771,0,0,66,66,0,1,0,1,0
652,2636,0,0,63,63,0,1,0,1,0
16035,1147,0,0,62,62,0,1,0,1,0
9422,2517,0,0,62,62,0,1,0,1,0
22433,1050,0,0,66,66,0,1,0,1,0
8980,1790,0,0,62,62,0,1,0,1,0
1723,2636,0,0,66,66,0,1,0,1,0
16951,255,0,0,62,62,0,1,0,1,0
6061,2883,0,0,63,63,0,1,0,1,0
15694,1515,0,0,145,145,0,1,0,1,0
1728,3216,0,0,65,65,0,1,0,1,0
9456,1888,0,0,66,66,0,1,0,1,0
16845,1888,0,0,62,62,0,1,0,1,0
16951,255,0,0,62,62,0,1,0,1,0
1739,2073,0,0,66,66,0,1,0,1,0
1483,1888,0,0,66,66,0,1,0,1,0
17200,1880,0,0,62,62,0,1,0,1,0
8335,1147,0,0,62,62,0,1,0,1,0
165,1147,0,0,65,65,0,1,0,1,0
158,1147,0,0,62,62,0,1,0,1,0
2009,2634,0,0,66,66,0,1,0,1,0
402,2666,0,0,62,62,0,1,0,1,0
12006,1147,0,0,62,62,0,1,0,1,0
16951,255,0,0,62,62,0,1,0,1,0
3102,2946,0,0,62,62,0,1,0,1,0
6687,1017,0,0,63,63,0,1,0,1,0
2168,1147,0,0,62,62,0,1,0,1,0
10714,1092,0,0,66,66,0,1,0,1,0
16951,255,0,0,62,62,0,1,0,1,0
15905,1147,0,0,109,109,0,1,0,1,0
18218,1017,0,0,66,66,0,1,0,1,0
1257,1886,0,0,62,62,0,1,0,1,0
15158,1086,0,0,66,66,0,1,0,1,0
627,987,0,0,112,112,0,1,0,1,0
3096,1147,0,0,64,64,0,1,0,1,0
8680,2675,0,0,162,162,0,1,0,1,0
8682,1792,0,0,62,62,0,1,0,1,0
1303,2952,0,0,62,62,0,1,0,1,0
8841,2938,0,0,63,63,0,1,0,1,0
6513,1771,0,0,66,66,0,1,0,1,0
7981,2938,0,0,62,62,0,1,0,1,0
11196,1213,0,0,66,66,0,1,0,1,0
16068,1816,0,0,64,64,0,1,0,1,0
5927,1472,0,0,62,62,0,1,0,1,0
6389,1017,0,0,62,62,0,1,0,1,0
21150,892,0,0,145,145,0,1,0,1,0
5081,2611,0,0,62,62,0,1,0,1,0
19453,1016,0,0,62,62,0,1,0,1,0
2758,3203,0,0,118,118,0,1,0,1,0
14064,1150,0,0,65,65,0,1,0,1,0
12,999,0,0,97,97,0,1,0,1,0
22482,2256,0,0,81,81,0,1,0,1,0
21044,1147,0,0,62,62,0,1,0,1,0
1473,561,0,0,62,62,0,1,0,1,0
2824,2912,0,0,142,142,0,1,0,1,0
2597,1771,0,0,64,64,0,1,0,1,0
1928,2668,0,0,62,62,0,1,0,1,0
1804,927,0,0,60,60,0,1,0,1,0
12096,2587,0,0,66,66,0,1,0,1,0
592,1888,0,0,62,62,0,1,0,1,0
2308,2486,0,0,123,123,0,1,0,1,0
21200,1883,0,0,65,65,0,1,0,1,0
16951,255,0,0,62,62,0,1,0,1,0
78,2612,0,0,146,146,0,1,0,1,0
10756,3216,0,0,66,66,0,1,0,1,0
7339,140,0,0,60,60,0,1,0,1,0
423,2587,0,0,62,62,0,1,0,1,0
19430,2934,0,0,66,66,0,1,0,1,0
21370,1147,0,0,62,62,0,1,0,1,0
1865,2587,0,0,146,146,0,1,0,1,0
10393,3216,0,0,66,66,0,1,0,1,0
16951,255,0,0,62,62,0,1,0,1,0
634,3216,0,0,145,145,0,1,0,1,0
19598,3216,0,0,65,65,0,1,0,1,0
19823,2844,0,0,61,61,0,1,0,1,0
2003,2938,0,0,62,62,0,1,0,1,0
725,7,0,0,60,60,0,1,0,1,0
286,308,0,0,62,62,0,1,0,1,0
3081,2341,0,0,60,60,0,1,0,1,0
22468,201,0,0,78,78,0,1,0,1,0
2121,3216,0,0,62,62,0,1,0,1,0
15869,3100,0,0,66,66,0,1,0,1,0
2008,1215,0,0,63,63,0,1,0,1,0
12173,1874,0,0,66,66,0,1,0,1,0
7335,1070,0,0,60,60,0,1,0,1,0
1665,1147,0,0,146,146,0,1,0,1,0
20348,1880,0,0,63,63,0,1,0,1,0
10774,1472,0,0,62,62,0,1,0,1,0
16213,1147,0,0,146,146,0,1,0,1,0
3877,2611,0,0,66,66,0,1,0,1,0
9193,1017,0,0,66,66,0,1,0,1,0
246,2587,0,0,62,62,0,1,0,1,0
1437,2951,0,0,65,65,0,1,0,1,0
2068,1888,0,0,62,62,0,1,0,1,0
16043,1147,0,0,65,65,0,1,0,1,0
5327,1888,0,0,62,62,0,1,0,1,0
15834,1893,0,0,63,63,0,1,0,1,0
3069,1888,0,0,65,65,0,1,0,1,0
7335,1072,0,0,60,60,0,1,0,1,0
1718,1215,0,0,62,62,0,1,0,1,0
1480,1888,0,0,65,65,0,1,0,1,0
10417,2601,0,0,68,68,0,1,0,1,0
20338,9,0,0,83,83,0,1,0,1,0
6297,1017,0,0,62,62,0,1,0,1,0
21812,2938,0,0,66,66,0,1,0,1,0
22115,2604,0,0,66,66,0,1,0,1,0
17659,1882,0,0,64,64,0,1,0,1,0
1498,1206,0,0,62,62,0,1,0,1,0
3057,1215,0,0,64,64,0,1,0,1,0
18943,2519,0,0,66,66,0,1,0,1,0
4117,1472,0,0,62,62,0,1,0,1,0
1925,2256,0,0,62,62,0,1,0,1,0
12,658,0,0,66,66,0,1,0,1,0
1830,2578,0,0,62,62,0,1,0,1,0
1720,2636,0,0,64,64,0,1,0,1,0
5439,1888,0,0,66,66,0,1,0,1,0
14662,995,0,0,66,66,0,1,0,1,0
1804,1766,0,0,60,60,0,1,0,1,0
3492,7,0,0,60,60,0,1,0,1,0
12813,2938,0,0,63,63,0,1,0,1,0
11950,3216,0,0,65,65,0,1,0,1,0
9706,1888,0,0,64,64,0,1,0,1,0
17111,2759,0,0,66,66,0,1,0,1,0
6690,1817,0,0,62,62,0,1,0,1,0
19823,1771,0,0,66,66,0,1,0,1,0
3001,357,0,0,62,62,0,1,0,1,0
16951,255,0,0,62,62,0,1,0,1,0
11185,1017,0,0,66,66,0,1,0,1,0
6323,83,0,0,60,60,0,1,0,1,0
345,509,0,0,66,66,0,1,0,1,0
399,2636,0,0,65,65,0,1,0,1,0
544,3206,0,0,145,145,0,1,0,1,0
685,2587,0,0,62,62,0,1,0,1,0
3106,1147,0,0,64,64,0,1,0,1,0
636,362,0,0,143,143,0,1,0,1,0
12809,2573,0,0,65,65,0,1,0,1,0
677,3216,0,0,66,66,0,1,0,1,0
16951,255,0,0,62,62,0,1,0,1,0
16951,255,0,0,62,62,0,1,0,1,0
19150,2883,0,0,62,62,0,1,0,1,0
1804,768,0,0,60,60,0,1,0,1,0
13539,104,0,0,60,60,0,1,0,1,0
3204,3117,0,0,143,143,0,1,0,1,0
636,280,0,0,62,62,0,1,0,1,0
8056,2256,0,0,146,146,0,1,0,1,0
5491,1194,0,0,63,63,0,1,0,1,0
19428,242,0,0,145,145,0,1,0,1,0
22683,10,0,0,88,88,0,1,0,1,0
17,2378,0,0,62,62,0,1,0,1,0
19225,2486,0,0,62,62,0,1,0,1,0
1355,3216,0,0,62,62,0,1,0,1,0
16951,255,0,0,62,62,0,1,0,1,0
2097,3216,0,0,62,62,0,1,0,1,0
1620,2883,0,0,128,128,0,1,0,1,0
2184,7,0,0,60,60,0,1,0,1,0
19826,1771,0,0,63,63,0,1,0,1,0
8443,2636,0,0,66,66,0,1,0,1,0
14003,1909,0,0,69,69,0,1,0,1,0
16734,127,0,0,60,60,0,1,0,1,0
18964,964,0,0,66,66,0,1,0,1,0
2554,6,0,0,60,60,0,1,0,1,0
8282,1013,0,0,62,62,0,1,0,1,0
1131,1811,0,0,64,64,0,1,0,1,0
5267,155,0,0,62,62,0,1,0,1,0
14472,2902,0,0,62,62,0,1,0,1,0
16951,255,0,0,62,62,0,1,0,1,0
16951,255,0,0,62,62,0,1,0,1,0
15258,3204,0,0,62,62,0,1,0,1,0
20212,2936,0,0,94,94,0,1,0,1,0
4084,1017,0,0,62,62,0,1,0,1,0
8108,2256,0,0,146,146,0,1,0,1,0
18303,1017,0,0,65,65,0,1,0,1,0
9217,3243,0,0,60,60,0,1,0,1,0
15694,1202,0,0,145,145,0,1,0,1,0
1525,1444,0,0,145,145,0,1,0,1,0
1728,3216,0,0,64,64,0,1,0,1,0
3436,1888,0,0,62,62,0,1,0,1,0
2765,1017,0,0,146,146,0,1,0,1,0
21848,1823,0,0,66,66,0,1,0,1,0
20749,1884,0,0,66,66,0,1,0,1,0
51,1147,0,0,146,146,0,1,0,1,0
9214,3256,0,0,60,60,0,1,0,1,0
3020,7,0,0,60,60,0,1,0,1,0
21594,2938,0,0,62,62,0,1,0,1,0
1852,1,0,0,61,61,0,1,0,1,0
15976,1017,0,0,62,62,0,1,0,1,0
21025,1888,0,0,66,66,0,1,0,1,0
19336,3214,0,0,66,66,0,1,0,1,0
20019,1207,0,0,62,62,0,1,0,1,0
18685,1771,0,0,64,64,0,1,0,1,0
606,2253,0,0,66,66,0,1,0,1,0
16456,1452,0,0,90,90,0,1,0,1,0
19907,1136,0,0,132,132,0,1,0,1,0
6517,1771,0,0,65,65,0,1,0,1,0
16951,255,0,0,62,62,0,1,0,1,0
6903,7,0,0,60,60,0,1,0,1,0
431,1221,0,0,61,61,0,1,0,1,0
16951,255,0,0,62,62,0,1,0,1,0
2953,1501,0,0,62,62,0,1,0,1,0
754,155,0,0,66,66,0,1,0,1,0
497,2220,0,0,220,220,0,1,0,1,0
20037,1888,0,0,66,66,0,1,0,1,0
18,2574,0,0,62,62,0,1,0,1,0
343,1017,0,0,62,62,0,1,0,1,0
7335,1070,0,0,60,60,0,1,0,1,0
11893,1172,0,0,66,66,0,1,0,1,0
17072,1075,0,0,64,64,0,1,0,1,0
1296,1786,0,0,60,60,0,1,0,1,0
7326,1649,0,0,60,60,0,1,0,1,0
16951,255,0,0,62,62,0,1,0,1,0
17011,1810,0,0,70,70,0,1,0,1,0
2742,1017,0,0,63,63,0,1,0,1,0
8767,2587,0,0,62,62,0,1,0,1,0
17339,509,0,0,62,62,0,1,0,1,0
21665,2892,0,0,65,65,0,1,0,1,0
7067,2938,0,0,64,64,0,1,0,1,0
16951,255,0,0,62,62,0,1,0,1,0
3209,2842,0,0,86,86,0,1,0,1,0
11995,1147,0,0,89,89,0,1,0,1,0
1246,1054,0,0,62,62,0,1,0,1,0
10458,2883,0,0,66,66,0,1,0,1,0
2009,1215,0,0,63,63,0,1,0,1,0
3002,1936,0,0,62,62,0,1,0,1,0
22683,10,0,0,88,88,0,1,0,1,0
2837,1147,0,0,62,62,0,1,0,1,0
10251,450,0,0,64,64,0,1,0,1,0
12375,3178,0,0,66,66,0,1,0,1,0
2977,1885,0,0,62,62,0,1,0,1,0
15589,2151,0,0,62,62,0,1,0,1,0
1714,1817,0,0,62,62,0,1,0,1,0
6919,1888,0,0,62,62,0,1,0,1,0
16951,255,0,0,62,62,0,1,0,1,0
2609,442,0,0,146,146,0,1,0,1,0
6890,1086,0,0,64,64,0,1,0,1,0
14472,2913,0,0,66,66,0,1,0,1,0
16881,2256,0,0,62,62,0,1,0,1,0
19463,2256,0,0,66,66,0,1,0,1,0
19609,509,0,0,64,64,0,1,0,1,0
16951,255,0,0,62,62,0,1,0,1,0
12862,1800,0,0,65,65,0,1,0,1,0
7748,1771,0,0,130,130,0,1,0,1,0
2902,3216,0,0,64,64,0,1,0,1,0
7994,2912,0,0,62,62,0,1,0,1,0
15061,697,0,0,146,146,0,1,0,1,0
226,1024,0,0,62,62,0,1,0,1,0
6533,1215,0,0,62,62,0,1,0,1,0
7849,1210,0,0,62,62,0,1,0,1,0
15964,2938,0,0,66,66,0,1,0,1,0
8267,255,0,0,60,60,0,1,0,1,0
14228,6,0,0,60,60,0,1,0,1,0
10532,539,0,0,85,85,0,1,0,1,0
18622,1098,0,0,66,66,0,1,0,1,0
3143,2938,0,0,74,74,0,1,0,1,0
16951,255,0,0,62,62,0,1,0,1,0
2765,3216,0,0,66,66,0,1,0,1,0
1869,1017,0,0,64,64,0,1,0,1,0
14364,2588,0,0,62,62,0,1,0,1,0
595,1147,0,0,62,62,0,1,0,1,0
22645,277,0,0,64,64,0,1,0,1,0
244,1054,0,0,66,66,0,1,0,1,0
9785,1781,0,0,66,66,0,1,0,1,0
2559,2581,0,0,146,146,0,1,0,1,0
12,1072,0,0,72,72,0,1,0,1,0
8126,2256,0,0,145,145,0,1,0,1,0
636,280,0,0,146,146,0,1,0,1,0
13,1719,0,0,62,62,0,1,0,1,0
2892,1804,0,0,63,63,0,1,0,1,0
1591,1888,0,0,62,62,0,1,0,1,0
17723,1147,0,0,62,62,0,1,0,1,0
12767,697,0,0,62,62,0,1,0,1,0
493,1543,0,0,64,64,0,1,0,1,0
19008,1916,0,0,97,97,0,1,0,1,0
803,1888,0,0,62,62,0,1,0,1,0
10123,1075,0,0,84,84,0,1,0,1,0
1067,2883,0,0,64,64,0,1,0,1,0
17588,2636,0,0,66,66,0,1,0,1,0
10467,1017,0,0,66,66,0,1,0,1,0
634,2464,0,0,147,147,0,1,0,1,0
10654,2636,0,0,66,66,0,1,0,1,0
1732,2894,0,0,145,145,0,1,0,1,0
1411,1888,0,0,64,64,0,1,0,1,0
2548,1907,0,0,60,60,0,1,0,1,0
9413,1771,0,0,66,66,0,1,0,1,0
1633,3216,0,0,62,62,0,1,0,1,0
15154,1138,0,0,62,62,0,1,0,1,0
1348,3216,0,0,145,145,0,1,0,1,0
574,2636,0,0,66,66,0,1,0,1,0
10314,690,0,0,76,76,0,1,0,1,0
1323,2587,0,0,65,65,0,1,0,1,0
22206,2603,0,0,66,66,0,1,0,1,0
6196,2999,0,0,71,71,0,1,0,1,0
636,2480,0,0,144,144,0,1,0,1,0
1756,1880,0,0,146,146,0,1,0,1,0
2004,2936,0,0,125,125,0,1,0,1,0
6450,2937,0,0,62,62,0,1,0,1,0
1132,2938,0,0,70,70,0,1,0,1,0
3979,2926,0,0,71,71,0,1,0,1,0
1124,146,0,0,60,60,0,1,0,1,0
7328,188,0,0,60,60,0,1,0,1,0
15163,388,0,0,60,60,0,1,0,1,0
16461,1017,0,0,64,64,0,1,0,1,0
1039,2636,0,0,64,64,0,1,0,1,0
17388,2938,0,0,65,65,0,1,0,1,0
2258,2636,0,0,62,62,0,1,0,1,0
20926,2354,0,0,62,62,0,1,0,1,0
1741,3216,0,0,65,65,0,1,0,1,0
5882,3216,0,0,140,140,0,1,0,1,0
6656,1215,0,0,63,63,0,1,0,1,0
21904,2938,0,0,66,66,0,1,0,1,0
612,228,0,0,60,60,0,1,0,1,0
16951,255,0,0,62,62,0,1,0,1,0
14294,1771,0,0,61,61,0,1,0,1,0
737,1147,0,0,65,65,0,1,0,1,0
16529,2587,0,0,66,66,0,1,0,1,0
16112,2611,0,0,62,62,0,1,0,1,0
18,1147,0,0,62,62,0,1,0,1,0
6533,1215,0,0,62,62,0,1,0,1,0
4546,2256,0,0,62,62,0,1,0,1,0
1067,2883,0,0,62,62,0,1,0,1,0
20746,1881,0,0,66,66,0,1,0,1,0
19573,1152,0,0,65,65,0,1,0,1,0
22625,1017,0,0,66,66,0,1,0,1,0
15022,95,0,0,67,67,0,1,0,1,0
10939,280,0,0,65,65,0,1,0,1,0
16312,1825,0,0,91,91,0,1,0,1,0
172,2486,0,0,65,65,0,1,0,1,0
21,2938,0,0,65,65,0,1,0,1,0
18213,2600,0,0,66,66,0,1,0,1,0
513,2232,0,0,66,66,0,1,0,1,0
6968,1539,0,0,136,136,0,1,0,1,0
1481,1888,0,0,66,66,0,1,0,1,0
12314,2256,0,0,62,62,0,1,0,1,0
3007,1215,0,0,62,62,0,1,0,1,0
1918,509,0,0,63,63,0,1,0,1,0
18632,2608,0,0,62,62,0,1,0,1,0
9859,2587,0,0,71,71,0,1,0,1,0
18067,1804,0,0,62,62,0,1,0,1,0
6815,3216,0,0,62,62,0,1,0,1,0
15140,427,0,0,78,78,0,1,0,1,0
2121,3216,0,0,62,62,0,1,0,1,0
1919,1796,0,0,62,62,0,1,0,1,0
5903,1147,0,0,62,62,0,1,0,1,0
14516,2263,0,0,72,72,0,1,0,1,0
16951,255,0,0,62,62,0,1,0,1,0
2972,2636,0,0,62,62,0,1,0,1,0
16941,1147,0,0,62,62,0,1,0,1,0
11359,3173,0,0,66,66,0,1,0,1,0
1712,2582,0,0,62,62,0,1,0,1,0
1463,1147,0,0,62,62,0,1,0,1,0
9329,3216,0,0,64,64,0,1,0,1,0
1744,1827,0,0,63,63,0,1,0,1,0
19806,1017,0,0,65,65,0,1,0,1,0
7339,152,0,0,60,60,0,1,0,1,0
1933,1017,0,0,62,62,0,1,0,1,0
17723,1147,0,0,63,63,0,1,0,1,0
20780,1147,0,0,66,66,0,1,0,1,0
16755,2939,0,0,66,66,0,1,0,1,0
23,1786,0,0,139,139,0,1,0,1,0
20931,1017,0,0,64,64,0,1,0,1,0
16444,2881,0,0,90,90,0,1,0,1,0
9999,1215,0,0,66,66,0,1,0,1,0
8,2758,0,0,60,60,0,1,0,1,0
13630,697,0,0,63,63,0,1,0,1,0
11680,697,0,0,66,66,0,1,0,1,0
12,2248,0,0,80,80,0,1,0,1,0
3092,1804,0,0,62,62,0,1,0,1,0
18113,111,0,0,135,135,0,1,0,1,0
16951,255,0,0,62,62,0,1,0,1,0
9707,1888,0,0,66,66,0,1,0,1,0
0,0,0,0,98,98,0,1,0,1,0
360,3105,0,0,912,912,0,1,0,1,0
22683,10,0,0,88,88,0,1,0,1,0
2515,1154,0,0,62,62,0,1,0,1,0
17311,1018,0,0,146,146,0,1,0,1,0
11747,2611,0,0,66,66,0,1,0,1,0
15084,465,0,0,70,70,0,1,0,1,0
1817,1016,0,0,62,62,0,1,0,1,0
3161,3038,0,0,98,98,0,1,0,1,0
18703,2953,0,0,65,65,0,1,0,1,0
1804,3211,0,0,60,60,0,1,0,1,0
20320,1771,0,0,66,66,0,1,0,1,0
160,2636,0,0,65,65,0,1,0,1,0
3167,3216,0,0,62,62,0,1,0,1,0
2279,2842,0,0,72,72,0,1,0,1,0
4961,2256,0,0,66,66,0,1,0,1,0
225,3193,0,0,62,62,0,1,0,1,0
778,1888,0,0,146,146,0,1,0,1,0
17607,2636,0,0,62,62,0,1,0,1,0
10604,2393,0,0,66,66,0,1,0,1,0
16678,2205,0,0,63,63,0,1,0,1,0
19119,205,0,0,60,60,0,1,0,1,0
265,7,0,0,60,60,0,1,0,1,0
11895,2256,0,0,66,66,0,1,0,1,0
14363,2587,0,0,62,62,0,1,0,1,0
32,1838,0,0,129,129,0,1,0,1,0
11886,2940,0,0,87,87,0,1,0,1,0
448,2944,0,0,63,63,0,1,0,1,0
2746,3216,0,0,62,62,0,1,0,1,0
538,1888,0,0,62,62,0,1,0,1,0
2298,1472,0,0,62,62,0,1,0,1,0
8,442,0,0,60,60,0,1,0,1,0
2586,141,0,0,135,135,0,1,0,1,0
16951,255,0,0,62,62,0,1,0,1,0
13074,181,0,0,60,60,0,1,0,1,0
1241,509,0,0,64,64,0,1,0,1,0
7997,1147,0,0,62,62,0,1,0,1,0
17428,2623,0,0,66,66,0,1,0,1,0
10458,2883,0,0,64,64,0,1,0,1,0
10753,954,0,0,66,66,0,1,0,1,0
18003,3235,0,0,98,98,0,1,0,1,0
6280,6,0,0,60,60,0,1,0,1,0
15253,1889,0,0,68,68,0,1,0,1,0
11439,2890,0,0,66,66,0,1,0,1,0
12377,1017,0,0,62,62,0,1,0,1,0
16951,255,0,0,62,62,0,1,0,1,0
3653,1015,0,0,62,62,0,1,0,1,0
6085,323,0,0,60,60,0,1,0,1,0
22193,203,0,0,62,62,0,1,0,1,0
16951,255,0,0,62,62,0,1,0,1,0
2967,1888,0,0,62,62,0,1,0,1,0
11588,1147,0,0,66,66,0,1,0,1,0
505,982,0,0,66,66,0,1,0,1,0
6926,2598,0,0,62,62,0,1,0,1,0
1965,1888,0,0,62,62,0,1,0,1,0
8070,1147,0,0,63,63,0,1,0,1,0
9469,2385,0,0,66,66,0,1,0,1,0
20919,1809,0,0,63,63,0,1,0,1,0
2951,1888,0,0,62,62,0,1,0,1,0
16951,255,0,0,62,62,0,1,0,1,0
17799,1888,0,0,62,62,0,1,0,1,0
22544,2376,0,0,66,66,0,1,0,1,0
11663,2883,0,0,62,62,0,1,0,1,0
10475,6,0,0,60,60,0,1,0,1,0
5942,1472,0,0,62,62,0,1,0,1,0
2548,3145,0,0,60,60,0,1,0,1,0
16951,255,0,0,62,62,0,1,0,1,0
2065,1888,0,0,62,62,0,1,0,1,0
8112,2541,0,0,71,71,0,1,0,1,0
360,3105,0,0,1305,1305,0,1,0,1,0
21280,1017,0,0,64,64,0,1,0,1,0
7637,3216,0,0,112,112,0,1,0,1,0
360,3105,0,0,1267,1267,0,1,0,1,0
4254,7,0,0,60,60,0,1,0,1,0
17,439,0,0,197,197,0,1,0,1,0
2917,1780,0,0,64,64,0,1,0,1,0
8976,1147,0,0,63,63,0,1,0,1,0
185,3110,0,0,613,613,0,1,0,1,0
16478,390,0,0,60,60,0,1,0,1,0
16,438,0,0,151,151,0,1,0,1,0
5608,7,0,0,60,60,0,1,0,1,0
13074,185,0,0,60,60,0,1,0,1,0
16951,255,0,0,62,62,0,1,0,1,0
0,0,0,0,70,70,0,1,0,1,0
1686,2256,0,0,64,64,0,1,0,1,0
12,2346,0,0,332,332,0,1,0,1,0
2118,794,0,0,62,62,0,1,0,1,0
3222,3146,0,0,65,65,0,1,0,1,0
18927,3216,0,0,69,69,0,1,0,1,0
5401,739,0,0,70,70,0,1,0,1,0
20994,3213,0,0,64,64,0,1,0,1,0
16951,255,0,0,62,62,0,1,0,1,0
1670,1215,0,0,62,62,0,1,0,1,0
328,1017,0,0,62,62,0,1,0,1,0
1873,466,0,0,158,158,0,1,0,1,0
2675,1147,0,0,65,65,0,1,0,1,0
18666,2971,0,0,62,62,0,1,0,1,0
9661,1017,0,0,64,64,0,1,0,1,0
240,1887,0,0,62,62,0,1,0,1,0
14243,2177,0,0,72,72,0,1,0,1,0
2447,2616,0,0,146,146,0,1,0,1,0
13675,1147,0,0,65,65,0,1,0,1,0
1412,1017,0,0,62,62,0,1,0,1,0
309,3216,0,0,65,65,0,1,0,1,0
778,1888,0,0,146,146,0,1,0,1,0
12,2568,0,0,331,331,0,1,0,1,0
17537,1771,0,0,65,65,0,1,0,1,0
1727,1017,0,0,62,62,0,1,0,1,0
10414,2588,0,0,62,62,0,1,0,1,0
16951,255,0,0,62,62,0,1,0,1,0
16951,255,0,0,62,62,0,1,0,1,0
13443,1464,0,0,66,66,0,1,0,1,0
20626,3216,0,0,66,66,0,1,0,1,0
68,2638,0,0,62,62,0,1,0,1,0
2904,2587,0,0,66,66,0,1,0,1,0
10644,2879,0,0,66,66,0,1,0,1,0
1230,983,0,0,62,62,0,1,0,1,0
16951,255,0,0,62,62,0,1,0,1,0
22135,1147,0,0,65,65,0,1,0,1,0
21419,2256,0,0,62,62,0,1,0,1,0
1547,2636,0,0,62,62,0,1,0,1,0
6506,936,0,0,62,62,0,1,0,1,0
16072,2256,0,0,62,62,0,1,0,1,0
18448,2938,0,0,62,62,0,1,0,1,0
2850,1792,0,0,62,62,0,1,0,1,0
638,1859,0,0,152,152,0,1,0,1,0
1957,3212,0,0,65,65,0,1,0,1,0
22106,1215,0,0,62,62,0,1,0,1,0
15154,1147,0,0,64,64,0,1,0,1,0
13800,509,0,0,66,66,0,1,0,1,0
4841,1074,0,0,129,129,0,1,0,1,0
16290,627,0,0,69,69,0,1,0,1,0
16951,255,0,0,62,62,0,1,0,1,0
11894,2721,0,0,66,66,0,1,0,1,0
1602,2532,0,0,61,61,0,1,0,1,0
700,2587,0,0,64,64,0,1,0,1,0
3217,2820,0,0,139,139,0,1,0,1,0
12,2568,0,0,331,331,0,1,0,1,0
1798,1034,0,0,102,102,0,1,0,1,0
11282,2362,0,0,62,62,0,1,0,1,0
11637,983,0,0,62,62,0,1,0,1,0
2227,6,0,0,60,60,0,1,0,1,0
19057,1888,0,0,62,62,0,1,0,1,0
1399,3216,0,0,63,63,0,1,0,1,0
10689,2607,0,0,66,66,0,1,0,1,0
16951,255,0,0,62,62,0,1,0,1,0
19874,3216,0,0,63,63,0,1,0,1,0
12493,3216,0,0,62,62,0,1,0,1,0
17406,2621,0,0,66,66,0,1,0,1,0
3021,1472,0,0,66,66,0,1,0,1,0
3173,697,0,0,131,131,0,1,0,1,0
1446,1535,0,0,62,62,0,1,0,1,0
16951,255,0,0,62,62,0,1,0,1,0
2758,1147,0,0,64,64,0,1,0,1,0
12611,1888,0,0,66,66,0,1,0,1,0
16951,255,0,0,62,62,0,1,0,1,0
19130,2787,0,0,62,62,0,1,0,1,0
10641,1040,0,0,66,66,0,1,0,1,0
8667,509,0,0,66,66,0,1,0,1,0
4793,178,0,0,66,66,0,1,0,1,0
19,2587,0,0,62,62,0,1,0,1,0
3252,2622,0,0,64,64,0,1,0,1,0
16951,255,0,0,62,62,0,1,0,1,0
2901,2602,0,0,146,146,0,1,0,1,0
1281,2543,0,0,60,60,0,1,0,1,0
18,2256,0,0,146,146,0,1,0,1,0
16951,255,0,0,62,62,0,1,0,1,0
16951,255,0,0,62,62,0,1,0,1,0
13694,2448,0,0,62,62,0,1,0,1,0
18,1147,0,0,62,62,0,1,0,1,0
16210,3216,0,0,66,66,0,1,0,1,0
16951,255,0,0,62,62,0,1,0,1,0
1809,470,0,0,66,66,0,1,0,1,0
2301,1946,0,0,60,60,0,1,0,1,0
11755,1816,0,0,62,62,0,1,0,1,0
13,202,0,0,89,89,0,1,0,1,0
20837,2636,0,0,66,66,0,1,0,1,0
12088,1472,0,0,66,66,0,1,0,1,0
21264,1147,0,0,62,62,0,1,0,1,0
7956,2587,0,0,70,70,0,1,0,1,0
7763,1656,0,0,145,145,0,1,0,1,0
7335,1070,0,0,60,60,0,1,0,1,0
20328,9,0,0,86,86,0,1,0,1,0
18,3216,0,0,62,62,0,1,0,1,0
2983,1147,0,0,146,146,0,1,0,1,0
11661,3216,0,0,62,62,0,1,0,1,0
10283,2883,0,0,66,66,0,1,0,1,0
16951,255,0,0,62,62,0,1,0,1,0
10848,2156,0,0,66,66,0,1,0,1,0
16951,255,0,0,62,62,0,1,0,1,0
18263,1888,0,0,66,66,0,1,0,1,0
61,1888,0,0,62,62,0,1,0,1,0
16266,1062,0,0,146,146,0,1,0,1,0
11818,2256,0,0,63,63,0,1,0,1,0
3034,2587,0,0,62,62,0,1,0,1,0
6450,1215,0,0,62,62,0,1,0,1,0
2440,2486,0,0,157,157,0,1,0,1,0
0,0,0,0,98,98,0,1,0,1,0
11617,2660,0,0,66,66,0,1,0,1,0
14505,2312,0,0,78,78,0,1,0,1,0
18921,2554,0,0,66,66,0,1,0,1,0
19919,1062,0,0,66,66,0,1,0,1,0
7327,2256,0,0,139,139,0,1,0,1,0
16683,1888,0,0,66,66,0,1,0,1,0
7821,277,0,0,60,60,0,1,0,1,0
15406,509,0,0,65,65,0,1,0,1,0
22003,2590,0,0,66,66,0,1,0,1,0
15736,2938,0,0,66,66,0,1,0,1,0
3946,1017,0,0,65,65,0,1,0,1,0
612,383,0,0,60,60,0,1,0,1,0
10960,2938,0,0,65,65,0,1,0,1,0
3850,2894,0,0,62,62,0,1,0,1,0
1804,192,0,0,60,60,0,1,0,1,0
13303,7,0,0,60,60,0,1,0,1,0
1682,1900,0,0,146,146,0,1,0,1,0
20747,1882,0,0,66,66,0,1,0,1,0
16941,3212,0,0,66,66,0,1,0,1,0
1162,3216,0,0,62,62,0,1,0,1,0
12290,2256,0,0,62,62,0,1,0,1,0
16171,1367,0,0,60,60,0,1,0,1,0
3671,2672,0,0,145,145,0,1,0,1,0
2021,3216,0,0,63,63,0,1,0,1,0
14891,1017,0,0,123,123,0,1,0,1,0
153,3216,0,0,66,66,0,1,0,1,0
19135,986,0,0,66,66,0,1,0,1,0
222,1147,0,0,146,146,0,1,0,1,0
11615,1828,0,0,62,62,0,1,0,1,0
16848,1935,0,0,65,65,0,1,0,1,0
21618,1017,0,0,66,66,0,1,0,1,0
360,3105,0,0,64,64,0,1,0,1,0
360,502,0,0,66,66,0,1,0,1,0
14952,1017,0,0,62,62,0,1,0,1,0
12,1017,0,0,88,88,0,1,0,1,0
12835,1147,0,0,65,65,0,1,0,1,0
2607,7,0,0,60,60,0,1,0,1,0
7905,94,0,0,123,123,0,1,0,1,0
212,1147,0,0,146,146,0,1,0,1,0
13793,509,0,0,66,66,0,1,0,1,0
16951,255,0,0,62,62,0,1,0,1,0
686,3216,0,0,65,65,0,1,0,1,0
20003,2256,0,0,66,66,0,1,0,1,0
10440,2889,0,0,66,66,0,1,0,1,0
30,262,0,0,71,71,0,1,0,1,0
1443,11,0,0,60,60,0,1,0,1,0
16261,1888,0,0,62,62,0,1,0,1,0
22046,1866,0,0,63,63,0,1,0,1,0
20834,2636,0,0,66,66,0,1,0,1,0
3238,3180,0,0,63,63,0,1,0,1,0
12871,1147,0,0,65,65,0,1,0,1,0
2750,1147,0,0,62,62,0,1,0,1,0
2914,2587,0,0,62,62,0,1,0,1,0
8134,2938,0,0,66,66,0,1,0,1,0
2649,1215,0,0,62,62,0,1,0,1,0
7226,1147,0,0,63,63,0,1,0,1,0
16050,1875,0,0,62,62,0,1,0,1,0
15005,2584,0,0,95,95,0,1,0,1,0
2090,1471,0,0,145,145,0,1,0,1,0
644,1777,0,0,64,64,0,1,0,1,0
12,152,0,0,135,135,0,1,0,1,0
19492,2917,0,0,71,71,0,1,0,1,0
8116,2575,0,0,62,62,0,1,0,1,0
16300,2587,0,0,66,66,0,1,0,1,0
19755,1017,0,0,66,66,0,1,0,1,0
12190,2587,0,0,65,65,0,1,0,1,0
12882,1809,0,0,65,65,0,1,0,1,0
1264,2256,0,0,62,62,0,1,0,1,0
360,3105,0,0,469,469,0,1,0,1,0
16477,1017,0,0,62,62,0,1,0,1,0
17547,1771,0,0,66,66,0,1,0,1,0
6928,183,0,0,60,60,0,1,0,1,0
3462,3125,0,0,144,144,0,1,0,1,0
1741,2077,0,0,65,65,0,1,0,1,0
1989,2256,0,0,66,66,0,1,0,1,0
10514,2747,0,0,66,66,0,1,0,1,0
2564,2596,0,0,66,66,0,1,0,1,0
13074,185,0,0,60,60,0,1,0,1,0
1789,2587,0,0,62,62,0,1,0,1,0
8350,62,0,0,129,129,0,1,0,1,0
7959,14,0,0,60,60,0,1,0,1,0
13083,1017,0,0,64,64,0,1,0,1,0
16951,255,0,0,62,62,0,1,0,1,0
3146,2587,0,0,62,62,0,1,0,1,0
16828,1855,0,0,66,66,0,1,0,1,0
18615,2611,0,0,62,62,0,1,0,1,0
21592,2938,0,0,65,65,0,1,0,1,0
1402,2938,0,0,62,62,0,1,0,1,0
16985,1827,0,0,74,74,0,1,0,1,0
9226,3216,0,0,62,62,0,1,0,1,0
7284,2507,0,0,63,63,0,1,0,1,0
16659,1792,0,0,63,63,0,1,0,1,0
16769,2918,0,0,64,64,0,1,0,1,0
2239,1472,0,0,62,62,0,1,0,1,0
636,981,0,0,146,146,0,1,0,1,0
2805,1017,0,0,62,62,0,1,0,1,0
2334,2910,0,0,62,62,0,1,0,1,0
20358,2256,0,0,66,66,0,1,0,1,0
15976,1017,0,0,62,62,0,1,0,1,0
1372,6,0,0,60,60,0,1,0,1,0
316,1799,0,0,62,62,0,1,0,1,0
7548,373,0,0,60,60,0,1,0,1,0
1755,2586,0,0,62,62,0,1,0,1,0
22,2256,0,0,62,62,0,1,0,1,0
21795,2210,0,0,62,62,0,1,0,1,0
1750,3216,0,0,66,66,0,1,0,1,0
9857,1017,0,0,62,62,0,1,0,1,0
761,697,0,0,106,106,0,1,0,1,0
1913,2573,0,0,62,62,0,1,0,1,0
3080,7,0,0,60,60,0,1,0,1,0
3493,7,0,0,60,60,0,1,0,1,0
10474,2938,0,0,72,72,0,1,0,1,0
18271,1771,0,0,66,66,0,1,0,1,0
17201,1107,0,0,63,63,0,1,0,1,0
8058,1817,0,0,109,109,0,1,0,1,0
599,2254,0,0,66,66,0,1,0,1,0
12276,1367,0,0,60,60,0,1,0,1,0
1738,2077,0,0,78,78,0,1,0,1,0
5698,1007,0,0,62,62,0,1,0,1,0
16951,255,0,0,62,62,0,1,0,1,0
6042,2883,0,0,66,66,0,1,0,1,0
18547,1017,0,0,65,65,0,1,0,1,0
16019,2938,0,0,66,66,0,1,0,1,0
7339,152,0,0,60,60,0,1,0,1,0
5807,991,0,0,65,65,0,1,0,1,0
405,1888,0,0,66,66,0,1,0,1,0
776,2920,0,0,63,63,0,1,0,1,0
11701,2943,0,0,62,62,0,1,0,1,0
16951,255,0,0,62,62,0,1,0,1,0
2807,1017,0,0,146,146,0,1,0,1,0
1374,1147,0,0,62,62,0,1,0,1,0
4014,2199,0,0,62,62,0,1,0,1,0
9698,3216,0,0,64,64,0,1,0,1,0
4008,1129,0,0,146,146,0,1,0,1,0
157,1147,0,0,62,62,0,1,0,1,0
4981,2630,0,0,127,127,0,1,0,1,0
16834,2256,0,0,65,65,0,1,0,1,0
22558,2864,0,0,66,66,0,1,0,1,0
684,7,0,0,60,60,0,1,0,1,0
10172,2587,0,0,66,66,0,1,0,1,0
8,441,0,0,60,60,0,1,0,1,0
7949,314,0,0,60,60,0,1,0,1,0
15860,3216,0,0,66,66,0,1,0,1,0
13000,1147,0,0,63,63,0,1,0,1,0
634,2415,0,0,146,146,0,1,0,1,0
497,653,0,0,220,220,0,1,0,1,0
8225,2587,0,0,64,64,0,1,0,1,0
15140,427,0,0,78,78,0,1,0,1,0
10595,509,0,0,66,66,0,1,0,1,0
1726,1017,0,0,62,62,0,1,0,1,0
13338,1215,0,0,62,62,0,1,0,1,0
1913,1791,0,0,63,63,0,1,0,1,0
8625,1929,0,0,108,108,0,1,0,1,0
16272,2592,0,0,66,66,0,1,0,1,0
244,2587,0,0,66,66,0,1,0,1,0
1247,1884,0,0,63,63,0,1,0,1,0
2833,2631,0,0,146,146,0,1,0,1,0
15081,2968,0,0,145,145,0,1,0,1,0
16951,255,0,0,62,62,0,1,0,1,0
10393,1888,0,0,62,62,0,1,0,1,0
12,3227,0,0,118,118,0,1,0,1,0
16951,255,0,0,62,62,0,1,0,1,0
1613,2609,0,0,64,64,0,1,0,1,0
6930,1883,0,0,62,62,0,1,0,1,0
240,2205,0,0,62,62,0,1,0,1,0
7326,180,0,0,60,60,0,1,0,1,0
19687,2591,0,0,65,65,0,1,0,1,0
1758,1091,0,0,146,146,0,1,0,1,0
2536,2612,0,0,64,64,0,1,0,1,0
9198,2256,0,0,73,73,0,1,0,1,0
20978,2382,0,0,64,64,0,1,0,1,0
17651,995,0,0,66,66,0,1,0,1,0
360,3105,0,0,223,223,0,1,0,1,0
14985,2587,0,0,62,62,0,1,0,1,0
10274,630,0,0,64,64,0,1,0,1,0
22208,2611,0,0,66,66,0,1,0,1,0
14722,1888,0,0,62,62,0,1,0,1,0
4165,7,0,0,60,60,0,1,0,1,0
2547,2576,0,0,60,60,0,1,0,1,0
2663,1147,0,0,146,146,0,1,0,1,0
3543,1017,0,0,146,146,0,1,0,1,0
1055,2883,0,0,63,63,0,1,0,1,0
1775,1017,0,0,62,62,0,1,0,1,0
893,1626,0,0,66,66,0,1,0,1,0
16951,255,0,0,62,62,0,1,0,1,0
1804,3206,0,0,60,60,0,1,0,1,0
479,130,0,0,66,66,0,1,0,1,0
16951,255,0,0,62,62,0,1,0,1,0
1946,1147,0,0,62,62,0,1,0,1,0
1591,2180,0,0,62,62,0,1,0,1,0
11857,2232,0,0,66,66,0,1,0,1,0
2212,2676,0,0,120,120,0,1,0,1,0
21079,1215,0,0,64,64,0,1,0,1,0
3871,2610,0,0,62,62,0,1,0,1,0
17120,1175,0,0,63,63,0,1,0,1,0
22402,2256,0,0,62,62,0,1,0,1,0
13236,1804,0,0,66,66,0,1,0,1,0
12590,1147,0,0,65,65,0,1,0,1,0
1804,1777,0,0,60,60,0,1,0,1,0
19892,1017,0,0,66,66,0,1,0,1,0
16360,2574,0,0,89,89,0,1,0,1,0
21291,2938,0,0,74,74,0,1,0,1,0
13470,1017,0,0,66,66,0,1,0,1,0
18,2938,0,0,62,62,0,1,0,1,0
22324,1883,0,0,69,69,0,1,0,1,0
1800,1770,0,0,61,61,0,1,0,1,0
7949,314,0,0,60,60,0,1,0,1,0
10589,1840,0,0,69,69,0,1,0,1,0
6,12,0,0,346,346,0,1,0,1,0
13622,139,0,0,60,60,0,1,0,1,0
12,2784,0,0,82,82,0,1,0,1,0
1521,1147,0,0,62,62,0,1,0,1,0
16478,192,0,0,60,60,0,1,0,1,0
18697,389,0,0,122,122,0,1,0,1,0
5278,2256,0,0,63,63,0,1,0,1,0
21345,2978,0,0,63,63,0,1,0,1,0
14621,2883,0,0,66,66,0,1,0,1,0
12662,1147,0,0,66,66,0,1,0,1,0
109,1017,0,0,63,63,0,1,0,1,0
7663,3216,0,0,62,62,0,1,0,1,0
9006,308,0,0,65,65,0,1,0,1,0
2897,1888,0,0,62,62,0,1,0,1,0
19407,1880,0,0,66,66,0,1,0,1,0
22042,1888,0,0,62,62,0,1,0,1,0
636,280,0,0,146,146,0,1,0,1,0
3555,2258,0,0,82,82,0,1,0,1,0
18307,1486,0,0,65,65,0,1,0,1,0
2262,2256,0,0,62,62,0,1,0,1,0
6685,260,0,0,60,60,0,1,0,1,0
1375,1885,0,0,145,145,0,1,0,1,0
12996,360,0,0,73,73,0,1,0,1,0
2380,2256,0,0,62,62,0,1,0,1,0
496,321,0,0,66,66,0,1,0,1,0
1119,13,0,0,60,60,0,1,0,1,0
10810,2914,0,0,63,63,0,1,0,1,0
2474,459,0,0,145,145,0,1,0,1,0
17158,697,0,0,66,66,0,1,0,1,0
14765,2919,0,0,63,63,0,1,0,1,0
14088,2883,0,0,66,66,0,1,0,1,0
7291,1155,0,0,62,62,0,1,0,1,0
1651,1147,0,0,146,146,0,1,0,1,0
21146,1147,0,0,78,78,0,1,0,1,0
3049,1215,0,0,66,66,0,1,0,1,0
17896,1152,0,0,63,63,0,1,0,1,0
12421,1792,0,0,63,63,0,1,0,1,0
17889,3139,0,0,66,66,0,1,0,1,0
1277,509,0,0,62,62,0,1,0,1,0
6314,1147,0,0,62,62,0,1,0,1,0
7339,334,0,0,60,60,0,1,0,1,0
7738,2780,0,0,146,146,0,1,0,1,0
25,1622,0,0,123,123,0,1,0,1,0
16113,2611,0,0,65,65,0,1,0,1,0
1863,3139,0,0,62,62,0,1,0,1,0
14608,2883,0,0,63,63,0,1,0,1,0
1804,2232,0,0,60,60,0,1,0,1,0
10772,1482,0,0,66,66,0,1,0,1,0
5527,1041,0,0,146,146,0,1,0,1,0
17796,1881,0,0,65,65,0,1,0,1,0
19130,2787,0,0,62,62,0,1,0,1,0
16549,2596,0,0,66,66,0,1,0,1,0
19130,130,0,0,60,60,0,1,0,1,0
2281,6,0,0,60,60,0,1,0,1,0
16837,1888,0,0,64,64,0,1,0,1,0
8650,2914,0,0,66,66,0,1,0,1,0
1423,1888,0,0,62,62,0,1,0,1,0
22482,2587,0,0,65,65,0,1,0,1,0
499,187,0,0,345,345,0,1,0,1,0
14505,2312,0,0,78,78,0,1,0,1,0
8465,2636,0,0,66,66,0,1,0,1,0
13698,2931,0,0,76,76,0,1,0,1,0
3070,1888,0,0,62,62,0,1,0,1,0
9214,3256,0,0,60,60,0,1,0,1,0
16691,3216,0,0,68,68,0,1,0,1,0
945,1590,0,0,72,72,0,1,0,1,0
4006,2635,0,0,61,61,0,1,0,1,0
914,2619,0,0,62,62,0,1,0,1,0
1850,3216,0,0,66,66,0,1,0,1,0
11476,1800,0,0,62,62,0,1,0,1,0
2865,1799,0,0,62,62,0,1,0,1,0
10736,1020,0,0,66,66,0,1,0,1,0
16288,2602,0,0,66,66,0,1,0,1,0
7347,134,0,0,60,60,0,1,0,1,0
2549,133,0,0,60,60,0,1,0,1,0
15964,2938,0,0,63,63,0,1,0,1,0
15599,2214,0,0,64,64,0,1,0,1,0
16951,255,0,0,62,62,0,1,0,1,0
9452,3166,0,0,117,117,0,1,0,1,0
18211,1771,0,0,65,65,0,1,0,1,0
1803,777,0,0,60,60,0,1,0,1,0
2084,1471,0,0,145,145,0,1,0,1,0
427,1215,0,0,61,61,0,1,0,1,0
19296,2671,0,0,69,69,0,1,0,1,0
4257,7,0,0,60,60,0,1,0,1,0
1254,1590,0,0,65,65,0,1,0,1,0
639,401,0,0,143,143,0,1,0,1,0
2312,1147,0,0,62,62,0,1,0,1,0
16951,255,0,0,62,62,0,1,0,1,0
17876,2874,0,0,64,64,0,1,0,1,0
19482,2942,0,0,71,71,0,1,0,1,0
163,2205,0,0,62,62,0,1,0,1,0
16951,255,0,0,62,62,0,1,0,1,0
3040,2587,0,0,63,63,0,1,0,1,0
1608,2477,0,0,60,60,0,1,0,1,0
2301,1946,0,0,60,60,0,1,0,1,0
12606,2636,0,0,65,65,0,1,0,1,0
7610,2604,0,0,62,62,0,1,0,1,0
3167,481,0,0,145,145,0,1,0,1,0
577,2611,0,0,78,78,0,1,0,1,0
12,3139,0,0,330,330,0,1,0,1,0
10,908,0,0,74,74,0,1,0,1,0
2561,1287,0,0,61,61,0,1,0,1,0
714,1017,0,0,62,62,0,1,0,1,0
18279,155,0,0,66,66,0,1,0,1,0
18151,1147,0,0,66,66,0,1,0,1,0
3487,3129,0,0,115,115,0,1,0,1,0
10162,1784,0,0,62,62,0,1,0,1,0
1402,2938,0,0,62,62,0,1,0,1,0
16086,1771,0,0,66,66,0,1,0,1,0
2157,3072,0,0,60,60,0,1,0,1,0
3255,7,0,0,60,60,0,1,0,1,0
6660,2950,0,0,94,94,0,1,0,1,0
353,797,0,0,62,62,0,1,0,1,0
2759,1017,0,0,62,62,0,1,0,1,0
8087,2938,0,0,73,73,0,1,0,1,0
1417,1888,0,0,62,62,0,1,0,1,0
16951,255,0,0,62,62,0,1,0,1,0
2058,1904,0,0,62,62,0,1,0,1,0
17526,983,0,0,66,66,0,1,0,1,0
9457,1017,0,0,63,63,0,1,0,1,0
17770,2397,0,0,64,64,0,1,0,1,0
16951,255,0,0,62,62,0,1,0,1,0
2810,1017,0,0,62,62,0,1,0,1,0
10780,3216,0,0,64,64,0,1,0,1,0
5122,1001,0,0,64,64,0,1,0,1,0
17858,1763,0,0,62,62,0,1,0,1,0
11921,1144,0,0,62,62,0,1,0,1,0
16029,308,0,0,62,62,0,1,0,1,0
9990,2713,0,0,66,66,0,1,0,1,0
16951,255,0,0,62,62,0,1,0,1,0
595,1215,0,0,62,62,0,1,0,1,0
14806,1837,0,0,66,66,0,1,0,1,0
9450,1017,0,0,64,64,0,1,0,1,0
11395,144,0,0,60,60,0,1,0,1,0
3033,2587,0,0,64,64,0,1,0,1,0
360,3105,0,0,911,911,0,1,0,1,0
6293,1017,0,0,62,62,0,1,0,1,0
7236,1,0,0,62,62,0,1,0,1,0
17465,2944,0,0,66,66,0,1,0,1,0
16951,255,0,0,62,62,0,1,0,1,0
9441,1017,0,0,65,65,0,1,0,1,0
1535,2256,0,0,65,65,0,1,0,1,0
19644,3214,0,0,66,66,0,1,0,1,0
778,2624,0,0,62,62,0,1,0,1,0
2025,3168,0,0,115,115,0,1,0,1,0
3176,2615,0,0,62,62,0,1,0,1,0
16951,255,0,0,62,62,0,1,0,1,0
19031,1919,0,0,64,64,0,1,0,1,0
1826,1147,0,0,62,62,0,1,0,1,0
2132,1888,0,0,62,62,0,1,0,1,0
12,207,0,0,320,320,0,1,0,1,0
17733,1804,0,0,63,63,0,1,0,1,0
6761,5,0,0,60,60,0,1,0,1,0
1960,3212,0,0,62,62,0,1,0,1,0
14555,1147,0,0,62,62,0,1,0,1,0
13473,1017,0,0,65,65,0,1,0,1,0
14149,2587,0,0,63,63,0,1,0,1,0
21720,183,0,0,117,117,0,1,0,1,0
3259,1017,0,0,65,65,0,1,0,1,0
1823,2573,0,0,62,62,0,1,0,1,0
800,2883,0,0,62,62,0,1,0,1,0
16478,245,0,0,60,60,0,1,0,1,0
2888,1156,0,0,62,62,0,1,0,1,0
18,1147,0,0,62,62,0,1,0,1,0
11435,1792,0,0,71,71,0,1,0,1,0
8171,1073,0,0,60,60,0,1,0,1,0
2663,2938,0,0,65,65,0,1,0,1,0
8171,1073,0,0,60,60,0,1,0,1,0
14334,246,0,0,60,60,0,1,0,1,0
2638,1253,0,0,64,64,0,1,0,1,0
1928,1045,0,0,66,66,0,1,0,1,0
326,1888,0,0,62,62,0,1,0,1,0
8647,2897,0,0,66,66,0,1,0,1,0
11472,2911,0,0,66,66,0,1,0,1,0
16951,255,0,0,62,62,0,1,0,1,0
21032,3216,0,0,66,66,0,1,0,1,0
273,1370,0,0,60,60,0,1,0,1,0
12380,1007,0,0,63,63,0,1,0,1,0
1121,2636,0,0,66,66,0,1,0,1,0
2396,1147,0,0,62,62,0,1,0,1,0
12,3124,0,0,328,328,0,1,0,1,0
13871,509,0,0,66,66,0,1,0,1,0
9214,3256,0,0,60,60,0,1,0,1,0
20374,2256,0,0,65,65,0,1,0,1,0
21035,674,0,0,92,92,0,1,0,1,0
1265,509,0,0,62,62,0,1,0,1,0
2562,1287,0,0,62,62,0,1,0,1,0
5498,2833,0,0,138,138,0,1,0,1,0
7846,1215,0,0,62,62,0,1,0,1,0
18220,1017,0,0,63,63,0,1,0,1,0
16830,1888,0,0,66,66,0,1,0,1,0
1812,1149,0,0,65,65,0,1,0,1,0
4481,1147,0,0,62,62,0,1,0,1,0
19934,2571,0,0,62,62,0,1,0,1,0
12,207,0,0,320,320,0,1,0,1,0
17758,2883,0,0,62,62,0,1,0,1,0
497,1610,0,0,104,104,0,1,0,1,0
16354,2563,0,0,87,87,0,1,0,1,0
16951,255,0,0,62,62,0,1,0,1,0
17796,2916,0,0,62,62,0,1,0,1,0
19483,1888,0,0,66,66,0,1,0,1,0
11997,1147,0,0,64,64,0,1,0,1,0
76,2883,0,0,66,66,0,1,0,1,0
304,3216,0,0,62,62,0,1,0,1,0
12073,1777,0,0,66,66,0,1,0,1,0
2416,1017,0,0,62,62,0,1,0,1,0
1763,2486,0,0,141,141,0,1,0,1,0
13191,1003,0,0,66,66,0,1,0,1,0
5033,1016,0,0,62,62,0,1,0,1,0
3729,3220,0,0,146,146,0,1,0,1,0
16951,255,0,0,62,62,0,1,0,1,0
9254,1473,0,0,65,65,0,1,0,1,0
1282,1147,0,0,62,62,0,1,0,1,0
20004,1147,0,0,62,62,0,1,0,1,0
16951,255,0,0,62,62,0,1,0,1,0
6229,2938,0,0,78,78,0,1,0,1,0
13269,1779,0,0,66,66,0,1,0,1,0
6243,2938,0,0,62,62,0,1,0,1,0
8074,1147,0,0,62,62,0,1,0,1,0
22468,201,0,0,78,78,0,1,0,1,0
7335,1070,0,0,60,60,0,1,0,1,0
5877,13,0,0,60,60,0,1,0,1,0
20135,592,0,0,64,64,0,1,0,1,0
3709,1010,0,0,62,62,0,1,0,1,0
12215,1215,0,0,63,63,0,1,0,1,0
1801,1772,0,0,61,61,0,1,0,1,0
7598,2580,0,0,70,70,0,1,0,1,0
6676,3057,0,0,133,133,0,1,0,1,0
19578,3216,0,0,64,64,0,1,0,1,0
7339,2845,0,0,60,60,0,1,0,1,0
12,207,0,0,320,320,0,1,0,1,0
14483,303,0,0,61,61,0,1,0,1,0
14611,2275,0,0,62,62,0,1,0,1,0
3436,6,0,0,60,60,0,1,0,1,0
5425,1888,0,0,66,66,0,1,0,1,0
2256,2636,0,0,62,62,0,1,0,1,0
12353,1412,0,0,62,62,0,1,0,1,0
1909,7,0,0,60,60,0,1,0,1,0
11344,2256,0,0,106,106,0,1,0,1,0
1952,7,0,0,60,60,0,1,0,1,0
2022,2532,0,0,147,147,0,1,0,1,0
12185,1880,0,0,66,66,0,1,0,1,0
14793,1012,0,0,66,66,0,1,0,1,0
2616,1210,0,0,62,62,0,1,0,1,0
16951,255,0,0,62,62,0,1,0,1,0
1550,2636,0,0,64,64,0,1,0,1,0
759,1145,0,0,64,64,0,1,0,1,0
12987,1147,0,0,64,64,0,1,0,1,0
16545,2274,0,0,63,63,0,1,0,1,0
13299,1215,0,0,63,63,0,1,0,1,0
1374,1147,0,0,62,62,0,1,0,1,0
16951,255,0,0,62,62,0,1,0,1,0
17890,2245,0,0,63,63,0,1,0,1,0
18954,3216,0,0,66,66,0,1,0,1,0
2983,1580,0,0,66,66,0,1,0,1,0
10965,2915,0,0,62,62,0,1,0,1,0
436,3216,0,0,62,62,0,1,0,1,0
16839,2938,0,0,66,66,0,1,0,1,0
19465,3214,0,0,64,64,0,1,0,1,0
11350,1042,0,0,63,63,0,1,0,1,0
16754,2939,0,0,66,66,0,1,0,1,0
17417,1936,0,0,68,68,0,1,0,1,0
7277,2441,0,0,65,65,0,1,0,1,0
12048,2611,0,0,66,66,0,1,0,1,0
19280,3216,0,0,64,64,0,1,0,1,0
1269,1054,0,0,65,65,0,1,0,1,0
3596,1017,0,0,146,146,0,1,0,1,0
1757,2577,0,0,146,146,0,1,0,1,0
16951,255,0,0,62,62,0,1,0,1,0
7765,311,0,0,123,123,0,1,0,1,0
591,1888,0,0,62,62,0,1,0,1,0
10229,3153,0,0,62,62,0,1,0,1,0
1637,2896,0,0,145,145,0,1,0,1,0
9487,1888,0,0,66,66,0,1,0,1,0
20004,1169,0,0,64,64,0,1,0,1,0
2888,1858,0,0,145,145,0,1,0,1,0
14957,2256,0,0,66,66,0,1,0,1,0
16951,255,0,0,62,62,0,1,0,1,0
1525,1444,0,0,145,145,0,1,0,1,0
17984,2256,0,0,65,65,0,1,0,1,0
16,2800,0,0,67,67,0,1,0,1,0
12,1932,0,0,82,82,0,1,0,1,0
3316,1888,0,0,66,66,0,1,0,1,0
11724,1050,0,0,63,63,0,1,0,1,0
2314,473,0,0,66,66,0,1,0,1,0
16951,255,0,0,62,62,0,1,0,1,0
7326,1649,0,0,60,60,0,1,0,1,0
6866,359,0,0,145,145,0,1,0,1,0
11538,708,0,0,73,73,0,1,0,1,0
8718,1789,0,0,110,110,0,1,0,1,0
693,2256,0,0,66,66,0,1,0,1,0
2301,1946,0,0,60,60,0,1,0,1,0
19819,2786,0,0,60,60,0,1,0,1,0
22427,2256,0,0,100,100,0,1,0,1,0
14913,1017,0,0,63,63,0,1,0,1,0
3681,1147,0,0,66,66,0,1,0,1,0
11716,379,0,0,112,112,0,1,0,1,0
3783,6,0,0,60,60,0,1,0,1,0
12,209,0,0,62,62,0,1,0,1,0
8581,1017,0,0,66,66,0,1,0,1,0
7339,170,0,0,60,60,0,1,0,1,0
11915,3214,0,0,66,66,0,1,0,1,0
1544,2945,0,0,62,62,0,1,0,1,0
20811,2953,0,0,63,63,0,1,0,1,0
2651,1215,0,0,62,62,0,1,0,1,0
6614,1215,0,0,64,64,0,1,0,1,0
21273,1147,0,0,62,62,0,1,0,1,0
360,3105,0,0,1287,1287,0,1,0,1,0
21066,2611,0,0,62,62,0,1,0,1,0
2327,3206,0,0,62,62,0,1,0,1,0
12,251,0,0,60,60,0,1,0,1,0
10484,1017,0,0,62,62,0,1,0,1,0
4562,2207,0,0,62,62,0,1,0,1,0
190,2938,0,0,78,78,0,1,0,1,0
4859,2584,0,0,62,62,0,1,0,1,0
9079,1771,0,0,76,76,0,1,0,1,0
16836,1888,0,0,64,64,0,1,0,1,0
643,1780,0,0,64,64,0,1,0,1,0
25,2950,0,0,145,145,0,1,0,1,0
16951,255,0,0,62,62,0,1,0,1,0
8021,2948,0,0,62,62,0,1,0,1,0
11545,1017,0,0,66,66,0,1,0,1,0
13767,326,0,0,66,66,0,1,0,1,0
4979,2603,0,0,65,65,0,1,0,1,0
12944,2581,0,0,66,66,0,1,0,1,0
223,2181,0,0,62,62,0,1,0,1,0
15688,2613,0,0,62,62,0,1,0,1,0
16951,255,0,0,62,62,0,1,0,1,0
3075,1795,0,0,152,152,0,1,0,1,0
7914,1147,0,0,146,146,0,1,0,1,0
13088,1924,0,0,62,62,0,1,0,1,0
5492,1854,0,0,64,64,0,1,0,1,0
17691,1888,0,0,62,62,0,1,0,1,0
2897,1888,0,0,62,62,0,1,0,1,0
16951,255,0,0,62,62,0,1,0,1,0
1482,1147,0,0,146,146,0,1,0,1,0
20162,2703,0,0,64,64,0,1,0,1,0
11447,2595,0,0,69,69,0,1,0,1,0
6459,1215,0,0,62,62,0,1,0,1,0
16444,2881,0,0,90,90,0,1,0,1,0
4813,1086,0,0,95,95,0,1,0,1,0
16720,2587,0,0,105,105,0,1,0,1,0
2304,1147,0,0,64,64,0,1,0,1,0
22181,223,0,0,61,61,0,1,0,1,0
12342,2,0,0,64,64,0,1,0,1,0
3114,1147,0,0,62,62,0,1,0,1,0
20306,775,0,0,66,66,0,1,0,1,0
19659,825,0,0,63,63,0,1,0,1,0
9232,1474,0,0,62,62,0,1,0,1,0
3931,2938,0,0,71,71,0,1,0,1,0
3031,2603,0,0,62,62,0,1,0,1,0
1319,2636,0,0,64,64,0,1,0,1,0
269,1768,0,0,66,66,0,1,0,1,0
14470,2912,0,0,65,65,0,1,0,1,0
22447,1037,0,0,66,66,0,1,0,1,0
13058,1804,0,0,64,64,0,1,0,1,0
19349,983,0,0,64,64,0,1,0,1,0
1783,1000,0,0,146,146,0,1,0,1,0
15447,986,0,0,72,72,0,1,0,1,0
18216,2644,0,0,66,66,0,1,0,1,0
18887,1147,0,0,64,64,0,1,0,1,0
5537,391,0,0,60,60,0,1,0,1,0
22588,299,0,0,66,66,0,1,0,1,0
495,2995,0,0,66,66,0,1,0,1,0
8171,1073,0,0,60,60,0,1,0,1,0
6938,1884,0,0,62,62,0,1,0,1,0
2450,2938,0,0,62,62,0,1,0,1,0
6327,1147,0,0,146,146,0,1,0,1,0
8573,2938,0,0,62,62,0,1,0,1,0
17373,155,0,0,66,66,0,1,0,1,0
3574,2938,0,0,74,74,0,1,0,1,0
5920,2587,0,0,66,66,0,1,0,1,0
12493,3216,0,0,62,62,0,1,0,1,0
5305,7,0,0,60,60,0,1,0,1,0
733,1802,0,0,69,69,0,1,0,1,0
16951,255,0,0,62,62,0,1,0,1,0
21618,1804,0,0,119,119,0,1,0,1,0
18044,1777,0,0,65,65,0,1,0,1,0
11354,3212,0,0,66,66,0,1,0,1,0
20053,2587,0,0,66,66,0,1,0,1,0
2684,2588,0,0,66,66,0,1,0,1,0
20025,2604,0,0,69,69,0,1,0,1,0
12333,2280,0,0,66,66,0,1,0,1,0
662,1475,0,0,146,146,0,1,0,1,0
2819,1147,0,0,146,146,0,1,0,1,0
12,2461,0,0,81,81,0,1,0,1,0
9426,2938,0,0,78,78,0,1,0,1,0
0,0,0,0,60,60,0,1,0,1,0
7965,128,0,0,115,115,0,1,0,1,0
16951,255,0,0,62,62,0,1,0,1,0
6423,2883,0,0,62,62,0,1,0,1,0
2514,3216,0,0,65,65,0,1,0,1,0
16951,255,0,0,62,62,0,1,0,1,0
637,2846,0,0,145,145,0,1,0,1,0
6398,1017,0,0,62,62,0,1,0,1,0
4416,2883,0,0,77,77,0,1,0,1,0
288,1766,0,0,64,64,0,1,0,1,0
19911,1881,0,0,62,62,0,1,0,1,0
15694,333,0,0,145,145,0,1,0,1,0
20313,3139,0,0,66,66,0,1,0,1,0
16951,255,0,0,62,62,0,1,0,1,0
7298,2596,0,0,98,98,0,1,0,1,0
18822,1888,0,0,62,62,0,1,0,1,0
4336,1105,0,0,146,146,0,1,0,1,0
2466,2587,0,0,146,146,0,1,0,1,0
6005,79,0,0,107,107,0,1,0,1,0
16951,255,0,0,62,62,0,1,0,1,0
2434,2938,0,0,62,62,0,1,0,1,0
7268,3216,0,0,63,63,0,1,0,1,0
14635,3216,0,0,63,63,0,1,0,1,0
14030,2235,0,0,66,66,0,1,0,1,0
15779,3216,0,0,64,64,0,1,0,1,0
16951,255,0,0,62,62,0,1,0,1,0
20760,8,0,0,66,66,0,1,0,1,0
790,1405,0,0,64,64,0,1,0,1,0
17583,2587,0,0,62,62,0,1,0,1,0
6945,3216,0,0,65,65,0,1,0,1,0
6233,1646,0,0,60,60,0,1,0,1,0
6243,2938,0,0,62,62,0,1,0,1,0
1542,2942,0,0,63,63,0,1,0,1,0
11540,1472,0,0,66,66,0,1,0,1,0
1402,2938,0,0,62,62,0,1,0,1,0
3956,1477,0,0,62,62,0,1,0,1,0
3630,2689,0,0,153,153,0,1,0,1,0
15157,3215,0,0,65,65,0,1,0,1,0
2630,1287,0,0,66,66,0,1,0,1,0
12146,1861,0,0,63,63,0,1,0,1,0
12923,1837,0,0,62,62,0,1,0,1,0
3038,2587,0,0,62,62,0,1,0,1,0
20772,1804,0,0,64,64,0,1,0,1,0
6233,1646,0,0,60,60,0,1,0,1,0
1325,942,0,0,62,62,0,1,0,1,0
16064,1514,0,0,64,64,0,1,0,1,0
1934,2587,0,0,66,66,0,1,0,1,0
2968,1888,0,0,62,62,0,1,0,1,0
2143,3190,0,0,145,145,0,1,0,1,0
2383,2256,0,0,62,62,0,1,0,1,0
18491,726,0,0,121,121,0,1,0,1,0
34,688,0,0,61,61,0,1,0,1,0
2642,3216,0,0,66,66,0,1,0,1,0
2000,2941,0,0,62,62,0,1,0,1,0
16951,255,0,0,62,62,0,1,0,1,0
22161,2256,0,0,66,66,0,1,0,1,0
7883,1153,0,0,62,62,0,1,0,1,0
17136,788,0,0,66,66,0,1,0,1,0
1952,7,0,0,60,60,0,1,0,1,0
10251,3205,0,0,62,62,0,1,0,1,0
6831,2256,0,0,66,66,0,1,0,1,0
17051,2611,0,0,62,62,0,1,0,1,0
448,7,0,0,60,60,0,1,0,1,0
7610,3216,0,0,145,145,0,1,0,1,0
11054,2920,0,0,64,64,0,1,0,1,0
370,1147,0,0,62,62,0,1,0,1,0
7273,1,0,0,62,62,0,1,0,1,0
1709,1147,0,0,146,146,0,1,0,1,0
2014,1888,0,0,62,62,0,1,0,1,0
1330,697,0,0,62,62,0,1,0,1,0
1619,1797,0,0,65,65,0,1,0,1,0
17436,362,0,0,66,66,0,1,0,1,0
0,0,0,0,98,98,0,1,0,1,0
9194,989,0,0,65,65,0,1,0,1,0
3735,1936,0,0,74,74,0,1,0,1,0
7356,2590,0,0,62,62,0,1,0,1,0
20872,1147,0,0,66,66,0,1,0,1,0
14807,2851,0,0,66,66,0,1,0,1,0
8646,3255,0,0,135,135,0,1,0,1,0
2483,288,0,0,63,63,0,1,0,1,0
8782,1472,0,0,62,62,0,1,0,1,0
9706,1888,0,0,62,62,0,1,0,1,0
800,2883,0,0,66,66,0,1,0,1,0
7299,1566,0,0,60,60,0,1,0,1,0
22448,1017,0,0,62,62,0,1,0,1,0
2269,911,0,0,66,66,0,1,0,1,0
16951,255,0,0,62,62,0,1,0,1,0
1620,1888,0,0,62,62,0,1,0,1,0
8339,987,0,0,76,76,0,1,0,1,0
1401,2938,0,0,62,62,0,1,0,1,0
6063,2938,0,0,62,62,0,1,0,1,0
14935,1017,0,0,82,82,0,1,0,1,0
616,2636,0,0,62,62,0,1,0,1,0
15158,1086,0,0,63,63,0,1,0,1,0
316,3216,0,0,62,62,0,1,0,1,0
10630,2636,0,0,63,63,0,1,0,1,0
17964,2256,0,0,66,66,0,1,0,1,0
12235,1215,0,0,64,64,0,1,0,1,0
1852,1788,0,0,146,146,0,1,0,1,0
22440,2325,0,0,66,66,0,1,0,1,0
20004,1156,0,0,62,62,0,1,0,1,0
22468,201,0,0,78,78,0,1,0,1,0
1150,1016,0,0,65,65,0,1,0,1,0
2753,2626,0,0,62,62,0,1,0,1,0
22221,2943,0,0,71,71,0,1,0,1,0
13331,1215,0,0,63,63,0,1,0,1,0
1330,697,0,0,62,62,0,1,0,1,0
16628,1889,0,0,66,66,0,1,0,1,0
16951,255,0,0,62,62,0,1,0,1,0
1800,1772,0,0,61,61,0,1,0,1,0
360,3105,0,0,1006,1006,0,1,0,1,0
15154,3216,0,0,62,62,0,1,0,1,0
427,1215,0,0,66,66,0,1,0,1,0
12491,1103,0,0,66,66,0,1,0,1,0
9266,6,0,0,60,60,0,1,0,1,0
14505,2312,0,0,78,78,0,1,0,1,0
5153,1017,0,0,66,66,0,1,0,1,0
20697,2938,0,0,66,66,0,1,0,1,0
2672,2938,0,0,62,62,0,1,0,1,0
16951,255,0,0,62,62,0,1,0,1,0
16951,255,0,0,62,62,0,1,0,1,0
2686,1017,0,0,146,146,0,1,0,1,0
9614,3105,0,0,86,86,0,1,0,1,0
16951,255,0,0,62,62,0,1,0,1,0
3197,1888,0,0,62,62,0,1,0,1,0
5786,134,0,0,61,61,0,1,0,1,0
15694,333,0,0,145,145,0,1,0,1,0
18660,2975,0,0,62,62,0,1,0,1,0
13534,2636,0,0,62,62,0,1,0,1,0
7971,715,0,0,63,63,0,1,0,1,0
7553,1801,0,0,62,62,0,1,0,1,0
395,2854,0,0,72,72,0,1,0,1,0
21489,1133,0,0,83,83,0,1,0,1,0
7326,1649,0,0,60,60,0,1,0,1,0
1289,1771,0,0,66,66,0,1,0,1,0
1791,1855,0,0,64,64,0,1,0,1,0
9160,1780,0,0,147,147,0,1,0,1,0
654,1888,0,0,66,66,0,1,0,1,0
3201,2938,0,0,60,60,0,1,0,1,0
66,2256,0,0,62,62,0,1,0,1,0
28,3216,0,0,62,62,0,1,0,1,0
12058,1788,0,0,66,66,0,1,0,1,0
19444,2948,0,0,68,68,0,1,0,1,0
13446,1797,0,0,66,66,0,1,0,1,0
21904,2938,0,0,66,66,0,1,0,1,0
15796,23,0,0,83,83,0,1,0,1,0
2939,7,0,0,60,60,0,1,0,1,0
9614,3105,0,0,86,86,0,1,0,1,0
3577,2644,0,0,156,156,0,1,0,1,0
3057,7,0,0,60,60,0,1,0,1,0
1388,1881,0,0,62,62,0,1,0,1,0
3239,2577,0,0,145,145,0,1,0,1,0
9226,3216,0,0,66,66,0,1,0,1,0
9812,3000,0,0,66,66,0,1,0,1,0
8024,2599,0,0,85,85,0,1,0,1,0
2295,1147,0,0,65,65,0,1,0,1,0
15265,1885,0,0,64,64,0,1,0,1,0
19428,242,0,0,145,145,0,1,0,1,0
2302,1472,0,0,62,62,0,1,0,1,0
16951,255,0,0,62,62,0,1,0,1,0
18214,4,0,0,64,64,0,1,0,1,0
5300,2878,0,0,88,88,0,1,0,1,0
5446,1888,0,0,66,66,0,1,0,1,0
11615,1186,0,0,63,63,0,1,0,1,0
12874,2558,0,0,64,64,0,1,0,1,0
8213,1147,0,0,64,64,0,1,0,1,0
208,2935,0,0,120,120,0,1,0,1,0
3807,2610,0,0,60,60,0,1,0,1,0
16917,962,0,0,66,66,0,1,0,1,0
21636,1888,0,0,62,62,0,1,0,1,0
4577,983,0,0,62,62,0,1,0,1,0
22348,1901,0,0,65,65,0,1,0,1,0
1238,3189,0,0,94,94,0,1,0,1,0
16951,255,0,0,62,62,0,1,0,1,0
7335,1070,0,0,60,60,0,1,0,1,0
12190,2587,0,0,66,66,0,1,0,1,0
1565,2944,0,0,60,60,0,1,0,1,0
725,2230,0,0,66,66,0,1,0,1,0
8341,986,0,0,65,65,0,1,0,1,0
15840,3216,0,0,66,66,0,1,0,1,0
372,2926,0,0,62,62,0,1,0,1,0
15544,1774,0,0,62,62,0,1,0,1,0
1374,1147,0,0,62,62,0,1,0,1,0
2617,1147,0,0,66,66,0,1,0,1,0
12127,2940,0,0,73,73,0,1,0,1,0
6857,1135,0,0,62,62,0,1,0,1,0
2756,2620,0,0,62,62,0,1,0,1,0
676,2938,0,0,62,62,0,1,0,1,0
10436,1876,0,0,63,63,0,1,0,1,0
4826,2573,0,0,66,66,0,1,0,1,0
1844,1833,0,0,146,146,0,1,0,1,0
2497,3216,0,0,62,62,0,1,0,1,0
7961,715,0,0,62,62,0,1,0,1,0
579,2632,0,0,65,65,0,1,0,1,0
20811,2953,0,0,63,63,0,1,0,1,0
10474,2938,0,0,72,72,0,1,0,1,0
17007,460,0,0,63,63,0,1,0,1,0
15694,1515,0,0,145,145,0,1,0,1,0
1310,1017,0,0,62,62,0,1,0,1,0
12,2461,0,0,81,81,0,1,0,1,0
18982,3216,0,0,66,66,0,1,0,1,0
2802,1887,0,0,65,65,0,1,0,1,0
11330,2256,0,0,118,118,0,1,0,1,0
9614,3105,0,0,86,86,0,1,0,1,0
3034,2587,0,0,62,62,0,1,0,1,0
1461,983,0,0,66,66,0,1,0,1,0
6732,2574,0,0,78,78,0,1,0,1,0
12535,3167,0,0,62,62,0,1,0,1,0
1121,7,0,0,60,60,0,1,0,1,0
20466,2614,0,0,65,65,0,1,0,1,0
10336,1444,0,0,95,95,0,1,0,1,0
16951,255,0,0,62,62,0,1,0,1,0
13364,1882,0,0,64,64,0,1,0,1,0
577,2611,0,0,74,74,0,1,0,1,0
2853,2611,0,0,66,66,0,1,0,1,0
16951,255,0,0,62,62,0,1,0,1,0
17368,2944,0,0,63,63,0,1,0,1,0
3194,1200,0,0,145,145,0,1,0,1,0
16337,2631,0,0,62,62,0,1,0,1,0
636,280,0,0,146,146,0,1,0,1,0
0,0,0,0,98,98,0,1,0,1,0
6686,1888,0,0,64,64,0,1,0,1,0
14212,2906,0,0,66,66,0,1,0,1,0
21994,1147,0,0,66,66,0,1,0,1,0
17727,2883,0,0,66,66,0,1,0,1,0
16263,2945,0,0,63,63,0,1,0,1,0
11563,1951,0,0,102,102,0,1,0,1,0
20594,3216,0,0,66,66,0,1,0,1,0
6451,2938,0,0,62,62,0,1,0,1,0
13824,509,0,0,66,66,0,1,0,1,0
16951,255,0,0,62,62,0,1,0,1,0
7326,180,0,0,60,60,0,1,0,1,0
16951,255,0,0,62,62,0,1,0,1,0
364,280,0,0,66,66,0,1,0,1,0
1790,292,0,0,146,146,0,1,0,1,0
20257,2938,0,0,62,62,0,1,0,1,0
10563,804,0,0,80,80,0,1,0,1,0
8228,2587,0,0,66,66,0,1,0,1,0
12,971,0,0,94,94,0,1,0,1,0
22690,1215,0,0,62,62,0,1,0,1,0
7653,1224,0,0,60,60,0,1,0,1,0
18070,2256,0,0,62,62,0,1,0,1,0
19686,2586,0,0,67,67,0,1,0,1,0
33,686,0,0,61,61,0,1,0,1,0
270,1516,0,0,64,64,0,1,0,1,0
4363,1147,0,0,62,62,0,1,0,1,0
2485,2594,0,0,146,146,0,1,0,1,0
6211,2971,0,0,73,73,0,1,0,1,0
16951,255,0,0,62,62,0,1,0,1,0
6651,1129,0,0,156,156,0,1,0,1,0
14857,1804,0,0,66,66,0,1,0,1,0
18249,1771,0,0,66,66,0,1,0,1,0
13,429,0,0,61,61,0,1,0,1,0
2579,2256,0,0,146,146,0,1,0,1,0
373,1147,0,0,62,62,0,1,0,1,0
693,672,0,0,154,154,0,1,0,1,0
22208,2611,0,0,65,65,0,1,0,1,0
16676,2595,0,0,63,63,0,1,0,1,0
2913,1017,0,0,62,62,0,1,0,1,0
1281,2543,0,0,60,60,0,1,0,1,0
7226,1147,0,0,64,64,0,1,0,1,0
21072,1771,0,0,66,66,0,1,0,1,0
6651,1129,0,0,156,156,0,1,0,1,0
18033,2256,0,0,66,66,0,1,0,1,0
11725,1048,0,0,63,63,0,1,0,1,0
9691,1017,0,0,62,62,0,1,0,1,0
14866,2696,0,0,62,62,0,1,0,1,0
421,1771,0,0,62,62,0,1,0,1,0
2369,1147,0,0,62,62,0,1,0,1,0
12,452,0,0,62,62,0,1,0,1,0
5703,1096,0,0,73,73,0,1,0,1,0
3244,2429,0,0,62,62,0,1,0,1,0
8,1873,0,0,60,60,0,1,0,1,0
2721,1888,0,0,66,66,0,1,0,1,0
17778,1788,0,0,64,64,0,1,0,1,0
2387,2256,0,0,62,62,0,1,0,1,0
1865,1017,0,0,66,66,0,1,0,1,0
8796,1017,0,0,64,64,0,1,0,1,0
14,1020,0,0,126,126,0,1,0,1,0
1830,2939,0,0,138,138,0,1,0,1,0
14640,1147,0,0,146,146,0,1,0,1,0
15519,1023,0,0,146,146,0,1,0,1,0
3691,983,0,0,62,62,0,1,0,1,0
3128,1785,0,0,62,62,0,1,0,1,0
10475,6,0,0,60,60,0,1,0,1,0
12,3227,0,0,131,131,0,1,0,1,0
3208,1756,0,0,62,62,0,1,0,1,0
8164,2726,0,0,60,60,0,1,0,1,0
17300,2611,0,0,66,66,0,1,0,1,0
329,291,0,0,64,64,0,1,0,1,0
13549,104,0,0,60,60,0,1,0,1,0
7990,1079,0,0,64,64,0,1,0,1,0
21653,1147,0,0,66,66,0,1,0,1,0
703,1007,0,0,76,76,0,1,0,1,0
12808,2846,0,0,62,62,0,1,0,1,0
13003,1147,0,0,62,62,0,1,0,1,0
16368,2256,0,0,65,65,0,1,0,1,0
16369,2333,0,0,87,87,0,1,0,1,0
16951,255,0,0,62,62,0,1,0,1,0
11640,1795,0,0,62,62,0,1,0,1,0
2986,1771,0,0,66,66,0,1,0,1,0
20159,2934,0,0,155,155,0,1,0,1,0
580,441,0,0,87,87,0,1,0,1,0
2186,6,0,0,60,60,0,1,0,1,0
2260,2636,0,0,64,64,0,1,0,1,0
3065,7,0,0,60,60,0,1,0,1,0
612,225,0,0,60,60,0,1,0,1,0
14587,2252,0,0,62,62,0,1,0,1,0
17016,2938,0,0,64,64,0,1,0,1,0
18008,805,0,0,84,84,0,1,0,1,0
7653,1224,0,0,60,60,0,1,0,1,0
17509,983,0,0,62,62,0,1,0,1,0
1352,2866,0,0,87,87,0,1,0,1,0
7063,1908,0,0,74,74,0,1,0,1,0
22615,2882,0,0,93,93,0,1,0,1,0
464,1888,0,0,66,66,0,1,0,1,0
19130,2787,0,0,62,62,0,1,0,1,0
11686,353,0,0,64,64,0,1,0,1,0
9311,2938,0,0,143,143,0,1,0,1,0
7321,1531,0,0,67,67,0,1,0,1,0
2532,1017,0,0,65,65,0,1,0,1,0
6355,2256,0,0,107,107,0,1,0,1,0
13074,181,0,0,60,60,0,1,0,1,0
19135,2862,0,0,62,62,0,1,0,1,0
1855,3216,0,0,64,64,0,1,0,1,0
21804,2583,0,0,63,63,0,1,0,1,0
4416,2883,0,0,62,62,0,1,0,1,0
2185,1147,0,0,90,90,0,1,0,1,0
16951,255,0,0,62,62,0,1,0,1,0
13467,2587,0,0,62,62,0,1,0,1,0
16302,2945,0,0,66,66,0,1,0,1,0
11832,2615,0,0,75,75,0,1,0,1,0
62,2256,0,0,63,63,0,1,0,1,0
21376,1147,0,0,62,62,0,1,0,1,0
6314,17,0,0,60,60,0,1,0,1,0
10069,3216,0,0,62,62,0,1,0,1,0
1282,1147,0,0,62,62,0,1,0,1,0
1124,1214,0,0,62,62,0,1,0,1,0
14968,2636,0,0,63,63,0,1,0,1,0
20352,2256,0,0,73,73,0,1,0,1,0
12819,2901,0,0,64,64,0,1,0,1,0
16116,2611,0,0,63,63,0,1,0,1,0
3615,3168,0,0,96,96,0,1,0,1,0
14306,1589,0,0,66,66,0,1,0,1,0
5573,7,0,0,60,60,0,1,0,1,0
2448,1884,0,0,62,62,0,1,0,1,0
4597,1147,0,0,62,62,0,1,0,1,0
20491,2631,0,0,66,66,0,1,0,1,0
3088,1804,0,0,62,62,0,1,0,1,0
7064,2587,0,0,62,62,0,1,0,1,0
2322,697,0,0,74,74,0,1,0,1,0
10957,1888,0,0,63,63,0,1,0,1,0
13791,509,0,0,66,66,0,1,0,1,0
822,137,0,0,60,60,0,1,0,1,0
2024,3216,0,0,64,64,0,1,0,1,0
7339,237,0,0,60,60,0,1,0,1,0
10784,847,0,0,62,62,0,1,0,1,0
66,2256,0,0,66,66,0,1,0,1,0
844,291,0,0,76,76,0,1,0,1,0
2906,1888,0,0,62,62,0,1,0,1,0
16196,3216,0,0,66,66,0,1,0,1,0
22681,228,0,0,61,61,0,1,0,1,0
10769,1147,0,0,62,62,0,1,0,1,0
1536,2256,0,0,66,66,0,1,0,1,0
16861,983,0,0,66,66,0,1,0,1,0
3543,2938,0,0,66,66,0,1,0,1,0
12195,3212,0,0,66,66,0,1,0,1,0
2717,2256,0,0,62,62,0,1,0,1,0
9273,6,0,0,60,60,0,1,0,1,0
100,2609,0,0,62,62,0,1,0,1,0
21797,2931,0,0,65,65,0,1,0,1,0
0,0,0,0,98,98,0,1,0,1,0
9294,3216,0,0,62,62,0,1,0,1,0
2658,1147,0,0,66,66,0,1,0,1,0
2694,1017,0,0,62,62,0,1,0,1,0
0,0,0,0,98,98,0,1,0,1,0
9124,2938,0,0,66,66,0,1,0,1,0
16951,255,0,0,62,62,0,1,0,1,0
22305,1472,0,0,66,66,0,1,0,1,0
0,0,0,0,98,98,0,1,0,1,0
4338,1473,0,0,87,87,0,1,0,1,0
506,55,0,0,63,63,0,1,0,1,0
1917,7,0,0,60,60,0,1,0,1,0
1693,2587,0,0,62,62,0,1,0,1,0
7921,125,0,0,140,140,0,1,0,1,0
14033,1215,0,0,62,62,0,1,0,1,0
12259,1199,0,0,84,84,0,1,0,1,0
20416,983,0,0,66,66,0,1,0,1,0
6896,1881,0,0,62,62,0,1,0,1,0
2504,2587,0,0,146,146,0,1,0,1,0
16951,255,0,0,62,62,0,1,0,1,0
6552,2093,0,0,145,145,0,1,0,1,0
2295,1147,0,0,65,65,0,1,0,1,0
0,0,0,0,98,98,0,1,0,1,0
21135,1811,0,0,62,62,0,1,0,1,0
19168,2841,0,0,64,64,0,1,0,1,0
16951,255,0,0,62,62,0,1,0,1,0
20119,1054,0,0,63,63,0,1,0,1,0
7468,1771,0,0,66,66,0,1,0,1,0
5189,1017,0,0,66,66,0,1,0,1,0
21769,1888,0,0,66,66,0,1,0,1,0
8590,1920,0,0,73,73,0,1,0,1,0
8171,1073,0,0,60,60,0,1,0,1,0
1258,1147,0,0,146,146,0,1,0,1,0
15618,1794,0,0,62,62,0,1,0,1,0
16951,255,0,0,62,62,0,1,0,1,0
14198,1497,0,0,66,66,0,1,0,1,0
5073,2611,0,0,65,65,0,1,0,1,0
4970,2619,0,0,66,66,0,1,0,1,0
10754,2883,0,0,62,62,0,1,0,1,0
16951,255,0,0,62,62,0,1,0,1,0
3011,1472,0,0,66,66,0,1,0,1,0
10972,2938,0,0,66,66,0,1,0,1,0
1506,2669,0,0,142,142,0,1,0,1,0
22081,2608,0,0,63,63,0,1,0,1,0
4526,26,0,0,60,60,0,1,0,1,0
16951,255,0,0,62,62,0,1,0,1,0
12620,1888,0,0,66,66,0,1,0,1,0
11158,1880,0,0,64,64,0,1,0,1,0
6302,2938,0,0,61,61,0,1,0,1,0
11943,3216,0,0,62,62,0,1,0,1,0
16951,255,0,0,62,62,0,1,0,1,0
1848,2949,0,0,65,65,0,1,0,1,0
2626,401,0,0,145,145,0,1,0,1,0
7534,3216,0,0,145,145,0,1,0,1,0
7509,218,0,0,60,60,0,1,0,1,0
6451,1215,0,0,62,62,0,1,0,1,0
1855,1820,0,0,146,146,0,1,0,1,0
2221,2575,0,0,66,66,0,1,0,1,0
16649,1898,0,0,66,66,0,1,0,1,0
9251,3216,0,0,66,66,0,1,0,1,0
5361,3199,0,0,62,62,0,1,0,1,0
2531,1134,0,0,143,143,0,1,0,1,0
6649,697,0,0,74,74,0,1,0,1,0
22575,2931,0,0,66,66,0,1,0,1,0
7335,1070,0,0,60,60,0,1,0,1,0
14962,2636,0,0,62,62,0,1,0,1,0
10165,1147,0,0,62,62,0,1,0,1,0
13792,1472,0,0,66,66,0,1,0,1,0
8317,2239,0,0,126,126,0,1,0,1,0
2072,406,0,0,61,61,0,1,0,1,0
124,390,0,0,145,145,0,1,0,1,0
20804,2950,0,0,62,62,0,1,0,1,0
3005,1147,0,0,62,62,0,1,0,1,0
2012,1472,0,0,62,62,0,1,0,1,0
7943,2587,0,0,62,62,0,1,0,1,0
1292,2406,0,0,97,97,0,1,0,1,0
16951,255,0,0,62,62,0,1,0,1,0
20224,1771,0,0,63,63,0,1,0,1,0
22683,10,0,0,88,88,0,1,0,1,0
5285,6,0,0,60,60,0,1,0,1,0
7888,1147,0,0,62,62,0,1,0,1,0
13157,1257,0,0,62,62,0,1,0,1,0
288,1766,0,0,64,64,0,1,0,1,0
8985,1169,0,0,62,62,0,1,0,1,0
2281,1086,0,0,65,65,0,1,0,1,0
22302,1880,0,0,62,62,0,1,0,1,0
15286,1147,0,0,62,62,0,1,0,1,0
8313,864,0,0,154,154,0,1,0,1,0
2150,3216,0,0,66,66,0,1,0,1,0
16951,255,0,0,62,62,0,1,0,1,0
13011,2940,0,0,66,66,0,1,0,1,0
2094,3216,0,0,62,62,0,1,0,1,0
13074,181,0,0,60,60,0,1,0,1,0
6555,2587,0,0,66,66,0,1,0,1,0
2888,6,0,0,60,60,0,1,0,1,0
16951,255,0,0,62,62,0,1,0,1,0
2724,3067,0,0,379,379,0,1,0,1,0
162,1147,0,0,64,64,0,1,0,1,0
3094,3216,0,0,62,62,0,1,0,1,0
16951,255,0,0,62,62,0,1,0,1,0
20554,3216,0,0,64,64,0,1,0,1,0
20772,1804,0,0,66,66,0,1,0,1,0
16951,255,0,0,62,62,0,1,0,1,0
8,166,0,0,620,620,0,1,0,1,0
2551,1017,0,0,146,146,0,1,0,1,0
4091,1016,0,0,65,65,0,1,0,1,0
438,2636,0,0,62,62,0,1,0,1,0
11368,1077,0,0,65,65,0,1,0,1,0
556,2256,0,0,66,66,0,1,0,1,0
1913,1791,0,0,63,63,0,1,0,1,0
7835,2615,0,0,63,63,0,1,0,1,0
8801,1472,0,0,66,66,0,1,0,1,0
19567,155,0,0,66,66,0,1,0,1,0
1289,1039,0,0,64,64,0,1,0,1,0
15694,1787,0,0,145,145,0,1,0,1,0
2531,13,0,0,60,60,0,1,0,1,0
20721,1173,0,0,108,108,0,1,0,1,0
16951,255,0,0,62,62,0,1,0,1,0
16951,255,0,0,62,62,0,1,0,1,0
20197,2204,0,0,66,66,0,1,0,1,0
1407,2915,0,0,63,63,0,1,0,1,0
152,3216,0,0,66,66,0,1,0,1,0
11119,1215,0,0,64,64,0,1,0,1,0
15391,509,0,0,64,64,0,1,0,1,0
2303,437,0,0,62,62,0,1,0,1,0
6207,1804,0,0,121,121,0,1,0,1,0
5216,1147,0,0,146,146,0,1,0,1,0
20785,1173,0,0,66,66,0,1,0,1,0
16008,2938,0,0,62,62,0,1,0,1,0
14948,2256,0,0,66,66,0,1,0,1,0
10506,185,0,0,100,100,0,1,0,1,0
19909,1880,0,0,65,65,0,1,0,1,0
1316,2458,0,0,141,141,0,1,0,1,0
1997,2587,0,0,146,146,0,1,0,1,0
527,7,0,0,60,60,0,1,0,1,0
1905,2587,0,0,146,146,0,1,0,1,0
6185,3019,0,0,69,69,0,1,0,1,0
16275,2938,0,0,66,66,0,1,0,1,0
14464,2854,0,0,66,66,0,1,0,1,0
2660,1888,0,0,62,62,0,1,0,1,0
2724,1888,0,0,63,63,0,1,0,1,0
18879,2587,0,0,66,66,0,1,0,1,0
5992,107,0,0,73,73,0,1,0,1,0
18363,1477,0,0,66,66,0,1,0,1,0
5454,1888,0,0,66,66,0,1,0,1,0
6233,1646,0,0,60,60,0,1,0,1,0
1876,1017,0,0,62,62,0,1,0,1,0
2575,134,0,0,114,114,0,1,0,1,0
1197,3216,0,0,62,62,0,1,0,1,0
8748,1779,0,0,64,64,0,1,0,1,0
1330,697,0,0,62,62,0,1,0,1,0
16951,255,0,0,62,62,0,1,0,1,0
19966,277,0,0,126,126,0,1,0,1,0
1744,2273,0,0,146,146,0,1,0,1,0
3107,612,0,0,129,129,0,1,0,1,0
10150,1017,0,0,65,65,0,1,0,1,0
3409,2587,0,0,62,62,0,1,0,1,0
3095,1147,0,0,63,63,0,1,0,1,0
14271,1518,0,0,66,66,0,1,0,1,0
354,285,0,0,62,62,0,1,0,1,0
411,2587,0,0,62,62,0,1,0,1,0
627,3216,0,0,145,145,0,1,0,1,0
16951,255,0,0,62,62,0,1,0,1,0
12953,263,0,0,70,70,0,1,0,1,0
21837,2587,0,0,64,64,0,1,0,1,0
18902,2116,0,0,66,66,0,1,0,1,0
3091,2360,0,0,60,60,0,1,0,1,0
5717,1205,0,0,62,62,0,1,0,1,0
11433,1132,0,0,66,66,0,1,0,1,0
2543,1795,0,0,62,62,0,1,0,1,0
91,7,0,0,60,60,0,1,0,1,0
10531,1147,0,0,65,65,0,1,0,1,0
121,1017,0,0,62,62,0,1,0,1,0
16951,255,0,0,62,62,0,1,0,1,0
3464,243,0,0,133,133,0,1,0,1,0
8114,2550,0,0,62,62,0,1,0,1,0
2429,2887,0,0,65,65,0,1,0,1,0
2321,2605,0,0,62,62,0,1,0,1,0
16533,2614,0,0,66,66,0,1,0,1,0
2968,1888,0,0,62,62,0,1,0,1,0
16951,255,0,0,62,62,0,1,0,1,0
4345,1147,0,0,146,146,0,1,0,1,0
18376,2906,0,0,69,69,0,1,0,1,0
5669,346,0,0,60,60,0,1,0,1,0
21044,2587,0,0,65,65,0,1,0,1,0
1264,2256,0,0,66,66,0,1,0,1,0
7542,1804,0,0,63,63,0,1,0,1,0
11899,2631,0,0,66,66,0,1,0,1,0
360,3105,0,0,893,893,0,1,0,1,0
7339,140,0,0,60,60,0,1,0,1,0
16769,1028,0,0,66,66,0,1,0,1,0
11268,1215,0,0,62,62,0,1,0,1,0
18112,111,0,0,136,136,0,1,0,1,0
12,2247,0,0,83,83,0,1,0,1,0
402,2868,0,0,63,63,0,1,0,1,0
16951,255,0,0,62,62,0,1,0,1,0
17827,2256,0,0,66,66,0,1,0,1,0
279,3163,0,0,64,64,0,1,0,1,0
229,1771,0,0,62,62,0,1,0,1,0
360,3105,0,0,68,68,0,1,0,1,0
11341,2265,0,0,62,62,0,1,0,1,0
3919,6,0,0,60,60,0,1,0,1,0
1235,1590,0,0,62,62,0,1,0,1,0
19757,1771,0,0,66,66,0,1,0,1,0
1804,768,0,0,60,60,0,1,0,1,0
8093,1212,0,0,134,134,0,1,0,1,0
16951,255,0,0,62,62,0,1,0,1,0
2615,1017,0,0,62,62,0,1,0,1,0
370,3216,0,0,62,62,0,1,0,1,0
10866,1877,0,0,66,66,0,1,0,1,0
6072,2487,0,0,144,144,0,1,0,1,0
6812,1017,0,0,62,62,0,1,0,1,0
20840,2636,0,0,66,66,0,1,0,1,0
21481,2604,0,0,66,66,0,1,0,1,0
805,2256,0,0,63,63,0,1,0,1,0
14836,2645,0,0,62,62,0,1,0,1,0
750,1607,0,0,61,61,0,1,0,1,0
22683,10,0,0,88,88,0,1,0,1,0
16951,255,0,0,62,62,0,1,0,1,0
1581,2883,0,0,62,62,0,1,0,1,0
10964,1806,0,0,65,65,0,1,0,1,0
360,3105,0,0,1274,1274,0,1,0,1,0
19892,2938,0,0,74,74,0,1,0,1,0
2761,2938,0,0,62,62,0,1,0,1,0
20277,2611,0,0,63,63,0,1,0,1,0
1569,2587,0,0,66,66,0,1,0,1,0
5825,983,0,0,62,62,0,1,0,1,0
15052,1888,0,0,65,65,0,1,0,1,0
6229,2938,0,0,78,78,0,1,0,1,0
5693,1008,0,0,62,62,0,1,0,1,0
7335,1070,0,0,60,60,0,1,0,1,0
7604,1804,0,0,62,62,0,1,0,1,0
7335,1072,0,0,60,60,0,1,0,1,0
2576,1147,0,0,66,66,0,1,0,1,0
1136,2931,0,0,82,82,0,1,0,1,0
21766,1888,0,0,66,66,0,1,0,1,0
10603,2389,0,0,66,66,0,1,0,1,0
3115,2557,0,0,145,145,0,1,0,1,0
317,2256,0,0,63,63,0,1,0,1,0
1365,3216,0,0,62,62,0,1,0,1,0
12228,3214,0,0,63,63,0,1,0,1,0
1931,3212,0,0,66,66,0,1,0,1,0
2120,1793,0,0,62,62,0,1,0,1,0
636,982,0,0,146,146,0,1,0,1,0
1558,1072,0,0,164,164,0,1,0,1,0
16951,255,0,0,62,62,0,1,0,1,0
2507,1147,0,0,62,62,0,1,0,1,0
32,2947,0,0,145,145,0,1,0,1,0
6383,1017,0,0,62,62,0,1,0,1,0
11486,2486,0,0,116,116,0,1,0,1,0
3452,465,0,0,154,154,0,1,0,1,0
2723,1888,0,0,62,62,0,1,0,1,0
3065,3117,0,0,62,62,0,1,0,1,0
18773,2608,0,0,66,66,0,1,0,1,0
18218,2866,0,0,66,66,0,1,0,1,0
7630,1147,0,0,62,62,0,1,0,1,0
19603,3216,0,0,66,66,0,1,0,1,0
7517,2938,0,0,62,62,0,1,0,1,0
12697,2246,0,0,64,64,0,1,0,1,0
20973,2382,0,0,64,64,0,1,0,1,0
5648,2852,0,0,63,63,0,1,0,1,0
2401,7,0,0,60,60,0,1,0,1,0
7517,2938,0,0,62,62,0,1,0,1,0
7560,183,0,0,60,60,0,1,0,1,0
9298,3216,0,0,62,62,0,1,0,1,0
3466,242,0,0,144,144,0,1,0,1,0
1743,1017,0,0,64,64,0,1,0,1,0
2132,1888,0,0,62,62,0,1,0,1,0
360,3105,0,0,164,164,0,1,0,1,0
1804,192,0,0,60,60,0,1,0,1,0
10895,3117,0,0,66,66,0,1,0,1,0
15501,1017,0,0,116,116,0,1,0,1,0
1846,474,0,0,62,62,0,1,0,1,0
423,2587,0,0,62,62,0,1,0,1,0
1491,482,0,0,153,153,0,1,0,1,0
18576,1771,0,0,65,65,0,1,0,1,0
16951,255,0,0,62,62,0,1,0,1,0
21590,2938,0,0,69,69,0,1,0,1,0
13578,3051,0,0,65,65,0,1,0,1,0
10709,827,0,0,64,64,0,1,0,1,0
18212,7,0,0,65,65,0,1,0,1,0
20335,1888,0,0,65,65,0,1,0,1,0
3221,1017,0,0,66,66,0,1,0,1,0
1123,1215,0,0,63,63,0,1,0,1,0
18361,1474,0,0,66,66,0,1,0,1,0
16951,255,0,0,62,62,0,1,0,1,0
15718,1215,0,0,63,63,0,1,0,1,0
5765,2938,0,0,62,62,0,1,0,1,0
19662,1796,0,0,65,65,0,1,0,1,0
2262,2636,0,0,62,62,0,1,0,1,0
9611,3111,0,0,81,81,0,1,0,1,0
2452,1215,0,0,63,63,0,1,0,1,0
3190,2869,0,0,62,62,0,1,0,1,0
1263,7,0,0,60,60,0,1,0,1,0
10561,804,0,0,90,90,0,1,0,1,0
1330,2943,0,0,62,62,0,1,0,1,0
9093,1215,0,0,63,63,0,1,0,1,0
18837,2591,0,0,63,63,0,1,0,1,0
16951,255,0,0,62,62,0,1,0,1,0
588,2611,0,0,78,78,0,1,0,1,0
12298,3171,0,0,64,64,0,1,0,1,0
7335,1070,0,0,60,60,0,1,0,1,0
20657,607,0,0,66,66,0,1,0,1,0
5525,1212,0,0,62,62,0,1,0,1,0
21109,1771,0,0,64,64,0,1,0,1,0
8171,1073,0,0,60,60,0,1,0,1,0
10511,2742,0,0,69,69,0,1,0,1,0
19003,2097,0,0,66,66,0,1,0,1,0
9263,1536,0,0,62,62,0,1,0,1,0
6903,2587,0,0,62,62,0,1,0,1,0
816,960,0,0,62,62,0,1,0,1,0
1897,3141,0,0,95,95,0,1,0,1,0
10125,1470,0,0,62,62,0,1,0,1,0
8819,1017,0,0,63,63,0,1,0,1,0
14155,2360,0,0,66,66,0,1,0,1,0
496,2220,0,0,65,65,0,1,0,1,0
21566,2599,0,0,66,66,0,1,0,1,0
17031,1799,0,0,66,66,0,1,0,1,0
12,2784,0,0,82,82,0,1,0,1,0
20762,1147,0,0,66,66,0,1,0,1,0
2060,1888,0,0,62,62,0,1,0,1,0
2323,1147,0,0,146,146,0,1,0,1,0
5266,2636,0,0,121,121,0,1,0,1,0
14505,2312,0,0,78,78,0,1,0,1,0
2298,146,0,0,60,60,0,1,0,1,0
7309,1147,0,0,62,62,0,1,0,1,0
13411,1472,0,0,66,66,0,1,0,1,0
2333,2486,0,0,62,62,0,1,0,1,0
1131,2938,0,0,62,62,0,1,0,1,0
3397,2587,0,0,62,62,0,1,0,1,0
16951,255,0,0,62,62,0,1,0,1,0
720,2938,0,0,65,65,0,1,0,1,0
21582,1158,0,0,66,66,0,1,0,1,0
2801,1017,0,0,64,64,0,1,0,1,0
8221,2587,0,0,62,62,0,1,0,1,0
804,2587,0,0,66,66,0,1,0,1,0
2410,1215,0,0,62,62,0,1,0,1,0
8171,1073,0,0,60,60,0,1,0,1,0
844,2938,0,0,146,146,0,1,0,1,0
10163,1017,0,0,66,66,0,1,0,1,0
20830,1886,0,0,62,62,0,1,0,1,0
22482,2256,0,0,107,107,0,1,0,1,0
21490,2621,0,0,63,63,0,1,0,1,0
16951,255,0,0,62,62,0,1,0,1,0
1525,1444,0,0,145,145,0,1,0,1,0
10052,3057,0,0,66,66,0,1,0,1,0
4022,697,0,0,67,67,0,1,0,1,0
4475,1119,0,0,62,62,0,1,0,1,0
1553,2244,0,0,62,62,0,1,0,1,0
13544,2636,0,0,64,64,0,1,0,1,0
1234,509,0,0,65,65,0,1,0,1,0
14984,2604,0,0,66,66,0,1,0,1,0
1402,2938,0,0,62,62,0,1,0,1,0
27,1215,0,0,62,62,0,1,0,1,0
7351,2636,0,0,62,62,0,1,0,1,0
4208,2616,0,0,61,61,0,1,0,1,0
16951,255,0,0,62,62,0,1,0,1,0
1413,2883,0,0,65,65,0,1,0,1,0
16884,983,0,0,62,62,0,1,0,1,0
18740,1801,0,0,62,62,0,1,0,1,0
2213,2901,0,0,68,68,0,1,0,1,0
2155,1888,0,0,62,62,0,1,0,1,0
13280,1768,0,0,66,66,0,1,0,1,0
7332,2256,0,0,94,94,0,1,0,1,0
2762,410,0,0,63,63,0,1,0,1,0
20012,2586,0,0,65,65,0,1,0,1,0
21748,384,0,0,74,74,0,1,0,1,0
19714,1017,0,0,66,66,0,1,0,1,0
569,1215,0,0,62,62,0,1,0,1,0
3060,1888,0,0,62,62,0,1,0,1,0
16735,1079,0,0,66,66,0,1,0,1,0
10244,3112,0,0,62,62,0,1,0,1,0
22089,1861,0,0,65,65,0,1,0,1,0
7038,1215,0,0,62,62,0,1,0,1,0
669,1147,0,0,64,64,0,1,0,1,0
7000,2370,0,0,74,74,0,1,0,1,0
20928,2256,0,0,66,66,0,1,0,1,0
2609,1888,0,0,66,66,0,1,0,1,0
10264,404,0,0,64,64,0,1,0,1,0
10388,3216,0,0,66,66,0,1,0,1,0
14577,2883,0,0,66,66,0,1,0,1,0
7,12,0,0,346,346,0,1,0,1,0
676,2627,0,0,62,62,0,1,0,1,0
16014,2636,0,0,66,66,0,1,0,1,0
0,0,0,0,98,98,0,1,0,1,0
2443,2587,0,0,62,62,0,1,0,1,0
6073,1871,0,0,62,62,0,1,0,1,0
1288,2504,0,0,113,113,0,1,0,1,0
10799,2636,0,0,66,66,0,1,0,1,0
2510,2486,0,0,62,62,0,1,0,1,0
17546,2256,0,0,66,66,0,1,0,1,0
6229,2603,0,0,67,67,0,1,0,1,0
1154,1590,0,0,64,64,0,1,0,1,0
7533,2587,0,0,62,62,0,1,0,1,0
614,2252,0,0,65,65,0,1,0,1,0
19806,1017,0,0,66,66,0,1,0,1,0
9847,2924,0,0,66,66,0,1,0,1,0
19590,509,0,0,65,65,0,1,0,1,0
1804,1762,0,0,60,60,0,1,0,1,0
16951,255,0,0,62,62,0,1,0,1,0
13190,1017,0,0,62,62,0,1,0,1,0
3036,2587,0,0,62,62,0,1,0,1,0
10756,3216,0,0,66,66,0,1,0,1,0
14194,3216,0,0,64,64,0,1,0,1,0
2528,2636,0,0,62,62,0,1,0,1,0
19976,3136,0,0,62,62,0,1,0,1,0
1664,1147,0,0,146,146,0,1,0,1,0
2036,1147,0,0,62,62,0,1,0,1,0
2665,2938,0,0,64,64,0,1,0,1,0
7026,1215,0,0,62,62,0,1,0,1,0
2315,2486,0,0,140,140,0,1,0,1,0
427,2587,0,0,62,62,0,1,0,1,0
8023,131,0,0,82,82,0,1,0,1,0
7335,1072,0,0,60,60,0,1,0,1,0
2295,2486,0,0,145,145,0,1,0,1,0
1141,1215,0,0,62,62,0,1,0,1,0
12166,1870,0,0,62,62,0,1,0,1,0
10962,1888,0,0,64,64,0,1,0,1,0
21919,1210,0,0,62,62,0,1,0,1,0
10165,1147,0,0,62,62,0,1,0,1,0
731,2256,0,0,66,66,0,1,0,1,0
15469,1451,0,0,83,83,0,1,0,1,0
8189,1881,0,0,62,62,0,1,0,1,0
545,2256,0,0,64,64,0,1,0,1,0
18678,262,0,0,101,101,0,1,0,1,0
863,1885,0,0,62,62,0,1,0,1,0
10307,704,0,0,71,71,0,1,0,1,0
10992,1008,0,0,65,65,0,1,0,1,0
326,1888,0,0,62,62,0,1,0,1,0
9214,3256,0,0,60,60,0,1,0,1,0
75,2256,0,0,64,64,0,1,0,1,0
360,3105,0,0,447,447,0,1,0,1,0
11677,2636,0,0,66,66,0,1,0,1,0
2006,1775,0,0,146,146,0,1,0,1,0
11585,1147,0,0,66,66,0,1,0,1,0
16,206,0,0,67,67,0,1,0,1,0
96,1017,0,0,62,62,0,1,0,1,0
11621,2747,0,0,62,62,0,1,0,1,0
2084,1471,0,0,145,145,0,1,0,1,0
14505,2312,0,0,78,78,0,1,0,1,0
5564,1186,0,0,62,62,0,1,0,1,0
10630,2636,0,0,65,65,0,1,0,1,0
19686,2587,0,0,66,66,0,1,0,1,0
2807,1472,0,0,68,68,0,1,0,1,0
7273,1,0,0,62,62,0,1,0,1,0
2675,1147,0,0,62,62,0,1,0,1,0
1193,1590,0,0,62,62,0,1,0,1,0
16951,255,0,0,62,62,0,1,0,1,0
16029,308,0,0,62,62,0,1,0,1,0
20316,2925,0,0,71,71,0,1,0,1,0
11268,1215,0,0,62,62,0,1,0,1,0
19684,2486,0,0,132,132,0,1,0,1,0
9614,3105,0,0,86,86,0,1,0,1,0
5,3,0,0,60,60,0,1,0,1,0
6649,697,0,0,74,74,0,1,0,1,0
10081,2353,0,0,62,62,0,1,0,1,0
1918,1472,0,0,62,62,0,1,0,1,0
1106,1147,0,0,62,62,0,1,0,1,0
13337,1215,0,0,62,62,0,1,0,1,0
1330,918,0,0,62,62,0,1,0,1,0
6889,3204,0,0,66,66,0,1,0,1,0
12,443,0,0,318,318,0,1,0,1,0
8176,506,0,0,146,146,0,1,0,1,0
6438,1215,0,0,62,62,0,1,0,1,0
61,1888,0,0,62,62,0,1,0,1,0
16827,509,0,0,66,66,0,1,0,1,0
1309,1457,0,0,130,130,0,1,0,1,0
10224,3192,0,0,66,66,0,1,0,1,0
10960,1017,0,0,64,64,0,1,0,1,0
12810,2573,0,0,66,66,0,1,0,1,0
7811,295,0,0,61,61,0,1,0,1,0
11347,2256,0,0,63,63,0,1,0,1,0
9553,1883,0,0,66,66,0,1,0,1,0
360,3105,0,0,927,927,0,1,0,1,0
16770,2915,0,0,66,66,0,1,0,1,0
2671,1147,0,0,146,146,0,1,0,1,0
489,191,0,0,1053,1053,0,1,0,1,0
1738,3216,0,0,97,97,0,1,0,1,0
6350,2249,0,0,62,62,0,1,0,1,0
12958,956,0,0,65,65,0,1,0,1,0
57,403,0,0,149,149,0,1,0,1,0
21632,1888,0,0,66,66,0,1,0,1,0
2975,7,0,0,60,60,0,1,0,1,0
16444,2881,0,0,90,90,0,1,0,1,0
14228,6,0,0,60,60,0,1,0,1,0
6552,2093,0,0,145,145,0,1,0,1,0
21128,1147,0,0,80,80,0,1,0,1,0
12445,1792,0,0,61,61,0,1,0,1,0
2543,1795,0,0,62,62,0,1,0,1,0
21446,2256,0,0,62,62,0,1,0,1,0
13597,84,0,0,60,60,0,1,0,1,0
16017,2938,0,0,65,65,0,1,0,1,0
3093,1147,0,0,62,62,0,1,0,1,0
2892,1804,0,0,63,63,0,1,0,1,0
4573,2256,0,0,63,63,0,1,0,1,0
2184,7,0,0,60,60,0,1,0,1,0
2543,1795,0,0,62,62,0,1,0,1,0
15780,2632,0,0,65,65,0,1,0,1,0
18222,2587,0,0,62,62,0,1,0,1,0
4058,697,0,0,63,63,0,1,0,1,0
218,2174,0,0,62,62,0,1,0,1,0
160,1888,0,0,62,62,0,1,0,1,0
6269,2477,0,0,60,60,0,1,0,1,0
4001,1147,0,0,121,121,0,1,0,1,0
10602,2380,0,0,65,65,0,1,0,1,0
16951,255,0,0,62,62,0,1,0,1,0
1634,2620,0,0,62,62,0,1,0,1,0
11501,2256,0,0,63,63,0,1,0,1,0
12812,2856,0,0,66,66,0,1,0,1,0
636,1792,0,0,62,62,0,1,0,1,0
3058,3262,0,0,60,60,0,1,0,1,0
6,12,0,0,346,346,0,1,0,1,0
4016,2215,0,0,62,62,0,1,0,1,0
6052,2883,0,0,64,64,0,1,0,1,0
17321,509,0,0,66,66,0,1,0,1,0
16951,255,0,0,62,62,0,1,0,1,0
4504,2486,0,0,62,62,0,1,0,1,0
7457,1781,0,0,66,66,0,1,0,1,0
6763,5,0,0,60,60,0,1,0,1,0
11734,1147,0,0,64,64,0,1,0,1,0
15024,1502,0,0,65,65,0,1,0,1,0
16951,255,0,0,62,62,0,1,0,1,0
9273,6,0,0,60,60,0,1,0,1,0
1322,2636,0,0,66,66,0,1,0,1,0
11834,165,0,0,60,60,0,1,0,1,0
6229,2938,0,0,78,78,0,1,0,1,0
3004,2256,0,0,64,64,0,1,0,1,0
2219,2880,0,0,66,66,0,1,0,1,0
232,1771,0,0,63,63,0,1,0,1,0
12176,997,0,0,66,66,0,1,0,1,0
360,3105,0,0,656,656,0,1,0,1,0
41,2938,0,0,62,62,0,1,0,1,0
19413,3216,0,0,62,62,0,1,0,1,0
1804,2587,0,0,62,62,0,1,0,1,0
10293,2883,0,0,62,62,0,1,0,1,0
16951,255,0,0,62,62,0,1,0,1,0
7949,314,0,0,60,60,0,1,0,1,0
15278,2587,0,0,62,62,0,1,0,1,0
20499,1017,0,0,65,65,0,1,0,1,0
11655,3216,0,0,62,62,0,1,0,1,0
12213,1215,0,0,63,63,0,1,0,1,0
40,2440,0,0,135,135,0,1,0,1,0
10362,187,0,0,106,106,0,1,0,1,0
1690,1147,0,0,62,62,0,1,0,1,0
16880,1481,0,0,62,62,0,1,0,1,0
7335,1070,0,0,60,60,0,1,0,1,0
2446,2587,0,0,64,64,0,1,0,1,0
4559,2213,0,0,62,62,0,1,0,1,0
66,406,0,0,62,62,0,1,0,1,0
9273,6,0,0,60,60,0,1,0,1,0
2136,2596,0,0,64,64,0,1,0,1,0
7578,3216,0,0,62,62,0,1,0,1,0
1637,3181,0,0,66,66,0,1,0,1,0
2154,2629,0,0,62,62,0,1,0,1,0
6330,38,0,0,60,60,0,1,0,1,0
8115,2562,0,0,62,62,0,1,0,1,0
16844,2938,0,0,66,66,0,1,0,1,0
12909,2178,0,0,64,64,0,1,0,1,0
146,1017,0,0,62,62,0,1,0,1,0
2292,1017,0,0,66,66,0,1,0,1,0
8221,2591,0,0,62,62,0,1,0,1,0
16951,255,0,0,62,62,0,1,0,1,0
1353,7,0,0,60,60,0,1,0,1,0
9630,2883,0,0,65,65,0,1,0,1,0
1714,8,0,0,60,60,0,1,0,1,0
1131,2938,0,0,63,63,0,1,0,1,0
20467,2612,0,0,65,65,0,1,0,1,0
20711,2701,0,0,66,66,0,1,0,1,0
3770,1771,0,0,62,62,0,1,0,1,0
7697,1147,0,0,79,79,0,1,0,1,0
20173,1495,0,0,129,129,0,1,0,1,0
2719,1147,0,0,66,66,0,1,0,1,0
14702,984,0,0,66,66,0,1,0,1,0
11055,1210,0,0,60,60,0,1,0,1,0
2497,3216,0,0,66,66,0,1,0,1,0
10207,1772,0,0,65,65,0,1,0,1,0
1959,1885,0,0,62,62,0,1,0,1,0
573,1147,0,0,63,63,0,1,0,1,0
3223,383,0,0,66,66,0,1,0,1,0
2018,2949,0,0,65,65,0,1,0,1,0
2269,1506,0,0,106,106,0,1,0,1,0
13,2377,0,0,63,63,0,1,0,1,0
2219,747,0,0,62,62,0,1,0,1,0
13086,1917,0,0,122,122,0,1,0,1,0
21587,2938,0,0,78,78,0,1,0,1,0
18925,2550,0,0,66,66,0,1,0,1,0
8862,1771,0,0,63,63,0,1,0,1,0
16951,255,0,0,62,62,0,1,0,1,0
9,3020,0,0,1499,1499,0,1,0,1,0
4799,1888,0,0,62,62,0,1,0,1,0
12695,1888,0,0,66,66,0,1,0,1,0
5301,1147,0,0,62,62,0,1,0,1,0
12347,2256,0,0,64,64,0,1,0,1,0
1238,1161,0,0,63,63,0,1,0,1,0
240,2205,0,0,62,62,0,1,0,1,0
21766,1888,0,0,63,63,0,1,0,1,0
21642,3216,0,0,64,64,0,1,0,1,0
13114,1048,0,0,65,65,0,1,0,1,0
16951,255,0,0,62,62,0,1,0,1,0
16114,2611,0,0,64,64,0,1,0,1,0
2668,1147,0,0,62,62,0,1,0,1,0
1708,1807,0,0,62,62,0,1,0,1,0
11483,1771,0,0,62,62,0,1,0,1,0
1535,2256,0,0,64,64,0,1,0,1,0
157,1147,0,0,64,64,0,1,0,1,0
17719,2883,0,0,65,65,0,1,0,1,0
6506,697,0,0,62,62,0,1,0,1,0
18970,1017,0,0,62,62,0,1,0,1,0
1489,1888,0,0,62,62,0,1,0,1,0
2840,1888,0,0,64,64,0,1,0,1,0
735,1147,0,0,65,65,0,1,0,1,0
8,1873,0,0,60,60,0,1,0,1,0
10977,1167,0,0,62,62,0,1,0,1,0
2293,2486,0,0,70,70,0,1,0,1,0
13553,110,0,0,60,60,0,1,0,1,0
297,2256,0,0,76,76,0,1,0,1,0
2532,994,0,0,65,65,0,1,0,1,0
779,2920,0,0,63,63,0,1,0,1,0
2135,791,0,0,62,62,0,1,0,1,0
1662,1147,0,0,65,65,0,1,0,1,0
1796,2587,0,0,146,146,0,1,0,1,0
17698,1147,0,0,63,63,0,1,0,1,0
5473,3139,0,0,66,66,0,1,0,1,0
21322,1017,0,0,63,63,0,1,0,1,0
2301,1946,0,0,60,60,0,1,0,1,0
15279,1147,0,0,63,63,0,1,0,1,0
9614,3105,0,0,86,86,0,1,0,1,0
17460,2951,0,0,66,66,0,1,0,1,0
2897,1888,0,0,62,62,0,1,0,1,0
8043,1888,0,0,62,62,0,1,0,1,0
11481,1844,0,0,63,63,0,1,0,1,0
16951,255,0,0,62,62,0,1,0,1,0
151,3207,0,0,66,66,0,1,0,1,0
1236,2256,0,0,66,66,0,1,0,1,0
11637,2714,0,0,66,66,0,1,0,1,0
373,1147,0,0,62,62,0,1,0,1,0
1802,926,0,0,60,60,0,1,0,1,0
9214,3256,0,0,60,60,0,1,0,1,0
2649,3216,0,0,64,64,0,1,0,1,0
16368,2256,0,0,63,63,0,1,0,1,0
4598,1858,0,0,66,66,0,1,0,1,0
11965,1147,0,0,66,66,0,1,0,1,0
636,426,0,0,128,128,0,1,0,1,0
29,1888,0,0,62,62,0,1,0,1,0
7663,3,0,0,61,61,0,1,0,1,0
1693,2938,0,0,72,72,0,1,0,1,0
7339,334,0,0,60,60,0,1,0,1,0
16558,1017,0,0,65,65,0,1,0,1,0
10960,2938,0,0,62,62,0,1,0,1,0
7530,3216,0,0,62,62,0,1,0,1,0
3876,1923,0,0,62,62,0,1,0,1,0
9918,1778,0,0,62,62,0,1,0,1,0
11686,1147,0,0,66,66,0,1,0,1,0
1752,1882,0,0,146,146,0,1,0,1,0
3214,1472,0,0,62,62,0,1,0,1,0
5621,1017,0,0,143,143,0,1,0,1,0
20038,1875,0,0,66,66,0,1,0,1,0
1547,2619,0,0,62,62,0,1,0,1,0
16382,3186,0,0,64,64,0,1,0,1,0
2438,2486,0,0,158,158,0,1,0,1,0
4297,9,0,0,60,60,0,1,0,1,0
16868,2586,0,0,132,132,0,1,0,1,0
16951,255,0,0,62,62,0,1,0,1,0
16951,255,0,0,62,62,0,1,0,1,0
2613,1017,0,0,62,62,0,1,0,1,0
15482,2587,0,0,65,65,0,1,0,1,0
11486,2923,0,0,66,66,0,1,0,1,0
17464,2946,0,0,66,66,0,1,0,1,0
17310,2622,0,0,63,63,0,1,0,1,0
18614,3216,0,0,62,62,0,1,0,1,0
7335,1072,0,0,60,60,0,1,0,1,0
6651,1129,0,0,156,156,0,1,0,1,0
10475,6,0,0,60,60,0,1,0,1,0
5256,2256,0,0,66,66,0,1,0,1,0
2385,1147,0,0,62,62,0,1,0,1,0
7549,2610,0,0,62,62,0,1,0,1,0
2311,2611,0,0,62,62,0,1,0,1,0
1668,2587,0,0,64,64,0,1,0,1,0
2662,1769,0,0,62,62,0,1,0,1,0
19898,3216,0,0,85,85,0,1,0,1,0
18406,1804,0,0,65,65,0,1,0,1,0
10503,2726,0,0,77,77,0,1,0,1,0
21436,1771,0,0,65,65,0,1,0,1,0
2726,1888,0,0,62,62,0,1,0,1,0
21989,2613,0,0,62,62,0,1,0,1,0
4711,2256,0,0,62,62,0,1,0,1,0
22376,1888,0,0,72,72,0,1,0,1,0
8549,985,0,0,65,65,0,1,0,1,0
9603,3139,0,0,63,63,0,1,0,1,0
843,2256,0,0,64,64,0,1,0,1,0
5266,2636,0,0,99,99,0,1,0,1,0
6391,2256,0,0,63,63,0,1,0,1,0
3191,509,0,0,62,62,0,1,0,1,0
635,1451,0,0,137,137,0,1,0,1,0
565,1017,0,0,62,62,0,1,0,1,0
5208,1888,0,0,62,62,0,1,0,1,0
16951,255,0,0,62,62,0,1,0,1,0
13485,1017,0,0,65,65,0,1,0,1,0
21607,1147,0,0,66,66,0,1,0,1,0
3876,1923,0,0,62,62,0,1,0,1,0
1374,1888,0,0,62,62,0,1,0,1,0
2971,2632,0,0,62,62,0,1,0,1,0
4503,2486,0,0,67,67,0,1,0,1,0
1742,1017,0,0,62,62,0,1,0,1,0
16951,255,0,0,62,62,0,1,0,1,0
2969,1888,0,0,62,62,0,1,0,1,0
9812,3000,0,0,66,66,0,1,0,1,0
135,3139,0,0,64,64,0,1,0,1,0
17336,1327,0,0,62,62,0,1,0,1,0
11658,3216,0,0,63,63,0,1,0,1,0
508,1596,0,0,84,84,0,1,0,1,0
1884,509,0,0,64,64,0,1,0,1,0
7339,170,0,0,60,60,0,1,0,1,0
21866,242,0,0,87,87,0,1,0,1,0
162,2636,0,0,63,63,0,1,0,1,0
2372,1147,0,0,146,146,0,1,0,1,0
20879,3173,0,0,64,64,0,1,0,1,0
6113,1288,0,0,145,145,0,1,0,1,0
8,1873,0,0,60,60,0,1,0,1,0
269,509,0,0,63,63,0,1,0,1,0
21980,509,0,0,96,96,0,1,0,1,0
15344,2306,0,0,63,63,0,1,0,1,0
13443,2587,0,0,66,66,0,1,0,1,0
4501,1147,0,0,62,62,0,1,0,1,0
13279,2301,0,0,63,63,0,1,0,1,0
18500,791,0,0,70,70,0,1,0,1,0
495,2996,0,0,66,66,0,1,0,1,0
1773,2883,0,0,66,66,0,1,0,1,0
10475,6,0,0,60,60,0,1,0,1,0
1810,1023,0,0,146,146,0,1,0,1,0
8164,2727,0,0,60,60,0,1,0,1,0
1525,1444,0,0,145,145,0,1,0,1,0
2215,2636,0,0,65,65,0,1,0,1,0
113,2587,0,0,146,146,0,1,0,1,0
10814,1017,0,0,62,62,0,1,0,1,0
186,2486,0,0,62,62,0,1,0,1,0
14726,1880,0,0,63,63,0,1,0,1,0
1817,1147,0,0,62,62,0,1,0,1,0
18118,1888,0,0,66,66,0,1,0,1,0
16951,255,0,0,62,62,0,1,0,1,0
18499,784,0,0,75,75,0,1,0,1,0
17624,1880,0,0,64,64,0,1,0,1,0
1324,2587,0,0,62,62,0,1,0,1,0
12505,1026,0,0,66,66,0,1,0,1,0
7756,2256,0,0,66,66,0,1,0,1,0
7999,2942,0,0,62,62,0,1,0,1,0
2787,1147,0,0,62,62,0,1,0,1,0
9214,3256,0,0,60,60,0,1,0,1,0
837,1171,0,0,60,60,0,1,0,1,0
19983,3129,0,0,65,65,0,1,0,1,0
12,2199,0,0,97,97,0,1,0,1,0
4563,2205,0,0,62,62,0,1,0,1,0
7326,1649,0,0,60,60,0,1,0,1,0
11761,1887,0,0,66,66,0,1,0,1,0
22037,1888,0,0,65,65,0,1,0,1,0
9428,1771,0,0,64,64,0,1,0,1,0
17855,3194,0,0,66,66,0,1,0,1,0
8087,52,0,0,60,60,0,1,0,1,0
3612,1147,0,0,64,64,0,1,0,1,0
14909,2883,0,0,66,66,0,1,0,1,0
1464,1017,0,0,64,64,0,1,0,1,0
13505,104,0,0,60,60,0,1,0,1,0
14982,2636,0,0,62,62,0,1,0,1,0
5327,1888,0,0,62,62,0,1,0,1,0
14846,2256,0,0,62,62,0,1,0,1,0
5278,2256,0,0,62,62,0,1,0,1,0
14751,2894,0,0,65,65,0,1,0,1,0
2556,2572,0,0,60,60,0,1,0,1,0
16951,255,0,0,62,62,0,1,0,1,0
2744,1050,0,0,61,61,0,1,0,1,0
1814,1147,0,0,64,64,0,1,0,1,0
713,947,0,0,145,145,0,1,0,1,0
787,1017,0,0,66,66,0,1,0,1,0
16,2955,0,0,61,61,0,1,0,1,0
16951,255,0,0,62,62,0,1,0,1,0
8358,1771,0,0,66,66,0,1,0,1,0
8,442,0,0,60,60,0,1,0,1,0
579,1035,0,0,64,64,0,1,0,1,0
3144,2587,0,0,65,65,0,1,0,1,0
9260,1481,0,0,66,66,0,1,0,1,0
7,12,0,0,356,356,0,1,0,1,0
9819,2883,0,0,66,66,0,1,0,1,0
29,1888,0,0,62,62,0,1,0,1,0
3655,1017,0,0,62,62,0,1,0,1,0
656,2471,0,0,139,139,0,1,0,1,0
12127,1215,0,0,64,64,0,1,0,1,0
10113,1469,0,0,63,63,0,1,0,1,0
3107,1017,0,0,71,71,0,1,0,1,0
528,2298,0,0,66,66,0,1,0,1,0
19996,3117,0,0,63,63,0,1,0,1,0
15593,1804,0,0,63,63,0,1,0,1,0
14767,2587,0,0,64,64,0,1,0,1,0
1625,280,0,0,70,70,0,1,0,1,0
3099,1147,0,0,62,62,0,1,0,1,0
17574,2148,0,0,73,73,0,1,0,1,0
2951,402,0,0,60,60,0,1,0,1,0
16951,255,0,0,62,62,0,1,0,1,0
328,1017,0,0,64,64,0,1,0,1,0
10784,2587,0,0,80,80,0,1,0,1,0
360,3105,0,0,454,454,0,1,0,1,0
1911,2586,0,0,145,145,0,1,0,1,0
11354,3212,0,0,66,66,0,1,0,1,0
2508,2579,0,0,145,145,0,1,0,1,0
21777,2574,0,0,65,65,0,1,0,1,0
844,2933,0,0,146,146,0,1,0,1,0
20989,3212,0,0,66,66,0,1,0,1,0
3316,1888,0,0,66,66,0,1,0,1,0
117,1771,0,0,62,62,0,1,0,1,0
17459,2953,0,0,66,66,0,1,0,1,0
11591,1017,0,0,63,63,0,1,0,1,0
9259,1222,0,0,62,62,0,1,0,1,0
15694,1515,0,0,145,145,0,1,0,1,0
11923,1147,0,0,62,62,0,1,0,1,0
16951,255,0,0,62,62,0,1,0,1,0
3233,7,0,0,60,60,0,1,0,1,0
21279,2256,0,0,66,66,0,1,0,1,0
16951,255,0,0,62,62,0,1,0,1,0
16648,7,0,0,60,60,0,1,0,1,0
16582,2205,0,0,63,63,0,1,0,1,0
14848,2256,0,0,63,63,0,1,0,1,0
2303,436,0,0,65,65,0,1,0,1,0
3027,1882,0,0,64,64,0,1,0,1,0
9639,644,0,0,128,128,0,1,0,1,0
15999,2938,0,0,65,65,0,1,0,1,0
21052,2596,0,0,64,64,0,1,0,1,0
1525,1444,0,0,145,145,0,1,0,1,0
18220,2609,0,0,66,66,0,1,0,1,0
22463,2256,0,0,66,66,0,1,0,1,0
752,1859,0,0,63,63,0,1,0,1,0
19688,1017,0,0,66,66,0,1,0,1,0
16951,255,0,0,62,62,0,1,0,1,0
18465,780,0,0,66,66,0,1,0,1,0
14542,2214,0,0,65,65,0,1,0,1,0
19718,2486,0,0,66,66,0,1,0,1,0
2968,2256,0,0,66,66,0,1,0,1,0
7330,335,0,0,72,72,0,1,0,1,0
13120,1051,0,0,66,66,0,1,0,1,0
4957,250,0,0,61,61,0,1,0,1,0
2538,146,0,0,60,60,0,1,0,1,0
5443,2573,0,0,146,146,0,1,0,1,0
2391,3216,0,0,62,62,0,1,0,1,0
9214,3256,0,0,60,60,0,1,0,1,0
7564,2579,0,0,70,70,0,1,0,1,0
15600,2929,0,0,62,62,0,1,0,1,0
10319,1888,0,0,66,66,0,1,0,1,0
3223,383,0,0,64,64,0,1,0,1,0
328,3216,0,0,62,62,0,1,0,1,0
1530,2943,0,0,62,62,0,1,0,1,0
20585,1018,0,0,62,62,0,1,0,1,0
16951,255,0,0,62,62,0,1,0,1,0
386,3216,0,0,62,62,0,1,0,1,0
659,280,0,0,62,62,0,1,0,1,0
16368,2256,0,0,63,63,0,1,0,1,0
1402,2938,0,0,62,62,0,1,0,1,0
10475,6,0,0,60,60,0,1,0,1,0
6234,2821,0,0,60,60,0,1,0,1,0
16951,255,0,0,62,62,0,1,0,1,0
5751,158,0,0,61,61,0,1,0,1,0
16951,255,0,0,62,62,0,1,0,1,0
14725,1870,0,0,62,62,0,1,0,1,0
7306,2572,0,0,145,145,0,1,0,1,0
9042,1789,0,0,94,94,0,1,0,1,0
729,138,0,0,66,66,0,1,0,1,0
15,2036,0,0,126,126,0,1,0,1,0
18609,2587,0,0,62,62,0,1,0,1,0
18893,2587,0,0,66,66,0,1,0,1,0
3141,2587,0,0,62,62,0,1,0,1,0
13794,312,0,0,66,66,0,1,0,1,0
20332,1147,0,0,116,116,0,1,0,1,0
2131,2938,0,0,62,62,0,1,0,1,0
20269,2938,0,0,62,62,0,1,0,1,0
1410,1888,0,0,63,63,0,1,0,1,0
3033,2587,0,0,62,62,0,1,0,1,0
4160,3193,0,0,89,89,0,1,0,1,0
10321,2974,0,0,79,79,0,1,0,1,0
19408,1880,0,0,66,66,0,1,0,1,0
1414,1828,0,0,142,142,0,1,0,1,0
16951,255,0,0,62,62,0,1,0,1,0
1871,1017,0,0,63,63,0,1,0,1,0
7339,141,0,0,60,60,0,1,0,1,0
11095,1017,0,0,62,62,0,1,0,1,0
2658,1147,0,0,65,65,0,1,0,1,0
19266,3216,0,0,65,65,0,1,0,1,0
16887,983,0,0,62,62,0,1,0,1,0
1161,3216,0,0,62,62,0,1,0,1,0
10417,2604,0,0,71,71,0,1,0,1,0
20336,1887,0,0,66,66,0,1,0,1,0
20927,1017,0,0,62,62,0,1,0,1,0
805,2130,0,0,61,61,0,1,0,1,0
360,3105,0,0,164,164,0,1,0,1,0
1285,1771,0,0,62,62,0,1,0,1,0
16951,255,0,0,62,62,0,1,0,1,0
1981,1086,0,0,62,62,0,1,0,1,0
2462,2587,0,0,62,62,0,1,0,1,0
1755,3170,0,0,145,145,0,1,0,1,0
16951,255,0,0,62,62,0,1,0,1,0
12998,1147,0,0,62,62,0,1,0,1,0
6651,1129,0,0,156,156,0,1,0,1,0
2648,1776,0,0,63,63,0,1,0,1,0
17102,722,0,0,66,66,0,1,0,1,0
1352,155,0,0,64,64,0,1,0,1,0
2590,1803,0,0,66,66,0,1,0,1,0
2547,927,0,0,60,60,0,1,0,1,0
19427,1881,0,0,66,66,0,1,0,1,0
2793,1017,0,0,62,62,0,1,0,1,0
15614,2256,0,0,65,65,0,1,0,1,0
6149,1771,0,0,62,62,0,1,0,1,0
2372,2944,0,0,125,125,0,1,0,1,0
5193,1888,0,0,62,62,0,1,0,1,0
2198,1017,0,0,62,62,0,1,0,1,0
13792,1472,0,0,66,66,0,1,0,1,0
18,3231,0,0,133,133,0,1,0,1,0
8335,1147,0,0,62,62,0,1,0,1,0
4441,2885,0,0,145,145,0,1,0,1,0
2703,2256,0,0,63,63,0,1,0,1,0
13625,3216,0,0,66,66,0,1,0,1,0
1606,2602,0,0,64,64,0,1,0,1,0
2512,2951,0,0,80,80,0,1,0,1,0
5767,2938,0,0,62,62,0,1,0,1,0
1662,1147,0,0,146,146,0,1,0,1,0
16951,255,0,0,62,62,0,1,0,1,0
10165,1147,0,0,62,62,0,1,0,1,0
62,2256,0,0,146,146,0,1,0,1,0
0,0,0,0,98,98,0,1,0,1,0
17738,3148,0,0,62,62,0,1,0,1,0
7460,1771,0,0,66,66,0,1,0,1,0
5810,233,0,0,60,60,0,1,0,1,0
16026,2256,0,0,66,66,0,1,0,1,0
21999,2587,0,0,66,66,0,1,0,1,0
8798,1472,0,0,66,66,0,1,0,1,0
2967,1147,0,0,146,146,0,1,0,1,0
7634,2588,0,0,62,62,0,1,0,1,0
2130,125,0,0,60,60,0,1,0,1,0
20475,1016,0,0,66,66,0,1,0,1,0
11814,1888,0,0,66,66,0,1,0,1,0
1416,1888,0,0,62,62,0,1,0,1,0
1415,1017,0,0,63,63,0,1,0,1,0
2539,1903,0,0,60,60,0,1,0,1,0
16951,255,0,0,62,62,0,1,0,1,0
10469,783,0,0,100,100,0,1,0,1,0
311,2256,0,0,63,63,0,1,0,1,0
2198,721,0,0,62,62,0,1,0,1,0
7071,1539,0,0,72,72,0,1,0,1,0
3162,2587,0,0,62,62,0,1,0,1,0
9578,3216,0,0,66,66,0,1,0,1,0
15540,1771,0,0,66,66,0,1,0,1,0
360,3105,0,0,906,906,0,1,0,1,0
1504,1147,0,0,146,146,0,1,0,1,0
18,2256,0,0,62,62,0,1,0,1,0
13280,1769,0,0,66,66,0,1,0,1,0
7921,1147,0,0,146,146,0,1,0,1,0
16951,255,0,0,62,62,0,1,0,1,0
13367,1804,0,0,65,65,0,1,0,1,0
1808,2580,0,0,62,62,0,1,0,1,0
18376,2923,0,0,71,71,0,1,0,1,0
1804,2921,0,0,60,60,0,1,0,1,0
2402,3216,0,0,63,63,0,1,0,1,0
7273,1888,0,0,62,62,0,1,0,1,0
3457,3200,0,0,75,75,0,1,0,1,0
283,3216,0,0,62,62,0,1,0,1,0
20244,2938,0,0,62,62,0,1,0,1,0
6589,1215,0,0,66,66,0,1,0,1,0
21547,2256,0,0,64,64,0,1,0,1,0
17200,1880,0,0,62,62,0,1,0,1,0
19875,2587,0,0,63,63,0,1,0,1,0
242,1054,0,0,65,65,0,1,0,1,0
1262,1017,0,0,146,146,0,1,0,1,0
18504,794,0,0,66,66,0,1,0,1,0
13933,1891,0,0,66,66,0,1,0,1,0
497,982,0,0,65,65,0,1,0,1,0
2535,1787,0,0,134,134,0,1,0,1,0
15735,2256,0,0,62,62,0,1,0,1,0
11817,1886,0,0,66,66,0,1,0,1,0
16951,255,0,0,62,62,0,1,0,1,0
16951,255,0,0,62,62,0,1,0,1,0
17026,1473,0,0,65,65,0,1,0,1,0
2281,1086,0,0,62,62,0,1,0,1,0
11594,715,0,0,62,62,0,1,0,1,0
2287,3216,0,0,66,66,0,1,0,1,0
12347,1,0,0,66,66,0,1,0,1,0
3473,3199,0,0,62,62,0,1,0,1,0
6269,2477,0,0,60,60,0,1,0,1,0
16951,255,0,0,62,62,0,1,0,1,0
10772,1480,0,0,66,66,0,1,0,1,0
3718,1147,0,0,119,119,0,1,0,1,0
2757,451,0,0,62,62,0,1,0,1,0
2611,2883,0,0,62,62,0,1,0,1,0
1455,1147,0,0,62,62,0,1,0,1,0
16951,255,0,0,62,62,0,1,0,1,0
305,2256,0,0,64,64,0,1,0,1,0
20770,1809,0,0,66,66,0,1,0,1,0
12,3106,0,0,325,325,0,1,0,1,0
1541,791,0,0,62,62,0,1,0,1,0
1989,2256,0,0,66,66,0,1,0,1,0
16951,255,0,0,62,62,0,1,0,1,0
19976,344,0,0,157,157,0,1,0,1,0
1795,2836,0,0,66,66,0,1,0,1,0
385,1215,0,0,66,66,0,1,0,1,0
7949,315,0,0,60,60,0,1,0,1,0
12581,3056,0,0,63,63,0,1,0,1,0
20446,996,0,0,66,66,0,1,0,1,0
6236,1147,0,0,62,62,0,1,0,1,0
17676,2746,0,0,62,62,0,1,0,1,0
16951,255,0,0,62,62,0,1,0,1,0
58,2256,0,0,146,146,0,1,0,1,0
16951,255,0,0,62,62,0,1,0,1,0
6665,2559,0,0,62,62,0,1,0,1,0
13166,1373,0,0,62,62,0,1,0,1,0
20866,1017,0,0,82,82,0,1,0,1,0
13485,1829,0,0,62,62,0,1,0,1,0
12078,3139,0,0,62,62,0,1,0,1,0
16439,3214,0,0,65,65,0,1,0,1,0
4955,2626,0,0,64,64,0,1,0,1,0
12476,3216,0,0,64,64,0,1,0,1,0
14950,1017,0,0,62,62,0,1,0,1,0
2546,2587,0,0,62,62,0,1,0,1,0
12174,2592,0,0,62,62,0,1,0,1,0
7375,2636,0,0,76,76,0,1,0,1,0
18,2258,0,0,145,145,0,1,0,1,0
2678,1147,0,0,62,62,0,1,0,1,0
21570,3216,0,0,62,62,0,1,0,1,0
1724,1017,0,0,62,62,0,1,0,1,0
395,2677,0,0,63,63,0,1,0,1,0
16951,255,0,0,62,62,0,1,0,1,0
9429,2509,0,0,65,65,0,1,0,1,0
3173,528,0,0,149,149,0,1,0,1,0
20364,3139,0,0,66,66,0,1,0,1,0
1814,1212,0,0,65,65,0,1,0,1,0
11886,2928,0,0,72,72,0,1,0,1,0
22160,1215,0,0,62,62,0,1,0,1,0
128,391,0,0,62,62,0,1,0,1,0
17297,1837,0,0,66,66,0,1,0,1,0
14489,3216,0,0,66,66,0,1,0,1,0
6727,2256,0,0,64,64,0,1,0,1,0
7949,314,0,0,60,60,0,1,0,1,0
11797,2611,0,0,74,74,0,1,0,1,0
12,1014,0,0,62,62,0,1,0,1,0
18,1147,0,0,62,62,0,1,0,1,0
2555,1017,0,0,146,146,0,1,0,1,0
2505,1147,0,0,62,62,0,1,0,1,0
20089,986,0,0,66,66,0,1,0,1,0
3065,1215,0,0,63,63,0,1,0,1,0
11029,1888,0,0,62,62,0,1,0,1,0
16951,255,0,0,62,62,0,1,0,1,0
2765,3216,0,0,64,64,0,1,0,1,0
1974,1833,0,0,146,146,0,1,0,1,0
8372,2195,0,0,149,149,0,1,0,1,0
20841,3216,0,0,62,62,0,1,0,1,0
2458,2859,0,0,70,70,0,1,0,1,0
2486,2492,0,0,144,144,0,1,0,1,0
9477,1888,0,0,66,66,0,1,0,1,0
6169,3051,0,0,63,63,0,1,0,1,0
35,278,0,0,68,68,0,1,0,1,0
21825,2587,0,0,63,63,0,1,0,1,0
16951,255,0,0,62,62,0,1,0,1,0
2965,1888,0,0,62,62,0,1,0,1,0
9260,805,0,0,66,66,0,1,0,1,0
11461,1472,0,0,66,66,0,1,0,1,0
360,3105,0,0,924,924,0,1,0,1,0
12512,1752,0,0,61,61,0,1,0,1,0
13073,1017,0,0,62,62,0,1,0,1,0
6667,2532,0,0,138,138,0,1,0,1,0
3033,1215,0,0,62,62,0,1,0,1,0
190,2938,0,0,78,78,0,1,0,1,0
1385,2473,0,0,86,86,0,1,0,1,0
3668,1888,0,0,62,62,0,1,0,1,0
4299,2587,0,0,91,91,0,1,0,1,0
14953,2256,0,0,62,62,0,1,0,1,0
1913,2587,0,0,62,62,0,1,0,1,0
844,2926,0,0,146,146,0,1,0,1,0
15287,1147,0,0,62,62,0,1,0,1,0
409,3216,0,0,62,62,0,1,0,1,0
18,2256,0,0,146,146,0,1,0,1,0
18005,1017,0,0,93,93,0,1,0,1,0
2903,1888,0,0,62,62,0,1,0,1,0
16951,255,0,0,62,62,0,1,0,1,0
4367,1147,0,0,66,66,0,1,0,1,0
1951,1003,0,0,63,63,0,1,0,1,0
22442,1144,0,0,70,70,0,1,0,1,0
20908,3141,0,0,62,62,0,1,0,1,0
1964,983,0,0,66,66,0,1,0,1,0
21079,1215,0,0,65,65,0,1,0,1,0
2833,1888,0,0,62,62,0,1,0,1,0
10278,2899,0,0,66,66,0,1,0,1,0
2315,2587,0,0,146,146,0,1,0,1,0
10716,2938,0,0,66,66,0,1,0,1,0
8532,2636,0,0,66,66,0,1,0,1,0
3136,2587,0,0,62,62,0,1,0,1,0
1780,6,0,0,60,60,0,1,0,1,0
677,3216,0,0,64,64,0,1,0,1,0
4397,1026,0,0,62,62,0,1,0,1,0
3119,1480,0,0,62,62,0,1,0,1,0
7339,322,0,0,60,60,0,1,0,1,0
10543,741,0,0,98,98,0,1,0,1,0
13,1021,0,0,121,121,0,1,0,1,0
11466,2606,0,0,72,72,0,1,0,1,0
695,2256,0,0,63,63,0,1,0,1,0
22148,1199,0,0,62,62,0,1,0,1,0
636,280,0,0,62,62,0,1,0,1,0
16333,3216,0,0,66,66,0,1,0,1,0
18,2938,0,0,62,62,0,1,0,1,0
7271,2,0,0,61,61,0,1,0,1,0
19932,1056,0,0,66,66,0,1,0,1,0
1271,2938,0,0,62,62,0,1,0,1,0
34,3226,0,0,145,145,0,1,0,1,0
2987,2256,0,0,63,63,0,1,0,1,0
8,2758,0,0,60,60,0,1,0,1,0
2972,2636,0,0,62,62,0,1,0,1,0
1330,697,0,0,62,62,0,1,0,1,0
9712,1017,0,0,62,62,0,1,0,1,0
16951,255,0,0,62,62,0,1,0,1,0
12313,1389,0,0,61,61,0,1,0,1,0
6206,10,0,0,64,64,0,1,0,1,0
3022,3216,0,0,62,62,0,1,0,1,0
1480,1888,0,0,64,64,0,1,0,1,0
13443,2587,0,0,66,66,0,1,0,1,0
16951,255,0,0,62,62,0,1,0,1,0
12055,3113,0,0,66,66,0,1,0,1,0
16951,255,0,0,62,62,0,1,0,1,0
17210,1123,0,0,64,64,0,1,0,1,0
2971,1792,0,0,66,66,0,1,0,1,0
7509,218,0,0,60,60,0,1,0,1,0
2902,2587,0,0,63,63,0,1,0,1,0
18925,2550,0,0,66,66,0,1,0,1,0
12014,3065,0,0,64,64,0,1,0,1,0
3217,1472,0,0,62,62,0,1,0,1,0
14096,2587,0,0,65,65,0,1,0,1,0
8584,1017,0,0,65,65,0,1,0,1,0
2935,7,0,0,60,60,0,1,0,1,0
102,3165,0,0,63,63,0,1,0,1,0
11811,2605,0,0,75,75,0,1,0,1,0
10418,2610,0,0,69,69,0,1,0,1,0
100,1017,0,0,64,64,0,1,0,1,0
22083,388,0,0,64,64,0,1,0,1,0
16951,255,0,0,62,62,0,1,0,1,0
360,3105,0,0,250,250,0,1,0,1,0
612,714,0,0,60,60,0,1,0,1,0
16951,255,0,0,62,62,0,1,0,1,0
21979,1539,0,0,66,66,0,1,0,1,0
3546,2938,0,0,66,66,0,1,0,1,0
432,1222,0,0,60,60,0,1,0,1,0
10615,2625,0,0,62,62,0,1,0,1,0
12690,1888,0,0,66,66,0,1,0,1,0
248,1055,0,0,62,62,0,1,0,1,0
17204,1882,0,0,63,63,0,1,0,1,0
2812,7,0,0,60,60,0,1,0,1,0
2955,391,0,0,60,60,0,1,0,1,0
14052,1888,0,0,66,66,0,1,0,1,0
19032,1917,0,0,64,64,0,1,0,1,0
14505,2312,0,0,78,78,0,1,0,1,0
5942,2587,0,0,98,98,0,1,0,1,0
1823,2573,0,0,62,62,0,1,0,1,0
19120,170,0,0,60,60,0,1,0,1,0
10212,1771,0,0,64,64,0,1,0,1,0
2132,1888,0,0,62,62,0,1,0,1,0
10293,2883,0,0,66,66,0,1,0,1,0
2117,7,0,0,60,60,0,1,0,1,0
1278,1147,0,0,146,146,0,1,0,1,0
245,1883,0,0,64,64,0,1,0,1,0
3086,1888,0,0,64,64,0,1,0,1,0
1245,1017,0,0,62,62,0,1,0,1,0
15140,427,0,0,78,78,0,1,0,1,0
11757,1888,0,0,66,66,0,1,0,1,0
9245,2938,0,0,66,66,0,1,0,1,0
13753,546,0,0,66,66,0,1,0,1,0
9994,1186,0,0,72,72,0,1,0,1,0
6651,1129,0,0,156,156,0,1,0,1,0
15294,1880,0,0,64,64,0,1,0,1,0
21892,2938,0,0,66,66,0,1,0,1,0
14583,1155,0,0,62,62,0,1,0,1,0
12232,2587,0,0,64,64,0,1,0,1,0
1466,2587,0,0,63,63,0,1,0,1,0
8171,1073,0,0,60,60,0,1,0,1,0
18,3216,0,0,62,62,0,1,0,1,0
16951,255,0,0,62,62,0,1,0,1,0
2583,5,0,0,60,60,0,1,0,1,0
19,1773,0,0,62,62,0,1,0,1,0
16001,2938,0,0,64,64,0,1,0,1,0
2172,1888,0,0,145,145,0,1,0,1,0
19409,2603,0,0,66,66,0,1,0,1,0
7072,1893,0,0,65,65,0,1,0,1,0
21555,2587,0,0,66,66,0,1,0,1,0
5535,117,0,0,61,61,0,1,0,1,0
2084,1888,0,0,62,62,0,1,0,1,0
612,22,0,0,60,60,0,1,0,1,0
15054,136,0,0,104,104,0,1,0,1,0
3983,1589,0,0,62,62,0,1,0,1,0
20119,1054,0,0,66,66,0,1,0,1,0
2084,1471,0,0,145,145,0,1,0,1,0
1113,7,0,0,60,60,0,1,0,1,0
309,1472,0,0,64,64,0,1,0,1,0
2431,2938,0,0,62,62,0,1,0,1,0
17717,2883,0,0,66,66,0,1,0,1,0
17822,2938,0,0,62,62,0,1,0,1,0
1897,1031,0,0,62,62,0,1,0,1,0
1173,3216,0,0,62,62,0,1,0,1,0
3988,697,0,0,74,74,0,1,0,1,0
10475,6,0,0,60,60,0,1,0,1,0
7032,2938,0,0,74,74,0,1,0,1,0
16661,2587,0,0,62,62,0,1,0,1,0
12478,3216,0,0,66,66,0,1,0,1,0
17596,1017,0,0,63,63,0,1,0,1,0
13129,2256,0,0,63,63,0,1,0,1,0
309,2256,0,0,64,64,0,1,0,1,0
15181,1888,0,0,62,62,0,1,0,1,0
14268,2188,0,0,69,69,0,1,0,1,0
3207,1888,0,0,62,62,0,1,0,1,0
577,2611,0,0,62,62,0,1,0,1,0
18376,2889,0,0,66,66,0,1,0,1,0
12881,2550,0,0,62,62,0,1,0,1,0
6362,2568,0,0,62,62,0,1,0,1,0
11054,1212,0,0,60,60,0,1,0,1,0
2414,2093,0,0,146,146,0,1,0,1,0
20869,1147,0,0,66,66,0,1,0,1,0
1235,2256,0,0,65,65,0,1,0,1,0
16951,255,0,0,62,62,0,1,0,1,0
19412,1880,0,0,66,66,0,1,0,1,0
5042,1053,0,0,63,63,0,1,0,1,0
5033,1017,0,0,128,128,0,1,0,1,0
10432,1161,0,0,66,66,0,1,0,1,0
19278,2572,0,0,62,62,0,1,0,1,0
16951,255,0,0,62,62,0,1,0,1,0
18150,1147,0,0,66,66,0,1,0,1,0
15882,1888,0,0,62,62,0,1,0,1,0
1717,1822,0,0,65,65,0,1,0,1,0
3671,999,0,0,62,62,0,1,0,1,0
634,3223,0,0,60,60,0,1,0,1,0
12,972,0,0,83,83,0,1,0,1,0
15961,750,0,0,63,63,0,1,0,1,0
17576,1017,0,0,62,62,0,1,0,1,0
16951,255,0,0,62,62,0,1,0,1,0
5699,2938,0,0,74,74,0,1,0,1,0
20517,1147,0,0,124,124,0,1,0,1,0
8849,652,0,0,65,65,0,1,0,1,0
1865,1017,0,0,66,66,0,1,0,1,0
9706,2256,0,0,66,66,0,1,0,1,0
5573,3,0,0,60,60,0,1,0,1,0
696,2590,0,0,65,65,0,1,0,1,0
276,3185,0,0,63,63,0,1,0,1,0
412,1147,0,0,62,62,0,1,0,1,0
4578,2256,0,0,64,64,0,1,0,1,0
9214,3256,0,0,60,60,0,1,0,1,0
9332,2256,0,0,70,70,0,1,0,1,0
13612,3190,0,0,66,66,0,1,0,1,0
21274,990,0,0,66,66,0,1,0,1,0
6948,2608,0,0,62,62,0,1,0,1,0
16951,255,0,0,62,62,0,1,0,1,0
13318,1215,0,0,65,65,0,1,0,1,0
17803,2636,0,0,62,62,0,1,0,1,0
17374,2938,0,0,66,66,0,1,0,1,0
1934,2587,0,0,66,66,0,1,0,1,0
7781,2256,0,0,65,65,0,1,0,1,0
9694,2856,0,0,62,62,0,1,0,1,0
2669,2902,0,0,62,62,0,1,0,1,0
6309,2938,0,0,60,60,0,1,0,1,0
6308,2883,0,0,62,62,0,1,0,1,0
18066,1803,0,0,62,62,0,1,0,1,0
19947,3166,0,0,64,64,0,1,0,1,0
157,2981,0,0,1101,1101,0,1,0,1,0
7765,1147,0,0,146,146,0,1,0,1,0
14930,2246,0,0,66,66,0,1,0,1,0
17319,1147,0,0,66,66,0,1,0,1,0
2035,1147,0,0,85,85,0,1,0,1,0
20833,2824,0,0,66,66,0,1,0,1,0
1687,2636,0,0,66,66,0,1,0,1,0
11632,308,0,0,66,66,0,1,0,1,0
614,244,0,0,60,60,0,1,0,1,0
21911,3216,0,0,66,66,0,1,0,1,0
9614,3105,0,0,86,86,0,1,0,1,0
7986,2939,0,0,62,62,0,1,0,1,0
1900,2587,0,0,146,146,0,1,0,1,0
17614,2614,0,0,65,65,0,1,0,1,0
12877,2560,0,0,65,65,0,1,0,1,0
1962,3,0,0,63,63,0,1,0,1,0
20326,3139,0,0,66,66,0,1,0,1,0
1931,2587,0,0,65,65,0,1,0,1,0
15294,1880,0,0,66,66,0,1,0,1,0
2632,1937,0,0,63,63,0,1,0,1,0
9643,734,0,0,136,136,0,1,0,1,0
494,1545,0,0,64,64,0,1,0,1,0
2942,1804,0,0,135,135,0,1,0,1,0
16951,255,0,0,62,62,0,1,0,1,0
15417,1004,0,0,67,67,0,1,0,1,0
17129,2634,0,0,65,65,0,1,0,1,0
7949,315,0,0,60,60,0,1,0,1,0
238,1771,0,0,115,115,0,1,0,1,0
2264,1147,0,0,64,64,0,1,0,1,0
12245,1200,0,0,79,79,0,1,0,1,0
2660,1888,0,0,62,62,0,1,0,1,0
9202,3190,0,0,66,66,0,1,0,1,0
9634,2881,0,0,62,62,0,1,0,1,0
8327,3181,0,0,146,146,0,1,0,1,0
6450,2248,0,0,62,62,0,1,0,1,0
6506,697,0,0,62,62,0,1,0,1,0
16951,255,0,0,62,62,0,1,0,1,0
13007,221,0,0,62,62,0,1,0,1,0
7564,2636,0,0,62,62,0,1,0,1,0
2396,1885,0,0,62,62,0,1,0,1,0
360,3105,0,0,216,216,0,1,0,1,0
10971,2893,0,0,66,66,0,1,0,1,0
14523,2300,0,0,74,74,0,1,0,1,0
10775,2938,0,0,143,143,0,1,0,1,0
13830,1497,0,0,66,66,0,1,0,1,0
16025,3143,0,0,66,66,0,1,0,1,0
27,1215,0,0,62,62,0,1,0,1,0
3635,94,0,0,60,60,0,1,0,1,0
12723,1888,0,0,64,64,0,1,0,1,0
1142,1215,0,0,62,62,0,1,0,1,0
10267,2883,0,0,64,64,0,1,0,1,0
9951,2616,0,0,66,66,0,1,0,1,0
10981,349,0,0,62,62,0,1,0,1,0
810,1017,0,0,66,66,0,1,0,1,0
20239,2842,0,0,66,66,0,1,0,1,0
20047,691,0,0,142,142,0,1,0,1,0
2720,2941,0,0,62,62,0,1,0,1,0
3022,2583,0,0,62,62,0,1,0,1,0
16951,255,0,0,62,62,0,1,0,1,0
2121,3216,0,0,62,62,0,1,0,1,0
20445,534,0,0,62,62,0,1,0,1,0
2340,2587,0,0,62,62,0,1,0,1,0
11602,1804,0,0,62,62,0,1,0,1,0
21264,2587,0,0,62,62,0,1,0,1,0
2584,1202,0,0,157,157,0,1,0,1,0
16951,255,0,0,62,62,0,1,0,1,0
15694,333,0,0,145,145,0,1,0,1,0
10227,509,0,0,64,64,0,1,0,1,0
443,2963,0,0,63,63,0,1,0,1,0
833,723,0,0,103,103,0,1,0,1,0
21292,1148,0,0,62,62,0,1,0,1,0
12820,1470,0,0,66,66,0,1,0,1,0
612,21,0,0,60,60,0,1,0,1,0
12,1944,0,0,79,79,0,1,0,1,0
2815,1017,0,0,146,146,0,1,0,1,0
10475,6,0,0,60,60,0,1,0,1,0
2135,1147,0,0,65,65,0,1,0,1,0
21630,1888,0,0,66,66,0,1,0,1,0
18289,11,0,0,70,70,0,1,0,1,0
19453,983,0,0,65,65,0,1,0,1,0
2658,1147,0,0,64,64,0,1,0,1,0
8059,122,0,0,60,60,0,1,0,1,0
17212,509,0,0,62,62,0,1,0,1,0
1458,7,0,0,60,60,0,1,0,1,0
95,2611,0,0,145,145,0,1,0,1,0
1480,1147,0,0,146,146,0,1,0,1,0
13248,1794,0,0,66,66,0,1,0,1,0
41,697,0,0,62,62,0,1,0,1,0
5266,1147,0,0,62,62,0,1,0,1,0
2391,3216,0,0,65,65,0,1,0,1,0
360,3105,0,0,241,241,0,1,0,1,0
13443,2587,0,0,66,66,0,1,0,1,0
17855,2636,0,0,62,62,0,1,0,1,0
17608,2118,0,0,70,70,0,1,0,1,0
16323,3216,0,0,66,66,0,1,0,1,0
11914,2604,0,0,63,63,0,1,0,1,0
2147,2938,0,0,62,62,0,1,0,1,0
16333,1203,0,0,76,76,0,1,0,1,0
7268,2256,0,0,63,63,0,1,0,1,0
612,225,0,0,60,60,0,1,0,1,0
15243,2587,0,0,62,62,0,1,0,1,0
834,1426,0,0,81,81,0,1,0,1,0
10414,2587,0,0,66,66,0,1,0,1,0
1687,2636,0,0,64,64,0,1,0,1,0
7335,1070,0,0,60,60,0,1,0,1,0
6889,1888,0,0,62,62,0,1,0,1,0
1801,973,0,0,61,61,0,1,0,1,0
16,1159,0,0,139,139,0,1,0,1,0
9993,1215,0,0,66,66,0,1,0,1,0
612,139,0,0,60,60,0,1,0,1,0
11511,1472,0,0,66,66,0,1,0,1,0
16043,18,0,0,60,60,0,1,0,1,0
17636,2587,0,0,65,65,0,1,0,1,0
2720,1164,0,0,64,64,0,1,0,1,0
2957,389,0,0,60,60,0,1,0,1,0
386,797,0,0,62,62,0,1,0,1,0
18629,1176,0,0,64,64,0,1,0,1,0
13081,1782,0,0,62,62,0,1,0,1,0
2833,1888,0,0,62,62,0,1,0,1,0
19,1147,0,0,146,146,0,1,0,1,0
1313,1004,0,0,62,62,0,1,0,1,0
10078,2274,0,0,65,65,0,1,0,1,0
17080,2618,0,0,63,63,0,1,0,1,0
10717,1105,0,0,66,66,0,1,0,1,0
9263,1535,0,0,66,66,0,1,0,1,0
10582,2256,0,0,64,64,0,1,0,1,0
13238,1880,0,0,66,66,0,1,0,1,0
14135,3213,0,0,62,62,0,1,0,1,0
15501,2909,0,0,64,64,0,1,0,1,0
15669,2938,0,0,63,63,0,1,0,1,0
9210,3199,0,0,66,66,0,1,0,1,0
647,132,0,0,94,94,0,1,0,1,0
20385,1680,0,0,66,66,0,1,0,1,0
106,2596,0,0,145,145,0,1,0,1,0
22457,1888,0,0,63,63,0,1,0,1,0
3415,2587,0,0,62,62,0,1,0,1,0
1135,1215,0,0,62,62,0,1,0,1,0
16951,255,0,0,62,62,0,1,0,1,0
10514,2747,0,0,66,66,0,1,0,1,0
5040,2636,0,0,62,62,0,1,0,1,0
18,3216,0,0,62,62,0,1,0,1,0
3109,2893,0,0,65,65,0,1,0,1,0
12275,1017,0,0,146,146,0,1,0,1,0
17091,1147,0,0,113,113,0,1,0,1,0
5141,1883,0,0,145,145,0,1,0,1,0
18,2938,0,0,62,62,0,1,0,1,0
8,2758,0,0,60,60,0,1,0,1,0
1667,1147,0,0,62,62,0,1,0,1,0
2694,2587,0,0,62,62,0,1,0,1,0
21267,1876,0,0,63,63,0,1,0,1,0
704,1017,0,0,64,64,0,1,0,1,0
20885,1017,0,0,111,111,0,1,0,1,0
16951,255,0,0,62,62,0,1,0,1,0
22235,2953,0,0,64,64,0,1,0,1,0
1306,973,0,0,145,145,0,1,0,1,0
6506,697,0,0,62,62,0,1,0,1,0
9199,1017,0,0,66,66,0,1,0,1,0
607,2175,0,0,67,67,0,1,0,1,0
3034,2587,0,0,62,62,0,1,0,1,0
12225,1215,0,0,66,66,0,1,0,1,0
17260,2950,0,0,66,66,0,1,0,1,0
19212,999,0,0,63,63,0,1,0,1,0
3002,1936,0,0,62,62,0,1,0,1,0
16951,255,0,0,62,62,0,1,0,1,0
16951,255,0,0,62,62,0,1,0,1,0
3652,1017,0,0,62,62,0,1,0,1,0
2432,319,0,0,147,147,0,1,0,1,0
15452,1017,0,0,62,62,0,1,0,1,0
3672,7,0,0,60,60,0,1,0,1,0
13529,914,0,0,63,63,0,1,0,1,0
17788,2452,0,0,62,62,0,1,0,1,0
8,2791,0,0,67,67,0,1,0,1,0
20829,1888,0,0,62,62,0,1,0,1,0
584,1888,0,0,62,62,0,1,0,1,0
11175,1898,0,0,66,66,0,1,0,1,0
19171,1013,0,0,65,65,0,1,0,1,0
3632,2256,0,0,66,66,0,1,0,1,0
20306,775,0,0,66,66,0,1,0,1,0
9247,6,0,0,60,60,0,1,0,1,0
20911,2256,0,0,66,66,0,1,0,1,0
12880,2551,0,0,62,62,0,1,0,1,0
29,1888,0,0,62,62,0,1,0,1,0
12799,1462,0,0,64,64,0,1,0,1,0
11536,2256,0,0,65,65,0,1,0,1,0
1900,2938,0,0,62,62,0,1,0,1,0
12045,1797,0,0,66,66,0,1,0,1,0
20437,1873,0,0,62,62,0,1,0,1,0
9582,1147,0,0,65,65,0,1,0,1,0
16951,255,0,0,62,62,0,1,0,1,0
16951,255,0,0,62,62,0,1,0,1,0
718,2256,0,0,66,66,0,1,0,1,0
5403,1034,0,0,66,66,0,1,0,1,0
13263,1743,0,0,66,66,0,1,0,1,0
18970,1017,0,0,65,65,0,1,0,1,0
623,2636,0,0,63,63,0,1,0,1,0
3699,1895,0,0,63,63,0,1,0,1,0
2538,1781,0,0,145,145,0,1,0,1,0
14601,1017,0,0,66,66,0,1,0,1,0
9959,2724,0,0,63,63,0,1,0,1,0
14418,270,0,0,60,60,0,1,0,1,0
15675,1209,0,0,98,98,0,1,0,1,0
8164,2728,0,0,60,60,0,1,0,1,0
16951,255,0,0,62,62,0,1,0,1,0
10505,609,0,0,116,116,0,1,0,1,0
1687,1215,0,0,62,62,0,1,0,1,0
2091,3216,0,0,64,64,0,1,0,1,0
6478,2938,0,0,62,62,0,1,0,1,0
12195,995,0,0,64,64,0,1,0,1,0
2724,1888,0,0,62,62,0,1,0,1,0
25,3198,0,0,145,145,0,1,0,1,0
22439,1017,0,0,81,81,0,1,0,1,0
13544,106,0,0,60,60,0,1,0,1,0
14990,2592,0,0,62,62,0,1,0,1,0
7335,1070,0,0,60,60,0,1,0,1,0
12895,2573,0,0,65,65,0,1,0,1,0
6269,2477,0,0,60,60,0,1,0,1,0
1757,3216,0,0,63,63,0,1,0,1,0
21210,2574,0,0,62,62,0,1,0,1,0
5902,3043,0,0,62,62,0,1,0,1,0
7949,315,0,0,60,60,0,1,0,1,0
16565,2227,0,0,62,62,0,1,0,1,0
18035,2256,0,0,66,66,0,1,0,1,0
4047,1017,0,0,62,62,0,1,0,1,0
1794,1134,0,0,60,60,0,1,0,1,0
2989,1147,0,0,62,62,0,1,0,1,0
8514,3212,0,0,76,76,0,1,0,1,0
1992,3216,0,0,62,62,0,1,0,1,0
16951,255,0,0,62,62,0,1,0,1,0
3975,1017,0,0,62,62,0,1,0,1,0
8193,503,0,0,86,86,0,1,0,1,0
19992,3120,0,0,65,65,0,1,0,1,0
11927,2885,0,0,66,66,0,1,0,1,0
348,797,0,0,62,62,0,1,0,1,0
16233,1888,0,0,62,62,0,1,0,1,0
15539,1771,0,0,63,63,0,1,0,1,0
2218,2636,0,0,62,62,0,1,0,1,0
858,1214,0,0,60,60,0,1,0,1,0
8115,2573,0,0,62,62,0,1,0,1,0
15289,1151,0,0,62,62,0,1,0,1,0
7425,3216,0,0,62,62,0,1,0,1,0
10390,2248,0,0,66,66,0,1,0,1,0
15667,2938,0,0,63,63,0,1,0,1,0
636,1790,0,0,62,62,0,1,0,1,0
5246,1017,0,0,62,62,0,1,0,1,0
2189,2256,0,0,65,65,0,1,0,1,0
13296,1162,0,0,66,66,0,1,0,1,0
14245,2883,0,0,66,66,0,1,0,1,0
16951,255,0,0,62,62,0,1,0,1,0
1617,1827,0,0,62,62,0,1,0,1,0
21091,3216,0,0,66,66,0,1,0,1,0
2157,3072,0,0,60,60,0,1,0,1,0
1304,2636,0,0,62,62,0,1,0,1,0
2972,2636,0,0,146,146,0,1,0,1,0
17024,2633,0,0,65,65,0,1,0,1,0
5414,1125,0,0,66,66,0,1,0,1,0
19649,509,0,0,63,63,0,1,0,1,0
642,698,0,0,95,95,0,1,0,1,0
1585,2159,0,0,65,65,0,1,0,1,0
725,2256,0,0,66,66,0,1,0,1,0
13628,3004,0,0,70,70,0,1,0,1,0
2677,1147,0,0,64,64,0,1,0,1,0
763,1888,0,0,62,62,0,1,0,1,0
11457,1784,0,0,68,68,0,1,0,1,0
19840,2256,0,0,64,64,0,1,0,1,0
21900,1869,0,0,66,66,0,1,0,1,0
1234,1590,0,0,62,62,0,1,0,1,0
18792,1831,0,0,65,65,0,1,0,1,0
407,2636,0,0,63,63,0,1,0,1,0
1513,2943,0,0,62,62,0,1,0,1,0
632,2154,0,0,62,62,0,1,0,1,0
761,2938,0,0,62,62,0,1,0,1,0
13663,1857,0,0,106,106,0,1,0,1,0
2279,2636,0,0,62,62,0,1,0,1,0
16951,255,0,0,62,62,0,1,0,1,0
636,280,0,0,146,146,0,1,0,1,0
239,1888,0,0,62,62,0,1,0,1,0
16951,255,0,0,62,62,0,1,0,1,0
8999,91,0,0,61,61,0,1,0,1,0
21302,1147,0,0,62,62,0,1,0,1,0
16827,509,0,0,66,66,0,1,0,1,0
20571,1771,0,0,62,62,0,1,0,1,0
4891,469,0,0,85,85,0,1,0,1,0
4356,1472,0,0,66,66,0,1,0,1,0
382,1147,0,0,62,62,0,1,0,1,0
16951,255,0,0,62,62,0,1,0,1,0
16951,255,0,0,62,62,0,1,0,1,0
19428,242,0,0,145,145,0,1,0,1,0
13334,292,0,0,66,66,0,1,0,1,0
10475,6,0,0,60,60,0,1,0,1,0
1265,1216,0,0,61,61,0,1,0,1,0
16951,255,0,0,62,62,0,1,0,1,0
1815,1147,0,0,64,64,0,1,0,1,0
6411,2518,0,0,113,113,0,1,0,1,0
16951,255,0,0,62,62,0,1,0,1,0
17440,3156,0,0,66,66,0,1,0,1,0
9638,1017,0,0,65,65,0,1,0,1,0
9921,1805,0,0,62,62,0,1,0,1,0
19485,1888,0,0,66,66,0,1,0,1,0
19584,1771,0,0,66,66,0,1,0,1,0
1896,1775,0,0,62,62,0,1,0,1,0
16259,690,0,0,66,66,0,1,0,1,0
8807,2577,0,0,63,63,0,1,0,1,0
18204,2599,0,0,62,62,0,1,0,1,0
3023,2256,0,0,62,62,0,1,0,1,0
18439,769,0,0,65,65,0,1,0,1,0
22214,2938,0,0,78,78,0,1,0,1,0
6395,1215,0,0,62,62,0,1,0,1,0
2850,2622,0,0,64,64,0,1,0,1,0
16951,255,0,0,62,62,0,1,0,1,0
4163,1771,0,0,62,62,0,1,0,1,0
16951,255,0,0,62,62,0,1,0,1,0
9792,2587,0,0,67,67,0,1,0,1,0
9442,1017,0,0,65,65,0,1,0,1,0
2341,1147,0,0,146,146,0,1,0,1,0
310,3216,0,0,65,65,0,1,0,1,0
2621,1287,0,0,65,65,0,1,0,1,0
5042,1017,0,0,62,62,0,1,0,1,0
1442,2527,0,0,62,62,0,1,0,1,0
20265,1147,0,0,64,64,0,1,0,1,0
8,2758,0,0,60,60,0,1,0,1,0
3057,1215,0,0,64,64,0,1,0,1,0
0,0,0,0,98,98,0,1,0,1,0
16776,2893,0,0,66,66,0,1,0,1,0
8985,1166,0,0,62,62,0,1,0,1,0
11027,2939,0,0,66,66,0,1,0,1,0
3061,2256,0,0,64,64,0,1,0,1,0
6805,280,0,0,113,113,0,1,0,1,0
1717,2636,0,0,62,62,0,1,0,1,0
464,1888,0,0,66,66,0,1,0,1,0
12,2553,0,0,82,82,0,1,0,1,0
150,3168,0,0,66,66,0,1,0,1,0
17083,1118,0,0,62,62,0,1,0,1,0
10688,1213,0,0,62,62,0,1,0,1,0
15521,5,0,0,60,60,0,1,0,1,0
2658,1147,0,0,66,66,0,1,0,1,0
3861,1211,0,0,62,62,0,1,0,1,0
22200,2573,0,0,66,66,0,1,0,1,0
2211,2567,0,0,66,66,0,1,0,1,0
18805,1850,0,0,64,64,0,1,0,1,0
5,3,0,0,60,60,0,1,0,1,0
10172,1827,0,0,66,66,0,1,0,1,0
13323,245,0,0,64,64,0,1,0,1,0
16951,255,0,0,62,62,0,1,0,1,0
41,3034,0,0,145,145,0,1,0,1,0
22444,2595,0,0,62,62,0,1,0,1,0
11644,319,0,0,65,65,0,1,0,1,0
18246,1512,0,0,63,63,0,1,0,1,0
16951,255,0,0,62,62,0,1,0,1,0
7872,274,0,0,60,60,0,1,0,1,0
12505,1026,0,0,66,66,0,1,0,1,0
18489,2938,0,0,62,62,0,1,0,1,0
3201,2613,0,0,146,146,0,1,0,1,0
22468,201,0,0,78,78,0,1,0,1,0
5067,1147,0,0,62,62,0,1,0,1,0
7115,2264,0,0,66,66,0,1,0,1,0
1782,2883,0,0,64,64,0,1,0,1,0
427,1215,0,0,66,66,0,1,0,1,0
15087,833,0,0,63,63,0,1,0,1,0
2403,7,0,0,60,60,0,1,0,1,0
14493,308,0,0,62,62,0,1,0,1,0
417,1771,0,0,64,64,0,1,0,1,0
21988,2625,0,0,62,62,0,1,0,1,0
11591,723,0,0,62,62,0,1,0,1,0
3026,2584,0,0,62,62,0,1,0,1,0
16076,1472,0,0,66,66,0,1,0,1,0
12181,1878,0,0,62,62,0,1,0,1,0
4073,1017,0,0,62,62,0,1,0,1,0
20055,2587,0,0,64,64,0,1,0,1,0
15457,1017,0,0,62,62,0,1,0,1,0
9273,6,0,0,60,60,0,1,0,1,0
16951,255,0,0,62,62,0,1,0,1,0
20338,1885,0,0,64,64,0,1,0,1,0
16951,255,0,0,62,62,0,1,0,1,0
835,2140,0,0,145,145,0,1,0,1,0
2179,1114,0,0,62,62,0,1,0,1,0
9243,1224,0,0,62,62,0,1,0,1,0
16718,2588,0,0,139,139,0,1,0,1,0
1805,2841,0,0,64,64,0,1,0,1,0
9464,2222,0,0,63,63,0,1,0,1,0
19097,1888,0,0,65,65,0,1,0,1,0
21187,2256,0,0,64,64,0,1,0,1,0
10826,3172,0,0,63,63,0,1,0,1,0
22407,2601,0,0,62,62,0,1,0,1,0
496,228,0,0,217,217,0,1,0,1,0
1178,1167,0,0,62,62,0,1,0,1,0
4750,1837,0,0,62,62,0,1,0,1,0
11906,3214,0,0,66,66,0,1,0,1,0
1101,96,0,0,60,60,0,1,0,1,0
19408,1880,0,0,66,66,0,1,0,1,0
18286,10,0,0,60,60,0,1,0,1,0
17350,509,0,0,65,65,0,1,0,1,0
18316,1017,0,0,62,62,0,1,0,1,0
11450,245,0,0,60,60,0,1,0,1,0
475,1888,0,0,66,66,0,1,0,1,0
22258,2622,0,0,63,63,0,1,0,1,0
1443,2512,0,0,62,62,0,1,0,1,0
20333,3139,0,0,63,63,0,1,0,1,0
16951,255,0,0,62,62,0,1,0,1,0
18319,2294,0,0,66,66,0,1,0,1,0
3037,2580,0,0,145,145,0,1,0,1,0
684,2938,0,0,62,62,0,1,0,1,0
12279,1017,0,0,146,146,0,1,0,1,0
20575,1057,0,0,63,63,0,1,0,1,0
3260,1017,0,0,66,66,0,1,0,1,0
21873,2205,0,0,62,62,0,1,0,1,0
299,302,0,0,62,62,0,1,0,1,0
2560,1154,0,0,64,64,0,1,0,1,0
612,21,0,0,60,60,0,1,0,1,0
1183,1546,0,0,134,134,0,1,0,1,0
5186,1888,0,0,62,62,0,1,0,1,0
2084,1471,0,0,145,145,0,1,0,1,0
7335,1070,0,0,60,60,0,1,0,1,0
21500,2587,0,0,66,66,0,1,0,1,0
254,2608,0,0,64,64,0,1,0,1,0
12154,3212,0,0,64,64,0,1,0,1,0
19145,992,0,0,66,66,0,1,0,1,0
6651,1129,0,0,156,156,0,1,0,1,0
4339,1473,0,0,86,86,0,1,0,1,0
11537,2256,0,0,62,62,0,1,0,1,0
2579,5,0,0,60,60,0,1,0,1,0
8593,3233,0,0,94,94,0,1,0,1,0
9279,106,0,0,66,66,0,1,0,1,0
8,2971,0,0,1507,1507,0,1,0,1,0
16089,1774,0,0,65,65,0,1,0,1,0
6229,2938,0,0,78,78,0,1,0,1,0
3704,459,0,0,93,93,0,1,0,1,0
20424,1798,0,0,62,62,0,1,0,1,0
305,2256,0,0,62,62,0,1,0,1,0
11666,2657,0,0,65,65,0,1,0,1,0
1270,1045,0,0,65,65,0,1,0,1,0
12075,3136,0,0,62,62,0,1,0,1,0
3114,1888,0,0,62,62,0,1,0,1,0
16951,255,0,0,62,62,0,1,0,1,0
968,1818,0,0,66,66,0,1,0,1,0
16098,2598,0,0,66,66,0,1,0,1,0
6048,2883,0,0,65,65,0,1,0,1,0
2089,3216,0,0,62,62,0,1,0,1,0
1327,2636,0,0,66,66,0,1,0,1,0
2084,1471,0,0,145,145,0,1,0,1,0
6880,1183,0,0,63,63,0,1,0,1,0
10391,3216,0,0,66,66,0,1,0,1,0
9,2760,0,0,60,60,0,1,0,1,0
2480,312,0,0,63,63,0,1,0,1,0
30,1888,0,0,62,62,0,1,0,1,0
5992,1892,0,0,93,93,0,1,0,1,0
18949,2561,0,0,95,95,0,1,0,1,0
129,1472,0,0,64,64,0,1,0,1,0
12088,1472,0,0,66,66,0,1,0,1,0
2023,2907,0,0,74,74,0,1,0,1,0
562,1215,0,0,62,62,0,1,0,1,0
15364,1775,0,0,62,62,0,1,0,1,0
16041,1479,0,0,66,66,0,1,0,1,0
2751,2612,0,0,71,71,0,1,0,1,0
20622,1799,0,0,62,62,0,1,0,1,0
5803,2587,0,0,133,133,0,1,0,1,0
1740,2910,0,0,145,145,0,1,0,1,0
11176,1911,0,0,66,66,0,1,0,1,0
2191,1000,0,0,102,102,0,1,0,1,0
7984,1017,0,0,66,66,0,1,0,1,0
17577,363,0,0,61,61,0,1,0,1,0
5696,1111,0,0,72,72,0,1,0,1,0
6976,2354,0,0,72,72,0,1,0,1,0
2529,1017,0,0,66,66,0,1,0,1,0
13890,1887,0,0,136,136,0,1,0,1,0
8648,2902,0,0,62,62,0,1,0,1,0
2335,2486,0,0,62,62,0,1,0,1,0
16951,255,0,0,62,62,0,1,0,1,0
20553,1888,0,0,66,66,0,1,0,1,0
3155,2590,0,0,62,62,0,1,0,1,0
10572,2587,0,0,62,62,0,1,0,1,0
3247,3212,0,0,64,64,0,1,0,1,0
7375,1594,0,0,74,74,0,1,0,1,0
13070,1872,0,0,66,66,0,1,0,1,0
12636,2252,0,0,66,66,0,1,0,1,0
11650,2688,0,0,66,66,0,1,0,1,0
606,2176,0,0,67,67,0,1,0,1,0
11481,1830,0,0,63,63,0,1,0,1,0
3890,1201,0,0,62,62,0,1,0,1,0
14079,1147,0,0,65,65,0,1,0,1,0
3184,1472,0,0,62,62,0,1,0,1,0
16373,1472,0,0,62,62,0,1,0,1,0
15220,2486,0,0,62,62,0,1,0,1,0
1690,1888,0,0,63,63,0,1,0,1,0
2084,1471,0,0,145,145,0,1,0,1,0
11399,1105,0,0,66,66,0,1,0,1,0
742,147,0,0,66,66,0,1,0,1,0
8533,2634,0,0,65,65,0,1,0,1,0
10781,1888,0,0,66,66,0,1,0,1,0
4108,958,0,0,63,63,0,1,0,1,0
3201,2938,0,0,60,60,0,1,0,1,0
4379,1784,0,0,62,62,0,1,0,1,0
432,2587,0,0,62,62,0,1,0,1,0
4338,2904,0,0,94,94,0,1,0,1,0
3140,6,0,0,60,60,0,1,0,1,0
2653,3216,0,0,62,62,0,1,0,1,0
15967,1131,0,0,62,62,0,1,0,1,0
20552,3216,0,0,66,66,0,1,0,1,0
15694,1515,0,0,145,145,0,1,0,1,0
2423,7,0,0,60,60,0,1,0,1,0
16951,255,0,0,62,62,0,1,0,1,0
16951,255,0,0,62,62,0,1,0,1,0
2260,1017,0,0,62,62,0,1,0,1,0
7339,170,0,0,60,60,0,1,0,1,0
8171,1073,0,0,60,60,0,1,0,1,0
3060,1888,0,0,72,72,0,1,0,1,0
12,528,0,0,72,72,0,1,0,1,0
11988,1147,0,0,66,66,0,1,0,1,0
3223,383,0,0,64,64,0,1,0,1,0
220,1771,0,0,62,62,0,1,0,1,0
19346,895,0,0,64,64,0,1,0,1,0
3211,697,0,0,65,65,0,1,0,1,0
8065,1147,0,0,62,62,0,1,0,1,0
1495,2853,0,0,65,65,0,1,0,1,0
580,2636,0,0,66,66,0,1,0,1,0
10796,2621,0,0,66,66,0,1,0,1,0
1376,1147,0,0,62,62,0,1,0,1,0
1461,1147,0,0,62,62,0,1,0,1,0
15457,1017,0,0,62,62,0,1,0,1,0
640,1680,0,0,155,155,0,1,0,1,0
3700,464,0,0,90,90,0,1,0,1,0
16951,255,0,0,62,62,0,1,0,1,0
7529,298,0,0,60,60,0,1,0,1,0
2589,6,0,0,60,60,0,1,0,1,0
20192,1147,0,0,64,64,0,1,0,1,0
764,2256,0,0,64,64,0,1,0,1,0
11719,1147,0,0,66,66,0,1,0,1,0
12,194,0,0,91,91,0,1,0,1,0
5704,1103,0,0,78,78,0,1,0,1,0
17746,2883,0,0,63,63,0,1,0,1,0
16951,255,0,0,62,62,0,1,0,1,0
19700,2541,0,0,64,64,0,1,0,1,0
5261,2743,0,0,143,143,0,1,0,1,0
8221,2587,0,0,62,62,0,1,0,1,0
21786,2577,0,0,91,91,0,1,0,1,0
160,1888,0,0,62,62,0,1,0,1,0
14930,3139,0,0,64,64,0,1,0,1,0
5193,1888,0,0,62,62,0,1,0,1,0
16951,255,0,0,62,62,0,1,0,1,0
16951,255,0,0,62,62,0,1,0,1,0
13071,168,0,0,60,60,0,1,0,1,0
1940,1147,0,0,62,62,0,1,0,1,0
14264,1505,0,0,66,66,0,1,0,1,0
12888,1811,0,0,62,62,0,1,0,1,0
1721,2636,0,0,66,66,0,1,0,1,0
1153,1581,0,0,65,65,0,1,0,1,0
22113,1839,0,0,64,64,0,1,0,1,0
14881,1804,0,0,66,66,0,1,0,1,0
6061,2587,0,0,145,145,0,1,0,1,0
16478,344,0,0,60,60,0,1,0,1,0
16951,255,0,0,62,62,0,1,0,1,0
3868,1017,0,0,62,62,0,1,0,1,0
11715,2938,0,0,76,76,0,1,0,1,0
12,964,0,0,97,97,0,1,0,1,0
9359,2256,0,0,69,69,0,1,0,1,0
19285,3216,0,0,64,64,0,1,0,1,0
6651,1129,0,0,156,156,0,1,0,1,0
1597,3141,0,0,65,65,0,1,0,1,0
1707,1804,0,0,62,62,0,1,0,1,0
18314,2587,0,0,66,66,0,1,0,1,0
11354,3212,0,0,66,66,0,1,0,1,0
5278,2256,0,0,65,65,0,1,0,1,0
360,3105,0,0,995,995,0,1,0,1,0
236,1054,0,0,63,63,0,1,0,1,0
13226,2920,0,0,62,62,0,1,0,1,0
16951,255,0,0,62,62,0,1,0,1,0
8414,2623,0,0,64,64,0,1,0,1,0
196,1771,0,0,66,66,0,1,0,1,0
6651,1129,0,0,156,156,0,1,0,1,0
8566,509,0,0,65,65,0,1,0,1,0
7961,715,0,0,62,62,0,1,0,1,0
17269,1458,0,0,65,65,0,1,0,1,0
12281,1080,0,0,146,146,0,1,0,1,0
19617,2557,0,0,66,66,0,1,0,1,0
2004,2256,0,0,65,65,0,1,0,1,0
17425,2940,0,0,66,66,0,1,0,1,0
14865,2697,0,0,62,62,0,1,0,1,0
2499,410,0,0,145,145,0,1,0,1,0
494,1544,0,0,64,64,0,1,0,1,0
1514,1771,0,0,63,63,0,1,0,1,0
2795,1014,0,0,66,66,0,1,0,1,0
12,1052,0,0,98,98,0,1,0,1,0
304,3106,0,0,679,679,0,1,0,1,0
16951,255,0,0,62,62,0,1,0,1,0
2084,1471,0,0,145,145,0,1,0,1,0
8613,509,0,0,63,63,0,1,0,1,0
1426,483,0,0,67,67,0,1,0,1,0
1330,804,0,0,62,62,0,1,0,1,0
11817,455,0,0,63,63,0,1,0,1,0
6399,1215,0,0,62,62,0,1,0,1,0
2228,2621,0,0,62,62,0,1,0,1,0
1479,1147,0,0,62,62,0,1,0,1,0
24,3216,0,0,62,62,0,1,0,1,0
1428,2609,0,0,62,62,0,1,0,1,0
3876,1923,0,0,62,62,0,1,0,1,0
17542,2938,0,0,74,74,0,1,0,1,0
7156,1147,0,0,62,62,0,1,0,1,0
8742,1007,0,0,64,64,0,1,0,1,0
15099,1590,0,0,62,62,0,1,0,1,0
1754,1881,0,0,146,146,0,1,0,1,0
2514,2942,0,0,67,67,0,1,0,1,0
3260,1017,0,0,66,66,0,1,0,1,0
1719,7,0,0,60,60,0,1,0,1,0
16951,255,0,0,62,62,0,1,0,1,0
2432,1880,0,0,62,62,0,1,0,1,0
6195,2788,0,0,60,60,0,1,0,1,0
16794,1472,0,0,66,66,0,1,0,1,0
8349,1147,0,0,66,66,0,1,0,1,0
820,1672,0,0,60,60,0,1,0,1,0
8742,255,0,0,60,60,0,1,0,1,0
14877,1804,0,0,63,63,0,1,0,1,0
2824,1147,0,0,146,146,0,1,0,1,0
12831,1147,0,0,65,65,0,1,0,1,0
360,3105,0,0,166,166,0,1,0,1,0
5786,810,0,0,69,69,0,1,0,1,0
12502,1040,0,0,66,66,0,1,0,1,0
2757,3216,0,0,62,62,0,1,0,1,0
14585,1170,0,0,62,62,0,1,0,1,0
3988,697,0,0,74,74,0,1,0,1,0
10203,2587,0,0,66,66,0,1,0,1,0
11462,1783,0,0,68,68,0,1,0,1,0
381,3216,0,0,63,63,0,1,0,1,0
14838,2836,0,0,66,66,0,1,0,1,0
16951,255,0,0,62,62,0,1,0,1,0
8235,1147,0,0,63,63,0,1,0,1,0
5784,2587,0,0,117,117,0,1,0,1,0
6364,2546,0,0,61,61,0,1,0,1,0
20487,2627,0,0,66,66,0,1,0,1,0
7326,180,0,0,60,60,0,1,0,1,0
16478,303,0,0,60,60,0,1,0,1,0
21912,1822,0,0,63,63,0,1,0,1,0
1309,1017,0,0,62,62,0,1,0,1,0
2369,2598,0,0,146,146,0,1,0,1,0
1198,2256,0,0,64,64,0,1,0,1,0
6938,1147,0,0,66,66,0,1,0,1,0
1717,1823,0,0,65,65,0,1,0,1,0
3144,7,0,0,60,60,0,1,0,1,0
1231,983,0,0,62,62,0,1,0,1,0
1322,799,0,0,62,62,0,1,0,1,0
1932,2256,0,0,66,66,0,1,0,1,0
16951,255,0,0,62,62,0,1,0,1,0
10448,2883,0,0,63,63,0,1,0,1,0
14797,2621,0,0,64,64,0,1,0,1,0
1477,2628,0,0,62,62,0,1,0,1,0
2087,3216,0,0,62,62,0,1,0,1,0
2543,1795,0,0,62,62,0,1,0,1,0
20937,1472,0,0,63,63,0,1,0,1,0
1395,1065,0,0,146,146,0,1,0,1,0
5550,1040,0,0,62,62,0,1,0,1,0
5033,1017,0,0,62,62,0,1,0,1,0
10052,3057,0,0,66,66,0,1,0,1,0
4909,2597,0,0,63,63,0,1,0,1,0
1551,2636,0,0,62,62,0,1,0,1,0
1367,2883,0,0,63,63,0,1,0,1,0
22227,1887,0,0,66,66,0,1,0,1,0
18931,1165,0,0,90,90,0,1,0,1,0
154,3216,0,0,62,62,0,1,0,1,0
13531,104,0,0,60,60,0,1,0,1,0
360,3105,0,0,891,891,0,1,0,1,0
13601,1147,0,0,63,63,0,1,0,1,0
20752,2603,0,0,62,62,0,1,0,1,0
21038,3216,0,0,65,65,0,1,0,1,0
4344,3216,0,0,62,62,0,1,0,1,0
2061,3216,0,0,62,62,0,1,0,1,0
2620,1210,0,0,62,62,0,1,0,1,0
2485,2594,0,0,146,146,0,1,0,1,0
7326,1649,0,0,60,60,0,1,0,1,0
6165,8,0,0,74,74,0,1,0,1,0
19821,2886,0,0,65,65,0,1,0,1,0
7908,1147,0,0,62,62,0,1,0,1,0
21670,346,0,0,63,63,0,1,0,1,0
16788,813,0,0,66,66,0,1,0,1,0
21619,1017,0,0,66,66,0,1,0,1,0
21637,2908,0,0,71,71,0,1,0,1,0
271,804,0,0,65,65,0,1,0,1,0
14505,2312,0,0,78,78,0,1,0,1,0
5189,1017,0,0,66,66,0,1,0,1,0
11985,1134,0,0,63,63,0,1,0,1,0
16951,255,0,0,62,62,0,1,0,1,0
21410,3037,0,0,62,62,0,1,0,1,0
16951,255,0,0,62,62,0,1,0,1,0
16951,255,0,0,62,62,0,1,0,1,0
16444,2881,0,0,90,90,0,1,0,1,0
21279,2256,0,0,64,64,0,1,0,1,0
9504,1771,0,0,63,63,0,1,0,1,0
3135,1750,0,0,145,145,0,1,0,1,0
17716,2913,0,0,66,66,0,1,0,1,0
1534,2256,0,0,63,63,0,1,0,1,0
15537,2222,0,0,62,62,0,1,0,1,0
22,3216,0,0,62,62,0,1,0,1,0
585,700,0,0,125,125,0,1,0,1,0
7528,3216,0,0,62,62,0,1,0,1,0
16951,255,0,0,62,62,0,1,0,1,0
13793,509,0,0,66,66,0,1,0,1,0
22684,161,0,0,60,60,0,1,0,1,0
1838,2584,0,0,62,62,0,1,0,1,0
2468,2643,0,0,62,62,0,1,0,1,0
14632,2626,0,0,131,131,0,1,0,1,0
412,1147,0,0,62,62,0,1,0,1,0
1611,2611,0,0,66,66,0,1,0,1,0
6754,268,0,0,105,105,0,1,0,1,0
17882,2240,0,0,64,64,0,1,0,1,0
1446,506,0,0,146,146,0,1,0,1,0
15059,482,0,0,69,69,0,1,0,1,0
7076,1888,0,0,62,62,0,1,0,1,0
4356,1472,0,0,66,66,0,1,0,1,0
16951,255,0,0,62,62,0,1,0,1,0
1525,1444,0,0,145,145,0,1,0,1,0
8,2758,0,0,60,60,0,1,0,1,0
0,0,0,0,98,98,0,1,0,1,0
1281,2543,0,0,60,60,0,1,0,1,0
19586,2256,0,0,65,65,0,1,0,1,0
1988,3216,0,0,62,62,0,1,0,1,0
16793,2256,0,0,62,62,0,1,0,1,0
13135,2536,0,0,153,153,0,1,0,1,0
11105,2680,0,0,64,64,0,1,0,1,0
2438,2486,0,0,159,159,0,1,0,1,0
1230,983,0,0,62,62,0,1,0,1,0
1413,1888,0,0,64,64,0,1,0,1,0
16568,2224,0,0,64,64,0,1,0,1,0
8,2758,0,0,60,60,0,1,0,1,0
637,2820,0,0,145,145,0,1,0,1,0
2095,2256,0,0,62,62,0,1,0,1,0
17803,2618,0,0,62,62,0,1,0,1,0
1669,1147,0,0,146,146,0,1,0,1,0
21995,3216,0,0,66,66,0,1,0,1,0
13090,1351,0,0,140,140,0,1,0,1,0
844,276,0,0,65,65,0,1,0,1,0
20565,2354,0,0,75,75,0,1,0,1,0
13026,1817,0,0,64,64,0,1,0,1,0
2776,1017,0,0,146,146,0,1,0,1,0
190,2938,0,0,78,78,0,1,0,1,0
5527,1210,0,0,62,62,0,1,0,1,0
3876,1923,0,0,62,62,0,1,0,1,0
3978,2207,0,0,64,64,0,1,0,1,0
10387,3216,0,0,64,64,0,1,0,1,0
7335,1072,0,0,60,60,0,1,0,1,0
7335,1072,0,0,60,60,0,1,0,1,0
690,2603,0,0,62,62,0,1,0,1,0
18293,11,0,0,65,65,0,1,0,1,0
6994,2631,0,0,62,62,0,1,0,1,0
21633,1888,0,0,66,66,0,1,0,1,0
5709,1215,0,0,62,62,0,1,0,1,0
22586,297,0,0,62,62,0,1,0,1,0
1438,2486,0,0,62,62,0,1,0,1,0
16951,255,0,0,62,62,0,1,0,1,0
20699,2697,0,0,78,78,0,1,0,1,0
190,2938,0,0,78,78,0,1,0,1,0
14660,996,0,0,66,66,0,1,0,1,0
6915,2587,0,0,62,62,0,1,0,1,0
1321,1498,0,0,147,147,0,1,0,1,0
22683,10,0,0,88,88,0,1,0,1,0
18887,3216,0,0,73,73,0,1,0,1,0
21565,1888,0,0,71,71,0,1,0,1,0
19632,509,0,0,66,66,0,1,0,1,0
14918,1017,0,0,62,62,0,1,0,1,0
15199,2213,0,0,66,66,0,1,0,1,0
8645,2883,0,0,62,62,0,1,0,1,0
18720,2590,0,0,66,66,0,1,0,1,0
21409,1147,0,0,62,62,0,1,0,1,0
1289,2256,0,0,64,64,0,1,0,1,0
16731,1086,0,0,66,66,0,1,0,1,0
15944,1147,0,0,146,146,0,1,0,1,0
20274,2938,0,0,64,64,0,1,0,1,0
12,447,0,0,60,60,0,1,0,1,0
19215,997,0,0,66,66,0,1,0,1,0
8065,1147,0,0,62,62,0,1,0,1,0
16835,1888,0,0,64,64,0,1,0,1,0
7034,1215,0,0,62,62,0,1,0,1,0
12107,2885,0,0,62,62,0,1,0,1,0
9957,2938,0,0,66,66,0,1,0,1,0
7304,1147,0,0,75,75,0,1,0,1,0
11029,2940,0,0,66,66,0,1,0,1,0
12815,1468,0,0,66,66,0,1,0,1,0
11461,308,0,0,64,64,0,1,0,1,0
18,1779,0,0,62,62,0,1,0,1,0
22510,2611,0,0,78,78,0,1,0,1,0
12,2346,0,0,210,210,0,1,0,1,0
8114,2550,0,0,62,62,0,1,0,1,0
1749,1885,0,0,146,146,0,1,0,1,0
10756,3216,0,0,66,66,0,1,0,1,0
27,1215,0,0,62,62,0,1,0,1,0
11450,1686,0,0,60,60,0,1,0,1,0
360,3105,0,0,164,164,0,1,0,1,0
9609,3120,0,0,75,75,0,1,0,1,0
649,2820,0,0,139,139,0,1,0,1,0
16951,255,0,0,62,62,0,1,0,1,0
1695,1215,0,0,62,62,0,1,0,1,0
9244,2938,0,0,66,66,0,1,0,1,0
385,2889,0,0,62,62,0,1,0,1,0
603,2179,0,0,68,68,0,1,0,1,0
2386,521,0,0,61,61,0,1,0,1,0
496,1317,0,0,66,66,0,1,0,1,0
16458,3155,0,0,66,66,0,1,0,1,0
5705,1100,0,0,74,74,0,1,0,1,0
18446,1787,0,0,63,63,0,1,0,1,0
2865,1017,0,0,62,62,0,1,0,1,0
21486,1136,0,0,79,79,0,1,0,1,0
7336,2256,0,0,104,104,0,1,0,1,0
2413,2093,0,0,146,146,0,1,0,1,0
16077,2256,0,0,62,62,0,1,0,1,0
6235,2938,0,0,70,70,0,1,0,1,0
4309,2587,0,0,120,120,0,1,0,1,0
20006,2530,0,0,93,93,0,1,0,1,0
14865,2697,0,0,62,62,0,1,0,1,0
10420,3216,0,0,66,66,0,1,0,1,0
16659,1771,0,0,64,64,0,1,0,1,0
710,2256,0,0,66,66,0,1,0,1,0
112,2256,0,0,62,62,0,1,0,1,0
146,3139,0,0,65,65,0,1,0,1,0
8354,1147,0,0,64,64,0,1,0,1,0
16902,2582,0,0,66,66,0,1,0,1,0
1233,983,0,0,65,65,0,1,0,1,0
3770,2932,0,0,66,66,0,1,0,1,0
15694,1787,0,0,145,145,0,1,0,1,0
5278,2256,0,0,64,64,0,1,0,1,0
12,1010,0,0,64,64,0,1,0,1,0
269,509,0,0,65,65,0,1,0,1,0
7338,234,0,0,60,60,0,1,0,1,0
13074,181,0,0,60,60,0,1,0,1,0
21147,1137,0,0,146,146,0,1,0,1,0
16478,300,0,0,60,60,0,1,0,1,0
14,1616,0,0,78,78,0,1,0,1,0
1620,3209,0,0,62,62,0,1,0,1,0
7339,334,0,0,60,60,0,1,0,1,0
12163,1869,0,0,66,66,0,1,0,1,0
12068,1208,0,0,62,62,0,1,0,1,0
833,2871,0,0,61,61,0,1,0,1,0
8110,2938,0,0,70,70,0,1,0,1,0
21854,2587,0,0,66,66,0,1,0,1,0
5669,2938,0,0,65,65,0,1,0,1,0
15981,1888,0,0,65,65,0,1,0,1,0
13767,326,0,0,62,62,0,1,0,1,0
3190,2873,0,0,62,62,0,1,0,1,0
12880,2551,0,0,62,62,0,1,0,1,0
9455,1017,0,0,66,66,0,1,0,1,0
19453,2897,0,0,66,66,0,1,0,1,0
427,1215,0,0,62,62,0,1,0,1,0
17361,1147,0,0,63,63,0,1,0,1,0
1178,1167,0,0,62,62,0,1,0,1,0
2207,2568,0,0,64,64,0,1,0,1,0
122,1469,0,0,62,62,0,1,0,1,0
7339,140,0,0,60,60,0,1,0,1,0
500,7,0,0,60,60,0,1,0,1,0
13012,1804,0,0,62,62,0,1,0,1,0
7458,3216,0,0,62,62,0,1,0,1,0
14238,1476,0,0,66,66,0,1,0,1,0
13283,1147,0,0,114,114,0,1,0,1,0
13562,2636,0,0,64,64,0,1,0,1,0
613,3219,0,0,63,63,0,1,0,1,0
5482,1831,0,0,63,63,0,1,0,1,0
1498,1173,0,0,62,62,0,1,0,1,0
2318,2592,0,0,62,62,0,1,0,1,0
29,1888,0,0,62,62,0,1,0,1,0
1333,697,0,0,62,62,0,1,0,1,0
16951,255,0,0,62,62,0,1,0,1,0
2103,154,0,0,62,62,0,1,0,1,0
21134,1814,0,0,65,65,0,1,0,1,0
14451,2151,0,0,62,62,0,1,0,1,0
16743,2594,0,0,63,63,0,1,0,1,0
21412,155,0,0,63,63,0,1,0,1,0
20039,1888,0,0,65,65,0,1,0,1,0
10645,1880,0,0,62,62,0,1,0,1,0
17320,2633,0,0,66,66,0,1,0,1,0
6229,2938,0,0,78,78,0,1,0,1,0
11651,1876,0,0,62,62,0,1,0,1,0
1753,2585,0,0,62,62,0,1,0,1,0
3062,1888,0,0,70,70,0,1,0,1,0
16350,1215,0,0,62,62,0,1,0,1,0
1465,1771,0,0,63,63,0,1,0,1,0
5912,2587,0,0,122,122,0,1,0,1,0
11741,1147,0,0,95,95,0,1,0,1,0
1281,2543,0,0,60,60,0,1,0,1,0
11951,3216,0,0,65,65,0,1,0,1,0
16951,255,0,0,62,62,0,1,0,1,0
2537,2609,0,0,63,63,0,1,0,1,0
20,3216,0,0,62,62,0,1,0,1,0
9181,1017,0,0,66,66,0,1,0,1,0
338,2256,0,0,72,72,0,1,0,1,0
5186,1888,0,0,62,62,0,1,0,1,0
16444,2881,0,0,90,90,0,1,0,1,0
7335,1070,0,0,60,60,0,1,0,1,0
12606,2636,0,0,66,66,0,1,0,1,0
3576,1920,0,0,127,127,0,1,0,1,0
19995,2254,0,0,66,66,0,1,0,1,0
12,295,0,0,61,61,0,1,0,1,0
7985,318,0,0,60,60,0,1,0,1,0
360,3105,0,0,252,252,0,1,0,1,0
6125,1778,0,0,62,62,0,1,0,1,0
17091,1147,0,0,62,62,0,1,0,1,0
3683,989,0,0,77,77,0,1,0,1,0
19008,2131,0,0,66,66,0,1,0,1,0
11757,2245,0,0,66,66,0,1,0,1,0
18037,2256,0,0,66,66,0,1,0,1,0
8156,2736,0,0,70,70,0,1,0,1,0
1576,2938,0,0,60,60,0,1,0,1,0
331,1025,0,0,66,66,0,1,0,1,0
6633,1771,0,0,62,62,0,1,0,1,0
16951,255,0,0,62,62,0,1,0,1,0
22664,2918,0,0,70,70,0,1,0,1,0
2506,2993,0,0,62,62,0,1,0,1,0
20678,2723,0,0,63,63,0,1,0,1,0
6552,2093,0,0,145,145,0,1,0,1,0
3876,1923,0,0,62,62,0,1,0,1,0
329,3216,0,0,62,62,0,1,0,1,0
16112,2611,0,0,64,64,0,1,0,1,0
7339,170,0,0,60,60,0,1,0,1,0
6241,1106,0,0,66,66,0,1,0,1,0
427,1215,0,0,62,62,0,1,0,1,0
15328,2256,0,0,62,62,0,1,0,1,0
810,1017,0,0,63,63,0,1,0,1,0
17805,2587,0,0,66,66,0,1,0,1,0
3030,1789,0,0,66,66,0,1,0,1,0
16951,255,0,0,62,62,0,1,0,1,0
29,1888,0,0,62,62,0,1,0,1,0
8892,3216,0,0,63,63,0,1,0,1,0
0,0,0,0,60,60,0,1,0,1,0
654,2678,0,0,88,88,0,1,0,1,0
18080,1888,0,0,66,66,0,1,0,1,0
14223,2194,0,0,67,67,0,1,0,1,0
9214,3256,0,0,60,60,0,1,0,1,0
1816,1144,0,0,61,61,0,1,0,1,0
10147,1043,0,0,64,64,0,1,0,1,0
18065,1801,0,0,66,66,0,1,0,1,0
2953,7,0,0,60,60,0,1,0,1,0
18,2256,0,0,62,62,0,1,0,1,0
12467,1793,0,0,63,63,0,1,0,1,0
16951,255,0,0,62,62,0,1,0,1,0
2447,2616,0,0,146,146,0,1,0,1,0
61,1888,0,0,62,62,0,1,0,1,0
13451,1828,0,0,66,66,0,1,0,1,0
16951,255,0,0,62,62,0,1,0,1,0
11900,2256,0,0,64,64,0,1,0,1,0
14643,1168,0,0,62,62,0,1,0,1,0
10347,747,0,0,100,100,0,1,0,1,0
14718,1888,0,0,64,64,0,1,0,1,0
1374,1888,0,0,62,62,0,1,0,1,0
16951,255,0,0,62,62,0,1,0,1,0
2509,2491,0,0,62,62,0,1,0,1,0
17322,460,0,0,60,60,0,1,0,1,0
2376,1147,0,0,146,146,0,1,0,1,0
14725,1881,0,0,66,66,0,1,0,1,0
6170,434,0,0,63,63,0,1,0,1,0
5819,234,0,0,60,60,0,1,0,1,0
22468,201,0,0,78,78,0,1,0,1,0
571,2607,0,0,62,62,0,1,0,1,0
2542,1904,0,0,60,60,0,1,0,1,0
1329,2636,0,0,66,66,0,1,0,1,0
20602,3216,0,0,66,66,0,1,0,1,0
702,2256,0,0,66,66,0,1,0,1,0
9232,874,0,0,64,64,0,1,0,1,0
1239,2256,0,0,66,66,0,1,0,1,0
5191,1017,0,0,64,64,0,1,0,1,0
4046,1763,0,0,94,94,0,1,0,1,0
17989,3207,0,0,70,70,0,1,0,1,0
17051,2611,0,0,62,62,0,1,0,1,0
16951,255,0,0,62,62,0,1,0,1,0
1401,2938,0,0,62,62,0,1,0,1,0
9460,1017,0,0,62,62,0,1,0,1,0
21547,1886,0,0,85,85,0,1,0,1,0
617,1888,0,0,66,66,0,1,0,1,0
160,1888,0,0,62,62,0,1,0,1,0
13951,2256,0,0,66,66,0,1,0,1,0
1263,2587,0,0,127,127,0,1,0,1,0
6548,1771,0,0,64,64,0,1,0,1,0
3500,7,0,0,60,60,0,1,0,1,0
3147,2587,0,0,64,64,0,1,0,1,0
3901,1890,0,0,62,62,0,1,0,1,0
20765,2938,0,0,66,66,0,1,0,1,0
636,280,0,0,62,62,0,1,0,1,0
17898,2883,0,0,66,66,0,1,0,1,0
13760,3201,0,0,66,66,0,1,0,1,0
1555,1004,0,0,62,62,0,1,0,1,0
107,1017,0,0,62,62,0,1,0,1,0
18285,2708,0,0,66,66,0,1,0,1,0
2847,2632,0,0,62,62,0,1,0,1,0
21481,2604,0,0,66,66,0,1,0,1,0
0,0,0,0,98,98,0,1,0,1,0
12,2492,0,0,75,75,0,1,0,1,0
9484,1888,0,0,66,66,0,1,0,1,0
364,280,0,0,66,66,0,1,0,1,0
18275,15,0,0,87,87,0,1,0,1,0
13849,1002,0,0,66,66,0,1,0,1,0
16951,255,0,0,62,62,0,1,0,1,0
360,3105,0,0,453,453,0,1,0,1,0
4724,1804,0,0,64,64,0,1,0,1,0
1607,1215,0,0,62,62,0,1,0,1,0
8,442,0,0,60,60,0,1,0,1,0
6734,2585,0,0,145,145,0,1,0,1,0
17499,983,0,0,63,63,0,1,0,1,0
3876,1923,0,0,62,62,0,1,0,1,0
18,3216,0,0,62,62,0,1,0,1,0
16951,255,0,0,62,62,0,1,0,1,0
14131,3212,0,0,66,66,0,1,0,1,0
16210,1404,0,0,60,60,0,1,0,1,0
82,7,0,0,60,60,0,1,0,1,0
21848,1822,0,0,66,66,0,1,0,1,0
1903,1036,0,0,64,64,0,1,0,1,0
14104,1017,0,0,87,87,0,1,0,1,0
2279,1147,0,0,62,62,0,1,0,1,0
16951,255,0,0,62,62,0,1,0,1,0
9424,1157,0,0,62,62,0,1,0,1,0
14847,1184,0,0,66,66,0,1,0,1,0
1591,1888,0,0,62,62,0,1,0,1,0
12,2461,0,0,81,81,0,1,0,1,0
19428,242,0,0,145,145,0,1,0,1,0
12766,2216,0,0,62,62,0,1,0,1,0
3180,519,0,0,75,75,0,1,0,1,0
16951,255,0,0,62,62,0,1,0,1,0
16951,255,0,0,62,62,0,1,0,1,0
800,2883,0,0,63,63,0,1,0,1,0
20796,2928,0,0,66,66,0,1,0,1,0
17,1822,0,0,128,128,0,1,0,1,0
7339,2845,0,0,60,60,0,1,0,1,0
19068,1888,0,0,62,62,0,1,0,1,0
1725,2881,0,0,145,145,0,1,0,1,0
11557,796,0,0,66,66,0,1,0,1,0
12,2456,0,0,90,90,0,1,0,1,0
3698,1017,0,0,62,62,0,1,0,1,0
21013,3216,0,0,63,63,0,1,0,1,0
12096,2587,0,0,66,66,0,1,0,1,0
11042,2949,0,0,66,66,0,1,0,1,0
17972,2256,0,0,66,66,0,1,0,1,0
6974,2352,0,0,72,72,0,1,0,1,0
2335,1147,0,0,146,146,0,1,0,1,0
20834,2636,0,0,66,66,0,1,0,1,0
21606,1821,0,0,63,63,0,1,0,1,0
12022,3074,0,0,63,63,0,1,0,1,0
2442,2695,0,0,66,66,0,1,0,1,0
21134,1811,0,0,66,66,0,1,0,1,0
266,1086,0,0,65,65,0,1,0,1,0
12582,1147,0,0,66,66,0,1,0,1,0
9819,2883,0,0,66,66,0,1,0,1,0
2086,26,0,0,60,60,0,1,0,1,0
271,3216,0,0,62,62,0,1,0,1,0
1538,1888,0,0,66,66,0,1,0,1,0
10627,2630,0,0,66,66,0,1,0,1,0
15330,2265,0,0,62,62,0,1,0,1,0
17670,3212,0,0,66,66,0,1,0,1,0
11354,3207,0,0,62,62,0,1,0,1,0
16951,255,0,0,62,62,0,1,0,1,0
2834,1888,0,0,62,62,0,1,0,1,0
13353,2256,0,0,69,69,0,1,0,1,0
16951,255,0,0,62,62,0,1,0,1,0
20070,1884,0,0,62,62,0,1,0,1,0
7697,1147,0,0,107,107,0,1,0,1,0
6506,697,0,0,62,62,0,1,0,1,0
612,2562,0,0,60,60,0,1,0,1,0
5972,1202,0,0,62,62,0,1,0,1,0
3718,1848,0,0,63,63,0,1,0,1,0
8326,3192,0,0,146,146,0,1,0,1,0
5042,1051,0,0,63,63,0,1,0,1,0
389,1215,0,0,66,66,0,1,0,1,0
3141,1474,0,0,65,65,0,1,0,1,0
17333,186,0,0,64,64,0,1,0,1,0
5146,1884,0,0,146,146,0,1,0,1,0
8,2758,0,0,60,60,0,1,0,1,0
12,2461,0,0,81,81,0,1,0,1,0
2584,1677,0,0,160,160,0,1,0,1,0
11354,3212,0,0,66,66,0,1,0,1,0
2931,7,0,0,60,60,0,1,0,1,0
16951,255,0,0,62,62,0,1,0,1,0
448,827,0,0,66,66,0,1,0,1,0
2084,1471,0,0,145,145,0,1,0,1,0
7009,1539,0,0,110,110,0,1,0,1,0
16951,255,0,0,62,62,0,1,0,1,0
338,2949,0,0,66,66,0,1,0,1,0
16951,255,0,0,62,62,0,1,0,1,0
8856,255,0,0,60,60,0,1,0,1,0
14015,3216,0,0,66,66,0,1,0,1,0
7569,3216,0,0,62,62,0,1,0,1,0
16951,255,0,0,62,62,0,1,0,1,0
11670,3216,0,0,62,62,0,1,0,1,0
18228,1771,0,0,66,66,0,1,0,1,0
3727,1142,0,0,65,65,0,1,0,1,0
21158,959,0,0,145,145,0,1,0,1,0
1211,1001,0,0,62,62,0,1,0,1,0
2413,1771,0,0,62,62,0,1,0,1,0
1444,2469,0,0,146,146,0,1,0,1,0
21084,1147,0,0,66,66,0,1,0,1,0
2289,437,0,0,62,62,0,1,0,1,0
12036,2591,0,0,66,66,0,1,0,1,0
2316,1147,0,0,62,62,0,1,0,1,0
4459,1052,0,0,65,65,0,1,0,1,0
9821,2887,0,0,66,66,0,1,0,1,0
59,1147,0,0,62,62,0,1,0,1,0
3601,2573,0,0,62,62,0,1,0,1,0
360,3105,0,0,164,164,0,1,0,1,0
2122,3216,0,0,62,62,0,1,0,1,0
1590,2,0,0,64,64,0,1,0,1,0
16951,255,0,0,62,62,0,1,0,1,0
16951,255,0,0,62,62,0,1,0,1,0
13090,1773,0,0,62,62,0,1,0,1,0
17809,2587,0,0,66,66,0,1,0,1,0
1330,697,0,0,62,62,0,1,0,1,0
10679,1215,0,0,62,62,0,1,0,1,0
15150,409,0,0,62,62,0,1,0,1,0
497,995,0,0,71,71,0,1,0,1,0
1604,1,0,0,65,65,0,1,0,1,0
6112,1771,0,0,62,62,0,1,0,1,0
7949,314,0,0,60,60,0,1,0,1,0
2942,509,0,0,85,85,0,1,0,1,0
360,3105,0,0,1294,1294,0,1,0,1,0
2536,1784,0,0,145,145,0,1,0,1,0
5554,22,0,0,60,60,0,1,0,1,0
4356,1472,0,0,66,66,0,1,0,1,0
18955,2500,0,0,66,66,0,1,0,1,0
4356,1472,0,0,66,66,0,1,0,1,0
1542,1888,0,0,62,62,0,1,0,1,0
17373,1922,0,0,71,71,0,1,0,1,0
22403,2604,0,0,65,65,0,1,0,1,0
76,2883,0,0,66,66,0,1,0,1,0
14609,2883,0,0,66,66,0,1,0,1,0
8955,1147,0,0,65,65,0,1,0,1,0
375,3216,0,0,62,62,0,1,0,1,0
9149,257,0,0,60,60,0,1,0,1,0
1823,2573,0,0,62,62,0,1,0,1,0
21074,2594,0,0,118,118,0,1,0,1,0
21140,1782,0,0,66,66,0,1,0,1,0
1443,2486,0,0,62,62,0,1,0,1,0
19693,1017,0,0,66,66,0,1,0,1,0
3060,1215,0,0,64,64,0,1,0,1,0
2534,10,0,0,60,60,0,1,0,1,0
400,2852,0,0,66,66,0,1,0,1,0
19264,1158,0,0,66,66,0,1,0,1,0
6286,1017,0,0,62,62,0,1,0,1,0
1280,7,0,0,60,60,0,1,0,1,0
614,246,0,0,60,60,0,1,0,1,0
3644,82,0,0,60,60,0,1,0,1,0
16115,2611,0,0,63,63,0,1,0,1,0
2827,2589,0,0,146,146,0,1,0,1,0
344,1763,0,0,62,62,0,1,0,1,0
2597,1771,0,0,64,64,0,1,0,1,0
21476,1147,0,0,66,66,0,1,0,1,0
44,2947,0,0,146,146,0,1,0,1,0
16951,255,0,0,62,62,0,1,0,1,0
16766,2930,0,0,66,66,0,1,0,1,0
2134,1888,0,0,62,62,0,1,0,1,0
2118,830,0,0,66,66,0,1,0,1,0
1981,2252,0,0,64,64,0,1,0,1,0
21066,1147,0,0,64,64,0,1,0,1,0
20397,1201,0,0,62,62,0,1,0,1,0
21262,1147,0,0,62,62,0,1,0,1,0
11,3099,0,0,1486,1486,0,1,0,1,0
4099,2477,0,0,62,62,0,1,0,1,0
18308,1472,0,0,66,66,0,1,0,1,0
16444,2881,0,0,90,90,0,1,0,1,0
2921,509,0,0,64,64,0,1,0,1,0
15260,2623,0,0,63,63,0,1,0,1,0
1774,1017,0,0,62,62,0,1,0,1,0
1281,2543,0,0,60,60,0,1,0,1,0
1355,2620,0,0,97,97,0,1,0,1,0
2306,431,0,0,63,63,0,1,0,1,0
9614,3105,0,0,86,86,0,1,0,1,0
9729,2607,0,0,64,64,0,1,0,1,0
22383,1472,0,0,66,66,0,1,0,1,0
19889,2930,0,0,72,72,0,1,0,1,0
487,1009,0,0,61,61,0,1,0,1,0
1614,4,0,0,62,62,0,1,0,1,0
7316,372,0,0,60,60,0,1,0,1,0
604,1888,0,0,64,64,0,1,0,1,0
9652,3216,0,0,64,64,0,1,0,1,0
498,2587,0,0,96,96,0,1,0,1,0
20261,2938,0,0,62,62,0,1,0,1,0
22020,2611,0,0,64,64,0,1,0,1,0
10283,2256,0,0,65,65,0,1,0,1,0
17243,3213,0,0,66,66,0,1,0,1,0
12638,2253,0,0,66,66,0,1,0,1,0
9004,80,0,0,63,63,0,1,0,1,0
7049,2938,0,0,68,68,0,1,0,1,0
6166,1367,0,0,82,82,0,1,0,1,0
18257,1771,0,0,66,66,0,1,0,1,0
1791,6,0,0,60,60,0,1,0,1,0
1912,2578,0,0,62,62,0,1,0,1,0
280,8,0,0,60,60,0,1,0,1,0
6562,1215,0,0,64,64,0,1,0,1,0
1780,2256,0,0,63,63,0,1,0,1,0
15170,1147,0,0,66,66,0,1,0,1,0
20682,2587,0,0,63,63,0,1,0,1,0
18008,787,0,0,63,63,0,1,0,1,0
1574,813,0,0,62,62,0,1,0,1,0
312,3216,0,0,62,62,0,1,0,1,0
2504,1147,0,0,62,62,0,1,0,1,0
20473,1015,0,0,66,66,0,1,0,1,0
3436,2663,0,0,64,64,0,1,0,1,0
16907,2583,0,0,66,66,0,1,0,1,0
14221,15,0,0,62,62,0,1,0,1,0
16951,255,0,0,62,62,0,1,0,1,0
10555,3216,0,0,66,66,0,1,0,1,0
1251,1590,0,0,62,62,0,1,0,1,0
300,2256,0,0,67,67,0,1,0,1,0
16951,255,0,0,62,62,0,1,0,1,0
684,2938,0,0,62,62,0,1,0,1,0
3466,242,0,0,145,145,0,1,0,1,0
8225,2598,0,0,64,64,0,1,0,1,0
8093,2256,0,0,86,86,0,1,0,1,0
438,2636,0,0,62,62,0,1,0,1,0
0,0,0,0,98,98,0,1,0,1,0
11302,2280,0,0,62,62,0,1,0,1,0
1227,509,0,0,66,66,0,1,0,1,0
2899,1888,0,0,62,62,0,1,0,1,0
11694,3216,0,0,66,66,0,1,0,1,0
2289,437,0,0,62,62,0,1,0,1,0
19320,3212,0,0,62,62,0,1,0,1,0
2054,1147,0,0,62,62,0,1,0,1,0
14730,2938,0,0,64,64,0,1,0,1,0
7270,1472,0,0,62,62,0,1,0,1,0
2482,3216,0,0,66,66,0,1,0,1,0
3319,2600,0,0,64,64,0,1,0,1,0
12494,3216,0,0,66,66,0,1,0,1,0
17115,1131,0,0,62,62,0,1,0,1,0
1913,2573,0,0,62,62,0,1,0,1,0
1804,1042,0,0,60,60,0,1,0,1,0
22357,1906,0,0,66,66,0,1,0,1,0
21352,1147,0,0,66,66,0,1,0,1,0
828,1491,0,0,60,60,0,1,0,1,0
1387,1771,0,0,66,66,0,1,0,1,0
11029,1888,0,0,62,62,0,1,0,1,0
16951,255,0,0,62,62,0,1,0,1,0
10764,842,0,0,62,62,0,1,0,1,0
18207,2596,0,0,66,66,0,1,0,1,0
503,1599,0,0,66,66,0,1,0,1,0
13767,326,0,0,63,63,0,1,0,1,0
15200,1147,0,0,66,66,0,1,0,1,0
3132,1780,0,0,62,62,0,1,0,1,0
13074,185,0,0,60,60,0,1,0,1,0
7747,1147,0,0,146,146,0,1,0,1,0
12092,1215,0,0,65,65,0,1,0,1,0
16951,255,0,0,62,62,0,1,0,1,0
1267,2938,0,0,62,62,0,1,0,1,0
9818,1017,0,0,62,62,0,1,0,1,0
15463,1458,0,0,78,78,0,1,0,1,0
2341,2760,0,0,67,67,0,1,0,1,0
2303,2802,0,0,69,69,0,1,0,1,0
360,3105,0,0,66,66,0,1,0,1,0
4365,1147,0,0,62,62,0,1,0,1,0
15148,411,0,0,64,64,0,1,0,1,0
7326,1649,0,0,60,60,0,1,0,1,0
21999,2587,0,0,66,66,0,1,0,1,0
11992,1147,0,0,65,65,0,1,0,1,0
17893,2256,0,0,66,66,0,1,0,1,0
18585,1038,0,0,62,62,0,1,0,1,0
846,2256,0,0,62,62,0,1,0,1,0
3876,1921,0,0,62,62,0,1,0,1,0
2748,2636,0,0,63,63,0,1,0,1,0
1346,3216,0,0,107,107,0,1,0,1,0
10128,1077,0,0,62,62,0,1,0,1,0
1427,2608,0,0,62,62,0,1,0,1,0
16444,2881,0,0,90,90,0,1,0,1,0
7624,2938,0,0,62,62,0,1,0,1,0
7335,1070,0,0,60,60,0,1,0,1,0
19827,383,0,0,66,66,0,1,0,1,0
21414,2908,0,0,67,67,0,1,0,1,0
2455,1215,0,0,63,63,0,1,0,1,0
4490,1147,0,0,64,64,0,1,0,1,0
301,2256,0,0,66,66,0,1,0,1,0
18240,1500,0,0,64,64,0,1,0,1,0
1124,1213,0,0,62,62,0,1,0,1,0
1958,1885,0,0,62,62,0,1,0,1,0
2210,1017,0,0,62,62,0,1,0,1,0
1757,3216,0,0,63,63,0,1,0,1,0
1804,3203,0,0,60,60,0,1,0,1,0
2500,3216,0,0,65,65,0,1,0,1,0
456,993,0,0,123,123,0,1,0,1,0
31,2938,0,0,68,68,0,1,0,1,0
1927,7,0,0,60,60,0,1,0,1,0
7460,1784,0,0,66,66,0,1,0,1,0
3025,1881,0,0,65,65,0,1,0,1,0
77,2609,0,0,145,145,0,1,0,1,0
1745,1888,0,0,146,146,0,1,0,1,0
1290,7,0,0,60,60,0,1,0,1,0
1755,2586,0,0,62,62,0,1,0,1,0
13069,161,0,0,61,61,0,1,0,1,0
7126,2587,0,0,62,62,0,1,0,1,0
5058,2620,0,0,66,66,0,1,0,1,0
8072,2256,0,0,62,62,0,1,0,1,0
18074,1017,0,0,62,62,0,1,0,1,0
4099,2477,0,0,62,62,0,1,0,1,0
10365,1168,0,0,66,66,0,1,0,1,0
29,1888,0,0,62,62,0,1,0,1,0
14722,1888,0,0,66,66,0,1,0,1,0
1001,2938,0,0,64,64,0,1,0,1,0
192,1779,0,0,63,63,0,1,0,1,0
8,2758,0,0,60,60,0,1,0,1,0
747,150,0,0,65,65,0,1,0,1,0
614,244,0,0,60,60,0,1,0,1,0
15790,2606,0,0,66,66,0,1,0,1,0
17521,1771,0,0,66,66,0,1,0,1,0
20667,2949,0,0,66,66,0,1,0,1,0
1628,3216,0,0,62,62,0,1,0,1,0
2471,2628,0,0,62,62,0,1,0,1,0
6870,1115,0,0,62,62,0,1,0,1,0
17499,2940,0,0,69,69,0,1,0,1,0
6233,1646,0,0,60,60,0,1,0,1,0
3910,2910,0,0,70,70,0,1,0,1,0
16951,255,0,0,62,62,0,1,0,1,0
0,0,0,0,70,70,0,1,0,1,0
5507,1804,0,0,62,62,0,1,0,1,0
15451,1001,0,0,65,65,0,1,0,1,0
16951,255,0,0,62,62,0,1,0,1,0
13563,3051,0,0,63,63,0,1,0,1,0
7335,1070,0,0,60,60,0,1,0,1,0
3985,1163,0,0,145,145,0,1,0,1,0
7617,3216,0,0,145,145,0,1,0,1,0
1862,4,0,0,60,60,0,1,0,1,0
10351,1178,0,0,63,63,0,1,0,1,0
100,185,0,0,60,60,0,1,0,1,0
16951,255,0,0,62,62,0,1,0,1,0
22208,2893,0,0,72,72,0,1,0,1,0
17770,2395,0,0,66,66,0,1,0,1,0
3717,1158,0,0,145,145,0,1,0,1,0
7,12,0,0,346,346,0,1,0,1,0
6651,1129,0,0,156,156,0,1,0,1,0
4070,1850,0,0,62,62,0,1,0,1,0
11942,1804,0,0,66,66,0,1,0,1,0
1312,2949,0,0,62,62,0,1,0,1,0
10080,2352,0,0,62,62,0,1,0,1,0
7141,3216,0,0,70,70,0,1,0,1,0
4503,2487,0,0,62,62,0,1,0,1,0
4760,1849,0,0,62,62,0,1,0,1,0
0,0,0,0,101,101,0,1,0,1,0
1664,1147,0,0,64,64,0,1,0,1,0
16951,255,0,0,62,62,0,1,0,1,0
18053,2256,0,0,63,63,0,1,0,1,0
31,665,0,0,138,138,0,1,0,1,0
20859,1882,0,0,63,63,0,1,0,1,0
5277,2256,0,0,62,62,0,1,0,1,0
17526,983,0,0,64,64,0,1,0,1,0
844,2938,0,0,146,146,0,1,0,1,0
2829,1147,0,0,62,62,0,1,0,1,0
1534,2256,0,0,66,66,0,1,0,1,0
146,2486,0,0,65,65,0,1,0,1,0
4971,2611,0,0,62,62,0,1,0,1,0
54,2610,0,0,145,145,0,1,0,1,0
641,2486,0,0,141,141,0,1,0,1,0
12,2553,0,0,82,82,0,1,0,1,0
8293,2028,0,0,160,160,0,1,0,1,0
16058,1851,0,0,63,63,0,1,0,1,0
18071,1888,0,0,66,66,0,1,0,1,0
9819,2883,0,0,66,66,0,1,0,1,0
8781,1173,0,0,63,63,0,1,0,1,0
1681,1888,0,0,62,62,0,1,0,1,0
1106,1147,0,0,62,62,0,1,0,1,0
19996,3117,0,0,62,62,0,1,0,1,0
683,1017,0,0,65,65,0,1,0,1,0
21392,1017,0,0,63,63,0,1,0,1,0
2859,2607,0,0,65,65,0,1,0,1,0
197,1006,0,0,62,62,0,1,0,1,0
16951,255,0,0,62,62,0,1,0,1,0
12,447,0,0,60,60,0,1,0,1,0
10392,3216,0,0,66,66,0,1,0,1,0
2826,2587,0,0,64,64,0,1,0,1,0
1361,3216,0,0,62,62,0,1,0,1,0
9146,1888,0,0,66,66,0,1,0,1,0
243,1884,0,0,66,66,0,1,0,1,0
3195,1689,0,0,62,62,0,1,0,1,0
844,2938,0,0,146,146,0,1,0,1,0
14462,2746,0,0,70,70,0,1,0,1,0
7752,2587,0,0,63,63,0,1,0,1,0
3130,1783,0,0,62,62,0,1,0,1,0
732,140,0,0,65,65,0,1,0,1,0
2537,2996,0,0,60,60,0,1,0,1,0
18184,1472,0,0,66,66,0,1,0,1,0
1544,6,0,0,60,60,0,1,0,1,0
1254,1789,0,0,62,62,0,1,0,1,0
10895,3117,0,0,66,66,0,1,0,1,0
8584,1017,0,0,62,62,0,1,0,1,0
2334,433,0,0,62,62,0,1,0,1,0
3285,1888,0,0,66,66,0,1,0,1,0
6679,2561,0,0,62,62,0,1,0,1,0
11130,2256,0,0,64,64,0,1,0,1,0
16698,2606,0,0,66,66,0,1,0,1,0
1688,1147,0,0,146,146,0,1,0,1,0
15447,988,0,0,68,68,0,1,0,1,0
157,1147,0,0,63,63,0,1,0,1,0
19130,2787,0,0,62,62,0,1,0,1,0
16951,255,0,0,62,62,0,1,0,1,0
7749,2869,0,0,133,133,0,1,0,1,0
9610,3117,0,0,77,77,0,1,0,1,0
6233,1646,0,0,60,60,0,1,0,1,0
5689,1024,0,0,66,66,0,1,0,1,0
10800,2629,0,0,66,66,0,1,0,1,0
11,217,0,0,64,64,0,1,0,1,0
630,2636,0,0,66,66,0,1,0,1,0
787,1419,0,0,64,64,0,1,0,1,0
11009,1147,0,0,66,66,0,1,0,1,0
1123,1481,0,0,104,104,0,1,0,1,0
2223,1017,0,0,62,62,0,1,0,1,0
3191,2938,0,0,61,61,0,1,0,1,0
10414,2587,0,0,62,62,0,1,0,1,0
9361,2604,0,0,66,66,0,1,0,1,0
439,2587,0,0,62,62,0,1,0,1,0
8,1873,0,0,60,60,0,1,0,1,0
9557,1199,0,0,62,62,0,1,0,1,0
4099,2477,0,0,62,62,0,1,0,1,0
688,1447,0,0,146,146,0,1,0,1,0
5462,2769,0,0,144,144,0,1,0,1,0
11003,2256,0,0,66,66,0,1,0,1,0
2559,1048,0,0,152,152,0,1,0,1,0
1132,2938,0,0,71,71,0,1,0,1,0
19741,1147,0,0,62,62,0,1,0,1,0
5597,1017,0,0,62,62,0,1,0,1,0
14502,3216,0,0,64,64,0,1,0,1,0
62,1147,0,0,62,62,0,1,0,1,0
1657,1147,0,0,64,64,0,1,0,1,0
6187,1802,0,0,65,65,0,1,0,1,0
353,2951,0,0,65,65,0,1,0,1,0
7339,152,0,0,60,60,0,1,0,1,0
16810,2256,0,0,62,62,0,1,0,1,0
10908,2202,0,0,66,66,0,1,0,1,0
12,2568,0,0,331,331,0,1,0,1,0
11767,1886,0,0,65,65,0,1,0,1,0
12767,697,0,0,62,62,0,1,0,1,0
2192,1539,0,0,146,146,0,1,0,1,0
5756,1003,0,0,62,62,0,1,0,1,0
3243,2432,0,0,66,66,0,1,0,1,0
17954,3139,0,0,66,66,0,1,0,1,0
11659,1792,0,0,62,62,0,1,0,1,0
18412,1811,0,0,66,66,0,1,0,1,0
11940,2604,0,0,66,66,0,1,0,1,0
6486,6,0,0,60,60,0,1,0,1,0
10052,3057,0,0,63,63,0,1,0,1,0
821,165,0,0,60,60,0,1,0,1,0
16402,3216,0,0,66,66,0,1,0,1,0
2694,2256,0,0,63,63,0,1,0,1,0
1804,755,0,0,60,60,0,1,0,1,0
2851,2695,0,0,74,74,0,1,0,1,0
2196,7,0,0,60,60,0,1,0,1,0
1457,1513,0,0,62,62,0,1,0,1,0
16951,255,0,0,62,62,0,1,0,1,0
2289,2486,0,0,71,71,0,1,0,1,0
16611,2222,0,0,66,66,0,1,0,1,0
5047,2629,0,0,66,66,0,1,0,1,0
17571,423,0,0,62,62,0,1,0,1,0
8472,2938,0,0,66,66,0,1,0,1,0
12,3140,0,0,199,199,0,1,0,1,0
1917,7,0,0,60,60,0,1,0,1,0
2157,2938,0,0,62,62,0,1,0,1,0
1964,983,0,0,66,66,0,1,0,1,0
10446,2884,0,0,66,66,0,1,0,1,0
18240,1017,0,0,62,62,0,1,0,1,0
18052,567,0,0,66,66,0,1,0,1,0
20540,1017,0,0,64,64,0,1,0,1,0
11724,2898,0,0,66,66,0,1,0,1,0
16951,255,0,0,62,62,0,1,0,1,0
20391,2256,0,0,64,64,0,1,0,1,0
10434,2587,0,0,66,66,0,1,0,1,0
15264,2614,0,0,63,63,0,1,0,1,0
17,213,0,0,66,66,0,1,0,1,0
6927,2598,0,0,62,62,0,1,0,1,0
8,2758,0,0,60,60,0,1,0,1,0
20659,2953,0,0,66,66,0,1,0,1,0
21247,2938,0,0,69,69,0,1,0,1,0
1720,2636,0,0,64,64,0,1,0,1,0
9717,1017,0,0,62,62,0,1,0,1,0
580,2636,0,0,62,62,0,1,0,1,0
8706,549,0,0,66,66,0,1,0,1,0
16951,255,0,0,62,62,0,1,0,1,0
12486,1125,0,0,66,66,0,1,0,1,0
16762,823,0,0,66,66,0,1,0,1,0
17524,977,0,0,66,66,0,1,0,1,0
8123,2256,0,0,95,95,0,1,0,1,0
1454,2587,0,0,62,62,0,1,0,1,0
8,2758,0,0,60,60,0,1,0,1,0
3046,1215,0,0,65,65,0,1,0,1,0
20741,1880,0,0,66,66,0,1,0,1,0
608,714,0,0,60,60,0,1,0,1,0
14429,276,0,0,62,62,0,1,0,1,0
2715,486,0,0,62,62,0,1,0,1,0
6260,2843,0,0,61,61,0,1,0,1,0
20584,3216,0,0,63,63,0,1,0,1,0
3191,509,0,0,91,91,0,1,0,1,0
16444,2881,0,0,90,90,0,1,0,1,0
11,432,0,0,60,60,0,1,0,1,0
15202,1147,0,0,66,66,0,1,0,1,0
16951,255,0,0,62,62,0,1,0,1,0
16670,2591,0,0,62,62,0,1,0,1,0
2121,3216,0,0,62,62,0,1,0,1,0
19410,1078,0,0,65,65,0,1,0,1,0
390,1888,0,0,62,62,0,1,0,1,0
6651,1129,0,0,156,156,0,1,0,1,0
2821,1147,0,0,146,146,0,1,0,1,0
2796,1017,0,0,65,65,0,1,0,1,0
16951,255,0,0,62,62,0,1,0,1,0
1178,1167,0,0,62,62,0,1,0,1,0
827,860,0,0,80,80,0,1,0,1,0
5256,2256,0,0,66,66,0,1,0,1,0
10002,2993,0,0,63,63,0,1,0,1,0
12825,2938,0,0,66,66,0,1,0,1,0
16941,1147,0,0,62,62,0,1,0,1,0
6373,253,0,0,60,60,0,1,0,1,0
16007,2938,0,0,62,62,0,1,0,1,0
16951,255,0,0,62,62,0,1,0,1,0
2658,1147,0,0,62,62,0,1,0,1,0
1588,1703,0,0,63,63,0,1,0,1,0
17575,420,0,0,62,62,0,1,0,1,0
8,2758,0,0,60,60,0,1,0,1,0
1615,155,0,0,100,100,0,1,0,1,0
11967,2211,0,0,63,63,0,1,0,1,0
12268,2574,0,0,124,124,0,1,0,1,0
1634,2883,0,0,62,62,0,1,0,1,0
14025,1888,0,0,66,66,0,1,0,1,0
3193,2852,0,0,62,62,0,1,0,1,0
3181,1771,0,0,64,64,0,1,0,1,0
158,1147,0,0,62,62,0,1,0,1,0
21079,1214,0,0,66,66,0,1,0,1,0
0,0,0,0,98,98,0,1,0,1,0
16638,1858,0,0,65,65,0,1,0,1,0
10,2422,0,0,81,81,0,1,0,1,0
3014,3216,0,0,62,62,0,1,0,1,0
5451,1888,0,0,66,66,0,1,0,1,0
2582,5,0,0,60,60,0,1,0,1,0
15278,2587,0,0,64,64,0,1,0,1,0
260,1472,0,0,65,65,0,1,0,1,0
2335,2486,0,0,62,62,0,1,0,1,0
16077,2256,0,0,62,62,0,1,0,1,0
11080,509,0,0,62,62,0,1,0,1,0
2588,5,0,0,60,60,0,1,0,1,0
260,2636,0,0,63,63,0,1,0,1,0
1796,996,0,0,146,146,0,1,0,1,0
19900,1020,0,0,66,66,0,1,0,1,0
9436,1888,0,0,66,66,0,1,0,1,0
328,1017,0,0,62,62,0,1,0,1,0
13446,1472,0,0,66,66,0,1,0,1,0
18661,2605,0,0,65,65,0,1,0,1,0
2063,1888,0,0,62,62,0,1,0,1,0
1320,7,0,0,60,60,0,1,0,1,0
5859,237,0,0,60,60,0,1,0,1,0
20824,2248,0,0,62,62,0,1,0,1,0
14194,3216,0,0,62,62,0,1,0,1,0
6578,13,0,0,61,61,0,1,0,1,0
711,1760,0,0,146,146,0,1,0,1,0
1887,7,0,0,60,60,0,1,0,1,0
16022,3139,0,0,65,65,0,1,0,1,0
2979,1472,0,0,66,66,0,1,0,1,0
2971,7,0,0,60,60,0,1,0,1,0
0,0,0,0,98,98,0,1,0,1,0
18036,840,0,0,68,68,0,1,0,1,0
3788,1176,0,0,64,64,0,1,0,1,0
670,1888,0,0,66,66,0,1,0,1,0
17673,3213,0,0,64,64,0,1,0,1,0
82,1147,0,0,65,65,0,1,0,1,0
9240,2938,0,0,66,66,0,1,0,1,0
4038,2256,0,0,140,140,0,1,0,1,0
1576,2938,0,0,60,60,0,1,0,1,0
20707,2938,0,0,66,66,0,1,0,1,0
261,3216,0,0,62,62,0,1,0,1,0
11471,2601,0,0,69,69,0,1,0,1,0
10389,3216,0,0,66,66,0,1,0,1,0
17005,465,0,0,63,63,0,1,0,1,0
20421,2613,0,0,62,62,0,1,0,1,0
15519,1,0,0,66,66,0,1,0,1,0
20834,2636,0,0,66,66,0,1,0,1,0
663,1047,0,0,65,65,0,1,0,1,0
10795,2617,0,0,66,66,0,1,0,1,0
4834,2575,0,0,65,65,0,1,0,1,0
7339,154,0,0,60,60,0,1,0,1,0
21433,1772,0,0,66,66,0,1,0,1,0
1570,1888,0,0,146,146,0,1,0,1,0
6857,1135,0,0,62,62,0,1,0,1,0
0,0,0,0,98,98,0,1,0,1,0
16951,255,0,0,62,62,0,1,0,1,0
2088,21,0,0,60,60,0,1,0,1,0
10386,2938,0,0,66,66,0,1,0,1,0
18929,2542,0,0,66,66,0,1,0,1,0
21146,1147,0,0,138,138,0,1,0,1,0
6715,2256,0,0,62,62,0,1,0,1,0
2068,14,0,0,60,60,0,1,0,1,0
11659,1792,0,0,62,62,0,1,0,1,0
7339,170,0,0,60,60,0,1,0,1,0
14227,2189,0,0,68,68,0,1,0,1,0
14530,1147,0,0,125,125,0,1,0,1,0
1335,2178,0,0,63,63,0,1,0,1,0
12847,2181,0,0,66,66,0,1,0,1,0
8061,2945,0,0,68,68,0,1,0,1,0
2833,1888,0,0,62,62,0,1,0,1,0
6308,2883,0,0,74,74,0,1,0,1,0
11844,2214,0,0,66,66,0,1,0,1,0
1681,9,0,0,60,60,0,1,0,1,0
19566,716,0,0,65,65,0,1,0,1,0
7339,170,0,0,60,60,0,1,0,1,0
397,797,0,0,63,63,0,1,0,1,0
19878,2256,0,0,65,65,0,1,0,1,0
3654,2262,0,0,115,115,0,1,0,1,0
4832,595,0,0,107,107,0,1,0,1,0
1401,2938,0,0,62,62,0,1,0,1,0
11035,2944,0,0,66,66,0,1,0,1,0
3874,1215,0,0,79,79,0,1,0,1,0
1471,2144,0,0,62,62,0,1,0,1,0
1258,1017,0,0,146,146,0,1,0,1,0
7326,1649,0,0,60,60,0,1,0,1,0
2412,2093,0,0,145,145,0,1,0,1,0
1804,3211,0,0,60,60,0,1,0,1,0
5163,1438,0,0,137,137,0,1,0,1,0
14910,1017,0,0,62,62,0,1,0,1,0
2486,2587,0,0,60,60,0,1,0,1,0
1357,2607,0,0,66,66,0,1,0,1,0
8651,509,0,0,63,63,0,1,0,1,0
20468,2611,0,0,66,66,0,1,0,1,0
20198,1147,0,0,63,63,0,1,0,1,0
1178,1167,0,0,62,62,0,1,0,1,0
14901,1804,0,0,66,66,0,1,0,1,0
12330,1017,0,0,65,65,0,1,0,1,0
1635,1215,0,0,62,62,0,1,0,1,0
17301,1014,0,0,146,146,0,1,0,1,0
6110,1153,0,0,74,74,0,1,0,1,0
11659,3216,0,0,62,62,0,1,0,1,0
16951,255,0,0,62,62,0,1,0,1,0
10368,1888,0,0,65,65,0,1,0,1,0
2136,1172,0,0,62,62,0,1,0,1,0
1639,1800,0,0,64,64,0,1,0,1,0
1288,2946,0,0,62,62,0,1,0,1,0
16951,255,0,0,62,62,0,1,0,1,0
5760,2176,0,0,154,154,0,1,0,1,0
526,3216,0,0,145,145,0,1,0,1,0
10123,1794,0,0,60,60,0,1,0,1,0
2497,3216,0,0,62,62,0,1,0,1,0
14957,2256,0,0,66,66,0,1,0,1,0
13656,1190,0,0,66,66,0,1,0,1,0
73,1147,0,0,62,62,0,1,0,1,0
0,0,0,0,98,98,0,1,0,1,0
11160,1887,0,0,66,66,0,1,0,1,0
13476,1017,0,0,86,86,0,1,0,1,0
2529,1017,0,0,66,66,0,1,0,1,0
6063,2938,0,0,62,62,0,1,0,1,0
1500,1197,0,0,64,64,0,1,0,1,0
1281,2543,0,0,60,60,0,1,0,1,0
16358,3200,0,0,66,66,0,1,0,1,0
360,3105,0,0,1094,1094,0,1,0,1,0
18997,755,0,0,129,129,0,1,0,1,0
12929,261,0,0,64,64,0,1,0,1,0
15140,427,0,0,78,78,0,1,0,1,0
10602,2380,0,0,65,65,0,1,0,1,0
2847,1147,0,0,62,62,0,1,0,1,0
1966,262,0,0,63,63,0,1,0,1,0
839,365,0,0,126,126,0,1,0,1,0
7586,2619,0,0,62,62,0,1,0,1,0
13,1608,0,0,82,82,0,1,0,1,0
18820,1147,0,0,66,66,0,1,0,1,0
783,2602,0,0,62,62,0,1,0,1,0
1264,2256,0,0,62,62,0,1,0,1,0
16951,255,0,0,62,62,0,1,0,1,0
4475,7,0,0,60,60,0,1,0,1,0
637,3258,0,0,144,144,0,1,0,1,0
13191,1000,0,0,64,64,0,1,0,1,0
14460,3204,0,0,66,66,0,1,0,1,0
6243,2938,0,0,62,62,0,1,0,1,0
16951,255,0,0,62,62,0,1,0,1,0
601,1008,0,0,64,64,0,1,0,1,0
6390,2522,0,0,153,153,0,1,0,1,0
17810,1880,0,0,66,66,0,1,0,1,0
8010,323,0,0,60,60,0,1,0,1,0
11432,1786,0,0,67,67,0,1,0,1,0
3014,2490,0,0,145,145,0,1,0,1,0
2367,2953,0,0,109,109,0,1,0,1,0
7,12,0,0,346,346,0,1,0,1,0
6051,2938,0,0,65,65,0,1,0,1,0
243,2587,0,0,62,62,0,1,0,1,0
13225,2929,0,0,62,62,0,1,0,1,0
13270,1147,0,0,62,62,0,1,0,1,0
16269,1155,0,0,62,62,0,1,0,1,0
8662,509,0,0,62,62,0,1,0,1,0
10213,1036,0,0,66,66,0,1,0,1,0
71,3216,0,0,63,63,0,1,0,1,0
19544,2256,0,0,64,64,0,1,0,1,0
473,2990,0,0,64,64,0,1,0,1,0
12,2354,0,0,81,81,0,1,0,1,0
4898,220,0,0,67,67,0,1,0,1,0
16951,255,0,0,62,62,0,1,0,1,0
16951,255,0,0,62,62,0,1,0,1,0
14958,2636,0,0,65,65,0,1,0,1,0
19923,358,0,0,125,125,0,1,0,1,0
1334,2183,0,0,64,64,0,1,0,1,0
20059,2587,0,0,66,66,0,1,0,1,0
5761,697,0,0,74,74,0,1,0,1,0
15647,2618,0,0,64,64,0,1,0,1,0
1596,2581,0,0,62,62,0,1,0,1,0
14294,1771,0,0,63,63,0,1,0,1,0
2429,2883,0,0,65,65,0,1,0,1,0
18812,2149,0,0,66,66,0,1,0,1,0
1402,2938,0,0,62,62,0,1,0,1,0
16444,2881,0,0,90,90,0,1,0,1,0
19056,2578,0,0,94,94,0,1,0,1,0
488,1029,0,0,61,61,0,1,0,1,0
13571,1868,0,0,63,63,0,1,0,1,0
10081,2353,0,0,62,62,0,1,0,1,0
16951,255,0,0,62,62,0,1,0,1,0
17014,2212,0,0,66,66,0,1,0,1,0
2603,7,0,0,60,60,0,1,0,1,0
2216,2636,0,0,62,62,0,1,0,1,0
3071,1888,0,0,66,66,0,1,0,1,0
20073,1882,0,0,64,64,0,1,0,1,0
153,3216,0,0,66,66,0,1,0,1,0
22669,267,0,0,63,63,0,1,0,1,0
2969,1804,0,0,66,66,0,1,0,1,0
8652,509,0,0,66,66,0,1,0,1,0
16404,2256,0,0,64,64,0,1,0,1,0
21136,1802,0,0,64,64,0,1,0,1,0
1477,7,0,0,60,60,0,1,0,1,0
16449,1017,0,0,66,66,0,1,0,1,0
538,1771,0,0,62,62,0,1,0,1,0
15607,2256,0,0,66,66,0,1,0,1,0
20225,1748,0,0,66,66,0,1,0,1,0
26,3216,0,0,144,144,0,1,0,1,0
5364,1025,0,0,62,62,0,1,0,1,0
9898,2938,0,0,69,69,0,1,0,1,0
786,1485,0,0,60,60,0,1,0,1,0
14531,3215,0,0,62,62,0,1,0,1,0
19606,509,0,0,66,66,0,1,0,1,0
8295,929,0,0,152,152,0,1,0,1,0
1796,2883,0,0,62,62,0,1,0,1,0
10539,799,0,0,76,76,0,1,0,1,0
18,2938,0,0,62,62,0,1,0,1,0
16951,255,0,0,62,62,0,1,0,1,0
8114,2558,0,0,62,62,0,1,0,1,0
3651,1016,0,0,62,62,0,1,0,1,0
13580,3051,0,0,66,66,0,1,0,1,0
12,2346,0,0,208,208,0,1,0,1,0
2990,2104,0,0,158,158,0,1,0,1,0
16112,2611,0,0,65,65,0,1,0,1,0
9707,1888,0,0,66,66,0,1,0,1,0
2254,1017,0,0,62,62,0,1,0,1,0
3154,2363,0,0,94,94,0,1,0,1,0
12,2375,0,0,65,65,0,1,0,1,0
270,8,0,0,60,60,0,1,0,1,0
11930,2883,0,0,66,66,0,1,0,1,0
612,20,0,0,68,68,0,1,0,1,0
6950,1147,0,0,63,63,0,1,0,1,0
18321,1472,0,0,62,62,0,1,0,1,0
16030,2883,0,0,66,66,0,1,0,1,0
1463,509,0,0,69,69,0,1,0,1,0
615,18,0,0,90,90,0,1,0,1,0
2298,1472,0,0,63,63,0,1,0,1,0
360,3105,0,0,1273,1273,0,1,0,1,0
7589,2573,0,0,74,74,0,1,0,1,0
22260,1017,0,0,66,66,0,1,0,1,0
6471,7,0,0,60,60,0,1,0,1,0
3032,1215,0,0,62,62,0,1,0,1,0
12,2461,0,0,81,81,0,1,0,1,0
1547,2611,0,0,62,62,0,1,0,1,0
12,3074,0,0,320,320,0,1,0,1,0
8886,1888,0,0,63,63,0,1,0,1,0
1903,7,0,0,60,60,0,1,0,1,0
360,3105,0,0,929,929,0,1,0,1,0
1582,1895,0,0,145,145,0,1,0,1,0
5540,1054,0,0,62,62,0,1,0,1,0
15694,333,0,0,145,145,0,1,0,1,0
17360,2938,0,0,62,62,0,1,0,1,0
6064,1888,0,0,63,63,0,1,0,1,0
15267,2619,0,0,62,62,0,1,0,1,0
6,12,0,0,346,346,0,1,0,1,0
16951,255,0,0,62,62,0,1,0,1,0
5033,1017,0,0,72,72,0,1,0,1,0
10488,1171,0,0,69,69,0,1,0,1,0
7647,1147,0,0,62,62,0,1,0,1,0
8524,2595,0,0,62,62,0,1,0,1,0
13538,2883,0,0,66,66,0,1,0,1,0
7729,104,0,0,60,60,0,1,0,1,0
612,21,0,0,60,60,0,1,0,1,0
3720,1919,0,0,69,69,0,1,0,1,0
11266,1157,0,0,65,65,0,1,0,1,0
1542,1888,0,0,66,66,0,1,0,1,0
175,2486,0,0,62,62,0,1,0,1,0
2997,2256,0,0,66,66,0,1,0,1,0
18,1147,0,0,62,62,0,1,0,1,0
20064,1882,0,0,66,66,0,1,0,1,0
4815,1056,0,0,66,66,0,1,0,1,0
3696,1147,0,0,66,66,0,1,0,1,0
18596,1147,0,0,66,66,0,1,0,1,0
6449,2917,0,0,62,62,0,1,0,1,0
13975,1888,0,0,66,66,0,1,0,1,0
2493,3216,0,0,65,65,0,1,0,1,0
11050,2256,0,0,66,66,0,1,0,1,0
2004,2953,0,0,63,63,0,1,0,1,0
1872,2938,0,0,62,62,0,1,0,1,0
16150,1390,0,0,64,64,0,1,0,1,0
1481,1147,0,0,62,62,0,1,0,1,0
111,3139,0,0,62,62,0,1,0,1,0
817,959,0,0,62,62,0,1,0,1,0
740,2256,0,0,66,66,0,1,0,1,0
17312,509,0,0,66,66,0,1,0,1,0
16,2579,0,0,61,61,0,1,0,1,0
16951,255,0,0,62,62,0,1,0,1,0
17393,1147,0,0,66,66,0,1,0,1,0
22423,1017,0,0,123,123,0,1,0,1,0
13783,241,0,0,66,66,0,1,0,1,0
22091,1215,0,0,62,62,0,1,0,1,0
17006,1813,0,0,70,70,0,1,0,1,0
18203,1109,0,0,66,66,0,1,0,1,0
3064,2938,0,0,60,60,0,1,0,1,0
20862,1017,0,0,76,76,0,1,0,1,0
17843,3216,0,0,66,66,0,1,0,1,0
3712,1014,0,0,62,62,0,1,0,1,0
13893,2610,0,0,66,66,0,1,0,1,0
2060,1888,0,0,62,62,0,1,0,1,0
1545,2256,0,0,63,63,0,1,0,1,0
10327,2211,0,0,66,66,0,1,0,1,0
16951,255,0,0,62,62,0,1,0,1,0
1411,1017,0,0,65,65,0,1,0,1,0
20440,1881,0,0,62,62,0,1,0,1,0
21657,331,0,0,64,64,0,1,0,1,0
13847,993,0,0,66,66,0,1,0,1,0
3645,1888,0,0,62,62,0,1,0,1,0
8680,2675,0,0,162,162,0,1,0,1,0
8664,1814,0,0,62,62,0,1,0,1,0
1804,1195,0,0,60,60,0,1,0,1,0
2809,1472,0,0,65,65,0,1,0,1,0
577,2611,0,0,78,78,0,1,0,1,0
6604,67,0,0,60,60,0,1,0,1,0
3081,1804,0,0,62,62,0,1,0,1,0
7335,1070,0,0,60,60,0,1,0,1,0
17523,983,0,0,62,62,0,1,0,1,0
16951,255,0,0,62,62,0,1,0,1,0
15627,1471,0,0,140,140,0,1,0,1,0
12925,1827,0,0,63,63,0,1,0,1,0
20338,1885,0,0,66,66,0,1,0,1,0
1860,3139,0,0,62,62,0,1,0,1,0
20699,2697,0,0,78,78,0,1,0,1,0
16951,255,0,0,62,62,0,1,0,1,0
6959,7,0,0,60,60,0,1,0,1,0
22037,1888,0,0,63,63,0,1,0,1,0
20785,1215,0,0,66,66,0,1,0,1,0
2493,3216,0,0,66,66,0,1,0,1,0
4993,2398,0,0,62,62,0,1,0,1,0
18735,2587,0,0,66,66,0,1,0,1,0
11158,1880,0,0,62,62,0,1,0,1,0
9250,2579,0,0,66,66,0,1,0,1,0
788,1888,0,0,62,62,0,1,0,1,0
16951,255,0,0,62,62,0,1,0,1,0
9278,2256,0,0,65,65,0,1,0,1,0
552,1888,0,0,66,66,0,1,0,1,0
16951,255,0,0,62,62,0,1,0,1,0
13453,1017,0,0,66,66,0,1,0,1,0
16951,255,0,0,62,62,0,1,0,1,0
3321,2587,0,0,62,62,0,1,0,1,0
6549,2963,0,0,62,62,0,1,0,1,0
1536,2607,0,0,63,63,0,1,0,1,0
16378,2256,0,0,65,65,0,1,0,1,0
6651,1129,0,0,156,156,0,1,0,1,0
8,1873,0,0,60,60,0,1,0,1,0
20093,1880,0,0,66,66,0,1,0,1,0
404,1888,0,0,66,66,0,1,0,1,0
14069,1147,0,0,63,63,0,1,0,1,0
1373,1147,0,0,62,62,0,1,0,1,0
21547,1886,0,0,72,72,0,1,0,1,0
3317,1888,0,0,66,66,0,1,0,1,0
254,7,0,0,60,60,0,1,0,1,0
8645,2883,0,0,64,64,0,1,0,1,0
9214,3256,0,0,60,60,0,1,0,1,0
2884,1017,0,0,62,62,0,1,0,1,0
16951,255,0,0,62,62,0,1,0,1,0
10417,2603,0,0,68,68,0,1,0,1,0
16427,2252,0,0,62,62,0,1,0,1,0
11104,2729,0,0,68,68,0,1,0,1,0
3207,2825,0,0,125,125,0,1,0,1,0
103,562,0,0,62,62,0,1,0,1,0
6229,2938,0,0,78,78,0,1,0,1,0
1330,697,0,0,62,62,0,1,0,1,0
844,2938,0,0,146,146,0,1,0,1,0
19130,2787,0,0,62,62,0,1,0,1,0
16985,1827,0,0,74,74,0,1,0,1,0
2585,991,0,0,66,66,0,1,0,1,0
8856,2573,0,0,62,62,0,1,0,1,0
13408,1801,0,0,63,63,0,1,0,1,0
612,1888,0,0,65,65,0,1,0,1,0
1607,2477,0,0,60,60,0,1,0,1,0
356,1472,0,0,62,62,0,1,0,1,0
3505,3239,0,0,105,105,0,1,0,1,0
128,391,0,0,62,62,0,1,0,1,0
22213,2932,0,0,77,77,0,1,0,1,0
2550,137,0,0,60,60,0,1,0,1,0
4495,9,0,0,60,60,0,1,0,1,0
16444,2881,0,0,90,90,0,1,0,1,0
638,280,0,0,62,62,0,1,0,1,0
6651,1129,0,0,156,156,0,1,0,1,0
20480,2256,0,0,62,62,0,1,0,1,0
3876,1923,0,0,62,62,0,1,0,1,0
7605,1139,0,0,62,62,0,1,0,1,0
16951,255,0,0,62,62,0,1,0,1,0
0,0,0,0,70,70,0,1,0,1,0
14965,1017,0,0,65,65,0,1,0,1,0
360,3105,0,0,939,939,0,1,0,1,0
5042,2634,0,0,62,62,0,1,0,1,0
9073,1773,0,0,62,62,0,1,0,1,0
10764,1147,0,0,63,63,0,1,0,1,0
1880,2715,0,0,62,62,0,1,0,1,0
1683,1147,0,0,146,146,0,1,0,1,0
8171,1073,0,0,60,60,0,1,0,1,0
10462,280,0,0,63,63,0,1,0,1,0
6300,2938,0,0,61,61,0,1,0,1,0
17954,3139,0,0,66,66,0,1,0,1,0
3221,1017,0,0,66,66,0,1,0,1,0
1887,2938,0,0,62,62,0,1,0,1,0
8331,1147,0,0,102,102,0,1,0,1,0
844,2938,0,0,146,146,0,1,0,1,0
18021,2211,0,0,97,97,0,1,0,1,0
1462,7,0,0,60,60,0,1,0,1,0
2950,3216,0,0,62,62,0,1,0,1,0
530,508,0,0,66,66,0,1,0,1,0
18642,2607,0,0,63,63,0,1,0,1,0
8114,2550,0,0,62,62,0,1,0,1,0
16951,255,0,0,62,62,0,1,0,1,0
6934,1567,0,0,98,98,0,1,0,1,0
10970,2896,0,0,66,66,0,1,0,1,0
10657,1888,0,0,64,64,0,1,0,1,0
11587,723,0,0,63,63,0,1,0,1,0
11755,1791,0,0,64,64,0,1,0,1,0
2135,1147,0,0,66,66,0,1,0,1,0
14975,2586,0,0,72,72,0,1,0,1,0
15453,1006,0,0,64,64,0,1,0,1,0
7335,1070,0,0,60,60,0,1,0,1,0
20037,1888,0,0,65,65,0,1,0,1,0
8043,1888,0,0,62,62,0,1,0,1,0
1728,1017,0,0,62,62,0,1,0,1,0
11102,1017,0,0,66,66,0,1,0,1,0
22468,201,0,0,78,78,0,1,0,1,0
2111,12,0,0,60,60,0,1,0,1,0
14935,1017,0,0,64,64,0,1,0,1,0
16951,255,0,0,62,62,0,1,0,1,0
14039,1202,0,0,62,62,0,1,0,1,0
7326,1649,0,0,60,60,0,1,0,1,0
8164,2727,0,0,60,60,0,1,0,1,0
22412,2953,0,0,64,64,0,1,0,1,0
3192,2859,0,0,62,62,0,1,0,1,0
20744,1880,0,0,66,66,0,1,0,1,0
737,1147,0,0,64,64,0,1,0,1,0
10304,2935,0,0,66,66,0,1,0,1,0
7339,170,0,0,60,60,0,1,0,1,0
2984,1589,0,0,62,62,0,1,0,1,0
661,1471,0,0,143,143,0,1,0,1,0
20069,1886,0,0,62,62,0,1,0,1,0
274,3193,0,0,63,63,0,1,0,1,0
12252,2587,0,0,62,62,0,1,0,1,0
6435,2486,0,0,155,155,0,1,0,1,0
8789,1199,0,0,62,62,0,1,0,1,0
619,3221,0,0,62,62,0,1,0,1,0
1720,1827,0,0,62,62,0,1,0,1,0
1850,3216,0,0,66,66,0,1,0,1,0
9456,1017,0,0,66,66,0,1,0,1,0
16,3223,0,0,135,135,0,1,0,1,0
331,1782,0,0,62,62,0,1,0,1,0
153,3216,0,0,66,66,0,1,0,1,0
1787,1138,0,0,61,61,0,1,0,1,0
5446,3139,0,0,102,102,0,1,0,1,0
16951,255,0,0,62,62,0,1,0,1,0
530,400,1966,259,497,497,0,1,0,1,0
1696,2587,0,0,62,62,0,1,0,1,0
1962,2611,0,0,62,62,0,1,0,1,0
10474,4,0,0,64,64,0,1,0,1,0
2332,7,0,0,60,60,0,1,0,1,0
17032,1798,0,0,66,66,0,1,0,1,0
1525,1444,0,0,145,145,0,1,0,1,0
20335,1888,0,0,65,65,0,1,0,1,0
17954,3139,0,0,65,65,0,1,0,1,0
7309,2602,0,0,66,66,0,1,0,1,0
16990,509,0,0,62,62,0,1,0,1,0
1269,1147,0,0,146,146,0,1,0,1,0
15694,1515,0,0,145,145,0,1,0,1,0
612,2562,0,0,60,60,0,1,0,1,0
11755,1800,0,0,63,63,0,1,0,1,0
18686,509,0,0,66,66,0,1,0,1,0
51,2419,0,0,164,164,0,1,0,1,0
1551,465,0,0,159,159,0,1,0,1,0
2710,2477,0,0,63,63,0,1,0,1,0
1640,3216,0,0,62,62,0,1,0,1,0
17898,2883,0,0,66,66,0,1,0,1,0
12607,1888,0,0,66,66,0,1,0,1,0
2471,2623,0,0,62,62,0,1,0,1,0
4368,1122,0,0,65,65,0,1,0,1,0
2121,3216,0,0,62,62,0,1,0,1,0
3316,1888,0,0,66,66,0,1,0,1,0
10391,3216,0,0,66,66,0,1,0,1,0
10009,1197,0,0,69,69,0,1,0,1,0
12982,996,0,0,64,64,0,1,0,1,0
16951,255,0,0,62,62,0,1,0,1,0
15593,1804,0,0,63,63,0,1,0,1,0
8986,1147,0,0,137,137,0,1,0,1,0
19134,2854,0,0,62,62,0,1,0,1,0
1975,2883,0,0,66,66,0,1,0,1,0
14911,1804,0,0,65,65,0,1,0,1,0
1251,1012,0,0,146,146,0,1,0,1,0
639,2075,0,0,143,143,0,1,0,1,0
352,2953,0,0,66,66,0,1,0,1,0
2014,1888,0,0,62,62,0,1,0,1,0
300,2938,0,0,66,66,0,1,0,1,0
17347,475,0,0,66,66,0,1,0,1,0
7106,1147,0,0,92,92,0,1,0,1,0
16736,1077,0,0,66,66,0,1,0,1,0
1575,2938,0,0,61,61,0,1,0,1,0
12787,2243,0,0,63,63,0,1,0,1,0
16705,1028,0,0,62,62,0,1,0,1,0
12058,2611,0,0,66,66,0,1,0,1,0
2401,2256,0,0,62,62,0,1,0,1,0
20325,10,0,0,88,88,0,1,0,1,0
11373,1086,0,0,65,65,0,1,0,1,0
19341,2587,0,0,62,62,0,1,0,1,0
1131,1837,0,0,66,66,0,1,0,1,0
9781,1804,0,0,66,66,0,1,0,1,0
18655,2605,0,0,64,64,0,1,0,1,0
16951,255,0,0,62,62,0,1,0,1,0
9585,3204,0,0,66,66,0,1,0,1,0
24,2938,0,0,72,72,0,1,0,1,0
9625,2636,0,0,66,66,0,1,0,1,0
183,168,0,0,63,63,0,1,0,1,0
165,2205,0,0,62,62,0,1,0,1,0
677,3216,0,0,66,66,0,1,0,1,0
15040,1888,0,0,66,66,0,1,0,1,0
11604,1817,0,0,65,65,0,1,0,1,0
12,1381,0,0,82,82,0,1,0,1,0
2300,2622,0,0,62,62,0,1,0,1,0
20094,712,0,0,62,62,0,1,0,1,0
10503,1865,0,0,66,66,0,1,0,1,0
19293,2587,0,0,62,62,0,1,0,1,0
14019,2248,0,0,66,66,0,1,0,1,0
16048,1478,0,0,63,63,0,1,0,1,0
7555,206,0,0,60,60,0,1,0,1,0
20248,2552,0,0,91,91,0,1,0,1,0
4367,3216,0,0,62,62,0,1,0,1,0
26,3216,0,0,62,62,0,1,0,1,0
14536,3213,0,0,62,62,0,1,0,1,0
344,2587,0,0,63,63,0,1,0,1,0
12233,7,0,0,60,60,0,1,0,1,0
21933,1150,0,0,63,63,0,1,0,1,0
542,1775,0,0,66,66,0,1,0,1,0
16638,2683,0,0,62,62,0,1,0,1,0
778,1888,0,0,146,146,0,1,0,1,0
3189,2875,0,0,62,62,0,1,0,1,0
11054,1211,0,0,60,60,0,1,0,1,0
531,991,0,0,66,66,0,1,0,1,0
19623,1813,0,0,66,66,0,1,0,1,0
9126,1215,0,0,64,64,0,1,0,1,0
8171,1073,0,0,60,60,0,1,0,1,0
16116,2611,0,0,63,63,0,1,0,1,0
12491,3216,0,0,66,66,0,1,0,1,0
10133,1110,0,0,64,64,0,1,0,1,0
18778,2610,0,0,66,66,0,1,0,1,0
10223,2925,0,0,66,66,0,1,0,1,0
6532,1771,0,0,65,65,0,1,0,1,0
7335,1070,0,0,60,60,0,1,0,1,0
15597,2198,0,0,63,63,0,1,0,1,0
13183,3167,0,0,64,64,0,1,0,1,0
1654,2588,0,0,65,65,0,1,0,1,0
624,2587,0,0,64,64,0,1,0,1,0
22015,2611,0,0,64,64,0,1,0,1,0
20994,697,0,0,66,66,0,1,0,1,0
2204,2570,0,0,63,63,0,1,0,1,0
3724,1923,0,0,70,70,0,1,0,1,0
12,443,0,0,305,305,0,1,0,1,0
12,2199,0,0,97,97,0,1,0,1,0
12,658,0,0,60,60,0,1,0,1,0
11447,1017,0,0,62,62,0,1,0,1,0
20189,2781,0,0,66,66,0,1,0,1,0
8350,1753,0,0,85,85,0,1,0,1,0
11504,2940,0,0,66,66,0,1,0,1,0
9314,112,0,0,60,60,0,1,0,1,0
8581,1017,0,0,66,66,0,1,0,1,0
4724,1804,0,0,66,66,0,1,0,1,0
9094,1172,0,0,63,63,0,1,0,1,0
16753,738,0,0,66,66,0,1,0,1,0
14631,2296,0,0,62,62,0,1,0,1,0
639,2486,0,0,143,143,0,1,0,1,0
13794,509,0,0,62,62,0,1,0,1,0
2461,2587,0,0,62,62,0,1,0,1,0
6200,2992,0,0,72,72,0,1,0,1,0
1452,1490,0,0,62,62,0,1,0,1,0
16951,255,0,0,62,62,0,1,0,1,0
3011,1147,0,0,62,62,0,1,0,1,0
12,207,0,0,320,320,0,1,0,1,0
155,2486,0,0,64,64,0,1,0,1,0
8171,1073,0,0,60,60,0,1,0,1,0
2023,2953,0,0,66,66,0,1,0,1,0
807,1017,0,0,62,62,0,1,0,1,0
4744,1822,0,0,65,65,0,1,0,1,0
9102,2938,0,0,62,62,0,1,0,1,0
2758,1017,0,0,60,60,0,1,0,1,0
19403,2601,0,0,65,65,0,1,0,1,0
13384,2611,0,0,66,66,0,1,0,1,0
4205,1196,0,0,63,63,0,1,0,1,0
18686,509,0,0,66,66,0,1,0,1,0
19430,2901,0,0,66,66,0,1,0,1,0
1309,2950,0,0,62,62,0,1,0,1,0
164,2636,0,0,62,62,0,1,0,1,0
7335,1072,0,0,60,60,0,1,0,1,0
1834,2581,0,0,62,62,0,1,0,1,0
11022,2242,0,0,66,66,0,1,0,1,0
18116,3216,0,0,62,62,0,1,0,1,0
16951,255,0,0,62,62,0,1,0,1,0
368,3216,0,0,62,62,0,1,0,1,0
16834,1888,0,0,64,64,0,1,0,1,0
12455,3216,0,0,66,66,0,1,0,1,0
2139,1147,0,0,65,65,0,1,0,1,0
5033,1017,0,0,87,87,0,1,0,1,0
17456,357,0,0,66,66,0,1,0,1,0
10431,259,0,0,74,74,0,1,0,1,0
21072,1771,0,0,66,66,0,1,0,1,0
638,1721,0,0,148,148,0,1,0,1,0
1804,192,0,0,60,60,0,1,0,1,0
360,3105,0,0,1263,1263,0,1,0,1,0
18094,510,0,0,66,66,0,1,0,1,0
12314,2256,0,0,66,66,0,1,0,1,0
24,2379,0,0,62,62,0,1,0,1,0
1879,504,0,0,65,65,0,1,0,1,0
12345,2256,0,0,62,62,0,1,0,1,0
2195,2938,0,0,68,68,0,1,0,1,0
1324,2587,0,0,66,66,0,1,0,1,0
8222,2587,0,0,63,63,0,1,0,1,0
2515,1472,0,0,62,62,0,1,0,1,0
14158,1147,0,0,70,70,0,1,0,1,0
413,1049,0,0,62,62,0,1,0,1,0
6662,743,0,0,68,68,0,1,0,1,0
2429,1022,0,0,61,61,0,1,0,1,0
12588,1147,0,0,62,62,0,1,0,1,0
7129,1088,0,0,99,99,0,1,0,1,0
10133,1067,0,0,63,63,0,1,0,1,0
10536,804,0,0,89,89,0,1,0,1,0
12829,2938,0,0,66,66,0,1,0,1,0
16669,2250,0,0,66,66,0,1,0,1,0
3115,1888,0,0,62,62,0,1,0,1,0
1285,1771,0,0,66,66,0,1,0,1,0
5033,1017,0,0,130,130,0,1,0,1,0
19897,1837,0,0,64,64,0,1,0,1,0
9908,2938,0,0,63,63,0,1,0,1,0
20479,2620,0,0,64,64,0,1,0,1,0
10501,1164,0,0,67,67,0,1,0,1,0
14294,1771,0,0,64,64,0,1,0,1,0
957,180,0,0,65,65,0,1,0,1,0
1699,1147,0,0,146,146,0,1,0,1,0
15006,3149,0,0,66,66,0,1,0,1,0
16727,178,0,0,60,60,0,1,0,1,0
19810,3216,0,0,66,66,0,1,0,1,0
944,2636,0,0,62,62,0,1,0,1,0
0,0,0,0,98,98,0,1,0,1,0
2852,2611,0,0,65,65,0,1,0,1,0
16951,255,0,0,62,62,0,1,0,1,0
1532,781,0,0,62,62,0,1,0,1,0
3201,1196,0,0,145,145,0,1,0,1,0
1945,1880,0,0,65,65,0,1,0,1,0
345,3111,0,0,67,67,0,1,0,1,0
21582,1840,0,0,62,62,0,1,0,1,0
12605,2247,0,0,66,66,0,1,0,1,0
8060,1147,0,0,62,62,0,1,0,1,0
157,1147,0,0,66,66,0,1,0,1,0
636,280,0,0,146,146,0,1,0,1,0
7339,2845,0,0,60,60,0,1,0,1,0
16951,255,0,0,62,62,0,1,0,1,0
19488,1016,0,0,62,62,0,1,0,1,0
300,2938,0,0,66,66,0,1,0,1,0
6494,1215,0,0,62,62,0,1,0,1,0
15525,1783,0,0,62,62,0,1,0,1,0
12,2784,0,0,82,82,0,1,0,1,0
8321,3024,0,0,146,146,0,1,0,1,0
16893,2587,0,0,93,93,0,1,0,1,0
2021,2879,0,0,72,72,0,1,0,1,0
17926,2873,0,0,66,66,0,1,0,1,0
7335,1072,0,0,60,60,0,1,0,1,0
21273,1178,0,0,63,63,0,1,0,1,0
12342,1880,0,0,66,66,0,1,0,1,0
1796,2883,0,0,62,62,0,1,0,1,0
7025,7,0,0,60,60,0,1,0,1,0
8695,983,0,0,62,62,0,1,0,1,0
13654,1147,0,0,65,65,0,1,0,1,0
16990,509,0,0,66,66,0,1,0,1,0
19884,1888,0,0,63,63,0,1,0,1,0
113,2743,0,0,62,62,0,1,0,1,0
16845,1888,0,0,62,62,0,1,0,1,0
638,345,0,0,143,143,0,1,0,1,0
1667,1147,0,0,63,63,0,1,0,1,0
16853,2256,0,0,63,63,0,1,0,1,0
16951,255,0,0,62,62,0,1,0,1,0
19741,419,0,0,60,60,0,1,0,1,0
1162,2662,0,0,64,64,0,1,0,1,0
14634,1147,0,0,62,62,0,1,0,1,0
14392,2657,0,0,66,66,0,1,0,1,0
17576,1783,0,0,62,62,0,1,0,1,0
3425,2605,0,0,64,64,0,1,0,1,0
643,1472,0,0,143,143,0,1,0,1,0
12096,2587,0,0,66,66,0,1,0,1,0
4047,1017,0,0,65,65,0,1,0,1,0
9458,1888,0,0,66,66,0,1,0,1,0
23,148,0,0,140,140,0,1,0,1,0
17301,2610,0,0,66,66,0,1,0,1,0
99,7,0,0,60,60,0,1,0,1,0
1161,3216,0,0,62,62,0,1,0,1,0
13,460,0,0,62,62,0,1,0,1,0
18007,1472,0,0,66,66,0,1,0,1,0
11744,697,0,0,66,66,0,1,0,1,0
8342,1147,0,0,63,63,0,1,0,1,0
1652,2873,0,0,145,145,0,1,0,1,0
16951,255,0,0,62,62,0,1,0,1,0
12,2542,0,0,67,67,0,1,0,1,0
3136,697,0,0,126,126,0,1,0,1,0
3025,2584,0,0,65,65,0,1,0,1,0
1912,1472,0,0,62,62,0,1,0,1,0
19728,509,0,0,66,66,0,1,0,1,0
6792,3216,0,0,62,62,0,1,0,1,0
12801,2246,0,0,64,64,0,1,0,1,0
7703,2850,0,0,132,132,0,1,0,1,0
610,403,0,0,60,60,0,1,0,1,0
15598,1156,0,0,65,65,0,1,0,1,0
11587,1472,0,0,64,64,0,1,0,1,0
21589,2938,0,0,72,72,0,1,0,1,0
18219,2874,0,0,66,66,0,1,0,1,0
21181,2256,0,0,62,62,0,1,0,1,0
2385,2942,0,0,145,145,0,1,0,1,0
9562,3216,0,0,65,65,0,1,0,1,0
14161,2256,0,0,66,66,0,1,0,1,0
14464,3139,0,0,64,64,0,1,0,1,0
20769,1811,0,0,66,66,0,1,0,1,0
3543,2938,0,0,66,66,0,1,0,1,0
13074,185,0,0,60,60,0,1,0,1,0
21594,3216,0,0,125,125,0,1,0,1,0
17268,2938,0,0,62,62,0,1,0,1,0
5895,1147,0,0,62,62,0,1,0,1,0
20,1147,0,0,62,62,0,1,0,1,0
2486,3216,0,0,66,66,0,1,0,1,0
21245,2587,0,0,66,66,0,1,0,1,0
14982,2636,0,0,64,64,0,1,0,1,0
414,1215,0,0,63,63,0,1,0,1,0
20410,1214,0,0,62,62,0,1,0,1,0
20333,1147,0,0,62,62,0,1,0,1,0
9847,1027,0,0,146,146,0,1,0,1,0
1678,3205,0,0,66,66,0,1,0,1,0
20072,1883,0,0,62,62,0,1,0,1,0
2119,787,0,0,62,62,0,1,0,1,0
3558,2256,0,0,66,66,0,1,0,1,0
11451,255,0,0,61,61,0,1,0,1,0
8222,2587,0,0,62,62,0,1,0,1,0
21647,1147,0,0,66,66,0,1,0,1,0
16727,178,0,0,60,60,0,1,0,1,0
12617,2636,0,0,66,66,0,1,0,1,0
1584,2587,0,0,66,66,0,1,0,1,0
16951,255,0,0,62,62,0,1,0,1,0
1814,1147,0,0,64,64,0,1,0,1,0
1816,2249,0,0,61,61,0,1,0,1,0
1441,2952,0,0,65,65,0,1,0,1,0
12227,1215,0,0,62,62,0,1,0,1,0
1330,697,0,0,62,62,0,1,0,1,0
2468,262,0,0,103,103,0,1,0,1,0
1804,3211,0,0,60,60,0,1,0,1,0
554,2252,0,0,65,65,0,1,0,1,0
12343,2256,0,0,62,62,0,1,0,1,0
1433,1017,0,0,66,66,0,1,0,1,0
7335,1070,0,0,60,60,0,1,0,1,0
4500,2491,0,0,119,119,0,1,0,1,0
15342,2826,0,0,62,62,0,1,0,1,0
10076,1017,0,0,62,62,0,1,0,1,0
16670,2244,0,0,66,66,0,1,0,1,0
10895,3117,0,0,62,62,0,1,0,1,0
8983,1887,0,0,62,62,0,1,0,1,0
18275,10,0,0,88,88,0,1,0,1,0
16951,255,0,0,62,62,0,1,0,1,0
10025,3084,0,0,66,66,0,1,0,1,0
467,1888,0,0,66,66,0,1,0,1,0
2573,1017,0,0,62,62,0,1,0,1,0
2680,510,0,0,66,66,0,1,0,1,0
19806,1017,0,0,66,66,0,1,0,1,0
352,2264,0,0,90,90,0,1,0,1,0
91,2597,0,0,62,62,0,1,0,1,0
21066,2610,0,0,62,62,0,1,0,1,0
17548,2938,0,0,68,68,0,1,0,1,0
1804,1723,0,0,60,60,0,1,0,1,0
16951,255,0,0,62,62,0,1,0,1,0
1279,509,0,0,69,69,0,1,0,1,0
5294,1147,0,0,62,62,0,1,0,1,0
21399,155,0,0,66,66,0,1,0,1,0
1473,1017,0,0,66,66,0,1,0,1,0
17618,2573,0,0,71,71,0,1,0,1,0
1728,2104,0,0,148,148,0,1,0,1,0
8106,2517,0,0,99,99,0,1,0,1,0
6239,2569,0,0,64,64,0,1,0,1,0
16951,255,0,0,62,62,0,1,0,1,0
9089,1784,0,0,62,62,0,1,0,1,0
6233,1646,0,0,60,60,0,1,0,1,0
3077,2928,0,0,149,149,0,1,0,1,0
2060,1888,0,0,62,62,0,1,0,1,0
360,3105,0,0,232,232,0,1,0,1,0
2798,1473,0,0,65,65,0,1,0,1,0
19826,385,0,0,66,66,0,1,0,1,0
289,1472,0,0,62,62,0,1,0,1,0
2746,3216,0,0,62,62,0,1,0,1,0
16898,2581,0,0,66,66,0,1,0,1,0
754,2256,0,0,65,65,0,1,0,1,0
2329,3216,0,0,63,63,0,1,0,1,0
3111,2618,0,0,69,69,0,1,0,1,0
3117,2889,0,0,66,66,0,1,0,1,0
7335,1072,0,0,60,60,0,1,0,1,0
6451,1215,0,0,62,62,0,1,0,1,0
0,0,0,0,98,98,0,1,0,1,0
1551,2636,0,0,62,62,0,1,0,1,0
1698,2587,0,0,62,62,0,1,0,1,0
8,442,0,0,60,60,0,1,0,1,0
17874,2465,0,0,87,87,0,1,0,1,0
12,365,0,0,341,341,0,1,0,1,0
11929,1147,0,0,66,66,0,1,0,1,0
18260,1068,0,0,64,64,0,1,0,1,0
8164,2728,0,0,60,60,0,1,0,1,0
3064,2938,0,0,60,60,0,1,0,1,0
4156,2631,0,0,131,131,0,1,0,1,0
9260,805,0,0,66,66,0,1,0,1,0
2762,1147,0,0,66,66,0,1,0,1,0
7818,1147,0,0,77,77,0,1,0,1,0
684,2938,0,0,62,62,0,1,0,1,0
5521,1215,0,0,62,62,0,1,0,1,0
21587,2938,0,0,78,78,0,1,0,1,0
1246,1884,0,0,63,63,0,1,0,1,0
19698,509,0,0,66,66,0,1,0,1,0
18,3216,0,0,62,62,0,1,0,1,0
22217,2940,0,0,75,75,0,1,0,1,0
18828,1147,0,0,66,66,0,1,0,1,0
1142,1215,0,0,62,62,0,1,0,1,0
11567,2256,0,0,62,62,0,1,0,1,0
20060,2938,0,0,66,66,0,1,0,1,0
6664,3126,0,0,147,147,0,1,0,1,0
3240,2534,0,0,146,146,0,1,0,1,0
16951,255,0,0,62,62,0,1,0,1,0
7339,152,0,0,60,60,0,1,0,1,0
13345,1215,0,0,66,66,0,1,0,1,0
19505,3212,0,0,62,62,0,1,0,1,0
1492,997,0,0,64,64,0,1,0,1,0
16951,255,0,0,62,62,0,1,0,1,0
6098,2863,0,0,61,61,0,1,0,1,0
21328,1086,0,0,66,66,0,1,0,1,0
13937,2256,0,0,64,64,0,1,0,1,0
14141,2938,0,0,113,113,0,1,0,1,0
3211,2611,0,0,62,62,0,1,0,1,0
5913,2587,0,0,66,66,0,1,0,1,0
21588,2938,0,0,75,75,0,1,0,1,0
2685,2939,0,0,65,65,0,1,0,1,0
3913,1879,0,0,63,63,0,1,0,1,0
14193,2268,0,0,66,66,0,1,0,1,0
2490,2591,0,0,146,146,0,1,0,1,0
2189,997,0,0,110,110,0,1,0,1,0
15457,1017,0,0,62,62,0,1,0,1,0
8651,2919,0,0,63,63,0,1,0,1,0
16473,245,0,0,60,60,0,1,0,1,0
17442,2606,0,0,66,66,0,1,0,1,0
16951,255,0,0,62,62,0,1,0,1,0
7326,180,0,0,60,60,0,1,0,1,0
21051,2595,0,0,62,62,0,1,0,1,0
2787,1147,0,0,62,62,0,1,0,1,0
16835,1477,0,0,63,63,0,1,0,1,0
636,280,0,0,62,62,0,1,0,1,0
6893,1884,0,0,62,62,0,1,0,1,0
10984,2256,0,0,66,66,0,1,0,1,0
388,1888,0,0,62,62,0,1,0,1,0
612,269,0,0,60,60,0,1,0,1,0
289,1472,0,0,63,63,0,1,0,1,0
1373,1147,0,0,62,62,0,1,0,1,0
2469,269,0,0,61,61,0,1,0,1,0
6383,2889,0,0,84,84,0,1,0,1,0
17611,2115,0,0,70,70,0,1,0,1,0
8682,1792,0,0,137,137,0,1,0,1,0
15968,2938,0,0,66,66,0,1,0,1,0
12603,2156,0,0,73,73,0,1,0,1,0
8465,2636,0,0,66,66,0,1,0,1,0
16951,255,0,0,62,62,0,1,0,1,0
1447,240,0,0,61,61,0,1,0,1,0
13074,185,0,0,60,60,0,1,0,1,0
14696,2938,0,0,62,62,0,1,0,1,0
7326,180,0,0,60,60,0,1,0,1,0
9273,6,0,0,60,60,0,1,0,1,0
6914,2587,0,0,122,122,0,1,0,1,0
11922,2604,0,0,63,63,0,1,0,1,0
19349,983,0,0,65,65,0,1,0,1,0
16951,255,0,0,62,62,0,1,0,1,0
17658,1882,0,0,64,64,0,1,0,1,0
1420,2944,0,0,63,63,0,1,0,1,0
6426,230,0,0,60,60,0,1,0,1,0
20370,1771,0,0,65,65,0,1,0,1,0
21141,1777,0,0,66,66,0,1,0,1,0
16099,2883,0,0,65,65,0,1,0,1,0
16951,255,0,0,62,62,0,1,0,1,0
19474,2256,0,0,66,66,0,1,0,1,0
4494,1147,0,0,63,63,0,1,0,1,0
3983,1589,0,0,62,62,0,1,0,1,0
1892,1771,0,0,66,66,0,1,0,1,0
16624,1897,0,0,66,66,0,1,0,1,0
20812,2542,0,0,66,66,0,1,0,1,0
20734,1880,0,0,66,66,0,1,0,1,0
20089,2594,0,0,146,146,0,1,0,1,0
17395,2256,0,0,65,65,0,1,0,1,0
11514,1472,0,0,62,62,0,1,0,1,0
19099,353,0,0,60,60,0,1,0,1,0
22264,1756,0,0,62,62,0,1,0,1,0
2014,1888,0,0,62,62,0,1,0,1,0
6286,2938,0,0,64,64,0,1,0,1,0
2354,2746,0,0,62,62,0,1,0,1,0
16951,255,0,0,62,62,0,1,0,1,0
1905,280,0,0,63,63,0,1,0,1,0
6812,299,0,0,150,150,0,1,0,1,0
16951,255,0,0,62,62,0,1,0,1,0
8,2758,0,0,60,60,0,1,0,1,0
17903,3139,0,0,62,62,0,1,0,1,0
704,1147,0,0,65,65,0,1,0,1,0
17997,1472,0,0,66,66,0,1,0,1,0
10481,2671,0,0,84,84,0,1,0,1,0
306,3216,0,0,62,62,0,1,0,1,0
813,2104,0,0,139,139,0,1,0,1,0
17815,2602,0,0,66,66,0,1,0,1,0
22002,197,0,0,61,61,0,1,0,1,0
6965,1155,0,0,62,62,0,1,0,1,0
605,1147,0,0,63,63,0,1,0,1,0
1909,2256,0,0,62,62,0,1,0,1,0
13210,3142,0,0,65,65,0,1,0,1,0
4172,2434,0,0,60,60,0,1,0,1,0
4206,1771,0,0,62,62,0,1,0,1,0
16951,255,0,0,62,62,0,1,0,1,0
370,3216,0,0,62,62,0,1,0,1,0
20338,1771,0,0,66,66,0,1,0,1,0
3237,2826,0,0,126,126,0,1,0,1,0
9214,3256,0,0,60,60,0,1,0,1,0
1515,1774,0,0,65,65,0,1,0,1,0
17970,720,0,0,66,66,0,1,0,1,0
1282,509,0,0,62,62,0,1,0,1,0
6682,2256,0,0,62,62,0,1,0,1,0
13710,2235,0,0,62,62,0,1,0,1,0
16664,1884,0,0,66,66,0,1,0,1,0
360,3105,0,0,1262,1262,0,1,0,1,0
2566,308,0,0,65,65,0,1,0,1,0
16951,255,0,0,62,62,0,1,0,1,0
21258,2584,0,0,65,65,0,1,0,1,0
2788,2636,0,0,66,66,0,1,0,1,0
28,310,0,0,60,60,0,1,0,1,0
22113,1215,0,0,62,62,0,1,0,1,0
10981,2926,0,0,66,66,0,1,0,1,0
18340,1472,0,0,66,66,0,1,0,1,0
15597,2202,0,0,64,64,0,1,0,1,0
7707,697,0,0,133,133,0,1,0,1,0
13959,2256,0,0,63,63,0,1,0,1,0
2678,2594,0,0,69,69,0,1,0,1,0
18258,1099,0,0,66,66,0,1,0,1,0
17820,2665,0,0,66,66,0,1,0,1,0
2834,1888,0,0,62,62,0,1,0,1,0
7981,2938,0,0,62,62,0,1,0,1,0
22223,155,0,0,64,64,0,1,0,1,0
1848,994,0,0,63,63,0,1,0,1,0
3664,509,0,0,66,66,0,1,0,1,0
16951,255,0,0,62,62,0,1,0,1,0
12,3134,0,0,69,69,0,1,0,1,0
1045,2883,0,0,64,64,0,1,0,1,0
360,3105,0,0,1291,1291,0,1,0,1,0
18879,2587,0,0,66,66,0,1,0,1,0
16951,255,0,0,62,62,0,1,0,1,0
1595,2557,0,0,62,62,0,1,0,1,0
12930,2564,0,0,63,63,0,1,0,1,0
16951,255,0,0,62,62,0,1,0,1,0
20772,1804,0,0,62,62,0,1,0,1,0
16478,266,0,0,60,60,0,1,0,1,0
9995,2984,0,0,64,64,0,1,0,1,0
23,1179,0,0,62,62,0,1,0,1,0
1309,1497,0,0,125,125,0,1,0,1,0
158,1147,0,0,62,62,0,1,0,1,0
17485,2941,0,0,67,67,0,1,0,1,0
12619,1888,0,0,66,66,0,1,0,1,0
2936,509,0,0,79,79,0,1,0,1,0
17917,2508,0,0,97,97,0,1,0,1,0
6155,33,0,0,70,70,0,1,0,1,0
16029,308,0,0,66,66,0,1,0,1,0
40,293,0,0,65,65,0,1,0,1,0
7339,170,0,0,60,60,0,1,0,1,0
22241,103,0,0,63,63,0,1,0,1,0
1549,2950,0,0,62,62,0,1,0,1,0
17439,1771,0,0,62,62,0,1,0,1,0
15272,2597,0,0,65,65,0,1,0,1,0
13242,1148,0,0,65,65,0,1,0,1,0
1130,2938,0,0,62,62,0,1,0,1,0
360,3105,0,0,66,66,0,1,0,1,0
12614,2636,0,0,66,66,0,1,0,1,0
650,3269,0,0,144,144,0,1,0,1,0
6733,2573,0,0,72,72,0,1,0,1,0
11480,1872,0,0,65,65,0,1,0,1,0
1130,2938,0,0,62,62,0,1,0,1,0
12,658,0,0,131,131,0,1,0,1,0
10784,3216,0,0,65,65,0,1,0,1,0
1804,3191,0,0,60,60,0,1,0,1,0
9809,2587,0,0,67,67,0,1,0,1,0
12995,3216,0,0,66,66,0,1,0,1,0
22557,1824,0,0,66,66,0,1,0,1,0
16951,255,0,0,62,62,0,1,0,1,0
13776,2474,0,0,64,64,0,1,0,1,0
12,972,0,0,83,83,0,1,0,1,0
12179,2590,0,0,62,62,0,1,0,1,0
15854,2611,0,0,66,66,0,1,0,1,0
16867,2940,0,0,66,66,0,1,0,1,0
1330,697,0,0,62,62,0,1,0,1,0
9368,2156,0,0,66,66,0,1,0,1,0
16992,505,0,0,65,65,0,1,0,1,0
9887,2938,0,0,70,70,0,1,0,1,0
17264,2938,0,0,62,62,0,1,0,1,0
12607,2636,0,0,66,66,0,1,0,1,0
7992,2595,0,0,62,62,0,1,0,1,0
1734,2538,0,0,146,146,0,1,0,1,0
8774,1778,0,0,109,109,0,1,0,1,0
1424,3216,0,0,65,65,0,1,0,1,0
741,146,0,0,66,66,0,1,0,1,0
7425,3216,0,0,62,62,0,1,0,1,0
3249,1147,0,0,79,79,0,1,0,1,0
3071,3225,0,0,64,64,0,1,0,1,0
2615,1017,0,0,62,62,0,1,0,1,0
6367,2256,0,0,62,62,0,1,0,1,0
16951,255,0,0,62,62,0,1,0,1,0
16951,255,0,0,62,62,0,1,0,1,0
2084,1471,0,0,145,145,0,1,0,1,0
18386,1483,0,0,66,66,0,1,0,1,0
1075,308,0,0,62,62,0,1,0,1,0
3153,1473,0,0,62,62,0,1,0,1,0
19552,1140,0,0,62,62,0,1,0,1,0
17633,2587,0,0,66,66,0,1,0,1,0
778,1888,0,0,146,146,0,1,0,1,0
1472,1147,0,0,146,146,0,1,0,1,0
16431,1017,0,0,117,117,0,1,0,1,0
14973,2636,0,0,66,66,0,1,0,1,0
3988,697,0,0,74,74,0,1,0,1,0
2824,2587,0,0,63,63,0,1,0,1,0
2780,1147,0,0,63,63,0,1,0,1,0
12268,2582,0,0,87,87,0,1,0,1,0
1804,3194,0,0,60,60,0,1,0,1,0
1161,3216,0,0,62,62,0,1,0,1,0
6913,2587,0,0,62,62,0,1,0,1,0
2805,1017,0,0,62,62,0,1,0,1,0
6229,2938,0,0,78,78,0,1,0,1,0
7213,357,0,0,62,62,0,1,0,1,0
745,1017,0,0,66,66,0,1,0,1,0
13198,1215,0,0,62,62,0,1,0,1,0
19175,1763,0,0,66,66,0,1,0,1,0
16640,1859,0,0,64,64,0,1,0,1,0
2677,1763,0,0,62,62,0,1,0,1,0
11343,1017,0,0,63,63,0,1,0,1,0
6533,1215,0,0,62,62,0,1,0,1,0
16951,255,0,0,62,62,0,1,0,1,0
5634,3216,0,0,62,62,0,1,0,1,0
1200,3216,0,0,62,62,0,1,0,1,0
2008,2892,0,0,73,73,0,1,0,1,0
1757,1147,0,0,62,62,0,1,0,1,0
7983,977,0,0,65,65,0,1,0,1,0
18,2256,0,0,146,146,0,1,0,1,0
13487,2499,0,0,66,66,0,1,0,1,0
12806,1465,0,0,66,66,0,1,0,1,0
1263,7,0,0,60,60,0,1,0,1,0
9782,1795,0,0,66,66,0,1,0,1,0
13154,1215,0,0,62,62,0,1,0,1,0
4908,2597,0,0,63,63,0,1,0,1,0
18249,1771,0,0,66,66,0,1,0,1,0
733,1147,0,0,65,65,0,1,0,1,0
16951,255,0,0,62,62,0,1,0,1,0
7273,1888,0,0,62,62,0,1,0,1,0
5508,1023,0,0,146,146,0,1,0,1,0
5505,3158,0,0,66,66,0,1,0,1,0
496,2222,0,0,114,114,0,1,0,1,0
747,1845,0,0,62,62,0,1,0,1,0
2405,2941,0,0,62,62,0,1,0,1,0
20363,1174,0,0,62,62,0,1,0,1,0
5950,1198,0,0,62,62,0,1,0,1,0
6449,2256,0,0,63,63,0,1,0,1,0
6309,2938,0,0,60,60,0,1,0,1,0
1744,1827,0,0,63,63,0,1,0,1,0
3015,1171,0,0,62,62,0,1,0,1,0
6703,2575,0,0,62,62,0,1,0,1,0
13688,1892,0,0,137,137,0,1,0,1,0
8221,2601,0,0,62,62,0,1,0,1,0
20342,3139,0,0,64,64,0,1,0,1,0
9767,2587,0,0,66,66,0,1,0,1,0
21459,2904,0,0,67,67,0,1,0,1,0
6686,2566,0,0,62,62,0,1,0,1,0
20329,1880,0,0,65,65,0,1,0,1,0
16951,255,0,0,62,62,0,1,0,1,0
1330,804,0,0,62,62,0,1,0,1,0
7339,141,0,0,60,60,0,1,0,1,0
3252,2390,0,0,66,66,0,1,0,1,0
2582,1147,0,0,66,66,0,1,0,1,0
11174,2521,0,0,62,62,0,1,0,1,0
7335,1072,0,0,60,60,0,1,0,1,0
2198,1017,0,0,62,62,0,1,0,1,0
2021,2952,0,0,65,65,0,1,0,1,0
2964,383,0,0,60,60,0,1,0,1,0
11432,1784,0,0,67,67,0,1,0,1,0
10389,639,0,0,100,100,0,1,0,1,0
2137,2938,0,0,62,62,0,1,0,1,0
409,1772,0,0,65,65,0,1,0,1,0
8222,2587,0,0,62,62,0,1,0,1,0
17773,2618,0,0,64,64,0,1,0,1,0
17886,1161,0,0,66,66,0,1,0,1,0
22043,1888,0,0,63,63,0,1,0,1,0
18234,1771,0,0,66,66,0,1,0,1,0
13732,1147,0,0,66,66,0,1,0,1,0
19918,2587,0,0,66,66,0,1,0,1,0
1415,1017,0,0,63,63,0,1,0,1,0
16951,255,0,0,62,62,0,1,0,1,0
21146,1147,0,0,62,62,0,1,0,1,0
16087,1771,0,0,66,66,0,1,0,1,0
2757,1147,0,0,64,64,0,1,0,1,0
20929,1017,0,0,63,63,0,1,0,1,0
19403,1883,0,0,66,66,0,1,0,1,0
9406,2938,0,0,73,73,0,1,0,1,0
1475,2636,0,0,62,62,0,1,0,1,0
17268,2953,0,0,66,66,0,1,0,1,0
1140,509,0,0,62,62,0,1,0,1,0
17268,1147,0,0,64,64,0,1,0,1,0
11942,1804,0,0,65,65,0,1,0,1,0
3140,7,0,0,60,60,0,1,0,1,0
16951,255,0,0,62,62,0,1,0,1,0
9244,3216,0,0,64,64,0,1,0,1,0
20866,2587,0,0,66,66,0,1,0,1,0
16894,2943,0,0,66,66,0,1,0,1,0
22091,1215,0,0,62,62,0,1,0,1,0
12484,3216,0,0,63,63,0,1,0,1,0
328,1017,0,0,62,62,0,1,0,1,0
16951,255,0,0,62,62,0,1,0,1,0
14949,1785,0,0,66,66,0,1,0,1,0
16117,2608,0,0,74,74,0,1,0,1,0
4174,1149,0,0,65,65,0,1,0,1,0
22044,1888,0,0,62,62,0,1,0,1,0
639,2486,0,0,142,142,0,1,0,1,0
16951,255,0,0,62,62,0,1,0,1,0
1853,2938,0,0,62,62,0,1,0,1,0
2394,1880,0,0,62,62,0,1,0,1,0
20015,2587,0,0,66,66,0,1,0,1,0
6898,1096,0,0,66,66,0,1,0,1,0
17128,3215,0,0,65,65,0,1,0,1,0
17308,1813,0,0,66,66,0,1,0,1,0
1132,2938,0,0,77,77,0,1,0,1,0
12112,2601,0,0,66,66,0,1,0,1,0
2016,1888,0,0,62,62,0,1,0,1,0
9245,106,0,0,82,82,0,1,0,1,0
6435,1215,0,0,62,62,0,1,0,1,0
7339,170,0,0,60,60,0,1,0,1,0
653,134,0,0,111,111,0,1,0,1,0
8276,2023,0,0,161,161,0,1,0,1,0
1606,1888,0,0,62,62,0,1,0,1,0
5908,2587,0,0,64,64,0,1,0,1,0
6320,2606,0,0,63,63,0,1,0,1,0
20587,1779,0,0,66,66,0,1,0,1,0
2915,1783,0,0,64,64,0,1,0,1,0
15232,2506,0,0,62,62,0,1,0,1,0
9248,6,0,0,60,60,0,1,0,1,0
18661,2975,0,0,62,62,0,1,0,1,0
12687,1809,0,0,62,62,0,1,0,1,0
11739,1147,0,0,65,65,0,1,0,1,0
1735,2085,0,0,97,97,0,1,0,1,0
10896,1017,0,0,62,62,0,1,0,1,0
2987,366,0,0,61,61,0,1,0,1,0
2718,1888,0,0,62,62,0,1,0,1,0
20241,3168,0,0,64,64,0,1,0,1,0
9269,2632,0,0,62,62,0,1,0,1,0
6689,1823,0,0,62,62,0,1,0,1,0
682,1481,0,0,143,143,0,1,0,1,0
2317,428,0,0,62,62,0,1,0,1,0
3724,1147,0,0,66,66,0,1,0,1,0
14299,1576,0,0,66,66,0,1,0,1,0
20,2957,0,0,141,141,0,1,0,1,0
6907,2584,0,0,145,145,0,1,0,1,0
2295,1472,0,0,65,65,0,1,0,1,0
2991,1771,0,0,66,66,0,1,0,1,0
3031,1473,0,0,86,86,0,1,0,1,0
1928,2256,0,0,62,62,0,1,0,1,0
636,280,0,0,146,146,0,1,0,1,0
18669,598,0,0,66,66,0,1,0,1,0
9673,2256,0,0,66,66,0,1,0,1,0
6474,2938,0,0,62,62,0,1,0,1,0
14844,2256,0,0,66,66,0,1,0,1,0
3193,2852,0,0,62,62,0,1,0,1,0
360,3105,0,0,402,402,0,1,0,1,0
9490,1888,0,0,66,66,0,1,0,1,0
4872,471,0,0,117,117,0,1,0,1,0
17494,887,0,0,66,66,0,1,0,1,0
10818,2591,0,0,64,64,0,1,0,1,0
16657,2587,0,0,65,65,0,1,0,1,0
18,1769,0,0,153,153,0,1,0,1,0
1591,1888,0,0,62,62,0,1,0,1,0
16951,255,0,0,62,62,0,1,0,1,0
16951,255,0,0,62,62,0,1,0,1,0
9004,98,0,0,60,60,0,1,0,1,0
8117,2938,0,0,69,69,0,1,0,1,0
17386,2942,0,0,66,66,0,1,0,1,0
3093,1147,0,0,62,62,0,1,0,1,0
9397,1771,0,0,66,66,0,1,0,1,0
7590,2820,0,0,147,147,0,1,0,1,0
653,1888,0,0,65,65,0,1,0,1,0
6433,2871,0,0,142,142,0,1,0,1,0
1986,1215,0,0,62,62,0,1,0,1,0
13415,1801,0,0,62,62,0,1,0,1,0
1316,2587,0,0,65,65,0,1,0,1,0
18879,2587,0,0,66,66,0,1,0,1,0
11966,2212,0,0,66,66,0,1,0,1,0
19104,1888,0,0,66,66,0,1,0,1,0
12,3140,0,0,199,199,0,1,0,1,0
20334,1880,0,0,66,66,0,1,0,1,0
3235,2828,0,0,123,123,0,1,0,1,0
21834,1797,0,0,64,64,0,1,0,1,0
640,1816,0,0,156,156,0,1,0,1,0
597,1017,0,0,62,62,0,1,0,1,0
20048,1797,0,0,66,66,0,1,0,1,0
7602,2596,0,0,64,64,0,1,0,1,0
8,442,0,0,60,60,0,1,0,1,0
495,2324,0,0,66,66,0,1,0,1,0
16331,2602,0,0,66,66,0,1,0,1,0
12377,148,0,0,60,60,0,1,0,1,0
299,2945,0,0,66,66,0,1,0,1,0
2792,1065,0,0,146,146,0,1,0,1,0
15263,1147,0,0,66,66,0,1,0,1,0
22459,162,0,0,80,80,0,1,0,1,0
16951,255,0,0,62,62,0,1,0,1,0
17527,983,0,0,66,66,0,1,0,1,0
9921,2938,0,0,66,66,0,1,0,1,0
17105,2625,0,0,64,64,0,1,0,1,0
16951,255,0,0,62,62,0,1,0,1,0
21136,1803,0,0,66,66,0,1,0,1,0
14865,2697,0,0,62,62,0,1,0,1,0
9504,1888,0,0,66,66,0,1,0,1,0
13154,2884,0,0,66,66,0,1,0,1,0
16951,255,0,0,62,62,0,1,0,1,0
7301,1148,0,0,62,62,0,1,0,1,0
14199,1497,0,0,66,66,0,1,0,1,0
10349,3018,0,0,97,97,0,1,0,1,0
16951,255,0,0,62,62,0,1,0,1,0
10866,148,0,0,60,60,0,1,0,1,0
11080,509,0,0,62,62,0,1,0,1,0
1298,2951,0,0,62,62,0,1,0,1,0
2051,2587,0,0,66,66,0,1,0,1,0
16951,255,0,0,62,62,0,1,0,1,0
20813,2233,0,0,66,66,0,1,0,1,0
10287,2583,0,0,83,83,0,1,0,1,0
8682,1792,0,0,98,98,0,1,0,1,0
10165,1147,0,0,66,66,0,1,0,1,0
8817,1888,0,0,74,74,0,1,0,1,0
6673,2558,0,0,62,62,0,1,0,1,0
7451,3216,0,0,62,62,0,1,0,1,0
19728,509,0,0,66,66,0,1,0,1,0
12195,3212,0,0,66,66,0,1,0,1,0
15014,1782,0,0,65,65,0,1,0,1,0
6233,1646,0,0,60,60,0,1,0,1,0
5327,1888,0,0,62,62,0,1,0,1,0
17045,1472,0,0,66,66,0,1,0,1,0
110,2883,0,0,62,62,0,1,0,1,0
16951,255,0,0,62,62,0,1,0,1,0
9924,2588,0,0,62,62,0,1,0,1,0
1402,2938,0,0,62,62,0,1,0,1,0
18836,1147,0,0,65,65,0,1,0,1,0
14189,2256,0,0,66,66,0,1,0,1,0
16726,223,0,0,133,133,0,1,0,1,0
6511,1215,0,0,62,62,0,1,0,1,0
4326,1866,0,0,62,62,0,1,0,1,0
3228,2602,0,0,146,146,0,1,0,1,0
15917,847,0,0,66,66,0,1,0,1,0
2916,3216,0,0,66,66,0,1,0,1,0
20864,1882,0,0,62,62,0,1,0,1,0
3189,2883,0,0,62,62,0,1,0,1,0
11031,2941,0,0,66,66,0,1,0,1,0
16045,1479,0,0,63,63,0,1,0,1,0
0,0,0,0,98,98,0,1,0,1,0
10579,800,0,0,64,64,0,1,0,1,0
16299,1177,0,0,62,62,0,1,0,1,0
18039,2256,0,0,66,66,0,1,0,1,0
326,1888,0,0,62,62,0,1,0,1,0
29,1888,0,0,62,62,0,1,0,1,0
1556,2249,0,0,62,62,0,1,0,1,0
11559,797,0,0,65,65,0,1,0,1,0
6935,3216,0,0,66,66,0,1,0,1,0
660,1888,0,0,95,95,0,1,0,1,0
12187,1774,0,0,64,64,0,1,0,1,0
20037,1888,0,0,66,66,0,1,0,1,0
11045,2238,0,0,66,66,0,1,0,1,0
6724,2256,0,0,62,62,0,1,0,1,0
2828,1147,0,0,62,62,0,1,0,1,0
1993,1771,0,0,146,146,0,1,0,1,0
152,3216,0,0,66,66,0,1,0,1,0
360,3105,0,0,164,164,0,1,0,1,0
2549,1484,0,0,67,67,0,1,0,1,0
11946,1803,0,0,66,66,0,1,0,1,0
16951,255,0,0,62,62,0,1,0,1,0
0,0,0,0,98,98,0,1,0,1,0
6050,2938,0,0,66,66,0,1,0,1,0
629,3224,0,0,60,60,0,1,0,1,0
18920,2544,0,0,65,65,0,1,0,1,0
15275,2592,0,0,74,74,0,1,0,1,0
289,1472,0,0,65,65,0,1,0,1,0
3853,1539,0,0,62,62,0,1,0,1,0
3656,1012,0,0,62,62,0,1,0,1,0
1819,1147,0,0,62,62,0,1,0,1,0
1334,1888,0,0,62,62,0,1,0,1,0
15840,3216,0,0,66,66,0,1,0,1,0
266,1086,0,0,66,66,0,1,0,1,0
12,645,0,0,150,150,0,1,0,1,0
3007,1215,0,0,62,62,0,1,0,1,0
8952,1147,0,0,66,66,0,1,0,1,0
639,2820,0,0,143,143,0,1,0,1,0
1126,14,0,0,60,60,0,1,0,1,0
8093,15,0,0,60,60,0,1,0,1,0
8164,2728,0,0,60,60,0,1,0,1,0
1645,3216,0,0,63,63,0,1,0,1,0
12,3116,0,0,1484,1484,0,1,0,1,0
17997,1472,0,0,66,66,0,1,0,1,0
8213,1147,0,0,65,65,0,1,0,1,0
360,3105,0,0,1274,1274,0,1,0,1,0
823,435,0,0,60,60,0,1,0,1,0
7949,315,0,0,60,60,0,1,0,1,0
13697,2938,0,0,78,78,0,1,0,1,0
6382,2236,0,0,62,62,0,1,0,1,0
14856,2256,0,0,66,66,0,1,0,1,0
9565,3216,0,0,64,64,0,1,0,1,0
1544,2944,0,0,63,63,0,1,0,1,0
20657,1660,0,0,146,146,0,1,0,1,0
9781,1804,0,0,62,62,0,1,0,1,0
13488,87,0,0,60,60,0,1,0,1,0
22005,3192,0,0,64,64,0,1,0,1,0
1591,1888,0,0,62,62,0,1,0,1,0
15426,997,0,0,70,70,0,1,0,1,0
2669,2897,0,0,62,62,0,1,0,1,0
7951,1147,0,0,146,146,0,1,0,1,0
22632,1017,0,0,64,64,0,1,0,1,0
16464,1017,0,0,80,80,0,1,0,1,0
17568,2245,0,0,66,66,0,1,0,1,0
3254,2382,0,0,66,66,0,1,0,1,0
11981,1106,0,0,66,66,0,1,0,1,0
2974,1888,0,0,62,62,0,1,0,1,0
360,3105,0,0,1298,1298,0,1,0,1,0
1742,2558,0,0,146,146,0,1,0,1,0
1598,1757,0,0,62,62,0,1,0,1,0
8590,3231,0,0,91,91,0,1,0,1,0
10426,2614,0,0,68,68,0,1,0,1,0
17569,2154,0,0,74,74,0,1,0,1,0
37,2380,0,0,62,62,0,1,0,1,0
18716,1788,0,0,64,64,0,1,0,1,0
22457,1888,0,0,66,66,0,1,0,1,0
7335,1072,0,0,60,60,0,1,0,1,0
11,439,0,0,60,60,0,1,0,1,0
1658,7,0,0,60,60,0,1,0,1,0
16144,1397,0,0,66,66,0,1,0,1,0
17903,2256,0,0,62,62,0,1,0,1,0
16746,2587,0,0,62,62,0,1,0,1,0
14860,1804,0,0,64,64,0,1,0,1,0
6376,2899,0,0,71,71,0,1,0,1,0
11282,2362,0,0,62,62,0,1,0,1,0
8846,1107,0,0,64,64,0,1,0,1,0
1799,299,0,0,77,77,0,1,0,1,0
450,126,0,0,136,136,0,1,0,1,0
1528,1771,0,0,66,66,0,1,0,1,0
2548,2175,0,0,60,60,0,1,0,1,0
19601,2621,0,0,66,66,0,1,0,1,0
16951,255,0,0,62,62,0,1,0,1,0
17573,2636,0,0,62,62,0,1,0,1,0
154,3216,0,0,66,66,0,1,0,1,0
16951,255,0,0,62,62,0,1,0,1,0
7425,3216,0,0,62,62,0,1,0,1,0
3029,7,0,0,60,60,0,1,0,1,0
3227,1017,0,0,62,62,0,1,0,1,0
11264,2636,0,0,119,119,0,1,0,1,0
16472,9,0,0,60,60,0,1,0,1,0
11176,1912,0,0,66,66,0,1,0,1,0
577,2611,0,0,78,78,0,1,0,1,0
3141,2938,0,0,73,73,0,1,0,1,0
22230,1571,0,0,62,62,0,1,0,1,0
611,1888,0,0,65,65,0,1,0,1,0
10462,280,0,0,65,65,0,1,0,1,0
2157,3072,0,0,60,60,0,1,0,1,0
1374,1888,0,0,62,62,0,1,0,1,0
22418,1025,0,0,128,128,0,1,0,1,0
16951,255,0,0,62,62,0,1,0,1,0
712,1795,0,0,62,62,0,1,0,1,0
700,2595,0,0,66,66,0,1,0,1,0
4726,1806,0,0,65,65,0,1,0,1,0
11187,2533,0,0,62,62,0,1,0,1,0
1330,697,0,0,62,62,0,1,0,1,0
365,1147,0,0,62,62,0,1,0,1,0
1418,2486,0,0,64,64,0,1,0,1,0
17005,2219,0,0,64,64,0,1,0,1,0
2604,1888,0,0,66,66,0,1,0,1,0
10201,2587,0,0,66,66,0,1,0,1,0
8988,1149,0,0,62,62,0,1,0,1,0
22191,1848,0,0,64,64,0,1,0,1,0
3254,7,0,0,60,60,0,1,0,1,0
11450,245,0,0,60,60,0,1,0,1,0
13617,1147,0,0,64,64,0,1,0,1,0
7949,314,0,0,60,60,0,1,0,1,0
428,1217,0,0,64,64,0,1,0,1,0
3876,1923,0,0,62,62,0,1,0,1,0
1207,1147,0,0,63,63,0,1,0,1,0
2076,3216,0,0,62,62,0,1,0,1,0
21620,1017,0,0,66,66,0,1,0,1,0
1591,1888,0,0,62,62,0,1,0,1,0
11206,1155,0,0,66,66,0,1,0,1,0
3223,383,0,0,66,66,0,1,0,1,0
15892,2589,0,0,66,66,0,1,0,1,0
11629,1147,0,0,66,66,0,1,0,1,0
15588,2144,0,0,62,62,0,1,0,1,0
16951,255,0,0,62,62,0,1,0,1,0
17476,833,0,0,66,66,0,1,0,1,0
770,1888,0,0,62,62,0,1,0,1,0
5424,2582,0,0,73,73,0,1,0,1,0
8107,2256,0,0,146,146,0,1,0,1,0
20492,509,0,0,62,62,0,1,0,1,0
11373,1086,0,0,66,66,0,1,0,1,0
18,3216,0,0,62,62,0,1,0,1,0
677,3216,0,0,63,63,0,1,0,1,0
4000,2636,0,0,108,108,0,1,0,1,0
13826,1494,0,0,66,66,0,1,0,1,0
11766,2611,0,0,68,68,0,1,0,1,0
18023,2256,0,0,66,66,0,1,0,1,0
17004,2587,0,0,66,66,0,1,0,1,0
7653,1224,0,0,60,60,0,1,0,1,0
5568,3197,0,0,62,62,0,1,0,1,0
7,2451,0,0,72,72,0,1,0,1,0
464,2910,0,0,66,66,0,1,0,1,0
4324,11,0,0,60,60,0,1,0,1,0
470,2586,0,0,65,65,0,1,0,1,0
1542,1888,0,0,63,63,0,1,0,1,0
2945,3216,0,0,62,62,0,1,0,1,0
2668,2876,0,0,62,62,0,1,0,1,0
18068,1888,0,0,66,66,0,1,0,1,0
1525,1444,0,0,145,145,0,1,0,1,0
18767,2144,0,0,65,65,0,1,0,1,0
17957,697,0,0,66,66,0,1,0,1,0
415,2932,0,0,62,62,0,1,0,1,0
20229,1771,0,0,62,62,0,1,0,1,0
10475,6,0,0,60,60,0,1,0,1,0
16959,1805,0,0,70,70,0,1,0,1,0
642,2636,0,0,64,64,0,1,0,1,0
2151,788,0,0,62,62,0,1,0,1,0
10651,1881,0,0,65,65,0,1,0,1,0
1716,2636,0,0,66,66,0,1,0,1,0
168,1147,0,0,146,146,0,1,0,1,0
16951,255,0,0,62,62,0,1,0,1,0
21641,1147,0,0,64,64,0,1,0,1,0
12,2545,0,0,71,71,0,1,0,1,0
7654,1761,0,0,61,61,0,1,0,1,0
2496,1147,0,0,146,146,0,1,0,1,0
360,3105,0,0,248,248,0,1,0,1,0
12711,1888,0,0,66,66,0,1,0,1,0
5203,3116,0,0,115,115,0,1,0,1,0
1525,1444,0,0,145,145,0,1,0,1,0
8706,2587,0,0,66,66,0,1,0,1,0
15263,1147,0,0,62,62,0,1,0,1,0
3108,2951,0,0,62,62,0,1,0,1,0
649,9,0,0,60,60,0,1,0,1,0
19837,3216,0,0,90,90,0,1,0,1,0
731,7,0,0,60,60,0,1,0,1,0
2413,2093,0,0,145,145,0,1,0,1,0
320,1804,0,0,62,62,0,1,0,1,0
11046,1147,0,0,66,66,0,1,0,1,0
22516,1197,0,0,66,66,0,1,0,1,0
1510,1934,0,0,141,141,0,1,0,1,0
129,1472,0,0,65,65,0,1,0,1,0
19649,509,0,0,63,63,0,1,0,1,0
21066,2611,0,0,62,62,0,1,0,1,0
10010,2747,0,0,63,63,0,1,0,1,0
20194,1784,0,0,63,63,0,1,0,1,0
9458,1771,0,0,66,66,0,1,0,1,0
15040,1888,0,0,65,65,0,1,0,1,0
1742,2558,0,0,146,146,0,1,0,1,0
596,1215,0,0,62,62,0,1,0,1,0
4212,1193,0,0,63,63,0,1,0,1,0
7824,2938,0,0,104,104,0,1,0,1,0
19299,3215,0,0,66,66,0,1,0,1,0
11889,3214,0,0,63,63,0,1,0,1,0
575,1888,0,0,62,62,0,1,0,1,0
18781,284,0,0,88,88,0,1,0,1,0
9450,1888,0,0,63,63,0,1,0,1,0
16951,255,0,0,62,62,0,1,0,1,0
4796,654,0,0,62,62,0,1,0,1,0
9214,3256,0,0,60,60,0,1,0,1,0
18,3216,0,0,62,62,0,1,0,1,0
14023,1590,0,0,62,62,0,1,0,1,0
16648,2205,0,0,63,63,0,1,0,1,0
16951,255,0,0,62,62,0,1,0,1,0
17624,2587,0,0,66,66,0,1,0,1,0
3816,2610,0,0,60,60,0,1,0,1,0
21218,1894,0,0,64,64,0,1,0,1,0
2003,2938,0,0,62,62,0,1,0,1,0
17036,1796,0,0,66,66,0,1,0,1,0
20639,3216,0,0,66,66,0,1,0,1,0
389,3216,0,0,65,65,0,1,0,1,0
1222,985,0,0,146,146,0,1,0,1,0
15882,3051,0,0,66,66,0,1,0,1,0
3485,1147,0,0,62,62,0,1,0,1,0
498,2587,0,0,62,62,0,1,0,1,0
20037,1888,0,0,66,66,0,1,0,1,0
321,1946,0,0,99,99,0,1,0,1,0
12559,1800,0,0,63,63,0,1,0,1,0
2440,2587,0,0,62,62,0,1,0,1,0
1533,1888,0,0,66,66,0,1,0,1,0
8581,1017,0,0,65,65,0,1,0,1,0
13815,509,0,0,66,66,0,1,0,1,0
6559,2587,0,0,82,82,0,1,0,1,0
8226,2587,0,0,65,65,0,1,0,1,0
15450,1472,0,0,66,66,0,1,0,1,0
11706,3216,0,0,66,66,0,1,0,1,0
9134,1857,0,0,66,66,0,1,0,1,0
19873,1769,0,0,62,62,0,1,0,1,0
20565,2379,0,0,78,78,0,1,0,1,0
12801,1463,0,0,66,66,0,1,0,1,0
5317,1853,0,0,109,109,0,1,0,1,0
614,1888,0,0,65,65,0,1,0,1,0
4008,697,0,0,70,70,0,1,0,1,0
8115,2571,0,0,62,62,0,1,0,1,0
612,2562,0,0,60,60,0,1,0,1,0
1195,1148,0,0,62,62,0,1,0,1,0
7882,1147,0,0,146,146,0,1,0,1,0
9369,2154,0,0,66,66,0,1,0,1,0
11678,1110,0,0,66,66,0,1,0,1,0
726,7,0,0,60,60,0,1,0,1,0
8859,2573,0,0,65,65,0,1,0,1,0
6815,3216,0,0,62,62,0,1,0,1,0
21420,1147,0,0,62,62,0,1,0,1,0
497,2220,0,0,127,127,0,1,0,1,0
2579,2573,0,0,62,62,0,1,0,1,0
330,1024,0,0,66,66,0,1,0,1,0
15273,1147,0,0,64,64,0,1,0,1,0
1509,1888,0,0,66,66,0,1,0,1,0
17555,1147,0,0,62,62,0,1,0,1,0
11768,1885,0,0,66,66,0,1,0,1,0
1031,2636,0,0,65,65,0,1,0,1,0
1969,2636,0,0,65,65,0,1,0,1,0
11671,2915,0,0,62,62,0,1,0,1,0
20364,3139,0,0,66,66,0,1,0,1,0
13580,3051,0,0,66,66,0,1,0,1,0
4445,2883,0,0,68,68,0,1,0,1,0
0,0,0,0,70,70,0,1,0,1,0
5062,991,0,0,61,61,0,1,0,1,0
6343,2594,0,0,62,62,0,1,0,1,0
22213,2933,0,0,77,77,0,1,0,1,0
6146,269,0,0,60,60,0,1,0,1,0
2588,6,0,0,60,60,0,1,0,1,0
8706,2587,0,0,65,65,0,1,0,1,0
1526,2148,0,0,63,63,0,1,0,1,0
7706,1,0,0,61,61,0,1,0,1,0
7333,2256,0,0,146,146,0,1,0,1,0
14894,2873,0,0,66,66,0,1,0,1,0
560,687,0,0,162,162,0,1,0,1,0
16951,255,0,0,62,62,0,1,0,1,0
14138,3215,0,0,62,62,0,1,0,1,0
497,3013,0,0,66,66,0,1,0,1,0
3219,1472,0,0,62,62,0,1,0,1,0
12,641,0,0,158,158,0,1,0,1,0
19381,2595,0,0,66,66,0,1,0,1,0
22457,1887,0,0,65,65,0,1,0,1,0
9970,2587,0,0,66,66,0,1,0,1,0
18005,3216,0,0,71,71,0,1,0,1,0
10165,1147,0,0,64,64,0,1,0,1,0
21390,155,0,0,66,66,0,1,0,1,0
20253,1595,0,0,107,107,0,1,0,1,0
17231,2938,0,0,68,68,0,1,0,1,0
4984,3216,0,0,97,97,0,1,0,1,0
1358,2607,0,0,66,66,0,1,0,1,0
16994,844,0,0,66,66,0,1,0,1,0
18213,1017,0,0,62,62,0,1,0,1,0
4486,1154,0,0,62,62,0,1,0,1,0
17734,2883,0,0,64,64,0,1,0,1,0
4487,1153,0,0,65,65,0,1,0,1,0
1475,1771,0,0,62,62,0,1,0,1,0
1804,329,0,0,60,60,0,1,0,1,0
1982,3216,0,0,62,62,0,1,0,1,0
17395,2256,0,0,65,65,0,1,0,1,0
2737,1042,0,0,63,63,0,1,0,1,0
16720,2587,0,0,121,121,0,1,0,1,0
13603,1147,0,0,63,63,0,1,0,1,0
3911,1217,0,0,112,112,0,1,0,1,0
1920,2587,0,0,63,63,0,1,0,1,0
3818,1033,0,0,64,64,0,1,0,1,0
1330,804,0,0,62,62,0,1,0,1,0
16430,2156,0,0,66,66,0,1,0,1,0
22229,1614,0,0,65,65,0,1,0,1,0
6262,2598,0,0,64,64,0,1,0,1,0
2925,2883,0,0,105,105,0,1,0,1,0
16951,255,0,0,62,62,0,1,0,1,0
1416,1888,0,0,63,63,0,1,0,1,0
2466,2587,0,0,61,61,0,1,0,1,0
17463,2947,0,0,66,66,0,1,0,1,0
1476,1771,0,0,62,62,0,1,0,1,0
6943,1147,0,0,63,63,0,1,0,1,0
6267,1441,0,0,62,62,0,1,0,1,0
3380,2587,0,0,62,62,0,1,0,1,0
13837,509,0,0,63,63,0,1,0,1,0
431,3177,0,0,63,63,0,1,0,1,0
1691,2636,0,0,62,62,0,1,0,1,0
2105,16,0,0,60,60,0,1,0,1,0
16951,255,0,0,62,62,0,1,0,1,0
2650,3216,0,0,65,65,0,1,0,1,0
16951,255,0,0,62,62,0,1,0,1,0
636,1677,0,0,105,105,0,1,0,1,0
20691,2939,0,0,66,66,0,1,0,1,0
7460,1771,0,0,66,66,0,1,0,1,0
1158,460,0,0,62,62,0,1,0,1,0
1687,2636,0,0,62,62,0,1,0,1,0
13490,1008,0,0,62,62,0,1,0,1,0
13154,1215,0,0,62,62,0,1,0,1,0
2132,1888,0,0,62,62,0,1,0,1,0
1498,1165,0,0,63,63,0,1,0,1,0
11142,180,0,0,64,64,0,1,0,1,0
17598,2587,0,0,63,63,0,1,0,1,0
14131,3212,0,0,64,64,0,1,0,1,0
2983,7,0,0,60,60,0,1,0,1,0
17643,998,0,0,62,62,0,1,0,1,0
1142,1215,0,0,62,62,0,1,0,1,0
19130,2787,0,0,62,62,0,1,0,1,0
17534,2938,0,0,73,73,0,1,0,1,0
10902,274,0,0,64,64,0,1,0,1,0
16951,255,0,0,62,62,0,1,0,1,0
12,3145,0,0,199,199,0,1,0,1,0
10009,1462,0,0,65,65,0,1,0,1,0
10396,505,0,0,66,66,0,1,0,1,0
7335,1070,0,0,60,60,0,1,0,1,0
8043,2950,0,0,76,76,0,1,0,1,0
1858,3216,0,0,64,64,0,1,0,1,0
1608,1017,0,0,64,64,0,1,0,1,0
1759,1017,0,0,63,63,0,1,0,1,0
462,1472,0,0,62,62,0,1,0,1,0
18239,1472,0,0,65,65,0,1,0,1,0
2907,1163,0,0,62,62,0,1,0,1,0
3588,2583,0,0,62,62,0,1,0,1,0
12190,2587,0,0,66,66,0,1,0,1,0
4676,2256,0,0,63,63,0,1,0,1,0
8458,2256,0,0,62,62,0,1,0,1,0
2145,134,0,0,63,63,0,1,0,1,0
491,1036,0,0,60,60,0,1,0,1,0
2377,1147,0,0,62,62,0,1,0,1,0
18,1147,0,0,62,62,0,1,0,1,0
17945,1472,0,0,66,66,0,1,0,1,0
1677,1215,0,0,62,62,0,1,0,1,0
4356,1472,0,0,66,66,0,1,0,1,0
20802,2950,0,0,62,62,0,1,0,1,0
4457,1211,0,0,62,62,0,1,0,1,0
22,2256,0,0,62,62,0,1,0,1,0
20293,3139,0,0,65,65,0,1,0,1,0
22150,3216,0,0,64,64,0,1,0,1,0
344,2587,0,0,64,64,0,1,0,1,0
718,2256,0,0,66,66,0,1,0,1,0
14995,1766,0,0,66,66,0,1,0,1,0
2929,481,0,0,64,64,0,1,0,1,0
597,3217,0,0,145,145,0,1,0,1,0
11726,2890,0,0,66,66,0,1,0,1,0
16951,255,0,0,62,62,0,1,0,1,0
17535,1147,0,0,62,62,0,1,0,1,0
9434,126,0,0,60,60,0,1,0,1,0
19878,2587,0,0,62,62,0,1,0,1,0
17975,2256,0,0,63,63,0,1,0,1,0
16951,255,0,0,62,62,0,1,0,1,0
4091,1017,0,0,63,63,0,1,0,1,0
20836,2629,0,0,66,66,0,1,0,1,0
2460,2489,0,0,152,152,0,1,0,1,0
13036,1827,0,0,62,62,0,1,0,1,0
615,2252,0,0,66,66,0,1,0,1,0
7984,1017,0,0,66,66,0,1,0,1,0
2929,1163,0,0,62,62,0,1,0,1,0
16630,2636,0,0,65,65,0,1,0,1,0
7988,2256,0,0,130,130,0,1,0,1,0
2706,1888,0,0,63,63,0,1,0,1,0
15275,1147,0,0,62,62,0,1,0,1,0
14154,2587,0,0,64,64,0,1,0,1,0
1808,983,0,0,62,62,0,1,0,1,0
16951,255,0,0,62,62,0,1,0,1,0
15614,1180,0,0,62,62,0,1,0,1,0
21341,1147,0,0,86,86,0,1,0,1,0
2814,1147,0,0,62,62,0,1,0,1,0
650,2927,0,0,109,109,0,1,0,1,0
10245,465,0,0,66,66,0,1,0,1,0
3894,697,0,0,62,62,0,1,0,1,0
276,1064,0,0,63,63,0,1,0,1,0
1879,1771,0,0,63,63,0,1,0,1,0
7273,1888,0,0,101,101,0,1,0,1,0
15707,1517,0,0,137,137,0,1,0,1,0
3163,2587,0,0,62,62,0,1,0,1,0
20836,2867,0,0,64,64,0,1,0,1,0
7308,1147,0,0,62,62,0,1,0,1,0
267,1769,0,0,66,66,0,1,0,1,0
21718,3216,0,0,66,66,0,1,0,1,0
11502,1017,0,0,66,66,0,1,0,1,0
8089,2938,0,0,73,73,0,1,0,1,0
16951,255,0,0,62,62,0,1,0,1,0
17742,1888,0,0,63,63,0,1,0,1,0
1784,2875,0,0,145,145,0,1,0,1,0
957,1720,0,0,67,67,0,1,0,1,0
16951,255,0,0,62,62,0,1,0,1,0
1499,1147,0,0,62,62,0,1,0,1,0
3093,7,0,0,60,60,0,1,0,1,0
1819,1147,0,0,62,62,0,1,0,1,0
26,1625,0,0,128,128,0,1,0,1,0
1525,1444,0,0,145,145,0,1,0,1,0
14137,3214,0,0,63,63,0,1,0,1,0
8791,1472,0,0,62,62,0,1,0,1,0
7114,2587,0,0,82,82,0,1,0,1,0
3594,2578,0,0,62,62,0,1,0,1,0
12583,1888,0,0,66,66,0,1,0,1,0
16270,1884,0,0,66,66,0,1,0,1,0
1908,3213,0,0,64,64,0,1,0,1,0
15588,2144,0,0,62,62,0,1,0,1,0
15889,3139,0,0,66,66,0,1,0,1,0
16083,1771,0,0,66,66,0,1,0,1,0
612,201,0,0,60,60,0,1,0,1,0
18927,2126,0,0,66,66,0,1,0,1,0
18192,1472,0,0,62,62,0,1,0,1,0
2149,104,0,0,60,60,0,1,0,1,0
2498,3216,0,0,63,63,0,1,0,1,0
20,1147,0,0,146,146,0,1,0,1,0
8171,1073,0,0,60,60,0,1,0,1,0
16951,255,0,0,62,62,0,1,0,1,0
13301,3216,0,0,62,62,0,1,0,1,0
15976,1017,0,0,62,62,0,1,0,1,0
8360,1663,0,0,62,62,0,1,0,1,0
65,2597,0,0,145,145,0,1,0,1,0
3001,2256,0,0,65,65,0,1,0,1,0
19428,242,0,0,145,145,0,1,0,1,0
11943,3216,0,0,65,65,0,1,0,1,0
11166,1880,0,0,64,64,0,1,0,1,0
10475,6,0,0,60,60,0,1,0,1,0
28,1657,0,0,122,122,0,1,0,1,0
2234,1472,0,0,62,62,0,1,0,1,0
10606,2404,0,0,62,62,0,1,0,1,0
636,280,0,0,146,146,0,1,0,1,0
3982,1002,0,0,62,62,0,1,0,1,0
20206,1593,0,0,99,99,0,1,0,1,0
21212,1147,0,0,146,146,0,1,0,1,0
20,2953,0,0,146,146,0,1,0,1,0
2978,1472,0,0,66,66,0,1,0,1,0
13266,1782,0,0,66,66,0,1,0,1,0
10808,2630,0,0,67,67,0,1,0,1,0
2823,7,0,0,60,60,0,1,0,1,0
3386,1888,0,0,62,62,0,1,0,1,0
3208,1888,0,0,62,62,0,1,0,1,0
2803,1872,0,0,62,62,0,1,0,1,0
3386,1888,0,0,62,62,0,1,0,1,0
18151,1147,0,0,66,66,0,1,0,1,0
17420,2256,0,0,62,62,0,1,0,1,0
5598,3216,0,0,62,62,0,1,0,1,0
14073,1888,0,0,66,66,0,1,0,1,0
1823,1800,0,0,65,65,0,1,0,1,0
773,1888,0,0,62,62,0,1,0,1,0
19834,1017,0,0,66,66,0,1,0,1,0
18903,1147,0,0,66,66,0,1,0,1,0
18,1780,0,0,62,62,0,1,0,1,0
2588,2869,0,0,62,62,0,1,0,1,0
16951,255,0,0,62,62,0,1,0,1,0
8090,1207,0,0,128,128,0,1,0,1,0
16951,255,0,0,62,62,0,1,0,1,0
17208,1884,0,0,66,66,0,1,0,1,0
16959,3214,0,0,62,62,0,1,0,1,0
572,2607,0,0,62,62,0,1,0,1,0
1946,1880,0,0,62,62,0,1,0,1,0
13893,1147,0,0,146,146,0,1,0,1,0
17443,2607,0,0,66,66,0,1,0,1,0
4202,1473,0,0,145,145,0,1,0,1,0
16951,255,0,0,62,62,0,1,0,1,0
1221,1882,0,0,64,64,0,1,0,1,0
9764,2587,0,0,64,64,0,1,0,1,0
2234,7,0,0,60,60,0,1,0,1,0
19,1773,0,0,62,62,0,1,0,1,0
20989,3212,0,0,66,66,0,1,0,1,0
16674,2950,0,0,66,66,0,1,0,1,0
19278,1147,0,0,65,65,0,1,0,1,0
12230,1051,0,0,65,65,0,1,0,1,0
21347,1120,0,0,66,66,0,1,0,1,0
22468,201,0,0,78,78,0,1,0,1,0
19669,1771,0,0,66,66,0,1,0,1,0
11430,2573,0,0,66,66,0,1,0,1,0
1804,1777,0,0,60,60,0,1,0,1,0
16105,2209,0,0,63,63,0,1,0,1,0
173,2486,0,0,63,63,0,1,0,1,0
15694,1202,0,0,145,145,0,1,0,1,0
1597,2203,0,0,62,62,0,1,0,1,0
16951,255,0,0,62,62,0,1,0,1,0
1917,2256,0,0,126,126,0,1,0,1,0
17654,2077,0,0,66,66,0,1,0,1,0
7326,180,0,0,60,60,0,1,0,1,0
360,3105,0,0,919,919,0,1,0,1,0
1628,3216,0,0,65,65,0,1,0,1,0
15333,2808,0,0,64,64,0,1,0,1,0
2236,2601,0,0,63,63,0,1,0,1,0
19132,1888,0,0,63,63,0,1,0,1,0
11949,2256,0,0,63,63,0,1,0,1,0
8004,1064,0,0,64,64,0,1,0,1,0
5040,2636,0,0,66,66,0,1,0,1,0
1326,801,0,0,62,62,0,1,0,1,0
15410,1792,0,0,66,66,0,1,0,1,0
21262,1880,0,0,63,63,0,1,0,1,0
18595,1043,0,0,66,66,0,1,0,1,0
18360,1170,0,0,62,62,0,1,0,1,0
4515,1147,0,0,146,146,0,1,0,1,0
6942,2600,0,0,62,62,0,1,0,1,0
16951,255,0,0,62,62,0,1,0,1,0
18364,1478,0,0,66,66,0,1,0,1,0
21602,2256,0,0,65,65,0,1,0,1,0
3171,1147,0,0,62,62,0,1,0,1,0
6556,2086,0,0,145,145,0,1,0,1,0
15184,2223,0,0,66,66,0,1,0,1,0
732,1590,0,0,62,62,0,1,0,1,0
4490,1147,0,0,65,65,0,1,0,1,0
2253,1017,0,0,62,62,0,1,0,1,0
18,1147,0,0,62,62,0,1,0,1,0
7702,3216,0,0,62,62,0,1,0,1,0
6888,1088,0,0,65,65,0,1,0,1,0
5130,697,0,0,117,117,0,1,0,1,0
372,2636,0,0,66,66,0,1,0,1,0
18843,1783,0,0,65,65,0,1,0,1,0
1525,1444,0,0,145,145,0,1,0,1,0
6815,3216,0,0,62,62,0,1,0,1,0
12,457,0,0,64,64,0,1,0,1,0
15275,2681,0,0,62,62,0,1,0,1,0
20364,3139,0,0,62,62,0,1,0,1,0
4222,2619,0,0,62,62,0,1,0,1,0
7335,1072,0,0,60,60,0,1,0,1,0
600,1147,0,0,65,65,0,1,0,1,0
21307,1147,0,0,62,62,0,1,0,1,0
20659,1771,0,0,65,65,0,1,0,1,0
21342,1083,0,0,65,65,0,1,0,1,0
7470,2197,0,0,103,103,0,1,0,1,0
16,2253,0,0,66,66,0,1,0,1,0
1735,2084,0,0,96,96,0,1,0,1,0
6229,2938,0,0,78,78,0,1,0,1,0
8617,3108,0,0,62,62,0,1,0,1,0
12998,1147,0,0,63,63,0,1,0,1,0
21481,2604,0,0,66,66,0,1,0,1,0
2592,1791,0,0,66,66,0,1,0,1,0
20314,3139,0,0,103,103,0,1,0,1,0
2298,1936,0,0,60,60,0,1,0,1,0
129,1472,0,0,66,66,0,1,0,1,0
375,3216,0,0,62,62,0,1,0,1,0
4939,243,0,0,62,62,0,1,0,1,0
2662,2938,0,0,62,62,0,1,0,1,0
5327,1888,0,0,62,62,0,1,0,1,0
19350,2587,0,0,62,62,0,1,0,1,0
551,470,0,0,92,92,0,1,0,1,0
10450,539,0,0,85,85,0,1,0,1,0
11038,2946,0,0,63,63,0,1,0,1,0
2806,1017,0,0,62,62,0,1,0,1,0
360,3105,0,0,164,164,0,1,0,1,0
16007,2938,0,0,62,62,0,1,0,1,0
22457,1888,0,0,66,66,0,1,0,1,0
260,2636,0,0,65,65,0,1,0,1,0
4010,939,0,0,64,64,0,1,0,1,0
15971,1888,0,0,65,65,0,1,0,1,0
1402,2938,0,0,62,62,0,1,0,1,0
11029,1888,0,0,62,62,0,1,0,1,0
202,901,0,0,62,62,0,1,0,1,0
10763,918,0,0,64,64,0,1,0,1,0
2468,1785,0,0,66,66,0,1,0,1,0
16951,255,0,0,62,62,0,1,0,1,0
360,3105,0,0,552,552,0,1,0,1,0
7949,314,0,0,60,60,0,1,0,1,0
1870,1016,0,0,62,62,0,1,0,1,0
16989,847,0,0,66,66,0,1,0,1,0
3727,1835,0,0,63,63,0,1,0,1,0
6815,3216,0,0,62,62,0,1,0,1,0
6921,3212,0,0,66,66,0,1,0,1,0
21266,1147,0,0,62,62,0,1,0,1,0
6301,2938,0,0,61,61,0,1,0,1,0
16951,255,0,0,62,62,0,1,0,1,0
588,2611,0,0,78,78,0,1,0,1,0
17481,1771,0,0,62,62,0,1,0,1,0
10384,169,0,0,116,116,0,1,0,1,0
3109,1147,0,0,62,62,0,1,0,1,0
15905,3150,0,0,66,66,0,1,0,1,0
12610,1147,0,0,63,63,0,1,0,1,0
11168,1215,0,0,66,66,0,1,0,1,0
3197,948,0,0,63,63,0,1,0,1,0
8969,279,0,0,65,65,0,1,0,1,0
10505,3003,0,0,100,100,0,1,0,1,0
19638,1869,0,0,66,66,0,1,0,1,0
17629,2587,0,0,66,66,0,1,0,1,0
12707,1798,0,0,62,62,0,1,0,1,0
1340,697,0,0,62,62,0,1,0,1,0
16951,255,0,0,62,62,0,1,0,1,0
2084,1471,0,0,145,145,0,1,0,1,0
3876,1923,0,0,62,62,0,1,0,1,0
16273,661,0,0,68,68,0,1,0,1,0
16951,255,0,0,62,62,0,1,0,1,0
16582,2205,0,0,64,64,0,1,0,1,0
19142,1017,0,0,66,66,0,1,0,1,0
17510,936,0,0,66,66,0,1,0,1,0
1793,2936,0,0,61,61,0,1,0,1,0
17660,2073,0,0,62,62,0,1,0,1,0
17059,1472,0,0,66,66,0,1,0,1,0
1803,2921,0,0,60,60,0,1,0,1,0
11650,1878,0,0,62,62,0,1,0,1,0
2312,1017,0,0,66,66,0,1,0,1,0
13678,1883,0,0,138,138,0,1,0,1,0
2006,3216,0,0,62,62,0,1,0,1,0
13,216,0,0,70,70,0,1,0,1,0
83,1147,0,0,65,65,0,1,0,1,0
11358,3178,0,0,66,66,0,1,0,1,0
9102,2938,0,0,66,66,0,1,0,1,0
6124,1777,0,0,62,62,0,1,0,1,0
21291,1003,0,0,63,63,0,1,0,1,0
21612,1885,0,0,64,64,0,1,0,1,0
3652,2630,0,0,128,128,0,1,0,1,0
13629,136,0,0,60,60,0,1,0,1,0
3702,1000,0,0,62,62,0,1,0,1,0
16951,255,0,0,62,62,0,1,0,1,0
7456,2256,0,0,146,146,0,1,0,1,0
5231,1147,0,0,62,62,0,1,0,1,0
3657,1017,0,0,62,62,0,1,0,1,0
11420,2869,0,0,66,66,0,1,0,1,0
19842,2931,0,0,66,66,0,1,0,1,0
16951,255,0,0,62,62,0,1,0,1,0
1617,2150,0,0,64,64,0,1,0,1,0
7212,4,0,0,61,61,0,1,0,1,0
635,2655,0,0,76,76,0,1,0,1,0
10692,2256,0,0,66,66,0,1,0,1,0
13411,1472,0,0,65,65,0,1,0,1,0
12,2358,0,0,74,74,0,1,0,1,0
10475,6,0,0,60,60,0,1,0,1,0
19406,1881,0,0,66,66,0,1,0,1,0
878,1636,0,0,65,65,0,1,0,1,0
20162,2747,0,0,66,66,0,1,0,1,0
2717,2938,0,0,62,62,0,1,0,1,0
2316,2486,0,0,65,65,0,1,0,1,0
12078,3139,0,0,62,62,0,1,0,1,0
16951,255,0,0,62,62,0,1,0,1,0
3303,1888,0,0,66,66,0,1,0,1,0
3154,1771,0,0,62,62,0,1,0,1,0
360,3105,0,0,164,164,0,1,0,1,0
643,2486,0,0,139,139,0,1,0,1,0
5828,3216,0,0,62,62,0,1,0,1,0
2203,2938,0,0,72,72,0,1,0,1,0
2058,1903,0,0,62,62,0,1,0,1,0
2278,2636,0,0,62,62,0,1,0,1,0
7474,2202,0,0,106,106,0,1,0,1,0
799,1652,0,0,60,60,0,1,0,1,0
8402,1791,0,0,65,65,0,1,0,1,0
19288,2587,0,0,62,62,0,1,0,1,0
22174,1829,0,0,63,63,0,1,0,1,0
2323,1771,0,0,64,64,0,1,0,1,0
16254,1447,0,0,61,61,0,1,0,1,0
1583,2587,0,0,62,62,0,1,0,1,0
16731,1086,0,0,66,66,0,1,0,1,0
11976,2188,0,0,66,66,0,1,0,1,0
4316,2911,0,0,104,104,0,1,0,1,0
12886,1167,0,0,64,64,0,1,0,1,0
19944,3169,0,0,62,62,0,1,0,1,0
21257,2938,0,0,70,70,0,1,0,1,0
16441,3208,0,0,65,65,0,1,0,1,0
0,0,0,0,70,70,0,1,0,1,0
18040,2256,0,0,66,66,0,1,0,1,0
312,1888,0,0,62,62,0,1,0,1,0
15004,2606,0,0,78,78,0,1,0,1,0
2648,3216,0,0,62,62,0,1,0,1,0
16951,255,0,0,62,62,0,1,0,1,0
13521,933,0,0,62,62,0,1,0,1,0
2320,1147,0,0,146,146,0,1,0,1,0
16412,2256,0,0,63,63,0,1,0,1,0
636,2856,0,0,139,139,0,1,0,1,0
16990,509,0,0,64,64,0,1,0,1,0
3728,1929,0,0,72,72,0,1,0,1,0
2788,1067,0,0,146,146,0,1,0,1,0
7985,318,0,0,60,60,0,1,0,1,0
1813,1141,0,0,61,61,0,1,0,1,0
16827,509,0,0,66,66,0,1,0,1,0
10141,3216,0,0,91,91,0,1,0,1,0
7509,218,0,0,60,60,0,1,0,1,0
13332,322,0,0,62,62,0,1,0,1,0
3127,6,0,0,60,60,0,1,0,1,0
6509,1215,0,0,62,62,0,1,0,1,0
16951,255,0,0,62,62,0,1,0,1,0
4328,1147,0,0,62,62,0,1,0,1,0
575,2205,0,0,72,72,0,1,0,1,0
8227,2587,0,0,65,65,0,1,0,1,0
5452,1888,0,0,62,62,0,1,0,1,0
15512,1031,0,0,146,146,0,1,0,1,0
10643,1880,0,0,62,62,0,1,0,1,0
1588,2587,0,0,130,130,0,1,0,1,0
637,2336,0,0,150,150,0,1,0,1,0
7201,3216,0,0,67,67,0,1,0,1,0
10204,2587,0,0,66,66,0,1,0,1,0
9410,3208,0,0,74,74,0,1,0,1,0
22334,1017,0,0,91,91,0,1,0,1,0
665,1502,0,0,127,127,0,1,0,1,0
1338,1017,0,0,64,64,0,1,0,1,0
3024,1785,0,0,66,66,0,1,0,1,0
13405,1802,0,0,62,62,0,1,0,1,0
10792,2599,0,0,66,66,0,1,0,1,0
16951,255,0,0,62,62,0,1,0,1,0
142,3139,0,0,65,65,0,1,0,1,0
7540,2953,0,0,66,66,0,1,0,1,0
687,2938,0,0,62,62,0,1,0,1,0
9813,2997,0,0,66,66,0,1,0,1,0
9745,1155,0,0,66,66,0,1,0,1,0
9487,1888,0,0,66,66,0,1,0,1,0
6292,1017,0,0,62,62,0,1,0,1,0
7561,2631,0,0,62,62,0,1,0,1,0
18789,1827,0,0,66,66,0,1,0,1,0
12,1596,0,0,89,89,0,1,0,1,0
1525,1444,0,0,145,145,0,1,0,1,0
612,225,0,0,60,60,0,1,0,1,0
3732,1932,0,0,73,73,0,1,0,1,0
243,2587,0,0,66,66,0,1,0,1,0
8135,2587,0,0,146,146,0,1,0,1,0
17541,990,0,0,66,66,0,1,0,1,0
16258,1137,0,0,146,146,0,1,0,1,0
0,0,0,0,98,98,0,1,0,1,0
18069,542,0,0,66,66,0,1,0,1,0
19892,2938,0,0,74,74,0,1,0,1,0
8206,1020,0,0,140,140,0,1,0,1,0
1295,1147,0,0,62,62,0,1,0,1,0
19844,1147,0,0,146,146,0,1,0,1,0
6307,1017,0,0,101,101,0,1,0,1,0
1525,1444,0,0,145,145,0,1,0,1,0
16951,255,0,0,62,62,0,1,0,1,0
21398,3151,0,0,62,62,0,1,0,1,0
18518,785,0,0,66,66,0,1,0,1,0
13191,996,0,0,63,63,0,1,0,1,0
15603,1171,0,0,62,62,0,1,0,1,0
12764,2238,0,0,62,62,0,1,0,1,0
13481,1017,0,0,63,63,0,1,0,1,0
15214,2486,0,0,65,65,0,1,0,1,0
16937,1774,0,0,66,66,0,1,0,1,0
20531,1017,0,0,64,64,0,1,0,1,0
16835,2940,0,0,66,66,0,1,0,1,0
10673,1187,0,0,63,63,0,1,0,1,0
13294,1167,0,0,66,66,0,1,0,1,0
4572,983,0,0,62,62,0,1,0,1,0
10189,1777,0,0,61,61,0,1,0,1,0
20044,2592,0,0,67,67,0,1,0,1,0
6947,1147,0,0,64,64,0,1,0,1,0
7948,1147,0,0,146,146,0,1,0,1,0
612,21,0,0,60,60,0,1,0,1,0
1801,1773,0,0,61,61,0,1,0,1,0
8744,2938,0,0,67,67,0,1,0,1,0
2217,2883,0,0,66,66,0,1,0,1,0
6682,2256,0,0,62,62,0,1,0,1,0
10789,1481,0,0,65,65,0,1,0,1,0
1281,2543,0,0,60,60,0,1,0,1,0
360,3105,0,0,1107,1107,0,1,0,1,0
1609,1800,0,0,62,62,0,1,0,1,0
2304,1215,0,0,62,62,0,1,0,1,0
9504,1782,0,0,62,62,0,1,0,1,0
3203,1212,0,0,145,145,0,1,0,1,0
2844,2934,0,0,67,67,0,1,0,1,0
21455,155,0,0,66,66,0,1,0,1,0
17137,2636,0,0,66,66,0,1,0,1,0
7032,2938,0,0,74,74,0,1,0,1,0
6310,1017,0,0,62,62,0,1,0,1,0
2132,1888,0,0,62,62,0,1,0,1,0
13340,1880,0,0,66,66,0,1,0,1,0
14875,2696,0,0,63,63,0,1,0,1,0
2277,1472,0,0,62,62,0,1,0,1,0
7326,1649,0,0,60,60,0,1,0,1,0
1328,7,0,0,60,60,0,1,0,1,0
18320,2315,0,0,66,66,0,1,0,1,0
14032,1017,0,0,146,146,0,1,0,1,0
1758,2256,0,0,66,66,0,1,0,1,0
20239,2597,0,0,65,65,0,1,0,1,0
1409,459,0,0,72,72,0,1,0,1,0
10529,518,0,0,87,87,0,1,0,1,0
9790,1795,0,0,64,64,0,1,0,1,0
20002,2256,0,0,64,64,0,1,0,1,0
3483,2256,0,0,63,63,0,1,0,1,0
7631,1804,0,0,62,62,0,1,0,1,0
2084,1471,0,0,145,145,0,1,0,1,0
8,442,0,0,60,60,0,1,0,1,0
6938,7,0,0,60,60,0,1,0,1,0
5567,7,0,0,60,60,0,1,0,1,0
256,1881,0,0,65,65,0,1,0,1,0
0,0,0,0,70,70,0,1,0,1,0
2640,2938,0,0,62,62,0,1,0,1,0
15033,1017,0,0,146,146,0,1,0,1,0
13206,3139,0,0,66,66,0,1,0,1,0
20695,2938,0,0,66,66,0,1,0,1,0
2803,1872,0,0,62,62,0,1,0,1,0
14372,1797,0,0,62,62,0,1,0,1,0
15325,1820,0,0,63,63,0,1,0,1,0
16665,2591,0,0,62,62,0,1,0,1,0
9207,995,0,0,66,66,0,1,0,1,0
1689,1888,0,0,62,62,0,1,0,1,0
16831,509,0,0,66,66,0,1,0,1,0
11434,2579,0,0,67,67,0,1,0,1,0
7339,141,0,0,60,60,0,1,0,1,0
13104,1041,0,0,64,64,0,1,0,1,0
6655,721,0,0,71,71,0,1,0,1,0
10214,3188,0,0,62,62,0,1,0,1,0
1887,284,0,0,61,61,0,1,0,1,0
438,2636,0,0,62,62,0,1,0,1,0
21136,1147,0,0,63,63,0,1,0,1,0
3103,1147,0,0,63,63,0,1,0,1,0
19166,1017,0,0,66,66,0,1,0,1,0
12850,1147,0,0,134,134,0,1,0,1,0
1364,2883,0,0,65,65,0,1,0,1,0
2423,2938,0,0,62,62,0,1,0,1,0
16552,209,0,0,130,130,0,1,0,1,0
2659,2611,0,0,78,78,0,1,0,1,0
434,1771,0,0,63,63,0,1,0,1,0
1416,1795,0,0,64,64,0,1,0,1,0
15556,1161,0,0,62,62,0,1,0,1,0
13093,1936,0,0,77,77,0,1,0,1,0
10229,502,0,0,66,66,0,1,0,1,0
20009,1213,0,0,62,62,0,1,0,1,0
20811,2953,0,0,62,62,0,1,0,1,0
4176,2614,0,0,75,75,0,1,0,1,0
13439,1888,0,0,65,65,0,1,0,1,0
7229,353,0,0,88,88,0,1,0,1,0
2780,286,0,0,62,62,0,1,0,1,0
20634,2950,0,0,64,64,0,1,0,1,0
1854,2587,0,0,146,146,0,1,0,1,0
1466,521,0,0,62,62,0,1,0,1,0
1154,1590,0,0,64,64,0,1,0,1,0
11988,1147,0,0,63,63,0,1,0,1,0
16951,255,0,0,62,62,0,1,0,1,0
1684,2256,0,0,62,62,0,1,0,1,0
16951,255,0,0,62,62,0,1,0,1,0
2084,1471,0,0,145,145,0,1,0,1,0
17898,1151,0,0,66,66,0,1,0,1,0
2505,1888,0,0,62,62,0,1,0,1,0
1608,3173,0,0,62,62,0,1,0,1,0
1233,1884,0,0,63,63,0,1,0,1,0
7956,2587,0,0,62,62,0,1,0,1,0
13014,1806,0,0,62,62,0,1,0,1,0
11943,2256,0,0,66,66,0,1,0,1,0
7557,2951,0,0,65,65,0,1,0,1,0
1965,1888,0,0,62,62,0,1,0,1,0
1955,509,0,0,66,66,0,1,0,1,0
2834,1888,0,0,62,62,0,1,0,1,0
24,1787,0,0,139,139,0,1,0,1,0
841,1,0,0,61,61,0,1,0,1,0
684,1147,0,0,63,63,0,1,0,1,0
11640,315,0,0,70,70,0,1,0,1,0
22340,2591,0,0,66,66,0,1,0,1,0
817,2672,0,0,60,60,0,1,0,1,0
2696,2587,0,0,62,62,0,1,0,1,0
672,1147,0,0,66,66,0,1,0,1,0
360,3105,0,0,483,483,0,1,0,1,0
12,3074,0,0,320,320,0,1,0,1,0
18893,2489,0,0,62,62,0,1,0,1,0
6822,265,0,0,61,61,0,1,0,1,0
18957,3216,0,0,66,66,0,1,0,1,0
13923,1888,0,0,84,84,0,1,0,1,0
3022,2596,0,0,146,146,0,1,0,1,0
652,144,0,0,133,133,0,1,0,1,0
1268,1887,0,0,62,62,0,1,0,1,0
4993,194,0,0,96,96,0,1,0,1,0
46,2946,0,0,146,146,0,1,0,1,0
2236,2587,0,0,65,65,0,1,0,1,0
9957,2657,0,0,66,66,0,1,0,1,0
6229,2938,0,0,78,78,0,1,0,1,0
497,653,0,0,220,220,0,1,0,1,0
19872,1086,0,0,66,66,0,1,0,1,0
7353,3216,0,0,62,62,0,1,0,1,0
19873,2883,0,0,66,66,0,1,0,1,0
7273,1888,0,0,62,62,0,1,0,1,0
22,2256,0,0,62,62,0,1,0,1,0
1855,1,0,0,62,62,0,1,0,1,0
2500,3216,0,0,65,65,0,1,0,1,0
15896,2938,0,0,66,66,0,1,0,1,0
22164,1800,0,0,62,62,0,1,0,1,0
12008,2256,0,0,110,110,0,1,0,1,0
15406,1790,0,0,65,65,0,1,0,1,0
18061,1797,0,0,62,62,0,1,0,1,0
4344,3216,0,0,62,62,0,1,0,1,0
8970,3216,0,0,64,64,0,1,0,1,0
12805,1464,0,0,66,66,0,1,0,1,0
16951,255,0,0,62,62,0,1,0,1,0
19419,2953,0,0,66,66,0,1,0,1,0
17420,2628,0,0,66,66,0,1,0,1,0
14808,1215,0,0,63,63,0,1,0,1,0
12,2205,0,0,84,84,0,1,0,1,0
7949,314,0,0,60,60,0,1,0,1,0
6925,1526,0,0,146,146,0,1,0,1,0
11369,2836,0,0,62,62,0,1,0,1,0
829,195,0,0,60,60,0,1,0,1,0
2218,2572,0,0,66,66,0,1,0,1,0
2619,7,0,0,60,60,0,1,0,1,0
18,2256,0,0,62,62,0,1,0,1,0
9781,1804,0,0,64,64,0,1,0,1,0
13710,2235,0,0,62,62,0,1,0,1,0
17,2499,0,0,137,137,0,1,0,1,0
2664,1151,0,0,147,147,0,1,0,1,0
16951,255,0,0,62,62,0,1,0,1,0
422,2587,0,0,63,63,0,1,0,1,0
1731,3216,0,0,62,62,0,1,0,1,0
306,2938,0,0,66,66,0,1,0,1,0
721,1147,0,0,63,63,0,1,0,1,0
4242,7,0,0,60,60,0,1,0,1,0
12287,2256,0,0,62,62,0,1,0,1,0
16951,255,0,0,62,62,0,1,0,1,0
1796,295,0,0,89,89,0,1,0,1,0
1534,2256,0,0,65,65,0,1,0,1,0
16951,255,0,0,62,62,0,1,0,1,0
2902,2897,0,0,62,62,0,1,0,1,0
21125,1147,0,0,66,66,0,1,0,1,0
21046,1147,0,0,62,62,0,1,0,1,0
21379,1017,0,0,64,64,0,1,0,1,0
636,280,0,0,62,62,0,1,0,1,0
3071,1888,0,0,66,66,0,1,0,1,0
16099,2883,0,0,66,66,0,1,0,1,0
13719,2250,0,0,64,64,0,1,0,1,0
2389,1880,0,0,62,62,0,1,0,1,0
12,447,0,0,60,60,0,1,0,1,0
7653,1224,0,0,60,60,0,1,0,1,0
17821,2587,0,0,62,62,0,1,0,1,0
12,2346,0,0,332,332,0,1,0,1,0
6106,2587,0,0,66,66,0,1,0,1,0
636,280,0,0,62,62,0,1,0,1,0
10583,2256,0,0,62,62,0,1,0,1,0
7981,2938,0,0,62,62,0,1,0,1,0
468,1888,0,0,66,66,0,1,0,1,0
427,1215,0,0,63,63,0,1,0,1,0
20775,1147,0,0,66,66,0,1,0,1,0
18671,2604,0,0,66,66,0,1,0,1,0
390,797,0,0,62,62,0,1,0,1,0
505,1598,0,0,91,91,0,1,0,1,0
15694,1787,0,0,145,145,0,1,0,1,0
9742,1184,0,0,66,66,0,1,0,1,0
13707,2894,0,0,68,68,0,1,0,1,0
20162,3216,0,0,62,62,0,1,0,1,0
18546,1147,0,0,66,66,0,1,0,1,0
2138,2938,0,0,62,62,0,1,0,1,0
9260,1478,0,0,63,63,0,1,0,1,0
1898,2256,0,0,64,64,0,1,0,1,0
10873,1476,0,0,66,66,0,1,0,1,0
8806,1472,0,0,62,62,0,1,0,1,0
20795,3139,0,0,66,66,0,1,0,1,0
1155,1590,0,0,62,62,0,1,0,1,0
186,2486,0,0,66,66,0,1,0,1,0
1677,1147,0,0,146,146,0,1,0,1,0
2104,367,0,0,60,60,0,1,0,1,0
14499,3215,0,0,65,65,0,1,0,1,0
17861,2713,0,0,64,64,0,1,0,1,0
174,2222,0,0,66,66,0,1,0,1,0
5850,3112,0,0,145,145,0,1,0,1,0
7213,357,0,0,62,62,0,1,0,1,0
16321,3216,0,0,64,64,0,1,0,1,0
1892,1771,0,0,63,63,0,1,0,1,0
19120,1191,0,0,62,62,0,1,0,1,0
10475,6,0,0,60,60,0,1,0,1,0
2574,2572,0,0,61,61,0,1,0,1,0
5766,758,0,0,71,71,0,1,0,1,0
311,3216,0,0,62,62,0,1,0,1,0
13249,1149,0,0,66,66,0,1,0,1,0
732,1590,0,0,62,62,0,1,0,1,0
12184,1777,0,0,64,64,0,1,0,1,0
14208,2240,0,0,67,67,0,1,0,1,0
275,9,0,0,60,60,0,1,0,1,0
19,3221,0,0,137,137,0,1,0,1,0
16149,1391,0,0,64,64,0,1,0,1,0
1854,2744,0,0,62,62,0,1,0,1,0
16951,255,0,0,62,62,0,1,0,1,0
10417,2602,0,0,68,68,0,1,0,1,0
10999,2256,0,0,66,66,0,1,0,1,0
1702,1147,0,0,146,146,0,1,0,1,0
11929,3216,0,0,62,62,0,1,0,1,0
12342,1880,0,0,66,66,0,1,0,1,0
7335,1070,0,0,60,60,0,1,0,1,0
1329,1476,0,0,62,62,0,1,0,1,0
7939,144,0,0,145,145,0,1,0,1,0
1794,2104,0,0,145,145,0,1,0,1,0
6496,947,0,0,62,62,0,1,0,1,0
8646,2893,0,0,64,64,0,1,0,1,0
18970,1017,0,0,64,64,0,1,0,1,0
3142,3216,0,0,62,62,0,1,0,1,0
2833,1888,0,0,62,62,0,1,0,1,0
16951,255,0,0,62,62,0,1,0,1,0
17607,2587,0,0,66,66,0,1,0,1,0
9938,1812,0,0,62,62,0,1,0,1,0
7373,2587,0,0,65,65,0,1,0,1,0
1922,2256,0,0,62,62,0,1,0,1,0
3442,6,0,0,60,60,0,1,0,1,0
17691,1888,0,0,62,62,0,1,0,1,0
13436,1888,0,0,65,65,0,1,0,1,0
16951,255,0,0,62,62,0,1,0,1,0
7979,674,0,0,85,85,0,1,0,1,0
9935,2713,0,0,62,62,0,1,0,1,0
20541,1888,0,0,65,65,0,1,0,1,0
7056,2938,0,0,66,66,0,1,0,1,0
7675,1867,0,0,62,62,0,1,0,1,0
15860,1888,0,0,62,62,0,1,0,1,0
19233,2498,0,0,62,62,0,1,0,1,0
20834,2636,0,0,66,66,0,1,0,1,0
1164,3216,0,0,62,62,0,1,0,1,0
12030,2610,0,0,73,73,0,1,0,1,0
8212,3176,0,0,99,99,0,1,0,1,0
635,2403,0,0,146,146,0,1,0,1,0
14461,2741,0,0,70,70,0,1,0,1,0
2167,2938,0,0,62,62,0,1,0,1,0
20792,2573,0,0,65,65,0,1,0,1,0
9999,1215,0,0,66,66,0,1,0,1,0
20060,2938,0,0,66,66,0,1,0,1,0
1286,1771,0,0,64,64,0,1,0,1,0
2121,3216,0,0,62,62,0,1,0,1,0
12,3116,0,0,1484,1484,0,1,0,1,0
3247,1017,0,0,66,66,0,1,0,1,0
22599,1771,0,0,63,63,0,1,0,1,0
1873,1147,0,0,146,146,0,1,0,1,0
2253,1017,0,0,62,62,0,1,0,1,0
20989,3212,0,0,66,66,0,1,0,1,0
553,2256,0,0,63,63,0,1,0,1,0
16941,3212,0,0,66,66,0,1,0,1,0
7326,180,0,0,60,60,0,1,0,1,0
251,180,0,0,66,66,0,1,0,1,0
2084,1471,0,0,145,145,0,1,0,1,0
1475,2636,0,0,62,62,0,1,0,1,0
16951,255,0,0,62,62,0,1,0,1,0
4327,2913,0,0,145,145,0,1,0,1,0
12704,1888,0,0,66,66,0,1,0,1,0
10988,2256,0,0,63,63,0,1,0,1,0
12563,11,0,0,62,62,0,1,0,1,0
3581,1147,0,0,62,62,0,1,0,1,0
12,929,0,0,83,83,0,1,0,1,0
8164,2725,0,0,60,60,0,1,0,1,0
19639,1870,0,0,66,66,0,1,0,1,0
6664,1215,0,0,65,65,0,1,0,1,0
17461,2942,0,0,66,66,0,1,0,1,0
21920,1215,0,0,62,62,0,1,0,1,0
11652,2626,0,0,66,66,0,1,0,1,0
1893,2256,0,0,65,65,0,1,0,1,0
4190,2611,0,0,60,60,0,1,0,1,0
5186,1888,0,0,62,62,0,1,0,1,0
7355,2235,0,0,64,64,0,1,0,1,0
10935,1213,0,0,62,62,0,1,0,1,0
17807,3187,0,0,64,64,0,1,0,1,0
18512,1771,0,0,63,63,0,1,0,1,0
613,2565,0,0,60,60,0,1,0,1,0
7053,2938,0,0,66,66,0,1,0,1,0
1828,460,0,0,63,63,0,1,0,1,0
188,1789,0,0,61,61,0,1,0,1,0
1965,1888,0,0,62,62,0,1,0,1,0
7574,2947,0,0,64,64,0,1,0,1,0
5743,3216,0,0,62,62,0,1,0,1,0
16951,255,0,0,62,62,0,1,0,1,0
677,3216,0,0,66,66,0,1,0,1,0
6959,1147,0,0,62,62,0,1,0,1,0
19686,2587,0,0,66,66,0,1,0,1,0
2417,2490,0,0,153,153,0,1,0,1,0
198,165,0,0,63,63,0,1,0,1,0
8,2949,0,0,1511,1511,0,1,0,1,0
18661,3047,0,0,62,62,0,1,0,1,0
20473,2615,0,0,66,66,0,1,0,1,0
0,0,0,0,98,98,0,1,0,1,0
12,2784,0,0,82,82,0,1,0,1,0
360,503,0,0,66,66,0,1,0,1,0
1924,2580,0,0,64,64,0,1,0,1,0
38,2603,0,0,62,62,0,1,0,1,0
13654,979,0,0,66,66,0,1,0,1,0
21359,1147,0,0,65,65,0,1,0,1,0
19100,334,0,0,60,60,0,1,0,1,0
7326,1649,0,0,60,60,0,1,0,1,0
8002,1147,0,0,62,62,0,1,0,1,0
12018,3070,0,0,66,66,0,1,0,1,0
1577,829,0,0,62,62,0,1,0,1,0
17369,2938,0,0,65,65,0,1,0,1,0
7228,3216,0,0,62,62,0,1,0,1,0
120,2883,0,0,62,62,0,1,0,1,0
18489,2938,0,0,62,62,0,1,0,1,0
1680,1888,0,0,62,62,0,1,0,1,0
9795,1163,0,0,62,62,0,1,0,1,0
14951,1017,0,0,62,62,0,1,0,1,0
11812,1884,0,0,64,64,0,1,0,1,0
11584,403,0,0,62,62,0,1,0,1,0
14953,2256,0,0,63,63,0,1,0,1,0
10184,1025,0,0,66,66,0,1,0,1,0
2151,2938,0,0,62,62,0,1,0,1,0
2188,6,0,0,60,60,0,1,0,1,0
8293,1147,0,0,64,64,0,1,0,1,0
17793,1888,0,0,66,66,0,1,0,1,0
3632,2256,0,0,66,66,0,1,0,1,0
20253,1596,0,0,106,106,0,1,0,1,0
1102,7,0,0,60,60,0,1,0,1,0
9583,1154,0,0,65,65,0,1,0,1,0
3978,1011,0,0,62,62,0,1,0,1,0
2759,2611,0,0,63,63,0,1,0,1,0
12825,2938,0,0,66,66,0,1,0,1,0
5261,2744,0,0,144,144,0,1,0,1,0
305,1888,0,0,62,62,0,1,0,1,0
13682,2951,0,0,76,76,0,1,0,1,0
18,522,0,0,64,64,0,1,0,1,0
16083,1771,0,0,66,66,0,1,0,1,0
7764,2587,0,0,129,129,0,1,0,1,0
11019,1017,0,0,105,105,0,1,0,1,0
131,1472,0,0,62,62,0,1,0,1,0
21493,2593,0,0,66,66,0,1,0,1,0
7000,2370,0,0,74,74,0,1,0,1,0
3636,3249,0,0,155,155,0,1,0,1,0
4593,2256,0,0,62,62,0,1,0,1,0
8221,2587,0,0,62,62,0,1,0,1,0
5131,2625,0,0,62,62,0,1,0,1,0
12,3141,0,0,199,199,0,1,0,1,0
2292,1472,0,0,65,65,0,1,0,1,0
7792,2587,0,0,66,66,0,1,0,1,0
497,672,0,0,66,66,0,1,0,1,0
18965,2522,0,0,88,88,0,1,0,1,0
14,3225,0,0,133,133,0,1,0,1,0
16478,245,0,0,60,60,0,1,0,1,0
13791,1215,0,0,65,65,0,1,0,1,0
7859,310,0,0,61,61,0,1,0,1,0
22037,1888,0,0,63,63,0,1,0,1,0
3642,2620,0,0,62,62,0,1,0,1,0
643,2820,0,0,141,141,0,1,0,1,0
2777,307,0,0,62,62,0,1,0,1,0
11009,1147,0,0,65,65,0,1,0,1,0
3223,2421,0,0,70,70,0,1,0,1,0
4490,1147,0,0,63,63,0,1,0,1,0
3223,383,0,0,66,66,0,1,0,1,0
19853,1099,0,0,65,65,0,1,0,1,0
187,1795,0,0,60,60,0,1,0,1,0
9620,2634,0,0,66,66,0,1,0,1,0
13869,1165,0,0,123,123,0,1,0,1,0
11680,1141,0,0,62,62,0,1,0,1,0
7213,357,0,0,62,62,0,1,0,1,0
1990,3216,0,0,65,65,0,1,0,1,0
643,1485,0,0,139,139,0,1,0,1,0
7034,1215,0,0,62,62,0,1,0,1,0
3245,2423,0,0,66,66,0,1,0,1,0
49,3253,0,0,146,146,0,1,0,1,0
2972,2636,0,0,146,146,0,1,0,1,0
16951,255,0,0,62,62,0,1,0,1,0
326,1888,0,0,62,62,0,1,0,1,0
7273,1888,0,0,62,62,0,1,0,1,0
7558,2581,0,0,69,69,0,1,0,1,0
2839,1783,0,0,63,63,0,1,0,1,0
22603,2611,0,0,69,69,0,1,0,1,0
9243,1224,0,0,109,109,0,1,0,1,0
6705,259,0,0,65,65,0,1,0,1,0
34,1470,0,0,62,62,0,1,0,1,0
17544,2938,0,0,62,62,0,1,0,1,0
17627,2587,0,0,64,64,0,1,0,1,0
8221,1017,0,0,129,129,0,1,0,1,0
21352,1147,0,0,66,66,0,1,0,1,0
1507,1147,0,0,62,62,0,1,0,1,0
22503,2611,0,0,70,70,0,1,0,1,0
11764,2594,0,0,66,66,0,1,0,1,0
18,7,0,0,60,60,0,1,0,1,0
9614,3105,0,0,86,86,0,1,0,1,0
17188,2938,0,0,66,66,0,1,0,1,0
19888,1078,0,0,66,66,0,1,0,1,0
216,1147,0,0,62,62,0,1,0,1,0
1598,2588,0,0,62,62,0,1,0,1,0
11,3233,0,0,81,81,0,1,0,1,0
2480,2636,0,0,62,62,0,1,0,1,0
18795,1821,0,0,62,62,0,1,0,1,0
2048,1201,0,0,65,65,0,1,0,1,0
12,1017,0,0,108,108,0,1,0,1,0
16951,255,0,0,62,62,0,1,0,1,0
795,1433,0,0,61,61,0,1,0,1,0
16951,255,0,0,62,62,0,1,0,1,0
11094,1017,0,0,64,64,0,1,0,1,0
12,2461,0,0,81,81,0,1,0,1,0
636,280,0,0,62,62,0,1,0,1,0
14429,2683,0,0,66,66,0,1,0,1,0
325,1888,0,0,62,62,0,1,0,1,0
6058,2883,0,0,63,63,0,1,0,1,0
16779,2256,0,0,65,65,0,1,0,1,0
16951,255,0,0,62,62,0,1,0,1,0
10462,280,0,0,66,66,0,1,0,1,0
1804,1764,0,0,60,60,0,1,0,1,0
13867,983,0,0,63,63,0,1,0,1,0
162,1779,0,0,61,61,0,1,0,1,0
2132,1888,0,0,62,62,0,1,0,1,0
12957,956,0,0,63,63,0,1,0,1,0
10475,2587,0,0,65,65,0,1,0,1,0
3621,2593,0,0,62,62,0,1,0,1,0
13836,1502,0,0,66,66,0,1,0,1,0
1789,2587,0,0,62,62,0,1,0,1,0
369,3134,0,0,155,155,0,1,0,1,0
13666,1863,0,0,113,113,0,1,0,1,0
2296,1472,0,0,65,65,0,1,0,1,0
16951,255,0,0,62,62,0,1,0,1,0
2132,1888,0,0,62,62,0,1,0,1,0
17,2515,0,0,129,129,0,1,0,1,0
19160,2829,0,0,63,63,0,1,0,1,0
0,0,0,0,98,98,0,1,0,1,0
5684,1056,0,0,62,62,0,1,0,1,0
2977,1885,0,0,62,62,0,1,0,1,0
3211,2841,0,0,88,88,0,1,0,1,0
18039,1771,0,0,65,65,0,1,0,1,0
650,1214,0,0,140,140,0,1,0,1,0
13190,1014,0,0,62,62,0,1,0,1,0
2600,1017,0,0,146,146,0,1,0,1,0
9706,1888,0,0,66,66,0,1,0,1,0
16951,255,0,0,62,62,0,1,0,1,0
8114,2550,0,0,62,62,0,1,0,1,0
6233,1646,0,0,60,60,0,1,0,1,0
17326,1906,0,0,69,69,0,1,0,1,0
7846,1215,0,0,62,62,0,1,0,1,0
28,3216,0,0,62,62,0,1,0,1,0
2017,3216,0,0,62,62,0,1,0,1,0
15294,2205,0,0,66,66,0,1,0,1,0
990,2938,0,0,65,65,0,1,0,1,0
8667,509,0,0,66,66,0,1,0,1,0
2497,3216,0,0,62,62,0,1,0,1,0
6649,697,0,0,74,74,0,1,0,1,0
1974,3214,0,0,62,62,0,1,0,1,0
1927,2256,0,0,62,62,0,1,0,1,0
20216,1771,0,0,66,66,0,1,0,1,0
1374,2883,0,0,66,66,0,1,0,1,0
16951,255,0,0,62,62,0,1,0,1,0
0,0,0,0,70,70,0,1,0,1,0
16794,1472,0,0,66,66,0,1,0,1,0
13885,1147,0,0,146,146,0,1,0,1,0
22283,1017,0,0,62,62,0,1,0,1,0
6715,2256,0,0,65,65,0,1,0,1,0
7335,1070,0,0,60,60,0,1,0,1,0
18906,2134,0,0,66,66,0,1,0,1,0
2059,7,0,0,60,60,0,1,0,1,0
16951,255,0,0,62,62,0,1,0,1,0
3063,7,0,0,60,60,0,1,0,1,0
14951,2256,0,0,63,63,0,1,0,1,0
2141,1888,0,0,62,62,0,1,0,1,0
17146,697,0,0,66,66,0,1,0,1,0
1300,2587,0,0,66,66,0,1,0,1,0
3476,614,0,0,85,85,0,1,0,1,0
11921,2892,0,0,67,67,0,1,0,1,0
7335,1070,0,0,60,60,0,1,0,1,0
16951,255,0,0,62,62,0,1,0,1,0
48,1147,0,0,146,146,0,1,0,1,0
9147,1888,0,0,66,66,0,1,0,1,0
19761,1017,0,0,66,66,0,1,0,1,0
14571,2238,0,0,63,63,0,1,0,1,0
8171,1073,0,0,60,60,0,1,0,1,0
15849,3216,0,0,66,66,0,1,0,1,0
1842,2879,0,0,65,65,0,1,0,1,0
18700,364,0,0,135,135,0,1,0,1,0
650,1888,0,0,63,63,0,1,0,1,0
16951,255,0,0,62,62,0,1,0,1,0
8089,2947,0,0,62,62,0,1,0,1,0
2993,2574,0,0,62,62,0,1,0,1,0
16951,255,0,0,62,62,0,1,0,1,0
8849,1081,0,0,63,63,0,1,0,1,0
22468,201,0,0,78,78,0,1,0,1,0
16951,255,0,0,62,62,0,1,0,1,0
661,1161,0,0,89,89,0,1,0,1,0
14644,1002,0,0,66,66,0,1,0,1,0
5704,1099,0,0,73,73,0,1,0,1,0
11727,2889,0,0,66,66,0,1,0,1,0
21247,1893,0,0,62,62,0,1,0,1,0
1597,2587,0,0,62,62,0,1,0,1,0
17336,1147,0,0,64,64,0,1,0,1,0
12844,2256,0,0,66,66,0,1,0,1,0
248,1880,0,0,65,65,0,1,0,1,0
14866,2696,0,0,62,62,0,1,0,1,0
20565,2379,0,0,78,78,0,1,0,1,0
1700,3020,0,0,63,63,0,1,0,1,0
15165,1147,0,0,66,66,0,1,0,1,0
16954,3213,0,0,64,64,0,1,0,1,0
2915,1166,0,0,62,62,0,1,0,1,0
3571,2664,0,0,149,149,0,1,0,1,0
4961,2256,0,0,66,66,0,1,0,1,0
9379,249,0,0,60,60,0,1,0,1,0
14885,1147,0,0,65,65,0,1,0,1,0
2430,2938,0,0,62,62,0,1,0,1,0
8164,2725,0,0,60,60,0,1,0,1,0
11424,1125,0,0,66,66,0,1,0,1,0
612,3131,0,0,60,60,0,1,0,1,0
20460,1006,0,0,66,66,0,1,0,1,0
16706,2603,0,0,65,65,0,1,0,1,0
5709,1102,0,0,146,146,0,1,0,1,0
22144,1215,0,0,62,62,0,1,0,1,0
1738,2077,0,0,78,78,0,1,0,1,0
1263,1147,0,0,146,146,0,1,0,1,0
266,1769,0,0,62,62,0,1,0,1,0
11489,1790,0,0,62,62,0,1,0,1,0
403,1147,0,0,62,62,0,1,0,1,0
17333,2938,0,0,66,66,0,1,0,1,0
7335,1070,0,0,60,60,0,1,0,1,0
0,0,0,0,98,98,0,1,0,1,0
13935,2587,0,0,66,66,0,1,0,1,0
19688,1017,0,0,66,66,0,1,0,1,0
3477,7,0,0,60,60,0,1,0,1,0
15031,888,0,0,62,62,0,1,0,1,0
16951,255,0,0,62,62,0,1,0,1,0
11033,1169,0,0,61,61,0,1,0,1,0
1254,1590,0,0,62,62,0,1,0,1,0
10773,1477,0,0,64,64,0,1,0,1,0
1197,1147,0,0,62,62,0,1,0,1,0
18432,2938,0,0,62,62,0,1,0,1,0
3119,3216,0,0,62,62,0,1,0,1,0
14096,2587,0,0,62,62,0,1,0,1,0
14716,1888,0,0,63,63,0,1,0,1,0
4356,1472,0,0,66,66,0,1,0,1,0
4179,3134,0,0,145,145,0,1,0,1,0
16951,255,0,0,62,62,0,1,0,1,0
7339,170,0,0,60,60,0,1,0,1,0
11048,2953,0,0,64,64,0,1,0,1,0
16951,255,0,0,62,62,0,1,0,1,0
580,2636,0,0,62,62,0,1,0,1,0
6282,2938,0,0,65,65,0,1,0,1,0
14819,2218,0,0,66,66,0,1,0,1,0
351,797,0,0,65,65,0,1,0,1,0
20119,1054,0,0,63,63,0,1,0,1,0
8,5,0,0,60,60,0,1,0,1,0
17328,1353,0,0,62,62,0,1,0,1,0
20333,983,0,0,66,66,0,1,0,1,0
18328,1017,0,0,66,66,0,1,0,1,0
3420,2250,0,0,70,70,0,1,0,1,0
1456,8,0,0,60,60,0,1,0,1,0
499,187,0,0,345,345,0,1,0,1,0
12185,1880,0,0,63,63,0,1,0,1,0
6679,209,0,0,60,60,0,1,0,1,0
20055,2587,0,0,66,66,0,1,0,1,0
3157,7,0,0,60,60,0,1,0,1,0
22132,2233,0,0,66,66,0,1,0,1,0
15659,2938,0,0,62,62,0,1,0,1,0
12516,1795,0,0,60,60,0,1,0,1,0
13287,2433,0,0,66,66,0,1,0,1,0
3256,2587,0,0,146,146,0,1,0,1,0
17403,1147,0,0,66,66,0,1,0,1,0
2693,2587,0,0,63,63,0,1,0,1,0
17,2252,0,0,61,61,0,1,0,1,0
8515,2591,0,0,62,62,0,1,0,1,0
16951,255,0,0,62,62,0,1,0,1,0
19230,7,0,0,60,60,0,1,0,1,0
13146,3216,0,0,62,62,0,1,0,1,0
11359,3192,0,0,66,66,0,1,0,1,0
3255,1068,0,0,62,62,0,1,0,1,0
9214,3256,0,0,60,60,0,1,0,1,0
18614,1054,0,0,64,64,0,1,0,1,0
16727,178,0,0,60,60,0,1,0,1,0
13621,3216,0,0,66,66,0,1,0,1,0
18,1772,0,0,62,62,0,1,0,1,0
2585,5,0,0,60,60,0,1,0,1,0
164,1147,0,0,65,65,0,1,0,1,0
2814,7,0,0,60,60,0,1,0,1,0
10165,1147,0,0,63,63,0,1,0,1,0
17459,2953,0,0,66,66,0,1,0,1,0
3973,1017,0,0,62,62,0,1,0,1,0
12,3165,0,0,100,100,0,1,0,1,0
11734,2883,0,0,139,139,0,1,0,1,0
1407,2486,0,0,82,82,0,1,0,1,0
9370,2256,0,0,66,66,0,1,0,1,0
12321,1017,0,0,66,66,0,1,0,1,0
12245,3215,0,0,62,62,0,1,0,1,0
16169,293,0,0,101,101,0,1,0,1,0
18045,1778,0,0,62,62,0,1,0,1,0
22046,463,0,0,64,64,0,1,0,1,0
8827,1888,0,0,67,67,0,1,0,1,0
3513,7,0,0,60,60,0,1,0,1,0
74,1147,0,0,62,62,0,1,0,1,0
702,1017,0,0,66,66,0,1,0,1,0
17324,1781,0,0,62,62,0,1,0,1,0
19859,2587,0,0,62,62,0,1,0,1,0
7653,3216,0,0,81,81,0,1,0,1,0
7994,1004,0,0,66,66,0,1,0,1,0
9562,2587,0,0,62,62,0,1,0,1,0
5533,2910,0,0,86,86,0,1,0,1,0
16951,255,0,0,62,62,0,1,0,1,0
17936,2256,0,0,64,64,0,1,0,1,0
4494,1147,0,0,146,146,0,1,0,1,0
136,1017,0,0,62,62,0,1,0,1,0
14802,2600,0,0,63,63,0,1,0,1,0
16951,255,0,0,62,62,0,1,0,1,0
10454,2883,0,0,66,66,0,1,0,1,0
2747,1017,0,0,63,63,0,1,0,1,0
21247,1893,0,0,62,62,0,1,0,1,0
4491,1147,0,0,66,66,0,1,0,1,0
14072,1147,0,0,62,62,0,1,0,1,0
6064,2587,0,0,140,140,0,1,0,1,0
16780,2883,0,0,62,62,0,1,0,1,0
14607,1014,0,0,66,66,0,1,0,1,0
1709,1808,0,0,62,62,0,1,0,1,0
14621,2883,0,0,66,66,0,1,0,1,0
2632,1017,0,0,146,146,0,1,0,1,0
17710,3173,0,0,63,63,0,1,0,1,0
4749,121,0,0,60,60,0,1,0,1,0
61,551,0,0,63,63,0,1,0,1,0
6506,697,0,0,62,62,0,1,0,1,0
1865,1017,0,0,66,66,0,1,0,1,0
5574,1180,0,0,62,62,0,1,0,1,0
6651,1129,0,0,156,156,0,1,0,1,0
6438,2228,0,0,62,62,0,1,0,1,0
16951,255,0,0,62,62,0,1,0,1,0
5452,2504,0,0,147,147,0,1,0,1,0
2206,2577,0,0,62,62,0,1,0,1,0
401,2636,0,0,64,64,0,1,0,1,0
753,1017,0,0,66,66,0,1,0,1,0
5586,1172,0,0,62,62,0,1,0,1,0
16951,255,0,0,62,62,0,1,0,1,0
3095,2284,0,0,62,62,0,1,0,1,0
16267,1885,0,0,63,63,0,1,0,1,0
17680,3215,0,0,62,62,0,1,0,1,0
1785,486,0,0,66,66,0,1,0,1,0
568,2234,0,0,69,69,0,1,0,1,0
3099,1147,0,0,64,64,0,1,0,1,0
10475,6,0,0,60,60,0,1,0,1,0
13700,2924,0,0,75,75,0,1,0,1,0
6874,1472,0,0,66,66,0,1,0,1,0
16951,255,0,0,62,62,0,1,0,1,0
19708,2516,0,0,66,66,0,1,0,1,0
16951,255,0,0,62,62,0,1,0,1,0
10399,1922,0,0,70,70,0,1,0,1,0
1737,3216,0,0,63,63,0,1,0,1,0
3848,1017,0,0,65,65,0,1,0,1,0
21397,1017,0,0,63,63,0,1,0,1,0
244,1054,0,0,65,65,0,1,0,1,0
28,3216,0,0,62,62,0,1,0,1,0
18919,1147,0,0,64,64,0,1,0,1,0
360,3105,0,0,898,898,0,1,0,1,0
15694,344,0,0,145,145,0,1,0,1,0
29,1888,0,0,62,62,0,1,0,1,0
16951,255,0,0,62,62,0,1,0,1,0
4073,1017,0,0,62,62,0,1,0,1,0
1430,433,0,0,69,69,0,1,0,1,0
1850,3216,0,0,66,66,0,1,0,1,0
3088,1804,0,0,62,62,0,1,0,1,0
11667,3216,0,0,63,63,0,1,0,1,0
373,1147,0,0,62,62,0,1,0,1,0
3415,2587,0,0,62,62,0,1,0,1,0
1776,3216,0,0,145,145,0,1,0,1,0
11994,1147,0,0,64,64,0,1,0,1,0
16951,255,0,0,62,62,0,1,0,1,0
20305,1771,0,0,65,65,0,1,0,1,0
2837,1147,0,0,62,62,0,1,0,1,0
16951,255,0,0,62,62,0,1,0,1,0
2970,1794,0,0,66,66,0,1,0,1,0
1282,2535,0,0,70,70,0,1,0,1,0
14807,2205,0,0,64,64,0,1,0,1,0
13849,1006,0,0,66,66,0,1,0,1,0
27,1147,0,0,146,146,0,1,0,1,0
17386,1147,0,0,84,84,0,1,0,1,0
1858,2,0,0,61,61,0,1,0,1,0
1899,1777,0,0,65,65,0,1,0,1,0
16951,255,0,0,62,62,0,1,0,1,0
393,1035,0,0,62,62,0,1,0,1,0
12082,1771,0,0,66,66,0,1,0,1,0
7956,2587,0,0,74,74,0,1,0,1,0
15839,2938,0,0,66,66,0,1,0,1,0
103,562,0,0,62,62,0,1,0,1,0
19430,3216,0,0,64,64,0,1,0,1,0
499,982,0,0,66,66,0,1,0,1,0
10625,2632,0,0,62,62,0,1,0,1,0
3580,1147,0,0,62,62,0,1,0,1,0
21438,1147,0,0,62,62,0,1,0,1,0
7326,1649,0,0,60,60,0,1,0,1,0
14896,2688,0,0,66,66,0,1,0,1,0
2003,2938,0,0,62,62,0,1,0,1,0
21079,1215,0,0,65,65,0,1,0,1,0
8671,2922,0,0,68,68,0,1,0,1,0
3058,690,0,0,67,67,0,1,0,1,0
9765,2587,0,0,63,63,0,1,0,1,0
577,2611,0,0,78,78,0,1,0,1,0
366,1147,0,0,62,62,0,1,0,1,0
12146,1861,0,0,62,62,0,1,0,1,0
275,9,0,0,60,60,0,1,0,1,0
8023,2256,0,0,62,62,0,1,0,1,0
16951,255,0,0,62,62,0,1,0,1,0
22538,2875,0,0,66,66,0,1,0,1,0
16549,1007,0,0,64,64,0,1,0,1,0
1374,1888,0,0,62,62,0,1,0,1,0
1893,1772,0,0,62,62,0,1,0,1,0
692,7,0,0,60,60,0,1,0,1,0
12,1768,0,0,160,160,0,1,0,1,0
1251,3216,0,0,62,62,0,1,0,1,0
3876,1923,0,0,62,62,0,1,0,1,0
17658,992,0,0,63,63,0,1,0,1,0
5270,2596,0,0,62,62,0,1,0,1,0
9812,3000,0,0,66,66,0,1,0,1,0
2597,2871,0,0,63,63,0,1,0,1,0
11106,2894,0,0,62,62,0,1,0,1,0
16951,255,0,0,62,62,0,1,0,1,0
10362,2226,0,0,66,66,0,1,0,1,0
16475,17,0,0,60,60,0,1,0,1,0
577,2611,0,0,78,78,0,1,0,1,0
19263,3216,0,0,64,64,0,1,0,1,0
2470,2615,0,0,62,62,0,1,0,1,0
15110,3049,0,0,145,145,0,1,0,1,0
1144,1215,0,0,64,64,0,1,0,1,0
8660,1937,0,0,142,142,0,1,0,1,0
1804,1019,0,0,61,61,0,1,0,1,0
12,1735,0,0,61,61,0,1,0,1,0
27,3216,0,0,62,62,0,1,0,1,0
3903,1888,0,0,62,62,0,1,0,1,0
8577,1013,0,0,66,66,0,1,0,1,0
3386,1888,0,0,62,62,0,1,0,1,0
21,2379,0,0,62,62,0,1,0,1,0
13697,2938,0,0,78,78,0,1,0,1,0
756,2938,0,0,62,62,0,1,0,1,0
12074,1215,0,0,63,63,0,1,0,1,0
8137,475,0,0,61,61,0,1,0,1,0
14978,1215,0,0,63,63,0,1,0,1,0
21312,1146,0,0,62,62,0,1,0,1,0
16951,255,0,0,62,62,0,1,0,1,0
11747,1147,0,0,62,62,0,1,0,1,0
17213,1887,0,0,66,66,0,1,0,1,0
12896,2549,0,0,62,62,0,1,0,1,0
4830,561,0,0,85,85,0,1,0,1,0
16951,255,0,0,62,62,0,1,0,1,0
10895,3117,0,0,64,64,0,1,0,1,0
1275,1147,0,0,146,146,0,1,0,1,0
15232,2617,0,0,62,62,0,1,0,1,0
2562,6,0,0,60,60,0,1,0,1,0
16951,255,0,0,62,62,0,1,0,1,0
2599,105,0,0,60,60,0,1,0,1,0
16951,255,0,0,62,62,0,1,0,1,0
7697,1,0,0,61,61,0,1,0,1,0
3095,3216,0,0,62,62,0,1,0,1,0
1877,1147,0,0,143,143,0,1,0,1,0
1289,1888,0,0,62,62,0,1,0,1,0
12076,1182,0,0,62,62,0,1,0,1,0
11136,185,0,0,64,64,0,1,0,1,0
594,3216,0,0,145,145,0,1,0,1,0
17339,509,0,0,66,66,0,1,0,1,0
5634,391,0,0,60,60,0,1,0,1,0
6061,2938,0,0,62,62,0,1,0,1,0
13679,1886,0,0,142,142,0,1,0,1,0
6463,987,0,0,64,64,0,1,0,1,0
7339,156,0,0,60,60,0,1,0,1,0
21423,1147,0,0,62,62,0,1,0,1,0
7079,4,0,0,60,60,0,1,0,1,0
16951,255,0,0,62,62,0,1,0,1,0
11657,3216,0,0,63,63,0,1,0,1,0
10475,6,0,0,60,60,0,1,0,1,0
3762,2938,0,0,66,66,0,1,0,1,0
16951,255,0,0,62,62,0,1,0,1,0
21038,1147,0,0,62,62,0,1,0,1,0
10531,11,0,0,60,60,0,1,0,1,0
2065,1888,0,0,62,62,0,1,0,1,0
1214,1559,0,0,113,113,0,1,0,1,0
1865,1147,0,0,86,86,0,1,0,1,0
16686,1888,0,0,66,66,0,1,0,1,0
697,2256,0,0,62,62,0,1,0,1,0
2906,1888,0,0,62,62,0,1,0,1,0
16951,255,0,0,62,62,0,1,0,1,0
6284,1017,0,0,62,62,0,1,0,1,0
16951,255,0,0,62,62,0,1,0,1,0
847,2256,0,0,62,62,0,1,0,1,0
2213,1017,0,0,62,62,0,1,0,1,0
2025,3216,0,0,65,65,0,1,0,1,0
8283,904,0,0,153,153,0,1,0,1,0
965,2938,0,0,66,66,0,1,0,1,0
16951,255,0,0,62,62,0,1,0,1,0
14145,3216,0,0,62,62,0,1,0,1,0
22596,296,0,0,62,62,0,1,0,1,0
2982,1555,0,0,63,63,0,1,0,1,0
21334,1086,0,0,66,66,0,1,0,1,0
8371,2604,0,0,62,62,0,1,0,1,0
19018,653,0,0,127,127,0,1,0,1,0
16132,2883,0,0,66,66,0,1,0,1,0
16951,255,0,0,62,62,0,1,0,1,0
11667,1147,0,0,66,66,0,1,0,1,0
13157,1382,0,0,75,75,0,1,0,1,0
3147,2587,0,0,65,65,0,1,0,1,0
18839,1147,0,0,66,66,0,1,0,1,0
16951,255,0,0,62,62,0,1,0,1,0
8171,1073,0,0,60,60,0,1,0,1,0
20489,1017,0,0,66,66,0,1,0,1,0
11758,680,0,0,66,66,0,1,0,1,0
27,1626,0,0,129,129,0,1,0,1,0
11900,2623,0,0,66,66,0,1,0,1,0
684,2938,0,0,62,62,0,1,0,1,0
22491,1866,0,0,66,66,0,1,0,1,0
14720,1888,0,0,62,62,0,1,0,1,0
14014,2254,0,0,66,66,0,1,0,1,0
1718,2256,0,0,70,70,0,1,0,1,0
22292,1017,0,0,62,62,0,1,0,1,0
7572,2629,0,0,62,62,0,1,0,1,0
14221,6,0,0,60,60,0,1,0,1,0
7906,1147,0,0,77,77,0,1,0,1,0
1399,2938,0,0,63,63,0,1,0,1,0
1829,2577,0,0,62,62,0,1,0,1,0
1662,1147,0,0,62,62,0,1,0,1,0
11821,1888,0,0,66,66,0,1,0,1,0
13979,1936,0,0,74,74,0,1,0,1,0
2014,2112,0,0,140,140,0,1,0,1,0
3587,1147,0,0,62,62,0,1,0,1,0
2394,3216,0,0,64,64,0,1,0,1,0
16445,1051,0,0,64,64,0,1,0,1,0
11744,697,0,0,66,66,0,1,0,1,0
14452,3216,0,0,66,66,0,1,0,1,0
20318,1147,0,0,62,62,0,1,0,1,0
2068,31,0,0,60,60,0,1,0,1,0
4554,2536,0,0,63,63,0,1,0,1,0
13317,509,0,0,66,66,0,1,0,1,0
2696,2583,0,0,66,66,0,1,0,1,0
2514,2584,0,0,145,145,0,1,0,1,0
13652,2541,0,0,65,65,0,1,0,1,0
771,2609,0,0,62,62,0,1,0,1,0
8074,1147,0,0,62,62,0,1,0,1,0
17365,2938,0,0,62,62,0,1,0,1,0
2954,2587,0,0,62,62,0,1,0,1,0
2596,1772,0,0,66,66,0,1,0,1,0
18,3216,0,0,62,62,0,1,0,1,0
16951,255,0,0,62,62,0,1,0,1,0
16111,2883,0,0,66,66,0,1,0,1,0
10165,1147,0,0,66,66,0,1,0,1,0
17629,1871,0,0,66,66,0,1,0,1,0
18718,2956,0,0,66,66,0,1,0,1,0
22020,3160,0,0,66,66,0,1,0,1,0
2581,5,0,0,60,60,0,1,0,1,0
2738,1044,0,0,63,63,0,1,0,1,0
18415,2587,0,0,64,64,0,1,0,1,0
23,1677,0,0,99,99,0,1,0,1,0
19102,1888,0,0,65,65,0,1,0,1,0
14955,1017,0,0,63,63,0,1,0,1,0
1852,482,0,0,66,66,0,1,0,1,0
18073,2927,0,0,66,66,0,1,0,1,0
2751,1147,0,0,62,62,0,1,0,1,0
450,126,0,0,136,136,0,1,0,1,0
675,1017,0,0,63,63,0,1,0,1,0
3178,1771,0,0,62,62,0,1,0,1,0
19483,1888,0,0,66,66,0,1,0,1,0
13790,1269,0,0,66,66,0,1,0,1,0
16951,255,0,0,62,62,0,1,0,1,0
617,712,0,0,60,60,0,1,0,1,0
2041,2256,0,0,66,66,0,1,0,1,0
4833,3139,0,0,81,81,0,1,0,1,0
12103,2593,0,0,66,66,0,1,0,1,0
4157,7,0,0,60,60,0,1,0,1,0
1744,2578,0,0,62,62,0,1,0,1,0
18642,2607,0,0,62,62,0,1,0,1,0
499,187,0,0,345,345,0,1,0,1,0
11518,1888,0,0,64,64,0,1,0,1,0
2695,2256,0,0,62,62,0,1,0,1,0
2141,1888,0,0,62,62,0,1,0,1,0
14228,6,0,0,60,60,0,1,0,1,0
1803,769,0,0,60,60,0,1,0,1,0
2672,1147,0,0,63,63,0,1,0,1,0
1491,1888,0,0,63,63,0,1,0,1,0
2748,2636,0,0,62,62,0,1,0,1,0
6865,2577,0,0,145,145,0,1,0,1,0
841,267,0,0,61,61,0,1,0,1,0
7265,504,0,0,60,60,0,1,0,1,0
2861,1163,0,0,62,62,0,1,0,1,0
4705,2256,0,0,62,62,0,1,0,1,0
11661,3216,0,0,62,62,0,1,0,1,0
2067,1771,0,0,62,62,0,1,0,1,0
7304,1147,0,0,62,62,0,1,0,1,0
1595,2595,0,0,146,146,0,1,0,1,0
1325,7,0,0,60,60,0,1,0,1,0
6778,2256,0,0,66,66,0,1,0,1,0
20118,2935,0,0,126,126,0,1,0,1,0
2561,1031,0,0,148,148,0,1,0,1,0
2960,386,0,0,60,60,0,1,0,1,0
2233,2256,0,0,62,62,0,1,0,1,0
17670,3212,0,0,66,66,0,1,0,1,0
425,1771,0,0,62,62,0,1,0,1,0
9769,2249,0,0,65,65,0,1,0,1,0
10896,273,0,0,61,61,0,1,0,1,0
610,1888,0,0,64,64,0,1,0,1,0
7969,715,0,0,62,62,0,1,0,1,0
9208,1017,0,0,65,65,0,1,0,1,0
8091,1888,0,0,62,62,0,1,0,1,0
6552,2093,0,0,145,145,0,1,0,1,0
2757,2256,0,0,62,62,0,1,0,1,0
9598,3156,0,0,66,66,0,1,0,1,0
16549,1007,0,0,64,64,0,1,0,1,0
6941,1147,0,0,64,64,0,1,0,1,0
8,2758,0,0,60,60,0,1,0,1,0
18214,2836,0,0,64,64,0,1,0,1,0
9614,3105,0,0,86,86,0,1,0,1,0
1589,2589,0,0,146,146,0,1,0,1,0
2372,1147,0,0,146,146,0,1,0,1,0
1236,2256,0,0,66,66,0,1,0,1,0
8189,1045,0,0,102,102,0,1,0,1,0
16951,255,0,0,62,62,0,1,0,1,0
10166,1147,0,0,65,65,0,1,0,1,0
488,111,0,0,77,77,0,1,0,1,0
23,2256,0,0,62,62,0,1,0,1,0
2365,1766,0,0,66,66,0,1,0,1,0
16951,255,0,0,62,62,0,1,0,1,0
2185,1147,0,0,88,88,0,1,0,1,0
4491,1147,0,0,65,65,0,1,0,1,0
360,3105,0,0,291,291,0,1,0,1,0
5755,3216,0,0,62,62,0,1,0,1,0
19698,3212,0,0,66,66,0,1,0,1,0
16659,1776,0,0,66,66,0,1,0,1,0
15793,2602,0,0,66,66,0,1,0,1,0
1316,2587,0,0,65,65,0,1,0,1,0
16951,255,0,0,62,62,0,1,0,1,0
2150,1781,0,0,146,146,0,1,0,1,0
12,447,0,0,60,60,0,1,0,1,0
3250,2399,0,0,66,66,0,1,0,1,0
3464,2236,0,0,94,94,0,1,0,1,0
11442,2883,0,0,66,66,0,1,0,1,0
17348,1147,0,0,62,62,0,1,0,1,0
18793,1823,0,0,66,66,0,1,0,1,0
6506,697,0,0,62,62,0,1,0,1,0
7,12,0,0,346,346,0,1,0,1,0
16951,255,0,0,62,62,0,1,0,1,0
20314,3139,0,0,62,62,0,1,0,1,0
21,2256,0,0,62,62,0,1,0,1,0
1555,707,0,0,62,62,0,1,0,1,0
1330,697,0,0,62,62,0,1,0,1,0
16951,255,0,0,62,62,0,1,0,1,0
1804,2232,0,0,60,60,0,1,0,1,0
3792,2520,0,0,60,60,0,1,0,1,0
3880,1472,0,0,62,62,0,1,0,1,0
2696,2587,0,0,62,62,0,1,0,1,0
16951,255,0,0,62,62,0,1,0,1,0
18108,2178,0,0,66,66,0,1,0,1,0
360,3105,0,0,1123,1123,0,1,0,1,0
6691,2256,0,0,62,62,0,1,0,1,0
14454,3216,0,0,66,66,0,1,0,1,0
11206,2540,0,0,63,63,0,1,0,1,0
13469,2587,0,0,62,62,0,1,0,1,0
4200,1147,0,0,65,65,0,1,0,1,0
21539,2636,0,0,66,66,0,1,0,1,0
3587,2588,0,0,62,62,0,1,0,1,0
21824,2587,0,0,62,62,0,1,0,1,0
15226,1018,0,0,66,66,0,1,0,1,0
10487,2783,0,0,112,112,0,1,0,1,0
16261,1888,0,0,63,63,0,1,0,1,0
12697,2208,0,0,65,65,0,1,0,1,0
17340,1147,0,0,66,66,0,1,0,1,0
14975,2636,0,0,62,62,0,1,0,1,0
7742,86,0,0,60,60,0,1,0,1,0
24,3216,0,0,62,62,0,1,0,1,0
1142,1215,0,0,62,62,0,1,0,1,0
19428,242,0,0,145,145,0,1,0,1,0
14839,1804,0,0,66,66,0,1,0,1,0
7206,3216,0,0,62,62,0,1,0,1,0
1677,1215,0,0,62,62,0,1,0,1,0
3046,2256,0,0,65,65,0,1,0,1,0
12,3116,0,0,1484,1484,0,1,0,1,0
16065,1147,0,0,64,64,0,1,0,1,0
14244,2883,0,0,66,66,0,1,0,1,0
16989,3212,0,0,63,63,0,1,0,1,0
17019,836,0,0,66,66,0,1,0,1,0
588,2611,0,0,78,78,0,1,0,1,0
4402,1147,0,0,63,63,0,1,0,1,0
1281,2543,0,0,60,60,0,1,0,1,0
2024,3216,0,0,65,65,0,1,0,1,0
1986,1215,0,0,62,62,0,1,0,1,0
9214,3256,0,0,60,60,0,1,0,1,0
11485,2589,0,0,63,63,0,1,0,1,0
1068,2918,0,0,63,63,0,1,0,1,0
20306,775,0,0,66,66,0,1,0,1,0
5829,99,0,0,60,60,0,1,0,1,0
7357,2612,0,0,63,63,0,1,0,1,0
8952,1147,0,0,66,66,0,1,0,1,0
16951,255,0,0,62,62,0,1,0,1,0
254,1054,0,0,66,66,0,1,0,1,0
9368,249,0,0,96,96,0,1,0,1,0
3117,1888,0,0,62,62,0,1,0,1,0
19993,2563,0,0,66,66,0,1,0,1,0
12617,2636,0,0,66,66,0,1,0,1,0
2430,2938,0,0,62,62,0,1,0,1,0
1227,509,0,0,65,65,0,1,0,1,0
1738,2573,0,0,62,62,0,1,0,1,0
22533,2891,0,0,66,66,0,1,0,1,0
5527,2619,0,0,62,62,0,1,0,1,0
1804,1193,0,0,60,60,0,1,0,1,0
20227,1657,0,0,79,79,0,1,0,1,0
17629,1880,0,0,63,63,0,1,0,1,0
1281,2543,0,0,60,60,0,1,0,1,0
16985,1827,0,0,73,73,0,1,0,1,0
8285,2256,0,0,62,62,0,1,0,1,0
496,321,0,0,66,66,0,1,0,1,0
8819,1472,0,0,66,66,0,1,0,1,0
8,2758,0,0,60,60,0,1,0,1,0
21537,1086,0,0,62,62,0,1,0,1,0
2135,2938,0,0,62,62,0,1,0,1,0
7111,1147,0,0,91,91,0,1,0,1,0
16951,255,0,0,62,62,0,1,0,1,0
9614,3105,0,0,86,86,0,1,0,1,0
29,1888,0,0,62,62,0,1,0,1,0
14033,1215,0,0,62,62,0,1,0,1,0
4980,2599,0,0,65,65,0,1,0,1,0
3110,2615,0,0,70,70,0,1,0,1,0
10551,798,0,0,73,73,0,1,0,1,0
11390,2199,0,0,66,66,0,1,0,1,0
2584,1677,0,0,160,160,0,1,0,1,0
1571,2940,0,0,60,60,0,1,0,1,0
756,1147,0,0,62,62,0,1,0,1,0
432,2587,0,0,62,62,0,1,0,1,0
8164,2725,0,0,60,60,0,1,0,1,0
17928,2256,0,0,66,66,0,1,0,1,0
16951,255,0,0,62,62,0,1,0,1,0
13404,1888,0,0,62,62,0,1,0,1,0
2361,1147,0,0,146,146,0,1,0,1,0
10,3216,0,0,62,62,0,1,0,1,0
19131,2810,0,0,62,62,0,1,0,1,0
16951,255,0,0,62,62,0,1,0,1,0
20,1147,0,0,62,62,0,1,0,1,0
4127,2468,0,0,78,78,0,1,0,1,0
8033,49,0,0,60,60,0,1,0,1,0
2672,2938,0,0,62,62,0,1,0,1,0
6288,2938,0,0,64,64,0,1,0,1,0
14294,1771,0,0,63,63,0,1,0,1,0
16951,255,0,0,62,62,0,1,0,1,0
14474,3216,0,0,66,66,0,1,0,1,0
19912,1878,0,0,62,62,0,1,0,1,0
9787,1775,0,0,66,66,0,1,0,1,0
8164,2727,0,0,60,60,0,1,0,1,0
3150,1472,0,0,64,64,0,1,0,1,0
16278,651,0,0,69,69,0,1,0,1,0
16951,255,0,0,62,62,0,1,0,1,0
676,3216,0,0,62,62,0,1,0,1,0
312,800,0,0,63,63,0,1,0,1,0
3543,2938,0,0,66,66,0,1,0,1,0
14622,3216,0,0,62,62,0,1,0,1,0
21105,1203,0,0,66,66,0,1,0,1,0
12955,857,0,0,64,64,0,1,0,1,0
19161,2883,0,0,63,63,0,1,0,1,0
21632,2256,0,0,62,62,0,1,0,1,0
577,2611,0,0,78,78,0,1,0,1,0
7335,1070,0,0,60,60,0,1,0,1,0
1133,1771,0,0,66,66,0,1,0,1,0
19405,2949,0,0,66,66,0,1,0,1,0
8760,255,0,0,60,60,0,1,0,1,0
2986,2256,0,0,66,66,0,1,0,1,0
19,2379,0,0,62,62,0,1,0,1,0
88,2621,0,0,146,146,0,1,0,1,0
1804,2232,0,0,60,60,0,1,0,1,0
14056,1147,0,0,64,64,0,1,0,1,0
3098,697,0,0,96,96,0,1,0,1,0
17004,2587,0,0,66,66,0,1,0,1,0
1885,1021,0,0,62,62,0,1,0,1,0
10163,1017,0,0,66,66,0,1,0,1,0
5515,2625,0,0,62,62,0,1,0,1,0
19315,3212,0,0,64,64,0,1,0,1,0
13337,1215,0,0,63,63,0,1,0,1,0
1493,3216,0,0,62,62,0,1,0,1,0
9485,1888,0,0,66,66,0,1,0,1,0
2285,2486,0,0,72,72,0,1,0,1,0
1798,2928,0,0,60,60,0,1,0,1,0
8682,1792,0,0,68,68,0,1,0,1,0
6815,3216,0,0,62,62,0,1,0,1,0
8668,2256,0,0,66,66,0,1,0,1,0
11178,1925,0,0,66,66,0,1,0,1,0
5159,1459,0,0,142,142,0,1,0,1,0
16951,255,0,0,62,62,0,1,0,1,0
1555,1888,0,0,104,104,0,1,0,1,0
9685,2919,0,0,66,66,0,1,0,1,0
593,1888,0,0,62,62,0,1,0,1,0
9257,1476,0,0,64,64,0,1,0,1,0
16951,255,0,0,62,62,0,1,0,1,0
7461,1790,0,0,66,66,0,1,0,1,0
17099,1472,0,0,66,66,0,1,0,1,0
16105,3216,0,0,65,65,0,1,0,1,0
10719,1017,0,0,62,62,0,1,0,1,0
158,1147,0,0,62,62,0,1,0,1,0
11369,2836,0,0,66,66,0,1,0,1,0
6600,1163,0,0,147,147,0,1,0,1,0
16951,255,0,0,62,62,0,1,0,1,0
3032,2588,0,0,146,146,0,1,0,1,0
12073,1777,0,0,66,66,0,1,0,1,0
19303,3228,0,0,66,66,0,1,0,1,0
16306,3216,0,0,66,66,0,1,0,1,0
3671,128,0,0,60,60,0,1,0,1,0
8065,1147,0,0,64,64,0,1,0,1,0
15279,2603,0,0,62,62,0,1,0,1,0
8858,2573,0,0,65,65,0,1,0,1,0
15846,3216,0,0,66,66,0,1,0,1,0
2538,2979,0,0,60,60,0,1,0,1,0
1676,2946,0,0,66,66,0,1,0,1,0
11780,654,0,0,66,66,0,1,0,1,0
7892,284,0,0,60,60,0,1,0,1,0
2186,6,0,0,60,60,0,1,0,1,0
3228,3139,0,0,66,66,0,1,0,1,0
7328,2256,0,0,62,62,0,1,0,1,0
3664,1147,0,0,66,66,0,1,0,1,0
18,3216,0,0,62,62,0,1,0,1,0
15446,983,0,0,69,69,0,1,0,1,0
360,3105,0,0,314,314,0,1,0,1,0
9273,6,0,0,60,60,0,1,0,1,0
3139,6,0,0,60,60,0,1,0,1,0
628,2636,0,0,65,65,0,1,0,1,0
21042,671,0,0,96,96,0,1,0,1,0
16951,255,0,0,62,62,0,1,0,1,0
3803,1041,0,0,62,62,0,1,0,1,0
1744,2578,0,0,62,62,0,1,0,1,0
17903,1139,0,0,65,65,0,1,0,1,0
17628,2587,0,0,66,66,0,1,0,1,0
8989,1147,0,0,137,137,0,1,0,1,0
12192,1215,0,0,65,65,0,1,0,1,0
11387,1017,0,0,64,64,0,1,0,1,0
19,2587,0,0,62,62,0,1,0,1,0
9018,1802,0,0,62,62,0,1,0,1,0
14722,1887,0,0,66,66,0,1,0,1,0
21587,2938,0,0,78,78,0,1,0,1,0
17025,2205,0,0,66,66,0,1,0,1,0
17900,1149,0,0,62,62,0,1,0,1,0
8798,1210,0,0,66,66,0,1,0,1,0
18364,1478,0,0,66,66,0,1,0,1,0
1395,2938,0,0,65,65,0,1,0,1,0
2038,1147,0,0,146,146,0,1,0,1,0
7986,715,0,0,64,64,0,1,0,1,0
21132,1827,0,0,66,66,0,1,0,1,0
2861,1177,0,0,64,64,0,1,0,1,0
16951,255,0,0,62,62,0,1,0,1,0
20162,2700,0,0,64,64,0,1,0,1,0
9122,1827,0,0,66,66,0,1,0,1,0
1804,1025,0,0,60,60,0,1,0,1,0
5290,1147,0,0,62,62,0,1,0,1,0
1749,2582,0,0,62,62,0,1,0,1,0
1423,1017,0,0,62,62,0,1,0,1,0
17142,2641,0,0,65,65,0,1,0,1,0
13470,2587,0,0,64,64,0,1,0,1,0
1453,6,0,0,60,60,0,1,0,1,0
11938,2604,0,0,66,66,0,1,0,1,0
16849,1936,0,0,66,66,0,1,0,1,0
2543,1795,0,0,62,62,0,1,0,1,0
800,2883,0,0,64,64,0,1,0,1,0
360,3105,0,0,164,164,0,1,0,1,0
454,1255,0,0,62,62,0,1,0,1,0
13093,1936,0,0,140,140,0,1,0,1,0
0,0,0,0,98,98,0,1,0,1,0
2052,1888,0,0,62,62,0,1,0,1,0
24,3216,0,0,62,62,0,1,0,1,0
3226,2620,0,0,66,66,0,1,0,1,0
11715,2256,0,0,66,66,0,1,0,1,0
7949,314,0,0,60,60,0,1,0,1,0
16951,255,0,0,62,62,0,1,0,1,0
5907,7,0,0,60,60,0,1,0,1,0
2854,2695,0,0,63,63,0,1,0,1,0
12821,2913,0,0,66,66,0,1,0,1,0
1948,1215,0,0,65,65,0,1,0,1,0
592,1054,0,0,66,66,0,1,0,1,0
24,3216,0,0,62,62,0,1,0,1,0
1386,2259,0,0,60,60,0,1,0,1,0
22043,1888,0,0,62,62,0,1,0,1,0
20809,2256,0,0,65,65,0,1,0,1,0
16951,255,0,0,62,62,0,1,0,1,0
12,2548,0,0,60,60,0,1,0,1,0
11489,1789,0,0,63,63,0,1,0,1,0
4080,1017,0,0,66,66,0,1,0,1,0
13101,1030,0,0,66,66,0,1,0,1,0
17596,1017,0,0,62,62,0,1,0,1,0
19428,242,0,0,145,145,0,1,0,1,0
11923,1147,0,0,65,65,0,1,0,1,0
19875,2938,0,0,71,71,0,1,0,1,0
17853,2633,0,0,62,62,0,1,0,1,0
7721,2837,0,0,144,144,0,1,0,1,0
221,869,0,0,63,63,0,1,0,1,0
19971,2246,0,0,63,63,0,1,0,1,0
6716,1546,0,0,122,122,0,1,0,1,0
349,2952,0,0,66,66,0,1,0,1,0
10401,2256,0,0,65,65,0,1,0,1,0
16951,255,0,0,62,62,0,1,0,1,0
1919,2577,0,0,63,63,0,1,0,1,0
6181,1771,0,0,62,62,0,1,0,1,0
7915,1147,0,0,62,62,0,1,0,1,0
2084,1471,0,0,145,145,0,1,0,1,0
17311,3212,0,0,66,66,0,1,0,1,0
387,1147,0,0,62,62,0,1,0,1,0
2966,2256,0,0,63,63,0,1,0,1,0
1976,509,0,0,66,66,0,1,0,1,0
12832,1459,0,0,66,66,0,1,0,1,0
3191,509,0,0,62,62,0,1,0,1,0
1509,1888,0,0,66,66,0,1,0,1,0
1288,2946,0,0,62,62,0,1,0,1,0
1982,2253,0,0,65,65,0,1,0,1,0
21046,1281,0,0,62,62,0,1,0,1,0
14963,1017,0,0,64,64,0,1,0,1,0
16951,255,0,0,62,62,0,1,0,1,0
16582,2205,0,0,62,62,0,1,0,1,0
1475,2636,0,0,62,62,0,1,0,1,0
12,2346,0,0,332,332,0,1,0,1,0
16951,255,0,0,62,62,0,1,0,1,0
13554,93,0,0,60,60,0,1,0,1,0
2216,768,0,0,62,62,0,1,0,1,0
22418,1774,0,0,66,66,0,1,0,1,0
20840,2183,0,0,66,66,0,1,0,1,0
1757,1877,0,0,62,62,0,1,0,1,0
17889,3139,0,0,66,66,0,1,0,1,0
17570,1771,0,0,62,62,0,1,0,1,0
13045,1817,0,0,62,62,0,1,0,1,0
20302,2256,0,0,141,141,0,1,0,1,0
8595,1902,0,0,65,65,0,1,0,1,0
394,1147,0,0,62,62,0,1,0,1,0
16951,255,0,0,62,62,0,1,0,1,0
1513,1779,0,0,62,62,0,1,0,1,0
22131,2233,0,0,66,66,0,1,0,1,0
7335,1072,0,0,60,60,0,1,0,1,0
2443,296,0,0,128,128,0,1,0,1,0
16951,255,0,0,62,62,0,1,0,1,0
576,2636,0,0,66,66,0,1,0,1,0
2748,2636,0,0,65,65,0,1,0,1,0
1714,1017,0,0,62,62,0,1,0,1,0
1866,3216,0,0,62,62,0,1,0,1,0
11173,1884,0,0,66,66,0,1,0,1,0
0,0,0,0,98,98,0,1,0,1,0
16951,255,0,0,62,62,0,1,0,1,0
6915,2587,0,0,146,146,0,1,0,1,0
22241,1665,0,0,66,66,0,1,0,1,0
2662,1215,0,0,65,65,0,1,0,1,0
9764,1215,0,0,66,66,0,1,0,1,0
1984,2256,0,0,66,66,0,1,0,1,0
10555,797,0,0,66,66,0,1,0,1,0
2125,2587,0,0,66,66,0,1,0,1,0
2803,1872,0,0,62,62,0,1,0,1,0
16951,255,0,0,62,62,0,1,0,1,0
1724,2577,0,0,62,62,0,1,0,1,0
2976,1888,0,0,62,62,0,1,0,1,0
5023,6,0,0,60,60,0,1,0,1,0
11981,1107,0,0,66,66,0,1,0,1,0
1712,1017,0,0,62,62,0,1,0,1,0
20785,1215,0,0,66,66,0,1,0,1,0
16951,255,0,0,62,62,0,1,0,1,0
325,2587,0,0,63,63,0,1,0,1,0
3089,2938,0,0,61,61,0,1,0,1,0
1543,726,0,0,62,62,0,1,0,1,0
2320,1147,0,0,63,63,0,1,0,1,0
14425,2681,0,0,66,66,0,1,0,1,0
152,3216,0,0,66,66,0,1,0,1,0
7624,2938,0,0,62,62,0,1,0,1,0
1560,4,0,0,62,62,0,1,0,1,0
15262,2227,0,0,64,64,0,1,0,1,0
16951,255,0,0,62,62,0,1,0,1,0
5865,3037,0,0,99,99,0,1,0,1,0
3019,1472,0,0,66,66,0,1,0,1,0
16444,2881,0,0,90,90,0,1,0,1,0
7781,2587,0,0,62,62,0,1,0,1,0
22385,2256,0,0,68,68,0,1,0,1,0
6050,2938,0,0,66,66,0,1,0,1,0
3183,2587,0,0,62,62,0,1,0,1,0
588,2611,0,0,78,78,0,1,0,1,0
636,2822,0,0,142,142,0,1,0,1,0
16275,2938,0,0,66,66,0,1,0,1,0
687,2595,0,0,62,62,0,1,0,1,0
18957,3216,0,0,66,66,0,1,0,1,0
3427,2256,0,0,62,62,0,1,0,1,0
1718,1824,0,0,65,65,0,1,0,1,0
4464,2541,0,0,151,151,0,1,0,1,0
5574,3,0,0,60,60,0,1,0,1,0
472,1888,0,0,66,66,0,1,0,1,0
360,3105,0,0,456,456,0,1,0,1,0
562,1017,0,0,65,65,0,1,0,1,0
9296,6,0,0,60,60,0,1,0,1,0
7964,715,0,0,62,62,0,1,0,1,0
4597,1147,0,0,62,62,0,1,0,1,0
19385,2596,0,0,66,66,0,1,0,1,0
764,1888,0,0,62,62,0,1,0,1,0
20151,2256,0,0,66,66,0,1,0,1,0
20244,2938,0,0,62,62,0,1,0,1,0
3104,1888,0,0,62,62,0,1,0,1,0
18,2577,0,0,62,62,0,1,0,1,0
8066,1147,0,0,62,62,0,1,0,1,0
612,8,0,0,60,60,0,1,0,1,0
16951,255,0,0,62,62,0,1,0,1,0
17,2377,0,0,63,63,0,1,0,1,0
20401,2905,0,0,95,95,0,1,0,1,0
2861,1166,0,0,63,63,0,1,0,1,0
16951,255,0,0,62,62,0,1,0,1,0
4309,1147,0,0,63,63,0,1,0,1,0
21587,2938,0,0,78,78,0,1,0,1,0
2080,3216,0,0,62,62,0,1,0,1,0
9368,2256,0,0,71,71,0,1,0,1,0
16951,255,0,0,62,62,0,1,0,1,0
5040,2636,0,0,62,62,0,1,0,1,0
3505,1804,0,0,62,62,0,1,0,1,0
681,3216,0,0,66,66,0,1,0,1,0
10421,2351,0,0,137,137,0,1,0,1,0
1816,1017,0,0,62,62,0,1,0,1,0
2366,1147,0,0,146,146,0,1,0,1,0
19454,1017,0,0,62,62,0,1,0,1,0
11911,2902,0,0,68,68,0,1,0,1,0
2071,1888,0,0,62,62,0,1,0,1,0
4069,1017,0,0,62,62,0,1,0,1,0
1444,510,0,0,62,62,0,1,0,1,0
299,1180,0,0,64,64,0,1,0,1,0
7335,1070,0,0,60,60,0,1,0,1,0
2908,1017,0,0,62,62,0,1,0,1,0
17691,1888,0,0,62,62,0,1,0,1,0
14718,1888,0,0,64,64,0,1,0,1,0
19699,2622,0,0,63,63,0,1,0,1,0
16951,255,0,0,62,62,0,1,0,1,0
1860,3139,0,0,62,62,0,1,0,1,0
18369,740,0,0,63,63,0,1,0,1,0
3254,2382,0,0,66,66,0,1,0,1,0
1373,1147,0,0,64,64,0,1,0,1,0
3008,2612,0,0,147,147,0,1,0,1,0
14085,3216,0,0,66,66,0,1,0,1,0
12,448,0,0,60,60,0,1,0,1,0
14505,2312,0,0,78,78,0,1,0,1,0
19710,1771,0,0,66,66,0,1,0,1,0
2967,1771,0,0,66,66,0,1,0,1,0
19891,255,0,0,66,66,0,1,0,1,0
2664,2938,0,0,64,64,0,1,0,1,0
20871,2587,0,0,66,66,0,1,0,1,0
18116,3216,0,0,62,62,0,1,0,1,0
16778,484,0,0,71,71,0,1,0,1,0
17629,2587,0,0,66,66,0,1,0,1,0
6296,1499,0,0,146,146,0,1,0,1,0
2675,1147,0,0,65,65,0,1,0,1,0
5738,3216,0,0,62,62,0,1,0,1,0
395,2855,0,0,65,65,0,1,0,1,0
20842,1880,0,0,62,62,0,1,0,1,0
16951,255,0,0,62,62,0,1,0,1,0
1502,2686,0,0,66,66,0,1,0,1,0
10474,2601,0,0,64,64,0,1,0,1,0
287,1764,0,0,66,66,0,1,0,1,0
612,714,0,0,60,60,0,1,0,1,0
11685,3216,0,0,65,65,0,1,0,1,0
2611,1017,0,0,62,62,0,1,0,1,0
10278,2883,0,0,66,66,0,1,0,1,0
905,2652,0,0,146,146,0,1,0,1,0
16951,255,0,0,62,62,0,1,0,1,0
610,146,0,0,60,60,0,1,0,1,0
11,205,0,0,320,320,0,1,0,1,0
3132,513,0,0,149,149,0,1,0,1,0
360,3105,0,0,171,171,0,1,0,1,0
527,7,0,0,60,60,0,1,0,1,0
639,2065,0,0,143,143,0,1,0,1,0
16063,1474,0,0,66,66,0,1,0,1,0
15521,5,0,0,60,60,0,1,0,1,0
2968,509,0,0,116,116,0,1,0,1,0
8024,24,0,0,60,60,0,1,0,1,0
16951,255,0,0,62,62,0,1,0,1,0
8164,2727,0,0,60,60,0,1,0,1,0
12846,2194,0,0,63,63,0,1,0,1,0
4489,1147,0,0,65,65,0,1,0,1,0
5144,697,0,0,144,144,0,1,0,1,0
16951,255,0,0,62,62,0,1,0,1,0
7339,334,0,0,60,60,0,1,0,1,0
1715,2636,0,0,62,62,0,1,0,1,0
12,965,0,0,97,97,0,1,0,1,0
3678,2486,0,0,145,145,0,1,0,1,0
21292,2938,0,0,73,73,0,1,0,1,0
20004,2559,0,0,62,62,0,1,0,1,0
20075,1880,0,0,62,62,0,1,0,1,0
9095,1147,0,0,64,64,0,1,0,1,0
1804,1771,0,0,60,60,0,1,0,1,0
1075,146,0,0,60,60,0,1,0,1,0
17997,1472,0,0,65,65,0,1,0,1,0
2524,2636,0,0,66,66,0,1,0,1,0
100,2611,0,0,62,62,0,1,0,1,0
8293,2555,0,0,154,154,0,1,0,1,0
2677,1763,0,0,62,62,0,1,0,1,0
6651,1129,0,0,156,156,0,1,0,1,0
7273,1888,0,0,62,62,0,1,0,1,0
15903,2938,0,0,66,66,0,1,0,1,0
747,150,0,0,66,66,0,1,0,1,0
3230,2460,0,0,153,153,0,1,0,1,0
1604,1,0,0,66,66,0,1,0,1,0
22516,2888,0,0,66,66,0,1,0,1,0
526,377,1757,231,481,481,0,1,0,1,0
3386,1888,0,0,62,62,0,1,0,1,0
12,3074,0,0,320,320,0,1,0,1,0
15061,2883,0,0,133,133,0,1,0,1,0
7949,314,0,0,60,60,0,1,0,1,0
18865,1147,0,0,66,66,0,1,0,1,0
16715,1066,0,0,100,100,0,1,0,1,0
1177,3216,0,0,62,62,0,1,0,1,0
3807,2610,0,0,60,60,0,1,0,1,0
17603,2587,0,0,64,64,0,1,0,1,0
1804,1764,0,0,60,60,0,1,0,1,0
6751,17,0,0,229,229,0,1,0,1,0
13650,1835,0,0,77,77,0,1,0,1,0
5436,2256,0,0,141,141,0,1,0,1,0
2770,3216,0,0,66,66,0,1,0,1,0
7326,180,0,0,60,60,0,1,0,1,0
14096,2587,0,0,62,62,0,1,0,1,0
7339,140,0,0,60,60,0,1,0,1,0
5327,1888,0,0,62,62,0,1,0,1,0
13348,2272,0,0,69,69,0,1,0,1,0
20785,1172,0,0,66,66,0,1,0,1,0
22119,1215,0,0,62,62,0,1,0,1,0
16951,255,0,0,62,62,0,1,0,1,0
16171,1367,0,0,60,60,0,1,0,1,0
592,1054,0,0,66,66,0,1,0,1,0
16506,2326,0,0,68,68,0,1,0,1,0
15075,1888,0,0,63,63,0,1,0,1,0
20851,2256,0,0,63,63,0,1,0,1,0
266,1086,0,0,66,66,0,1,0,1,0
13716,2244,0,0,63,63,0,1,0,1,0
616,5,0,0,60,60,0,1,0,1,0
2456,2853,0,0,69,69,0,1,0,1,0
22046,1827,0,0,66,66,0,1,0,1,0
22091,1215,0,0,62,62,0,1,0,1,0
6690,1817,0,0,62,62,0,1,0,1,0
565,1017,0,0,62,62,0,1,0,1,0
8,1873,0,0,60,60,0,1,0,1,0
11450,245,0,0,60,60,0,1,0,1,0
6695,1825,0,0,63,63,0,1,0,1,0
18630,1167,0,0,64,64,0,1,0,1,0
3111,1481,0,0,62,62,0,1,0,1,0
1846,340,0,0,147,147,0,1,0,1,0
12960,3216,0,0,66,66,0,1,0,1,0
465,1888,0,0,66,66,0,1,0,1,0
21222,1896,0,0,63,63,0,1,0,1,0
2084,1471,0,0,145,145,0,1,0,1,0
3983,1589,0,0,62,62,0,1,0,1,0
8581,1017,0,0,66,66,0,1,0,1,0
16804,807,0,0,65,65,0,1,0,1,0
188,1792,0,0,60,60,0,1,0,1,0
7335,1070,0,0,60,60,0,1,0,1,0
1855,1,0,0,62,62,0,1,0,1,0
10759,281,0,0,60,60,0,1,0,1,0
12329,1880,0,0,64,64,0,1,0,1,0
11783,651,0,0,66,66,0,1,0,1,0
456,139,0,0,119,119,0,1,0,1,0
4158,2629,0,0,124,124,0,1,0,1,0
3254,1141,0,0,62,62,0,1,0,1,0
5153,1017,0,0,66,66,0,1,0,1,0
389,1888,0,0,62,62,0,1,0,1,0
12,1030,0,0,108,108,0,1,0,1,0
6243,2938,0,0,62,62,0,1,0,1,0
8050,2546,0,0,146,146,0,1,0,1,0
830,2451,0,0,91,91,0,1,0,1,0
315,2256,0,0,62,62,0,1,0,1,0
19175,1763,0,0,65,65,0,1,0,1,0
2181,1147,0,0,62,62,0,1,0,1,0
22321,2587,0,0,65,65,0,1,0,1,0
21599,2636,0,0,66,66,0,1,0,1,0
2184,6,0,0,60,60,0,1,0,1,0
16951,255,0,0,62,62,0,1,0,1,0
8264,1147,0,0,66,66,0,1,0,1,0
1463,7,0,0,60,60,0,1,0,1,0
158,1147,0,0,62,62,0,1,0,1,0
14244,2224,0,0,64,64,0,1,0,1,0
360,3105,0,0,275,275,0,1,0,1,0
2648,1212,0,0,63,63,0,1,0,1,0
19244,3132,0,0,62,62,0,1,0,1,0
10202,2587,0,0,66,66,0,1,0,1,0
1343,2154,0,0,62,62,0,1,0,1,0
14420,1817,0,0,64,64,0,1,0,1,0
13979,1936,0,0,74,74,0,1,0,1,0
14076,2903,0,0,68,68,0,1,0,1,0
2145,2604,0,0,63,63,0,1,0,1,0
1804,3191,0,0,60,60,0,1,0,1,0
8039,2938,0,0,114,114,0,1,0,1,0
9788,1771,0,0,66,66,0,1,0,1,0
12,3074,0,0,320,320,0,1,0,1,0
18314,1472,0,0,66,66,0,1,0,1,0
32,666,0,0,138,138,0,1,0,1,0
2658,1147,0,0,64,64,0,1,0,1,0
15391,509,0,0,64,64,0,1,0,1,0
19,1773,0,0,62,62,0,1,0,1,0
2015,2953,0,0,86,86,0,1,0,1,0
733,1591,0,0,61,61,0,1,0,1,0
21920,1153,0,0,66,66,0,1,0,1,0
1525,1444,0,0,145,145,0,1,0,1,0
1691,1888,0,0,62,62,0,1,0,1,0
13846,1006,0,0,64,64,0,1,0,1,0
21086,1147,0,0,62,62,0,1,0,1,0
7285,1490,0,0,63,63,0,1,0,1,0
6588,1771,0,0,62,62,0,1,0,1,0
9588,1215,0,0,66,66,0,1,0,1,0
2866,1017,0,0,62,62,0,1,0,1,0
388,1888,0,0,62,62,0,1,0,1,0
14455,3139,0,0,66,66,0,1,0,1,0
19031,2256,0,0,66,66,0,1,0,1,0
3228,2456,0,0,154,154,0,1,0,1,0
19099,357,0,0,60,60,0,1,0,1,0
1457,11,0,0,60,60,0,1,0,1,0
17455,1147,0,0,62,62,0,1,0,1,0
5576,2253,0,0,145,145,0,1,0,1,0
16727,174,0,0,60,60,0,1,0,1,0
16951,255,0,0,62,62,0,1,0,1,0
810,1017,0,0,65,65,0,1,0,1,0
13539,104,0,0,60,60,0,1,0,1,0
1699,2636,0,0,63,63,0,1,0,1,0
13676,2957,0,0,75,75,0,1,0,1,0
1374,1888,0,0,62,62,0,1,0,1,0
2452,2587,0,0,66,66,0,1,0,1,0
17871,2235,0,0,66,66,0,1,0,1,0
3006,2633,0,0,146,146,0,1,0,1,0
1478,2644,0,0,62,62,0,1,0,1,0
5350,2747,0,0,146,146,0,1,0,1,0
7004,2636,0,0,62,62,0,1,0,1,0
8714,993,0,0,63,63,0,1,0,1,0
8938,279,0,0,60,60,0,1,0,1,0
7509,218,0,0,60,60,0,1,0,1,0
2167,1147,0,0,97,97,0,1,0,1,0
12109,2599,0,0,66,66,0,1,0,1,0
20,438,0,0,672,672,0,1,0,1,0
1625,2883,0,0,62,62,0,1,0,1,0
1657,1147,0,0,146,146,0,1,0,1,0
6229,2938,0,0,78,78,0,1,0,1,0
5574,7,0,0,60,60,0,1,0,1,0
6922,2596,0,0,62,62,0,1,0,1,0
17594,1017,0,0,65,65,0,1,0,1,0
6798,430,0,0,129,129,0,1,0,1,0
20416,1211,0,0,62,62,0,1,0,1,0
1453,2123,0,0,101,101,0,1,0,1,0
6901,1100,0,0,62,62,0,1,0,1,0
569,1147,0,0,62,62,0,1,0,1,0
1528,1888,0,0,63,63,0,1,0,1,0
22040,1888,0,0,64,64,0,1,0,1,0
11930,2604,0,0,66,66,0,1,0,1,0
54,183,0,0,68,68,0,1,0,1,0
6690,1888,0,0,65,65,0,1,0,1,0
16951,255,0,0,62,62,0,1,0,1,0
16951,255,0,0,62,62,0,1,0,1,0
2003,2938,0,0,62,62,0,1,0,1,0
9964,2726,0,0,63,63,0,1,0,1,0
1311,1888,0,0,62,62,0,1,0,1,0
15096,161,0,0,145,145,0,1,0,1,0
19173,1017,0,0,66,66,0,1,0,1,0
1401,2938,0,0,62,62,0,1,0,1,0
9093,1215,0,0,65,65,0,1,0,1,0
5108,697,0,0,74,74,0,1,0,1,0
548,2256,0,0,66,66,0,1,0,1,0
11900,2914,0,0,70,70,0,1,0,1,0
9057,1781,0,0,62,62,0,1,0,1,0
14351,3213,0,0,66,66,0,1,0,1,0
731,1147,0,0,63,63,0,1,0,1,0
3414,2587,0,0,62,62,0,1,0,1,0
2179,1147,0,0,114,114,0,1,0,1,0
2222,1017,0,0,62,62,0,1,0,1,0
12493,3216,0,0,65,65,0,1,0,1,0
1495,2683,0,0,65,65,0,1,0,1,0
160,1888,0,0,62,62,0,1,0,1,0
2084,1471,0,0,145,145,0,1,0,1,0
9563,1215,0,0,65,65,0,1,0,1,0
8276,2023,0,0,161,161,0,1,0,1,0
6448,2883,0,0,62,62,0,1,0,1,0
7509,218,0,0,60,60,0,1,0,1,0
2847,2636,0,0,62,62,0,1,0,1,0
1855,2753,0,0,62,62,0,1,0,1,0
18801,2635,0,0,62,62,0,1,0,1,0
16621,1906,0,0,66,66,0,1,0,1,0
9557,3197,0,0,65,65,0,1,0,1,0
20331,1147,0,0,62,62,0,1,0,1,0
2141,1888,0,0,62,62,0,1,0,1,0
10066,2256,0,0,63,63,0,1,0,1,0
3940,1017,0,0,66,66,0,1,0,1,0
1880,2938,0,0,62,62,0,1,0,1,0
20468,1782,0,0,64,64,0,1,0,1,0
1699,1147,0,0,146,146,0,1,0,1,0
9480,1771,0,0,66,66,0,1,0,1,0
1737,3216,0,0,65,65,0,1,0,1,0
2594,3216,0,0,62,62,0,1,0,1,0
1531,465,0,0,159,159,0,1,0,1,0
1635,1818,0,0,63,63,0,1,0,1,0
636,1202,0,0,153,153,0,1,0,1,0
2672,1147,0,0,62,62,0,1,0,1,0
12946,259,0,0,63,63,0,1,0,1,0
433,3213,0,0,65,65,0,1,0,1,0
677,3216,0,0,63,63,0,1,0,1,0
18379,2938,0,0,73,73,0,1,0,1,0
1302,2953,0,0,69,69,0,1,0,1,0
20566,3216,0,0,62,62,0,1,0,1,0
17449,2610,0,0,66,66,0,1,0,1,0
46,669,0,0,147,147,0,1,0,1,0
595,1888,0,0,62,62,0,1,0,1,0
20838,2209,0,0,66,66,0,1,0,1,0
12,2346,0,0,199,199,0,1,0,1,0
10358,1888,0,0,66,66,0,1,0,1,0
19198,1216,0,0,66,66,0,1,0,1,0
17371,2948,0,0,66,66,0,1,0,1,0
18260,9,0,0,82,82,0,1,0,1,0
12002,2256,0,0,105,105,0,1,0,1,0
2197,2256,0,0,66,66,0,1,0,1,0
13682,3151,0,0,66,66,0,1,0,1,0
8164,2727,0,0,60,60,0,1,0,1,0
13208,1215,0,0,63,63,0,1,0,1,0
3049,1215,0,0,64,64,0,1,0,1,0
8542,509,0,0,66,66,0,1,0,1,0
12,442,0,0,150,150,0,1,0,1,0
636,280,0,0,146,146,0,1,0,1,0
18468,783,0,0,66,66,0,1,0,1,0
3208,509,0,0,146,146,0,1,0,1,0
6292,1017,0,0,62,62,0,1,0,1,0
20011,2499,0,0,130,130,0,1,0,1,0
18449,1786,0,0,62,62,0,1,0,1,0
6233,1646,0,0,60,60,0,1,0,1,0
9879,1017,0,0,105,105,0,1,0,1,0
1321,2636,0,0,64,64,0,1,0,1,0
3502,3179,0,0,151,151,0,1,0,1,0
2138,1215,0,0,65,65,0,1,0,1,0
14637,2600,0,0,88,88,0,1,0,1,0
497,2220,0,0,220,220,0,1,0,1,0
1755,2587,0,0,62,62,0,1,0,1,0
10172,2587,0,0,65,65,0,1,0,1,0
11456,1017,0,0,62,62,0,1,0,1,0
17133,2646,0,0,66,66,0,1,0,1,0
4787,7,0,0,60,60,0,1,0,1,0
17643,1880,0,0,66,66,0,1,0,1,0
12802,1459,0,0,66,66,0,1,0,1,0
838,2256,0,0,65,65,0,1,0,1,0
2098,374,0,0,60,60,0,1,0,1,0
7003,1215,0,0,62,62,0,1,0,1,0
7615,2594,0,0,65,65,0,1,0,1,0
8,876,0,0,61,61,0,1,0,1,0
16951,255,0,0,62,62,0,1,0,1,0
6308,2883,0,0,62,62,0,1,0,1,0
2593,1017,0,0,146,146,0,1,0,1,0
16951,255,0,0,62,62,0,1,0,1,0
12551,8,0,0,60,60,0,1,0,1,0
18086,2938,0,0,64,64,0,1,0,1,0
19370,2938,0,0,66,66,0,1,0,1,0
7496,3216,0,0,62,62,0,1,0,1,0
19786,1147,0,0,143,143,0,1,0,1,0
497,653,0,0,220,220,0,1,0,1,0
14458,2734,0,0,67,67,0,1,0,1,0
2061,3216,0,0,62,62,0,1,0,1,0
16323,2587,0,0,66,66,0,1,0,1,0
8323,2623,0,0,146,146,0,1,0,1,0
8065,1147,0,0,63,63,0,1,0,1,0
99,2781,0,0,66,66,0,1,0,1,0
1542,3216,0,0,145,145,0,1,0,1,0
592,1048,0,0,65,65,0,1,0,1,0
13451,1785,0,0,110,110,0,1,0,1,0
6451,2938,0,0,62,62,0,1,0,1,0
2082,27,0,0,60,60,0,1,0,1,0
7949,315,0,0,60,60,0,1,0,1,0
2631,1212,0,0,62,62,0,1,0,1,0
3268,1888,0,0,66,66,0,1,0,1,0
1243,328,0,0,137,137,0,1,0,1,0
22510,2611,0,0,78,78,0,1,0,1,0
2416,2938,0,0,62,62,0,1,0,1,0
12684,1017,0,0,65,65,0,1,0,1,0
763,1888,0,0,62,62,0,1,0,1,0
21590,2938,0,0,69,69,0,1,0,1,0
11677,2636,0,0,66,66,0,1,0,1,0
16234,894,0,0,65,65,0,1,0,1,0
7326,180,0,0,60,60,0,1,0,1,0
10386,2938,0,0,66,66,0,1,0,1,0
15271,1147,0,0,96,96,0,1,0,1,0
16951,255,0,0,62,62,0,1,0,1,0
19892,2938,0,0,74,74,0,1,0,1,0
19,1773,0,0,62,62,0,1,0,1,0
16951,255,0,0,62,62,0,1,0,1,0
16641,2614,0,0,64,64,0,1,0,1,0
17392,1147,0,0,66,66,0,1,0,1,0
11,851,0,0,60,60,0,1,0,1,0
1785,2883,0,0,62,62,0,1,0,1,0
4479,2617,0,0,93,93,0,1,0,1,0
5578,7,0,0,60,60,0,1,0,1,0
15588,2144,0,0,62,62,0,1,0,1,0
6281,1017,0,0,63,63,0,1,0,1,0
135,3139,0,0,64,64,0,1,0,1,0
408,3214,0,0,62,62,0,1,0,1,0
19072,1408,0,0,96,96,0,1,0,1,0
12,2199,0,0,97,97,0,1,0,1,0
8164,2727,0,0,60,60,0,1,0,1,0
12520,1795,0,0,60,60,0,1,0,1,0
21618,1017,0,0,64,64,0,1,0,1,0
10242,3123,0,0,66,66,0,1,0,1,0
16951,255,0,0,62,62,0,1,0,1,0
21032,1883,0,0,66,66,0,1,0,1,0
2604,1888,0,0,66,66,0,1,0,1,0
6708,1017,0,0,62,62,0,1,0,1,0
18053,2256,0,0,64,64,0,1,0,1,0
1539,2938,0,0,62,62,0,1,0,1,0
8283,3088,0,0,147,147,0,1,0,1,0
7335,1072,0,0,60,60,0,1,0,1,0
7339,170,0,0,60,60,0,1,0,1,0
298,2256,0,0,71,71,0,1,0,1,0
19131,2094,0,0,110,110,0,1,0,1,0
45,2941,0,0,145,145,0,1,0,1,0
16033,1482,0,0,62,62,0,1,0,1,0
2824,1147,0,0,146,146,0,1,0,1,0
6896,1881,0,0,62,62,0,1,0,1,0
14833,3139,0,0,65,65,0,1,0,1,0
22259,1773,0,0,62,62,0,1,0,1,0
21140,1782,0,0,62,62,0,1,0,1,0
8603,1892,0,0,65,65,0,1,0,1,0
17409,2636,0,0,66,66,0,1,0,1,0
3564,1147,0,0,62,62,0,1,0,1,0
16951,255,0,0,62,62,0,1,0,1,0
1344,2181,0,0,64,64,0,1,0,1,0
13646,2559,0,0,65,65,0,1,0,1,0
17555,1147,0,0,62,62,0,1,0,1,0
3064,1888,0,0,62,62,0,1,0,1,0
1037,2883,0,0,66,66,0,1,0,1,0
3241,1464,0,0,62,62,0,1,0,1,0
13074,181,0,0,60,60,0,1,0,1,0
3664,509,0,0,64,64,0,1,0,1,0
18029,1472,0,0,63,63,0,1,0,1,0
21611,2926,0,0,62,62,0,1,0,1,0
12481,2883,0,0,76,76,0,1,0,1,0
2308,428,0,0,62,62,0,1,0,1,0
16951,255,0,0,62,62,0,1,0,1,0
2510,2486,0,0,62,62,0,1,0,1,0
1604,1,0,0,66,66,0,1,0,1,0
5399,3153,0,0,129,129,0,1,0,1,0
20812,2236,0,0,66,66,0,1,0,1,0
4346,11,0,0,60,60,0,1,0,1,0
10722,1011,0,0,62,62,0,1,0,1,0
11946,2189,0,0,66,66,0,1,0,1,0
1611,2611,0,0,66,66,0,1,0,1,0
66,1147,0,0,146,146,0,1,0,1,0
7882,279,0,0,60,60,0,1,0,1,0
12690,1803,0,0,62,62,0,1,0,1,0
7721,2,0,0,61,61,0,1,0,1,0
19247,983,0,0,64,64,0,1,0,1,0
2380,2256,0,0,62,62,0,1,0,1,0
8660,1937,0,0,142,142,0,1,0,1,0
3118,2949,0,0,65,65,0,1,0,1,0
2223,1017,0,0,62,62,0,1,0,1,0
10883,179,0,0,60,60,0,1,0,1,0
1576,2883,0,0,62,62,0,1,0,1,0
88,378,0,0,64,64,0,1,0,1,0
17809,1880,0,0,66,66,0,1,0,1,0
17618,2578,0,0,70,70,0,1,0,1,0
16829,509,0,0,66,66,0,1,0,1,0
1402,2938,0,0,62,62,0,1,0,1,0
13701,2919,0,0,73,73,0,1,0,1,0
12,2903,0,0,78,78,0,1,0,1,0
2682,1017,0,0,62,62,0,1,0,1,0
11453,1147,0,0,62,62,0,1,0,1,0
13362,1811,0,0,90,90,0,1,0,1,0
16444,2881,0,0,90,90,0,1,0,1,0
16072,2256,0,0,62,62,0,1,0,1,0
15409,1017,0,0,65,65,0,1,0,1,0
4319,1147,0,0,62,62,0,1,0,1,0
2482,3216,0,0,66,66,0,1,0,1,0
22600,2938,0,0,67,67,0,1,0,1,0
4290,1147,0,0,65,65,0,1,0,1,0
6083,216,0,0,60,60,0,1,0,1,0
16480,416,0,0,60,60,0,1,0,1,0
20308,2611,0,0,66,66,0,1,0,1,0
12,155,0,0,132,132,0,1,0,1,0
360,3105,0,0,164,164,0,1,0,1,0
338,1771,0,0,62,62,0,1,0,1,0
15386,2886,0,0,62,62,0,1,0,1,0
8336,2256,0,0,63,63,0,1,0,1,0
7335,1070,0,0,60,60,0,1,0,1,0
12939,263,0,0,67,67,0,1,0,1,0
16951,255,0,0,62,62,0,1,0,1,0
13363,1215,0,0,66,66,0,1,0,1,0
20070,1881,0,0,62,62,0,1,0,1,0
6506,697,0,0,62,62,0,1,0,1,0
1285,1771,0,0,62,62,0,1,0,1,0
636,280,0,0,146,146,0,1,0,1,0
7993,319,0,0,60,60,0,1,0,1,0
4002,2636,0,0,146,146,0,1,0,1,0
3638,102,0,0,60,60,0,1,0,1,0
16951,255,0,0,62,62,0,1,0,1,0
12388,2256,0,0,135,135,0,1,0,1,0
16951,255,0,0,62,62,0,1,0,1,0
10335,2205,0,0,66,66,0,1,0,1,0
16951,255,0,0,62,62,0,1,0,1,0
17808,2587,0,0,63,63,0,1,0,1,0
2676,3216,0,0,62,62,0,1,0,1,0
16951,255,0,0,62,62,0,1,0,1,0
10367,1888,0,0,66,66,0,1,0,1,0
20739,2780,0,0,77,77,0,1,0,1,0
8171,1073,0,0,60,60,0,1,0,1,0
7273,1888,0,0,62,62,0,1,0,1,0
20246,1664,0,0,80,80,0,1,0,1,0
11450,245,0,0,60,60,0,1,0,1,0
1804,1017,0,0,61,61,0,1,0,1,0
6334,1072,0,0,146,146,0,1,0,1,0
13842,90,0,0,63,63,0,1,0,1,0
16389,2256,0,0,66,66,0,1,0,1,0
7273,1888,0,0,62,62,0,1,0,1,0
3650,1009,0,0,61,61,0,1,0,1,0
3416,2587,0,0,146,146,0,1,0,1,0
13369,1883,0,0,64,64,0,1,0,1,0
15560,2187,0,0,62,62,0,1,0,1,0
13471,1017,0,0,63,63,0,1,0,1,0
10401,2256,0,0,63,63,0,1,0,1,0
344,2587,0,0,63,63,0,1,0,1,0
11356,3193,0,0,62,62,0,1,0,1,0
5492,1813,0,0,66,66,0,1,0,1,0
9273,6,0,0,60,60,0,1,0,1,0
1989,1771,0,0,146,146,0,1,0,1,0
14489,3216,0,0,66,66,0,1,0,1,0
2597,2954,0,0,61,61,0,1,0,1,0
7339,140,0,0,60,60,0,1,0,1,0
8,5,0,0,60,60,0,1,0,1,0
9677,2636,0,0,66,66,0,1,0,1,0
626,276,0,0,61,61,0,1,0,1,0
9080,1147,0,0,66,66,0,1,0,1,0
11587,1472,0,0,63,63,0,1,0,1,0
1669,1147,0,0,62,62,0,1,0,1,0
16951,255,0,0,62,62,0,1,0,1,0
8827,1888,0,0,67,67,0,1,0,1,0
2324,430,0,0,62,62,0,1,0,1,0
7339,140,0,0,60,60,0,1,0,1,0
1329,2636,0,0,66,66,0,1,0,1,0
2058,3216,0,0,62,62,0,1,0,1,0
19157,1009,0,0,62,62,0,1,0,1,0
9274,12,0,0,60,60,0,1,0,1,0
19485,1013,0,0,62,62,0,1,0,1,0
6724,2256,0,0,62,62,0,1,0,1,0
14485,3216,0,0,66,66,0,1,0,1,0
65,1147,0,0,62,62,0,1,0,1,0
18549,764,0,0,66,66,0,1,0,1,0
808,2493,0,0,146,146,0,1,0,1,0
16938,259,0,0,77,77,0,1,0,1,0
1507,1888,0,0,65,65,0,1,0,1,0
16951,255,0,0,62,62,0,1,0,1,0
6088,1083,0,0,62,62,0,1,0,1,0
3894,697,0,0,62,62,0,1,0,1,0
19881,2938,0,0,72,72,0,1,0,1,0
2791,988,0,0,66,66,0,1,0,1,0
12650,1147,0,0,66,66,0,1,0,1,0
22041,1888,0,0,64,64,0,1,0,1,0
2537,1789,0,0,119,119,0,1,0,1,0
1401,2938,0,0,62,62,0,1,0,1,0
17596,2636,0,0,64,64,0,1,0,1,0
794,1174,0,0,61,61,0,1,0,1,0
1551,2953,0,0,66,66,0,1,0,1,0
18,3216,0,0,62,62,0,1,0,1,0
3260,1017,0,0,66,66,0,1,0,1,0
11864,209,0,0,62,62,0,1,0,1,0
6177,1804,0,0,86,86,0,1,0,1,0
17677,3214,0,0,63,63,0,1,0,1,0
2660,1888,0,0,62,62,0,1,0,1,0
7561,1804,0,0,62,62,0,1,0,1,0
20553,3216,0,0,62,62,0,1,0,1,0
8185,1099,0,0,62,62,0,1,0,1,0
16951,255,0,0,62,62,0,1,0,1,0
16951,255,0,0,62,62,0,1,0,1,0
22302,1880,0,0,62,62,0,1,0,1,0
5987,1156,0,0,62,62,0,1,0,1,0
16266,1885,0,0,63,63,0,1,0,1,0
288,1766,0,0,64,64,0,1,0,1,0
636,1676,0,0,151,151,0,1,0,1,0
7328,336,0,0,60,60,0,1,0,1,0
20047,1803,0,0,66,66,0,1,0,1,0
17456,357,0,0,66,66,0,1,0,1,0
16478,246,0,0,60,60,0,1,0,1,0
6233,1646,0,0,60,60,0,1,0,1,0
3060,1888,0,0,70,70,0,1,0,1,0
3001,357,0,0,62,62,0,1,0,1,0
4504,2486,0,0,62,62,0,1,0,1,0
1845,6,0,0,60,60,0,1,0,1,0
13352,1847,0,0,66,66,0,1,0,1,0
10212,2975,0,0,64,64,0,1,0,1,0
20585,1017,0,0,62,62,0,1,0,1,0
8549,985,0,0,65,65,0,1,0,1,0
584,1888,0,0,62,62,0,1,0,1,0
20848,3174,0,0,66,66,0,1,0,1,0
1188,1155,0,0,62,62,0,1,0,1,0
16073,2883,0,0,63,63,0,1,0,1,0
7339,170,0,0,60,60,0,1,0,1,0
2704,493,0,0,64,64,0,1,0,1,0
62,1888,0,0,62,62,0,1,0,1,0
1224,1882,0,0,64,64,0,1,0,1,0
1398,10,0,0,60,60,0,1,0,1,0
1825,460,0,0,66,66,0,1,0,1,0
2992,2124,0,0,146,146,0,1,0,1,0
5332,3216,0,0,62,62,0,1,0,1,0
9243,1224,0,0,62,62,0,1,0,1,0
11582,1472,0,0,66,66,0,1,0,1,0
9146,1888,0,0,66,66,0,1,0,1,0
1607,3172,0,0,62,62,0,1,0,1,0
3585,2541,0,0,145,145,0,1,0,1,0
16986,2233,0,0,66,66,0,1,0,1,0
2444,2938,0,0,62,62,0,1,0,1,0
12925,1827,0,0,66,66,0,1,0,1,0
20068,2587,0,0,83,83,0,1,0,1,0
15149,410,0,0,63,63,0,1,0,1,0
2654,3216,0,0,62,62,0,1,0,1,0
3118,1147,0,0,62,62,0,1,0,1,0
9258,2601,0,0,63,63,0,1,0,1,0
1962,2613,0,0,62,62,0,1,0,1,0
3851,2883,0,0,63,63,0,1,0,1,0
18237,1086,0,0,66,66,0,1,0,1,0
16951,255,0,0,62,62,0,1,0,1,0
1987,2256,0,0,66,66,0,1,0,1,0
14417,2675,0,0,63,63,0,1,0,1,0
21920,1215,0,0,62,62,0,1,0,1,0
37,1469,0,0,62,62,0,1,0,1,0
12421,1792,0,0,64,64,0,1,0,1,0
9928,2486,0,0,66,66,0,1,0,1,0
17819,2935,0,0,62,62,0,1,0,1,0
3876,1923,0,0,62,62,0,1,0,1,0
1910,7,0,0,60,60,0,1,0,1,0
17335,1327,0,0,62,62,0,1,0,1,0
8006,2587,0,0,62,62,0,1,0,1,0
16951,255,0,0,62,62,0,1,0,1,0
4075,1147,0,0,65,65,0,1,0,1,0
13575,1147,0,0,62,62,0,1,0,1,0
14743,2938,0,0,62,62,0,1,0,1,0
2358,3180,0,0,63,63,0,1,0,1,0
666,1042,0,0,66,66,0,1,0,1,0
5476,1183,0,0,63,63,0,1,0,1,0
11316,1215,0,0,62,62,0,1,0,1,0
15118,3216,0,0,62,62,0,1,0,1,0
7339,170,0,0,60,60,0,1,0,1,0
16951,255,0,0,62,62,0,1,0,1,0
1435,1017,0,0,62,62,0,1,0,1,0
306,2938,0,0,66,66,0,1,0,1,0
9614,3105,0,0,86,86,0,1,0,1,0
16833,1927,0,0,85,85,0,1,0,1,0
7335,1069,0,0,60,60,0,1,0,1,0
16951,255,0,0,62,62,0,1,0,1,0
2027,1888,0,0,64,64,0,1,0,1,0
16951,255,0,0,62,62,0,1,0,1,0
60,2382,0,0,62,62,0,1,0,1,0
1735,1147,0,0,62,62,0,1,0,1,0
611,2595,0,0,62,62,0,1,0,1,0
16951,255,0,0,62,62,0,1,0,1,0
13785,509,0,0,62,62,0,1,0,1,0
2497,3216,0,0,62,62,0,1,0,1,0
1911,1771,0,0,146,146,0,1,0,1,0
14023,1590,0,0,65,65,0,1,0,1,0
13278,2256,0,0,62,62,0,1,0,1,0
3876,1923,0,0,62,62,0,1,0,1,0
1975,2585,0,0,145,145,0,1,0,1,0
2792,1147,0,0,62,62,0,1,0,1,0
4082,1017,0,0,62,62,0,1,0,1,0
614,18,0,0,88,88,0,1,0,1,0
1328,2205,0,0,66,66,0,1,0,1,0
21617,1000,0,0,66,66,0,1,0,1,0
1330,697,0,0,62,62,0,1,0,1,0
7339,140,0,0,60,60,0,1,0,1,0
16951,255,0,0,62,62,0,1,0,1,0
189,1789,0,0,61,61,0,1,0,1,0
21570,2604,0,0,66,66,0,1,0,1,0
12401,2883,0,0,121,121,0,1,0,1,0
163,2636,0,0,62,62,0,1,0,1,0
2680,510,0,0,65,65,0,1,0,1,0
11453,1147,0,0,62,62,0,1,0,1,0
13847,1215,0,0,66,66,0,1,0,1,0
17440,1147,0,0,65,65,0,1,0,1,0
19120,158,0,0,60,60,0,1,0,1,0
7038,2938,0,0,71,71,0,1,0,1,0
683,1017,0,0,62,62,0,1,0,1,0
2492,1472,0,0,62,62,0,1,0,1,0
2555,6,0,0,60,60,0,1,0,1,0
10532,1147,0,0,63,63,0,1,0,1,0
10199,3193,0,0,62,62,0,1,0,1,0
639,2935,0,0,147,147,0,1,0,1,0
1158,460,0,0,62,62,0,1,0,1,0
6761,5,0,0,60,60,0,1,0,1,0
0,0,0,0,180,180,0,1,0,1,0
19096,1327,0,0,65,65,0,1,0,1,0
1885,3139,0,0,65,65,0,1,0,1,0
15281,1882,0,0,62,62,0,1,0,1,0
20871,1884,0,0,64,64,0,1,0,1,0
600,708,0,0,89,89,0,1,0,1,0
6715,2568,0,0,69,69,0,1,0,1,0
2959,3216,0,0,62,62,0,1,0,1,0
16951,255,0,0,62,62,0,1,0,1,0
9312,2938,0,0,66,66,0,1,0,1,0
13329,2633,0,0,66,66,0,1,0,1,0
8276,2023,0,0,161,161,0,1,0,1,0
20718,2256,0,0,62,62,0,1,0,1,0
18,1147,0,0,62,62,0,1,0,1,0
17694,1147,0,0,64,64,0,1,0,1,0
1435,1017,0,0,62,62,0,1,0,1,0
16951,255,0,0,62,62,0,1,0,1,0
19589,2256,0,0,62,62,0,1,0,1,0
16951,255,0,0,62,62,0,1,0,1,0
2697,2587,0,0,62,62,0,1,0,1,0
15391,509,0,0,66,66,0,1,0,1,0
19795,1500,0,0,140,140,0,1,0,1,0
16759,825,0,0,66,66,0,1,0,1,0
9791,1154,0,0,62,62,0,1,0,1,0
1591,1888,0,0,62,62,0,1,0,1,0
4738,148,0,0,60,60,0,1,0,1,0
7335,1070,0,0,60,60,0,1,0,1,0
3309,1888,0,0,66,66,0,1,0,1,0
4563,2205,0,0,62,62,0,1,0,1,0
3192,2629,0,0,62,62,0,1,0,1,0
12710,743,0,0,62,62,0,1,0,1,0
396,2853,0,0,65,65,0,1,0,1,0
2062,1461,0,0,145,145,0,1,0,1,0
2837,2587,0,0,62,62,0,1,0,1,0
22704,1017,0,0,66,66,0,1,0,1,0
12146,1853,0,0,65,65,0,1,0,1,0
2394,2256,0,0,146,146,0,1,0,1,0
13456,1797,0,0,63,63,0,1,0,1,0
2275,1017,0,0,146,146,0,1,0,1,0
13074,181,0,0,60,60,0,1,0,1,0
22276,1215,0,0,65,65,0,1,0,1,0
1415,1017,0,0,62,62,0,1,0,1,0
1256,1152,0,0,62,62,0,1,0,1,0
16269,1156,0,0,134,134,0,1,0,1,0
19291,3216,0,0,66,66,0,1,0,1,0
4259,7,0,0,60,60,0,1,0,1,0
16829,509,0,0,66,66,0,1,0,1,0
7597,1133,0,0,62,62,0,1,0,1,0
10439,2376,0,0,133,133,0,1,0,1,0
17952,1066,0,0,66,66,0,1,0,1,0
15457,1017,0,0,62,62,0,1,0,1,0
751,2587,0,0,62,62,0,1,0,1,0
21437,180,0,0,66,66,0,1,0,1,0
1802,1766,0,0,60,60,0,1,0,1,0
1902,2256,0,0,62,62,0,1,0,1,0
12572,2185,0,0,70,70,0,1,0,1,0
1846,3151,0,0,61,61,0,1,0,1,0
12325,1880,0,0,63,63,0,1,0,1,0
1525,1444,0,0,145,145,0,1,0,1,0
16199,3216,0,0,63,63,0,1,0,1,0
18218,1017,0,0,64,64,0,1,0,1,0
1330,918,0,0,62,62,0,1,0,1,0
13476,1472,0,0,66,66,0,1,0,1,0
16025,1112,0,0,62,62,0,1,0,1,0
2804,1017,0,0,62,62,0,1,0,1,0
12337,3139,0,0,63,63,0,1,0,1,0
17305,2616,0,0,66,66,0,1,0,1,0
7626,1723,0,0,60,60,0,1,0,1,0
3234,2432,0,0,69,69,0,1,0,1,0
17757,2884,0,0,66,66,0,1,0,1,0
264,1147,0,0,146,146,0,1,0,1,0
9614,3105,0,0,86,86,0,1,0,1,0
12,3039,0,0,61,61,0,1,0,1,0
2921,3216,0,0,66,66,0,1,0,1,0
11900,2913,0,0,70,70,0,1,0,1,0
21273,995,0,0,63,63,0,1,0,1,0
17945,2256,0,0,66,66,0,1,0,1,0
13278,1153,0,0,118,118,0,1,0,1,0
1460,11,0,0,60,60,0,1,0,1,0
16951,255,0,0,62,62,0,1,0,1,0
17317,1130,0,0,65,65,0,1,0,1,0
16951,255,0,0,62,62,0,1,0,1,0
21923,1888,0,0,66,66,0,1,0,1,0
14088,2883,0,0,66,66,0,1,0,1,0
21904,2205,0,0,63,63,0,1,0,1,0
1330,804,0,0,62,62,0,1,0,1,0
354,3110,0,0,63,63,0,1,0,1,0
1292,1017,0,0,146,146,0,1,0,1,0
12961,3215,0,0,66,66,0,1,0,1,0
16951,255,0,0,62,62,0,1,0,1,0
4921,2601,0,0,63,63,0,1,0,1,0
16951,255,0,0,62,62,0,1,0,1,0
15961,1888,0,0,65,65,0,1,0,1,0
13012,1804,0,0,62,62,0,1,0,1,0
554,2251,0,0,65,65,0,1,0,1,0
11114,2886,0,0,62,62,0,1,0,1,0
256,3216,0,0,62,62,0,1,0,1,0
10475,6,0,0,60,60,0,1,0,1,0
4026,697,0,0,66,66,0,1,0,1,0
6859,7,0,0,62,62,0,1,0,1,0
3032,2587,0,0,64,64,0,1,0,1,0
1720,1827,0,0,64,64,0,1,0,1,0
182,2486,0,0,62,62,0,1,0,1,0
19260,3216,0,0,62,62,0,1,0,1,0
2254,1472,0,0,66,66,0,1,0,1,0
18943,2519,0,0,66,66,0,1,0,1,0
4490,1147,0,0,62,62,0,1,0,1,0
7326,1649,0,0,60,60,0,1,0,1,0
278,303,0,0,62,62,0,1,0,1,0
2132,1888,0,0,62,62,0,1,0,1,0
16951,255,0,0,62,62,0,1,0,1,0
15694,1515,0,0,145,145,0,1,0,1,0
13364,1215,0,0,66,66,0,1,0,1,0
21293,1147,0,0,62,62,0,1,0,1,0
1679,1147,0,0,62,62,0,1,0,1,0
689,2587,0,0,63,63,0,1,0,1,0
1438,2873,0,0,66,66,0,1,0,1,0
20462,2938,0,0,113,113,0,1,0,1,0
362,280,0,0,66,66,0,1,0,1,0
16179,1147,0,0,63,63,0,1,0,1,0
1242,298,0,0,144,144,0,1,0,1,0
7507,2587,0,0,66,66,0,1,0,1,0
21455,155,0,0,66,66,0,1,0,1,0
14990,2588,0,0,62,62,0,1,0,1,0
5768,3216,0,0,62,62,0,1,0,1,0
2457,2587,0,0,63,63,0,1,0,1,0
19836,2939,0,0,65,65,0,1,0,1,0
12706,1888,0,0,66,66,0,1,0,1,0
6106,2587,0,0,66,66,0,1,0,1,0
14400,1807,0,0,62,62,0,1,0,1,0
360,3105,0,0,1110,1110,0,1,0,1,0
5793,3216,0,0,62,62,0,1,0,1,0
704,1017,0,0,96,96,0,1,0,1,0
5040,2636,0,0,66,66,0,1,0,1,0
17562,2256,0,0,66,66,0,1,0,1,0
3180,1771,0,0,65,65,0,1,0,1,0
360,3105,0,0,927,927,0,1,0,1,0
3466,242,0,0,145,145,0,1,0,1,0
13874,983,0,0,62,62,0,1,0,1,0
13042,1835,0,0,66,66,0,1,0,1,0
11814,2607,0,0,76,76,0,1,0,1,0
16951,255,0,0,62,62,0,1,0,1,0
13793,509,0,0,66,66,0,1,0,1,0
5265,2256,0,0,66,66,0,1,0,1,0
9208,1017,0,0,62,62,0,1,0,1,0
8114,2550,0,0,62,62,0,1,0,1,0
12,2247,0,0,83,83,0,1,0,1,0
19096,1327,0,0,65,65,0,1,0,1,0
1547,2948,0,0,64,64,0,1,0,1,0
18312,178,0,0,64,64,0,1,0,1,0
16951,255,0,0,62,62,0,1,0,1,0
2664,1147,0,0,62,62,0,1,0,1,0
12325,239,0,0,61,61,0,1,0,1,0
2482,3216,0,0,66,66,0,1,0,1,0
12065,1207,0,0,62,62,0,1,0,1,0
16729,161,0,0,60,60,0,1,0,1,0
19139,992,0,0,66,66,0,1,0,1,0
7261,1162,0,0,62,62,0,1,0,1,0
186,2486,0,0,64,64,0,1,0,1,0
1452,224,0,0,61,61,0,1,0,1,0
22277,1802,0,0,66,66,0,1,0,1,0
2454,2938,0,0,62,62,0,1,0,1,0
21342,1147,0,0,65,65,0,1,0,1,0
2518,2938,0,0,62,62,0,1,0,1,0
7335,1070,0,0,60,60,0,1,0,1,0
18039,1771,0,0,65,65,0,1,0,1,0
181,2486,0,0,65,65,0,1,0,1,0
15363,1215,0,0,65,65,0,1,0,1,0
4471,1183,0,0,62,62,0,1,0,1,0
2973,7,0,0,60,60,0,1,0,1,0
15450,1472,0,0,66,66,0,1,0,1,0
10475,6,0,0,60,60,0,1,0,1,0
339,1769,0,0,66,66,0,1,0,1,0
16451,1472,0,0,62,62,0,1,0,1,0
14832,1206,0,0,66,66,0,1,0,1,0
13159,2256,0,0,65,65,0,1,0,1,0
14963,1017,0,0,65,65,0,1,0,1,0
7986,1147,0,0,146,146,0,1,0,1,0
18,2938,0,0,62,62,0,1,0,1,0
757,1614,0,0,61,61,0,1,0,1,0
2460,2587,0,0,62,62,0,1,0,1,0
9364,1768,0,0,66,66,0,1,0,1,0
16714,2604,0,0,65,65,0,1,0,1,0
16794,1472,0,0,66,66,0,1,0,1,0
407,2895,0,0,63,63,0,1,0,1,0
14804,2852,0,0,66,66,0,1,0,1,0
1133,2938,0,0,78,78,0,1,0,1,0
4380,1019,0,0,62,62,0,1,0,1,0
18955,2500,0,0,62,62,0,1,0,1,0
20745,1884,0,0,66,66,0,1,0,1,0
391,3216,0,0,62,62,0,1,0,1,0
3133,2920,0,0,71,71,0,1,0,1,0
22636,2938,0,0,69,69,0,1,0,1,0
1525,1444,0,0,145,145,0,1,0,1,0
16951,255,0,0,62,62,0,1,0,1,0
775,997,0,0,63,63,0,1,0,1,0
17293,1894,0,0,65,65,0,1,0,1,0
21096,1215,0,0,64,64,0,1,0,1,0
7068,2938,0,0,64,64,0,1,0,1,0
20044,2594,0,0,67,67,0,1,0,1,0
163,2205,0,0,63,63,0,1,0,1,0
5526,1017,0,0,65,65,0,1,0,1,0
16951,255,0,0,62,62,0,1,0,1,0
18537,1771,0,0,64,64,0,1,0,1,0
13281,2354,0,0,66,66,0,1,0,1,0
3726,1926,0,0,71,71,0,1,0,1,0
20769,1147,0,0,64,64,0,1,0,1,0
7347,2636,0,0,62,62,0,1,0,1,0
22,3216,0,0,62,62,0,1,0,1,0
798,3008,0,0,60,60,0,1,0,1,0
1605,1017,0,0,62,62,0,1,0,1,0
14891,1017,0,0,146,146,0,1,0,1,0
16951,255,0,0,62,62,0,1,0,1,0
340,1768,0,0,62,62,0,1,0,1,0
18268,1063,0,0,64,64,0,1,0,1,0
1330,697,0,0,62,62,0,1,0,1,0
12245,1017,0,0,62,62,0,1,0,1,0
22510,2611,0,0,78,78,0,1,0,1,0
2602,986,0,0,65,65,0,1,0,1,0
7224,354,0,0,61,61,0,1,0,1,0
8228,2587,0,0,66,66,0,1,0,1,0
7304,1147,0,0,135,135,0,1,0,1,0
16951,255,0,0,62,62,0,1,0,1,0
14228,6,0,0,60,60,0,1,0,1,0
1860,3139,0,0,62,62,0,1,0,1,0
12604,1888,0,0,66,66,0,1,0,1,0
1328,2636,0,0,66,66,0,1,0,1,0
19447,1051,0,0,63,63,0,1,0,1,0
16951,255,0,0,62,62,0,1,0,1,0
12175,1875,0,0,66,66,0,1,0,1,0
704,1147,0,0,63,63,0,1,0,1,0
14020,1890,0,0,66,66,0,1,0,1,0
3535,663,0,0,110,110,0,1,0,1,0
676,3216,0,0,62,62,0,1,0,1,0
2964,1888,0,0,62,62,0,1,0,1,0
612,21,0,0,60,60,0,1,0,1,0
19269,3216,0,0,64,64,0,1,0,1,0
2620,1210,0,0,62,62,0,1,0,1,0
2490,1147,0,0,62,62,0,1,0,1,0
16952,3212,0,0,62,62,0,1,0,1,0
10544,798,0,0,73,73,0,1,0,1,0
5525,2938,0,0,62,62,0,1,0,1,0
11631,2905,0,0,66,66,0,1,0,1,0
7335,1072,0,0,60,60,0,1,0,1,0
2658,1147,0,0,66,66,0,1,0,1,0
19913,1880,0,0,66,66,0,1,0,1,0
7339,140,0,0,60,60,0,1,0,1,0
3974,1017,0,0,143,143,0,1,0,1,0
0,0,0,0,98,98,0,1,0,1,0
1121,2636,0,0,66,66,0,1,0,1,0
809,2587,0,0,104,104,0,1,0,1,0
729,1147,0,0,62,62,0,1,0,1,0
418,1771,0,0,63,63,0,1,0,1,0
8867,255,0,0,60,60,0,1,0,1,0
16415,2180,0,0,66,66,0,1,0,1,0
1502,1888,0,0,66,66,0,1,0,1,0
1672,3216,0,0,66,66,0,1,0,1,0
8825,1888,0,0,68,68,0,1,0,1,0
17065,3213,0,0,63,63,0,1,0,1,0
20135,1880,0,0,65,65,0,1,0,1,0
19876,2587,0,0,66,66,0,1,0,1,0
16951,255,0,0,62,62,0,1,0,1,0
11878,2938,0,0,74,74,0,1,0,1,0
2195,2256,0,0,66,66,0,1,0,1,0
5327,1888,0,0,62,62,0,1,0,1,0
2717,2256,0,0,62,62,0,1,0,1,0
20811,2953,0,0,66,66,0,1,0,1,0
12885,2546,0,0,62,62,0,1,0,1,0
20735,2778,0,0,78,78,0,1,0,1,0
18843,2918,0,0,66,66,0,1,0,1,0
148,7,0,0,60,60,0,1,0,1,0
453,127,0,0,126,126,0,1,0,1,0
11502,1851,0,0,64,64,0,1,0,1,0
9503,1888,0,0,66,66,0,1,0,1,0
3005,1147,0,0,62,62,0,1,0,1,0
9509,1888,0,0,66,66,0,1,0,1,0
6364,1186,0,0,62,62,0,1,0,1,0
16951,255,0,0,62,62,0,1,0,1,0
18,1147,0,0,62,62,0,1,0,1,0
588,2611,0,0,78,78,0,1,0,1,0
16951,255,0,0,62,62,0,1,0,1,0
21592,847,0,0,66,66,0,1,0,1,0
14978,1215,0,0,64,64,0,1,0,1,0
1447,493,0,0,67,67,0,1,0,1,0
1363,2883,0,0,65,65,0,1,0,1,0
2651,3216,0,0,65,65,0,1,0,1,0
1833,2580,0,0,62,62,0,1,0,1,0
17902,2520,0,0,91,91,0,1,0,1,0
16951,255,0,0,62,62,0,1,0,1,0
1937,1215,0,0,64,64,0,1,0,1,0
497,2220,0,0,220,220,0,1,0,1,0
16951,255,0,0,62,62,0,1,0,1,0
1772,1841,0,0,146,146,0,1,0,1,0
1472,555,0,0,62,62,0,1,0,1,0
13443,1888,0,0,66,66,0,1,0,1,0
6335,1157,0,0,62,62,0,1,0,1,0
14393,1804,0,0,62,62,0,1,0,1,0
3651,1017,0,0,62,62,0,1,0,1,0
16951,255,0,0,62,62,0,1,0,1,0
1350,1147,0,0,66,66,0,1,0,1,0
16951,255,0,0,62,62,0,1,0,1,0
10775,3216,0,0,62,62,0,1,0,1,0
20785,1171,0,0,66,66,0,1,0,1,0
2608,1017,0,0,62,62,0,1,0,1,0
1265,1215,0,0,62,62,0,1,0,1,0
1804,1195,0,0,60,60,0,1,0,1,0
14808,2207,0,0,62,62,0,1,0,1,0
16317,2587,0,0,66,66,0,1,0,1,0
9938,1865,0,0,65,65,0,1,0,1,0
4224,2620,0,0,62,62,0,1,0,1,0
12,2537,0,0,88,88,0,1,0,1,0
2450,2938,0,0,62,62,0,1,0,1,0
12,658,0,0,104,104,0,1,0,1,0
10153,1033,0,0,65,65,0,1,0,1,0
1441,11,0,0,60,60,0,1,0,1,0
1239,1039,0,0,62,62,0,1,0,1,0
11898,2697,0,0,66,66,0,1,0,1,0
12,3116,0,0,1484,1484,0,1,0,1,0
22223,155,0,0,66,66,0,1,0,1,0
20861,2588,0,0,66,66,0,1,0,1,0
2280,1147,0,0,62,62,0,1,0,1,0
13872,983,0,0,63,63,0,1,0,1,0
2454,1215,0,0,63,63,0,1,0,1,0
22468,201,0,0,78,78,0,1,0,1,0
1932,1771,0,0,62,62,0,1,0,1,0
22058,1821,0,0,67,67,0,1,0,1,0
17607,1887,0,0,66,66,0,1,0,1,0
20989,697,0,0,66,66,0,1,0,1,0
14066,1147,0,0,65,65,0,1,0,1,0
1663,2953,0,0,62,62,0,1,0,1,0
2776,1017,0,0,63,63,0,1,0,1,0
2387,2256,0,0,63,63,0,1,0,1,0
2898,2883,0,0,90,90,0,1,0,1,0
16951,255,0,0,62,62,0,1,0,1,0
5037,1017,0,0,146,146,0,1,0,1,0
18789,1827,0,0,62,62,0,1,0,1,0
263,289,0,0,64,64,0,1,0,1,0
7669,3216,0,0,62,62,0,1,0,1,0
7760,4,0,0,60,60,0,1,0,1,0
252,2613,0,0,62,62,0,1,0,1,0
12,1420,0,0,82,82,0,1,0,1,0
4583,2256,0,0,66,66,0,1,0,1,0
1820,1147,0,0,62,62,0,1,0,1,0
2965,2592,0,0,65,65,0,1,0,1,0
10756,3216,0,0,62,62,0,1,0,1,0
12,1932,0,0,82,82,0,1,0,1,0
360,3105,0,0,479,479,0,1,0,1,0
6851,243,0,0,61,61,0,1,0,1,0
12,3110,0,0,326,326,0,1,0,1,0
20558,545,0,0,62,62,0,1,0,1,0
7555,209,0,0,60,60,0,1,0,1,0
6651,1129,0,0,156,156,0,1,0,1,0
3715,1147,0,0,140,140,0,1,0,1,0
3004,1771,0,0,66,66,0,1,0,1,0
9707,1888,0,0,66,66,0,1,0,1,0
2513,1477,0,0,61,61,0,1,0,1,0
16951,255,0,0,62,62,0,1,0,1,0
6452,355,0,0,61,61,0,1,0,1,0
360,3105,0,0,240,240,0,1,0,1,0
8409,1794,0,0,66,66,0,1,0,1,0
6076,1147,0,0,62,62,0,1,0,1,0
1275,509,0,0,62,62,0,1,0,1,0
13,193,0,0,90,90,0,1,0,1,0
120,2883,0,0,62,62,0,1,0,1,0
17954,3139,0,0,66,66,0,1,0,1,0
22223,155,0,0,66,66,0,1,0,1,0
2425,295,0,0,146,146,0,1,0,1,0
12524,3216,0,0,63,63,0,1,0,1,0
2840,2587,0,0,62,62,0,1,0,1,0
19421,2603,0,0,83,83,0,1,0,1,0
16951,255,0,0,62,62,0,1,0,1,0
7519,3216,0,0,62,62,0,1,0,1,0
17412,2602,0,0,66,66,0,1,0,1,0
16951,255,0,0,62,62,0,1,0,1,0
1065,2883,0,0,62,62,0,1,0,1,0
21,509,0,0,62,62,0,1,0,1,0
0,0,0,0,98,98,0,1,0,1,0
5600,2578,0,0,62,62,0,1,0,1,0
9870,2938,0,0,66,66,0,1,0,1,0
20053,2587,0,0,66,66,0,1,0,1,0
9420,3153,0,0,130,130,0,1,0,1,0
17555,997,0,0,66,66,0,1,0,1,0
21264,1147,0,0,62,62,0,1,0,1,0
17466,2943,0,0,66,66,0,1,0,1,0
7335,1070,0,0,60,60,0,1,0,1,0
2852,2671,0,0,62,62,0,1,0,1,0
2546,2587,0,0,62,62,0,1,0,1,0
2196,2256,0,0,66,66,0,1,0,1,0
612,225,0,0,60,60,0,1,0,1,0
15607,2256,0,0,66,66,0,1,0,1,0
7677,3216,0,0,62,62,0,1,0,1,0
2660,1888,0,0,62,62,0,1,0,1,0
16727,177,0,0,60,60,0,1,0,1,0
14757,3139,0,0,66,66,0,1,0,1,0
1226,2256,0,0,66,66,0,1,0,1,0
13978,2256,0,0,66,66,0,1,0,1,0
521,341,1429,188,456,456,0,1,0,1,0
1745,1888,0,0,146,146,0,1,0,1,0
8939,1888,0,0,62,62,0,1,0,1,0
11500,1771,0,0,63,63,0,1,0,1,0
119,1017,0,0,62,62,0,1,0,1,0
668,7,0,0,60,60,0,1,0,1,0
1548,2614,0,0,62,62,0,1,0,1,0
6050,2938,0,0,62,62,0,1,0,1,0
2084,1471,0,0,145,145,0,1,0,1,0
746,7,0,0,60,60,0,1,0,1,0
5806,252,0,0,60,60,0,1,0,1,0
4822,1082,0,0,140,140,0,1,0,1,0
16951,255,0,0,62,62,0,1,0,1,0
2216,2636,0,0,62,62,0,1,0,1,0
2132,1888,0,0,62,62,0,1,0,1,0
1575,823,0,0,62,62,0,1,0,1,0
538,1888,0,0,62,62,0,1,0,1,0
14228,6,0,0,60,60,0,1,0,1,0
5634,391,0,0,60,60,0,1,0,1,0
20993,3213,0,0,64,64,0,1,0,1,0
16951,255,0,0,62,62,0,1,0,1,0
2121,3216,0,0,64,64,0,1,0,1,0
19428,242,0,0,145,145,0,1,0,1,0
525,1888,0,0,62,62,0,1,0,1,0
4495,1147,0,0,130,130,0,1,0,1,0
84,1147,0,0,63,63,0,1,0,1,0
328,1017,0,0,65,65,0,1,0,1,0
6377,2920,0,0,65,65,0,1,0,1,0
1247,1014,0,0,62,62,0,1,0,1,0
16951,255,0,0,62,62,0,1,0,1,0
9687,997,0,0,71,71,0,1,0,1,0
22436,2937,0,0,66,66,0,1,0,1,0
15140,427,0,0,78,78,0,1,0,1,0
7606,3216,0,0,62,62,0,1,0,1,0
636,2299,0,0,113,113,0,1,0,1,0
16030,1147,0,0,62,62,0,1,0,1,0
16951,255,0,0,62,62,0,1,0,1,0
22606,1215,0,0,62,62,0,1,0,1,0
14244,2883,0,0,66,66,0,1,0,1,0
19038,621,0,0,113,113,0,1,0,1,0
1471,1147,0,0,62,62,0,1,0,1,0
2456,2587,0,0,64,64,0,1,0,1,0
1992,3216,0,0,64,64,0,1,0,1,0
19405,2602,0,0,66,66,0,1,0,1,0
2084,1471,0,0,145,145,0,1,0,1,0
3053,306,0,0,145,145,0,1,0,1,0
1161,3216,0,0,62,62,0,1,0,1,0
15735,1905,0,0,65,65,0,1,0,1,0
5956,2587,0,0,66,66,0,1,0,1,0
8363,2243,0,0,113,113,0,1,0,1,0
5564,2256,0,0,146,146,0,1,0,1,0
4967,1026,0,0,60,60,0,1,0,1,0
2376,2937,0,0,115,115,0,1,0,1,0
10895,2187,0,0,64,64,0,1,0,1,0
8821,2938,0,0,63,63,0,1,0,1,0
1815,1147,0,0,62,62,0,1,0,1,0
732,1590,0,0,62,62,0,1,0,1,0
15281,1147,0,0,62,62,0,1,0,1,0
344,2587,0,0,64,64,0,1,0,1,0
16951,255,0,0,62,62,0,1,0,1,0
275,9,0,0,60,60,0,1,0,1,0
18489,2938,0,0,62,62,0,1,0,1,0
17364,1147,0,0,63,63,0,1,0,1,0
3603,666,0,0,132,132,0,1,0,1,0
16951,255,0,0,62,62,0,1,0,1,0
2589,1213,0,0,65,65,0,1,0,1,0
7381,2636,0,0,62,62,0,1,0,1,0
19263,3216,0,0,62,62,0,1,0,1,0
3632,109,0,0,60,60,0,1,0,1,0
20764,1825,0,0,66,66,0,1,0,1,0
2381,1017,0,0,63,63,0,1,0,1,0
1414,1888,0,0,62,62,0,1,0,1,0
20507,509,0,0,62,62,0,1,0,1,0
17091,811,0,0,66,66,0,1,0,1,0
1631,1888,0,0,62,62,0,1,0,1,0
0,0,0,0,98,98,0,1,0,1,0
1459,1147,0,0,146,146,0,1,0,1,0
14339,1215,0,0,64,64,0,1,0,1,0
20119,1054,0,0,66,66,0,1,0,1,0
711,2938,0,0,66,66,0,1,0,1,0
17,1909,0,0,65,65,0,1,0,1,0
6651,1129,0,0,156,156,0,1,0,1,0
16570,1901,0,0,64,64,0,1,0,1,0
1342,2205,0,0,66,66,0,1,0,1,0
14060,1147,0,0,63,63,0,1,0,1,0
6875,1474,0,0,65,65,0,1,0,1,0
788,1143,0,0,62,62,0,1,0,1,0
17,2764,0,0,60,60,0,1,0,1,0
2775,2636,0,0,63,63,0,1,0,1,0
16951,255,0,0,62,62,0,1,0,1,0
1609,2608,0,0,65,65,0,1,0,1,0
2336,1147,0,0,146,146,0,1,0,1,0
19808,1017,0,0,64,64,0,1,0,1,0
9699,2624,0,0,66,66,0,1,0,1,0
15694,1515,0,0,145,145,0,1,0,1,0
9,2991,0,0,1504,1504,0,1,0,1,0
5760,289,0,0,60,60,0,1,0,1,0
6569,2587,0,0,119,119,0,1,0,1,0
14805,2852,0,0,66,66,0,1,0,1,0
18684,489,0,0,65,65,0,1,0,1,0
16951,255,0,0,62,62,0,1,0,1,0
24,1471,0,0,150,150,0,1,0,1,0
17454,2592,0,0,62,62,0,1,0,1,0
2369,3216,0,0,62,62,0,1,0,1,0
19240,3117,0,0,63,63,0,1,0,1,0
2643,1917,0,0,62,62,0,1,0,1,0
4304,1147,0,0,63,63,0,1,0,1,0
13790,1900,0,0,63,63,0,1,0,1,0
674,3216,0,0,62,62,0,1,0,1,0
2841,1888,0,0,64,64,0,1,0,1,0
12116,3212,0,0,66,66,0,1,0,1,0
6862,28,0,0,65,65,0,1,0,1,0
1309,7,0,0,60,60,0,1,0,1,0
17051,2611,0,0,62,62,0,1,0,1,0
3974,2199,0,0,62,62,0,1,0,1,0
3415,2587,0,0,65,65,0,1,0,1,0
1592,1718,0,0,62,62,0,1,0,1,0
3876,1923,0,0,62,62,0,1,0,1,0
7339,140,0,0,60,60,0,1,0,1,0
16951,255,0,0,62,62,0,1,0,1,0
508,7,0,0,60,60,0,1,0,1,0
20461,2626,0,0,63,63,0,1,0,1,0
6429,1215,0,0,62,62,0,1,0,1,0
4955,2628,0,0,64,64,0,1,0,1,0
2189,6,0,0,60,60,0,1,0,1,0
14473,3216,0,0,66,66,0,1,0,1,0
2387,1764,0,0,65,65,0,1,0,1,0
1330,697,0,0,62,62,0,1,0,1,0
5965,1220,0,0,63,63,0,1,0,1,0
16668,3216,0,0,67,67,0,1,0,1,0
16277,1882,0,0,66,66,0,1,0,1,0
14185,1160,0,0,66,66,0,1,0,1,0
2253,7,0,0,60,60,0,1,0,1,0
2692,501,0,0,62,62,0,1,0,1,0
319,3216,0,0,62,62,0,1,0,1,0
22622,1017,0,0,66,66,0,1,0,1,0
13847,1017,0,0,66,66,0,1,0,1,0
16086,1771,0,0,66,66,0,1,0,1,0
7339,2845,0,0,60,60,0,1,0,1,0
7326,1649,0,0,60,60,0,1,0,1,0
3785,2477,0,0,60,60,0,1,0,1,0
1359,2636,0,0,104,104,0,1,0,1,0
22366,1472,0,0,66,66,0,1,0,1,0
639,2063,0,0,143,143,0,1,0,1,0
2780,1147,0,0,63,63,0,1,0,1,0
18504,1017,0,0,66,66,0,1,0,1,0
6506,697,0,0,62,62,0,1,0,1,0
12,1425,0,0,88,88,0,1,0,1,0
20306,775,0,0,66,66,0,1,0,1,0
16951,255,0,0,62,62,0,1,0,1,0
11347,1215,0,0,63,63,0,1,0,1,0
688,2587,0,0,62,62,0,1,0,1,0
9614,3105,0,0,86,86,0,1,0,1,0
229,1048,0,0,62,62,0,1,0,1,0
1423,1017,0,0,66,66,0,1,0,1,0
15846,1539,0,0,65,65,0,1,0,1,0
14722,1771,0,0,62,62,0,1,0,1,0
1438,1017,0,0,64,64,0,1,0,1,0
8,1873,0,0,60,60,0,1,0,1,0
351,797,0,0,62,62,0,1,0,1,0
22200,2573,0,0,66,66,0,1,0,1,0
1913,1790,0,0,62,62,0,1,0,1,0
21918,1154,0,0,63,63,0,1,0,1,0
22152,1215,0,0,62,62,0,1,0,1,0
21476,1146,0,0,66,66,0,1,0,1,0
595,1031,0,0,63,63,0,1,0,1,0
13442,2587,0,0,66,66,0,1,0,1,0
10972,2938,0,0,66,66,0,1,0,1,0
24,3216,0,0,62,62,0,1,0,1,0
2626,1211,0,0,62,62,0,1,0,1,0
13847,1215,0,0,66,66,0,1,0,1,0
12,207,0,0,256,256,0,1,0,1,0
1292,1035,0,0,64,64,0,1,0,1,0
18531,1771,0,0,63,63,0,1,0,1,0
16951,255,0,0,62,62,0,1,0,1,0
2121,3216,0,0,64,64,0,1,0,1,0
7708,2587,0,0,62,62,0,1,0,1,0
3435,465,0,0,150,150,0,1,0,1,0
16951,255,0,0,62,62,0,1,0,1,0
2983,1147,0,0,146,146,0,1,0,1,0
506,1771,0,0,65,65,0,1,0,1,0
2636,510,0,0,63,63,0,1,0,1,0
1587,2587,0,0,136,136,0,1,0,1,0
16951,255,0,0,62,62,0,1,0,1,0
13424,1472,0,0,66,66,0,1,0,1,0
16951,255,0,0,62,62,0,1,0,1,0
1854,3216,0,0,65,65,0,1,0,1,0
13236,1804,0,0,66,66,0,1,0,1,0
12,979,0,0,73,73,0,1,0,1,0
14065,2923,0,0,71,71,0,1,0,1,0
16951,255,0,0,62,62,0,1,0,1,0
1446,3216,0,0,145,145,0,1,0,1,0
1716,2636,0,0,62,62,0,1,0,1,0
19855,2169,0,0,66,66,0,1,0,1,0
18808,2747,0,0,66,66,0,1,0,1,0
6347,1169,0,0,62,62,0,1,0,1,0
7517,2938,0,0,62,62,0,1,0,1,0
16265,2587,0,0,66,66,0,1,0,1,0
10771,3216,0,0,62,62,0,1,0,1,0
1350,3216,0,0,62,62,0,1,0,1,0
12,983,0,0,97,97,0,1,0,1,0
4770,695,0,0,62,62,0,1,0,1,0
22037,1821,0,0,66,66,0,1,0,1,0
3212,2587,0,0,146,146,0,1,0,1,0
16951,255,0,0,62,62,0,1,0,1,0
112,2883,0,0,62,62,0,1,0,1,0
392,1888,0,0,63,63,0,1,0,1,0
11575,1472,0,0,66,66,0,1,0,1,0
21267,1017,0,0,66,66,0,1,0,1,0
22438,1039,0,0,64,64,0,1,0,1,0
11023,1147,0,0,64,64,0,1,0,1,0
3020,1880,0,0,66,66,0,1,0,1,0
9503,1017,0,0,62,62,0,1,0,1,0
10973,1888,0,0,62,62,0,1,0,1,0
16951,255,0,0,62,62,0,1,0,1,0
3950,1017,0,0,64,64,0,1,0,1,0
823,2121,0,0,144,144,0,1,0,1,0
8651,509,0,0,65,65,0,1,0,1,0
22427,2309,0,0,66,66,0,1,0,1,0
20840,2202,0,0,63,63,0,1,0,1,0
18320,2371,0,0,66,66,0,1,0,1,0
1327,1017,0,0,63,63,0,1,0,1,0
7304,2606,0,0,62,62,0,1,0,1,0
9462,2539,0,0,66,66,0,1,0,1,0
360,3105,0,0,904,904,0,1,0,1,0
639,2055,0,0,143,143,0,1,0,1,0
5306,2747,0,0,146,146,0,1,0,1,0
2969,1804,0,0,66,66,0,1,0,1,0
7339,170,0,0,60,60,0,1,0,1,0
12,3216,0,0,62,62,0,1,0,1,0
12,3142,0,0,65,65,0,1,0,1,0
16951,255,0,0,62,62,0,1,0,1,0
1782,2587,0,0,62,62,0,1,0,1,0
1591,1888,0,0,62,62,0,1,0,1,0
13015,2939,0,0,66,66,0,1,0,1,0
19815,3216,0,0,65,65,0,1,0,1,0
7615,1804,0,0,62,62,0,1,0,1,0
360,3105,0,0,159,159,0,1,0,1,0
1428,2607,0,0,62,62,0,1,0,1,0
13129,2256,0,0,66,66,0,1,0,1,0
3260,1017,0,0,66,66,0,1,0,1,0
17138,783,0,0,66,66,0,1,0,1,0
645,1520,0,0,114,114,0,1,0,1,0
18,3216,0,0,62,62,0,1,0,1,0
15450,1472,0,0,66,66,0,1,0,1,0
7373,1591,0,0,73,73,0,1,0,1,0
16840,2938,0,0,66,66,0,1,0,1,0
21192,2256,0,0,63,63,0,1,0,1,0
1437,499,0,0,63,63,0,1,0,1,0
820,143,0,0,60,60,0,1,0,1,0
11092,1017,0,0,108,108,0,1,0,1,0
2444,2695,0,0,66,66,0,1,0,1,0
1804,218,0,0,60,60,0,1,0,1,0
2942,2587,0,0,66,66,0,1,0,1,0
17210,1886,0,0,66,66,0,1,0,1,0
1509,1888,0,0,66,66,0,1,0,1,0
20785,1215,0,0,66,66,0,1,0,1,0
3060,1888,0,0,69,69,0,1,0,1,0
2185,7,0,0,60,60,0,1,0,1,0
1655,280,0,0,80,80,0,1,0,1,0
1370,2883,0,0,62,62,0,1,0,1,0
14228,6,0,0,60,60,0,1,0,1,0
12532,2235,0,0,66,66,0,1,0,1,0
13280,1155,0,0,63,63,0,1,0,1,0
20051,685,0,0,140,140,0,1,0,1,0
20196,3195,0,0,63,63,0,1,0,1,0
7077,2607,0,0,62,62,0,1,0,1,0
4115,939,0,0,62,62,0,1,0,1,0
3179,1147,0,0,95,95,0,1,0,1,0
2500,1482,0,0,65,65,0,1,0,1,0
15576,1147,0,0,63,63,0,1,0,1,0
16951,255,0,0,62,62,0,1,0,1,0
1281,2543,0,0,60,60,0,1,0,1,0
466,1273,0,0,63,63,0,1,0,1,0
21634,1888,0,0,62,62,0,1,0,1,0
17108,697,0,0,66,66,0,1,0,1,0
12088,2963,0,0,71,71,0,1,0,1,0
22575,2256,0,0,66,66,0,1,0,1,0
19,1469,0,0,143,143,0,1,0,1,0
2301,1946,0,0,60,60,0,1,0,1,0
15450,1472,0,0,63,63,0,1,0,1,0
16951,255,0,0,62,62,0,1,0,1,0
15892,3139,0,0,63,63,0,1,0,1,0
21430,1147,0,0,63,63,0,1,0,1,0
8965,258,0,0,60,60,0,1,0,1,0
2553,3178,0,0,60,60,0,1,0,1,0
9510,3175,0,0,66,66,0,1,0,1,0
1827,1147,0,0,62,62,0,1,0,1,0
1461,1147,0,0,62,62,0,1,0,1,0
6721,2256,0,0,63,63,0,1,0,1,0
1695,1215,0,0,62,62,0,1,0,1,0
6261,2501,0,0,61,61,0,1,0,1,0
13709,2886,0,0,66,66,0,1,0,1,0
1236,509,0,0,65,65,0,1,0,1,0
6550,1215,0,0,62,62,0,1,0,1,0
15328,2256,0,0,62,62,0,1,0,1,0
16621,1906,0,0,66,66,0,1,0,1,0
4333,1147,0,0,63,63,0,1,0,1,0
3311,1888,0,0,66,66,0,1,0,1,0
18607,1050,0,0,66,66,0,1,0,1,0
9273,6,0,0,60,60,0,1,0,1,0
10,406,0,0,74,74,0,1,0,1,0
7283,3216,0,0,62,62,0,1,0,1,0
10451,2883,0,0,63,63,0,1,0,1,0
9,3016,0,0,1500,1500,0,1,0,1,0
975,2636,0,0,62,62,0,1,0,1,0
10474,1179,0,0,72,72,0,1,0,1,0
7500,222,0,0,60,60,0,1,0,1,0
2976,1888,0,0,62,62,0,1,0,1,0
8221,2587,0,0,62,62,0,1,0,1,0
5160,1017,0,0,65,65,0,1,0,1,0
778,1888,0,0,146,146,0,1,0,1,0
12146,1861,0,0,63,63,0,1,0,1,0
2005,2587,0,0,62,62,0,1,0,1,0
2116,8,0,0,60,60,0,1,0,1,0
1211,3216,0,0,62,62,0,1,0,1,0
8795,1215,0,0,66,66,0,1,0,1,0
16951,255,0,0,62,62,0,1,0,1,0
14070,3216,0,0,66,66,0,1,0,1,0
13710,2235,0,0,62,62,0,1,0,1,0
19464,1886,0,0,66,66,0,1,0,1,0
17760,2885,0,0,62,62,0,1,0,1,0
2202,1017,0,0,62,62,0,1,0,1,0
14908,2235,0,0,66,66,0,1,0,1,0
2902,2587,0,0,63,63,0,1,0,1,0
7988,1147,0,0,146,146,0,1,0,1,0
13070,1872,0,0,66,66,0,1,0,1,0
2548,2198,0,0,60,60,0,1,0,1,0
8841,646,0,0,65,65,0,1,0,1,0
1866,1017,0,0,64,64,0,1,0,1,0
7625,2593,0,0,62,62,0,1,0,1,0
20659,2953,0,0,62,62,0,1,0,1,0
12,929,0,0,83,83,0,1,0,1,0
17670,3212,0,0,66,66,0,1,0,1,0
275,9,0,0,60,60,0,1,0,1,0
16951,255,0,0,62,62,0,1,0,1,0
17874,2235,0,0,66,66,0,1,0,1,0
20506,1017,0,0,66,66,0,1,0,1,0
12767,697,0,0,62,62,0,1,0,1,0
405,1888,0,0,65,65,0,1,0,1,0
19978,2562,0,0,66,66,0,1,0,1,0
11029,1888,0,0,62,62,0,1,0,1,0
250,2587,0,0,62,62,0,1,0,1,0
11822,156,0,0,65,65,0,1,0,1,0
11340,1215,0,0,62,62,0,1,0,1,0
19820,2787,0,0,60,60,0,1,0,1,0
20339,3139,0,0,66,66,0,1,0,1,0
17459,2953,0,0,66,66,0,1,0,1,0
3205,2607,0,0,62,62,0,1,0,1,0
20960,1200,0,0,156,156,0,1,0,1,0
12561,3139,0,0,62,62,0,1,0,1,0
19607,509,0,0,66,66,0,1,0,1,0
19343,804,0,0,66,66,0,1,0,1,0
10475,6,0,0,60,60,0,1,0,1,0
5277,2256,0,0,62,62,0,1,0,1,0
18929,2552,0,0,70,70,0,1,0,1,0
19862,1705,0,0,62,62,0,1,0,1,0
14691,3216,0,0,65,65,0,1,0,1,0
9991,2738,0,0,65,65,0,1,0,1,0
17914,677,0,0,125,125,0,1,0,1,0
1415,1017,0,0,63,63,0,1,0,1,0
231,1147,0,0,62,62,0,1,0,1,0
669,1888,0,0,64,64,0,1,0,1,0
1908,2543,0,0,145,145,0,1,0,1,0
14023,1590,0,0,65,65,0,1,0,1,0
16845,1928,0,0,66,66,0,1,0,1,0
3184,7,0,0,60,60,0,1,0,1,0
2850,1792,0,0,62,62,0,1,0,1,0
2385,1763,0,0,65,65,0,1,0,1,0
16951,255,0,0,62,62,0,1,0,1,0
13147,1040,0,0,66,66,0,1,0,1,0
559,1017,0,0,65,65,0,1,0,1,0
7051,2938,0,0,67,67,0,1,0,1,0
17821,2587,0,0,64,64,0,1,0,1,0
7304,1147,0,0,115,115,0,1,0,1,0
364,280,0,0,63,63,0,1,0,1,0
21829,2587,0,0,117,117,0,1,0,1,0
3152,2587,0,0,62,62,0,1,0,1,0
16125,929,0,0,66,66,0,1,0,1,0
360,3105,0,0,233,233,0,1,0,1,0
16951,255,0,0,62,62,0,1,0,1,0
22176,252,0,0,70,70,0,1,0,1,0
16030,2883,0,0,66,66,0,1,0,1,0
21081,1771,0,0,62,62,0,1,0,1,0
1020,2938,0,0,62,62,0,1,0,1,0
20317,9,0,0,85,85,0,1,0,1,0
8491,1009,0,0,66,66,0,1,0,1,0
1333,1472,0,0,63,63,0,1,0,1,0
20758,1147,0,0,66,66,0,1,0,1,0
2479,2435,0,0,145,145,0,1,0,1,0
2739,1046,0,0,62,62,0,1,0,1,0
1161,3216,0,0,62,62,0,1,0,1,0
5070,2611,0,0,62,62,0,1,0,1,0
2828,2587,0,0,62,62,0,1,0,1,0
891,2615,0,0,146,146,0,1,0,1,0
20695,2938,0,0,66,66,0,1,0,1,0
8135,2753,0,0,96,96,0,1,0,1,0
2430,2938,0,0,62,62,0,1,0,1,0
9352,1215,0,0,62,62,0,1,0,1,0
2599,2871,0,0,61,61,0,1,0,1,0
2937,2587,0,0,62,62,0,1,0,1,0
1958,2580,0,0,145,145,0,1,0,1,0
543,1771,0,0,62,62,0,1,0,1,0
11029,1888,0,0,62,62,0,1,0,1,0
3443,1888,0,0,62,62,0,1,0,1,0
14393,1804,0,0,117,117,0,1,0,1,0
10013,2587,0,0,66,66,0,1,0,1,0
7,12,0,0,346,346,0,1,0,1,0
2348,3139,0,0,66,66,0,1,0,1,0
1255,2365,0,0,62,62,0,1,0,1,0
3651,1017,0,0,81,81,0,1,0,1,0
9509,1888,0,0,66,66,0,1,0,1,0
22079,1867,0,0,62,62,0,1,0,1,0
30,1888,0,0,62,62,0,1,0,1,0
14155,2352,0,0,66,66,0,1,0,1,0
643,4,0,0,97,97,0,1,0,1,0
16844,2938,0,0,66,66,0,1,0,1,0
587,1888,0,0,62,62,0,1,0,1,0
1684,1215,0,0,62,62,0,1,0,1,0
14479,3139,0,0,66,66,0,1,0,1,0
1738,2573,0,0,62,62,0,1,0,1,0
352,2332,0,0,68,68,0,1,0,1,0
2851,2618,0,0,64,64,0,1,0,1,0
11979,2181,0,0,66,66,0,1,0,1,0
14061,1905,0,0,66,66,0,1,0,1,0
2651,3216,0,0,65,65,0,1,0,1,0
12151,1863,0,0,66,66,0,1,0,1,0
7344,1085,0,0,60,60,0,1,0,1,0
10851,2883,0,0,65,65,0,1,0,1,0
17809,1880,0,0,66,66,0,1,0,1,0
12485,3216,0,0,66,66,0,1,0,1,0
1613,4,0,0,62,62,0,1,0,1,0
11711,3216,0,0,62,62,0,1,0,1,0
11350,1043,0,0,63,63,0,1,0,1,0
9975,2600,0,0,66,66,0,1,0,1,0
16549,1008,0,0,64,64,0,1,0,1,0
16951,255,0,0,62,62,0,1,0,1,0
456,3160,0,0,66,66,0,1,0,1,0
9590,3186,0,0,66,66,0,1,0,1,0
9170,996,0,0,66,66,0,1,0,1,0
2303,436,0,0,62,62,0,1,0,1,0
638,480,0,0,133,133,0,1,0,1,0
16951,255,0,0,62,62,0,1,0,1,0
8164,2727,0,0,60,60,0,1,0,1,0
3480,3192,0,0,62,62,0,1,0,1,0
7335,1070,0,0,60,60,0,1,0,1,0
22657,271,0,0,62,62,0,1,0,1,0
1533,6,0,0,60,60,0,1,0,1,0
778,1888,0,0,146,146,0,1,0,1,0
65,7,0,0,60,60,0,1,0,1,0
12541,2901,0,0,63,63,0,1,0,1,0
8960,1147,0,0,65,65,0,1,0,1,0
17819,2938,0,0,73,73,0,1,0,1,0
3235,2563,0,0,146,146,0,1,0,1,0
16648,7,0,0,60,60,0,1,0,1,0
15984,2938,0,0,66,66,0,1,0,1,0
268,1472,0,0,63,63,0,1,0,1,0
16444,2881,0,0,90,90,0,1,0,1,0
20,1147,0,0,146,146,0,1,0,1,0
13580,3051,0,0,66,66,0,1,0,1,0
8985,1147,0,0,62,62,0,1,0,1,0
1516,1771,0,0,65,65,0,1,0,1,0
3177,2602,0,0,62,62,0,1,0,1,0
714,2938,0,0,65,65,0,1,0,1,0
16861,983,0,0,66,66,0,1,0,1,0
2592,338,0,0,66,66,0,1,0,1,0
4600,1804,0,0,66,66,0,1,0,1,0
10511,550,0,0,92,92,0,1,0,1,0
15588,2256,0,0,65,65,0,1,0,1,0
16951,255,0,0,62,62,0,1,0,1,0
18374,1472,0,0,66,66,0,1,0,1,0
20350,983,0,0,66,66,0,1,0,1,0
632,2933,0,0,75,75,0,1,0,1,0
8276,2495,0,0,161,161,0,1,0,1,0
11956,3004,0,0,67,67,0,1,0,1,0
20785,1199,0,0,66,66,0,1,0,1,0
8367,2256,0,0,64,64,0,1,0,1,0
1264,1782,0,0,64,64,0,1,0,1,0
16171,1367,0,0,60,60,0,1,0,1,0
2236,2609,0,0,62,62,0,1,0,1,0
1240,309,0,0,144,144,0,1,0,1,0
16263,1887,0,0,66,66,0,1,0,1,0
16951,255,0,0,62,62,0,1,0,1,0
6110,1132,0,0,62,62,0,1,0,1,0
16972,2218,0,0,64,64,0,1,0,1,0
12957,956,0,0,62,62,0,1,0,1,0
9304,1763,0,0,66,66,0,1,0,1,0
7213,357,0,0,62,62,0,1,0,1,0
14702,3204,0,0,66,66,0,1,0,1,0
15099,1590,0,0,62,62,0,1,0,1,0
19174,2158,0,0,66,66,0,1,0,1,0
21406,1017,0,0,64,64,0,1,0,1,0
636,280,0,0,146,146,0,1,0,1,0
7949,314,0,0,60,60,0,1,0,1,0
1264,1147,0,0,62,62,0,1,0,1,0
16951,255,0,0,62,62,0,1,0,1,0
12293,2256,0,0,62,62,0,1,0,1,0
16652,1796,0,0,66,66,0,1,0,1,0
1525,1444,0,0,145,145,0,1,0,1,0
13267,1748,0,0,66,66,0,1,0,1,0
12,650,0,0,143,143,0,1,0,1,0
19892,2938,0,0,74,74,0,1,0,1,0
139,1017,0,0,62,62,0,1,0,1,0
16951,255,0,0,62,62,0,1,0,1,0
19343,3215,0,0,66,66,0,1,0,1,0
10787,2587,0,0,72,72,0,1,0,1,0
21786,1872,0,0,66,66,0,1,0,1,0
11934,2604,0,0,64,64,0,1,0,1,0
12619,1888,0,0,65,65,0,1,0,1,0
10611,1885,0,0,69,69,0,1,0,1,0
3419,2594,0,0,62,62,0,1,0,1,0
11450,245,0,0,60,60,0,1,0,1,0
5157,1017,0,0,66,66,0,1,0,1,0
20383,513,0,0,62,62,0,1,0,1,0
5536,1045,0,0,62,62,0,1,0,1,0
12502,1147,0,0,66,66,0,1,0,1,0
7335,1070,0,0,60,60,0,1,0,1,0
19,1773,0,0,62,62,0,1,0,1,0
595,1017,0,0,62,62,0,1,0,1,0
1100,7,0,0,60,60,0,1,0,1,0
8171,1073,0,0,60,60,0,1,0,1,0
8865,3216,0,0,66,66,0,1,0,1,0
16951,255,0,0,62,62,0,1,0,1,0
1471,2144,0,0,62,62,0,1,0,1,0
2256,2636,0,0,62,62,0,1,0,1,0
18046,1880,0,0,62,62,0,1,0,1,0
7339,237,0,0,60,60,0,1,0,1,0
12863,2938,0,0,66,66,0,1,0,1,0
2084,1471,0,0,145,145,0,1,0,1,0
9348,3216,0,0,66,66,0,1,0,1,0
12,2564,0,0,65,65,0,1,0,1,0
15859,3139,0,0,66,66,0,1,0,1,0
5460,3139,0,0,83,83,0,1,0,1,0
21848,2587,0,0,65,65,0,1,0,1,0
2168,1147,0,0,62,62,0,1,0,1,0
16238,2265,0,0,142,142,0,1,0,1,0
21055,2599,0,0,62,62,0,1,0,1,0
6857,2577,0,0,120,120,0,1,0,1,0
2591,397,0,0,148,148,0,1,0,1,0
7273,1888,0,0,62,62,0,1,0,1,0
60,1888,0,0,62,62,0,1,0,1,0
1734,1147,0,0,62,62,0,1,0,1,0
9377,2256,0,0,67,67,0,1,0,1,0
14555,2225,0,0,98,98,0,1,0,1,0
2000,2256,0,0,66,66,0,1,0,1,0
10223,2587,0,0,65,65,0,1,0,1,0
1463,1147,0,0,62,62,0,1,0,1,0
7787,6,0,0,60,60,0,1,0,1,0
16951,255,0,0,62,62,0,1,0,1,0
17469,509,0,0,62,62,0,1,0,1,0
3489,7,0,0,60,60,0,1,0,1,0
6464,353,0,0,61,61,0,1,0,1,0
362,498,0,0,66,66,0,1,0,1,0
6661,1771,0,0,62,62,0,1,0,1,0
17349,2549,0,0,73,73,0,1,0,1,0
2219,2636,0,0,66,66,0,1,0,1,0
1964,983,0,0,66,66,0,1,0,1,0
7589,2573,0,0,74,74,0,1,0,1,0
11962,2222,0,0,66,66,0,1,0,1,0
1255,509,0,0,62,62,0,1,0,1,0
5155,1017,0,0,65,65,0,1,0,1,0
12843,1147,0,0,109,109,0,1,0,1,0
3021,1472,0,0,65,65,0,1,0,1,0
2212,7,0,0,60,60,0,1,0,1,0
13807,1880,0,0,64,64,0,1,0,1,0
14580,1201,0,0,62,62,0,1,0,1,0
16951,255,0,0,62,62,0,1,0,1,0
17525,2613,0,0,63,63,0,1,0,1,0
1980,1771,0,0,146,146,0,1,0,1,0
15459,1422,0,0,65,65,0,1,0,1,0
7509,218,0,0,60,60,0,1,0,1,0
2562,1153,0,0,64,64,0,1,0,1,0
1894,2256,0,0,64,64,0,1,0,1,0
666,1147,0,0,63,63,0,1,0,1,0
11276,1215,0,0,62,62,0,1,0,1,0
257,509,0,0,104,104,0,1,0,1,0
763,1888,0,0,62,62,0,1,0,1,0
16951,255,0,0,62,62,0,1,0,1,0
751,2466,0,0,149,149,0,1,0,1,0
15882,3051,0,0,63,63,0,1,0,1,0
446,1880,0,0,62,62,0,1,0,1,0
19990,2560,0,0,62,62,0,1,0,1,0
11530,2256,0,0,64,64,0,1,0,1,0
19,3216,0,0,62,62,0,1,0,1,0
3973,1549,0,0,63,63,0,1,0,1,0
20243,1703,0,0,66,66,0,1,0,1,0
371,1147,0,0,62,62,0,1,0,1,0
3047,1801,0,0,66,66,0,1,0,1,0
1965,1888,0,0,62,62,0,1,0,1,0
2584,1677,0,0,160,160,0,1,0,1,0
6181,3028,0,0,68,68,0,1,0,1,0
638,408,0,0,143,143,0,1,0,1,0
16988,1824,0,0,69,69,0,1,0,1,0
1777,2883,0,0,64,64,0,1,0,1,0
6237,2938,0,0,67,67,0,1,0,1,0
1403,1771,0,0,66,66,0,1,0,1,0
7335,1070,0,0,60,60,0,1,0,1,0
1858,2938,0,0,62,62,0,1,0,1,0
1330,918,0,0,62,62,0,1,0,1,0
2560,1042,0,0,151,151,0,1,0,1,0
5282,1530,0,0,146,146,0,1,0,1,0
16951,255,0,0,62,62,0,1,0,1,0
13767,326,0,0,66,66,0,1,0,1,0
3147,2587,0,0,62,62,0,1,0,1,0
19260,3216,0,0,62,62,0,1,0,1,0
2495,1472,0,0,61,61,0,1,0,1,0
7002,1215,0,0,62,62,0,1,0,1,0
1505,2670,0,0,128,128,0,1,0,1,0
11923,3216,0,0,62,62,0,1,0,1,0
20542,1147,0,0,64,64,0,1,0,1,0
2584,1677,0,0,160,160,0,1,0,1,0
680,3216,0,0,66,66,0,1,0,1,0
15,1773,0,0,132,132,0,1,0,1,0
11069,269,0,0,60,60,0,1,0,1,0
8164,2725,0,0,60,60,0,1,0,1,0
6380,2558,0,0,62,62,0,1,0,1,0
16951,255,0,0,62,62,0,1,0,1,0
2958,7,0,0,60,60,0,1,0,1,0
7335,1070,0,0,60,60,0,1,0,1,0
21877,1515,0,0,66,66,0,1,0,1,0
10849,265,0,0,62,62,0,1,0,1,0
142,2486,0,0,63,63,0,1,0,1,0
1804,927,0,0,60,60,0,1,0,1,0
1358,1470,0,0,62,62,0,1,0,1,0
13791,509,0,0,66,66,0,1,0,1,0
5903,1147,0,0,62,62,0,1,0,1,0
3223,383,0,0,66,66,0,1,0,1,0
12320,2256,0,0,65,65,0,1,0,1,0
1618,2883,0,0,62,62,0,1,0,1,0
636,280,0,0,146,146,0,1,0,1,0
10836,1472,0,0,66,66,0,1,0,1,0
8115,2562,0,0,62,62,0,1,0,1,0
360,3105,0,0,66,66,0,1,0,1,0
15450,1472,0,0,65,65,0,1,0,1,0
20698,2593,0,0,64,64,0,1,0,1,0
5047,2631,0,0,62,62,0,1,0,1,0
22200,2573,0,0,66,66,0,1,0,1,0
11951,3216,0,0,66,66,0,1,0,1,0
7334,2256,0,0,79,79,0,1,0,1,0
1525,1444,0,0,145,145,0,1,0,1,0
10070,1017,0,0,64,64,0,1,0,1,0
17020,1805,0,0,67,67,0,1,0,1,0
15021,509,0,0,66,66,0,1,0,1,0
5548,1050,0,0,146,146,0,1,0,1,0
2323,2603,0,0,62,62,0,1,0,1,0
16951,255,0,0,62,62,0,1,0,1,0
13018,1809,0,0,63,63,0,1,0,1,0
13843,2521,0,0,66,66,0,1,0,1,0
5518,2874,0,0,119,119,0,1,0,1,0
1998,191,0,0,60,60,0,1,0,1,0
16844,2938,0,0,66,66,0,1,0,1,0
7908,1147,0,0,146,146,0,1,0,1,0
1727,1017,0,0,62,62,0,1,0,1,0
456,207,0,0,910,910,0,1,0,1,0
2596,1771,0,0,62,62,0,1,0,1,0
16951,255,0,0,62,62,0,1,0,1,0
2084,1471,0,0,145,145,0,1,0,1,0
3400,1888,0,0,62,62,0,1,0,1,0
2802,1888,0,0,66,66,0,1,0,1,0
12347,1,0,0,66,66,0,1,0,1,0
22383,2599,0,0,62,62,0,1,0,1,0
17618,2573,0,0,73,73,0,1,0,1,0
4073,5,0,0,76,76,0,1,0,1,0
3160,2938,0,0,126,126,0,1,0,1,0
12,1976,0,0,74,74,0,1,0,1,0
3181,1771,0,0,64,64,0,1,0,1,0
8660,509,0,0,66,66,0,1,0,1,0
1401,2938,0,0,62,62,0,1,0,1,0
16079,1782,0,0,65,65,0,1,0,1,0
4867,456,0,0,146,146,0,1,0,1,0
14122,1147,0,0,62,62,0,1,0,1,0
15229,2473,0,0,62,62,0,1,0,1,0
93,1017,0,0,64,64,0,1,0,1,0
16653,2593,0,0,66,66,0,1,0,1,0
10626,2628,0,0,62,62,0,1,0,1,0
13649,1147,0,0,65,65,0,1,0,1,0
1330,697,0,0,62,62,0,1,0,1,0
15163,1124,0,0,66,66,0,1,0,1,0
19486,1888,0,0,66,66,0,1,0,1,0
16951,255,0,0,62,62,0,1,0,1,0
4420,1147,0,0,66,66,0,1,0,1,0
11755,1794,0,0,66,66,0,1,0,1,0
11916,3216,0,0,143,143,0,1,0,1,0
6556,2587,0,0,63,63,0,1,0,1,0
16951,255,0,0,62,62,0,1,0,1,0
7336,2256,0,0,62,62,0,1,0,1,0
11458,2608,0,0,73,73,0,1,0,1,0
16659,2587,0,0,62,62,0,1,0,1,0
797,181,0,0,62,62,0,1,0,1,0
6777,424,0,0,128,128,0,1,0,1,0
24,3216,0,0,62,62,0,1,0,1,0
2960,7,0,0,60,60,0,1,0,1,0
16951,255,0,0,62,62,0,1,0,1,0
18,2261,0,0,145,145,0,1,0,1,0
1584,2883,0,0,62,62,0,1,0,1,0
16112,2611,0,0,62,62,0,1,0,1,0
20353,2256,0,0,72,72,0,1,0,1,0
2615,1899,0,0,65,65,0,1,0,1,0
1286,1771,0,0,64,64,0,1,0,1,0
447,1783,0,0,66,66,0,1,0,1,0
3159,1472,0,0,62,62,0,1,0,1,0
16287,3216,0,0,65,65,0,1,0,1,0
450,126,0,0,136,136,0,1,0,1,0
346,3117,0,0,65,65,0,1,0,1,0
1812,1149,0,0,65,65,0,1,0,1,0
13576,3215,0,0,66,66,0,1,0,1,0
32,2439,0,0,145,145,0,1,0,1,0
504,3201,0,0,145,145,0,1,0,1,0
0,0,0,0,75,75,0,1,0,1,0
11628,1849,0,0,62,62,0,1,0,1,0
12574,3160,0,0,63,63,0,1,0,1,0
6676,2945,0,0,99,99,0,1,0,1,0
10346,678,0,0,100,100,0,1,0,1,0
414,3188,0,0,65,65,0,1,0,1,0
11461,2611,0,0,74,74,0,1,0,1,0
4488,2144,0,0,62,62,0,1,0,1,0
9290,1765,0,0,75,75,0,1,0,1,0
351,797,0,0,64,64,0,1,0,1,0
1411,1027,0,0,146,146,0,1,0,1,0
19312,2587,0,0,63,63,0,1,0,1,0
20333,1147,0,0,62,62,0,1,0,1,0
750,2472,0,0,148,148,0,1,0,1,0
3112,2887,0,0,65,65,0,1,0,1,0
16951,255,0,0,62,62,0,1,0,1,0
2443,2587,0,0,62,62,0,1,0,1,0
17146,747,0,0,66,66,0,1,0,1,0
10608,2593,0,0,66,66,0,1,0,1,0
7335,1070,0,0,60,60,0,1,0,1,0
20335,1147,0,0,62,62,0,1,0,1,0
18197,1888,0,0,66,66,0,1,0,1,0
17765,2382,0,0,66,66,0,1,0,1,0
1525,1444,0,0,145,145,0,1,0,1,0
17957,2256,0,0,66,66,0,1,0,1,0
7344,2636,0,0,62,62,0,1,0,1,0
16659,1801,0,0,66,66,0,1,0,1,0
475,154,0,0,66,66,0,1,0,1,0
19900,1017,0,0,66,66,0,1,0,1,0
698,674,0,0,154,154,0,1,0,1,0
632,2154,0,0,62,62,0,1,0,1,0
10457,1017,0,0,64,64,0,1,0,1,0
1758,2256,0,0,66,66,0,1,0,1,0
594,12,0,0,60,60,0,1,0,1,0
7326,180,0,0,60,60,0,1,0,1,0
7064,2587,0,0,100,100,0,1,0,1,0
17441,1147,0,0,65,65,0,1,0,1,0
5246,1147,0,0,62,62,0,1,0,1,0
16951,255,0,0,62,62,0,1,0,1,0
2605,1147,0,0,62,62,0,1,0,1,0
480,1888,0,0,66,66,0,1,0,1,0
20344,983,0,0,66,66,0,1,0,1,0
16418,1162,0,0,62,62,0,1,0,1,0
15007,1482,0,0,66,66,0,1,0,1,0
19614,1771,0,0,66,66,0,1,0,1,0
2701,1017,0,0,146,146,0,1,0,1,0
20063,2937,0,0,69,69,0,1,0,1,0
8980,1147,0,0,62,62,0,1,0,1,0
3584,2520,0,0,117,117,0,1,0,1,0
3828,1017,0,0,114,114,0,1,0,1,0
3807,2610,0,0,60,60,0,1,0,1,0
1922,1518,0,0,62,62,0,1,0,1,0
463,1887,0,0,65,65,0,1,0,1,0
9709,1017,0,0,62,62,0,1,0,1,0
15041,100,0,0,60,60,0,1,0,1,0
1748,2582,0,0,62,62,0,1,0,1,0
5040,2636,0,0,66,66,0,1,0,1,0
11994,1147,0,0,64,64,0,1,0,1,0
7580,1804,0,0,62,62,0,1,0,1,0
4498,2634,0,0,62,62,0,1,0,1,0
2281,1086,0,0,64,64,0,1,0,1,0
5419,998,0,0,65,65,0,1,0,1,0
16951,255,0,0,62,62,0,1,0,1,0
360,3105,0,0,1068,1068,0,1,0,1,0
16951,255,0,0,62,62,0,1,0,1,0
2518,2504,0,0,61,61,0,1,0,1,0
21551,3216,0,0,94,94,0,1,0,1,0
17435,363,0,0,66,66,0,1,0,1,0
19346,915,0,0,64,64,0,1,0,1,0
21588,2938,0,0,74,74,0,1,0,1,0
10271,2883,0,0,65,65,0,1,0,1,0
18377,2938,0,0,74,74,0,1,0,1,0
5412,1888,0,0,66,66,0,1,0,1,0
6651,706,0,0,72,72,0,1,0,1,0
12817,1469,0,0,66,66,0,1,0,1,0
12296,2256,0,0,66,66,0,1,0,1,0
8164,2727,0,0,60,60,0,1,0,1,0
7509,218,0,0,60,60,0,1,0,1,0
11733,2928,0,0,132,132,0,1,0,1,0
18267,9,0,0,85,85,0,1,0,1,0
21065,2610,0,0,62,62,0,1,0,1,0
19777,1017,0,0,66,66,0,1,0,1,0
1780,2581,0,0,62,62,0,1,0,1,0
22468,201,0,0,78,78,0,1,0,1,0
0,0,0,0,98,98,0,1,0,1,0
20838,1880,0,0,62,62,0,1,0,1,0
2281,1017,0,0,66,66,0,1,0,1,0
3221,1017,0,0,64,64,0,1,0,1,0
3072,667,0,0,85,85,0,1,0,1,0
2973,2636,0,0,62,62,0,1,0,1,0
2149,109,0,0,60,60,0,1,0,1,0
16951,255,0,0,62,62,0,1,0,1,0
1215,2938,0,0,62,62,0,1,0,1,0
2664,2256,0,0,66,66,0,1,0,1,0
2606,2883,0,0,64,64,0,1,0,1,0
20399,2256,0,0,64,64,0,1,0,1,0
7561,177,0,0,60,60,0,1,0,1,0
7339,140,0,0,60,60,0,1,0,1,0
2419,1771,0,0,62,62,0,1,0,1,0
10264,3216,0,0,66,66,0,1,0,1,0
2525,2636,0,0,63,63,0,1,0,1,0
10287,2883,0,0,66,66,0,1,0,1,0
7740,2251,0,0,65,65,0,1,0,1,0
21978,1547,0,0,66,66,0,1,0,1,0
16827,509,0,0,66,66,0,1,0,1,0
16779,767,0,0,66,66,0,1,0,1,0
1607,2604,0,0,64,64,0,1,0,1,0
3256,2583,0,0,145,145,0,1,0,1,0
11639,1796,0,0,62,62,0,1,0,1,0
3691,983,0,0,62,62,0,1,0,1,0
296,5,0,0,60,60,0,1,0,1,0
18,3216,0,0,62,62,0,1,0,1,0
1695,1215,0,0,62,62,0,1,0,1,0
18949,2509,0,0,66,66,0,1,0,1,0
3853,1539,0,0,62,62,0,1,0,1,0
3982,1002,0,0,62,62,0,1,0,1,0
22137,1215,0,0,62,62,0,1,0,1,0
16951,255,0,0,62,62,0,1,0,1,0
16951,255,0,0,62,62,0,1,0,1,0
2084,1471,0,0,145,145,0,1,0,1,0
13168,1215,0,0,63,63,0,1,0,1,0
9316,1085,0,0,63,63,0,1,0,1,0
16545,2255,0,0,62,62,0,1,0,1,0
6723,2587,0,0,62,62,0,1,0,1,0
11667,3216,0,0,63,63,0,1,0,1,0
18271,9,0,0,86,86,0,1,0,1,0
1277,1147,0,0,146,146,0,1,0,1,0
20268,2936,0,0,62,62,0,1,0,1,0
17895,2248,0,0,66,66,0,1,0,1,0
12,1380,0,0,82,82,0,1,0,1,0
16951,255,0,0,62,62,0,1,0,1,0
389,2636,0,0,66,66,0,1,0,1,0
3162,2359,0,0,99,99,0,1,0,1,0
13552,3051,0,0,62,62,0,1,0,1,0
633,1888,0,0,62,62,0,1,0,1,0
1717,2636,0,0,66,66,0,1,0,1,0
13443,1888,0,0,66,66,0,1,0,1,0
15786,2600,0,0,65,65,0,1,0,1,0
16951,255,0,0,62,62,0,1,0,1,0
1695,3010,0,0,63,63,0,1,0,1,0
499,187,0,0,345,345,0,1,0,1,0
1462,147,0,0,60,60,0,1,0,1,0
19,3150,0,0,133,133,0,1,0,1,0
2303,146,0,0,60,60,0,1,0,1,0
20675,2721,0,0,67,67,0,1,0,1,0
17740,1888,0,0,62,62,0,1,0,1,0
16951,255,0,0,62,62,0,1,0,1,0
15694,1787,0,0,145,145,0,1,0,1,0
11,204,0,0,320,320,0,1,0,1,0
20785,1215,0,0,66,66,0,1,0,1,0
21136,1803,0,0,66,66,0,1,0,1,0
2061,3216,0,0,62,62,0,1,0,1,0
16063,2256,0,0,63,63,0,1,0,1,0
12586,1147,0,0,62,62,0,1,0,1,0
6233,1646,0,0,60,60,0,1,0,1,0
17329,1771,0,0,64,64,0,1,0,1,0
3124,3216,0,0,62,62,0,1,0,1,0
652,144,0,0,133,133,0,1,0,1,0
11986,1139,0,0,66,66,0,1,0,1,0
6092,1147,0,0,62,62,0,1,0,1,0
11086,509,0,0,62,62,0,1,0,1,0
432,1771,0,0,62,62,0,1,0,1,0
755,7,0,0,60,60,0,1,0,1,0
8,2758,0,0,60,60,0,1,0,1,0
5202,3168,0,0,130,130,0,1,0,1,0
16951,255,0,0,62,62,0,1,0,1,0
1014,2938,0,0,62,62,0,1,0,1,0
5294,1147,0,0,102,102,0,1,0,1,0
11678,1106,0,0,66,66,0,1,0,1,0
21198,2256,0,0,62,62,0,1,0,1,0
1804,3208,0,0,60,60,0,1,0,1,0
7902,1147,0,0,62,62,0,1,0,1,0
2155,2636,0,0,62,62,0,1,0,1,0
104,1017,0,0,62,62,0,1,0,1,0
16951,255,0,0,62,62,0,1,0,1,0
1422,471,0,0,70,70,0,1,0,1,0
1747,2580,0,0,62,62,0,1,0,1,0
677,1017,0,0,62,62,0,1,0,1,0
22491,2595,0,0,70,70,0,1,0,1,0
3113,697,0,0,108,108,0,1,0,1,0
2094,1471,0,0,145,145,0,1,0,1,0
17324,509,0,0,66,66,0,1,0,1,0
2363,1147,0,0,64,64,0,1,0,1,0
9439,1017,0,0,62,62,0,1,0,1,0
17314,3212,0,0,66,66,0,1,0,1,0
12320,2256,0,0,65,65,0,1,0,1,0
15,1019,0,0,131,131,0,1,0,1,0
17618,2575,0,0,72,72,0,1,0,1,0
16448,1017,0,0,66,66,0,1,0,1,0
7460,1771,0,0,66,66,0,1,0,1,0
20751,10,0,0,73,73,0,1,0,1,0
20375,3139,0,0,66,66,0,1,0,1,0
2726,1215,0,0,62,62,0,1,0,1,0
6729,2256,0,0,63,63,0,1,0,1,0
2515,2938,0,0,62,62,0,1,0,1,0
6231,1147,0,0,64,64,0,1,0,1,0
1777,2592,0,0,64,64,0,1,0,1,0
18200,1472,0,0,63,63,0,1,0,1,0
7711,1,0,0,61,61,0,1,0,1,0
8958,1147,0,0,66,66,0,1,0,1,0
12,2199,0,0,97,97,0,1,0,1,0
9580,1162,0,0,66,66,0,1,0,1,0
14,2762,0,0,60,60,0,1,0,1,0
16951,255,0,0,62,62,0,1,0,1,0
3071,1888,0,0,65,65,0,1,0,1,0
1447,3188,0,0,64,64,0,1,0,1,0
6761,5,0,0,60,60,0,1,0,1,0
15213,1093,0,0,66,66,0,1,0,1,0
18615,2611,0,0,62,62,0,1,0,1,0
8164,2726,0,0,60,60,0,1,0,1,0
7539,2593,0,0,65,65,0,1,0,1,0
10891,2542,0,0,113,113,0,1,0,1,0
10584,2256,0,0,95,95,0,1,0,1,0
9111,2938,0,0,64,64,0,1,0,1,0
18832,1888,0,0,65,65,0,1,0,1,0
18321,1472,0,0,65,65,0,1,0,1,0
10491,1147,0,0,146,146,0,1,0,1,0
4556,2256,0,0,66,66,0,1,0,1,0
10792,2627,0,0,79,79,0,1,0,1,0
11055,1193,0,0,61,61,0,1,0,1,0
11625,1981,0,0,121,121,0,1,0,1,0
11345,1215,0,0,63,63,0,1,0,1,0
15179,797,0,0,66,66,0,1,0,1,0
14722,1888,0,0,66,66,0,1,0,1,0
16804,794,0,0,66,66,0,1,0,1,0
16951,255,0,0,62,62,0,1,0,1,0
16891,983,0,0,66,66,0,1,0,1,0
2658,1147,0,0,64,64,0,1,0,1,0
2478,2587,0,0,146,146,0,1,0,1,0
8171,1073,0,0,60,60,0,1,0,1,0
3258,2590,0,0,146,146,0,1,0,1,0
12074,1189,0,0,62,62,0,1,0,1,0
239,1888,0,0,62,62,0,1,0,1,0
11984,2153,0,0,66,66,0,1,0,1,0
3058,3262,0,0,60,60,0,1,0,1,0
303,1888,0,0,62,62,0,1,0,1,0
7335,1070,0,0,60,60,0,1,0,1,0
21772,399,0,0,62,62,0,1,0,1,0
9445,973,0,0,84,84,0,1,0,1,0
6993,3216,0,0,62,62,0,1,0,1,0
10395,3216,0,0,66,66,0,1,0,1,0
15446,983,0,0,71,71,0,1,0,1,0
19318,3212,0,0,66,66,0,1,0,1,0
15586,2616,0,0,66,66,0,1,0,1,0
18533,2938,0,0,62,62,0,1,0,1,0
18397,2938,0,0,68,68,0,1,0,1,0
3876,1923,0,0,62,62,0,1,0,1,0
6651,1129,0,0,156,156,0,1,0,1,0
17692,1147,0,0,66,66,0,1,0,1,0
2435,7,0,0,60,60,0,1,0,1,0
7557,1101,0,0,64,64,0,1,0,1,0
10610,2597,0,0,66,66,0,1,0,1,0
2137,1211,0,0,65,65,0,1,0,1,0
11054,1147,0,0,64,64,0,1,0,1,0
541,1804,0,0,64,64,0,1,0,1,0
258,285,0,0,65,65,0,1,0,1,0
3200,1147,0,0,62,62,0,1,0,1,0
16478,247,0,0,60,60,0,1,0,1,0
418,1771,0,0,66,66,0,1,0,1,0
14808,1017,0,0,66,66,0,1,0,1,0
18376,2929,0,0,72,72,0,1,0,1,0
6567,2,0,0,61,61,0,1,0,1,0
7339,152,0,0,60,60,0,1,0,1,0
1240,2587,0,0,146,146,0,1,0,1,0
1869,2863,0,0,66,66,0,1,0,1,0
1615,155,0,0,62,62,0,1,0,1,0
1814,1153,0,0,66,66,0,1,0,1,0
1735,2860,0,0,145,145,0,1,0,1,0
789,2378,0,0,62,62,0,1,0,1,0
19885,2587,0,0,66,66,0,1,0,1,0
14948,2256,0,0,63,63,0,1,0,1,0
3069,1215,0,0,62,62,0,1,0,1,0
2458,570,0,0,69,69,0,1,0,1,0
20006,1215,0,0,65,65,0,1,0,1,0
10419,2611,0,0,72,72,0,1,0,1,0
735,7,0,0,60,60,0,1,0,1,0
12809,2836,0,0,66,66,0,1,0,1,0
13605,3026,0,0,68,68,0,1,0,1,0
16628,1889,0,0,66,66,0,1,0,1,0
19586,2256,0,0,64,64,0,1,0,1,0
15381,467,0,0,62,62,0,1,0,1,0
18,3216,0,0,62,62,0,1,0,1,0
11668,1789,0,0,62,62,0,1,0,1,0
10172,2587,0,0,66,66,0,1,0,1,0
4337,84,0,0,61,61,0,1,0,1,0
11308,2256,0,0,65,65,0,1,0,1,0
16444,2881,0,0,90,90,0,1,0,1,0
16951,255,0,0,62,62,0,1,0,1,0
12085,1149,0,0,62,62,0,1,0,1,0
1688,2256,0,0,65,65,0,1,0,1,0
16951,255,0,0,62,62,0,1,0,1,0
8276,2023,0,0,161,161,0,1,0,1,0
186,2486,0,0,66,66,0,1,0,1,0
818,3257,0,0,149,149,0,1,0,1,0
11573,1472,0,0,66,66,0,1,0,1,0
16187,1382,0,0,60,60,0,1,0,1,0
750,1017,0,0,66,66,0,1,0,1,0
21276,1147,0,0,62,62,0,1,0,1,0
16951,255,0,0,62,62,0,1,0,1,0
13244,1797,0,0,66,66,0,1,0,1,0
17,1724,0,0,64,64,0,1,0,1,0
1133,2938,0,0,78,78,0,1,0,1,0
10665,1172,0,0,64,64,0,1,0,1,0
3174,2611,0,0,62,62,0,1,0,1,0
22289,2256,0,0,66,66,0,1,0,1,0
11679,1127,0,0,66,66,0,1,0,1,0
10723,2926,0,0,65,65,0,1,0,1,0
15614,1471,0,0,134,134,0,1,0,1,0
11910,2904,0,0,69,69,0,1,0,1,0
13444,1877,0,0,66,66,0,1,0,1,0
636,1792,0,0,62,62,0,1,0,1,0
3001,357,0,0,62,62,0,1,0,1,0
16951,255,0,0,62,62,0,1,0,1,0
3379,2587,0,0,62,62,0,1,0,1,0
1320,797,0,0,62,62,0,1,0,1,0
2571,357,0,0,62,62,0,1,0,1,0
7273,1888,0,0,62,62,0,1,0,1,0
2071,1888,0,0,62,62,0,1,0,1,0
136,1017,0,0,62,62,0,1,0,1,0
2420,1215,0,0,62,62,0,1,0,1,0
3212,509,0,0,146,146,0,1,0,1,0
1671,1147,0,0,146,146,0,1,0,1,0
19168,1765,0,0,63,63,0,1,0,1,0
10475,6,0,0,60,60,0,1,0,1,0
11158,1880,0,0,65,65,0,1,0,1,0
0,0,0,0,99,99,0,1,0,1,0
12,2358,0,0,331,331,0,1,0,1,0
19104,1888,0,0,66,66,0,1,0,1,0
3247,2411,0,0,63,63,0,1,0,1,0
4954,2618,0,0,63,63,0,1,0,1,0
29,1888,0,0,62,62,0,1,0,1,0
3638,2610,0,0,62,62,0,1,0,1,0
16951,255,0,0,62,62,0,1,0,1,0
230,1147,0,0,146,146,0,1,0,1,0
9590,2863,0,0,62,62,0,1,0,1,0
9412,1771,0,0,65,65,0,1,0,1,0
5896,3027,0,0,62,62,0,1,0,1,0
17568,2245,0,0,66,66,0,1,0,1,0
17898,2883,0,0,66,66,0,1,0,1,0
21656,2897,0,0,69,69,0,1,0,1,0
2946,2608,0,0,146,146,0,1,0,1,0
16029,2887,0,0,66,66,0,1,0,1,0
10683,2596,0,0,66,66,0,1,0,1,0
2497,2589,0,0,146,146,0,1,0,1,0
2517,192,0,0,60,60,0,1,0,1,0
13710,2235,0,0,62,62,0,1,0,1,0
3045,2256,0,0,65,65,0,1,0,1,0
2376,2934,0,0,145,145,0,1,0,1,0
17359,2938,0,0,62,62,0,1,0,1,0
8422,2256,0,0,66,66,0,1,0,1,0
20960,1472,0,0,62,62,0,1,0,1,0
17597,2636,0,0,64,64,0,1,0,1,0
10952,2256,0,0,66,66,0,1,0,1,0
16951,255,0,0,62,62,0,1,0,1,0
1316,2587,0,0,62,62,0,1,0,1,0
13112,1047,0,0,65,65,0,1,0,1,0
1777,1880,0,0,63,63,0,1,0,1,0
10692,2612,0,0,66,66,0,1,0,1,0
7753,1733,0,0,145,145,0,1,0,1,0
16863,2587,0,0,76,76,0,1,0,1,0
2597,104,0,0,60,60,0,1,0,1,0
2296,452,0,0,66,66,0,1,0,1,0
13968,2256,0,0,66,66,0,1,0,1,0
1142,1215,0,0,62,62,0,1,0,1,0
15069,2897,0,0,146,146,0,1,0,1,0
13075,1017,0,0,63,63,0,1,0,1,0
3109,2371,0,0,61,61,0,1,0,1,0
20774,2941,0,0,62,62,0,1,0,1,0
1386,2883,0,0,63,63,0,1,0,1,0
16951,255,0,0,62,62,0,1,0,1,0
16849,1936,0,0,66,66,0,1,0,1,0
4623,2256,0,0,64,64,0,1,0,1,0
3107,2606,0,0,71,71,0,1,0,1,0
19372,2592,0,0,63,63,0,1,0,1,0
10328,727,0,0,86,86,0,1,0,1,0
3175,1147,0,0,76,76,0,1,0,1,0
17324,194,0,0,63,63,0,1,0,1,0
5182,1017,0,0,66,66,0,1,0,1,0
19502,3212,0,0,62,62,0,1,0,1,0
18408,1802,0,0,65,65,0,1,0,1,0
14,2379,0,0,62,62,0,1,0,1,0
3953,2144,0,0,62,62,0,1,0,1,0
797,2645,0,0,83,83,0,1,0,1,0
18515,2938,0,0,62,62,0,1,0,1,0
2499,2587,0,0,146,146,0,1,0,1,0
612,13,0,0,60,60,0,1,0,1,0
6233,1646,0,0,60,60,0,1,0,1,0
8748,573,0,0,66,66,0,1,0,1,0
1743,6,0,0,60,60,0,1,0,1,0
16951,255,0,0,62,62,0,1,0,1,0
5008,6,0,0,60,60,0,1,0,1,0
2787,1147,0,0,62,62,0,1,0,1,0
15726,1520,0,0,127,127,0,1,0,1,0
5221,1147,0,0,62,62,0,1,0,1,0
7036,1215,0,0,62,62,0,1,0,1,0
17945,2256,0,0,66,66,0,1,0,1,0
4844,1184,0,0,66,66,0,1,0,1,0
1686,546,0,0,66,66,0,1,0,1,0
20902,1842,0,0,66,66,0,1,0,1,0
1852,6,0,0,60,60,0,1,0,1,0
517,7,0,0,60,60,0,1,0,1,0
3001,357,0,0,62,62,0,1,0,1,0
9429,2509,0,0,65,65,0,1,0,1,0
670,1017,0,0,62,62,0,1,0,1,0
16558,1017,0,0,65,65,0,1,0,1,0
3029,2602,0,0,147,147,0,1,0,1,0
1234,985,0,0,146,146,0,1,0,1,0
10475,6,0,0,60,60,0,1,0,1,0
10575,1774,0,0,66,66,0,1,0,1,0
8811,1191,0,0,66,66,0,1,0,1,0
4831,648,0,0,63,63,0,1,0,1,0
2098,23,0,0,60,60,0,1,0,1,0
19062,1888,0,0,62,62,0,1,0,1,0
12,871,0,0,67,67,0,1,0,1,0
8171,1073,0,0,60,60,0,1,0,1,0
16951,255,0,0,62,62,0,1,0,1,0
14505,2312,0,0,78,78,0,1,0,1,0
915,1825,0,0,64,64,0,1,0,1,0
12185,1880,0,0,65,65,0,1,0,1,0
2295,1472,0,0,65,65,0,1,0,1,0
2406,2491,0,0,159,159,0,1,0,1,0
9153,1888,0,0,66,66,0,1,0,1,0
7298,1150,0,0,62,62,0,1,0,1,0
851,464,0,0,60,60,0,1,0,1,0
2152,7,0,0,60,60,0,1,0,1,0
14389,1822,0,0,62,62,0,1,0,1,0
16951,255,0,0,62,62,0,1,0,1,0
18713,1786,0,0,63,63,0,1,0,1,0
6967,1539,0,0,136,136,0,1,0,1,0
15970,733,0,0,62,62,0,1,0,1,0
728,2587,0,0,62,62,0,1,0,1,0
3934,1861,0,0,66,66,0,1,0,1,0
10645,1880,0,0,66,66,0,1,0,1,0
2296,1017,0,0,64,64,0,1,0,1,0
20004,1147,0,0,64,64,0,1,0,1,0
2595,5,0,0,60,60,0,1,0,1,0
15859,2607,0,0,66,66,0,1,0,1,0
20411,1215,0,0,62,62,0,1,0,1,0
8475,1017,0,0,64,64,0,1,0,1,0
9214,3256,0,0,60,60,0,1,0,1,0
11029,1888,0,0,62,62,0,1,0,1,0
16951,255,0,0,62,62,0,1,0,1,0
10486,1171,0,0,69,69,0,1,0,1,0
13815,2256,0,0,64,64,0,1,0,1,0
11264,2608,0,0,80,80,0,1,0,1,0
22,2256,0,0,62,62,0,1,0,1,0
1042,2883,0,0,66,66,0,1,0,1,0
12086,1147,0,0,64,64,0,1,0,1,0
4761,1467,0,0,145,145,0,1,0,1,0
2097,375,0,0,60,60,0,1,0,1,0
1833,296,0,0,61,61,0,1,0,1,0
489,2574,0,0,62,62,0,1,0,1,0
18873,1147,0,0,66,66,0,1,0,1,0
22570,2932,0,0,66,66,0,1,0,1,0
5243,2304,0,0,64,64,0,1,0,1,0
19821,2811,0,0,61,61,0,1,0,1,0
154,3216,0,0,66,66,0,1,0,1,0
2186,989,0,0,129,129,0,1,0,1,0
8010,323,0,0,60,60,0,1,0,1,0
17372,2953,0,0,66,66,0,1,0,1,0
3738,1818,0,0,64,64,0,1,0,1,0
19169,1017,0,0,66,66,0,1,0,1,0
18566,1027,0,0,66,66,0,1,0,1,0
1888,2256,0,0,65,65,0,1,0,1,0
5989,1147,0,0,65,65,0,1,0,1,0
10370,1888,0,0,65,65,0,1,0,1,0
636,1792,0,0,62,62,0,1,0,1,0
8410,2621,0,0,64,64,0,1,0,1,0
21341,1086,0,0,63,63,0,1,0,1,0
612,183,0,0,60,60,0,1,0,1,0
16951,255,0,0,62,62,0,1,0,1,0
22066,311,0,0,62,62,0,1,0,1,0
1653,252,0,0,62,62,0,1,0,1,0
3842,2610,0,0,61,61,0,1,0,1,0
22079,1853,0,0,62,62,0,1,0,1,0
5218,1017,0,0,63,63,0,1,0,1,0
9226,3216,0,0,66,66,0,1,0,1,0
5411,2576,0,0,146,146,0,1,0,1,0
2408,3216,0,0,62,62,0,1,0,1,0
10475,2587,0,0,64,64,0,1,0,1,0
5249,2322,0,0,62,62,0,1,0,1,0
8807,1196,0,0,66,66,0,1,0,1,0
16989,847,0,0,66,66,0,1,0,1,0
3598,1147,0,0,62,62,0,1,0,1,0
16044,2256,0,0,66,66,0,1,0,1,0
7888,1384,0,0,62,62,0,1,0,1,0
13065,1798,0,0,62,62,0,1,0,1,0
17244,1884,0,0,66,66,0,1,0,1,0
13303,1147,0,0,65,65,0,1,0,1,0
2333,138,0,0,60,60,0,1,0,1,0
3097,1147,0,0,62,62,0,1,0,1,0
200,1020,0,0,62,62,0,1,0,1,0
16951,255,0,0,62,62,0,1,0,1,0
4096,1017,0,0,63,63,0,1,0,1,0
8745,2938,0,0,68,68,0,1,0,1,0
18614,2608,0,0,70,70,0,1,0,1,0
14838,2836,0,0,66,66,0,1,0,1,0
4319,1147,0,0,146,146,0,1,0,1,0
16321,3216,0,0,66,66,0,1,0,1,0
3134,2587,0,0,62,62,0,1,0,1,0
9387,2256,0,0,62,62,0,1,0,1,0
3017,3216,0,0,62,62,0,1,0,1,0
20522,509,0,0,70,70,0,1,0,1,0
1126,1215,0,0,62,62,0,1,0,1,0
2668,1017,0,0,65,65,0,1,0,1,0
11450,245,0,0,60,60,0,1,0,1,0
22572,2856,0,0,66,66,0,1,0,1,0
7084,2938,0,0,62,62,0,1,0,1,0
3150,1472,0,0,65,65,0,1,0,1,0
20260,2587,0,0,65,65,0,1,0,1,0
8755,2938,0,0,77,77,0,1,0,1,0
1804,1019,0,0,61,61,0,1,0,1,0
16951,255,0,0,62,62,0,1,0,1,0
1735,2084,0,0,97,97,0,1,0,1,0
20989,3212,0,0,66,66,0,1,0,1,0
22468,201,0,0,78,78,0,1,0,1,0
6708,1017,0,0,62,62,0,1,0,1,0
1894,1800,0,0,63,63,0,1,0,1,0
16951,255,0,0,62,62,0,1,0,1,0
37,2380,0,0,62,62,0,1,0,1,0
8,442,0,0,60,60,0,1,0,1,0
16951,255,0,0,62,62,0,1,0,1,0
14697,2636,0,0,113,113,0,1,0,1,0
2279,1147,0,0,62,62,0,1,0,1,0
3535,3139,0,0,65,65,0,1,0,1,0
11174,2521,0,0,62,62,0,1,0,1,0
5158,1017,0,0,66,66,0,1,0,1,0
21123,1147,0,0,66,66,0,1,0,1,0
14479,3139,0,0,62,62,0,1,0,1,0
10427,1017,0,0,66,66,0,1,0,1,0
1964,983,0,0,66,66,0,1,0,1,0
7335,1070,0,0,60,60,0,1,0,1,0
11677,2636,0,0,66,66,0,1,0,1,0
6072,2883,0,0,62,62,0,1,0,1,0
11861,482,0,0,64,64,0,1,0,1,0
20750,10,0,0,74,74,0,1,0,1,0
16261,1888,0,0,63,63,0,1,0,1,0
2960,1154,0,0,62,62,0,1,0,1,0
392,1888,0,0,63,63,0,1,0,1,0
19786,1147,0,0,117,117,0,1,0,1,0
20072,1882,0,0,62,62,0,1,0,1,0
18239,1017,0,0,66,66,0,1,0,1,0
3575,1017,0,0,146,146,0,1,0,1,0
333,3216,0,0,65,65,0,1,0,1,0
5186,1888,0,0,62,62,0,1,0,1,0
328,1017,0,0,65,65,0,1,0,1,0
491,2587,0,0,62,62,0,1,0,1,0
4367,1147,0,0,66,66,0,1,0,1,0
16910,2587,0,0,66,66,0,1,0,1,0
426,2587,0,0,62,62,0,1,0,1,0
1361,2256,0,0,61,61,0,1,0,1,0
2839,1147,0,0,62,62,0,1,0,1,0
19971,3142,0,0,62,62,0,1,0,1,0
20594,3216,0,0,66,66,0,1,0,1,0
1601,1772,0,0,62,62,0,1,0,1,0
7110,1147,0,0,122,122,0,1,0,1,0
17881,1166,0,0,62,62,0,1,0,1,0
8581,1017,0,0,65,65,0,1,0,1,0
15199,3216,0,0,62,62,0,1,0,1,0
9223,3223,0,0,64,64,0,1,0,1,0
15657,2636,0,0,65,65,0,1,0,1,0
2393,2256,0,0,62,62,0,1,0,1,0
16951,255,0,0,62,62,0,1,0,1,0
1237,1159,0,0,66,66,0,1,0,1,0
12,657,0,0,131,131,0,1,0,1,0
6395,1215,0,0,62,62,0,1,0,1,0
1460,1403,0,0,145,145,0,1,0,1,0
15410,1792,0,0,66,66,0,1,0,1,0
16951,255,0,0,62,62,0,1,0,1,0
10491,1147,0,0,146,146,0,1,0,1,0
16951,255,0,0,62,62,0,1,0,1,0
1804,326,0,0,60,60,0,1,0,1,0
9259,2604,0,0,63,63,0,1,0,1,0
17284,1436,0,0,64,64,0,1,0,1,0
2845,1888,0,0,66,66,0,1,0,1,0
17146,748,0,0,66,66,0,1,0,1,0
13542,885,0,0,62,62,0,1,0,1,0
13282,2387,0,0,66,66,0,1,0,1,0
16951,255,0,0,62,62,0,1,0,1,0
21128,1147,0,0,65,65,0,1,0,1,0
50,358,0,0,65,65,0,1,0,1,0
7741,2587,0,0,62,62,0,1,0,1,0
4079,1147,0,0,66,66,0,1,0,1,0
1672,3216,0,0,63,63,0,1,0,1,0
16284,1880,0,0,66,66,0,1,0,1,0
11878,2938,0,0,74,74,0,1,0,1,0
9579,3139,0,0,62,62,0,1,0,1,0
2660,1147,0,0,146,146,0,1,0,1,0
8581,1017,0,0,62,62,0,1,0,1,0
2362,1147,0,0,146,146,0,1,0,1,0
1427,2622,0,0,62,62,0,1,0,1,0
11274,2628,0,0,136,136,0,1,0,1,0
8114,2550,0,0,62,62,0,1,0,1,0
3386,1888,0,0,62,62,0,1,0,1,0
10123,1795,0,0,60,60,0,1,0,1,0
15655,1779,0,0,63,63,0,1,0,1,0
16478,223,0,0,60,60,0,1,0,1,0
9650,2684,0,0,130,130,0,1,0,1,0
13614,2592,0,0,64,64,0,1,0,1,0
12957,956,0,0,64,64,0,1,0,1,0
472,1888,0,0,66,66,0,1,0,1,0
2694,1888,0,0,62,62,0,1,0,1,0
18226,1017,0,0,66,66,0,1,0,1,0
16951,255,0,0,62,62,0,1,0,1,0
1464,1147,0,0,62,62,0,1,0,1,0
3782,1017,0,0,118,118,0,1,0,1,0
19,1773,0,0,62,62,0,1,0,1,0
20699,2697,0,0,78,78,0,1,0,1,0
11886,2256,0,0,66,66,0,1,0,1,0
1142,1215,0,0,62,62,0,1,0,1,0
18937,3216,0,0,67,67,0,1,0,1,0
20321,1147,0,0,107,107,0,1,0,1,0
10374,2235,0,0,66,66,0,1,0,1,0
7462,2187,0,0,68,68,0,1,0,1,0
18970,2533,0,0,98,98,0,1,0,1,0
8263,1147,0,0,66,66,0,1,0,1,0
9593,2864,0,0,62,62,0,1,0,1,0
3201,2938,0,0,60,60,0,1,0,1,0
3002,1936,0,0,62,62,0,1,0,1,0
21937,2897,0,0,63,63,0,1,0,1,0
8689,984,0,0,62,62,0,1,0,1,0
2097,3216,0,0,64,64,0,1,0,1,0
11939,2604,0,0,66,66,0,1,0,1,0
9931,2587,0,0,62,62,0,1,0,1,0
17,183,0,0,73,73,0,1,0,1,0
1931,1555,0,0,64,64,0,1,0,1,0
1804,768,0,0,60,60,0,1,0,1,0
2062,1034,0,0,63,63,0,1,0,1,0
335,1035,0,0,66,66,0,1,0,1,0
16951,255,0,0,62,62,0,1,0,1,0
11925,2604,0,0,66,66,0,1,0,1,0
2593,1017,0,0,146,146,0,1,0,1,0
3839,2890,0,0,66,66,0,1,0,1,0
20336,9,0,0,84,84,0,1,0,1,0
11174,1896,0,0,66,66,0,1,0,1,0
2682,3216,0,0,62,62,0,1,0,1,0
3041,7,0,0,60,60,0,1,0,1,0
21069,1147,0,0,62,62,0,1,0,1,0
21344,1082,0,0,66,66,0,1,0,1,0
11156,2722,0,0,66,66,0,1,0,1,0
17277,1447,0,0,62,62,0,1,0,1,0
1201,1017,0,0,146,146,0,1,0,1,0
2590,1804,0,0,66,66,0,1,0,1,0
18014,798,0,0,66,66,0,1,0,1,0
7346,1626,0,0,65,65,0,1,0,1,0
17639,1880,0,0,66,66,0,1,0,1,0
3093,1147,0,0,62,62,0,1,0,1,0
9273,6,0,0,60,60,0,1,0,1,0
18771,291,0,0,94,94,0,1,0,1,0
338,1147,0,0,64,64,0,1,0,1,0
7076,5,0,0,60,60,0,1,0,1,0
52,2609,0,0,145,145,0,1,0,1,0
1290,2587,0,0,62,62,0,1,0,1,0
1941,1020,0,0,62,62,0,1,0,1,0
16318,2587,0,0,66,66,0,1,0,1,0
2643,1214,0,0,62,62,0,1,0,1,0
3135,2587,0,0,62,62,0,1,0,1,0
13278,2256,0,0,65,65,0,1,0,1,0
12,207,0,0,216,216,0,1,0,1,0
17691,1888,0,0,62,62,0,1,0,1,0
13074,185,0,0,60,60,0,1,0,1,0
16702,1021,0,0,62,62,0,1,0,1,0
8198,1122,0,0,63,63,0,1,0,1,0
17119,2718,0,0,66,66,0,1,0,1,0
12354,2317,0,0,66,66,0,1,0,1,0
268,1054,0,0,64,64,0,1,0,1,0
323,2256,0,0,64,64,0,1,0,1,0
11011,1147,0,0,66,66,0,1,0,1,0
280,1520,0,0,66,66,0,1,0,1,0
769,7,0,0,60,60,0,1,0,1,0
4962,2636,0,0,86,86,0,1,0,1,0
21494,2629,0,0,62,62,0,1,0,1,0
3864,957,0,0,62,62,0,1,0,1,0
7326,180,0,0,60,60,0,1,0,1,0
5272,2256,0,0,66,66,0,1,0,1,0
157,1147,0,0,64,64,0,1,0,1,0
3069,2938,0,0,60,60,0,1,0,1,0
1552,1067,0,0,162,162,0,1,0,1,0
3013,3155,0,0,136,136,0,1,0,1,0
6889,1888,0,0,62,62,0,1,0,1,0
14904,2879,0,0,66,66,0,1,0,1,0
705,1017,0,0,62,62,0,1,0,1,0
588,2611,0,0,78,78,0,1,0,1,0
12,2453,0,0,95,95,0,1,0,1,0
18489,2938,0,0,62,62,0,1,0,1,0
16951,255,0,0,62,62,0,1,0,1,0
2398,7,0,0,60,60,0,1,0,1,0
1138,98,0,0,60,60,0,1,0,1,0
13301,3216,0,0,62,62,0,1,0,1,0
8795,1215,0,0,66,66,0,1,0,1,0
733,7,0,0,60,60,0,1,0,1,0
10767,3216,0,0,62,62,0,1,0,1,0
615,2252,0,0,66,66,0,1,0,1,0
1622,246,0,0,146,146,0,1,0,1,0
3757,1829,0,0,66,66,0,1,0,1,0
12,3140,0,0,199,199,0,1,0,1,0
6473,2929,0,0,62,62,0,1,0,1,0
2584,1677,0,0,160,160,0,1,0,1,0
6643,1215,0,0,62,62,0,1,0,1,0
19023,2215,0,0,66,66,0,1,0,1,0
21,2952,0,0,145,145,0,1,0,1,0
1691,2256,0,0,62,62,0,1,0,1,0
15602,2230,0,0,65,65,0,1,0,1,0
11761,1887,0,0,65,65,0,1,0,1,0
8665,509,0,0,62,62,0,1,0,1,0
21272,1872,0,0,63,63,0,1,0,1,0
16951,255,0,0,62,62,0,1,0,1,0
4088,1147,0,0,66,66,0,1,0,1,0
4485,2142,0,0,63,63,0,1,0,1,0
14500,3216,0,0,64,64,0,1,0,1,0
10986,1157,0,0,62,62,0,1,0,1,0
1213,1147,0,0,64,64,0,1,0,1,0
6050,2938,0,0,62,62,0,1,0,1,0
1479,2621,0,0,63,63,0,1,0,1,0
12,3227,0,0,131,131,0,1,0,1,0
20349,1880,0,0,62,62,0,1,0,1,0
12840,1147,0,0,64,64,0,1,0,1,0
20217,1771,0,0,65,65,0,1,0,1,0
820,136,0,0,60,60,0,1,0,1,0
18204,2599,0,0,65,65,0,1,0,1,0
16951,255,0,0,62,62,0,1,0,1,0
10214,3188,0,0,66,66,0,1,0,1,0
5067,1147,0,0,64,64,0,1,0,1,0
10672,1020,0,0,66,66,0,1,0,1,0
2024,1215,0,0,64,64,0,1,0,1,0
16500,2917,0,0,74,74,0,1,0,1,0
6233,1646,0,0,60,60,0,1,0,1,0
2256,2636,0,0,62,62,0,1,0,1,0
342,1765,0,0,66,66,0,1,0,1,0
10450,2587,0,0,62,62,0,1,0,1,0
20857,2587,0,0,66,66,0,1,0,1,0
636,1690,0,0,154,154,0,1,0,1,0
16951,255,0,0,62,62,0,1,0,1,0
13732,1147,0,0,66,66,0,1,0,1,0
21635,1888,0,0,62,62,0,1,0,1,0
20129,1880,0,0,65,65,0,1,0,1,0
2068,31,0,0,60,60,0,1,0,1,0
6815,3216,0,0,62,62,0,1,0,1,0
262,1054,0,0,66,66,0,1,0,1,0
9214,3256,0,0,60,60,0,1,0,1,0
8650,2913,0,0,65,65,0,1,0,1,0
1869,3214,0,0,101,101,0,1,0,1,0
9214,3256,0,0,60,60,0,1,0,1,0
2037,1147,0,0,62,62,0,1,0,1,0
18748,1880,0,0,62,62,0,1,0,1,0
21576,2636,0,0,66,66,0,1,0,1,0
6552,2093,0,0,145,145,0,1,0,1,0
7748,2587,0,0,63,63,0,1,0,1,0
3127,1786,0,0,62,62,0,1,0,1,0
16951,255,0,0,62,62,0,1,0,1,0
1851,2,0,0,61,61,0,1,0,1,0
19589,2256,0,0,62,62,0,1,0,1,0
128,391,0,0,62,62,0,1,0,1,0
12809,2938,0,0,63,63,0,1,0,1,0
2639,1250,0,0,63,63,0,1,0,1,0
22610,1215,0,0,62,62,0,1,0,1,0
231,1771,0,0,62,62,0,1,0,1,0
2274,2836,0,0,74,74,0,1,0,1,0
17426,2237,0,0,67,67,0,1,0,1,0
18671,2604,0,0,66,66,0,1,0,1,0
115,2767,0,0,66,66,0,1,0,1,0
1262,1147,0,0,146,146,0,1,0,1,0
9764,2587,0,0,66,66,0,1,0,1,0
16951,255,0,0,62,62,0,1,0,1,0
13466,2587,0,0,62,62,0,1,0,1,0
20733,1880,0,0,66,66,0,1,0,1,0
431,1771,0,0,62,62,0,1,0,1,0
1912,7,0,0,60,60,0,1,0,1,0
12964,967,0,0,62,62,0,1,0,1,0
2222,2575,0,0,66,66,0,1,0,1,0
438,1778,0,0,63,63,0,1,0,1,0
20048,1797,0,0,66,66,0,1,0,1,0
2027,3216,0,0,66,66,0,1,0,1,0
10506,169,0,0,100,100,0,1,0,1,0
319,1,0,0,61,61,0,1,0,1,0
1594,1888,0,0,62,62,0,1,0,1,0
9457,1017,0,0,66,66,0,1,0,1,0
7625,1147,0,0,95,95,0,1,0,1,0
665,1888,0,0,62,62,0,1,0,1,0
17578,418,0,0,62,62,0,1,0,1,0
21593,860,0,0,66,66,0,1,0,1,0
16951,255,0,0,62,62,0,1,0,1,0
17015,474,0,0,62,62,0,1,0,1,0
1821,3175,0,0,60,60,0,1,0,1,0
15694,344,0,0,145,145,0,1,0,1,0
5898,7,0,0,60,60,0,1,0,1,0
3987,697,0,0,73,73,0,1,0,1,0
7339,140,0,0,60,60,0,1,0,1,0
8224,2599,0,0,63,63,0,1,0,1,0
15804,2606,0,0,66,66,0,1,0,1,0
0,0,0,0,73,73,0,1,0,1,0
2183,2256,0,0,121,121,0,1,0,1,0
19006,3216,0,0,63,63,0,1,0,1,0
19452,987,0,0,65,65,0,1,0,1,0
5584,7,0,0,60,60,0,1,0,1,0
2980,372,0,0,61,61,0,1,0,1,0
9349,3216,0,0,64,64,0,1,0,1,0
3740,1908,0,0,72,72,0,1,0,1,0
9523,2587,0,0,65,65,0,1,0,1,0
10516,6,0,0,60,60,0,1,0,1,0
10475,2587,0,0,62,62,0,1,0,1,0
732,140,0,0,66,66,0,1,0,1,0
18798,1840,0,0,65,65,0,1,0,1,0
2062,25,0,0,60,60,0,1,0,1,0
1274,1888,0,0,62,62,0,1,0,1,0
16510,2576,0,0,124,124,0,1,0,1,0
1668,2920,0,0,62,62,0,1,0,1,0
3257,1017,0,0,66,66,0,1,0,1,0
16951,255,0,0,62,62,0,1,0,1,0
6651,1129,0,0,156,156,0,1,0,1,0
17562,1771,0,0,62,62,0,1,0,1,0
14505,2312,0,0,78,78,0,1,0,1,0
20893,1888,0,0,66,66,0,1,0,1,0
9945,2636,0,0,66,66,0,1,0,1,0
8171,1073,0,0,60,60,0,1,0,1,0
311,3216,0,0,64,64,0,1,0,1,0
6439,1017,0,0,66,66,0,1,0,1,0
6576,2601,0,0,146,146,0,1,0,1,0
8699,2608,0,0,89,89,0,1,0,1,0
16042,1479,0,0,66,66,0,1,0,1,0
588,2611,0,0,78,78,0,1,0,1,0
14800,1017,0,0,64,64,0,1,0,1,0
786,2904,0,0,62,62,0,1,0,1,0
12,981,0,0,71,71,0,1,0,1,0
10154,1472,0,0,62,62,0,1,0,1,0
21865,1797,0,0,64,64,0,1,0,1,0
8054,2947,0,0,66,66,0,1,0,1,0
3096,2942,0,0,62,62,0,1,0,1,0
15268,1147,0,0,65,65,0,1,0,1,0
16951,255,0,0,62,62,0,1,0,1,0
3022,1880,0,0,65,65,0,1,0,1,0
18600,2571,0,0,70,70,0,1,0,1,0
10746,979,0,0,62,62,0,1,0,1,0
1319,1472,0,0,127,127,0,1,0,1,0
20872,2953,0,0,66,66,0,1,0,1,0
50,2434,0,0,154,154,0,1,0,1,0
4445,2883,0,0,79,79,0,1,0,1,0
3984,1819,0,0,74,74,0,1,0,1,0
12030,2611,0,0,74,74,0,1,0,1,0
17957,697,0,0,66,66,0,1,0,1,0
1213,2695,0,0,62,62,0,1,0,1,0
20259,2631,0,0,66,66,0,1,0,1,0
11080,509,0,0,62,62,0,1,0,1,0
22701,2256,0,0,65,65,0,1,0,1,0
2876,1017,0,0,62,62,0,1,0,1,0
8995,1858,0,0,64,64,0,1,0,1,0
2091,1801,0,0,62,62,0,1,0,1,0
10652,1149,0,0,65,65,0,1,0,1,0
1222,2256,0,0,62,62,0,1,0,1,0
12227,1215,0,0,62,62,0,1,0,1,0
2556,1797,0,0,63,63,0,1,0,1,0
22039,1888,0,0,62,62,0,1,0,1,0
4961,2256,0,0,66,66,0,1,0,1,0
7050,1194,0,0,62,62,0,1,0,1,0
16951,255,0,0,62,62,0,1,0,1,0
11123,2256,0,0,66,66,0,1,0,1,0
20811,2953,0,0,65,65,0,1,0,1,0
10270,2883,0,0,66,66,0,1,0,1,0
7462,1771,0,0,66,66,0,1,0,1,0
16951,255,0,0,62,62,0,1,0,1,0
10391,3216,0,0,66,66,0,1,0,1,0
11013,2248,0,0,66,66,0,1,0,1,0
1954,1215,0,0,64,64,0,1,0,1,0
20070,1885,0,0,64,64,0,1,0,1,0
4323,2046,0,0,143,143,0,1,0,1,0
2894,2883,0,0,146,146,0,1,0,1,0
578,471,0,0,63,63,0,1,0,1,0
13595,2619,0,0,66,66,0,1,0,1,0
8656,509,0,0,64,64,0,1,0,1,0
18807,1853,0,0,66,66,0,1,0,1,0
13776,321,0,0,66,66,0,1,0,1,0
8039,1179,0,0,146,146,0,1,0,1,0
22286,1831,0,0,64,64,0,1,0,1,0
20989,3212,0,0,66,66,0,1,0,1,0
763,1888,0,0,62,62,0,1,0,1,0
6521,1215,0,0,62,62,0,1,0,1,0
1247,1017,0,0,62,62,0,1,0,1,0
63,1147,0,0,62,62,0,1,0,1,0
6727,2571,0,0,71,71,0,1,0,1,0
6953,1888,0,0,62,62,0,1,0,1,0
17511,983,0,0,62,62,0,1,0,1,0
9193,1218,0,0,64,64,0,1,0,1,0
2243,2256,0,0,62,62,0,1,0,1,0
2558,1017,0,0,146,146,0,1,0,1,0
14861,3260,0,0,139,139,0,1,0,1,0
6513,1771,0,0,66,66,0,1,0,1,0
20991,3212,0,0,65,65,0,1,0,1,0
10272,2883,0,0,66,66,0,1,0,1,0
1752,2584,0,0,62,62,0,1,0,1,0
699,2938,0,0,62,62,0,1,0,1,0
10474,2,0,0,67,67,0,1,0,1,0
21980,1147,0,0,66,66,0,1,0,1,0
16444,2881,0,0,90,90,0,1,0,1,0
19314,2938,0,0,66,66,0,1,0,1,0
12305,1064,0,0,146,146,0,1,0,1,0
698,7,0,0,60,60,0,1,0,1,0
7935,2938,0,0,74,74,0,1,0,1,0
1914,2256,0,0,62,62,0,1,0,1,0
19047,1899,0,0,62,62,0,1,0,1,0
15697,2256,0,0,63,63,0,1,0,1,0
497,653,0,0,220,220,0,1,0,1,0
6778,2256,0,0,63,63,0,1,0,1,0
536,3216,0,0,62,62,0,1,0,1,0
3199,2368,0,0,86,86,0,1,0,1,0
4977,1024,0,0,60,60,0,1,0,1,0
371,1147,0,0,62,62,0,1,0,1,0
16834,509,0,0,66,66,0,1,0,1,0
15140,427,0,0,78,78,0,1,0,1,0
5784,2587,0,0,116,116,0,1,0,1,0
8695,983,0,0,62,62,0,1,0,1,0
740,1803,0,0,66,66,0,1,0,1,0
26,2652,0,0,82,82,0,1,0,1,0
7372,2495,0,0,145,145,0,1,0,1,0
9829,2897,0,0,66,66,0,1,0,1,0
20399,6,0,0,60,60,0,1,0,1,0
19826,2883,0,0,64,64,0,1,0,1,0
2219,2636,0,0,62,62,0,1,0,1,0
4374,1017,0,0,96,96,0,1,0,1,0
15691,1202,0,0,139,139,0,1,0,1,0
16877,1482,0,0,62,62,0,1,0,1,0
1676,1147,0,0,62,62,0,1,0,1,0
12,3116,0,0,1484,1484,0,1,0,1,0
2823,7,0,0,60,60,0,1,0,1,0
3193,2938,0,0,61,61,0,1,0,1,0
11653,3216,0,0,66,66,0,1,0,1,0
4253,2482,0,0,146,146,0,1,0,1,0
11460,306,0,0,65,65,0,1,0,1,0
3109,2611,0,0,72,72,0,1,0,1,0
10163,1017,0,0,66,66,0,1,0,1,0
9896,2938,0,0,62,62,0,1,0,1,0
4091,1017,0,0,66,66,0,1,0,1,0
2628,3216,0,0,66,66,0,1,0,1,0
17716,1809,0,0,66,66,0,1,0,1,0
6441,2256,0,0,65,65,0,1,0,1,0
7076,1888,0,0,62,62,0,1,0,1,0
3049,256,0,0,145,145,0,1,0,1,0
20779,1214,0,0,71,71,0,1,0,1,0
321,2587,0,0,62,62,0,1,0,1,0
11512,2256,0,0,66,66,0,1,0,1,0
7529,1119,0,0,62,62,0,1,0,1,0
1780,2587,0,0,65,65,0,1,0,1,0
7536,2587,0,0,64,64,0,1,0,1,0
450,126,0,0,136,136,0,1,0,1,0
1437,2951,0,0,65,65,0,1,0,1,0
2493,3216,0,0,65,65,0,1,0,1,0
1661,3206,0,0,66,66,0,1,0,1,0
14773,2938,0,0,62,62,0,1,0,1,0
20712,3146,0,0,66,66,0,1,0,1,0
16112,2611,0,0,66,66,0,1,0,1,0
12354,2926,0,0,62,62,0,1,0,1,0
19782,1098,0,0,63,63,0,1,0,1,0
3448,7,0,0,60,60,0,1,0,1,0
18395,1161,0,0,63,63,0,1,0,1,0
9584,3209,0,0,62,62,0,1,0,1,0
10660,2877,0,0,65,65,0,1,0,1,0
5435,3159,0,0,64,64,0,1,0,1,0
26,2938,0,0,72,72,0,1,0,1,0
12,2346,0,0,332,332,0,1,0,1,0
12,207,0,0,320,320,0,1,0,1,0
1509,465,0,0,159,159,0,1,0,1,0
5699,2938,0,0,74,74,0,1,0,1,0
21016,1147,0,0,65,65,0,1,0,1,0
16951,255,0,0,62,62,0,1,0,1,0
16951,255,0,0,62,62,0,1,0,1,0
15255,2587,0,0,62,62,0,1,0,1,0
18151,1147,0,0,66,66,0,1,0,1,0
6067,2883,0,0,62,62,0,1,0,1,0
16951,255,0,0,62,62,0,1,0,1,0
19913,1880,0,0,66,66,0,1,0,1,0
3850,2889,0,0,66,66,0,1,0,1,0
770,3216,0,0,66,66,0,1,0,1,0
12477,3216,0,0,66,66,0,1,0,1,0
2266,1017,0,0,90,90,0,1,0,1,0
2505,1147,0,0,62,62,0,1,0,1,0
18,3216,0,0,62,62,0,1,0,1,0
11515,2256,0,0,63,63,0,1,0,1,0
16951,255,0,0,62,62,0,1,0,1,0
16732,1118,0,0,128,128,0,1,0,1,0
2457,1215,0,0,63,63,0,1,0,1,0
23,2256,0,0,62,62,0,1,0,1,0
20754,1888,0,0,66,66,0,1,0,1,0
11480,1888,0,0,66,66,0,1,0,1,0
6061,2938,0,0,62,62,0,1,0,1,0
5766,2938,0,0,62,62,0,1,0,1,0
8,2002,0,0,1509,1509,0,1,0,1,0
21599,2636,0,0,66,66,0,1,0,1,0
16989,847,0,0,66,66,0,1,0,1,0
2412,1215,0,0,62,62,0,1,0,1,0
17465,2945,0,0,66,66,0,1,0,1,0
16951,255,0,0,62,62,0,1,0,1,0
17319,2632,0,0,62,62,0,1,0,1,0
2647,1210,0,0,65,65,0,1,0,1,0
2904,2587,0,0,66,66,0,1,0,1,0
4490,1147,0,0,87,87,0,1,0,1,0
5622,2853,0,0,62,62,0,1,0,1,0
5812,111,0,0,60,60,0,1,0,1,0
17441,1147,0,0,62,62,0,1,0,1,0
20005,2559,0,0,66,66,0,1,0,1,0
11875,2256,0,0,63,63,0,1,0,1,0
15155,1116,0,0,63,63,0,1,0,1,0
33,1805,0,0,65,65,0,1,0,1,0
22592,1215,0,0,62,62,0,1,0,1,0
18319,2255,0,0,66,66,0,1,0,1,0
21940,1149,0,0,64,64,0,1,0,1,0
12,3074,0,0,320,320,0,1,0,1,0
2485,3216,0,0,66,66,0,1,0,1,0
2205,2672,0,0,112,112,0,1,0,1,0
20124,1085,0,0,62,62,0,1,0,1,0
8185,3172,0,0,88,88,0,1,0,1,0
9005,104,0,0,60,60,0,1,0,1,0
1374,1888,0,0,62,62,0,1,0,1,0
13566,84,0,0,60,60,0,1,0,1,0
577,2611,0,0,78,78,0,1,0,1,0
4293,9,0,0,60,60,0,1,0,1,0
16951,255,0,0,62,62,0,1,0,1,0
7326,180,0,0,60,60,0,1,0,1,0
6555,2587,0,0,64,64,0,1,0,1,0
1132,1215,0,0,62,62,0,1,0,1,0
1382,2587,0,0,66,66,0,1,0,1,0
5081,2611,0,0,62,62,0,1,0,1,0
18389,2938,0,0,70,70,0,1,0,1,0
4551,1147,0,0,62,62,0,1,0,1,0
360,3105,0,0,168,168,0,1,0,1,0
10996,1147,0,0,62,62,0,1,0,1,0
16951,255,0,0,62,62,0,1,0,1,0
9986,1190,0,0,71,71,0,1,0,1,0
11660,3216,0,0,62,62,0,1,0,1,0
6402,1017,0,0,62,62,0,1,0,1,0
1388,1880,0,0,62,62,0,1,0,1,0
2154,2938,0,0,62,62,0,1,0,1,0
2517,1142,0,0,146,146,0,1,0,1,0
2203,2636,0,0,127,127,0,1,0,1,0
1850,3216,0,0,66,66,0,1,0,1,0
9258,1476,0,0,64,64,0,1,0,1,0
2317,1481,0,0,157,157,0,1,0,1,0
152,3216,0,0,66,66,0,1,0,1,0
614,983,0,0,62,62,0,1,0,1,0
15882,1888,0,0,62,62,0,1,0,1,0
20352,1880,0,0,62,62,0,1,0,1,0
9214,3256,0,0,60,60,0,1,0,1,0
1525,1444,0,0,145,145,0,1,0,1,0
2295,1926,0,0,62,62,0,1,0,1,0
2621,2256,0,0,146,146,0,1,0,1,0
16029,308,0,0,62,62,0,1,0,1,0
7299,2588,0,0,65,65,0,1,0,1,0
12096,2587,0,0,66,66,0,1,0,1,0
10427,1017,0,0,62,62,0,1,0,1,0
12925,1827,0,0,64,64,0,1,0,1,0
2232,2587,0,0,64,64,0,1,0,1,0
16050,1147,0,0,94,94,0,1,0,1,0
16444,2881,0,0,90,90,0,1,0,1,0
7339,152,0,0,60,60,0,1,0,1,0
7428,1471,0,0,130,130,0,1,0,1,0
1170,3216,0,0,62,62,0,1,0,1,0
2871,2607,0,0,146,146,0,1,0,1,0
17456,1147,0,0,66,66,0,1,0,1,0
3289,1888,0,0,66,66,0,1,0,1,0
15351,2216,0,0,65,65,0,1,0,1,0
14917,1017,0,0,108,108,0,1,0,1,0
186,2486,0,0,64,64,0,1,0,1,0
8328,2569,0,0,148,148,0,1,0,1,0
20187,2227,0,0,66,66,0,1,0,1,0
8094,1216,0,0,138,138,0,1,0,1,0
2543,1795,0,0,62,62,0,1,0,1,0
4624,2256,0,0,64,64,0,1,0,1,0
3418,2592,0,0,62,62,0,1,0,1,0
21258,2587,0,0,63,63,0,1,0,1,0
5579,7,0,0,60,60,0,1,0,1,0
5612,2863,0,0,62,62,0,1,0,1,0
7542,1804,0,0,63,63,0,1,0,1,0
496,321,0,0,66,66,0,1,0,1,0
5534,1038,0,0,62,62,0,1,0,1,0
22636,1215,0,0,62,62,0,1,0,1,0
3693,1888,0,0,62,62,0,1,0,1,0
612,22,0,0,60,60,0,1,0,1,0
2673,2601,0,0,71,71,0,1,0,1,0
3443,1888,0,0,62,62,0,1,0,1,0
521,7,0,0,60,60,0,1,0,1,0
15694,344,0,0,145,145,0,1,0,1,0
2793,1147,0,0,62,62,0,1,0,1,0
13190,1016,0,0,65,65,0,1,0,1,0
20742,2611,0,0,62,62,0,1,0,1,0
8651,509,0,0,62,62,0,1,0,1,0
2727,2574,0,0,62,62,0,1,0,1,0
2976,1472,0,0,83,83,0,1,0,1,0
2061,1888,0,0,62,62,0,1,0,1,0
2584,1677,0,0,160,160,0,1,0,1,0
2402,2256,0,0,117,117,0,1,0,1,0
6659,735,0,0,69,69,0,1,0,1,0
12703,1888,0,0,66,66,0,1,0,1,0
14215,2205,0,0,66,66,0,1,0,1,0
3096,1147,0,0,64,64,0,1,0,1,0
8171,1073,0,0,60,60,0,1,0,1,0
16951,255,0,0,62,62,0,1,0,1,0
497,653,0,0,220,220,0,1,0,1,0
20750,10,0,0,72,72,0,1,0,1,0
773,2611,0,0,62,62,0,1,0,1,0
11355,3213,0,0,66,66,0,1,0,1,0
7082,1909,0,0,67,67,0,1,0,1,0
5767,2938,0,0,62,62,0,1,0,1,0
4996,1021,0,0,60,60,0,1,0,1,0
10427,1017,0,0,66,66,0,1,0,1,0
16827,509,0,0,66,66,0,1,0,1,0
693,2256,0,0,66,66,0,1,0,1,0
2671,1147,0,0,62,62,0,1,0,1,0
2779,1147,0,0,63,63,0,1,0,1,0
7505,3216,0,0,62,62,0,1,0,1,0
15391,509,0,0,64,64,0,1,0,1,0
19962,1089,0,0,64,64,0,1,0,1,0
3146,2587,0,0,146,146,0,1,0,1,0
18053,2256,0,0,62,62,0,1,0,1,0
14070,1147,0,0,62,62,0,1,0,1,0
20713,2708,0,0,67,67,0,1,0,1,0
3653,535,0,0,77,77,0,1,0,1,0
12010,1147,0,0,62,62,0,1,0,1,0
16951,255,0,0,62,62,0,1,0,1,0
302,2953,0,0,66,66,0,1,0,1,0
9901,2587,0,0,88,88,0,1,0,1,0
16951,255,0,0,62,62,0,1,0,1,0
3918,1196,0,0,62,62,0,1,0,1,0
16899,2582,0,0,66,66,0,1,0,1,0
3969,2184,0,0,62,62,0,1,0,1,0
2289,440,0,0,62,62,0,1,0,1,0
515,982,0,0,63,63,0,1,0,1,0
12,2419,0,0,95,95,0,1,0,1,0
6506,936,0,0,62,62,0,1,0,1,0
547,2256,0,0,65,65,0,1,0,1,0
2659,1889,0,0,62,62,0,1,0,1,0
413,2587,0,0,64,64,0,1,0,1,0
3064,1147,0,0,62,62,0,1,0,1,0
360,3105,0,0,1093,1093,0,1,0,1,0
1330,697,0,0,62,62,0,1,0,1,0
16951,255,0,0,62,62,0,1,0,1,0
19047,2938,0,0,64,64,0,1,0,1,0
3136,2940,0,0,71,71,0,1,0,1,0
2773,3216,0,0,66,66,0,1,0,1,0
21180,2256,0,0,62,62,0,1,0,1,0
27,2938,0,0,72,72,0,1,0,1,0
20349,3139,0,0,64,64,0,1,0,1,0
7525,1136,0,0,62,62,0,1,0,1,0
2430,2938,0,0,62,62,0,1,0,1,0
21279,985,0,0,65,65,0,1,0,1,0
1234,983,0,0,64,64,0,1,0,1,0
17578,418,0,0,62,62,0,1,0,1,0
578,2611,0,0,78,78,0,1,0,1,0
7339,152,0,0,60,60,0,1,0,1,0
14641,2587,0,0,66,66,0,1,0,1,0
360,3105,0,0,1172,1172,0,1,0,1,0
29,1888,0,0,62,62,0,1,0,1,0
8074,1147,0,0,62,62,0,1,0,1,0
21098,1215,0,0,66,66,0,1,0,1,0
6997,2632,0,0,62,62,0,1,0,1,0
12,3227,0,0,116,116,0,1,0,1,0
1009,2938,0,0,63,63,0,1,0,1,0
22690,2938,0,0,72,72,0,1,0,1,0
15423,1017,0,0,62,62,0,1,0,1,0
15882,3051,0,0,65,65,0,1,0,1,0
1898,1480,0,0,62,62,0,1,0,1,0
612,25,0,0,60,60,0,1,0,1,0
5327,1888,0,0,62,62,0,1,0,1,0
20342,1883,0,0,62,62,0,1,0,1,0
13488,1888,0,0,64,64,0,1,0,1,0
13146,3216,0,0,62,62,0,1,0,1,0
2317,475,0,0,64,64,0,1,0,1,0
10480,3216,0,0,64,64,0,1,0,1,0
2861,1215,0,0,65,65,0,1,0,1,0
2716,1017,0,0,65,65,0,1,0,1,0
297,509,0,0,63,63,0,1,0,1,0
16251,1888,0,0,64,64,0,1,0,1,0
6401,1199,0,0,62,62,0,1,0,1,0
12,3109,0,0,325,325,0,1,0,1,0
2781,2615,0,0,146,146,0,1,0,1,0
17584,1147,0,0,65,65,0,1,0,1,0
636,398,0,0,143,143,0,1,0,1,0
17300,509,0,0,63,63,0,1,0,1,0
16330,2595,0,0,65,65,0,1,0,1,0
1869,3215,0,0,62,62,0,1,0,1,0
7101,1147,0,0,134,134,0,1,0,1,0
14340,1164,0,0,124,124,0,1,0,1,0
10689,1215,0,0,62,62,0,1,0,1,0
6651,1186,0,0,156,156,0,1,0,1,0
8,442,0,0,60,60,0,1,0,1,0
10613,430,0,0,66,66,0,1,0,1,0
9484,1888,0,0,63,63,0,1,0,1,0
1278,7,0,0,60,60,0,1,0,1,0
2024,1888,0,0,63,63,0,1,0,1,0
2754,2623,0,0,62,62,0,1,0,1,0
19001,3216,0,0,62,62,0,1,0,1,0
12,3143,0,0,65,65,0,1,0,1,0
20832,2953,0,0,66,66,0,1,0,1,0
17339,509,0,0,65,65,0,1,0,1,0
16443,1087,0,0,63,63,0,1,0,1,0
17768,1016,0,0,66,66,0,1,0,1,0
11764,1888,0,0,66,66,0,1,0,1,0
8088,154,0,0,60,60,0,1,0,1,0
12,106,0,0,90,90,0,1,0,1,0
16951,255,0,0,62,62,0,1,0,1,0
12259,1017,0,0,62,62,0,1,0,1,0
578,1215,0,0,62,62,0,1,0,1,0
14207,1493,0,0,66,66,0,1,0,1,0
16951,255,0,0,62,62,0,1,0,1,0
7025,1832,0,0,144,144,0,1,0,1,0
15404,509,0,0,66,66,0,1,0,1,0
16116,2611,0,0,63,63,0,1,0,1,0
2658,1147,0,0,66,66,0,1,0,1,0
360,3105,0,0,348,348,0,1,0,1,0
8974,1209,0,0,62,62,0,1,0,1,0
1387,3216,0,0,62,62,0,1,0,1,0
10859,1799,0,0,66,66,0,1,0,1,0
3132,1017,0,0,64,64,0,1,0,1,0
16904,2584,0,0,66,66,0,1,0,1,0
14215,6,0,0,60,60,0,1,0,1,0
20194,2210,0,0,66,66,0,1,0,1,0
20268,1469,0,0,161,161,0,1,0,1,0
311,1888,0,0,62,62,0,1,0,1,0
9863,2938,0,0,71,71,0,1,0,1,0
18,3216,0,0,62,62,0,1,0,1,0
2746,1017,0,0,60,60,0,1,0,1,0
7894,2624,0,0,65,65,0,1,0,1,0
11450,245,0,0,60,60,0,1,0,1,0
4544,2256,0,0,62,62,0,1,0,1,0
8164,2728,0,0,60,60,0,1,0,1,0
19893,1883,0,0,64,64,0,1,0,1,0
6434,2237,0,0,64,64,0,1,0,1,0
11360,1031,0,0,66,66,0,1,0,1,0
20886,2589,0,0,66,66,0,1,0,1,0
7556,74,0,0,60,60,0,1,0,1,0
21152,1103,0,0,146,146,0,1,0,1,0
2402,1768,0,0,63,63,0,1,0,1,0
12,131,0,0,97,97,0,1,0,1,0
644,1472,0,0,143,143,0,1,0,1,0
14620,2883,0,0,62,62,0,1,0,1,0
1407,1888,0,0,66,66,0,1,0,1,0
11679,1130,0,0,66,66,0,1,0,1,0
7354,3216,0,0,62,62,0,1,0,1,0
3069,1888,0,0,66,66,0,1,0,1,0
22234,2950,0,0,66,66,0,1,0,1,0
16951,255,0,0,62,62,0,1,0,1,0
360,3105,0,0,933,933,0,1,0,1,0
1981,2251,0,0,64,64,0,1,0,1,0
16116,291,0,0,62,62,0,1,0,1,0
1794,2587,0,0,62,62,0,1,0,1,0
19799,1771,0,0,66,66,0,1,0,1,0
5925,3105,0,0,62,62,0,1,0,1,0
32,685,0,0,61,61,0,1,0,1,0
0,0,0,0,99,99,0,1,0,1,0
17215,986,0,0,143,143,0,1,0,1,0
1595,1888,0,0,62,62,0,1,0,1,0
13826,509,0,0,66,66,0,1,0,1,0
17579,2587,0,0,65,65,0,1,0,1,0
10386,2938,0,0,66,66,0,1,0,1,0
13497,2606,0,0,66,66,0,1,0,1,0
17803,2598,0,0,62,62,0,1,0,1,0
1741,2575,0,0,62,62,0,1,0,1,0
17811,1880,0,0,66,66,0,1,0,1,0
7373,2587,0,0,63,63,0,1,0,1,0
10356,2221,0,0,66,66,0,1,0,1,0
4479,7,0,0,60,60,0,1,0,1,0
1374,1888,0,0,62,62,0,1,0,1,0
12,2247,0,0,83,83,0,1,0,1,0
10602,2380,0,0,66,66,0,1,0,1,0
29,1888,0,0,62,62,0,1,0,1,0
17616,1147,0,0,66,66,0,1,0,1,0
13025,1817,0,0,62,62,0,1,0,1,0
3674,2385,0,0,146,146,0,1,0,1,0
11026,2938,0,0,66,66,0,1,0,1,0
16084,2883,0,0,66,66,0,1,0,1,0
2509,1150,0,0,62,62,0,1,0,1,0
5419,1020,0,0,62,62,0,1,0,1,0
17043,428,0,0,62,62,0,1,0,1,0
3018,1880,0,0,66,66,0,1,0,1,0
16951,255,0,0,62,62,0,1,0,1,0
865,425,0,0,60,60,0,1,0,1,0
1680,10,0,0,60,60,0,1,0,1,0
15983,2938,0,0,105,105,0,1,0,1,0
301,3216,0,0,62,62,0,1,0,1,0
1754,1017,0,0,146,146,0,1,0,1,0
12868,1167,0,0,62,62,0,1,0,1,0
12,3135,0,0,72,72,0,1,0,1,0
274,9,0,0,60,60,0,1,0,1,0
15050,486,0,0,61,61,0,1,0,1,0
9260,805,0,0,66,66,0,1,0,1,0
16951,255,0,0,62,62,0,1,0,1,0
730,2255,0,0,66,66,0,1,0,1,0
17417,1147,0,0,123,123,0,1,0,1,0
1796,2247,0,0,61,61,0,1,0,1,0
15354,2210,0,0,65,65,0,1,0,1,0
1758,2883,0,0,64,64,0,1,0,1,0
944,2636,0,0,63,63,0,1,0,1,0
3956,1578,0,0,62,62,0,1,0,1,0
19649,509,0,0,66,66,0,1,0,1,0
9411,2250,0,0,62,62,0,1,0,1,0
16951,255,0,0,62,62,0,1,0,1,0
16103,1442,0,0,64,64,0,1,0,1,0
1275,1147,0,0,146,146,0,1,0,1,0
2202,2907,0,0,64,64,0,1,0,1,0
16448,1017,0,0,66,66,0,1,0,1,0
2703,2491,0,0,62,62,0,1,0,1,0
13071,1017,0,0,62,62,0,1,0,1,0
42,2948,0,0,139,139,0,1,0,1,0
20840,1880,0,0,62,62,0,1,0,1,0
13305,3216,0,0,62,62,0,1,0,1,0
7621,2595,0,0,62,62,0,1,0,1,0
18945,2515,0,0,63,63,0,1,0,1,0
18147,1888,0,0,66,66,0,1,0,1,0
14965,1778,0,0,65,65,0,1,0,1,0
2990,7,0,0,60,60,0,1,0,1,0
6651,1129,0,0,156,156,0,1,0,1,0
19898,3215,0,0,62,62,0,1,0,1,0
11756,1771,0,0,66,66,0,1,0,1,0
10968,1888,0,0,62,62,0,1,0,1,0
1267,1147,0,0,62,62,0,1,0,1,0
7050,1195,0,0,62,62,0,1,0,1,0
4194,1147,0,0,66,66,0,1,0,1,0
808,2883,0,0,65,65,0,1,0,1,0
1718,2636,0,0,63,63,0,1,0,1,0
1986,3216,0,0,63,63,0,1,0,1,0
7955,714,0,0,63,63,0,1,0,1,0
1910,2576,0,0,145,145,0,1,0,1,0
616,2821,0,0,121,121,0,1,0,1,0
19806,1017,0,0,66,66,0,1,0,1,0
1641,1800,0,0,63,63,0,1,0,1,0
17199,3214,0,0,66,66,0,1,0,1,0
1161,1496,0,0,92,92,0,1,0,1,0
4553,983,0,0,63,63,0,1,0,1,0
6815,3216,0,0,62,62,0,1,0,1,0
68,2938,0,0,62,62,0,1,0,1,0
3665,7,0,0,60,60,0,1,0,1,0
1304,2256,0,0,66,66,0,1,0,1,0
20038,1931,0,0,137,137,0,1,0,1,0
18215,3145,0,0,65,65,0,1,0,1,0
1964,983,0,0,66,66,0,1,0,1,0
21344,1147,0,0,62,62,0,1,0,1,0
21118,1147,0,0,66,66,0,1,0,1,0
12,3227,0,0,131,131,0,1,0,1,0
3637,2257,0,0,77,77,0,1,0,1,0
1330,804,0,0,62,62,0,1,0,1,0
4047,1017,0,0,63,63,0,1,0,1,0
22683,10,0,0,88,88,0,1,0,1,0
15846,1539,0,0,66,66,0,1,0,1,0
2723,1888,0,0,63,63,0,1,0,1,0
7615,1147,0,0,62,62,0,1,0,1,0
17733,1804,0,0,64,64,0,1,0,1,0
3543,2938,0,0,66,66,0,1,0,1,0
16951,255,0,0,62,62,0,1,0,1,0
13433,1462,0,0,66,66,0,1,0,1,0
18938,3216,0,0,68,68,0,1,0,1,0
3034,2587,0,0,62,62,0,1,0,1,0
3192,2858,0,0,62,62,0,1,0,1,0
1804,1762,0,0,60,60,0,1,0,1,0
8001,995,0,0,66,66,0,1,0,1,0
1366,1017,0,0,146,146,0,1,0,1,0
2756,459,0,0,62,62,0,1,0,1,0
18458,243,0,0,60,60,0,1,0,1,0
16951,255,0,0,62,62,0,1,0,1,0
2771,3216,0,0,64,64,0,1,0,1,0
15705,1729,0,0,62,62,0,1,0,1,0
21581,1850,0,0,62,62,0,1,0,1,0
360,3105,0,0,67,67,0,1,0,1,0
2290,437,0,0,62,62,0,1,0,1,0
10483,2436,0,0,91,91,0,1,0,1,0
330,2739,0,0,66,66,0,1,0,1,0
17320,454,0,0,61,61,0,1,0,1,0
19497,3212,0,0,62,62,0,1,0,1,0
16951,255,0,0,62,62,0,1,0,1,0
14691,2861,0,0,109,109,0,1,0,1,0
6229,2938,0,0,78,78,0,1,0,1,0
115,1467,0,0,64,64,0,1,0,1,0
19435,2950,0,0,67,67,0,1,0,1,0
1417,466,0,0,70,70,0,1,0,1,0
588,2611,0,0,78,78,0,1,0,1,0
8224,2587,0,0,63,63,0,1,0,1,0
461,204,0,0,934,934,0,1,0,1,0
11026,2938,0,0,65,65,0,1,0,1,0
8718,1785,0,0,63,63,0,1,0,1,0
1731,3216,0,0,64,64,0,1,0,1,0
9433,2506,0,0,75,75,0,1,0,1,0
7890,1147,0,0,146,146,0,1,0,1,0
2414,2093,0,0,146,146,0,1,0,1,0
17740,1888,0,0,62,62,0,1,0,1,0
3032,2587,0,0,62,62,0,1,0,1,0
14873,3139,0,0,66,66,0,1,0,1,0
1153,1587,0,0,66,66,0,1,0,1,0
6472,1215,0,0,62,62,0,1,0,1,0
12,2553,0,0,82,82,0,1,0,1,0
20500,1017,0,0,66,66,0,1,0,1,0
20768,1147,0,0,66,66,0,1,0,1,0
1818,1147,0,0,62,62,0,1,0,1,0
5932,1182,0,0,62,62,0,1,0,1,0
16951,255,0,0,62,62,0,1,0,1,0
9222,1787,0,0,148,148,0,1,0,1,0
108,7,0,0,60,60,0,1,0,1,0
2361,1147,0,0,64,64,0,1,0,1,0
12921,258,0,0,62,62,0,1,0,1,0
6017,2587,0,0,66,66,0,1,0,1,0
8292,2252,0,0,76,76,0,1,0,1,0
3770,1771,0,0,65,65,0,1,0,1,0
11349,1215,0,0,64,64,0,1,0,1,0
11439,340,0,0,63,63,0,1,0,1,0
21066,2611,0,0,62,62,0,1,0,1,0
16951,255,0,0,62,62,0,1,0,1,0
3260,1017,0,0,66,66,0,1,0,1,0
10954,1888,0,0,63,63,0,1,0,1,0
18614,1054,0,0,62,62,0,1,0,1,0
572,2205,0,0,72,72,0,1,0,1,0
6060,2938,0,0,62,62,0,1,0,1,0
2473,2587,0,0,60,60,0,1,0,1,0
20391,1888,0,0,62,62,0,1,0,1,0
14,214,0,0,63,63,0,1,0,1,0
16951,255,0,0,62,62,0,1,0,1,0
14634,3216,0,0,63,63,0,1,0,1,0
8,442,0,0,60,60,0,1,0,1,0
16951,255,0,0,62,62,0,1,0,1,0
438,1771,0,0,64,64,0,1,0,1,0
1663,2953,0,0,65,65,0,1,0,1,0
16928,2600,0,0,62,62,0,1,0,1,0
20699,2697,0,0,78,78,0,1,0,1,0
16951,255,0,0,62,62,0,1,0,1,0
18642,697,0,0,70,70,0,1,0,1,0
18437,2379,0,0,72,72,0,1,0,1,0
10979,2256,0,0,63,63,0,1,0,1,0
7351,2592,0,0,64,64,0,1,0,1,0
16951,255,0,0,62,62,0,1,0,1,0
2084,1471,0,0,145,145,0,1,0,1,0
1333,7,0,0,60,60,0,1,0,1,0
346,2587,0,0,66,66,0,1,0,1,0
6571,1,0,0,62,62,0,1,0,1,0
17187,1472,0,0,63,63,0,1,0,1,0
16951,255,0,0,62,62,0,1,0,1,0
19904,2587,0,0,66,66,0,1,0,1,0
1964,3213,0,0,64,64,0,1,0,1,0
19449,2903,0,0,66,66,0,1,0,1,0
9222,1787,0,0,148,148,0,1,0,1,0
2328,137,0,0,60,60,0,1,0,1,0
1130,1858,0,0,66,66,0,1,0,1,0
6552,2093,0,0,145,145,0,1,0,1,0
14133,3213,0,0,64,64,0,1,0,1,0
5497,1804,0,0,63,63,0,1,0,1,0
22457,1888,0,0,64,64,0,1,0,1,0
12,3074,0,0,320,320,0,1,0,1,0
4427,1147,0,0,65,65,0,1,0,1,0
597,418,0,0,72,72,0,1,0,1,0
17596,1017,0,0,66,66,0,1,0,1,0
9614,3105,0,0,86,86,0,1,0,1,0
21029,3216,0,0,66,66,0,1,0,1,0
8010,323,0,0,60,60,0,1,0,1,0
22020,3159,0,0,66,66,0,1,0,1,0
5266,2636,0,0,62,62,0,1,0,1,0
263,805,0,0,66,66,0,1,0,1,0
17087,2234,0,0,68,68,0,1,0,1,0
18053,1787,0,0,66,66,0,1,0,1,0
76,2589,0,0,145,145,0,1,0,1,0
2451,2587,0,0,65,65,0,1,0,1,0
7720,1771,0,0,62,62,0,1,0,1,0
10,904,0,0,73,73,0,1,0,1,0
3729,1204,0,0,139,139,0,1,0,1,0
2167,7,0,0,60,60,0,1,0,1,0
16951,255,0,0,62,62,0,1,0,1,0
948,186,0,0,66,66,0,1,0,1,0
1120,2940,0,0,91,91,0,1,0,1,0
1711,1215,0,0,62,62,0,1,0,1,0
16269,1042,0,0,146,146,0,1,0,1,0
22501,1017,0,0,66,66,0,1,0,1,0
15762,1215,0,0,65,65,0,1,0,1,0
2289,437,0,0,62,62,0,1,0,1,0
13015,1807,0,0,62,62,0,1,0,1,0
2723,1888,0,0,63,63,0,1,0,1,0
20394,1791,0,0,66,66,0,1,0,1,0
14,1801,0,0,60,60,0,1,0,1,0
12,1768,0,0,161,161,0,1,0,1,0
21143,1812,0,0,66,66,0,1,0,1,0
3149,2587,0,0,62,62,0,1,0,1,0
1525,1444,0,0,145,145,0,1,0,1,0
16951,255,0,0,62,62,0,1,0,1,0
13903,1889,0,0,143,143,0,1,0,1,0
175,2937,0,0,145,145,0,1,0,1,0
19621,2632,0,0,66,66,0,1,0,1,0
6506,936,0,0,62,62,0,1,0,1,0
496,2584,0,0,62,62,0,1,0,1,0
84,7,0,0,60,60,0,1,0,1,0
9346,2600,0,0,65,65,0,1,0,1,0
20921,1888,0,0,66,66,0,1,0,1,0
8369,1744,0,0,107,107,0,1,0,1,0
5391,1044,0,0,66,66,0,1,0,1,0
5262,2256,0,0,66,66,0,1,0,1,0
14616,2883,0,0,66,66,0,1,0,1,0
16951,255,0,0,62,62,0,1,0,1,0
1377,1888,0,0,62,62,0,1,0,1,0
2680,509,0,0,65,65,0,1,0,1,0
13717,2246,0,0,64,64,0,1,0,1,0
333,1017,0,0,62,62,0,1,0,1,0
12341,1880,0,0,65,65,0,1,0,1,0
12,2568,0,0,331,331,0,1,0,1,0
12817,1780,0,0,63,63,0,1,0,1,0
19905,1069,0,0,66,66,0,1,0,1,0
3002,1472,0,0,63,63,0,1,0,1,0
4495,1147,0,0,62,62,0,1,0,1,0
19315,3212,0,0,66,66,0,1,0,1,0
9313,2938,0,0,146,146,0,1,0,1,0
20306,775,0,0,66,66,0,1,0,1,0
2331,2599,0,0,62,62,0,1,0,1,0
2412,2093,0,0,145,145,0,1,0,1,0
581,3216,0,0,64,64,0,1,0,1,0
20784,1147,0,0,66,66,0,1,0,1,0
17344,2575,0,0,68,68,0,1,0,1,0
11792,2594,0,0,69,69,0,1,0,1,0
8171,1073,0,0,60,60,0,1,0,1,0
11871,218,0,0,62,62,0,1,0,1,0
415,2636,0,0,64,64,0,1,0,1,0
17620,2587,0,0,66,66,0,1,0,1,0
17111,2759,0,0,62,62,0,1,0,1,0
13411,1472,0,0,66,66,0,1,0,1,0
20229,2938,0,0,82,82,0,1,0,1,0
360,797,0,0,62,62,0,1,0,1,0
2066,1903,0,0,62,62,0,1,0,1,0
1866,3216,0,0,62,62,0,1,0,1,0
38,976,0,0,129,129,0,1,0,1,0
19696,2553,0,0,64,64,0,1,0,1,0
677,1756,0,0,144,144,0,1,0,1,0
2148,1888,0,0,62,62,0,1,0,1,0
7222,354,0,0,77,77,0,1,0,1,0
7698,3216,0,0,62,62,0,1,0,1,0
2531,2643,0,0,64,64,0,1,0,1,0
14169,2938,0,0,66,66,0,1,0,1,0
1892,1771,0,0,66,66,0,1,0,1,0
11892,2736,0,0,66,66,0,1,0,1,0
2847,2601,0,0,64,64,0,1,0,1,0
496,2233,0,0,64,64,0,1,0,1,0
6993,3216,0,0,62,62,0,1,0,1,0
5301,1147,0,0,62,62,0,1,0,1,0
0,0,0,0,98,98,0,1,0,1,0
12799,1462,0,0,64,64,0,1,0,1,0
2659,2611,0,0,78,78,0,1,0,1,0
11892,2739,0,0,63,63,0,1,0,1,0
4412,2883,0,0,62,62,0,1,0,1,0
5515,1834,0,0,63,63,0,1,0,1,0
7624,2938,0,0,62,62,0,1,0,1,0
9260,805,0,0,66,66,0,1,0,1,0
11662,2629,0,0,66,66,0,1,0,1,0
14232,12,0,0,62,62,0,1,0,1,0
21614,283,0,0,65,65,0,1,0,1,0
2075,1467,0,0,145,145,0,1,0,1,0
10773,1478,0,0,66,66,0,1,0,1,0
11519,1472,0,0,63,63,0,1,0,1,0
17977,732,0,0,66,66,0,1,0,1,0
3947,1017,0,0,65,65,0,1,0,1,0
19718,2486,0,0,135,135,0,1,0,1,0
10487,1153,0,0,64,64,0,1,0,1,0
16951,255,0,0,62,62,0,1,0,1,0
18833,2130,0,0,66,66,0,1,0,1,0
2362,1147,0,0,62,62,0,1,0,1,0
18741,1046,0,0,64,64,0,1,0,1,0
4490,1147,0,0,65,65,0,1,0,1,0
360,3105,0,0,1291,1291,0,1,0,1,0
11681,1146,0,0,66,66,0,1,0,1,0
3018,1880,0,0,66,66,0,1,0,1,0
778,1888,0,0,146,146,0,1,0,1,0
133,1017,0,0,62,62,0,1,0,1,0
1418,1017,0,0,62,62,0,1,0,1,0
4309,2587,0,0,137,137,0,1,0,1,0
17411,2634,0,0,66,66,0,1,0,1,0
440,2879,0,0,62,62,0,1,0,1,0
16951,255,0,0,62,62,0,1,0,1,0
12,447,0,0,60,60,0,1,0,1,0
1231,983,0,0,63,63,0,1,0,1,0
1853,2938,0,0,62,62,0,1,0,1,0
1514,2945,0,0,62,62,0,1,0,1,0
20754,1888,0,0,66,66,0,1,0,1,0
16951,255,0,0,62,62,0,1,0,1,0
4309,2587,0,0,62,62,0,1,0,1,0
2371,1147,0,0,62,62,0,1,0,1,0
3140,7,0,0,60,60,0,1,0,1,0
2966,2256,0,0,66,66,0,1,0,1,0
3674,7,0,0,60,60,0,1,0,1,0
20745,1880,0,0,66,66,0,1,0,1,0
19577,767,0,0,66,66,0,1,0,1,0
21045,1147,0,0,62,62,0,1,0,1,0
313,3216,0,0,65,65,0,1,0,1,0
11908,2611,0,0,66,66,0,1,0,1,0
21581,1888,0,0,70,70,0,1,0,1,0
16951,255,0,0,62,62,0,1,0,1,0
18830,254,0,0,60,60,0,1,0,1,0
5803,2589,0,0,62,62,0,1,0,1,0
7326,180,0,0,60,60,0,1,0,1,0
360,3105,0,0,832,832,0,1,0,1,0
11715,697,0,0,66,66,0,1,0,1,0
3976,1472,0,0,62,62,0,1,0,1,0
12151,2600,0,0,64,64,0,1,0,1,0
17452,2600,0,0,64,64,0,1,0,1,0
3023,2595,0,0,146,146,0,1,0,1,0
9214,3256,0,0,60,60,0,1,0,1,0
4982,2634,0,0,141,141,0,1,0,1,0
12576,1888,0,0,66,66,0,1,0,1,0
11893,2636,0,0,66,66,0,1,0,1,0
16951,255,0,0,62,62,0,1,0,1,0
22180,1580,0,0,66,66,0,1,0,1,0
3174,6,0,0,60,60,0,1,0,1,0
14421,1818,0,0,96,96,0,1,0,1,0
4206,1771,0,0,62,62,0,1,0,1,0
9244,6,0,0,60,60,0,1,0,1,0
5665,2881,0,0,67,67,0,1,0,1,0
14078,2901,0,0,68,68,0,1,0,1,0
3244,2611,0,0,66,66,0,1,0,1,0
636,407,0,0,143,143,0,1,0,1,0
14980,1771,0,0,66,66,0,1,0,1,0
17691,1888,0,0,62,62,0,1,0,1,0
12,959,0,0,97,97,0,1,0,1,0
360,3105,0,0,954,954,0,1,0,1,0
475,158,0,0,66,66,0,1,0,1,0
20257,2913,0,0,63,63,0,1,0,1,0
178,2486,0,0,62,62,0,1,0,1,0
18249,1771,0,0,66,66,0,1,0,1,0
16336,1472,0,0,62,62,0,1,0,1,0
20612,2751,0,0,63,63,0,1,0,1,0
10833,3172,0,0,66,66,0,1,0,1,0
10474,4,0,0,63,63,0,1,0,1,0
15694,1787,0,0,145,145,0,1,0,1,0
14365,3214,0,0,66,66,0,1,0,1,0
1237,1017,0,0,146,146,0,1,0,1,0
9693,2205,0,0,63,63,0,1,0,1,0
326,1888,0,0,62,62,0,1,0,1,0
16130,308,0,0,127,127,0,1,0,1,0
11916,2256,0,0,66,66,0,1,0,1,0
427,1216,0,0,61,61,0,1,0,1,0
1804,927,0,0,60,60,0,1,0,1,0
5048,1017,0,0,96,96,0,1,0,1,0
15859,3139,0,0,66,66,0,1,0,1,0
1423,1888,0,0,62,62,0,1,0,1,0
13,417,0,0,71,71,0,1,0,1,0
712,1147,0,0,62,62,0,1,0,1,0
21207,1888,0,0,65,65,0,1,0,1,0
20893,1888,0,0,66,66,0,1,0,1,0
12276,2256,0,0,64,64,0,1,0,1,0
5011,2477,0,0,60,60,0,1,0,1,0
23,2591,0,0,62,62,0,1,0,1,0
15267,1884,0,0,66,66,0,1,0,1,0
14079,1113,0,0,62,62,0,1,0,1,0
2525,2636,0,0,66,66,0,1,0,1,0
2506,1147,0,0,146,146,0,1,0,1,0
3106,1888,0,0,62,62,0,1,0,1,0
1475,2636,0,0,62,62,0,1,0,1,0
10165,1147,0,0,62,62,0,1,0,1,0
6409,2859,0,0,131,131,0,1,0,1,0
1758,3216,0,0,62,62,0,1,0,1,0
11450,1686,0,0,60,60,0,1,0,1,0
20162,2747,0,0,66,66,0,1,0,1,0
2966,2256,0,0,65,65,0,1,0,1,0
1752,1883,0,0,146,146,0,1,0,1,0
16951,255,0,0,62,62,0,1,0,1,0
19442,3216,0,0,65,65,0,1,0,1,0
6233,1646,0,0,60,60,0,1,0,1,0
12,3059,0,0,60,60,0,1,0,1,0
1343,2939,0,0,62,62,0,1,0,1,0
2024,2892,0,0,71,71,0,1,0,1,0
2303,1212,0,0,62,62,0,1,0,1,0
3079,3216,0,0,65,65,0,1,0,1,0
10869,1811,0,0,65,65,0,1,0,1,0
2448,2682,0,0,65,65,0,1,0,1,0
11756,1771,0,0,66,66,0,1,0,1,0
2967,2604,0,0,64,64,0,1,0,1,0
4065,697,0,0,64,64,0,1,0,1,0
16477,1017,0,0,66,66,0,1,0,1,0
10756,3216,0,0,66,66,0,1,0,1,0
7534,2938,0,0,65,65,0,1,0,1,0
1281,2543,0,0,60,60,0,1,0,1,0
22536,2381,0,0,66,66,0,1,0,1,0
10650,2881,0,0,66,66,0,1,0,1,0
2960,2587,0,0,63,63,0,1,0,1,0
9116,269,0,0,60,60,0,1,0,1,0
6395,1215,0,0,62,62,0,1,0,1,0
190,2938,0,0,78,78,0,1,0,1,0
16951,255,0,0,62,62,0,1,0,1,0
20,2587,0,0,62,62,0,1,0,1,0
14891,1017,0,0,120,120,0,1,0,1,0
23,3218,0,0,141,141,0,1,0,1,0
13,460,0,0,62,62,0,1,0,1,0
3071,2603,0,0,146,146,0,1,0,1,0
2293,460,0,0,66,66,0,1,0,1,0
2351,3151,0,0,65,65,0,1,0,1,0
0,0,0,0,98,98,0,1,0,1,0
1319,1472,0,0,125,125,0,1,0,1,0
5265,1147,0,0,62,62,0,1,0,1,0
9581,1147,0,0,65,65,0,1,0,1,0
2830,1017,0,0,62,62,0,1,0,1,0
8693,983,0,0,62,62,0,1,0,1,0
360,3105,0,0,977,977,0,1,0,1,0
22475,1017,0,0,62,62,0,1,0,1,0
20334,1147,0,0,62,62,0,1,0,1,0
16951,255,0,0,62,62,0,1,0,1,0
20472,2938,0,0,127,127,0,1,0,1,0
7339,334,0,0,60,60,0,1,0,1,0
7995,715,0,0,65,65,0,1,0,1,0
461,151,0,0,104,104,0,1,0,1,0
41,2938,0,0,62,62,0,1,0,1,0
6063,2938,0,0,62,62,0,1,0,1,0
1333,1472,0,0,66,66,0,1,0,1,0
9398,1150,0,0,62,62,0,1,0,1,0
9614,3105,0,0,86,86,0,1,0,1,0
10382,1837,0,0,63,63,0,1,0,1,0
2695,2256,0,0,62,62,0,1,0,1,0
698,7,0,0,60,60,0,1,0,1,0
3622,1147,0,0,64,64,0,1,0,1,0
1741,3216,0,0,135,135,0,1,0,1,0
3035,2587,0,0,65,65,0,1,0,1,0
11164,2713,0,0,66,66,0,1,0,1,0
8171,1073,0,0,60,60,0,1,0,1,0
15164,1147,0,0,79,79,0,1,0,1,0
360,3105,0,0,896,896,0,1,0,1,0
1657,1147,0,0,64,64,0,1,0,1,0
636,280,0,0,62,62,0,1,0,1,0
659,1054,0,0,65,65,0,1,0,1,0
11026,2938,0,0,66,66,0,1,0,1,0
7335,1072,0,0,60,60,0,1,0,1,0
7335,1070,0,0,60,60,0,1,0,1,0
16951,255,0,0,62,62,0,1,0,1,0
14590,1212,0,0,62,62,0,1,0,1,0
7460,1771,0,0,66,66,0,1,0,1,0
8114,2550,0,0,62,62,0,1,0,1,0
2084,1471,0,0,145,145,0,1,0,1,0
13849,1017,0,0,66,66,0,1,0,1,0
14190,3216,0,0,65,65,0,1,0,1,0
3115,1147,0,0,62,62,0,1,0,1,0
10474,2,0,0,68,68,0,1,0,1,0
8134,2566,0,0,146,146,0,1,0,1,0
317,1888,0,0,62,62,0,1,0,1,0
1269,1147,0,0,146,146,0,1,0,1,0
2148,105,0,0,60,60,0,1,0,1,0
3199,1206,0,0,130,130,0,1,0,1,0
844,2938,0,0,146,146,0,1,0,1,0
3726,1024,0,0,62,62,0,1,0,1,0
11181,2234,0,0,66,66,0,1,0,1,0
20994,3213,0,0,64,64,0,1,0,1,0
16951,255,0,0,62,62,0,1,0,1,0
11151,1017,0,0,66,66,0,1,0,1,0
241,1147,0,0,146,146,0,1,0,1,0
8164,2727,0,0,60,60,0,1,0,1,0
16951,255,0,0,62,62,0,1,0,1,0
19729,2747,0,0,61,61,0,1,0,1,0
16951,255,0,0,62,62,0,1,0,1,0
1067,2883,0,0,66,66,0,1,0,1,0
8830,1888,0,0,66,66,0,1,0,1,0
844,2938,0,0,146,146,0,1,0,1,0
801,2588,0,0,65,65,0,1,0,1,0
5666,1022,0,0,62,62,0,1,0,1,0
360,3105,0,0,164,164,0,1,0,1,0
16,2801,0,0,66,66,0,1,0,1,0
3989,2917,0,0,69,69,0,1,0,1,0
1512,1782,0,0,63,63,0,1,0,1,0
2509,3160,0,0,147,147,0,1,0,1,0
3021,1472,0,0,64,64,0,1,0,1,0
612,267,0,0,60,60,0,1,0,1,0
16951,255,0,0,62,62,0,1,0,1,0
21132,1827,0,0,66,66,0,1,0,1,0
2823,1017,0,0,62,62,0,1,0,1,0
17031,2600,0,0,63,63,0,1,0,1,0
1383,3216,0,0,62,62,0,1,0,1,0
3402,2587,0,0,62,62,0,1,0,1,0
636,420,0,0,133,133,0,1,0,1,0
4161,1147,0,0,66,66,0,1,0,1,0
3154,1472,0,0,62,62,0,1,0,1,0
8688,2644,0,0,128,128,0,1,0,1,0
17207,1117,0,0,66,66,0,1,0,1,0
16951,255,0,0,62,62,0,1,0,1,0
672,1147,0,0,66,66,0,1,0,1,0
20802,1147,0,0,66,66,0,1,0,1,0
1615,1017,0,0,74,74,0,1,0,1,0
11174,2521,0,0,62,62,0,1,0,1,0
1918,1500,0,0,62,62,0,1,0,1,0
14587,1178,0,0,62,62,0,1,0,1,0
9781,1804,0,0,63,63,0,1,0,1,0
13539,2636,0,0,64,64,0,1,0,1,0
18559,1023,0,0,66,66,0,1,0,1,0
18554,2587,0,0,63,63,0,1,0,1,0
10165,3206,0,0,63,63,0,1,0,1,0
2630,1287,0,0,66,66,0,1,0,1,0
12479,3216,0,0,66,66,0,1,0,1,0
20003,2558,0,0,64,64,0,1,0,1,0
1809,936,0,0,60,60,0,1,0,1,0
7339,237,0,0,60,60,0,1,0,1,0
2677,2595,0,0,70,70,0,1,0,1,0
793,1888,0,0,62,62,0,1,0,1,0
14343,1787,0,0,60,60,0,1,0,1,0
16951,255,0,0,62,62,0,1,0,1,0
14025,1888,0,0,66,66,0,1,0,1,0
18407,2639,0,0,66,66,0,1,0,1,0
6166,1367,0,0,132,132,0,1,0,1,0
9614,3105,0,0,86,86,0,1,0,1,0
1274,509,0,0,62,62,0,1,0,1,0
22255,1215,0,0,65,65,0,1,0,1,0
6263,1017,0,0,66,66,0,1,0,1,0
10154,1472,0,0,65,65,0,1,0,1,0
6842,1177,0,0,62,62,0,1,0,1,0
2132,1888,0,0,62,62,0,1,0,1,0
20931,1017,0,0,64,64,0,1,0,1,0
7339,170,0,0,60,60,0,1,0,1,0
1525,1444,0,0,145,145,0,1,0,1,0
1868,1017,0,0,63,63,0,1,0,1,0
7268,7,0,0,60,60,0,1,0,1,0
3396,2587,0,0,146,146,0,1,0,1,0
659,1054,0,0,62,62,0,1,0,1,0
21370,1147,0,0,62,62,0,1,0,1,0
2995,2256,0,0,62,62,0,1,0,1,0
16951,255,0,0,62,62,0,1,0,1,0
2844,2942,0,0,85,85,0,1,0,1,0
17422,2592,0,0,66,66,0,1,0,1,0
17119,697,0,0,66,66,0,1,0,1,0
3780,2938,0,0,66,66,0,1,0,1,0
8043,1888,0,0,62,62,0,1,0,1,0
3647,1017,0,0,62,62,0,1,0,1,0
9698,3216,0,0,66,66,0,1,0,1,0
9273,6,0,0,60,60,0,1,0,1,0
15576,1801,0,0,62,62,0,1,0,1,0
2776,1017,0,0,63,63,0,1,0,1,0
13,1907,0,0,66,66,0,1,0,1,0
11014,1147,0,0,64,64,0,1,0,1,0
4087,1017,0,0,62,62,0,1,0,1,0
693,2256,0,0,66,66,0,1,0,1,0
16951,255,0,0,62,62,0,1,0,1,0
3058,3262,0,0,60,60,0,1,0,1,0
15894,3139,0,0,66,66,0,1,0,1,0
1542,2942,0,0,63,63,0,1,0,1,0
1328,802,0,0,62,62,0,1,0,1,0
12067,1215,0,0,62,62,0,1,0,1,0
12321,1017,0,0,66,66,0,1,0,1,0
3060,1888,0,0,72,72,0,1,0,1,0
9085,1206,0,0,117,117,0,1,0,1,0
19,1773,0,0,62,62,0,1,0,1,0
16951,255,0,0,62,62,0,1,0,1,0
1900,2938,0,0,62,62,0,1,0,1,0
16951,255,0,0,62,62,0,1,0,1,0
1547,2625,0,0,62,62,0,1,0,1,0
2253,1011,0,0,62,62,0,1,0,1,0
10479,7,0,0,60,60,0,1,0,1,0
2432,2880,0,0,66,66,0,1,0,1,0
2287,2256,0,0,62,62,0,1,0,1,0
286,3167,0,0,64,64,0,1,0,1,0
12,312,0,0,60,60,0,1,0,1,0
1824,2853,0,0,62,62,0,1,0,1,0
2632,1932,0,0,62,62,0,1,0,1,0
16951,255,0,0,62,62,0,1,0,1,0
6280,1017,0,0,63,63,0,1,0,1,0
14139,3215,0,0,62,62,0,1,0,1,0
16951,255,0,0,62,62,0,1,0,1,0
16951,255,0,0,62,62,0,1,0,1,0
16527,983,0,0,63,63,0,1,0,1,0
5760,2112,0,0,155,155,0,1,0,1,0
3849,2921,0,0,66,66,0,1,0,1,0
8827,1017,0,0,63,63,0,1,0,1,0
16951,255,0,0,62,62,0,1,0,1,0
15694,344,0,0,145,145,0,1,0,1,0
11612,2610,0,0,66,66,0,1,0,1,0
6166,1367,0,0,72,72,0,1,0,1,0
10214,3026,0,0,62,62,0,1,0,1,0
21361,1147,0,0,62,62,0,1,0,1,0
7458,1771,0,0,66,66,0,1,0,1,0
16951,255,0,0,62,62,0,1,0,1,0
8682,1792,0,0,62,62,0,1,0,1,0
20043,695,0,0,62,62,0,1,0,1,0
17622,2660,0,0,62,62,0,1,0,1,0
839,2,0,0,61,61,0,1,0,1,0
3184,1888,0,0,62,62,0,1,0,1,0
16023,2256,0,0,64,64,0,1,0,1,0
2016,3216,0,0,62,62,0,1,0,1,0
10474,2938,0,0,72,72,0,1,0,1,0
11539,1472,0,0,66,66,0,1,0,1,0
323,1888,0,0,62,62,0,1,0,1,0
2996,2573,0,0,62,62,0,1,0,1,0
16096,2614,0,0,66,66,0,1,0,1,0
10165,1147,0,0,66,66,0,1,0,1,0
18,2938,0,0,62,62,0,1,0,1,0
17779,2612,0,0,66,66,0,1,0,1,0
4954,2611,0,0,62,62,0,1,0,1,0
450,1790,0,0,66,66,0,1,0,1,0
636,280,0,0,146,146,0,1,0,1,0
9449,2496,0,0,107,107,0,1,0,1,0
2752,2611,0,0,72,72,0,1,0,1,0
11084,1017,0,0,80,80,0,1,0,1,0
19244,3130,0,0,62,62,0,1,0,1,0
19820,2787,0,0,60,60,0,1,0,1,0
11531,2256,0,0,62,62,0,1,0,1,0
20659,2953,0,0,65,65,0,1,0,1,0
16448,1017,0,0,66,66,0,1,0,1,0
7326,180,0,0,60,60,0,1,0,1,0
1635,1818,0,0,62,62,0,1,0,1,0
21641,1147,0,0,62,62,0,1,0,1,0
12872,1804,0,0,62,62,0,1,0,1,0
2504,2587,0,0,146,146,0,1,0,1,0
36,1804,0,0,64,64,0,1,0,1,0
16951,255,0,0,62,62,0,1,0,1,0
19130,2787,0,0,62,62,0,1,0,1,0
3317,1888,0,0,66,66,0,1,0,1,0
2772,3216,0,0,63,63,0,1,0,1,0
10276,3216,0,0,62,62,0,1,0,1,0
1259,2256,0,0,62,62,0,1,0,1,0
21819,3216,0,0,66,66,0,1,0,1,0
17636,2587,0,0,66,66,0,1,0,1,0
1294,2587,0,0,66,66,0,1,0,1,0
7004,1563,0,0,64,64,0,1,0,1,0
495,2587,0,0,62,62,0,1,0,1,0
8,1873,0,0,60,60,0,1,0,1,0
13236,1804,0,0,66,66,0,1,0,1,0
16951,255,0,0,62,62,0,1,0,1,0
15694,344,0,0,145,145,0,1,0,1,0
20018,2507,0,0,145,145,0,1,0,1,0
16114,2611,0,0,62,62,0,1,0,1,0
17464,2945,0,0,66,66,0,1,0,1,0
18741,1086,0,0,63,63,0,1,0,1,0
14505,2312,0,0,78,78,0,1,0,1,0
10610,2256,0,0,66,66,0,1,0,1,0
10651,1147,0,0,66,66,0,1,0,1,0
1437,2577,0,0,62,62,0,1,0,1,0
326,1888,0,0,62,62,0,1,0,1,0
14244,2883,0,0,66,66,0,1,0,1,0
16951,255,0,0,62,62,0,1,0,1,0
2386,2256,0,0,62,62,0,1,0,1,0
9706,1888,0,0,66,66,0,1,0,1,0
386,1147,0,0,62,62,0,1,0,1,0
20861,1017,0,0,75,75,0,1,0,1,0
1997,2256,0,0,66,66,0,1,0,1,0
16085,1771,0,0,66,66,0,1,0,1,0
9073,1147,0,0,64,64,0,1,0,1,0
6694,1843,0,0,64,64,0,1,0,1,0
8049,2868,0,0,68,68,0,1,0,1,0
11548,1017,0,0,65,65,0,1,0,1,0
249,2605,0,0,66,66,0,1,0,1,0
2842,1888,0,0,65,65,0,1,0,1,0
18995,2585,0,0,146,146,0,1,0,1,0
21931,1151,0,0,66,66,0,1,0,1,0
13862,2731,0,0,66,66,0,1,0,1,0
8061,2256,0,0,62,62,0,1,0,1,0
19589,2256,0,0,62,62,0,1,0,1,0
16951,255,0,0,62,62,0,1,0,1,0
4557,2256,0,0,66,66,0,1,0,1,0
8475,1017,0,0,66,66,0,1,0,1,0
475,1287,0,0,64,64,0,1,0,1,0
2928,3216,0,0,64,64,0,1,0,1,0
791,178,0,0,60,60,0,1,0,1,0
14798,2299,0,0,64,64,0,1,0,1,0
19838,1017,0,0,66,66,0,1,0,1,0
17225,1147,0,0,66,66,0,1,0,1,0
2588,3216,0,0,62,62,0,1,0,1,0
21090,1147,0,0,66,66,0,1,0,1,0
14068,3216,0,0,66,66,0,1,0,1,0
12402,2253,0,0,62,62,0,1,0,1,0
13085,1915,0,0,119,119,0,1,0,1,0
6882,1098,0,0,65,65,0,1,0,1,0
16951,255,0,0,62,62,0,1,0,1,0
525,369,1683,221,475,475,0,1,0,1,0
4074,1017,0,0,62,62,0,1,0,1,0
14461,295,0,0,61,61,0,1,0,1,0
16844,2938,0,0,66,66,0,1,0,1,0
2996,2573,0,0,62,62,0,1,0,1,0
16951,255,0,0,62,62,0,1,0,1,0
1860,241,0,0,61,61,0,1,0,1,0
10123,1795,0,0,60,60,0,1,0,1,0
3054,1147,0,0,62,62,0,1,0,1,0
360,3105,0,0,604,604,0,1,0,1,0
9430,2240,0,0,66,66,0,1,0,1,0
17095,2241,0,0,122,122,0,1,0,1,0
1802,790,0,0,61,61,0,1,0,1,0
4345,1147,0,0,64,64,0,1,0,1,0
10474,2938,0,0,72,72,0,1,0,1,0
1327,801,0,0,62,62,0,1,0,1,0
16951,255,0,0,62,62,0,1,0,1,0
579,2630,0,0,62,62,0,1,0,1,0
21766,1888,0,0,62,62,0,1,0,1,0
293,1472,0,0,62,62,0,1,0,1,0
1964,1472,0,0,62,62,0,1,0,1,0
15140,427,0,0,78,78,0,1,0,1,0
12,201,0,0,96,96,0,1,0,1,0
15916,1005,0,0,62,62,0,1,0,1,0
18102,3216,0,0,64,64,0,1,0,1,0
14175,1156,0,0,66,66,0,1,0,1,0
16039,1147,0,0,64,64,0,1,0,1,0
9819,2883,0,0,66,66,0,1,0,1,0
6465,2938,0,0,62,62,0,1,0,1,0
22615,1215,0,0,62,62,0,1,0,1,0
619,2821,0,0,122,122,0,1,0,1,0
8370,1746,0,0,106,106,0,1,0,1,0
20881,1017,0,0,62,62,0,1,0,1,0
8658,509,0,0,66,66,0,1,0,1,0
6055,2883,0,0,64,64,0,1,0,1,0
7908,544,0,0,146,146,0,1,0,1,0
16478,384,0,0,60,60,0,1,0,1,0
2505,1134,0,0,148,148,0,1,0,1,0
2262,2636,0,0,62,62,0,1,0,1,0
16951,255,0,0,62,62,0,1,0,1,0
1693,2938,0,0,72,72,0,1,0,1,0
2838,2587,0,0,146,146,0,1,0,1,0
14058,1162,0,0,65,65,0,1,0,1,0
16951,255,0,0,62,62,0,1,0,1,0
1678,1888,0,0,62,62,0,1,0,1,0
10510,2751,0,0,72,72,0,1,0,1,0
14601,1017,0,0,66,66,0,1,0,1,0
683,1017,0,0,62,62,0,1,0,1,0
5056,2622,0,0,63,63,0,1,0,1,0
3167,1771,0,0,62,62,0,1,0,1,0
154,3216,0,0,63,63,0,1,0,1,0
13,2248,0,0,78,78,0,1,0,1,0
15073,2901,0,0,145,145,0,1,0,1,0
10401,2256,0,0,66,66,0,1,0,1,0
148,2623,0,0,64,64,0,1,0,1,0
12960,3216,0,0,66,66,0,1,0,1,0
17570,1771,0,0,62,62,0,1,0,1,0
8,2758,0,0,60,60,0,1,0,1,0
2837,1888,0,0,63,63,0,1,0,1,0
16951,255,0,0,62,62,0,1,0,1,0
10261,427,0,0,66,66,0,1,0,1,0
1271,1147,0,0,146,146,0,1,0,1,0
16951,255,0,0,62,62,0,1,0,1,0
636,280,0,0,146,146,0,1,0,1,0
2004,2256,0,0,66,66,0,1,0,1,0
6889,1887,0,0,62,62,0,1,0,1,0
3424,2184,0,0,111,111,0,1,0,1,0
2529,1124,0,0,150,150,0,1,0,1,0
13190,1011,0,0,65,65,0,1,0,1,0
10272,2883,0,0,65,65,0,1,0,1,0
5414,1024,0,0,66,66,0,1,0,1,0
429,2587,0,0,62,62,0,1,0,1,0
16878,2256,0,0,62,62,0,1,0,1,0
18,2379,0,0,62,62,0,1,0,1,0
275,9,0,0,60,60,0,1,0,1,0
2209,7,0,0,60,60,0,1,0,1,0
18044,956,0,0,63,63,0,1,0,1,0
5170,1017,0,0,66,66,0,1,0,1,0
17286,509,0,0,66,66,0,1,0,1,0
1804,1763,0,0,60,60,0,1,0,1,0
13153,3206,0,0,62,62,0,1,0,1,0
12,962,0,0,92,92,0,1,0,1,0
16951,255,0,0,62,62,0,1,0,1,0
2654,3216,0,0,62,62,0,1,0,1,0
15643,2938,0,0,62,62,0,1,0,1,0
12,122,0,0,100,100,0,1,0,1,0
21477,172,0,0,66,66,0,1,0,1,0
21179,2256,0,0,62,62,0,1,0,1,0
15254,2636,0,0,101,101,0,1,0,1,0
9819,2883,0,0,66,66,0,1,0,1,0
1484,1147,0,0,62,62,0,1,0,1,0
3117,1776,0,0,146,146,0,1,0,1,0
6506,697,0,0,62,62,0,1,0,1,0
20112,2935,0,0,120,120,0,1,0,1,0
11140,2256,0,0,66,66,0,1,0,1,0
1374,1888,0,0,62,62,0,1,0,1,0
17807,2624,0,0,66,66,0,1,0,1,0
17741,1888,0,0,63,63,0,1,0,1,0
19447,1881,0,0,66,66,0,1,0,1,0
13562,3051,0,0,63,63,0,1,0,1,0
12036,2592,0,0,66,66,0,1,0,1,0
10475,6,0,0,60,60,0,1,0,1,0
17740,1888,0,0,62,62,0,1,0,1,0
3110,2890,0,0,65,65,0,1,0,1,0
14886,1804,0,0,66,66,0,1,0,1,0
15694,341,0,0,145,145,0,1,0,1,0
2304,1215,0,0,62,62,0,1,0,1,0
20922,1888,0,0,62,62,0,1,0,1,0
13455,2582,0,0,86,86,0,1,0,1,0
11466,2606,0,0,71,71,0,1,0,1,0
333,2587,0,0,102,102,0,1,0,1,0
16951,255,0,0,62,62,0,1,0,1,0
20699,2697,0,0,78,78,0,1,0,1,0
360,3105,0,0,278,278,0,1,0,1,0
2897,1888,0,0,62,62,0,1,0,1,0
13096,1025,0,0,66,66,0,1,0,1,0
4063,697,0,0,64,64,0,1,0,1,0
3047,7,0,0,60,60,0,1,0,1,0
2121,3216,0,0,62,62,0,1,0,1,0
15278,2587,0,0,62,62,0,1,0,1,0
1330,697,0,0,100,100,0,1,0,1,0
1804,3208,0,0,60,60,0,1,0,1,0
2254,1472,0,0,66,66,0,1,0,1,0
12973,263,0,0,73,73,0,1,0,1,0
10293,2883,0,0,66,66,0,1,0,1,0
10467,270,0,0,70,70,0,1,0,1,0
1525,1444,0,0,145,145,0,1,0,1,0
16661,2587,0,0,62,62,0,1,0,1,0
650,203,0,0,110,110,0,1,0,1,0
3164,1147,0,0,146,146,0,1,0,1,0
22086,1863,0,0,65,65,0,1,0,1,0
617,1215,0,0,64,64,0,1,0,1,0
7635,1188,0,0,60,60,0,1,0,1,0
2051,1147,0,0,62,62,0,1,0,1,0
7910,2938,0,0,81,81,0,1,0,1,0
20060,2600,0,0,146,146,0,1,0,1,0
429,2587,0,0,62,62,0,1,0,1,0
20607,1150,0,0,72,72,0,1,0,1,0
16951,255,0,0,62,62,0,1,0,1,0
7522,2944,0,0,63,63,0,1,0,1,0
13191,998,0,0,66,66,0,1,0,1,0
819,2419,0,0,60,60,0,1,0,1,0
1715,2862,0,0,145,145,0,1,0,1,0
3067,2938,0,0,60,60,0,1,0,1,0
1977,1120,0,0,62,62,0,1,0,1,0
844,7,0,0,60,60,0,1,0,1,0
1525,1444,0,0,145,145,0,1,0,1,0
14590,1783,0,0,65,65,0,1,0,1,0
342,1765,0,0,64,64,0,1,0,1,0
636,280,0,0,146,146,0,1,0,1,0
16951,255,0,0,62,62,0,1,0,1,0
16985,1827,0,0,71,71,0,1,0,1,0
1414,1888,0,0,62,62,0,1,0,1,0
8,442,0,0,60,60,0,1,0,1,0
18,3216,0,0,62,62,0,1,0,1,0
4973,1025,0,0,60,60,0,1,0,1,0
15842,3205,0,0,66,66,0,1,0,1,0
10786,3216,0,0,65,65,0,1,0,1,0
16951,255,0,0,62,62,0,1,0,1,0
16951,255,0,0,62,62,0,1,0,1,0
8116,2578,0,0,62,62,0,1,0,1,0
1373,1888,0,0,62,62,0,1,0,1,0
12,641,0,0,158,158,0,1,0,1,0
12711,1888,0,0,66,66,0,1,0,1,0
4285,1147,0,0,65,65,0,1,0,1,0
16951,255,0,0,62,62,0,1,0,1,0
21263,1147,0,0,116,116,0,1,0,1,0
1988,1771,0,0,146,146,0,1,0,1,0
7926,1147,0,0,62,62,0,1,0,1,0
1737,2544,0,0,146,146,0,1,0,1,0
564,1888,0,0,66,66,0,1,0,1,0
18039,1771,0,0,66,66,0,1,0,1,0
1942,3212,0,0,65,65,0,1,0,1,0
18244,1771,0,0,66,66,0,1,0,1,0
12876,2559,0,0,62,62,0,1,0,1,0
6725,2583,0,0,64,64,0,1,0,1,0
22023,3153,0,0,66,66,0,1,0,1,0
11393,136,0,0,60,60,0,1,0,1,0
7957,2587,0,0,62,62,0,1,0,1,0
1282,1147,0,0,62,62,0,1,0,1,0
15846,1539,0,0,63,63,0,1,0,1,0
79,1147,0,0,62,62,0,1,0,1,0
19820,2787,0,0,60,60,0,1,0,1,0
3506,2256,0,0,62,62,0,1,0,1,0
17219,1137,0,0,65,65,0,1,0,1,0
13547,1147,0,0,110,110,0,1,0,1,0
8065,1147,0,0,66,66,0,1,0,1,0
5929,2601,0,0,62,62,0,1,0,1,0
3072,1888,0,0,66,66,0,1,0,1,0
2908,1017,0,0,62,62,0,1,0,1,0
16536,2371,0,0,70,70,0,1,0,1,0
1840,2585,0,0,62,62,0,1,0,1,0
7949,315,0,0,60,60,0,1,0,1,0
17821,2938,0,0,62,62,0,1,0,1,0
19776,1017,0,0,66,66,0,1,0,1,0
2005,2587,0,0,146,146,0,1,0,1,0
3876,1923,0,0,62,62,0,1,0,1,0
9765,2587,0,0,66,66,0,1,0,1,0
15694,341,0,0,145,145,0,1,0,1,0
4544,2256,0,0,66,66,0,1,0,1,0
7982,1147,0,0,62,62,0,1,0,1,0
2623,1211,0,0,66,66,0,1,0,1,0
1854,2587,0,0,146,146,0,1,0,1,0
17723,2883,0,0,66,66,0,1,0,1,0
12064,3124,0,0,64,64,0,1,0,1,0
2185,1147,0,0,75,75,0,1,0,1,0
12516,1795,0,0,60,60,0,1,0,1,0
18333,1149,0,0,66,66,0,1,0,1,0
742,1017,0,0,66,66,0,1,0,1,0
640,142,0,0,108,108,0,1,0,1,0
2725,1017,0,0,66,66,0,1,0,1,0
729,1147,0,0,62,62,0,1,0,1,0
15196,2587,0,0,62,62,0,1,0,1,0
1321,797,0,0,62,62,0,1,0,1,0
636,280,0,0,146,146,0,1,0,1,0
2759,2611,0,0,64,64,0,1,0,1,0
16720,2587,0,0,62,62,0,1,0,1,0
7524,1140,0,0,62,62,0,1,0,1,0
20438,445,0,0,130,130,0,1,0,1,0
2843,2626,0,0,146,146,0,1,0,1,0
22255,1720,0,0,62,62,0,1,0,1,0
19792,3215,0,0,66,66,0,1,0,1,0
21078,1771,0,0,66,66,0,1,0,1,0
15694,334,0,0,145,145,0,1,0,1,0
3030,2594,0,0,146,146,0,1,0,1,0
183,2932,0,0,76,76,0,1,0,1,0
13074,181,0,0,60,60,0,1,0,1,0
16233,903,0,0,66,66,0,1,0,1,0
20911,3139,0,0,63,63,0,1,0,1,0
2408,1767,0,0,63,63,0,1,0,1,0
15840,3216,0,0,66,66,0,1,0,1,0
612,225,0,0,60,60,0,1,0,1,0
14582,1147,0,0,62,62,0,1,0,1,0
2543,1795,0,0,62,62,0,1,0,1,0
22440,1033,0,0,63,63,0,1,0,1,0
21092,1215,0,0,66,66,0,1,0,1,0
17318,449,0,0,61,61,0,1,0,1,0
3147,2587,0,0,65,65,0,1,0,1,0
12,2419,0,0,85,85,0,1,0,1,0
3876,1923,0,0,62,62,0,1,0,1,0
21038,1147,0,0,62,62,0,1,0,1,0
19296,2667,0,0,69,69,0,1,0,1,0
15462,1023,0,0,75,75,0,1,0,1,0
7326,1649,0,0,60,60,0,1,0,1,0
1779,2585,0,0,65,65,0,1,0,1,0
360,3105,0,0,481,481,0,1,0,1,0
14199,2219,0,0,66,66,0,1,0,1,0
1699,1147,0,0,146,146,0,1,0,1,0
13319,1215,0,0,65,65,0,1,0,1,0
56,1867,0,0,141,141,0,1,0,1,0
19408,1880,0,0,66,66,0,1,0,1,0
9154,255,0,0,60,60,0,1,0,1,0
7513,3216,0,0,62,62,0,1,0,1,0
360,3105,0,0,899,899,0,1,0,1,0
659,999,0,0,146,146,0,1,0,1,0
19996,3117,0,0,66,66,0,1,0,1,0
17372,383,0,0,66,66,0,1,0,1,0
395,1888,0,0,64,64,0,1,0,1,0
20744,2609,0,0,62,62,0,1,0,1,0
13074,185,0,0,60,60,0,1,0,1,0
16951,255,0,0,62,62,0,1,0,1,0
4253,3133,0,0,145,145,0,1,0,1,0
2014,1888,0,0,62,62,0,1,0,1,0
3218,402,0,0,65,65,0,1,0,1,0
208,1771,0,0,64,64,0,1,0,1,0
19576,2256,0,0,66,66,0,1,0,1,0
17300,2611,0,0,62,62,0,1,0,1,0
2396,1147,0,0,62,62,0,1,0,1,0
11941,3216,0,0,62,62,0,1,0,1,0
6376,2910,0,0,70,70,0,1,0,1,0
9214,3256,0,0,60,60,0,1,0,1,0
16951,255,0,0,62,62,0,1,0,1,0
9767,2587,0,0,66,66,0,1,0,1,0
1982,2636,0,0,62,62,0,1,0,1,0
21573,3216,0,0,62,62,0,1,0,1,0
10621,2619,0,0,66,66,0,1,0,1,0
4501,2155,0,0,62,62,0,1,0,1,0
8392,2060,0,0,158,158,0,1,0,1,0
7653,1224,0,0,60,60,0,1,0,1,0
3443,1888,0,0,62,62,0,1,0,1,0
2980,2256,0,0,64,64,0,1,0,1,0
360,3105,0,0,1093,1093,0,1,0,1,0
9254,1473,0,0,62,62,0,1,0,1,0
15736,1521,0,0,121,121,0,1,0,1,0
1853,1798,0,0,146,146,0,1,0,1,0
40,696,0,0,61,61,0,1,0,1,0
8164,2728,0,0,60,60,0,1,0,1,0
438,2869,0,0,63,63,0,1,0,1,0
16951,255,0,0,62,62,0,1,0,1,0
2972,2636,0,0,62,62,0,1,0,1,0
2974,1888,0,0,62,62,0,1,0,1,0
4496,1147,0,0,62,62,0,1,0,1,0
1755,1032,0,0,146,146,0,1,0,1,0
13054,1183,0,0,64,64,0,1,0,1,0
1153,138,0,0,60,60,0,1,0,1,0
16951,255,0,0,62,62,0,1,0,1,0
5178,1017,0,0,63,63,0,1,0,1,0
16368,2256,0,0,66,66,0,1,0,1,0
1122,13,0,0,60,60,0,1,0,1,0
2265,1017,0,0,95,95,0,1,0,1,0
190,2938,0,0,78,78,0,1,0,1,0
2032,1147,0,0,146,146,0,1,0,1,0
16278,1882,0,0,66,66,0,1,0,1,0
9214,3256,0,0,60,60,0,1,0,1,0
1597,2587,0,0,65,65,0,1,0,1,0
15896,2938,0,0,66,66,0,1,0,1,0
2467,2853,0,0,72,72,0,1,0,1,0
326,1888,0,0,62,62,0,1,0,1,0
6370,2600,0,0,62,62,0,1,0,1,0
14464,3216,0,0,66,66,0,1,0,1,0
4304,1147,0,0,111,111,0,1,0,1,0
13348,2627,0,0,66,66,0,1,0,1,0
20994,696,0,0,66,66,0,1,0,1,0
768,3194,0,0,61,61,0,1,0,1,0
2759,1147,0,0,65,65,0,1,0,1,0
18185,1017,0,0,65,65,0,1,0,1,0
7335,1072,0,0,60,60,0,1,0,1,0
13643,2573,0,0,66,66,0,1,0,1,0
2623,1147,0,0,66,66,0,1,0,1,0
1611,2610,0,0,65,65,0,1,0,1,0
5297,1147,0,0,62,62,0,1,0,1,0
17620,2587,0,0,66,66,0,1,0,1,0
5067,1147,0,0,66,66,0,1,0,1,0
14122,2587,0,0,62,62,0,1,0,1,0
490,2226,0,0,65,65,0,1,0,1,0
16058,1147,0,0,124,124,0,1,0,1,0
17578,418,0,0,62,62,0,1,0,1,0
17716,2883,0,0,66,66,0,1,0,1,0
14067,1147,0,0,65,65,0,1,0,1,0
654,1888,0,0,62,62,0,1,0,1,0
7568,392,0,0,67,67,0,1,0,1,0
6651,1129,0,0,156,156,0,1,0,1,0
16645,2608,0,0,63,63,0,1,0,1,0
16363,1472,0,0,62,62,0,1,0,1,0
63,1147,0,0,146,146,0,1,0,1,0
594,1038,0,0,66,66,0,1,0,1,0
15197,1147,0,0,65,65,0,1,0,1,0
2907,1017,0,0,62,62,0,1,0,1,0
16951,255,0,0,62,62,0,1,0,1,0
1281,2543,0,0,60,60,0,1,0,1,0
3072,1888,0,0,66,66,0,1,0,1,0
21236,1903,0,0,62,62,0,1,0,1,0
14158,2294,0,0,66,66,0,1,0,1,0
1433,2604,0,0,62,62,0,1,0,1,0
1868,1017,0,0,63,63,0,1,0,1,0
8112,447,0,0,84,84,0,1,0,1,0
1853,1,0,0,61,61,0,1,0,1,0
244,7,0,0,60,60,0,1,0,1,0
19809,1017,0,0,63,63,0,1,0,1,0
1329,2636,0,0,66,66,0,1,0,1,0
4117,1472,0,0,145,145,0,1,0,1,0
9216,1021,0,0,65,65,0,1,0,1,0
576,2613,0,0,62,62,0,1,0,1,0
5832,227,0,0,60,60,0,1,0,1,0
19305,1133,0,0,65,65,0,1,0,1,0
13479,1472,0,0,66,66,0,1,0,1,0
10,3056,0,0,1493,1493,0,1,0,1,0
17033,1797,0,0,67,67,0,1,0,1,0
1591,986,0,0,146,146,0,1,0,1,0
612,267,0,0,60,60,0,1,0,1,0
637,1715,0,0,149,149,0,1,0,1,0
2571,997,0,0,66,66,0,1,0,1,0
16951,255,0,0,62,62,0,1,0,1,0
3911,1147,0,0,62,62,0,1,0,1,0
6761,5,0,0,60,60,0,1,0,1,0
12816,2882,0,0,66,66,0,1,0,1,0
2070,1888,0,0,62,62,0,1,0,1,0
2161,7,0,0,60,60,0,1,0,1,0
6694,1841,0,0,64,64,0,1,0,1,0
11949,2256,0,0,64,64,0,1,0,1,0
12614,1147,0,0,63,63,0,1,0,1,0
528,3206,0,0,62,62,0,1,0,1,0
7534,1804,0,0,64,64,0,1,0,1,0
2284,1147,0,0,63,63,0,1,0,1,0
16951,255,0,0,62,62,0,1,0,1,0
887,330,0,0,61,61,0,1,0,1,0
29,1888,0,0,62,62,0,1,0,1,0
16261,1888,0,0,64,64,0,1,0,1,0
18547,1017,0,0,62,62,0,1,0,1,0
11369,2836,0,0,66,66,0,1,0,1,0
1525,1444,0,0,145,145,0,1,0,1,0
53,2616,0,0,62,62,0,1,0,1,0
21182,3216,0,0,64,64,0,1,0,1,0
16951,255,0,0,62,62,0,1,0,1,0
1476,1771,0,0,62,62,0,1,0,1,0
221,1007,0,0,62,62,0,1,0,1,0
1133,2938,0,0,78,78,0,1,0,1,0
2449,2866,0,0,69,69,0,1,0,1,0
14614,3216,0,0,62,62,0,1,0,1,0
1240,1017,0,0,146,146,0,1,0,1,0
1595,1741,0,0,63,63,0,1,0,1,0
12887,2545,0,0,62,62,0,1,0,1,0
7273,1888,0,0,62,62,0,1,0,1,0
387,1147,0,0,62,62,0,1,0,1,0
11450,1686,0,0,60,60,0,1,0,1,0
16951,255,0,0,62,62,0,1,0,1,0
16951,255,0,0,62,62,0,1,0,1,0
20232,1761,0,0,62,62,0,1,0,1,0
20998,3215,0,0,62,62,0,1,0,1,0
7035,2938,0,0,72,72,0,1,0,1,0
21327,1827,0,0,64,64,0,1,0,1,0
21908,1797,0,0,63,63,0,1,0,1,0
12773,2240,0,0,63,63,0,1,0,1,0
16171,1367,0,0,60,60,0,1,0,1,0
2084,1471,0,0,145,145,0,1,0,1,0
47,670,0,0,147,147,0,1,0,1,0
21918,1162,0,0,62,62,0,1,0,1,0
8221,2587,0,0,62,62,0,1,0,1,0
87,2755,0,0,64,64,0,1,0,1,0
1402,2938,0,0,62,62,0,1,0,1,0
16538,480,0,0,66,66,0,1,0,1,0
14942,2252,0,0,66,66,0,1,0,1,0
3594,1881,0,0,62,62,0,1,0,1,0
14157,2587,0,0,66,66,0,1,0,1,0
2659,2611,0,0,78,78,0,1,0,1,0
18419,1798,0,0,65,65,0,1,0,1,0
12,3144,0,0,90,90,0,1,0,1,0
11450,1017,0,0,62,62,0,1,0,1,0
9795,3216,0,0,63,63,0,1,0,1,0
12474,3216,0,0,66,66,0,1,0,1,0
16951,255,0,0,62,62,0,1,0,1,0
2236,2599,0,0,63,63,0,1,0,1,0
17318,1147,0,0,62,62,0,1,0,1,0
3153,1771,0,0,62,62,0,1,0,1,0
2588,2089,0,0,99,99,0,1,0,1,0
10614,2452,0,0,66,66,0,1,0,1,0
1937,509,0,0,62,62,0,1,0,1,0
22644,277,0,0,64,64,0,1,0,1,0
21374,3004,0,0,66,66,0,1,0,1,0
9252,1472,0,0,65,65,0,1,0,1,0
16951,255,0,0,62,62,0,1,0,1,0
17579,2587,0,0,65,65,0,1,0,1,0
12,3074,0,0,320,320,0,1,0,1,0
16928,3139,0,0,63,63,0,1,0,1,0
5186,1888,0,0,62,62,0,1,0,1,0
12042,1825,0,0,64,64,0,1,0,1,0
11468,2229,0,0,63,63,0,1,0,1,0
243,1884,0,0,66,66,0,1,0,1,0
16951,255,0,0,62,62,0,1,0,1,0
4202,1771,0,0,146,146,0,1,0,1,0
21391,3020,0,0,66,66,0,1,0,1,0
12969,976,0,0,66,66,0,1,0,1,0
18613,2603,0,0,62,62,0,1,0,1,0
18556,1022,0,0,66,66,0,1,0,1,0
16635,2668,0,0,64,64,0,1,0,1,0
7271,3,0,0,61,61,0,1,0,1,0
13236,1804,0,0,66,66,0,1,0,1,0
14845,2680,0,0,63,63,0,1,0,1,0
7339,237,0,0,60,60,0,1,0,1,0
776,3266,0,0,155,155,0,1,0,1,0
2155,2938,0,0,62,62,0,1,0,1,0
16951,255,0,0,62,62,0,1,0,1,0
10520,14,0,0,63,63,0,1,0,1,0
10227,509,0,0,63,63,0,1,0,1,0
74,3216,0,0,66,66,0,1,0,1,0
13212,3144,0,0,65,65,0,1,0,1,0
19302,3214,0,0,66,66,0,1,0,1,0
11158,1880,0,0,65,65,0,1,0,1,0
9473,1017,0,0,64,64,0,1,0,1,0
14030,2235,0,0,66,66,0,1,0,1,0
12848,2153,0,0,62,62,0,1,0,1,0
16951,255,0,0,62,62,0,1,0,1,0
21594,2938,0,0,62,62,0,1,0,1,0
13472,2587,0,0,64,64,0,1,0,1,0
5011,2477,0,0,60,60,0,1,0,1,0
15154,1137,0,0,62,62,0,1,0,1,0
1985,3216,0,0,63,63,0,1,0,1,0
2890,1017,0,0,62,62,0,1,0,1,0
1603,147,0,0,62,62,0,1,0,1,0
5787,255,0,0,60,60,0,1,0,1,0
21,3268,0,0,158,158,0,1,0,1,0
21450,2256,0,0,62,62,0,1,0,1,0
2059,1888,0,0,62,62,0,1,0,1,0
11713,2618,0,0,66,66,0,1,0,1,0
567,1025,0,0,62,62,0,1,0,1,0
16530,2594,0,0,66,66,0,1,0,1,0
19346,2942,0,0,66,66,0,1,0,1,0
181,2237,0,0,64,64,0,1,0,1,0
20551,1017,0,0,63,63,0,1,0,1,0
10416,2597,0,0,69,69,0,1,0,1,0
13547,1147,0,0,62,62,0,1,0,1,0
7378,2618,0,0,62,62,0,1,0,1,0
11594,381,0,0,63,63,0,1,0,1,0
2550,146,0,0,60,60,0,1,0,1,0
14821,1822,0,0,66,66,0,1,0,1,0
21636,3216,0,0,64,64,0,1,0,1,0
152,3216,0,0,66,66,0,1,0,1,0
16951,255,0,0,62,62,0,1,0,1,0
14611,2883,0,0,62,62,0,1,0,1,0
21117,1147,0,0,66,66,0,1,0,1,0
22587,1215,0,0,62,62,0,1,0,1,0
8,1814,0,0,1514,1514,0,1,0,1,0
778,1888,0,0,146,146,0,1,0,1,0
3685,987,0,0,62,62,0,1,0,1,0
1047,2636,0,0,66,66,0,1,0,1,0
20332,1885,0,0,64,64,0,1,0,1,0
16431,2155,0,0,65,65,0,1,0,1,0
16321,3216,0,0,64,64,0,1,0,1,0
9563,1215,0,0,65,65,0,1,0,1,0
16079,7,0,0,60,60,0,1,0,1,0
16,1771,0,0,63,63,0,1,0,1,0
1673,1215,0,0,62,62,0,1,0,1,0
7339,170,0,0,60,60,0,1,0,1,0
6376,2899,0,0,72,72,0,1,0,1,0
4500,2491,0,0,125,125,0,1,0,1,0
2045,1147,0,0,83,83,0,1,0,1,0
20281,2611,0,0,66,66,0,1,0,1,0
0,0,0,0,77,77,0,1,0,1,0
16951,255,0,0,62,62,0,1,0,1,0
22144,225,0,0,60,60,0,1,0,1,0
22269,1017,0,0,63,63,0,1,0,1,0
3004,2256,0,0,62,62,0,1,0,1,0
3201,2938,0,0,60,60,0,1,0,1,0
9679,2636,0,0,66,66,0,1,0,1,0
8691,2635,0,0,119,119,0,1,0,1,0
22,1164,0,0,62,62,0,1,0,1,0
1910,2576,0,0,145,145,0,1,0,1,0
634,2306,0,0,96,96,0,1,0,1,0
16951,255,0,0,62,62,0,1,0,1,0
18,1147,0,0,146,146,0,1,0,1,0
2984,1790,0,0,66,66,0,1,0,1,0
17,2482,0,0,144,144,0,1,0,1,0
571,3216,0,0,145,145,0,1,0,1,0
2222,730,0,0,62,62,0,1,0,1,0
787,2640,0,0,65,65,0,1,0,1,0
12552,1147,0,0,65,65,0,1,0,1,0
18540,697,0,0,119,119,0,1,0,1,0
1513,1771,0,0,62,62,0,1,0,1,0
3001,357,0,0,62,62,0,1,0,1,0
9286,2585,0,0,62,62,0,1,0,1,0
82,2607,0,0,64,64,0,1,0,1,0
21551,3216,0,0,62,62,0,1,0,1,0
9263,2256,0,0,72,72,0,1,0,1,0
20978,2382,0,0,64,64,0,1,0,1,0
6369,2608,0,0,62,62,0,1,0,1,0
21263,1305,0,0,64,64,0,1,0,1,0
19315,3212,0,0,62,62,0,1,0,1,0
10769,3216,0,0,62,62,0,1,0,1,0
352,797,0,0,62,62,0,1,0,1,0
13307,2562,0,0,66,66,0,1,0,1,0
2055,426,0,0,61,61,0,1,0,1,0
2290,7,0,0,60,60,0,1,0,1,0
16849,1936,0,0,66,66,0,1,0,1,0
20571,1771,0,0,66,66,0,1,0,1,0
14976,1207,0,0,62,62,0,1,0,1,0
16951,255,0,0,62,62,0,1,0,1,0
626,2646,0,0,71,71,0,1,0,1,0
17697,1147,0,0,65,65,0,1,0,1,0
2297,1147,0,0,66,66,0,1,0,1,0
3109,2614,0,0,70,70,0,1,0,1,0
16951,255,0,0,62,62,0,1,0,1,0
4759,1849,0,0,63,63,0,1,0,1,0
2047,7,0,0,60,60,0,1,0,1,0
2722,2256,0,0,62,62,0,1,0,1,0
4311,1147,0,0,62,62,0,1,0,1,0
20571,1771,0,0,65,65,0,1,0,1,0
13939,1007,0,0,123,123,0,1,0,1,0
823,2427,0,0,63,63,0,1,0,1,0
16951,255,0,0,62,62,0,1,0,1,0
3317,1888,0,0,66,66,0,1,0,1,0
12,3074,0,0,320,320,0,1,0,1,0
7578,3216,0,0,62,62,0,1,0,1,0
12011,2256,0,0,110,110,0,1,0,1,0
8,2758,0,0,60,60,0,1,0,1,0
10508,6,0,0,60,60,0,1,0,1,0
1851,2942,0,0,63,63,0,1,0,1,0
1673,2883,0,0,62,62,0,1,0,1,0
3159,1472,0,0,62,62,0,1,0,1,0
21001,3216,0,0,63,63,0,1,0,1,0
5170,1017,0,0,64,64,0,1,0,1,0
1965,1888,0,0,62,62,0,1,0,1,0
7494,1804,0,0,66,66,0,1,0,1,0
11932,1147,0,0,62,62,0,1,0,1,0
12,137,0,0,90,90,0,1,0,1,0
6400,2870,0,0,115,115,0,1,0,1,0
16951,255,0,0,62,62,0,1,0,1,0
12,2559,0,0,71,71,0,1,0,1,0
1866,3216,0,0,62,62,0,1,0,1,0
10250,3204,0,0,62,62,0,1,0,1,0
15260,2623,0,0,63,63,0,1,0,1,0
12507,1017,0,0,66,66,0,1,0,1,0
18542,2938,0,0,62,62,0,1,0,1,0
7746,2757,0,0,146,146,0,1,0,1,0
2548,2134,0,0,60,60,0,1,0,1,0
3716,1147,0,0,136,136,0,1,0,1,0
2899,2603,0,0,146,146,0,1,0,1,0
13351,1853,0,0,66,66,0,1,0,1,0
4472,2609,0,0,107,107,0,1,0,1,0
7360,2508,0,0,145,145,0,1,0,1,0
17898,2883,0,0,66,66,0,1,0,1,0
10165,1147,0,0,64,64,0,1,0,1,0
14722,1888,0,0,65,65,0,1,0,1,0
6328,2519,0,0,61,61,0,1,0,1,0
1745,2460,0,0,150,150,0,1,0,1,0
20198,1147,0,0,63,63,0,1,0,1,0
2635,411,0,0,145,145,0,1,0,1,0
7910,1147,0,0,62,62,0,1,0,1,0
2084,1471,0,0,145,145,0,1,0,1,0
1972,1215,0,0,62,62,0,1,0,1,0
16951,255,0,0,62,62,0,1,0,1,0
4060,1017,0,0,62,62,0,1,0,1,0
20479,2605,0,0,65,65,0,1,0,1,0
14986,2587,0,0,62,62,0,1,0,1,0
16119,2611,0,0,62,62,0,1,0,1,0
22620,1215,0,0,62,62,0,1,0,1,0
7047,1549,0,0,65,65,0,1,0,1,0
0,0,0,0,70,70,0,1,0,1,0
3821,1017,0,0,132,132,0,1,0,1,0
14839,2651,0,0,62,62,0,1,0,1,0
16951,255,0,0,62,62,0,1,0,1,0
2214,2574,0,0,64,64,0,1,0,1,0
3316,1888,0,0,66,66,0,1,0,1,0
77,1797,0,0,141,141,0,1,0,1,0
10475,2587,0,0,66,66,0,1,0,1,0
9821,2994,0,0,66,66,0,1,0,1,0
2398,3216,0,0,62,62,0,1,0,1,0
20112,2935,0,0,120,120,0,1,0,1,0
21020,3216,0,0,63,63,0,1,0,1,0
285,1763,0,0,66,66,0,1,0,1,0
7,45,0,0,341,341,0,1,0,1,0
502,212,232,30,362,362,0,1,0,1,0
9508,1888,0,0,66,66,0,1,0,1,0
6233,1646,0,0,60,60,0,1,0,1,0
2331,1147,0,0,146,146,0,1,0,1,0
4567,1147,0,0,146,146,0,1,0,1,0
10756,944,0,0,62,62,0,1,0,1,0
7392,99,0,0,60,60,0,1,0,1,0
10476,2774,0,0,131,131,0,1,0,1,0
17526,983,0,0,65,65,0,1,0,1,0
837,1888,0,0,62,62,0,1,0,1,0
613,2594,0,0,62,62,0,1,0,1,0
1839,1787,0,0,63,63,0,1,0,1,0
0,0,0,0,60,60,0,1,0,1,0
149,3139,0,0,66,66,0,1,0,1,0
1498,3216,0,0,62,62,0,1,0,1,0
2206,2636,0,0,63,63,0,1,0,1,0
42,2947,0,0,146,146,0,1,0,1,0
2488,3216,0,0,66,66,0,1,0,1,0
8228,2587,0,0,66,66,0,1,0,1,0
334,3216,0,0,64,64,0,1,0,1,0
2803,1881,0,0,64,64,0,1,0,1,0
360,3105,0,0,891,891,0,1,0,1,0
16951,255,0,0,62,62,0,1,0,1,0
7263,1846,0,0,145,145,0,1,0,1,0
20668,2728,0,0,63,63,0,1,0,1,0
9764,2587,0,0,64,64,0,1,0,1,0
13296,6,0,0,60,60,0,1,0,1,0
16951,255,0,0,62,62,0,1,0,1,0
326,1888,0,0,62,62,0,1,0,1,0
1330,697,0,0,62,62,0,1,0,1,0
18275,10,0,0,88,88,0,1,0,1,0
17331,2570,0,0,70,70,0,1,0,1,0
360,3105,0,0,1266,1266,0,1,0,1,0
1976,1,0,0,65,65,0,1,0,1,0
9614,3105,0,0,86,86,0,1,0,1,0
16155,1384,0,0,63,63,0,1,0,1,0
73,1147,0,0,62,62,0,1,0,1,0
18973,246,0,0,60,60,0,1,0,1,0
36,1784,0,0,140,140,0,1,0,1,0
3240,2536,0,0,146,146,0,1,0,1,0
3641,2258,0,0,85,85,0,1,0,1,0
2509,1147,0,0,62,62,0,1,0,1,0
14228,3215,0,0,62,62,0,1,0,1,0
11430,2210,0,0,62,62,0,1,0,1,0
20119,2587,0,0,141,141,0,1,0,1,0
20333,1148,0,0,62,62,0,1,0,1,0
3509,7,0,0,60,60,0,1,0,1,0
7258,1825,0,0,115,115,0,1,0,1,0
7037,1215,0,0,62,62,0,1,0,1,0
14837,3257,0,0,131,131,0,1,0,1,0
12055,3113,0,0,64,64,0,1,0,1,0
2540,1124,0,0,144,144,0,1,0,1,0
636,2856,0,0,145,145,0,1,0,1,0
20091,1170,0,0,63,63,0,1,0,1,0
18,3216,0,0,62,62,0,1,0,1,0
19520,2256,0,0,62,62,0,1,0,1,0
16258,1888,0,0,62,62,0,1,0,1,0
6185,1147,0,0,64,64,0,1,0,1,0
275,9,0,0,60,60,0,1,0,1,0
21386,1147,0,0,63,63,0,1,0,1,0
6944,2607,0,0,62,62,0,1,0,1,0
16054,1000,0,0,63,63,0,1,0,1,0
8164,2725,0,0,60,60,0,1,0,1,0
18,3216,0,0,62,62,0,1,0,1,0
7694,2831,0,0,146,146,0,1,0,1,0
8977,1147,0,0,63,63,0,1,0,1,0
16985,2234,0,0,63,63,0,1,0,1,0
7339,170,0,0,60,60,0,1,0,1,0
2672,1147,0,0,63,63,0,1,0,1,0
1804,768,0,0,60,60,0,1,0,1,0
2444,2587,0,0,63,63,0,1,0,1,0
22537,2382,0,0,62,62,0,1,0,1,0
834,2582,0,0,62,62,0,1,0,1,0
74,2633,0,0,145,145,0,1,0,1,0
2806,7,0,0,60,60,0,1,0,1,0
10251,450,0,0,66,66,0,1,0,1,0
12815,1468,0,0,66,66,0,1,0,1,0
16276,1882,0,0,64,64,0,1,0,1,0
276,9,0,0,60,60,0,1,0,1,0
8970,3216,0,0,66,66,0,1,0,1,0
10585,2256,0,0,82,82,0,1,0,1,0
20826,3234,0,0,64,64,0,1,0,1,0
7931,2587,0,0,62,62,0,1,0,1,0
12618,1888,0,0,66,66,0,1,0,1,0
1891,2256,0,0,65,65,0,1,0,1,0
20695,2700,0,0,76,76,0,1,0,1,0
16951,255,0,0,62,62,0,1,0,1,0
1130,1856,0,0,63,63,0,1,0,1,0
9988,1200,0,0,69,69,0,1,0,1,0
1981,2144,0,0,63,63,0,1,0,1,0
20742,2611,0,0,62,62,0,1,0,1,0
2823,1148,0,0,147,147,0,1,0,1,0
21079,1215,0,0,62,62,0,1,0,1,0
10475,2587,0,0,66,66,0,1,0,1,0
16007,2938,0,0,66,66,0,1,0,1,0
16264,1886,0,0,62,62,0,1,0,1,0
743,1444,0,0,63,63,0,1,0,1,0
7032,2938,0,0,74,74,0,1,0,1,0
16951,255,0,0,62,62,0,1,0,1,0
12,1970,0,0,74,74,0,1,0,1,0
7808,2595,0,0,66,66,0,1,0,1,0
1184,1160,0,0,62,62,0,1,0,1,0
20677,2945,0,0,66,66,0,1,0,1,0
21904,2938,0,0,66,66,0,1,0,1,0
17963,2256,0,0,66,66,0,1,0,1,0
12457,2245,0,0,63,63,0,1,0,1,0
2865,2923,0,0,62,62,0,1,0,1,0
1898,2256,0,0,144,144,0,1,0,1,0
3144,2587,0,0,62,62,0,1,0,1,0
18787,1124,0,0,66,66,0,1,0,1,0
5864,3216,0,0,125,125,0,1,0,1,0
11304,1017,0,0,62,62,0,1,0,1,0
9585,2860,0,0,62,62,0,1,0,1,0
18626,1215,0,0,62,62,0,1,0,1,0
7977,1147,0,0,62,62,0,1,0,1,0
3949,1017,0,0,64,64,0,1,0,1,0
3121,2947,0,0,66,66,0,1,0,1,0
941,184,0,0,65,65,0,1,0,1,0
1730,2100,0,0,138,138,0,1,0,1,0
8710,1790,0,0,149,149,0,1,0,1,0
18823,2609,0,0,62,62,0,1,0,1,0
11659,3216,0,0,62,62,0,1,0,1,0
1678,2945,0,0,69,69,0,1,0,1,0
20436,1871,0,0,62,62,0,1,0,1,0
360,3105,0,0,977,977,0,1,0,1,0
177,2229,0,0,63,63,0,1,0,1,0
8381,1781,0,0,63,63,0,1,0,1,0
16504,2619,0,0,119,119,0,1,0,1,0
9253,1472,0,0,62,62,0,1,0,1,0
8578,2256,0,0,66,66,0,1,0,1,0
4829,1116,0,0,66,66,0,1,0,1,0
14891,1017,0,0,106,106,0,1,0,1,0
17,1148,0,0,145,145,0,1,0,1,0
613,3237,0,0,144,144,0,1,0,1,0
3184,2587,0,0,62,62,0,1,0,1,0
1804,321,0,0,60,60,0,1,0,1,0
749,1147,0,0,63,63,0,1,0,1,0
1507,1888,0,0,66,66,0,1,0,1,0
4004,678,0,0,87,87,0,1,0,1,0
614,2252,0,0,66,66,0,1,0,1,0
1018,2938,0,0,62,62,0,1,0,1,0
16060,2256,0,0,62,62,0,1,0,1,0
16951,255,0,0,62,62,0,1,0,1,0
5210,2636,0,0,62,62,0,1,0,1,0
8,442,0,0,60,60,0,1,0,1,0
13713,2880,0,0,66,66,0,1,0,1,0
0,0,0,0,98,98,0,1,0,1,0
15,3220,0,0,61,61,0,1,0,1,0
16951,255,0,0,62,62,0,1,0,1,0
8171,1073,0,0,60,60,0,1,0,1,0
18320,2374,0,0,66,66,0,1,0,1,0
12,138,0,0,123,123,0,1,0,1,0
9614,3105,0,0,86,86,0,1,0,1,0
10268,2883,0,0,62,62,0,1,0,1,0
18276,1472,0,0,63,63,0,1,0,1,0
20335,1888,0,0,64,64,0,1,0,1,0
2051,1147,0,0,62,62,0,1,0,1,0
0,0,0,0,98,98,0,1,0,1,0
9580,3216,0,0,66,66,0,1,0,1,0
22420,2592,0,0,66,66,0,1,0,1,0
2259,7,0,0,60,60,0,1,0,1,0
11951,3216,0,0,66,66,0,1,0,1,0
1829,3113,0,0,60,60,0,1,0,1,0
1698,2587,0,0,62,62,0,1,0,1,0
4206,1771,0,0,75,75,0,1,0,1,0
16052,1871,0,0,62,62,0,1,0,1,0
19288,2587,0,0,62,62,0,1,0,1,0
10817,2909,0,0,64,64,0,1,0,1,0
11311,1215,0,0,62,62,0,1,0,1,0
1616,1897,0,0,146,146,0,1,0,1,0
826,1416,0,0,110,110,0,1,0,1,0
14306,1589,0,0,66,66,0,1,0,1,0
2755,3216,0,0,64,64,0,1,0,1,0
246,509,0,0,145,145,0,1,0,1,0
6169,3051,0,0,62,62,0,1,0,1,0
1791,1793,0,0,146,146,0,1,0,1,0
1324,1147,0,0,65,65,0,1,0,1,0
20571,1771,0,0,64,64,0,1,0,1,0
2431,7,0,0,60,60,0,1,0,1,0
9495,1888,0,0,64,64,0,1,0,1,0
14066,1147,0,0,65,65,0,1,0,1,0
16951,255,0,0,62,62,0,1,0,1,0
16537,2636,0,0,66,66,0,1,0,1,0
15694,334,0,0,145,145,0,1,0,1,0
16951,255,0,0,62,62,0,1,0,1,0
2014,1888,0,0,62,62,0,1,0,1,0
2635,1210,0,0,64,64,0,1,0,1,0
18878,1147,0,0,66,66,0,1,0,1,0
14959,212,0,0,60,60,0,1,0,1,0
2844,2938,0,0,62,62,0,1,0,1,0
390,797,0,0,64,64,0,1,0,1,0
1237,3216,0,0,62,62,0,1,0,1,0
16951,255,0,0,62,62,0,1,0,1,0
8649,3056,0,0,62,62,0,1,0,1,0
261,1147,0,0,66,66,0,1,0,1,0
10443,99,0,0,125,125,0,1,0,1,0
12,207,0,0,200,200,0,1,0,1,0
17114,750,0,0,66,66,0,1,0,1,0
815,2106,0,0,125,125,0,1,0,1,0
635,708,0,0,62,62,0,1,0,1,0
1361,2451,0,0,143,143,0,1,0,1,0
16849,1936,0,0,66,66,0,1,0,1,0
6394,1214,0,0,62,62,0,1,0,1,0
16951,255,0,0,62,62,0,1,0,1,0
1596,1888,0,0,62,62,0,1,0,1,0
638,2484,0,0,143,143,0,1,0,1,0
16951,255,0,0,62,62,0,1,0,1,0
89,2256,0,0,65,65,0,1,0,1,0
5149,1886,0,0,146,146,0,1,0,1,0
360,3105,0,0,1286,1286,0,1,0,1,0
3483,7,0,0,60,60,0,1,0,1,0
14703,984,0,0,65,65,0,1,0,1,0
599,1215,0,0,62,62,0,1,0,1,0
5071,995,0,0,62,62,0,1,0,1,0
1497,7,0,0,60,60,0,1,0,1,0
13569,3051,0,0,64,64,0,1,0,1,0
14971,2636,0,0,63,63,0,1,0,1,0
733,1804,0,0,63,63,0,1,0,1,0
17528,984,0,0,65,65,0,1,0,1,0
0,0,0,0,71,71,0,1,0,1,0
17372,2953,0,0,66,66,0,1,0,1,0
10442,28,0,0,70,70,0,1,0,1,0
12468,28,0,0,66,66,0,1,0,1,0
15321,28,0,0,70,70,0,1,0,1,0
22715,28,0,0,70,70,0,1,0,1,0
18312,28,0,0,66,66,0,1,0,1,0
15143,28,0,0,70,70,0,1,0,1,0
19280,28,0,0,70,70,0,1,0,1,0
22578,28,0,0,70,70,0,1,0,1,0
11749,28,0,0,70,70,0,1,0,1,0
15724,28,0,0,66,66,0,1,0,1,0
21489,28,0,0,66,66,0,1,0,1,0
10395,28,0,0,66,66,0,1,0,1,0
10027,28,0,0,66,66,0,1,0,1,0
10978,28,0,0,70,70,0,1,0,1,0
22647,28,0,0,70,70,0,1,0,1,0
11284,28,0,0,70,70,0,1,0,1,0
14370,28,0,0,70,70,0,1,0,1,0
16959,28,0,0,70,70,0,1,0,1,0
9588,28,0,0,70,70,0,1,0,1,0
17256,28,0,0,70,70,0,1,0,1,0
18357,28,0,0,70,70,0,1,0,1,0
8691,28,0,0,70,70,0,1,0,1,0
21843,28,0,0,66,66,0,1,0,1,0
19034,28,0,0,70,70,0,1,0,1,0
18392,28,0,0,70,70,0,1,0,1,0
13357,28,0,0,70,70,0,1,0,1,0
18765,28,0,0,66,66,0,1,0,1,0
16470,28,0,0,70,70,0,1,0,1,0
10256,28,0,0,70,70,0,1,0,1,0
15478,28,0,0,66,66,0,1,0,1,0
17807,28,0,0,66,66,0,1,0,1,0
10516,28,0,0,70,70,0,1,0,1,0
17812,28,0,0,66,66,0,1,0,1,0
20738,28,0,0,66,66,0,1,0,1,0
9346,28,0,0,70,70,0,1,0,1,0
20527,28,0,0,70,70,0,1,0,1,0
14742,28,0,0,70,70,0,1,0,1,0
11996,28,0,0,70,70,0,1,0,1,0
16805,28,0,0,66,66,0,1,0,1,0
19853,28,0,0,66,66,0,1,0,1,0
17557,28,0,0,70,70,0,1,0,1,0
20744,28,0,0,70,70,0,1,0,1,0
17054,28,0,0,70,70,0,1,0,1,0
19787,28,0,0,70,70,0,1,0,1,0
16942,28,0,0,70,70,0,1,0,1,0
17383,28,0,0,70,70,0,1,0,1,0
13225,28,0,0,70,70,0,1,0,1,0
9038,28,0,0,70,70,0,1,0,1,0
11285,28,0,0,66,66,0,1,0,1,0
21133,28,0,0,70,70,0,1,0,1,0
18935,28,0,0,70,70,0,1,0,1,0
19290,28,0,0,70,70,0,1,0,1,0
13666,28,0,0,70,70,0,1,0,1,0
13429,28,0,0,66,66,0,1,0,1,0
11540,28,0,0,70,70,0,1,0,1,0
20205,28,0,0,70,70,0,1,0,1,0
12345,28,0,0,66,66,0,1,0,1,0
20379,28,0,0,66,66,0,1,0,1,0
14864,28,0,0,66,66,0,1,0,1,0
9061,28,0,0,66,66,0,1,0,1,0
20171,28,0,0,70,70,0,1,0,1,0
15935,28,0,0,66,66,0,1,0,1,0
9927,28,0,0,66,66,0,1,0,1,0
22450,28,0,0,70,70,0,1,0,1,0
12632,28,0,0,70,70,0,1,0,1,0
9757,28,0,0,70,70,0,1,0,1,0
10186,28,0,0,70,70,0,1,0,1,0
14060,28,0,0,70,70,0,1,0,1,0
15955,28,0,0,70,70,0,1,0,1,0
12772,28,0,0,66,66,0,1,0,1,0
18041,28,0,0,66,66,0,1,0,1,0
17710,28,0,0,70,70,0,1,0,1,0
20984,28,0,0,70,70,0,1,0,1,0
22076,28,0,0,66,66,0,1,0,1,0
12773,28,0,0,70,70,0,1,0,1,0
9043,28,0,0,70,70,0,1,0,1,0
13096,28,0,0,70,70,0,1,0,1,0
13326,28,0,0,66,66,0,1,0,1,0
20401,28,0,0,70,70,0,1,0,1,0
8360,28,0,0,70,70,0,1,0,1,0
20921,28,0,0,66,66,0,1,0,1,0
13488,28,0,0,70,70,0,1,0,1,0
19697,28,0,0,70,70,0,1,0,1,0
22457,28,0,0,66,66,0,1,0,1,0
11022,28,0,0,70,70,0,1,0,1,0
12670,28,0,0,70,70,0,1,0,1,0
16311,28,0,0,70,70,0,1,0,1,0
14569,28,0,0,70,70,0,1,0,1,0
12644,28,0,0,66,66,0,1,0,1,0
20954,28,0,0,70,70,0,1,0,1,0
21093,28,0,0,66,66,0,1,0,1,0
12259,28,0,0,70,70,0,1,0,1,0
10039,28,0,0,70,70,0,1,0,1,0
16083,28,0,0,70,70,0,1,0,1,0
17165,28,0,0,70,70,0,1,0,1,0
15928,28,0,0,70,70,0,1,0,1,0
16405,28,0,0,66,66,0,1,0,1,0
12476,28,0,0,70,70,0,1,0,1,0
15952,28,0,0,66,66,0,1,0,1,0
22400,28,0,0,70,70,0,1,0,1,0
14430,28,0,0,66,66,0,1,0,1,0
14389,28,0,0,70,70,0,1,0,1,0
11828,28,0,0,66,66,0,1,0,1,0
13026,28,0,0,70,70,0,1,0,1,0
16052,28,0,0,66,66,0,1,0,1,0
16072,28,0,0,70,70,0,1,0,1,0
14038,28,0,0,66,66,0,1,0,1,0
15596,28,0,0,66,66,0,1,0,1,0
19665,28,0,0,70,70,0,1,0,1,0
11835,28,0,0,66,66,0,1,0,1,0
15662,28,0,0,66,66,0,1,0,1,0
21713,28,0,0,66,66,0,1,0,1,0
16654,28,0,0,70,70,0,1,0,1,0
19564,28,0,0,66,66,0,1,0,1,0
20469,28,0,0,70,70,0,1,0,1,0
13573,28,0,0,70,70,0,1,0,1,0
20655,28,0,0,66,66,0,1,0,1,0
19942,28,0,0,70,70,0,1,0,1,0
19754,28,0,0,66,66,0,1,0,1,0
9510,28,0,0,66,66,0,1,0,1,0
12568,28,0,0,70,70,0,1,0,1,0
19974,28,0,0,70,70,0,1,0,1,0
12790,28,0,0,66,66,0,1,0,1,0
14107,28,0,0,70,70,0,1,0,1,0
17640,28,0,0,70,70,0,1,0,1,0
21165,28,0,0,70,70,0,1,0,1,0
16537,28,0,0,70,70,0,1,0,1,0
17271,28,0,0,70,70,0,1,0,1,0
14331,28,0,0,70,70,0,1,0,1,0
12340,28,0,0,70,70,0,1,0,1,0
8733,28,0,0,66,66,0,1,0,1,0
9802,28,0,0,66,66,0,1,0,1,0
13559,28,0,0,70,70,0,1,0,1,0
8359,28,0,0,70,70,0,1,0,1,0
9170,28,0,0,70,70,0,1,0,1,0
16608,28,0,0,66,66,0,1,0,1,0
21022,28,0,0,70,70,0,1,0,1,0
21263,28,0,0,70,70,0,1,0,1,0
10708,28,0,0,70,70,0,1,0,1,0
13670,28,0,0,66,66,0,1,0,1,0
14168,28,0,0,70,70,0,1,0,1,0
13773,28,0,0,70,70,0,1,0,1,0
13373,28,0,0,70,70,0,1,0,1,0
8646,28,0,0,70,70,0,1,0,1,0
13476,28,0,0,70,70,0,1,0,1,0
18852,28,0,0,70,70,0,1,0,1,0
14907,28,0,0,70,70,0,1,0,1,0
19722,28,0,0,70,70,0,1,0,1,0
13890,28,0,0,70,70,0,1,0,1,0
17953,28,0,0,70,70,0,1,0,1,0
9229,28,0,0,70,70,0,1,0,1,0
14256,28,0,0,70,70,0,1,0,1,0
19237,28,0,0,66,66,0,1,0,1,0
9299,28,0,0,70,70,0,1,0,1,0
18948,28,0,0,66,66,0,1,0,1,0
19442,28,0,0,70,70,0,1,0,1,0
17181,28,0,0,70,70,0,1,0,1,0
16479,28,0,0,70,70,0,1,0,1,0
22498,28,0,0,66,66,0,1,0,1,0
12065,28,0,0,70,70,0,1,0,1,0
16401,28,0,0,70,70,0,1,0,1,0
14883,28,0,0,70,70,0,1,0,1,0
19970,28,0,0,66,66,0,1,0,1,0
14137,28,0,0,66,66,0,1,0,1,0
21462,28,0,0,70,70,0,1,0,1,0
14083,28,0,0,70,70,0,1,0,1,0
17217,28,0,0,70,70,0,1,0,1,0
14202,28,0,0,66,66,0,1,0,1,0
11811,28,0,0,70,70,0,1,0,1,0
10115,28,0,0,70,70,0,1,0,1,0
16412,28,0,0,70,70,0,1,0,1,0
17967,28,0,0,66,66,0,1,0,1,0
8569,28,0,0,66,66,0,1,0,1,0
16993,28,0,0,66,66,0,1,0,1,0
10691,28,0,0,70,70,0,1,0,1,0
17390,28,0,0,70,70,0,1,0,1,0
20781,28,0,0,66,66,0,1,0,1,0
18964,28,0,0,66,66,0,1,0,1,0
9820,28,0,0,66,66,0,1,0,1,0
13356,28,0,0,70,70,0,1,0,1,0
19909,28,0,0,70,70,0,1,0,1,0
9916,28,0,0,66,66,0,1,0,1,0
19751,28,0,0,66,66,0,1,0,1,0
21104,28,0,0,70,70,0,1,0,1,0
8671,28,0,0,70,70,0,1,0,1,0
18971,28,0,0,70,70,0,1,0,1,0
19621,28,0,0,70,70,0,1,0,1,0
10608,28,0,0,70,70,0,1,0,1,0
20103,28,0,0,70,70,0,1,0,1,0
9481,28,0,0,70,70,0,1,0,1,0
9206,28,0,0,70,70,0,1,0,1,0
14844,28,0,0,70,70,0,1,0,1,0
19163,28,0,0,66,66,0,1,0,1,0
16288,28,0,0,70,70,0,1,0,1,0
17260,28,0,0,66,66,0,1,0,1,0
22499,28,0,0,66,66,0,1,0,1,0
20780,28,0,0,70,70,0,1,0,1,0
9372,28,0,0,70,70,0,1,0,1,0
21078,28,0,0,66,66,0,1,0,1,0
12872,28,0,0,70,70,0,1,0,1,0
20122,28,0,0,66,66,0,1,0,1,0
13996,28,0,0,66,66,0,1,0,1,0
19133,28,0,0,66,66,0,1,0,1,0
11608,28,0,0,66,66,0,1,0,1,0
15210,28,0,0,66,66,0,1,0,1,0
8495,28,0,0,66,66,0,1,0,1,0
21285,28,0,0,70,70,0,1,0,1,0
12139,28,0,0,70,70,0,1,0,1,0
21922,28,0,0,70,70,0,1,0,1,0
15759,28,0,0,70,70,0,1,0,1,0
11093,28,0,0,70,70,0,1,0,1,0
19195,28,0,0,70,70,0,1,0,1,0
20805,28,0,0,70,70,0,1,0,1,0
12710,28,0,0,70,70,0,1,0,1,0
8397,28,0,0,70,70,0,1,0,1,0
11604,28,0,0,66,66,0,1,0,1,0
10768,28,0,0,70,70,0,1,0,1,0
12356,28,0,0,70,70,0,1,0,1,0
17442,28,0,0,66,66,0,1,0,1,0
16756,28,0,0,70,70,0,1,0,1,0
17320,28,0,0,70,70,0,1,0,1,0
13736,28,0,0,66,66,0,1,0,1,0
17972,28,0,0,70,70,0,1,0,1,0
18118,28,0,0,70,70,0,1,0,1,0
10030,28,0,0,70,70,0,1,0,1,0
15954,28,0,0,70,70,0,1,0,1,0
18877,28,0,0,70,70,0,1,0,1,0
15849,28,0,0,66,66,0,1,0,1,0
16170,28,0,0,70,70,0,1,0,1,0
15097,28,0,0,66,66,0,1,0,1,0
22547,28,0,0,70,70,0,1,0,1,0
17722,28,0,0,70,70,0,1,0,1,0
21533,28,0,0,66,66,0,1,0,1,0
17471,28,0,0,70,70,0,1,0,1,0
14727,28,0,0,70,70,0,1,0,1,0
21024,28,0,0,70,70,0,1,0,1,0
9822,28,0,0,70,70,0,1,0,1,0
11117,28,0,0,66,66,0,1,0,1,0
9463,28,0,0,70,70,0,1,0,1,0
20324,28,0,0,70,70,0,1,0,1,0
17760,28,0,0,70,70,0,1,0,1,0
14702,28,0,0,70,70,0,1,0,1,0
14470,28,0,0,70,70,0,1,0,1,0
9349,28,0,0,70,70,0,1,0,1,0
13697,28,0,0,66,66,0,1,0,1,0
17214,28,0,0,70,70,0,1,0,1,0
12882,28,0,0,70,70,0,1,0,1,0
10501,28,0,0,70,70,0,1,0,1,0
8964,28,0,0,70,70,0,1,0,1,0
17915,28,0,0,70,70,0,1,0,1,0
11106,28,0,0,70,70,0,1,0,1,0
16250,28,0,0,70,70,0,1,0,1,0
21538,28,0,0,70,70,0,1,0,1,0
9210,28,0,0,70,70,0,1,0,1,0
15587,28,0,0,66,66,0,1,0,1,0
15095,28,0,0,66,66,0,1,0,1,0
15080,28,0,0,66,66,0,1,0,1,0
8974,28,0,0,70,70,0,1,0,1,0
18665,28,0,0,66,66,0,1,0,1,0
8660,28,0,0,66,66,0,1,0,1,0
15771,28,0,0,70,70,0,1,0,1,0
9655,28,0,0,70,70,0,1,0,1,0
12055,28,0,0,70,70,0,1,0,1,0
18996,28,0,0,66,66,0,1,0,1,0
16866,28,0,0,70,70,0,1,0,1,0
9896,28,0,0,66,66,0,1,0,1,0
15426,28,0,0,70,70,0,1,0,1,0
15068,28,0,0,70,70,0,1,0,1,0
11287,28,0,0,70,70,0,1,0,1,0
12249,28,0,0,70,70,0,1,0,1,0
20255,28,0,0,66,66,0,1,0,1,0
19141,28,0,0,70,70,0,1,0,1,0
20930,28,0,0,70,70,0,1,0,1,0
14323,28,0,0,66,66,0,1,0,1,0
15708,28,0,0,66,66,0,1,0,1,0
8806,28,0,0,66,66,0,1,0,1,0
13592,28,0,0,70,70,0,1,0,1,0
16740,28,0,0,66,66,0,1,0,1,0
11492,28,0,0,70,70,0,1,0,1,0
20142,28,0,0,70,70,0,1,0,1,0
17799,28,0,0,70,70,0,1,0,1,0
10783,28,0,0,70,70,0,1,0,1,0
12967,28,0,0,70,70,0,1,0,1,0
20825,28,0,0,66,66,0,1,0,1,0
10681,28,0,0,70,70,0,1,0,1,0
17464,28,0,0,70,70,0,1,0,1,0
20939,28,0,0,66,66,0,1,0,1,0
11050,28,0,0,70,70,0,1,0,1,0
15573,28,0,0,70,70,0,1,0,1,0
9439,28,0,0,70,70,0,1,0,1,0
11236,28,0,0,70,70,0,1,0,1,0
10064,28,0,0,66,66,0,1,0,1,0
9546,28,0,0,70,70,0,1,0,1,0
8467,28,0,0,70,70,0,1,0,1,0
16391,28,0,0,70,70,0,1,0,1,0
20552,28,0,0,66,66,0,1,0,1,0
21656,28,0,0,70,70,0,1,0,1,0
9691,28,0,0,70,70,0,1,0,1,0
20457,28,0,0,70,70,0,1,0,1,0
16927,28,0,0,70,70,0,1,0,1,0
11618,28,0,0,66,66,0,1,0,1,0
21053,28,0,0,70,70,0,1,0,1,0
14662,28,0,0,66,66,0,1,0,1,0
10328,28,0,0,70,70,0,1,0,1,0
13726,28,0,0,70,70,0,1,0,1,0
19674,28,0,0,66,66,0,1,0,1,0
18179,28,0,0,70,70,0,1,0,1,0
16711,28,0,0,66,66,0,1,0,1,0
12690,28,0,0,70,70,0,1,0,1,0
12395,28,0,0,66,66,0,1,0,1,0
13237,28,0,0,70,70,0,1,0,1,0
9703,28,0,0,70,70,0,1,0,1,0
10676,28,0,0,66,66,0,1,0,1,0
16853,28,0,0,66,66,0,1,0,1,0
11892,28,0,0,70,70,0,1,0,1,0
13918,28,0,0,70,70,0,1,0,1,0
9588,28,0,0,70,70,0,1,0,1,0
18700,28,0,0,70,70,0,1,0,1,0
20116,28,0,0,66,66,0,1,0,1,0
10132,28,0,0,70,70,0,1,0,1,0
16061,28,0,0,70,70,0,1,0,1,0
13104,28,0,0,66,66,0,1,0,1,0
14554,28,0,0,70,70,0,1,0,1,0
22483,28,0,0,70,70,0,1,0,1,0
17317,28,0,0,70,70,0,1,0,1,0
20435,28,0,0,66,66,0,1,0,1,0
12574,28,0,0,66,66,0,1,0,1,0
16705,28,0,0,70,70,0,1,0,1,0
20983,28,0,0,70,70,0,1,0,1,0
17759,28,0,0,70,70,0,1,0,1,0
12997,28,0,0,70,70,0,1,0,1,0
14353,28,0,0,66,66,0,1,0,1,0
21967,28,0,0,66,66,0,1,0,1,0
9346,28,0,0,70,70,0,1,0,1,0
20633,28,0,0,66,66,0,1,0,1,0
9907,28,0,0,70,70,0,1,0,1,0
19822,28,0,0,70,70,0,1,0,1,0
19571,28,0,0,70,70,0,1,0,1,0
18657,28,0,0,70,70,0,1,0,1,0
11145,28,0,0,70,70,0,1,0,1,0
16722,28,0,0,70,70,0,1,0,1,0
9836,28,0,0,66,66,0,1,0,1,0
20353,28,0,0,66,66,0,1,0,1,0
16221,28,0,0,70,70,0,1,0,1,0
19803,28,0,0,66,66,0,1,0,1,0
10863,28,0,0,70,70,0,1,0,1,0
16782,28,0,0,70,70,0,1,0,1,0
17499,28,0,0,70,70,0,1,0,1,0
18270,28,0,0,70,70,0,1,0,1,0
20033,28,0,0,70,70,0,1,0,1,0
22408,28,0,0,70,70,0,1,0,1,0
14462,28,0,0,70,70,0,1,0,1,0
14887,28,0,0,66,66,0,1,0,1,0
16594,28,0,0,66,66,0,1,0,1,0
9655,28,0,0,70,70,0,1,0,1,0
15871,28,0,0,70,70,0,1,0,1,0
17598,28,0,0,66,66,0,1,0,1,0
15351,28,0,0,70,70,0,1,0,1,0
15109,28,0,0,66,66,0,1,0,1,0
19340,28,0,0,66,66,0,1,0,1,0
21446,28,0,0,70,70,0,1,0,1,0
9794,28,0,0,70,70,0,1,0,1,0
16943,28,0,0,66,66,0,1,0,1,0
12889,28,0,0,66,66,0,1,0,1,0
11047,28,0,0,66,66,0,1,0,1,0
9692,28,0,0,66,66,0,1,0,1,0
21475,28,0,0,70,70,0,1,0,1,0
17736,28,0,0,66,66,0,1,0,1,0
13687,28,0,0,66,66,0,1,0,1,0
14720,28,0,0,66,66,0,1,0,1,0
14433,28,0,0,66,66,0,1,0,1,0
9551,28,0,0,66,66,0,1,0,1,0
15605,28,0,0,70,70,0,1,0,1,0
10258,28,0,0,70,70,0,1,0,1,0
21827,28,0,0,70,70,0,1,0,1,0
15373,28,0,0,66,66,0,1,0,1,0
11583,28,0,0,66,66,0,1,0,1,0
17234,28,0,0,70,70,0,1,0,1,0
9414,28,0,0,66,66,0,1,0,1,0
13058,28,0,0,66,66,0,1,0,1,0
19685,28,0,0,66,66,0,1,0,1,0
17114,28,0,0,70,70,0,1,0,1,0
9083,28,0,0,70,70,0,1,0,1,0
19950,28,0,0,70,70,0,1,0,1,0
18608,28,0,0,66,66,0,1,0,1,0
14274,28,0,0,70,70,0,1,0,1,0
11381,28,0,0,70,70,0,1,0,1,0
21279,28,0,0,70,70,0,1,0,1,0
11541,28,0,0,70,70,0,1,0,1,0
21535,28,0,0,66,66,0,1,0,1,0
13278,28,0,0,66,66,0,1,0,1,0
14001,28,0,0,70,70,0,1,0,1,0
20739,28,0,0,66,66,0,1,0,1,0
12649,28,0,0,66,66,0,1,0,1,0
12038,28,0,0,70,70,0,1,0,1,0
18327,28,0,0,70,70,0,1,0,1,0
16994,28,0,0,66,66,0,1,0,1,0
16854,28,0,0,70,70,0,1,0,1,0
16137,28,0,0,70,70,0,1,0,1,0
22644,28,0,0,66,66,0,1,0,1,0
17831,28,0,0,70,70,0,1,0,1,0
15560,28,0,0,70,70,0,1,0,1,0
17082,28,0,0,70,70,0,1,0,1,0
13535,28,0,0,70,70,0,1,0,1,0
13767,28,0,0,66,66,0,1,0,1,0
18463,28,0,0,70,70,0,1,0,1,0
22704,28,0,0,70,70,0,1,0,1,0
20842,28,0,0,70,70,0,1,0,1,0
22552,28,0,0,70,70,0,1,0,1,0
12044,28,0,0,70,70,0,1,0,1,0
13236,28,0,0,66,66,0,1,0,1,0
16758,28,0,0,66,66,0,1,0,1,0
18934,28,0,0,66,66,0,1,0,1,0
19655,28,0,0,66,66,0,1,0,1,0
19872,28,0,0,70,70,0,1,0,1,0
14039,28,0,0,66,66,0,1,0,1,0
11113,28,0,0,70,70,0,1,0,1,0
13857,28,0,0,70,70,0,1,0,1,0
10991,28,0,0,66,66,0,1,0,1,0
15152,28,0,0,66,66,0,1,0,1,0
15162,28,0,0,70,70,0,1,0,1,0
19456,28,0,0,70,70,0,1,0,1,0
8867,28,0,0,70,70,0,1,0,1,0
19209,28,0,0,66,66,0,1,0,1,0
18255,28,0,0,66,66,0,1,0,1,0
15489,28,0,0,66,66,0,1,0,1,0
9069,28,0,0,70,70,0,1,0,1,0
9562,28,0,0,66,66,0,1,0,1,0
22393,28,0,0,70,70,0,1,0,1,0
14907,28,0,0,66,66,0,1,0,1,0
16259,28,0,0,70,70,0,1,0,1,0
11512,28,0,0,70,70,0,1,0,1,0
18437,28,0,0,70,70,0,1,0,1,0
9265,28,0,0,70,70,0,1,0,1,0
9965,28,0,0,70,70,0,1,0,1,0
20612,28,0,0,70,70,0,1,0,1,0
14552,28,0,0,70,70,0,1,0,1,0
16769,28,0,0,70,70,0,1,0,1,0
9453,28,0,0,70,70,0,1,0,1,0
20614,28,0,0,70,70,0,1,0,1,0
20420,28,0,0,66,66,0,1,0,1,0
14055,28,0,0,70,70,0,1,0,1,0
16647,28,0,0,70,70,0,1,0,1,0
15052,28,0,0,70,70,0,1,0,1,0
12547,28,0,0,66,66,0,1,0,1,0
16006,28,0,0,70,70,0,1,0,1,0
19572,28,0,0,70,70,0,1,0,1,0
17459,28,0,0,66,66,0,1,0,1,0
13707,28,0,0,70,70,0,1,0,1,0
10313,28,0,0,70,70,0,1,0,1,0
13472,28,0,0,70,70,0,1,0,1,0
19753,28,0,0,70,70,0,1,0,1,0
19400,28,0,0,70,70,0,1,0,1,0
9255,28,0,0,66,66,0,1,0,1,0
19391,28,0,0,66,66,0,1,0,1,0
12300,28,0,0,70,70,0,1,0,1,0
10597,28,0,0,70,70,0,1,0,1,0
10783,28,0,0,70,70,0,1,0,1,0
22304,28,0,0,70,70,0,1,0,1,0
16025,28,0,0,70,70,0,1,0,1,0
15348,28,0,0,70,70,0,1,0,1,0
10687,28,0,0,66,66,0,1,0,1,0
15139,28,0,0,66,66,0,1,0,1,0
11628,28,0,0,70,70,0,1,0,1,0
11239,28,0,0,70,70,0,1,0,1,0
20277,28,0,0,70,70,0,1,0,1,0
16698,28,0,0,66,66,0,1,0,1,0
10615,28,0,0,66,66,0,1,0,1,0
9512,28,0,0,66,66,0,1,0,1,0
20530,28,0,0,66,66,0,1,0,1,0
16637,28,0,0,70,70,0,1,0,1,0
14736,28,0,0,70,70,0,1,0,1,0
20501,28,0,0,70,70,0,1,0,1,0
19961,28,0,0,70,70,0,1,0,1,0
14487,28,0,0,66,66,0,1,0,1,0
11323,28,0,0,66,66,0,1,0,1,0
22545,28,0,0,66,66,0,1,0,1,0
8608,28,0,0,66,66,0,1,0,1,0
17256,28,0,0,66,66,0,1,0,1,0
11670,28,0,0,70,70,0,1,0,1,0
8568,28,0,0,66,66,0,1,0,1,0
22471,28,0,0,70,70,0,1,0,1,0
9821,28,0,0,70,70,0,1,0,1,0
20557,28,0,0,70,70,0,1,0,1,0
21834,28,0,0,70,70,0,1,0,1,0
10498,28,0,0,66,66,0,1,0,1,0
22159,28,0,0,70,70,0,1,0,1,0
14147,28,0,0,70,70,0,1,0,1,0
12312,28,0,0,70,70,0,1,0,1,0
11762,28,0,0,70,70,0,1,0,1,0
22386,28,0,0,70,70,0,1,0,1,0
10369,28,0,0,66,66,0,1,0,1,0
9428,28,0,0,66,66,0,1,0,1,0
14723,28,0,0,70,70,0,1,0,1,0
12376,28,0,0,70,70,0,1,0,1,0
9197,28,0,0,70,70,0,1,0,1,0
12237,28,0,0,70,70,0,1,0,1,0
11074,28,0,0,70,70,0,1,0,1,0
17732,28,0,0,70,70,0,1,0,1,0
21955,28,0,0,66,66,0,1,0,1,0
13568,28,0,0,66,66,0,1,0,1,0
18166,28,0,0,66,66,0,1,0,1,0
11849,28,0,0,66,66,0,1,0,1,0
22568,28,0,0,66,66,0,1,0,1,0
17648,28,0,0,66,66,0,1,0,1,0
12568,28,0,0,70,70,0,1,0,1,0
9750,28,0,0,66,66,0,1,0,1,0
14029,28,0,0,70,70,0,1,0,1,0
9894,28,0,0,70,70,0,1,0,1,0
10133,28,0,0,66,66,0,1,0,1,0
13226,28,0,0,66,66,0,1,0,1,0
12619,28,0,0,66,66,0,1,0,1,0
20020,28,0,0,66,66,0,1,0,1,0
22567,28,0,0,66,66,0,1,0,1,0
12238,28,0,0,70,70,0,1,0,1,0
20023,28,0,0,66,66,0,1,0,1,0
14244,28,0,0,66,66,0,1,0,1,0
20070,28,0,0,70,70,0,1,0,1,0
18092,28,0,0,66,66,0,1,0,1,0
8659,28,0,0,70,70,0,1,0,1,0
14972,28,0,0,70,70,0,1,0,1,0
9146,28,0,0,66,66,0,1,0,1,0
14885,28,0,0,70,70,0,1,0,1,0
11703,28,0,0,70,70,0,1,0,1,0
22466,28,0,0,66,66,0,1,0,1,0
22239,28,0,0,70,70,0,1,0,1,0
10372,28,0,0,70,70,0,1,0,1,0
10165,28,0,0,70,70,0,1,0,1,0
11663,28,0,0,66,66,0,1,0,1,0
21797,28,0,0,66,66,0,1,0,1,0
17826,28,0,0,70,70,0,1,0,1,0
13429,28,0,0,70,70,0,1,0,1,0
17452,28,0,0,70,70,0,1,0,1,0
20890,28,0,0,70,70,0,1,0,1,0
16096,28,0,0,70,70,0,1,0,1,0
17192,28,0,0,70,70,0,1,0,1,0
10049,28,0,0,70,70,0,1,0,1,0
16199,28,0,0,70,70,0,1,0,1,0
14341,28,0,0,66,66,0,1,0,1,0
9470,28,0,0,66,66,0,1,0,1,0
19161,28,0,0,66,66,0,1,0,1,0
11710,28,0,0,66,66,0,1,0,1,0
19347,28,0,0,70,70,0,1,0,1,0
22435,28,0,0,70,70,0,1,0,1,0
16085,28,0,0,70,70,0,1,0,1,0
20687,28,0,0,70,70,0,1,0,1,0
9955,28,0,0,66,66,0,1,0,1,0
21256,28,0,0,66,66,0,1,0,1,0
13932,28,0,0,70,70,0,1,0,1,0
21576,28,0,0,66,66,0,1,0,1,0
9182,28,0,0,70,70,0,1,0,1,0
18206,28,0,0,66,66,0,1,0,1,0
19535,28,0,0,70,70,0,1,0,1,0
21586,28,0,0,70,70,0,1,0,1,0
11509,28,0,0,70,70,0,1,0,1,0
18439,28,0,0,70,70,0,1,0,1,0
12343,28,0,0,66,66,0,1,0,1,0
18880,28,0,0,66,66,0,1,0,1,0
9608,28,0,0,66,66,0,1,0,1,0
9577,28,0,0,70,70,0,1,0,1,0
15435,28,0,0,70,70,0,1,0,1,0
9407,28,0,0,70,70,0,1,0,1,0
20950,28,0,0,70,70,0,1,0,1,0
20699,28,0,0,70,70,0,1,0,1,0
13869,28,0,0,70,70,0,1,0,1,0
11120,28,0,0,66,66,0,1,0,1,0
9764,28,0,0,70,70,0,1,0,1,0
22086,28,0,0,66,66,0,1,0,1,0
12495,28,0,0,66,66,0,1,0,1,0
17257,28,0,0,70,70,0,1,0,1,0
9667,28,0,0,70,70,0,1,0,1,0
12478,28,0,0,70,70,0,1,0,1,0
9323,28,0,0,70,70,0,1,0,1,0
13063,28,0,0,70,70,0,1,0,1,0
10611,28,0,0,66,66,0,1,0,1,0
11114,28,0,0,66,66,0,1,0,1,0
15797,28,0,0,66,66,0,1,0,1,0
19181,28,0,0,70,70,0,1,0,1,0
17749,28,0,0,66,66,0,1,0,1,0
19454,28,0,0,70,70,0,1,0,1,0
13164,28,0,0,70,70,0,1,0,1,0
15607,28,0,0,66,66,0,1,0,1,0
16657,28,0,0,70,70,0,1,0,1,0
12482,28,0,0,66,66,0,1,0,1,0
9009,28,0,0,66,66,0,1,0,1,0
9377,28,0,0,70,70,0,1,0,1,0
8853,28,0,0,70,70,0,1,0,1,0
19156,28,0,0,70,70,0,1,0,1,0
19588,28,0,0,70,70,0,1,0,1,0
15747,28,0,0,70,70,0,1,0,1,0
13285,28,0,0,70,70,0,1,0,1,0
18297,28,0,0,70,70,0,1,0,1,0
12640,28,0,0,70,70,0,1,0,1,0
9529,28,0,0,70,70,0,1,0,1,0
15285,28,0,0,66,66,0,1,0,1,0
21903,28,0,0,70,70,0,1,0,1,0
11937,28,0,0,70,70,0,1,0,1,0
18536,28,0,0,66,66,0,1,0,1,0
19555,28,0,0,70,70,0,1,0,1,0
9415,28,0,0,70,70,0,1,0,1,0
9498,28,0,0,70,70,0,1,0,1,0
8732,28,0,0,70,70,0,1,0,1,0
14403,28,0,0,70,70,0,1,0,1,0
10046,28,0,0,70,70,0,1,0,1,0
8927,28,0,0,70,70,0,1,0,1,0
15780,28,0,0,66,66,0,1,0,1,0
14513,28,0,0,70,70,0,1,0,1,0
20740,28,0,0,66,66,0,1,0,1,0
9172,28,0,0,70,70,0,1,0,1,0
10738,28,0,0,70,70,0,1,0,1,0
12193,28,0,0,66,66,0,1,0,1,0
20285,28,0,0,70,70,0,1,0,1,0
9739,28,0,0,66,66,0,1,0,1,0
22626,28,0,0,66,66,0,1,0,1,0
17718,28,0,0,70,70,0,1,0,1,0
10731,28,0,0,66,66,0,1,0,1,0
11365,28,0,0,70,70,0,1,0,1,0
9629,28,0,0,70,70,0,1,0,1,0
17756,28,0,0,70,70,0,1,0,1,0
21186,28,0,0,70,70,0,1,0,1,0
19594,28,0,0,70,70,0,1,0,1,0
22220,28,0,0,66,66,0,1,0,1,0
19365,28,0,0,70,70,0,1,0,1,0
19431,28,0,0,70,70,0,1,0,1,0
15820,28,0,0,70,70,0,1,0,1,0
12193,28,0,0,70,70,0,1,0,1,0
9842,28,0,0,70,70,0,1,0,1,0
21367,28,0,0,70,70,0,1,0,1,0
9103,28,0,0,70,70,0,1,0,1,0
12281,28,0,0,66,66,0,1,0,1,0
9171,28,0,0,70,70,0,1,0,1,0
21184,28,0,0,66,66,0,1,0,1,0
14477,28,0,0,66,66,0,1,0,1,0
15732,28,0,0,70,70,0,1,0,1,0
22047,28,0,0,70,70,0,1,0,1,0
19207,28,0,0,70,70,0,1,0,1,0
17384,28,0,0,70,70,0,1,0,1,0
22041,28,0,0,70,70,0,1,0,1,0
12767,28,0,0,66,66,0,1,0,1,0
21137,28,0,0,70,70,0,1,0,1,0
20889,28,0,0,66,66,0,1,0,1,0
9932,28,0,0,70,70,0,1,0,1,0
11266,28,0,0,70,70,0,1,0,1,0
19693,28,0,0,66,66,0,1,0,1,0
12278,28,0,0,70,70,0,1,0,1,0
21815,28,0,0,70,70,0,1,0,1,0
12320,28,0,0,70,70,0,1,0,1,0
21691,28,0,0,66,66,0,1,0,1,0
9913,28,0,0,70,70,0,1,0,1,0
15783,28,0,0,66,66,0,1,0,1,0
16461,28,0,0,70,70,0,1,0,1,0
15583,28,0,0,70,70,0,1,0,1,0
12643,28,0,0,70,70,0,1,0,1,0
17366,28,0,0,70,70,0,1,0,1,0
10794,28,0,0,66,66,0,1,0,1,0
19890,28,0,0,66,66,0,1,0,1,0
14667,28,0,0,66,66,0,1,0,1,0
9004,28,0,0,70,70,0,1,0,1,0
18291,28,0,0,70,70,0,1,0,1,0
11548,28,0,0,70,70,0,1,0,1,0
9782,28,0,0,70,70,0,1,0,1,0
10128,28,0,0,70,70,0,1,0,1,0
8791,28,0,0,70,70,0,1,0,1,0
13036,28,0,0,70,70,0,1,0,1,0
15414,28,0,0,66,66,0,1,0,1,0
22722,28,0,0,66,66,0,1,0,1,0
8495,28,0,0,70,70,0,1,0,1,0
19686,28,0,0,66,66,0,1,0,1,0
15842,28,0,0,66,66,0,1,0,1,0
8754,28,0,0,66,66,0,1,0,1,0
13913,28,0,0,70,70,0,1,0,1,0
9033,28,0,0,70,70,0,1,0,1,0
13804,28,0,0,70,70,0,1,0,1,0
14307,28,0,0,70,70,0,1,0,1,0
18743,28,0,0,70,70,0,1,0,1,0
16208,28,0,0,66,66,0,1,0,1,0
18820,28,0,0,66,66,0,1,0,1,0
9130,28,0,0,66,66,0,1,0,1,0
13532,28,0,0,66,66,0,1,0,1,0
16236,28,0,0,70,70,0,1,0,1,0
15160,28,0,0,66,66,0,1,0,1,0
11213,28,0,0,70,70,0,1,0,1,0
16830,28,0,0,70,70,0,1,0,1,0
16996,28,0,0,70,70,0,1,0,1,0
14226,28,0,0,70,70,0,1,0,1,0
12372,28,0,0,70,70,0,1,0,1,0
13510,28,0,0,70,70,0,1,0,1,0
17407,28,0,0,70,70,0,1,0,1,0
16414,28,0,0,70,70,0,1,0,1,0
9973,28,0,0,66,66,0,1,0,1,0
14548,28,0,0,70,70,0,1,0,1,0
9979,28,0,0,70,70,0,1,0,1,0
11701,28,0,0,70,70,0,1,0,1,0
13601,28,0,0,70,70,0,1,0,1,0
13101,28,0,0,70,70,0,1,0,1,0
18716,28,0,0,66,66,0,1,0,1,0
19607,28,0,0,66,66,0,1,0,1,0
13083,28,0,0,70,70,0,1,0,1,0
17822,28,0,0,70,70,0,1,0,1,0
16037,28,0,0,70,70,0,1,0,1,0
14939,28,0,0,70,70,0,1,0,1,0
16444,28,0,0,66,66,0,1,0,1,0
11216,28,0,0,70,70,0,1,0,1,0
9763,28,0,0,70,70,0,1,0,1,0
22572,28,0,0,70,70,0,1,0,1,0
13651,28,0,0,70,70,0,1,0,1,0
11804,28,0,0,70,70,0,1,0,1,0
14187,28,0,0,70,70,0,1,0,1,0
14976,28,0,0,70,70,0,1,0,1,0
19315,28,0,0,70,70,0,1,0,1,0
12947,28,0,0,70,70,0,1,0,1,0
12167,28,0,0,70,70,0,1,0,1,0
19735,28,0,0,70,70,0,1,0,1,0
10594,28,0,0,70,70,0,1,0,1,0
14355,28,0,0,70,70,0,1,0,1,0
12223,28,0,0,66,66,0,1,0,1,0
16136,28,0,0,66,66,0,1,0,1,0
22213,28,0,0,70,70,0,1,0,1,0
18009,28,0,0,66,66,0,1,0,1,0
18746,28,0,0,70,70,0,1,0,1,0
15492,28,0,0,70,70,0,1,0,1,0
9502,28,0,0,70,70,0,1,0,1,0
19288,28,0,0,70,70,0,1,0,1,0
12309,28,0,0,70,70,0,1,0,1,0
10752,28,0,0,70,70,0,1,0,1,0
17737,28,0,0,70,70,0,1,0,1,0
15729,28,0,0,70,70,0,1,0,1,0
13438,28,0,0,70,70,0,1,0,1,0
19968,28,0,0,70,70,0,1,0,1,0
20213,28,0,0,70,70,0,1,0,1,0
11625,28,0,0,66,66,0,1,0,1,0
15191,28,0,0,70,70,0,1,0,1,0
12788,28,0,0,70,70,0,1,0,1,0
10169,28,0,0,70,70,0,1,0,1,0
21663,28,0,0,66,66,0,1,0,1,0
20596,28,0,0,70,70,0,1,0,1,0
9831,28,0,0,70,70,0,1,0,1,0
9659,28,0,0,70,70,0,1,0,1,0
9951,28,0,0,70,70,0,1,0,1,0
17446,28,0,0,66,66,0,1,0,1,0
10760,28,0,0,66,66,0,1,0,1,0
20189,28,0,0,70,70,0,1,0,1,0
10008,28,0,0,70,70,0,1,0,1,0
20700,28,0,0,66,66,0,1,0,1,0
12925,28,0,0,70,70,0,1,0,1,0
18950,28,0,0,66,66,0,1,0,1,0
11557,28,0,0,70,70,0,1,0,1,0
13003,28,0,0,66,66,0,1,0,1,0
13178,28,0,0,70,70,0,1,0,1,0
11692,28,0,0,70,70,0,1,0,1,0
19761,28,0,0,70,70,0,1,0,1,0
20479,28,0,0,66,66,0,1,0,1,0
22697,28,0,0,70,70,0,1,0,1,0
8415,28,0,0,66,66,0,1,0,1,0
11887,28,0,0,66,66,0,1,0,1,0
9693,28,0,0,66,66,0,1,0,1,0
12601,28,0,0,70,70,0,1,0,1,0
22003,28,0,0,70,70,0,1,0,1,0
17768,28,0,0,70,70,0,1,0,1,0
9646,28,0,0,66,66,0,1,0,1,0
19381,28,0,0,70,70,0,1,0,1,0
14388,28,0,0,70,70,0,1,0,1,0
13344,28,0,0,70,70,0,1,0,1,0
9646,28,0,0,70,70,0,1,0,1,0
18256,28,0,0,66,66,0,1,0,1,0
18173,28,0,0,70,70,0,1,0,1,0
14796,28,0,0,70,70,0,1,0,1,0
20129,28,0,0,70,70,0,1,0,1,0
19131,28,0,0,70,70,0,1,0,1,0
20145,28,0,0,66,66,0,1,0,1,0
22298,28,0,0,70,70,0,1,0,1,0
11945,28,0,0,66,66,0,1,0,1,0
11684,28,0,0,66,66,0,1,0,1,0
20186,28,0,0,70,70,0,1,0,1,0
19530,28,0,0,70,70,0,1,0,1,0
9315,28,0,0,70,70,0,1,0,1,0
16894,28,0,0,70,70,0,1,0,1,0
18617,28,0,0,70,70,0,1,0,1,0
9776,28,0,0,66,66,0,1,0,1,0
14056,28,0,0,70,70,0,1,0,1,0
19354,28,0,0,70,70,0,1,0,1,0
20712,28,0,0,70,70,0,1,0,1,0
9086,28,0,0,70,70,0,1,0,1,0
21715,28,0,0,70,70,0,1,0,1,0
19282,28,0,0,66,66,0,1,0,1,0
20679,28,0,0,70,70,0,1,0,1,0
11947,28,0,0,70,70,0,1,0,1,0
11564,28,0,0,66,66,0,1,0,1,0
20382,28,0,0,66,66,0,1,0,1,0
10932,28,0,0,70,70,0,1,0,1,0
19501,28,0,0,70,70,0,1,0,1,0
17352,28,0,0,70,70,0,1,0,1,0
9662,28,0,0,70,70,0,1,0,1,0
16008,28,0,0,70,70,0,1,0,1,0
17305,28,0,0,70,70,0,1,0,1,0
8793,28,0,0,70,70,0,1,0,1,0
11350,28,0,0,70,70,0,1,0,1,0
20648,28,0,0,70,70,0,1,0,1,0
14811,28,0,0,70,70,0,1,0,1,0
19227,28,0,0,66,66,0,1,0,1,0
19087,28,0,0,70,70,0,1,0,1,0
13317,28,0,0,66,66,0,1,0,1,0
14176,28,0,0,70,70,0,1,0,1,0
18563,28,0,0,70,70,0,1,0,1,0
19183,28,0,0,70,70,0,1,0,1,0
13366,28,0,0,70,70,0,1,0,1,0
10289,28,0,0,66,66,0,1,0,1,0
22646,28,0,0,70,70,0,1,0,1,0
17847,28,0,0,70,70,0,1,0,1,0
22260,28,0,0,70,70,0,1,0,1,0
16464,28,0,0,66,66,0,1,0,1,0
13976,28,0,0,66,66,0,1,0,1,0
9821,28,0,0,66,66,0,1,0,1,0
20871,28,0,0,70,70,0,1,0,1,0
14115,28,0,0,66,66,0,1,0,1,0
13228,28,0,0,70,70,0,1,0,1,0
17682,28,0,0,70,70,0,1,0,1,0
10028,28,0,0,70,70,0,1,0,1,0
16947,28,0,0,70,70,0,1,0,1,0
14219,28,0,0,70,70,0,1,0,1,0
17381,28,0,0,70,70,0,1,0,1,0
14711,28,0,0,66,66,0,1,0,1,0
22213,28,0,0,66,66,0,1,0,1,0
19737,28,0,0,66,66,0,1,0,1,0
16862,28,0,0,66,66,0,1,0,1,0
15685,28,0,0,70,70,0,1,0,1,0
11373,28,0,0,66,66,0,1,0,1,0
20685,28,0,0,70,70,0,1,0,1,0
19020,28,0,0,66,66,0,1,0,1,0
10337,28,0,0,70,70,0,1,0,1,0
11858,28,0,0,70,70,0,1,0,1,0
13625,28,0,0,70,70,0,1,0,1,0
14159,28,0,0,66,66,0,1,0,1,0
16811,28,0,0,70,70,0,1,0,1,0
17311,28,0,0,66,66,0,1,0,1,0
20877,28,0,0,70,70,0,1,0,1,0
17828,28,0,0,70,70,0,1,0,1,0
18829,28,0,0,70,70,0,1,0,1,0
20844,28,0,0,66,66,0,1,0,1,0
13687,28,0,0,70,70,0,1,0,1,0
22421,28,0,0,66,66,0,1,0,1,0
14726,28,0,0,66,66,0,1,0,1,0
16346,28,0,0,70,70,0,1,0,1,0
13628,28,0,0,70,70,0,1,0,1,0
18696,28,0,0,70,70,0,1,0,1,0
16331,28,0,0,70,70,0,1,0,1,0
20312,28,0,0,66,66,0,1,0,1,0
9449,28,0,0,70,70,0,1,0,1,0
14385,28,0,0,70,70,0,1,0,1,0
16321,28,0,0,70,70,0,1,0,1,0
18551,28,0,0,66,66,0,1,0,1,0
13053,28,0,0,70,70,0,1,0,1,0
12700,28,0,0,70,70,0,1,0,1,0
11276,28,0,0,70,70,0,1,0,1,0
22542,28,0,0,66,66,0,1,0,1,0
20413,28,0,0,70,70,0,1,0,1,0
19780,28,0,0,70,70,0,1,0,1,0
14750,28,0,0,70,70,0,1,0,1,0
12724,28,0,0,66,66,0,1,0,1,0
14847,28,0,0,66,66,0,1,0,1,0
10018,28,0,0,70,70,0,1,0,1,0
18888,28,0,0,70,70,0,1,0,1,0
16512,28,0,0,66,66,0,1,0,1,0
9860,28,0,0,66,66,0,1,0,1,0
12321,28,0,0,70,70,0,1,0,1,0
13737,28,0,0,70,70,0,1,0,1,0
11534,28,0,0,70,70,0,1,0,1,0
16832,28,0,0,66,66,0,1,0,1,0
17591,28,0,0,70,70,0,1,0,1,0
19602,28,0,0,70,70,0,1,0,1,0
9050,28,0,0,70,70,0,1,0,1,0
21959,28,0,0,70,70,0,1,0,1,0
12769,28,0,0,66,66,0,1,0,1,0
17853,28,0,0,70,70,0,1,0,1,0
13376,28,0,0,66,66,0,1,0,1,0
11333,28,0,0,70,70,0,1,0,1,0
22236,28,0,0,70,70,0,1,0,1,0
22223,28,0,0,70,70,0,1,0,1,0
13369,28,0,0,70,70,0,1,0,1,0
18371,28,0,0,66,66,0,1,0,1,0
10797,28,0,0,70,70,0,1,0,1,0
16258,28,0,0,70,70,0,1,0,1,0
20678,28,0,0,70,70,0,1,0,1,0
21785,28,0,0,70,70,0,1,0,1,0
19950,28,0,0,70,70,0,1,0,1,0
18239,28,0,0,70,70,0,1,0,1,0
19214,28,0,0,70,70,0,1,0,1,0
10689,28,0,0,70,70,0,1,0,1,0
20101,28,0,0,70,70,0,1,0,1,0
13745,28,0,0,66,66,0,1,0,1,0
11240,28,0,0,70,70,0,1,0,1,0
14840,28,0,0,70,70,0,1,0,1,0
12396,28,0,0,66,66,0,1,0,1,0
12840,28,0,0,66,66,0,1,0,1,0
20622,28,0,0,66,66,0,1,0,1,0
15564,28,0,0,66,66,0,1,0,1,0
15199,28,0,0,70,70,0,1,0,1,0
19676,28,0,0,70,70,0,1,0,1,0
17741,28,0,0,66,66,0,1,0,1,0
13590,28,0,0,66,66,0,1,0,1,0
22133,28,0,0,66,66,0,1,0,1,0
10480,28,0,0,70,70,0,1,0,1,0
9212,28,0,0,66,66,0,1,0,1,0
15322,28,0,0,70,70,0,1,0,1,0
8818,28,0,0,70,70,0,1,0,1,0
20444,28,0,0,66,66,0,1,0,1,0
15686,28,0,0,66,66,0,1,0,1,0
12786,28,0,0,66,66,0,1,0,1,0
21806,28,0,0,66,66,0,1,0,1,0
10145,28,0,0,66,66,0,1,0,1,0
12504,28,0,0,66,66,0,1,0,1,0
8642,28,0,0,70,70,0,1,0,1,0
15131,28,0,0,70,70,0,1,0,1,0
19085,28,0,0,70,70,0,1,0,1,0
16509,28,0,0,70,70,0,1,0,1,0
18147,28,0,0,66,66,0,1,0,1,0
18402,28,0,0,70,70,0,1,0,1,0
19487,28,0,0,66,66,0,1,0,1,0
8447,28,0,0,70,70,0,1,0,1,0
12192,28,0,0,70,70,0,1,0,1,0
14247,28,0,0,70,70,0,1,0,1,0
10746,28,0,0,70,70,0,1,0,1,0
19126,28,0,0,70,70,0,1,0,1,0
9974,28,0,0,70,70,0,1,0,1,0
14387,28,0,0,66,66,0,1,0,1,0
10753,28,0,0,70,70,0,1,0,1,0
16880,28,0,0,70,70,0,1,0,1,0
12347,28,0,0,66,66,0,1,0,1,0
13439,28,0,0,70,70,0,1,0,1,0
18353,28,0,0,70,70,0,1,0,1,0
17457,28,0,0,66,66,0,1,0,1,0
15129,28,0,0,70,70,0,1,0,1,0
15116,28,0,0,70,70,0,1,0,1,0
17764,28,0,0,66,66,0,1,0,1,0
17189,28,0,0,66,66,0,1,0,1,0
15974,28,0,0,66,66,0,1,0,1,0
10575,28,0,0,70,70,0,1,0,1,0
21639,28,0,0,70,70,0,1,0,1,0
20506,28,0,0,70,70,0,1,0,1,0
19356,28,0,0,66,66,0,1,0,1,0
20279,28,0,0,70,70,0,1,0,1,0
20783,28,0,0,70,70,0,1,0,1,0
22196,28,0,0,66,66,0,1,0,1,0
9641,28,0,0,70,70,0,1,0,1,0
9437,28,0,0,66,66,0,1,0,1,0
17394,28,0,0,66,66,0,1,0,1,0
9669,28,0,0,70,70,0,1,0,1,0
18401,28,0,0,70,70,0,1,0,1,0
19816,28,0,0,70,70,0,1,0,1,0
14813,28,0,0,70,70,0,1,0,1,0
21133,28,0,0,66,66,0,1,0,1,0
16107,28,0,0,70,70,0,1,0,1,0
18676,28,0,0,70,70,0,1,0,1,0
11599,28,0,0,70,70,0,1,0,1,0
18728,28,0,0,70,70,0,1,0,1,0
16792,28,0,0,70,70,0,1,0,1,0
9288,28,0,0,70,70,0,1,0,1,0
10674,28,0,0,66,66,0,1,0,1,0
17727,28,0,0,70,70,0,1,0,1,0
10692,28,0,0,70,70,0,1,0,1,0
9193,28,0,0,70,70,0,1,0,1,0
9559,28,0,0,70,70,0,1,0,1,0
18175,28,0,0,70,70,0,1,0,1,0
20234,28,0,0,70,70,0,1,0,1,0
16865,28,0,0,70,70,0,1,0,1,0
8404,28,0,0,70,70,0,1,0,1,0
22224,28,0,0,70,70,0,1,0,1,0
11268,28,0,0,70,70,0,1,0,1,0
15123,28,0,0,70,70,0,1,0,1,0
14825,28,0,0,70,70,0,1,0,1,0
19073,28,0,0,70,70,0,1,0,1,0
11778,28,0,0,66,66,0,1,0,1,0
17538,28,0,0,66,66,0,1,0,1,0
12141,28,0,0,70,70,0,1,0,1,0
20900,28,0,0,70,70,0,1,0,1,0
20028,28,0,0,66,66,0,1,0,1,0
9270,28,0,0,70,70,0,1,0,1,0
15633,28,0,0,70,70,0,1,0,1,0
11463,28,0,0,66,66,0,1,0,1,0
10140,28,0,0,66,66,0,1,0,1,0
12005,28,0,0,66,66,0,1,0,1,0
9679,28,0,0,66,66,0,1,0,1,0
20338,28,0,0,66,66,0,1,0,1,0
12564,28,0,0,70,70,0,1,0,1,0
21748,28,0,0,70,70,0,1,0,1,0
11961,28,0,0,70,70,0,1,0,1,0
17857,28,0,0,66,66,0,1,0,1,0
21055,28,0,0,70,70,0,1,0,1,0
8361,28,0,0,70,70,0,1,0,1,0
8709,28,0,0,66,66,0,1,0,1,0
15710,28,0,0,66,66,0,1,0,1,0
16443,28,0,0,66,66,0,1,0,1,0
15290,28,0,0,70,70,0,1,0,1,0
13990,28,0,0,66,66,0,1,0,1,0
14562,28,0,0,66,66,0,1,0,1,0
21831,28,0,0,66,66,0,1,0,1,0
15253,28,0,0,70,70,0,1,0,1,0
22587,28,0,0,70,70,0,1,0,1,0
20650,28,0,0,66,66,0,1,0,1,0
11973,28,0,0,70,70,0,1,0,1,0
17795,28,0,0,66,66,0,1,0,1,0
9935,28,0,0,66,66,0,1,0,1,0
9573,28,0,0,70,70,0,1,0,1,0
13777,28,0,0,70,70,0,1,0,1,0
21695,28,0,0,70,70,0,1,0,1,0
12957,28,0,0,70,70,0,1,0,1,0
16739,28,0,0,70,70,0,1,0,1,0
22691,28,0,0,70,70,0,1,0,1,0
8335,28,0,0,70,70,0,1,0,1,0
17458,28,0,0,70,70,0,1,0,1,0
8409,28,0,0,70,70,0,1,0,1,0
21916,28,0,0,70,70,0,1,0,1,0
15903,28,0,0,66,66,0,1,0,1,0
16180,28,0,0,70,70,0,1,0,1,0
15183,28,0,0,70,70,0,1,0,1,0
12532,28,0,0,66,66,0,1,0,1,0
19669,28,0,0,70,70,0,1,0,1,0
16614,28,0,0,70,70,0,1,0,1,0
22368,28,0,0,66,66,0,1,0,1,0
11045,28,0,0,70,70,0,1,0,1,0
21956,28,0,0,70,70,0,1,0,1,0
13330,28,0,0,70,70,0,1,0,1,0
16560,28,0,0,66,66,0,1,0,1,0
20718,28,0,0,70,70,0,1,0,1,0
19834,28,0,0,66,66,0,1,0,1,0
16785,28,0,0,70,70,0,1,0,1,0
19908,28,0,0,70,70,0,1,0,1,0
9238,28,0,0,66,66,0,1,0,1,0
16039,28,0,0,66,66,0,1,0,1,0
8485,28,0,0,70,70,0,1,0,1,0
13858,28,0,0,70,70,0,1,0,1,0
9173,28,0,0,70,70,0,1,0,1,0
22695,28,0,0,66,66,0,1,0,1,0
18019,28,0,0,66,66,0,1,0,1,0
9055,28,0,0,66,66,0,1,0,1,0
21563,28,0,0,70,70,0,1,0,1,0
19671,28,0,0,70,70,0,1,0,1,0
18450,28,0,0,66,66,0,1,0,1,0
13810,28,0,0,70,70,0,1,0,1,0
15672,28,0,0,70,70,0,1,0,1,0
17124,28,0,0,70,70,0,1,0,1,0
15278,28,0,0,70,70,0,1,0,1,0
13932,28,0,0,70,70,0,1,0,1,0
8559,28,0,0,66,66,0,1,0,1,0
19596,28,0,0,66,66,0,1,0,1,0
14899,28,0,0,70,70,0,1,0,1,0
9991,28,0,0,70,70,0,1,0,1,0
18242,28,0,0,66,66,0,1,0,1,0
14125,28,0,0,70,70,0,1,0,1,0
15532,28,0,0,70,70,0,1,0,1,0
16244,28,0,0,70,70,0,1,0,1,0
22299,28,0,0,70,70,0,1,0,1,0
13477,28,0,0,66,66,0,1,0,1,0
9943,28,0,0,66,66,0,1,0,1,0
14173,28,0,0,70,70,0,1,0,1,0
17594,28,0,0,66,66,0,1,0,1,0
13352,28,0,0,70,70,0,1,0,1,0
11075,28,0,0,70,70,0,1,0,1,0
21212,28,0,0,70,70,0,1,0,1,0
17212,28,0,0,70,70,0,1,0,1,0
15763,28,0,0,66,66,0,1,0,1,0
22473,28,0,0,66,66,0,1,0,1,0
12159,28,0,0,70,70,0,1,0,1,0
21033,28,0,0,70,70,0,1,0,1,0
13805,28,0,0,66,66,0,1,0,1,0
13737,28,0,0,70,70,0,1,0,1,0
15181,28,0,0,66,66,0,1,0,1,0
9195,28,0,0,66,66,0,1,0,1,0
19541,28,0,0,66,66,0,1,0,1,0
20357,28,0,0,70,70,0,1,0,1,0
16071,28,0,0,70,70,0,1,0,1,0
9855,28,0,0,70,70,0,1,0,1,0
19664,28,0,0,70,70,0,1,0,1,0
9415,28,0,0,66,66,0,1,0,1,0
10061,28,0,0,66,66,0,1,0,1,0
8663,28,0,0,70,70,0,1,0,1,0
10139,28,0,0,70,70,0,1,0,1,0
19910,28,0,0,70,70,0,1,0,1,0
13415,28,0,0,70,70,0,1,0,1,0
21903,28,0,0,70,70,0,1,0,1,0
22069,28,0,0,70,70,0,1,0,1,0
16044,28,0,0,66,66,0,1,0,1,0
21174,28,0,0,70,70,0,1,0,1,0
13008,28,0,0,66,66,0,1,0,1,0
17852,28,0,0,70,70,0,1,0,1,0
20174,28,0,0,66,66,0,1,0,1,0
18694,28,0,0,70,70,0,1,0,1,0
16167,28,0,0,70,70,0,1,0,1,0
9860,28,0,0,70,70,0,1,0,1,0
18861,28,0,0,70,70,0,1,0,1,0
12893,28,0,0,66,66,0,1,0,1,0
11485,28,0,0,70,70,0,1,0,1,0
13504,28,0,0,70,70,0,1,0,1,0
11603,28,0,0,66,66,0,1,0,1,0
16680,28,0,0,70,70,0,1,0,1,0
13251,28,0,0,70,70,0,1,0,1,0
9390,28,0,0,70,70,0,1,0,1,0
22659,28,0,0,70,70,0,1,0,1,0
16064,28,0,0,70,70,0,1,0,1,0
22149,28,0,0,66,66,0,1,0,1,0
14901,28,0,0,70,70,0,1,0,1,0
16738,28,0,0,70,70,0,1,0,1,0
13140,28,0,0,70,70,0,1,0,1,0
22034,28,0,0,66,66,0,1,0,1,0
19792,28,0,0,66,66,0,1,0,1,0
9211,28,0,0,70,70,0,1,0,1,0
8844,28,0,0,70,70,0,1,0,1,0
8961,28,0,0,70,70,0,1,0,1,0
16981,28,0,0,70,70,0,1,0,1,0
22277,28,0,0,70,70,0,1,0,1,0
9056,28,0,0,70,70,0,1,0,1,0
10690,28,0,0,70,70,0,1,0,1,0
17972,28,0,0,70,70,0,1,0,1,0
20076,28,0,0,70,70,0,1,0,1,0
13538,28,0,0,70,70,0,1,0,1,0
9589,28,0,0,70,70,0,1,0,1,0
21492,28,0,0,70,70,0,1,0,1,0
18423,28,0,0,66,66,0,1,0,1,0
13359,28,0,0,66,66,0,1,0,1,0
9184,28,0,0,70,70,0,1,0,1,0
20656,28,0,0,70,70,0,1,0,1,0
14966,28,0,0,70,70,0,1,0,1,0
9069,28,0,0,70,70,0,1,0,1,0
11932,28,0,0,70,70,0,1,0,1,0
16128,28,0,0,70,70,0,1,0,1,0
22127,28,0,0,70,70,0,1,0,1,0
13556,28,0,0,66,66,0,1,0,1,0
18072,28,0,0,66,66,0,1,0,1,0
13056,28,0,0,66,66,0,1,0,1,0
10641,28,0,0,70,70,0,1,0,1,0
18043,28,0,0,70,70,0,1,0,1,0
17191,28,0,0,70,70,0,1,0,1,0
14296,28,0,0,70,70,0,1,0,1,0
16497,28,0,0,66,66,0,1,0,1,0
9410,28,0,0,70,70,0,1,0,1,0
14496,28,0,0,70,70,0,1,0,1,0
21652,28,0,0,66,66,0,1,0,1,0
13596,28,0,0,70,70,0,1,0,1,0
9883,28,0,0,66,66,0,1,0,1,0
11637,28,0,0,70,70,0,1,0,1,0
10732,28,0,0,66,66,0,1,0,1,0
18630,28,0,0,66,66,0,1,0,1,0
12739,28,0,0,70,70,0,1,0,1,0
12907,28,0,0,66,66,0,1,0,1,0
8756,28,0,0,66,66,0,1,0,1,0
8620,28,0,0,70,70,0,1,0,1,0
20393,28,0,0,66,66,0,1,0,1,0
15006,28,0,0,70,70,0,1,0,1,0
18741,28,0,0,70,70,0,1,0,1,0
8430,28,0,0,66,66,0,1,0,1,0
17728,28,0,0,66,66,0,1,0,1,0
17600,28,0,0,66,66,0,1,0,1,0
19824,28,0,0,70,70,0,1,0,1,0
14830,28,0,0,70,70,0,1,0,1,0
18150,28,0,0,70,70,0,1,0,1,0
9293,28,0,0,70,70,0,1,0,1,0
15153,28,0,0,70,70,0,1,0,1,0
16488,28,0,0,70,70,0,1,0,1,0
14707,28,0,0,70,70,0,1,0,1,0
11977,28,0,0,70,70,0,1,0,1,0
14713,28,0,0,70,70,0,1,0,1,0
21498,28,0,0,70,70,0,1,0,1,0
17267,28,0,0,66,66,0,1,0,1,0
10496,28,0,0,70,70,0,1,0,1,0
18634,28,0,0,70,70,0,1,0,1,0
22175,28,0,0,70,70,0,1,0,1,0
10741,28,0,0,70,70,0,1,0,1,0
13138,28,0,0,70,70,0,1,0,1,0
17520,28,0,0,70,70,0,1,0,1,0
14314,28,0,0,70,70,0,1,0,1,0
9586,28,0,0,70,70,0,1,0,1,0
14782,28,0,0,66,66,0,1,0,1,0
9262,28,0,0,70,70,0,1,0,1,0
19184,28,0,0,70,70,0,1,0,1,0
22711,28,0,0,70,70,0,1,0,1,0
12348,28,0,0,66,66,0,1,0,1,0
11967,28,0,0,70,70,0,1,0,1,0
21473,28,0,0,66,66,0,1,0,1,0
10404,28,0,0,66,66,0,1,0,1,0
22502,28,0,0,70,70,0,1,0,1,0
9090,28,0,0,70,70,0,1,0,1,0
18146,28,0,0,66,66,0,1,0,1,0
12302,28,0,0,70,70,0,1,0,1,0
19683,28,0,0,70,70,0,1,0,1,0
11451,28,0,0,70,70,0,1,0,1,0
19791,28,0,0,66,66,0,1,0,1,0
18717,28,0,0,66,66,0,1,0,1,0
16849,28,0,0,70,70,0,1,0,1,0
12450,28,0,0,66,66,0,1,0,1,0
9712,28,0,0,66,66,0,1,0,1,0
12589,28,0,0,70,70,0,1,0,1,0
16010,28,0,0,70,70,0,1,0,1,0
12313,28,0,0,70,70,0,1,0,1,0
11581,28,0,0,70,70,0,1,0,1,0
16717,28,0,0,66,66,0,1,0,1,0
11842,28,0,0,66,66,0,1,0,1,0
16149,28,0,0,70,70,0,1,0,1,0
14862,28,0,0,66,66,0,1,0,1,0
21170,28,0,0,66,66,0,1,0,1,0
22265,28,0,0,70,70,0,1,0,1,0
12884,28,0,0,70,70,0,1,0,1,0
20099,28,0,0,70,70,0,1,0,1,0
12196,28,0,0,70,70,0,1,0,1,0
11745,28,0,0,70,70,0,1,0,1,0
18090,28,0,0,70,70,0,1,0,1,0
11377,28,0,0,70,70,0,1,0,1,0
9527,28,0,0,70,70,0,1,0,1,0
11779,28,0,0,70,70,0,1,0,1,0
9791,28,0,0,70,70,0,1,0,1,0
12601,28,0,0,70,70,0,1,0,1,0
15474,28,0,0,66,66,0,1,0,1,0
10059,28,0,0,70,70,0,1,0,1,0
20115,28,0,0,66,66,0,1,0,1,0
10222,28,0,0,66,66,0,1,0,1,0
12005,28,0,0,70,70,0,1,0,1,0
20760,28,0,0,70,70,0,1,0,1,0
18560,28,0,0,66,66,0,1,0,1,0
21523,28,0,0,70,70,0,1,0,1,0
17420,28,0,0,70,70,0,1,0,1,0
22322,28,0,0,66,66,0,1,0,1,0
13943,28,0,0,70,70,0,1,0,1,0
18242,28,0,0,70,70,0,1,0,1,0
20134,28,0,0,66,66,0,1,0,1,0
12254,28,0,0,70,70,0,1,0,1,0
11352,28,0,0,70,70,0,1,0,1,0
10345,28,0,0,66,66,0,1,0,1,0
15005,28,0,0,70,70,0,1,0,1,0
17939,28,0,0,66,66,0,1,0,1,0
14900,28,0,0,70,70,0,1,0,1,0
8621,28,0,0,66,66,0,1,0,1,0
13284,28,0,0,70,70,0,1,0,1,0
9230,28,0,0,70,70,0,1,0,1,0
10875,28,0,0,70,70,0,1,0,1,0
18919,28,0,0,70,70,0,1,0,1,0
14653,28,0,0,70,70,0,1,0,1,0
21672,28,0,0,70,70,0,1,0,1,0
22647,28,0,0,70,70,0,1,0,1,0
16270,28,0,0,70,70,0,1,0,1,0
9766,28,0,0,66,66,0,1,0,1,0
17293,28,0,0,66,66,0,1,0,1,0
19315,28,0,0,66,66,0,1,0,1,0
11484,28,0,0,70,70,0,1,0,1,0
20976,28,0,0,70,70,0,1,0,1,0
13794,28,0,0,70,70,0,1,0,1,0
14350,28,0,0,70,70,0,1,0,1,0
12704,28,0,0,66,66,0,1,0,1,0
9600,28,0,0,70,70,0,1,0,1,0
21756,28,0,0,70,70,0,1,0,1,0
15743,28,0,0,66,66,0,1,0,1,0
20968,28,0,0,70,70,0,1,0,1,0
20893,28,0,0,70,70,0,1,0,1,0
16808,28,0,0,66,66,0,1,0,1,0
13291,28,0,0,70,70,0,1,0,1,0
10922,28,0,0,66,66,0,1,0,1,0
19478,28,0,0,70,70,0,1,0,1,0
13441,28,0,0,66,66,0,1,0,1,0
20547,28,0,0,70,70,0,1,0,1,0
10634,28,0,0,70,70,0,1,0,1,0
15905,28,0,0,66,66,0,1,0,1,0
19136,28,0,0,66,66,0,1,0,1,0
22063,28,0,0,70,70,0,1,0,1,0
10430,28,0,0,70,70,0,1,0,1,0
16504,28,0,0,70,70,0,1,0,1,0
18305,28,0,0,70,70,0,1,0,1,0
13319,28,0,0,66,66,0,1,0,1,0
20627,28,0,0,70,70,0,1,0,1,0
22139,28,0,0,70,70,0,1,0,1,0
16724,28,0,0,70,70,0,1,0,1,0
13531,28,0,0,70,70,0,1,0,1,0
15353,28,0,0,66,66,0,1,0,1,0
11300,28,0,0,70,70,0,1,0,1,0
12039,28,0,0,70,70,0,1,0,1,0
17307,28,0,0,70,70,0,1,0,1,0
13090,28,0,0,70,70,0,1,0,1,0
9652,28,0,0,66,66,0,1,0,1,0
12656,28,0,0,66,66,0,1,0,1,0
13239,28,0,0,66,66,0,1,0,1,0
15680,28,0,0,70,70,0,1,0,1,0
14371,28,0,0,66,66,0,1,0,1,0
21658,28,0,0,70,70,0,1,0,1,0
19475,28,0,0,70,70,0,1,0,1,0
12179,28,0,0,70,70,0,1,0,1,0
18570,28,0,0,70,70,0,1,0,1,0
10859,28,0,0,66,66,0,1,0,1,0
9454,28,0,0,70,70,0,1,0,1,0
19096,28,0,0,70,70,0,1,0,1,0
12273,28,0,0,70,70,0,1,0,1,0
8382,28,0,0,70,70,0,1,0,1,0
12237,28,0,0,66,66,0,1,0,1,0
12291,28,0,0,70,70,0,1,0,1,0
14326,28,0,0,70,70,0,1,0,1,0
10114,28,0,0,66,66,0,1,0,1,0
12885,28,0,0,70,70,0,1,0,1,0
16623,28,0,0,70,70,0,1,0,1,0
21289,28,0,0,70,70,0,1,0,1,0
20859,28,0,0,66,66,0,1,0,1,0
9203,28,0,0,70,70,0,1,0,1,0
22492,28,0,0,70,70,0,1,0,1,0
14239,28,0,0,70,70,0,1,0,1,0
17809,28,0,0,70,70,0,1,0,1,0
11461,28,0,0,66,66,0,1,0,1,0
21689,28,0,0,66,66,0,1,0,1,0
9470,28,0,0,66,66,0,1,0,1,0
11928,28,0,0,70,70,0,1,0,1,0
17000,28,0,0,70,70,0,1,0,1,0
18181,28,0,0,70,70,0,1,0,1,0
14325,28,0,0,70,70,0,1,0,1,0
18188,28,0,0,66,66,0,1,0,1,0
21832,28,0,0,66,66,0,1,0,1,0
9836,28,0,0,70,70,0,1,0,1,0
19128,28,0,0,70,70,0,1,0,1,0
12515,28,0,0,66,66,0,1,0,1,0
16085,28,0,0,66,66,0,1,0,1,0
17065,28,0,0,70,70,0,1,0,1,0
17957,28,0,0,70,70,0,1,0,1,0
9293,28,0,0,70,70,0,1,0,1,0
20678,28,0,0,70,70,0,1,0,1,0
10377,28,0,0,70,70,0,1,0,1,0
14889,28,0,0,66,66,0,1,0,1,0
19004,28,0,0,66,66,0,1,0,1,0
13688,28,0,0,66,66,0,1,0,1,0
12368,28,0,0,70,70,0,1,0,1,0
9166,28,0,0,70,70,0,1,0,1,0
9134,28,0,0,66,66,0,1,0,1,0
11737,28,0,0,66,66,0,1,0,1,0
19578,28,0,0,70,70,0,1,0,1,0
12546,28,0,0,70,70,0,1,0,1,0
19210,28,0,0,70,70,0,1,0,1,0
17595,28,0,0,66,66,0,1,0,1,0
21765,28,0,0,66,66,0,1,0,1,0
9920,28,0,0,66,66,0,1,0,1,0
22565,28,0,0,70,70,0,1,0,1,0
13521,28,0,0,70,70,0,1,0,1,0
20705,28,0,0,70,70,0,1,0,1,0
9091,28,0,0,70,70,0,1,0,1,0
9522,28,0,0,70,70,0,1,0,1,0
15776,28,0,0,66,66,0,1,0,1,0
16735,28,0,0,70,70,0,1,0,1,0
13371,28,0,0,70,70,0,1,0,1,0
9960,28,0,0,66,66,0,1,0,1,0
9694,28,0,0,70,70,0,1,0,1,0
17499,28,0,0,66,66,0,1,0,1,0
13871,28,0,0,66,66,0,1,0,1,0
18135,28,0,0,70,70,0,1,0,1,0
13665,28,0,0,70,70,0,1,0,1,0
10140,28,0,0,70,70,0,1,0,1,0
14958,28,0,0,66,66,0,1,0,1,0
19256,28,0,0,70,70,0,1,0,1,0
13047,28,0,0,66,66,0,1,0,1,0
21369,28,0,0,70,70,0,1,0,1,0
9735,28,0,0,70,70,0,1,0,1,0
9404,28,0,0,70,70,0,1,0,1,0
16275,28,0,0,66,66,0,1,0,1,0
11416,28,0,0,70,70,0,1,0,1,0
14700,28,0,0,70,70,0,1,0,1,0
16190,28,0,0,66,66,0,1,0,1,0
10304,28,0,0,70,70,0,1,0,1,0
9926,28,0,0,66,66,0,1,0,1,0
15271,28,0,0,70,70,0,1,0,1,0
14238,28,0,0,66,66,0,1,0,1,0
13221,28,0,0,66,66,0,1,0,1,0
13977,28,0,0,70,70,0,1,0,1,0
10216,28,0,0,70,70,0,1,0,1,0
13760,28,0,0,70,70,0,1,0,1,0
9042,28,0,0,70,70,0,1,0,1,0
17566,28,0,0,70,70,0,1,0,1,0
9154,28,0,0,66,66,0,1,0,1,0
17586,28,0,0,70,70,0,1,0,1,0
10408,28,0,0,70,70,0,1,0,1,0
9552,28,0,0,70,70,0,1,0,1,0
16683,28,0,0,66,66,0,1,0,1,0
15474,28,0,0,70,70,0,1,0,1,0
13594,28,0,0,70,70,0,1,0,1,0
9417,28,0,0,70,70,0,1,0,1,0
22161,28,0,0,70,70,0,1,0,1,0
11407,28,0,0,66,66,0,1,0,1,0
17800,28,0,0,66,66,0,1,0,1,0
9971,28,0,0,70,70,0,1,0,1,0
21427,28,0,0,70,70,0,1,0,1,0
20451,28,0,0,70,70,0,1,0,1,0
17886,28,0,0,70,70,0,1,0,1,0
13275,28,0,0,70,70,0,1,0,1,0
9690,28,0,0,70,70,0,1,0,1,0
18608,28,0,0,70,70,0,1,0,1,0
17463,28,0,0,70,70,0,1,0,1,0
18927,28,0,0,70,70,0,1,0,1,0
22233,28,0,0,66,66,0,1,0,1,0
19301,28,0,0,70,70,0,1,0,1,0
10460,28,0,0,70,70,0,1,0,1,0
18974,28,0,0,70,70,0,1,0,1,0
19829,28,0,0,70,70,0,1,0,1,0
11564,28,0,0,70,70,0,1,0,1,0
10194,28,0,0,70,70,0,1,0,1,0
19432,28,0,0,70,70,0,1,0,1,0
14268,28,0,0,70,70,0,1,0,1,0
20625,28,0,0,70,70,0,1,0,1,0
14826,28,0,0,70,70,0,1,0,1,0
18346,28,0,0,70,70,0,1,0,1,0
21681,28,0,0,70,70,0,1,0,1,0
17538,28,0,0,70,70,0,1,0,1,0
13095,28,0,0,70,70,0,1,0,1,0
20440,28,0,0,70,70,0,1,0,1,0
16081,28,0,0,70,70,0,1,0,1,0
16553,28,0,0,66,66,0,1,0,1,0
12104,28,0,0,70,70,0,1,0,1,0
11406,28,0,0,70,70,0,1,0,1,0
22634,28,0,0,70,70,0,1,0,1,0
9567,28,0,0,70,70,0,1,0,1,0
8781,28,0,0,70,70,0,1,0,1,0
16529,28,0,0,66,66,0,1,0,1,0
18504,28,0,0,70,70,0,1,0,1,0
11031,28,0,0,70,70,0,1,0,1,0
9273,28,0,0,66,66,0,1,0,1,0
19651,28,0,0,70,70,0,1,0,1,0
20185,28,0,0,70,70,0,1,0,1,0
19743,28,0,0,70,70,0,1,0,1,0
10800,28,0,0,70,70,0,1,0,1,0
21723,28,0,0,70,70,0,1,0,1,0
13210,28,0,0,66,66,0,1,0,1,0
18555,28,0,0,66,66,0,1,0,1,0
18987,28,0,0,70,70,0,1,0,1,0
21086,28,0,0,70,70,0,1,0,1,0
21626,28,0,0,66,66,0,1,0,1,0
22507,28,0,0,70,70,0,1,0,1,0
14124,28,0,0,66,66,0,1,0,1,0
19359,28,0,0,70,70,0,1,0,1,0
11719,28,0,0,66,66,0,1,0,1,0
19227,28,0,0,70,70,0,1,0,1,0
9858,28,0,0,70,70,0,1,0,1,0
12653,28,0,0,66,66,0,1,0,1,0
11401,28,0,0,66,66,0,1,0,1,0
14372,28,0,0,66,66,0,1,0,1,0
17054,28,0,0,66,66,0,1,0,1,0
16298,28,0,0,70,70,0,1,0,1,0
11727,28,0,0,66,66,0,1,0,1,0
16400,28,0,0,70,70,0,1,0,1,0
9917,28,0,0,70,70,0,1,0,1,0
15537,28,0,0,66,66,0,1,0,1,0
18648,28,0,0,70,70,0,1,0,1,0
22402,28,0,0,70,70,0,1,0,1,0
19063,28,0,0,70,70,0,1,0,1,0
12243,28,0,0,66,66,0,1,0,1,0
11404,28,0,0,66,66,0,1,0,1,0
18165,28,0,0,70,70,0,1,0,1,0
18404,28,0,0,70,70,0,1,0,1,0
11080,28,0,0,70,70,0,1,0,1,0
9097,28,0,0,70,70,0,1,0,1,0
20714,28,0,0,70,70,0,1,0,1,0
13756,28,0,0,70,70,0,1,0,1,0
10157,28,0,0,70,70,0,1,0,1,0
13685,28,0,0,66,66,0,1,0,1,0
17921,28,0,0,70,70,0,1,0,1,0
15045,28,0,0,70,70,0,1,0,1,0
11585,28,0,0,70,70,0,1,0,1,0
11537,28,0,0,70,70,0,1,0,1,0
15028,28,0,0,66,66,0,1,0,1,0
17356,28,0,0,66,66,0,1,0,1,0
21587,28,0,0,70,70,0,1,0,1,0
18991,28,0,0,70,70,0,1,0,1,0
22536,28,0,0,70,70,0,1,0,1,0
9526,28,0,0,70,70,0,1,0,1,0
19869,28,0,0,70,70,0,1,0,1,0
20168,28,0,0,66,66,0,1,0,1,0
10598,28,0,0,66,66,0,1,0,1,0
11067,28,0,0,66,66,0,1,0,1,0
22087,28,0,0,70,70,0,1,0,1,0
11978,28,0,0,70,70,0,1,0,1,0
16358,28,0,0,70,70,0,1,0,1,0
11605,28,0,0,70,70,0,1,0,1,0
14723,28,0,0,66,66,0,1,0,1,0
19281,28,0,0,70,70,0,1,0,1,0
15657,28,0,0,70,70,0,1,0,1,0
9510,28,0,0,70,70,0,1,0,1,0
12762,28,0,0,70,70,0,1,0,1,0
21407,28,0,0,70,70,0,1,0,1,0
20156,28,0,0,70,70,0,1,0,1,0
22259,28,0,0,66,66,0,1,0,1,0
20146,28,0,0,70,70,0,1,0,1,0
10843,28,0,0,66,66,0,1,0,1,0
9727,28,0,0,70,70,0,1,0,1,0
14039,28,0,0,70,70,0,1,0,1,0
19757,28,0,0,66,66,0,1,0,1,0
9133,28,0,0,66,66,0,1,0,1,0
12566,28,0,0,70,70,0,1,0,1,0
18474,28,0,0,70,70,0,1,0,1,0
18691,28,0,0,70,70,0,1,0,1,0
13390,28,0,0,70,70,0,1,0,1,0
14841,28,0,0,66,66,0,1,0,1,0
9435,28,0,0,70,70,0,1,0,1,0
19698,28,0,0,70,70,0,1,0,1,0
19916,28,0,0,70,70,0,1,0,1,0
13612,28,0,0,70,70,0,1,0,1,0
11504,28,0,0,70,70,0,1,0,1,0
17401,28,0,0,70,70,0,1,0,1,0
9608,28,0,0,70,70,0,1,0,1,0
22033,28,0,0,66,66,0,1,0,1,0
19172,28,0,0,66,66,0,1,0,1,0
10907,28,0,0,70,70,0,1,0,1,0
21809,28,0,0,70,70,0,1,0,1,0
21288,28,0,0,70,70,0,1,0,1,0
20657,28,0,0,66,66,0,1,0,1,0
9478,28,0,0,66,66,0,1,0,1,0
18724,28,0,0,70,70,0,1,0,1,0
14002,28,0,0,70,70,0,1,0,1,0
10398,28,0,0,66,66,0,1,0,1,0
16429,28,0,0,70,70,0,1,0,1,0
8673,28,0,0,66,66,0,1,0,1,0
11613,28,0,0,66,66,0,1,0,1,0
13971,28,0,0,70,70,0,1,0,1,0
21205,28,0,0,70,70,0,1,0,1,0
13609,28,0,0,66,66,0,1,0,1,0
19673,28,0,0,70,70,0,1,0,1,0
12115,28,0,0,70,70,0,1,0,1,0
17578,28,0,0,70,70,0,1,0,1,0
20215,28,0,0,66,66,0,1,0,1,0
16362,28,0,0,70,70,0,1,0,1,0
17041,28,0,0,70,70,0,1,0,1,0
12125,28,0,0,66,66,0,1,0,1,0
15376,28,0,0,70,70,0,1,0,1,0
21685,28,0,0,70,70,0,1,0,1,0
15963,28,0,0,70,70,0,1,0,1,0
13842,28,0,0,70,70,0,1,0,1,0
20572,28,0,0,70,70,0,1,0,1,0
15287,28,0,0,66,66,0,1,0,1,0
12458,28,0,0,70,70,0,1,0,1,0
13547,28,0,0,70,70,0,1,0,1,0
9124,28,0,0,70,70,0,1,0,1,0
20526,28,0,0,70,70,0,1,0,1,0
15430,28,0,0,66,66,0,1,0,1,0
21674,28,0,0,70,70,0,1,0,1,0
13881,28,0,0,70,70,0,1,0,1,0
11028,28,0,0,70,70,0,1,0,1,0
11015,28,0,0,70,70,0,1,0,1,0
13666,28,0,0,70,70,0,1,0,1,0
11120,28,0,0,70,70,0,1,0,1,0
14369,28,0,0,70,70,0,1,0,1,0
18669,28,0,0,66,66,0,1,0,1,0
20559,28,0,0,70,70,0,1,0,1,0
11403,28,0,0,70,70,0,1,0,1,0
10659,28,0,0,70,70,0,1,0,1,0
13886,28,0,0,70,70,0,1,0,1,0
10333,28,0,0,70,70,0,1,0,1,0
18204,28,0,0,70,70,0,1,0,1,0
14660,28,0,0,70,70,0,1,0,1,0
18495,28,0,0,70,70,0,1,0,1,0
13538,28,0,0,66,66,0,1,0,1,0
10962,28,0,0,70,70,0,1,0,1,0
18043,28,0,0,70,70,0,1,0,1,0
9451,28,0,0,70,70,0,1,0,1,0
10206,28,0,0,70,70,0,1,0,1,0
9138,28,0,0,66,66,0,1,0,1,0
16692,28,0,0,66,66,0,1,0,1,0
12897,28,0,0,70,70,0,1,0,1,0
11500,28,0,0,70,70,0,1,0,1,0
9190,28,0,0,70,70,0,1,0,1,0
16988,28,0,0,70,70,0,1,0,1,0
22336,28,0,0,66,66,0,1,0,1,0
17312,28,0,0,70,70,0,1,0,1,0
9623,28,0,0,66,66,0,1,0,1,0
12921,28,0,0,70,70,0,1,0,1,0
19711,28,0,0,70,70,0,1,0,1,0
16032,28,0,0,70,70,0,1,0,1,0
18258,28,0,0,66,66,0,1,0,1,0
19326,28,0,0,70,70,0,1,0,1,0
10607,28,0,0,70,70,0,1,0,1,0
9125,28,0,0,70,70,0,1,0,1,0
22247,28,0,0,66,66,0,1,0,1,0
9975,28,0,0,70,70,0,1,0,1,0
22396,28,0,0,66,66,0,1,0,1,0
13449,28,0,0,70,70,0,1,0,1,0
21037,28,0,0,66,66,0,1,0,1,0
12667,28,0,0,70,70,0,1,0,1,0
18857,28,0,0,66,66,0,1,0,1,0
19407,28,0,0,70,70,0,1,0,1,0
19887,28,0,0,70,70,0,1,0,1,0
10915,28,0,0,70,70,0,1,0,1,0
16973,28,0,0,70,70,0,1,0,1,0
17058,28,0,0,66,66,0,1,0,1,0
14724,28,0,0,70,70,0,1,0,1,0
16717,28,0,0,70,70,0,1,0,1,0
10062,28,0,0,66,66,0,1,0,1,0
12473,28,0,0,66,66,0,1,0,1,0
8750,28,0,0,66,66,0,1,0,1,0
10130,28,0,0,70,70,0,1,0,1,0
16498,28,0,0,70,70,0,1,0,1,0
10669,28,0,0,66,66,0,1,0,1,0
14970,28,0,0,70,70,0,1,0,1,0
22535,28,0,0,66,66,0,1,0,1,0
11710,28,0,0,70,70,0,1,0,1,0
11473,28,0,0,70,70,0,1,0,1,0
19246,28,0,0,70,70,0,1,0,1,0
19558,28,0,0,70,70,0,1,0,1,0
21644,28,0,0,70,70,0,1,0,1,0
19710,28,0,0,70,70,0,1,0,1,0
10077,28,0,0,66,66,0,1,0,1,0
15563,28,0,0,70,70,0,1,0,1,0
13820,28,0,0,66,66,0,1,0,1,0
9614,28,0,0,70,70,0,1,0,1,0
19727,28,0,0,70,70,0,1,0,1,0
9412,28,0,0,70,70,0,1,0,1,0
14048,28,0,0,70,70,0,1,0,1,0
20688,28,0,0,66,66,0,1,0,1,0
15156,28,0,0,66,66,0,1,0,1,0
18860,28,0,0,70,70,0,1,0,1,0
15058,28,0,0,70,70,0,1,0,1,0
15056,28,0,0,70,70,0,1,0,1,0
17426,28,0,0,66,66,0,1,0,1,0
10379,28,0,0,70,70,0,1,0,1,0
21187,28,0,0,66,66,0,1,0,1,0
13653,28,0,0,70,70,0,1,0,1,0
19927,28,0,0,70,70,0,1,0,1,0
9497,28,0,0,66,66,0,1,0,1,0
12836,28,0,0,70,70,0,1,0,1,0
14250,28,0,0,70,70,0,1,0,1,0
21464,28,0,0,66,66,0,1,0,1,0
20507,28,0,0,70,70,0,1,0,1,0
12823,28,0,0,70,70,0,1,0,1,0
15466,28,0,0,66,66,0,1,0,1,0
19481,28,0,0,70,70,0,1,0,1,0
22103,28,0,0,66,66,0,1,0,1,0
19045,28,0,0,70,70,0,1,0,1,0
10598,28,0,0,70,70,0,1,0,1,0
18947,28,0,0,66,66,0,1,0,1,0
17543,28,0,0,70,70,0,1,0,1,0
17169,28,0,0,66,66,0,1,0,1,0
8534,28,0,0,66,66,0,1,0,1,0
22427,28,0,0,70,70,0,1,0,1,0
22689,28,0,0,66,66,0,1,0,1,0
20697,28,0,0,70,70,0,1,0,1,0
20956,28,0,0,70,70,0,1,0,1,0
20447,28,0,0,70,70,0,1,0,1,0
10538,28,0,0,70,70,0,1,0,1,0
10327,28,0,0,66,66,0,1,0,1,0
14117,28,0,0,70,70,0,1,0,1,0
8573,28,0,0,70,70,0,1,0,1,0
17686,28,0,0,70,70,0,1,0,1,0
10618,28,0,0,70,70,0,1,0,1,0
19862,28,0,0,70,70,0,1,0,1,0
17918,28,0,0,70,70,0,1,0,1,0
18069,28,0,0,70,70,0,1,0,1,0
21682,28,0,0,70,70,0,1,0,1,0
21780,28,0,0,66,66,0,1,0,1,0
17584,28,0,0,66,66,0,1,0,1,0
17086,28,0,0,66,66,0,1,0,1,0
22160,28,0,0,70,70,0,1,0,1,0
16405,28,0,0,70,70,0,1,0,1,0
21543,28,0,0,70,70,0,1,0,1,0
8465,28,0,0,70,70,0,1,0,1,0
13145,28,0,0,70,70,0,1,0,1,0
14631,28,0,0,70,70,0,1,0,1,0
15024,28,0,0,70,70,0,1,0,1,0
16434,28,0,0,66,66,0,1,0,1,0
16564,28,0,0,70,70,0,1,0,1,0
16175,28,0,0,70,70,0,1,0,1,0
17702,28,0,0,66,66,0,1,0,1,0
22247,28,0,0,70,70,0,1,0,1,0
11818,28,0,0,70,70,0,1,0,1,0
10283,28,0,0,70,70,0,1,0,1,0
19092,28,0,0,66,66,0,1,0,1,0
11471,28,0,0,70,70,0,1,0,1,0
21799,28,0,0,70,70,0,1,0,1,0
9568,28,0,0,66,66,0,1,0,1,0
9919,28,0,0,70,70,0,1,0,1,0
22017,28,0,0,70,70,0,1,0,1,0
9501,28,0,0,66,66,0,1,0,1,0
8502,28,0,0,70,70,0,1,0,1,0
15704,28,0,0,70,70,0,1,0,1,0
21934,28,0,0,70,70,0,1,0,1,0
21819,28,0,0,70,70,0,1,0,1,0
16644,28,0,0,66,66,0,1,0,1,0
14024,28,0,0,70,70,0,1,0,1,0
10111,28,0,0,70,70,0,1,0,1,0
12874,28,0,0,66,66,0,1,0,1,0
12463,28,0,0,70,70,0,1,0,1,0
22467,28,0,0,70,70,0,1,0,1,0
18522,28,0,0,70,70,0,1,0,1,0
17264,28,0,0,70,70,0,1,0,1,0
12029,28,0,0,66,66,0,1,0,1,0
17540,28,0,0,66,66,0,1,0,1,0
18673,28,0,0,66,66,0,1,0,1,0
8927,28,0,0,66,66,0,1,0,1,0
12458,28,0,0,70,70,0,1,0,1,0
15203,28,0,0,70,70,0,1,0,1,0
18571,28,0,0,66,66,0,1,0,1,0
19965,28,0,0,66,66,0,1,0,1,0
19815,28,0,0,70,70,0,1,0,1,0
8720,28,0,0,70,70,0,1,0,1,0
14725,28,0,0,66,66,0,1,0,1,0
11037,28,0,0,70,70,0,1,0,1,0
10182,28,0,0,66,66,0,1,0,1,0
20252,28,0,0,70,70,0,1,0,1,0
14012,28,0,0,66,66,0,1,0,1,0
9747,28,0,0,66,66,0,1,0,1,0
18644,28,0,0,70,70,0,1,0,1,0
11729,28,0,0,70,70,0,1,0,1,0
10627,28,0,0,70,70,0,1,0,1,0
21037,28,0,0,70,70,0,1,0,1,0
12238,28,0,0,66,66,0,1,0,1,0
12991,28,0,0,70,70,0,1,0,1,0
14175,28,0,0,66,66,0,1,0,1,0
13449,28,0,0,70,70,0,1,0,1,0
21083,28,0,0,70,70,0,1,0,1,0
21961,28,0,0,70,70,0,1,0,1,0
15468,28,0,0,66,66,0,1,0,1,0
13819,28,0,0,70,70,0,1,0,1,0
11331,28,0,0,70,70,0,1,0,1,0
9502,28,0,0,66,66,0,1,0,1,0
11459,28,0,0,66,66,0,1,0,1,0
12277,28,0,0,66,66,0,1,0,1,0
16707,28,0,0,66,66,0,1,0,1,0
10187,28,0,0,70,70,0,1,0,1,0
20636,28,0,0,66,66,0,1,0,1,0
21075,28,0,0,70,70,0,1,0,1,0
20288,28,0,0,70,70,0,1,0,1,0
19935,28,0,0,70,70,0,1,0,1,0
10715,28,0,0,70,70,0,1,0,1,0
12285,28,0,0,70,70,0,1,0,1,0
21294,28,0,0,70,70,0,1,0,1,0
20171,28,0,0,70,70,0,1,0,1,0
22509,28,0,0,70,70,0,1,0,1,0
9318,28,0,0,70,70,0,1,0,1,0
15564,28,0,0,70,70,0,1,0,1,0
11247,28,0,0,66,66,0,1,0,1,0
12240,28,0,0,66,66,0,1,0,1,0
21977,28,0,0,70,70,0,1,0,1,0
19476,28,0,0,70,70,0,1,0,1,0
14073,28,0,0,70,70,0,1,0,1,0
21740,28,0,0,66,66,0,1,0,1,0
14021,28,0,0,70,70,0,1,0,1,0
19506,28,0,0,66,66,0,1,0,1,0
12990,28,0,0,70,70,0,1,0,1,0
15926,28,0,0,66,66,0,1,0,1,0
11555,28,0,0,70,70,0,1,0,1,0
9479,28,0,0,70,70,0,1,0,1,0
9571,28,0,0,70,70,0,1,0,1,0
16444,28,0,0,70,70,0,1,0,1,0
11293,28,0,0,66,66,0,1,0,1,0
10599,28,0,0,66,66,0,1,0,1,0
10567,28,0,0,70,70,0,1,0,1,0
9981,28,0,0,70,70,0,1,0,1,0
12723,28,0,0,66,66,0,1,0,1,0
14069,28,0,0,70,70,0,1,0,1,0
14853,28,0,0,66,66,0,1,0,1,0
12188,28,0,0,70,70,0,1,0,1,0
13062,28,0,0,66,66,0,1,0,1,0
12152,28,0,0,70,70,0,1,0,1,0
17305,28,0,0,70,70,0,1,0,1,0
16236,28,0,0,66,66,0,1,0,1,0
14698,28,0,0,66,66,0,1,0,1,0
14737,28,0,0,66,66,0,1,0,1,0
15640,28,0,0,70,70,0,1,0,1,0
19789,28,0,0,66,66,0,1,0,1,0
11147,28,0,0,66,66,0,1,0,1,0
12778,28,0,0,66,66,0,1,0,1,0
11358,28,0,0,66,66,0,1,0,1,0
20339,28,0,0,66,66,0,1,0,1,0
9966,28,0,0,66,66,0,1,0,1,0
10636,28,0,0,70,70,0,1,0,1,0
12413,28,0,0,66,66,0,1,0,1,0
22289,28,0,0,70,70,0,1,0,1,0
20763,28,0,0,70,70,0,1,0,1,0
18714,28,0,0,70,70,0,1,0,1,0
11936,28,0,0,70,70,0,1,0,1,0
11819,28,0,0,66,66,0,1,0,1,0
15155,28,0,0,66,66,0,1,0,1,0
15342,28,0,0,66,66,0,1,0,1,0
14196,28,0,0,70,70,0,1,0,1,0
21321,28,0,0,70,70,0,1,0,1,0
19035,28,0,0,70,70,0,1,0,1,0
9239,28,0,0,66,66,0,1,0,1,0
16765,28,0,0,70,70,0,1,0,1,0
17009,28,0,0,66,66,0,1,0,1,0
17492,28,0,0,70,70,0,1,0,1,0
19639,28,0,0,66,66,0,1,0,1,0
17377,28,0,0,70,70,0,1,0,1,0
13557,28,0,0,70,70,0,1,0,1,0
11417,28,0,0,70,70,0,1,0,1,0
14090,28,0,0,70,70,0,1,0,1,0
12278,28,0,0,70,70,0,1,0,1,0
9796,28,0,0,70,70,0,1,0,1,0
17403,28,0,0,66,66,0,1,0,1,0
21777,28,0,0,66,66,0,1,0,1,0
18117,28,0,0,70,70,0,1,0,1,0
9541,28,0,0,66,66,0,1,0,1,0
20402,28,0,0,66,66,0,1,0,1,0
11994,28,0,0,70,70,0,1,0,1,0
17971,28,0,0,66,66,0,1,0,1,0
8365,28,0,0,66,66,0,1,0,1,0
18802,28,0,0,70,70,0,1,0,1,0
14026,28,0,0,70,70,0,1,0,1,0
9877,28,0,0,66,66,0,1,0,1,0
20647,28,0,0,70,70,0,1,0,1,0
20316,28,0,0,70,70,0,1,0,1,0
20133,28,0,0,70,70,0,1,0,1,0
22517,28,0,0,66,66,0,1,0,1,0
13240,28,0,0,66,66,0,1,0,1,0
21161,28,0,0,70,70,0,1,0,1,0
22064,28,0,0,70,70,0,1,0,1,0
9576,28,0,0,70,70,0,1,0,1,0
9627,28,0,0,66,66,0,1,0,1,0
14453,28,0,0,70,70,0,1,0,1,0
19426,28,0,0,70,70,0,1,0,1,0
15175,28,0,0,66,66,0,1,0,1,0
13759,28,0,0,70,70,0,1,0,1,0
16496,28,0,0,70,70,0,1,0,1,0
16797,28,0,0,70,70,0,1,0,1,0
18183,28,0,0,66,66,0,1,0,1,0
11772,28,0,0,66,66,0,1,0,1,0
17513,28,0,0,70,70,0,1,0,1,0
14661,28,0,0,66,66,0,1,0,1,0
8743,28,0,0,70,70,0,1,0,1,0
20914,28,0,0,66,66,0,1,0,1,0
11504,28,0,0,66,66,0,1,0,1,0
10094,28,0,0,66,66,0,1,0,1,0
15338,28,0,0,70,70,0,1,0,1,0
10866,28,0,0,70,70,0,1,0,1,0
18693,28,0,0,70,70,0,1,0,1,0
22285,28,0,0,70,70,0,1,0,1,0
15803,28,0,0,70,70,0,1,0,1,0
13907,28,0,0,70,70,0,1,0,1,0
9636,28,0,0,70,70,0,1,0,1,0
22041,28,0,0,70,70,0,1,0,1,0
17952,28,0,0,66,66,0,1,0,1,0
21971,28,0,0,70,70,0,1,0,1,0
17448,28,0,0,70,70,0,1,0,1,0
17789,28,0,0,70,70,0,1,0,1,0
21603,28,0,0,70,70,0,1,0,1,0
13794,28,0,0,66,66,0,1,0,1,0
21638,28,0,0,70,70,0,1,0,1,0
15585,28,0,0,66,66,0,1,0,1,0
11971,28,0,0,70,70,0,1,0,1,0
12269,28,0,0,70,70,0,1,0,1,0
13966,28,0,0,66,66,0,1,0,1,0
10411,28,0,0,70,70,0,1,0,1,0
13691,28,0,0,70,70,0,1,0,1,0
21665,28,0,0,70,70,0,1,0,1,0
13703,28,0,0,70,70,0,1,0,1,0
12404,28,0,0,70,70,0,1,0,1,0
19505,28,0,0,70,70,0,1,0,1,0
22343,28,0,0,66,66,0,1,0,1,0
14913,28,0,0,70,70,0,1,0,1,0
16904,28,0,0,70,70,0,1,0,1,0
16995,28,0,0,66,66,0,1,0,1,0
20028,28,0,0,70,70,0,1,0,1,0
22632,28,0,0,70,70,0,1,0,1,0
14564,28,0,0,70,70,0,1,0,1,0
16908,28,0,0,70,70,0,1,0,1,0
20063,28,0,0,70,70,0,1,0,1,0
11648,28,0,0,66,66,0,1,0,1,0
22399,28,0,0,70,70,0,1,0,1,0
17291,28,0,0,70,70,0,1,0,1,0
20050,28,0,0,70,70,0,1,0,1,0
15668,28,0,0,70,70,0,1,0,1,0
19581,28,0,0,70,70,0,1,0,1,0
20322,28,0,0,70,70,0,1,0,1,0
19370,28,0,0,70,70,0,1,0,1,0
19303,28,0,0,66,66,0,1,0,1,0
15789,28,0,0,70,70,0,1,0,1,0
19601,28,0,0,66,66,0,1,0,1,0
10796,28,0,0,70,70,0,1,0,1,0
15719,28,0,0,70,70,0,1,0,1,0
8797,28,0,0,70,70,0,1,0,1,0
15114,28,0,0,70,70,0,1,0,1,0
17151,28,0,0,70,70,0,1,0,1,0
9904,28,0,0,70,70,0,1,0,1,0
13527,28,0,0,66,66,0,1,0,1,0
14284,28,0,0,70,70,0,1,0,1,0
12054,28,0,0,70,70,0,1,0,1,0
17243,28,0,0,66,66,0,1,0,1,0
20899,28,0,0,70,70,0,1,0,1,0
16770,28,0,0,70,70,0,1,0,1,0
9622,28,0,0,70,70,0,1,0,1,0
21909,28,0,0,66,66,0,1,0,1,0
9644,28,0,0,70,70,0,1,0,1,0
10779,28,0,0,70,70,0,1,0,1,0
13396,28,0,0,66,66,0,1,0,1,0
18236,28,0,0,70,70,0,1,0,1,0
14436,28,0,0,70,70,0,1,0,1,0
14103,28,0,0,66,66,0,1,0,1,0
19250,28,0,0,66,66,0,1,0,1,0
12750,28,0,0,70,70,0,1,0,1,0
18755,28,0,0,70,70,0,1,0,1,0
11455,28,0,0,70,70,0,1,0,1,0
15959,28,0,0,66,66,0,1,0,1,0
22075,28,0,0,70,70,0,1,0,1,0
16402,28,0,0,70,70,0,1,0,1,0
9892,28,0,0,66,66,0,1,0,1,0
16875,28,0,0,70,70,0,1,0,1,0
21873,28,0,0,70,70,0,1,0,1,0
20990,28,0,0,66,66,0,1,0,1,0
9668,28,0,0,66,66,0,1,0,1,0
15535,28,0,0,70,70,0,1,0,1,0
17815,28,0,0,70,70,0,1,0,1,0
19082,28,0,0,70,70,0,1,0,1,0
8812,28,0,0,70,70,0,1,0,1,0
22162,28,0,0,70,70,0,1,0,1,0
10941,28,0,0,66,66,0,1,0,1,0
18066,28,0,0,70,70,0,1,0,1,0
9068,28,0,0,70,70,0,1,0,1,0
9809,28,0,0,66,66,0,1,0,1,0
11316,28,0,0,70,70,0,1,0,1,0
11042,28,0,0,70,70,0,1,0,1,0
15032,28,0,0,66,66,0,1,0,1,0
19200,28,0,0,66,66,0,1,0,1,0
21050,28,0,0,70,70,0,1,0,1,0
21478,28,0,0,66,66,0,1,0,1,0
22500,28,0,0,66,66,0,1,0,1,0
9585,28,0,0,66,66,0,1,0,1,0
17879,28,0,0,66,66,0,1,0,1,0
18040,28,0,0,66,66,0,1,0,1,0
12892,28,0,0,66,66,0,1,0,1,0
12769,28,0,0,70,70,0,1,0,1,0
20627,28,0,0,70,70,0,1,0,1,0
19036,28,0,0,70,70,0,1,0,1,0
20643,28,0,0,70,70,0,1,0,1,0
22287,28,0,0,70,70,0,1,0,1,0
19861,28,0,0,70,70,0,1,0,1,0
12616,28,0,0,70,70,0,1,0,1,0
10338,28,0,0,70,70,0,1,0,1,0
10102,28,0,0,66,66,0,1,0,1,0
21280,28,0,0,70,70,0,1,0,1,0
10291,28,0,0,66,66,0,1,0,1,0
11830,28,0,0,70,70,0,1,0,1,0
12954,28,0,0,66,66,0,1,0,1,0
20591,28,0,0,66,66,0,1,0,1,0
9274,28,0,0,70,70,0,1,0,1,0
12290,28,0,0,70,70,0,1,0,1,0
10262,28,0,0,70,70,0,1,0,1,0
10014,28,0,0,66,66,0,1,0,1,0
8990,28,0,0,70,70,0,1,0,1,0
16780,28,0,0,66,66,0,1,0,1,0
12103,28,0,0,70,70,0,1,0,1,0
20475,28,0,0,70,70,0,1,0,1,0
21861,28,0,0,66,66,0,1,0,1,0
19948,28,0,0,70,70,0,1,0,1,0
15447,28,0,0,70,70,0,1,0,1,0
20027,28,0,0,70,70,0,1,0,1,0
19580,28,0,0,70,70,0,1,0,1,0
13734,28,0,0,70,70,0,1,0,1,0
13806,28,0,0,70,70,0,1,0,1,0
20651,28,0,0,70,70,0,1,0,1,0
17315,28,0,0,66,66,0,1,0,1,0
22044,28,0,0,70,70,0,1,0,1,0
16785,28,0,0,66,66,0,1,0,1,0
15244,28,0,0,70,70,0,1,0,1,0
12516,28,0,0,70,70,0,1,0,1,0
16887,28,0,0,70,70,0,1,0,1,0
18069,28,0,0,66,66,0,1,0,1,0
18015,28,0,0,70,70,0,1,0,1,0
22202,28,0,0,66,66,0,1,0,1,0
17628,28,0,0,70,70,0,1,0,1,0
12236,28,0,0,70,70,0,1,0,1,0
21437,28,0,0,66,66,0,1,0,1,0
10995,28,0,0,70,70,0,1,0,1,0
21222,28,0,0,70,70,0,1,0,1,0
15933,28,0,0,66,66,0,1,0,1,0
10270,28,0,0,70,70,0,1,0,1,0
18467,28,0,0,70,70,0,1,0,1,0
12845,28,0,0,66,66,0,1,0,1,0
12595,28,0,0,66,66,0,1,0,1,0
16194,28,0,0,70,70,0,1,0,1,0
14869,28,0,0,70,70,0,1,0,1,0
10323,28,0,0,70,70,0,1,0,1,0
10705,28,0,0,70,70,0,1,0,1,0
22326,28,0,0,66,66,0,1,0,1,0
9689,28,0,0,66,66,0,1,0,1,0
13747,28,0,0,70,70,0,1,0,1,0
8927,28,0,0,70,70,0,1,0,1,0
17521,28,0,0,70,70,0,1,0,1,0
9399,28,0,0,70,70,0,1,0,1,0
16597,28,0,0,70,70,0,1,0,1,0
9241,28,0,0,66,66,0,1,0,1,0
19806,28,0,0,70,70,0,1,0,1,0
14193,28,0,0,70,70,0,1,0,1,0
15835,28,0,0,70,70,0,1,0,1,0
18329,28,0,0,66,66,0,1,0,1,0
9956,28,0,0,70,70,0,1,0,1,0
17547,28,0,0,66,66,0,1,0,1,0
16363,28,0,0,70,70,0,1,0,1,0
12527,28,0,0,66,66,0,1,0,1,0
16290,28,0,0,66,66,0,1,0,1,0
13355,28,0,0,70,70,0,1,0,1,0
19357,28,0,0,70,70,0,1,0,1,0
13469,28,0,0,70,70,0,1,0,1,0
14537,28,0,0,70,70,0,1,0,1,0
9811,28,0,0,66,66,0,1,0,1,0
9516,28,0,0,66,66,0,1,0,1,0
17853,28,0,0,70,70,0,1,0,1,0
19790,28,0,0,70,70,0,1,0,1,0
18598,28,0,0,66,66,0,1,0,1,0
21025,28,0,0,70,70,0,1,0,1,0
11881,28,0,0,70,70,0,1,0,1,0
18246,28,0,0,70,70,0,1,0,1,0
21964,28,0,0,70,70,0,1,0,1,0
20644,28,0,0,70,70,0,1,0,1,0
17247,28,0,0,70,70,0,1,0,1,0
16312,28,0,0,70,70,0,1,0,1,0
21359,28,0,0,70,70,0,1,0,1,0
9144,28,0,0,70,70,0,1,0,1,0
18558,28,0,0,70,70,0,1,0,1,0
11436,28,0,0,70,70,0,1,0,1,0
22212,28,0,0,70,70,0,1,0,1,0
13960,28,0,0,70,70,0,1,0,1,0
19765,28,0,0,66,66,0,1,0,1,0
20728,28,0,0,70,70,0,1,0,1,0
9816,28,0,0,66,66,0,1,0,1,0
21030,28,0,0,66,66,0,1,0,1,0
15460,28,0,0,66,66,0,1,0,1,0
18998,28,0,0,66,66,0,1,0,1,0
16120,28,0,0,66,66,0,1,0,1,0
16847,28,0,0,70,70,0,1,0,1,0
12216,28,0,0,70,70,0,1,0,1,0
11296,28,0,0,70,70,0,1,0,1,0
14721,28,0,0,66,66,0,1,0,1,0
20185,28,0,0,66,66,0,1,0,1,0
10063,28,0,0,70,70,0,1,0,1,0
10447,28,0,0,66,66,0,1,0,1,0
9863,28,0,0,66,66,0,1,0,1,0
22026,28,0,0,66,66,0,1,0,1,0
13780,28,0,0,70,70,0,1,0,1,0
15033,28,0,0,66,66,0,1,0,1,0
17599,28,0,0,70,70,0,1,0,1,0
12770,28,0,0,70,70,0,1,0,1,0
16179,28,0,0,66,66,0,1,0,1,0
18262,28,0,0,70,70,0,1,0,1,0
21592,28,0,0,70,70,0,1,0,1,0
15339,28,0,0,66,66,0,1,0,1,0
14492,28,0,0,66,66,0,1,0,1,0
8498,28,0,0,66,66,0,1,0,1,0
16801,28,0,0,70,70,0,1,0,1,0
22080,28,0,0,70,70,0,1,0,1,0
19164,28,0,0,70,70,0,1,0,1,0
10587,28,0,0,70,70,0,1,0,1,0
22043,28,0,0,70,70,0,1,0,1,0
19925,28,0,0,70,70,0,1,0,1,0
13867,28,0,0,70,70,0,1,0,1,0
20922,28,0,0,70,70,0,1,0,1,0
13442,28,0,0,70,70,0,1,0,1,0
21730,28,0,0,66,66,0,1,0,1,0
17953,28,0,0,66,66,0,1,0,1,0
9879,28,0,0,66,66,0,1,0,1,0
9443,28,0,0,66,66,0,1,0,1,0
18830,28,0,0,70,70,0,1,0,1,0
9130,28,0,0,70,70,0,1,0,1,0
15073,28,0,0,70,70,0,1,0,1,0
12646,28,0,0,66,66,0,1,0,1,0
22643,28,0,0,66,66,0,1,0,1,0
8837,28,0,0,66,66,0,1,0,1,0
21034,28,0,0,70,70,0,1,0,1,0
15955,28,0,0,66,66,0,1,0,1,0
20306,28,0,0,66,66,0,1,0,1,0
10528,28,0,0,70,70,0,1,0,1,0
16791,28,0,0,70,70,0,1,0,1,0
22204,28,0,0,66,66,0,1,0,1,0
20755,28,0,0,70,70,0,1,0,1,0
21899,28,0,0,70,70,0,1,0,1,0
16508,28,0,0,66,66,0,1,0,1,0
16397,28,0,0,66,66,0,1,0,1,0
14095,28,0,0,70,70,0,1,0,1,0
16391,28,0,0,70,70,0,1,0,1,0
11900,28,0,0,70,70,0,1,0,1,0
10511,28,0,0,70,70,0,1,0,1,0
16304,28,0,0,70,70,0,1,0,1,0
11524,28,0,0,70,70,0,1,0,1,0
20770,28,0,0,66,66,0,1,0,1,0
10418,28,0,0,70,70,0,1,0,1,0
20669,28,0,0,70,70,0,1,0,1,0
17783,28,0,0,66,66,0,1,0,1,0
16337,28,0,0,66,66,0,1,0,1,0
10045,28,0,0,66,66,0,1,0,1,0
11084,28,0,0,70,70,0,1,0,1,0
12532,28,0,0,70,70,0,1,0,1,0
12994,28,0,0,66,66,0,1,0,1,0
17650,28,0,0,70,70,0,1,0,1,0
19654,28,0,0,70,70,0,1,0,1,0
19300,28,0,0,66,66,0,1,0,1,0
13935,28,0,0,66,66,0,1,0,1,0
9234,28,0,0,70,70,0,1,0,1,0
9856,28,0,0,70,70,0,1,0,1,0
20149,28,0,0,70,70,0,1,0,1,0
10038,28,0,0,70,70,0,1,0,1,0
15208,28,0,0,66,66,0,1,0,1,0
10392,28,0,0,66,66,0,1,0,1,0
10113,28,0,0,70,70,0,1,0,1,0
22477,28,0,0,66,66,0,1,0,1,0
12802,28,0,0,66,66,0,1,0,1,0
14314,28,0,0,70,70,0,1,0,1,0
11584,28,0,0,70,70,0,1,0,1,0
20355,28,0,0,70,70,0,1,0,1,0
19622,28,0,0,70,70,0,1,0,1,0
10685,28,0,0,66,66,0,1,0,1,0
14408,28,0,0,70,70,0,1,0,1,0
20539,28,0,0,66,66,0,1,0,1,0
20935,28,0,0,70,70,0,1,0,1,0
19539,28,0,0,66,66,0,1,0,1,0
11710,28,0,0,70,70,0,1,0,1,0
14917,28,0,0,70,70,0,1,0,1,0
14848,28,0,0,70,70,0,1,0,1,0
21308,28,0,0,70,70,0,1,0,1,0
20448,28,0,0,70,70,0,1,0,1,0
8544,28,0,0,70,70,0,1,0,1,0
15202,28,0,0,70,70,0,1,0,1,0
21237,28,0,0,70,70,0,1,0,1,0
17629,28,0,0,70,70,0,1,0,1,0
21398,28,0,0,70,70,0,1,0,1,0
20821,28,0,0,70,70,0,1,0,1,0
10578,28,0,0,66,66,0,1,0,1,0
20392,28,0,0,70,70,0,1,0,1,0
15511,28,0,0,70,70,0,1,0,1,0
17236,28,0,0,66,66,0,1,0,1,0
18976,28,0,0,66,66,0,1,0,1,0
11363,28,0,0,66,66,0,1,0,1,0
17597,28,0,0,70,70,0,1,0,1,0
20494,28,0,0,70,70,0,1,0,1,0
19836,28,0,0,66,66,0,1,0,1,0
18133,28,0,0,70,70,0,1,0,1,0
20757,28,0,0,70,70,0,1,0,1,0
13268,28,0,0,70,70,0,1,0,1,0
15237,28,0,0,66,66,0,1,0,1,0
12467,28,0,0,66,66,0,1,0,1,0
13640,28,0,0,66,66,0,1,0,1,0
9688,28,0,0,70,70,0,1,0,1,0
17028,28,0,0,66,66,0,1,0,1,0
14714,28,0,0,70,70,0,1,0,1,0
12060,28,0,0,66,66,0,1,0,1,0
15833,28,0,0,70,70,0,1,0,1,0
13845,28,0,0,70,70,0,1,0,1,0
8757,28,0,0,70,70,0,1,0,1,0
17143,28,0,0,66,66,0,1,0,1,0
19001,28,0,0,66,66,0,1,0,1,0
8589,28,0,0,70,70,0,1,0,1,0
17773,28,0,0,70,70,0,1,0,1,0
17844,28,0,0,66,66,0,1,0,1,0
8950,28,0,0,70,70,0,1,0,1,0
16787,28,0,0,70,70,0,1,0,1,0
22361,28,0,0,70,70,0,1,0,1,0
10104,28,0,0,66,66,0,1,0,1,0
18649,28,0,0,70,70,0,1,0,1,0
12256,28,0,0,66,66,0,1,0,1,0
21945,28,0,0,70,70,0,1,0,1,0
18873,28,0,0,70,70,0,1,0,1,0
15982,28,0,0,70,70,0,1,0,1,0
18889,28,0,0,66,66,0,1,0,1,0
8997,28,0,0,70,70,0,1,0,1,0
16897,28,0,0,70,70,0,1,0,1,0
20723,28,0,0,66,66,0,1,0,1,0
18059,28,0,0,70,70,0,1,0,1,0
17308,28,0,0,66,66,0,1,0,1,0
12226,28,0,0,66,66,0,1,0,1,0
14525,28,0,0,70,70,0,1,0,1,0
13977,28,0,0,70,70,0,1,0,1,0
13917,28,0,0,66,66,0,1,0,1,0
14011,28,0,0,70,70,0,1,0,1,0
15236,28,0,0,70,70,0,1,0,1,0
20858,28,0,0,66,66,0,1,0,1,0
11746,28,0,0,70,70,0,1,0,1,0
13736,28,0,0,70,70,0,1,0,1,0
18151,28,0,0,70,70,0,1,0,1,0
15380,28,0,0,70,70,0,1,0,1,0
9357,28,0,0,70,70,0,1,0,1,0
16905,28,0,0,70,70,0,1,0,1,0
15144,28,0,0,70,70,0,1,0,1,0
19507,28,0,0,66,66,0,1,0,1,0
18627,28,0,0,70,70,0,1,0,1,0
21492,28,0,0,70,70,0,1,0,1,0
19042,28,0,0,70,70,0,1,0,1,0
17635,28,0,0,66,66,0,1,0,1,0
22240,28,0,0,70,70,0,1,0,1,0
20032,28,0,0,70,70,0,1,0,1,0
12455,28,0,0,70,70,0,1,0,1,0
18139,28,0,0,66,66,0,1,0,1,0
16696,28,0,0,66,66,0,1,0,1,0
14057,28,0,0,66,66,0,1,0,1,0
20295,28,0,0,66,66,0,1,0,1,0
12838,28,0,0,70,70,0,1,0,1,0
18735,28,0,0,66,66,0,1,0,1,0
18184,28,0,0,70,70,0,1,0,1,0
11814,28,0,0,66,66,0,1,0,1,0
16453,28,0,0,70,70,0,1,0,1,0
16191,28,0,0,66,66,0,1,0,1,0
15607,28,0,0,70,70,0,1,0,1,0
21830,28,0,0,66,66,0,1,0,1,0
17374,28,0,0,70,70,0,1,0,1,0
17599,28,0,0,66,66,0,1,0,1,0
11777,28,0,0,70,70,0,1,0,1,0
10552,28,0,0,66,66,0,1,0,1,0
19960,28,0,0,66,66,0,1,0,1,0
19600,28,0,0,70,70,0,1,0,1,0
17186,28,0,0,66,66,0,1,0,1,0
15241,28,0,0,70,70,0,1,0,1,0
9451,28,0,0,66,66,0,1,0,1,0
14015,28,0,0,70,70,0,1,0,1,0
19490,28,0,0,66,66,0,1,0,1,0
9543,28,0,0,70,70,0,1,0,1,0
14724,28,0,0,70,70,0,1,0,1,0
13514,28,0,0,66,66,0,1,0,1,0
20871,28,0,0,66,66,0,1,0,1,0
10998,28,0,0,70,70,0,1,0,1,0
17788,28,0,0,70,70,0,1,0,1,0
17574,28,0,0,70,70,0,1,0,1,0
9609,28,0,0,70,70,0,1,0,1,0
13094,28,0,0,70,70,0,1,0,1,0
14607,28,0,0,70,70,0,1,0,1,0
9878,28,0,0,70,70,0,1,0,1,0
17410,28,0,0,70,70,0,1,0,1,0
16796,28,0,0,66,66,0,1,0,1,0
17691,28,0,0,70,70,0,1,0,1,0
20777,28,0,0,70,70,0,1,0,1,0
17233,28,0,0,70,70,0,1,0,1,0
10178,28,0,0,70,70,0,1,0,1,0
16456,28,0,0,70,70,0,1,0,1,0
9805,28,0,0,70,70,0,1,0,1,0
17201,28,0,0,70,70,0,1,0,1,0
13509,28,0,0,66,66,0,1,0,1,0
17391,28,0,0,70,70,0,1,0,1,0
14133,28,0,0,66,66,0,1,0,1,0
8551,28,0,0,66,66,0,1,0,1,0
13467,28,0,0,70,70,0,1,0,1,0
9458,28,0,0,66,66,0,1,0,1,0
13262,28,0,0,66,66,0,1,0,1,0
12210,28,0,0,70,70,0,1,0,1,0
19226,28,0,0,70,70,0,1,0,1,0
9397,28,0,0,70,70,0,1,0,1,0
21332,28,0,0,70,70,0,1,0,1,0
16476,28,0,0,70,70,0,1,0,1,0
20021,28,0,0,70,70,0,1,0,1,0
13644,28,0,0,70,70,0,1,0,1,0
15578,28,0,0,70,70,0,1,0,1,0
9818,28,0,0,70,70,0,1,0,1,0
15453,28,0,0,70,70,0,1,0,1,0
13085,28,0,0,70,70,0,1,0,1,0
14152,28,0,0,70,70,0,1,0,1,0
20971,28,0,0,66,66,0,1,0,1,0
19340,28,0,0,70,70,0,1,0,1,0
10244,28,0,0,70,70,0,1,0,1,0
18406,28,0,0,70,70,0,1,0,1,0
9699,28,0,0,70,70,0,1,0,1,0
14544,28,0,0,66,66,0,1,0,1,0
20478,28,0,0,66,66,0,1,0,1,0
14119,28,0,0,70,70,0,1,0,1,0
12032,28,0,0,70,70,0,1,0,1,0
9688,28,0,0,66,66,0,1,0,1,0
19672,28,0,0,70,70,0,1,0,1,0
17366,28,0,0,70,70,0,1,0,1,0
11486,28,0,0,70,70,0,1,0,1,0
9777,28,0,0,70,70,0,1,0,1,0
22234,28,0,0,70,70,0,1,0,1,0
21110,28,0,0,70,70,0,1,0,1,0
19112,28,0,0,70,70,0,1,0,1,0
11011,28,0,0,70,70,0,1,0,1,0
9287,28,0,0,70,70,0,1,0,1,0
10120,28,0,0,70,70,0,1,0,1,0
19236,28,0,0,70,70,0,1,0,1,0
14137,28,0,0,70,70,0,1,0,1,0
22528,28,0,0,70,70,0,1,0,1,0
14859,28,0,0,70,70,0,1,0,1,0
15932,28,0,0,70,70,0,1,0,1,0
17249,28,0,0,66,66,0,1,0,1,0
13415,28,0,0,66,66,0,1,0,1,0
13243,28,0,0,70,70,0,1,0,1,0
11780,28,0,0,70,70,0,1,0,1,0
22164,28,0,0,70,70,0,1,0,1,0
20724,28,0,0,66,66,0,1,0,1,0
19578,28,0,0,66,66,0,1,0,1,0
11816,28,0,0,66,66,0,1,0,1,0
18878,28,0,0,66,66,0,1,0,1,0
21108,28,0,0,70,70,0,1,0,1,0
16843,28,0,0,66,66,0,1,0,1,0
16486,28,0,0,70,70,0,1,0,1,0
22028,28,0,0,66,66,0,1,0,1,0
9252,28,0,0,66,66,0,1,0,1,0
17161,28,0,0,70,70,0,1,0,1,0
15975,28,0,0,66,66,0,1,0,1,0
22026,28,0,0,70,70,0,1,0,1,0
21546,28,0,0,70,70,0,1,0,1,0
17350,28,0,0,66,66,0,1,0,1,0
16184,28,0,0,66,66,0,1,0,1,0
15757,28,0,0,70,70,0,1,0,1,0
19185,28,0,0,70,70,0,1,0,1,0
10781,28,0,0,70,70,0,1,0,1,0
15512,28,0,0,70,70,0,1,0,1,0
8945,28,0,0,70,70,0,1,0,1,0
16917,28,0,0,70,70,0,1,0,1,0
14790,28,0,0,70,70,0,1,0,1,0
13171,28,0,0,70,70,0,1,0,1,0
19480,28,0,0,70,70,0,1,0,1,0
13933,28,0,0,66,66,0,1,0,1,0
9810,28,0,0,66,66,0,1,0,1,0
10167,28,0,0,66,66,0,1,0,1,0
9559,28,0,0,70,70,0,1,0,1,0
15995,28,0,0,66,66,0,1,0,1,0
11402,28,0,0,70,70,0,1,0,1,0
11270,28,0,0,70,70,0,1,0,1,0
18915,28,0,0,70,70,0,1,0,1,0
9936,28,0,0,66,66,0,1,0,1,0
19932,28,0,0,70,70,0,1,0,1,0
14622,28,0,0,66,66,0,1,0,1,0
16963,28,0,0,70,70,0,1,0,1,0
8426,28,0,0,70,70,0,1,0,1,0
16491,28,0,0,66,66,0,1,0,1,0
16404,28,0,0,66,66,0,1,0,1,0
9878,28,0,0,70,70,0,1,0,1,0
11969,28,0,0,70,70,0,1,0,1,0
11982,28,0,0,70,70,0,1,0,1,0
14688,28,0,0,70,70,0,1,0,1,0
20089,28,0,0,70,70,0,1,0,1,0
10822,28,0,0,70,70,0,1,0,1,0
11888,28,0,0,66,66,0,1,0,1,0
14646,28,0,0,70,70,0,1,0,1,0
17274,28,0,0,70,70,0,1,0,1,0
19708,28,0,0,66,66,0,1,0,1,0
22597,28,0,0,70,70,0,1,0,1,0
15181,28,0,0,70,70,0,1,0,1,0
10223,28,0,0,66,66,0,1,0,1,0
16761,28,0,0,70,70,0,1,0,1,0
20389,28,0,0,70,70,0,1,0,1,0
11014,28,0,0,70,70,0,1,0,1,0
12716,28,0,0,70,70,0,1,0,1,0
9312,28,0,0,70,70,0,1,0,1,0
9740,28,0,0,66,66,0,1,0,1,0
9757,28,0,0,66,66,0,1,0,1,0
21729,28,0,0,66,66,0,1,0,1,0
11864,28,0,0,70,70,0,1,0,1,0
10784,28,0,0,70,70,0,1,0,1,0
14807,28,0,0,70,70,0,1,0,1,0
16180,28,0,0,70,70,0,1,0,1,0
10736,28,0,0,66,66,0,1,0,1,0
19023,28,0,0,70,70,0,1,0,1,0
14823,28,0,0,70,70,0,1,0,1,0
16590,28,0,0,70,70,0,1,0,1,0
9202,28,0,0,66,66,0,1,0,1,0
19077,28,0,0,70,70,0,1,0,1,0
12506,28,0,0,70,70,0,1,0,1,0
20647,28,0,0,66,66,0,1,0,1,0
14948,28,0,0,70,70,0,1,0,1,0
10415,28,0,0,70,70,0,1,0,1,0
15681,28,0,0,70,70,0,1,0,1,0
13457,28,0,0,66,66,0,1,0,1,0
12910,28,0,0,66,66,0,1,0,1,0
11083,28,0,0,70,70,0,1,0,1,0
15888,28,0,0,66,66,0,1,0,1,0
20877,28,0,0,66,66,0,1,0,1,0
10007,28,0,0,66,66,0,1,0,1,0
20362,28,0,0,66,66,0,1,0,1,0
11676,28,0,0,70,70,0,1,0,1,0
10084,28,0,0,66,66,0,1,0,1,0
16900,28,0,0,70,70,0,1,0,1,0
22579,28,0,0,66,66,0,1,0,1,0
11400,28,0,0,70,70,0,1,0,1,0
10653,28,0,0,70,70,0,1,0,1,0
22011,28,0,0,66,66,0,1,0,1,0
20182,28,0,0,70,70,0,1,0,1,0
17482,28,0,0,70,70,0,1,0,1,0
21109,28,0,0,70,70,0,1,0,1,0
12776,28,0,0,66,66,0,1,0,1,0
14514,28,0,0,70,70,0,1,0,1,0
9715,28,0,0,66,66,0,1,0,1,0
17492,28,0,0,66,66,0,1,0,1,0
10914,28,0,0,66,66,0,1,0,1,0
12013,28,0,0,70,70,0,1,0,1,0
10472,28,0,0,70,70,0,1,0,1,0
20489,28,0,0,70,70,0,1,0,1,0
16141,28,0,0,66,66,0,1,0,1,0
15329,28,0,0,70,70,0,1,0,1,0
14264,28,0,0,66,66,0,1,0,1,0
18411,28,0,0,70,70,0,1,0,1,0
12007,28,0,0,70,70,0,1,0,1,0
16810,28,0,0,66,66,0,1,0,1,0
21664,28,0,0,66,66,0,1,0,1,0
10276,28,0,0,70,70,0,1,0,1,0
15281,28,0,0,66,66,0,1,0,1,0
9195,28,0,0,70,70,0,1,0,1,0
17799,28,0,0,66,66,0,1,0,1,0
14766,28,0,0,66,66,0,1,0,1,0
21735,28,0,0,70,70,0,1,0,1,0
15170,28,0,0,70,70,0,1,0,1,0
12596,28,0,0,66,66,0,1,0,1,0
16442,28,0,0,70,70,0,1,0,1,0
12676,28,0,0,70,70,0,1,0,1,0
15021,28,0,0,70,70,0,1,0,1,0
21994,28,0,0,70,70,0,1,0,1,0
16050,28,0,0,70,70,0,1,0,1,0
8760,28,0,0,70,70,0,1,0,1,0
21939,28,0,0,70,70,0,1,0,1,0
15513,28,0,0,70,70,0,1,0,1,0
14351,28,0,0,70,70,0,1,0,1,0
14500,28,0,0,70,70,0,1,0,1,0
10462,28,0,0,70,70,0,1,0,1,0
21227,28,0,0,70,70,0,1,0,1,0
20437,28,0,0,70,70,0,1,0,1,0
13094,28,0,0,70,70,0,1,0,1,0
22225,28,0,0,66,66,0,1,0,1,0
14695,28,0,0,70,70,0,1,0,1,0
8969,28,0,0,70,70,0,1,0,1,0
18367,28,0,0,66,66,0,1,0,1,0
20106,28,0,0,66,66,0,1,0,1,0
10888,28,0,0,70,70,0,1,0,1,0
10189,28,0,0,70,70,0,1,0,1,0
19739,28,0,0,66,66,0,1,0,1,0
12081,28,0,0,70,70,0,1,0,1,0
15775,28,0,0,66,66,0,1,0,1,0
17113,28,0,0,70,70,0,1,0,1,0
16674,28,0,0,70,70,0,1,0,1,0
15960,28,0,0,70,70,0,1,0,1,0
20117,28,0,0,66,66,0,1,0,1,0
16511,28,0,0,66,66,0,1,0,1,0
13811,28,0,0,66,66,0,1,0,1,0
18748,28,0,0,70,70,0,1,0,1,0
14345,28,0,0,70,70,0,1,0,1,0
21774,28,0,0,70,70,0,1,0,1,0
18168,28,0,0,66,66,0,1,0,1,0
12750,28,0,0,66,66,0,1,0,1,0
20180,28,0,0,70,70,0,1,0,1,0
22410,28,0,0,66,66,0,1,0,1,0
13194,28,0,0,70,70,0,1,0,1,0
22598,28,0,0,66,66,0,1,0,1,0
16884,28,0,0,66,66,0,1,0,1,0
9484,28,0,0,70,70,0,1,0,1,0
13485,28,0,0,70,70,0,1,0,1,0
17582,28,0,0,70,70,0,1,0,1,0
9317,28,0,0,70,70,0,1,0,1,0
17940,28,0,0,70,70,0,1,0,1,0
19414,28,0,0,66,66,0,1,0,1,0
21993,28,0,0,70,70,0,1,0,1,0
11050,28,0,0,66,66,0,1,0,1,0
16445,28,0,0,66,66,0,1,0,1,0
10082,28,0,0,66,66,0,1,0,1,0
16308,28,0,0,66,66,0,1,0,1,0
19876,28,0,0,66,66,0,1,0,1,0
20119,28,0,0,70,70,0,1,0,1,0
12213,28,0,0,70,70,0,1,0,1,0
11310,28,0,0,66,66,0,1,0,1,0
21773,28,0,0,70,70,0,1,0,1,0
14991,28,0,0,70,70,0,1,0,1,0
9114,28,0,0,70,70,0,1,0,1,0
10381,28,0,0,70,70,0,1,0,1,0
12936,28,0,0,66,66,0,1,0,1,0
9696,28,0,0,70,70,0,1,0,1,0
11783,28,0,0,70,70,0,1,0,1,0
20980,28,0,0,66,66,0,1,0,1,0
13955,28,0,0,70,70,0,1,0,1,0
13934,28,0,0,70,70,0,1,0,1,0
9453,28,0,0,66,66,0,1,0,1,0
18443,28,0,0,66,66,0,1,0,1,0
10403,28,0,0,70,70,0,1,0,1,0
18838,28,0,0,66,66,0,1,0,1,0
15369,28,0,0,70,70,0,1,0,1,0
15385,28,0,0,70,70,0,1,0,1,0
13600,28,0,0,70,70,0,1,0,1,0
22170,28,0,0,66,66,0,1,0,1,0
8630,28,0,0,70,70,0,1,0,1,0
9352,28,0,0,70,70,0,1,0,1,0
20973,28,0,0,70,70,0,1,0,1,0
21904,28,0,0,66,66,0,1,0,1,0
10431,28,0,0,70,70,0,1,0,1,0
16999,28,0,0,66,66,0,1,0,1,0
9660,28,0,0,70,70,0,1,0,1,0
8977,28,0,0,66,66,0,1,0,1,0
17825,28,0,0,70,70,0,1,0,1,0
18745,28,0,0,66,66,0,1,0,1,0
13175,28,0,0,66,66,0,1,0,1,0
16686,28,0,0,70,70,0,1,0,1,0
13998,28,0,0,70,70,0,1,0,1,0
9899,28,0,0,66,66,0,1,0,1,0
13268,28,0,0,70,70,0,1,0,1,0
16634,28,0,0,70,70,0,1,0,1,0
8587,28,0,0,70,70,0,1,0,1,0
15326,28,0,0,70,70,0,1,0,1,0
13293,28,0,0,70,70,0,1,0,1,0
10026,28,0,0,70,70,0,1,0,1,0
21434,28,0,0,66,66,0,1,0,1,0
10541,28,0,0,70,70,0,1,0,1,0
20715,28,0,0,66,66,0,1,0,1,0
11902,28,0,0,70,70,0,1,0,1,0
16065,28,0,0,70,70,0,1,0,1,0
11298,28,0,0,66,66,0,1,0,1,0
21284,28,0,0,70,70,0,1,0,1,0
11554,28,0,0,70,70,0,1,0,1,0
12949,28,0,0,70,70,0,1,0,1,0
14833,28,0,0,66,66,0,1,0,1,0
9445,28,0,0,70,70,0,1,0,1,0
15191,28,0,0,66,66,0,1,0,1,0
22438,28,0,0,70,70,0,1,0,1,0
20342,28,0,0,66,66,0,1,0,1,0
11397,28,0,0,66,66,0,1,0,1,0
18254,28,0,0,66,66,0,1,0,1,0
20515,28,0,0,70,70,0,1,0,1,0
9650,28,0,0,70,70,0,1,0,1,0
14334,28,0,0,66,66,0,1,0,1,0
12353,28,0,0,66,66,0,1,0,1,0
19503,28,0,0,70,70,0,1,0,1,0
13212,28,0,0,70,70,0,1,0,1,0
11641,28,0,0,70,70,0,1,0,1,0
12969,28,0,0,70,70,0,1,0,1,0
18369,28,0,0,70,70,0,1,0,1,0
19210,28,0,0,66,66,0,1,0,1,0
11097,28,0,0,70,70,0,1,0,1,0
8700,28,0,0,70,70,0,1,0,1,0
21348,28,0,0,70,70,0,1,0,1,0
10958,28,0,0,70,70,0,1,0,1,0
17305,28,0,0,66,66,0,1,0,1,0
9527,28,0,0,66,66,0,1,0,1,0
12875,28,0,0,70,70,0,1,0,1,0
19949,28,0,0,70,70,0,1,0,1,0
9607,28,0,0,66,66,0,1,0,1,0
19407,28,0,0,70,70,0,1,0,1,0
10098,28,0,0,70,70,0,1,0,1,0
13973,28,0,0,70,70,0,1,0,1,0
17187,28,0,0,66,66,0,1,0,1,0
21859,28,0,0,70,70,0,1,0,1,0
11433,28,0,0,70,70,0,1,0,1,0
8746,28,0,0,70,70,0,1,0,1,0
11916,28,0,0,70,70,0,1,0,1,0
20809,28,0,0,70,70,0,1,0,1,0
20238,28,0,0,66,66,0,1,0,1,0
14471,28,0,0,70,70,0,1,0,1,0
8748,28,0,0,70,70,0,1,0,1,0
10147,28,0,0,66,66,0,1,0,1,0
9426,28,0,0,66,66,0,1,0,1,0
22430,28,0,0,70,70,0,1,0,1,0
19418,28,0,0,70,70,0,1,0,1,0
9738,28,0,0,66,66,0,1,0,1,0
22491,28,0,0,70,70,0,1,0,1,0
14654,28,0,0,70,70,0,1,0,1,0
15258,28,0,0,70,70,0,1,0,1,0
14582,28,0,0,66,66,0,1,0,1,0
9309,28,0,0,70,70,0,1,0,1,0
20215,28,0,0,70,70,0,1,0,1,0
9973,28,0,0,70,70,0,1,0,1,0
17370,28,0,0,66,66,0,1,0,1,0
13197,28,0,0,70,70,0,1,0,1,0
16988,28,0,0,70,70,0,1,0,1,0
19745,28,0,0,70,70,0,1,0,1,0
16884,28,0,0,70,70,0,1,0,1,0
20402,28,0,0,70,70,0,1,0,1,0
18495,28,0,0,66,66,0,1,0,1,0
10974,28,0,0,70,70,0,1,0,1,0
12128,28,0,0,66,66,0,1,0,1,0
22199,28,0,0,70,70,0,1,0,1,0
16382,28,0,0,66,66,0,1,0,1,0
11706,28,0,0,66,66,0,1,0,1,0
14474,28,0,0,70,70,0,1,0,1,0
9413,28,0,0,70,70,0,1,0,1,0
11440,28,0,0,70,70,0,1,0,1,0
13410,28,0,0,70,70,0,1,0,1,0
12273,28,0,0,70,70,0,1,0,1,0
12895,28,0,0,70,70,0,1,0,1,0
9359,28,0,0,70,70,0,1,0,1,0
9172,28,0,0,70,70,0,1,0,1,0
14338,28,0,0,70,70,0,1,0,1,0
9991,28,0,0,66,66,0,1,0,1,0
17896,28,0,0,70,70,0,1,0,1,0
16942,28,0,0,66,66,0,1,0,1,0
13375,28,0,0,66,66,0,1,0,1,0
17281,28,0,0,70,70,0,1,0,1,0
20313,28,0,0,70,70,0,1,0,1,0
19310,28,0,0,70,70,0,1,0,1,0
10143,28,0,0,70,70,0,1,0,1,0
19513,28,0,0,70,70,0,1,0,1,0
13664,28,0,0,70,70,0,1,0,1,0
15442,28,0,0,70,70,0,1,0,1,0
19856,28,0,0,70,70,0,1,0,1,0
15712,28,0,0,70,70,0,1,0,1,0
11503,28,0,0,66,66,0,1,0,1,0
21011,28,0,0,70,70,0,1,0,1,0
19680,28,0,0,70,70,0,1,0,1,0
13860,28,0,0,70,70,0,1,0,1,0
15101,28,0,0,66,66,0,1,0,1,0
10774,28,0,0,70,70,0,1,0,1,0
21595,28,0,0,66,66,0,1,0,1,0
11933,28,0,0,66,66,0,1,0,1,0
11515,28,0,0,70,70,0,1,0,1,0
12109,28,0,0,70,70,0,1,0,1,0
17983,28,0,0,70,70,0,1,0,1,0
18314,28,0,0,70,70,0,1,0,1,0
20866,28,0,0,66,66,0,1,0,1,0
9733,28,0,0,70,70,0,1,0,1,0
21852,28,0,0,66,66,0,1,0,1,0
17739,28,0,0,70,70,0,1,0,1,0
9919,28,0,0,66,66,0,1,0,1,0
16427,28,0,0,70,70,0,1,0,1,0
17029,28,0,0,70,70,0,1,0,1,0
16003,28,0,0,70,70,0,1,0,1,0
18721,28,0,0,66,66,0,1,0,1,0
15312,28,0,0,66,66,0,1,0,1,0
9117,28,0,0,66,66,0,1,0,1,0
13753,28,0,0,66,66,0,1,0,1,0
22030,28,0,0,66,66,0,1,0,1,0
19387,28,0,0,70,70,0,1,0,1,0
9930,28,0,0,66,66,0,1,0,1,0
21624,28,0,0,70,70,0,1,0,1,0
16011,28,0,0,70,70,0,1,0,1,0
16808,28,0,0,70,70,0,1,0,1,0
19186,28,0,0,66,66,0,1,0,1,0
18720,28,0,0,66,66,0,1,0,1,0
21307,28,0,0,70,70,0,1,0,1,0
14355,28,0,0,66,66,0,1,0,1,0
15604,28,0,0,70,70,0,1,0,1,0
19234,28,0,0,70,70,0,1,0,1,0
14031,28,0,0,70,70,0,1,0,1,0
16165,28,0,0,70,70,0,1,0,1,0
15985,28,0,0,66,66,0,1,0,1,0
19841,28,0,0,70,70,0,1,0,1,0
11469,28,0,0,70,70,0,1,0,1,0
9952,28,0,0,70,70,0,1,0,1,0
14179,28,0,0,66,66,0,1,0,1,0
20597,28,0,0,66,66,0,1,0,1,0
22075,28,0,0,66,66,0,1,0,1,0
19962,28,0,0,70,70,0,1,0,1,0
9355,28,0,0,70,70,0,1,0,1,0
19702,28,0,0,70,70,0,1,0,1,0
18751,28,0,0,66,66,0,1,0,1,0
21312,28,0,0,66,66,0,1,0,1,0
13698,28,0,0,70,70,0,1,0,1,0
12846,28,0,0,66,66,0,1,0,1,0
12156,28,0,0,66,66,0,1,0,1,0
9581,28,0,0,66,66,0,1,0,1,0
11151,28,0,0,70,70,0,1,0,1,0
22443,28,0,0,70,70,0,1,0,1,0
9132,28,0,0,66,66,0,1,0,1,0
11801,28,0,0,70,70,0,1,0,1,0
14803,28,0,0,66,66,0,1,0,1,0
20249,28,0,0,66,66,0,1,0,1,0
12909,28,0,0,70,70,0,1,0,1,0
14045,28,0,0,70,70,0,1,0,1,0
20942,28,0,0,70,70,0,1,0,1,0
15047,28,0,0,70,70,0,1,0,1,0
11531,28,0,0,70,70,0,1,0,1,0
18620,28,0,0,66,66,0,1,0,1,0
14148,28,0,0,70,70,0,1,0,1,0
11051,28,0,0,66,66,0,1,0,1,0
10455,28,0,0,70,70,0,1,0,1,0
16611,28,0,0,70,70,0,1,0,1,0
19204,28,0,0,70,70,0,1,0,1,0
17856,28,0,0,70,70,0,1,0,1,0
8385,28,0,0,70,70,0,1,0,1,0
15468,28,0,0,70,70,0,1,0,1,0
18769,28,0,0,66,66,0,1,0,1,0
19098,28,0,0,66,66,0,1,0,1,0
10152,28,0,0,70,70,0,1,0,1,0
10000,28,0,0,70,70,0,1,0,1,0
19780,28,0,0,70,70,0,1,0,1,0
18135,28,0,0,70,70,0,1,0,1,0
19281,28,0,0,66,66,0,1,0,1,0
18955,28,0,0,70,70,0,1,0,1,0
18992,28,0,0,70,70,0,1,0,1,0
17183,28,0,0,66,66,0,1,0,1,0
14065,28,0,0,70,70,0,1,0,1,0
9375,28,0,0,70,70,0,1,0,1,0
17620,28,0,0,70,70,0,1,0,1,0
22633,28,0,0,70,70,0,1,0,1,0
12674,28,0,0,70,70,0,1,0,1,0
19427,28,0,0,66,66,0,1,0,1,0
19884,28,0,0,66,66,0,1,0,1,0
9181,28,0,0,70,70,0,1,0,1,0
17240,28,0,0,70,70,0,1,0,1,0
10991,28,0,0,70,70,0,1,0,1,0
21251,28,0,0,66,66,0,1,0,1,0
16941,28,0,0,66,66,0,1,0,1,0
16075,28,0,0,70,70,0,1,0,1,0
22684,28,0,0,70,70,0,1,0,1,0
12154,28,0,0,70,70,0,1,0,1,0
13793,28,0,0,70,70,0,1,0,1,0
11687,28,0,0,70,70,0,1,0,1,0
17184,28,0,0,66,66,0,1,0,1,0
10909,28,0,0,70,70,0,1,0,1,0
21618,28,0,0,66,66,0,1,0,1,0
21634,28,0,0,70,70,0,1,0,1,0
11827,28,0,0,70,70,0,1,0,1,0
15282,28,0,0,66,66,0,1,0,1,0
11798,28,0,0,66,66,0,1,0,1,0
16156,28,0,0,70,70,0,1,0,1,0
20158,28,0,0,66,66,0,1,0,1,0
20224,28,0,0,70,70,0,1,0,1,0
16464,28,0,0,70,70,0,1,0,1,0
17593,28,0,0,70,70,0,1,0,1,0
20399,28,0,0,70,70,0,1,0,1,0
13157,28,0,0,66,66,0,1,0,1,0
11658,28,0,0,70,70,0,1,0,1,0
16958,28,0,0,66,66,0,1,0,1,0
19145,28,0,0,70,70,0,1,0,1,0
20276,28,0,0,70,70,0,1,0,1,0
20239,28,0,0,66,66,0,1,0,1,0
12580,28,0,0,70,70,0,1,0,1,0
12484,28,0,0,70,70,0,1,0,1,0
10433,28,0,0,66,66,0,1,0,1,0
21988,28,0,0,70,70,0,1,0,1,0
10528,28,0,0,66,66,0,1,0,1,0
16617,28,0,0,70,70,0,1,0,1,0
21446,28,0,0,70,70,0,1,0,1,0
21562,28,0,0,70,70,0,1,0,1,0
16639,28,0,0,70,70,0,1,0,1,0
19268,28,0,0,70,70,0,1,0,1,0
10002,28,0,0,66,66,0,1,0,1,0
22417,28,0,0,70,70,0,1,0,1,0
10160,28,0,0,70,70,0,1,0,1,0
13717,28,0,0,66,66,0,1,0,1,0
15341,28,0,0,70,70,0,1,0,1,0
15218,28,0,0,70,70,0,1,0,1,0
12460,28,0,0,70,70,0,1,0,1,0
10971,28,0,0,70,70,0,1,0,1,0
15876,28,0,0,70,70,0,1,0,1,0
21786,28,0,0,70,70,0,1,0,1,0
18185,28,0,0,66,66,0,1,0,1,0
16077,28,0,0,66,66,0,1,0,1,0
18197,28,0,0,66,66,0,1,0,1,0
20965,28,0,0,70,70,0,1,0,1,0
14842,28,0,0,66,66,0,1,0,1,0
12242,28,0,0,66,66,0,1,0,1,0
19978,28,0,0,66,66,0,1,0,1,0
20972,28,0,0,66,66,0,1,0,1,0
22238,28,0,0,70,70,0,1,0,1,0
8516,28,0,0,66,66,0,1,0,1,0
19026,28,0,0,70,70,0,1,0,1,0
18212,28,0,0,70,70,0,1,0,1,0
14195,28,0,0,70,70,0,1,0,1,0
17729,28,0,0,70,70,0,1,0,1,0
14186,28,0,0,70,70,0,1,0,1,0
12177,28,0,0,66,66,0,1,0,1,0
12272,28,0,0,70,70,0,1,0,1,0
11970,28,0,0,70,70,0,1,0,1,0
9251,28,0,0,70,70,0,1,0,1,0
10358,28,0,0,66,66,0,1,0,1,0
18838,28,0,0,70,70,0,1,0,1,0
21048,28,0,0,66,66,0,1,0,1,0
8557,28,0,0,70,70,0,1,0,1,0
10335,28,0,0,66,66,0,1,0,1,0
20162,28,0,0,70,70,0,1,0,1,0
9668,28,0,0,70,70,0,1,0,1,0
10257,28,0,0,66,66,0,1,0,1,0
18356,28,0,0,70,70,0,1,0,1,0
17890,28,0,0,66,66,0,1,0,1,0
17945,28,0,0,70,70,0,1,0,1,0
10202,28,0,0,70,70,0,1,0,1,0
20998,28,0,0,70,70,0,1,0,1,0
14289,28,0,0,66,66,0,1,0,1,0
12169,28,0,0,70,70,0,1,0,1,0
19413,28,0,0,70,70,0,1,0,1,0
9808,28,0,0,70,70,0,1,0,1,0
16651,28,0,0,66,66,0,1,0,1,0
20412,28,0,0,70,70,0,1,0,1,0
10707,28,0,0,70,70,0,1,0,1,0
20439,28,0,0,66,66,0,1,0,1,0
16966,28,0,0,66,66,0,1,0,1,0
11214,28,0,0,70,70,0,1,0,1,0
15195,28,0,0,70,70,0,1,0,1,0
20345,28,0,0,70,70,0,1,0,1,0
13120,28,0,0,70,70,0,1,0,1,0
16855,28,0,0,70,70,0,1,0,1,0
21898,28,0,0,70,70,0,1,0,1,0
19667,28,0,0,70,70,0,1,0,1,0
20396,28,0,0,70,70,0,1,0,1,0
8491,28,0,0,70,70,0,1,0,1,0
21548,28,0,0,70,70,0,1,0,1,0
13561,28,0,0,70,70,0,1,0,1,0
13727,28,0,0,70,70,0,1,0,1,0
13474,28,0,0,70,70,0,1,0,1,0
8471,28,0,0,70,70,0,1,0,1,0
13758,28,0,0,70,70,0,1,0,1,0
10244,28,0,0,66,66,0,1,0,1,0
22015,28,0,0,70,70,0,1,0,1,0
13125,28,0,0,66,66,0,1,0,1,0
15346,28,0,0,70,70,0,1,0,1,0
20687,28,0,0,66,66,0,1,0,1,0
18506,28,0,0,70,70,0,1,0,1,0
16889,28,0,0,70,70,0,1,0,1,0
10440,28,0,0,70,70,0,1,0,1,0
16422,28,0,0,70,70,0,1,0,1,0
16663,28,0,0,70,70,0,1,0,1,0
22317,28,0,0,70,70,0,1,0,1,0
13540,28,0,0,70,70,0,1,0,1,0
18355,28,0,0,66,66,0,1,0,1,0
19713,28,0,0,70,70,0,1,0,1,0
11656,28,0,0,70,70,0,1,0,1,0
14612,28,0,0,70,70,0,1,0,1,0
20504,28,0,0,66,66,0,1,0,1,0
9946,28,0,0,70,70,0,1,0,1,0
17310,28,0,0,70,70,0,1,0,1,0
17118,28,0,0,70,70,0,1,0,1,0
11840,28,0,0,70,70,0,1,0,1,0
22258,28,0,0,66,66,0,1,0,1,0
9945,28,0,0,70,70,0,1,0,1,0
10146,28,0,0,70,70,0,1,0,1,0
12402,28,0,0,66,66,0,1,0,1,0
15467,28,0,0,70,70,0,1,0,1,0
12393,28,0,0,70,70,0,1,0,1,0
9987,28,0,0,70,70,0,1,0,1,0
9393,28,0,0,70,70,0,1,0,1,0
21458,28,0,0,70,70,0,1,0,1,0
19067,28,0,0,66,66,0,1,0,1,0
10175,28,0,0,66,66,0,1,0,1,0
14726,28,0,0,70,70,0,1,0,1,0
12751,28,0,0,70,70,0,1,0,1,0
11391,28,0,0,70,70,0,1,0,1,0
10545,28,0,0,66,66,0,1,0,1,0
12231,28,0,0,70,70,0,1,0,1,0
9982,28,0,0,66,66,0,1,0,1,0
18234,28,0,0,70,70,0,1,0,1,0
13800,28,0,0,70,70,0,1,0,1,0
19715,28,0,0,70,70,0,1,0,1,0
10226,28,0,0,70,70,0,1,0,1,0
16379,28,0,0,70,70,0,1,0,1,0
19276,28,0,0,70,70,0,1,0,1,0
13812,28,0,0,66,66,0,1,0,1,0
9219,28,0,0,70,70,0,1,0,1,0
9316,28,0,0,70,70,0,1,0,1,0
9950,28,0,0,70,70,0,1,0,1,0
12952,28,0,0,66,66,0,1,0,1,0
20704,28,0,0,66,66,0,1,0,1,0
21680,28,0,0,70,70,0,1,0,1,0
17064,28,0,0,70,70,0,1,0,1,0
16853,28,0,0,70,70,0,1,0,1,0
16635,28,0,0,70,70,0,1,0,1,0
20827,28,0,0,66,66,0,1,0,1,0
14288,28,0,0,70,70,0,1,0,1,0
16595,28,0,0,70,70,0,1,0,1,0
11177,28,0,0,70,70,0,1,0,1,0
10907,28,0,0,70,70,0,1,0,1,0
10070,28,0,0,70,70,0,1,0,1,0
15843,28,0,0,70,70,0,1,0,1,0
17818,28,0,0,70,70,0,1,0,1,0
16890,28,0,0,66,66,0,1,0,1,0
21495,28,0,0,66,66,0,1,0,1,0
13993,28,0,0,66,66,0,1,0,1,0
19006,28,0,0,70,70,0,1,0,1,0
9258,28,0,0,66,66,0,1,0,1,0
12007,28,0,0,70,70,0,1,0,1,0
20661,28,0,0,70,70,0,1,0,1,0
21665,28,0,0,66,66,0,1,0,1,0
11184,28,0,0,66,66,0,1,0,1,0
8323,28,0,0,66,66,0,1,0,1,0
11549,28,0,0,66,66,0,1,0,1,0
11463,28,0,0,70,70,0,1,0,1,0
11204,28,0,0,66,66,0,1,0,1,0
21583,28,0,0,66,66,0,1,0,1,0
8786,28,0,0,70,70,0,1,0,1,0
20573,28,0,0,70,70,0,1,0,1,0
12685,28,0,0,70,70,0,1,0,1,0
21591,28,0,0,70,70,0,1,0,1,0
16542,28,0,0,70,70,0,1,0,1,0
12660,28,0,0,70,70,0,1,0,1,0
21436,28,0,0,66,66,0,1,0,1,0
17460,28,0,0,70,70,0,1,0,1,0
22551,28,0,0,70,70,0,1,0,1,0
21006,28,0,0,66,66,0,1,0,1,0
14074,28,0,0,66,66,0,1,0,1,0
9871,28,0,0,66,66,0,1,0,1,0
13590,28,0,0,70,70,0,1,0,1,0
13621,28,0,0,70,70,0,1,0,1,0
15411,28,0,0,66,66,0,1,0,1,0
9736,28,0,0,70,70,0,1,0,1,0
20272,28,0,0,70,70,0,1,0,1,0
8820,28,0,0,70,70,0,1,0,1,0
8640,28,0,0,70,70,0,1,0,1,0
15649,28,0,0,70,70,0,1,0,1,0
16521,28,0,0,66,66,0,1,0,1,0
12950,28,0,0,66,66,0,1,0,1,0
12241,28,0,0,66,66,0,1,0,1,0
22045,28,0,0,70,70,0,1,0,1,0
15231,28,0,0,70,70,0,1,0,1,0
18281,28,0,0,66,66,0,1,0,1,0
12890,28,0,0,70,70,0,1,0,1,0
11469,28,0,0,70,70,0,1,0,1,0
20897,28,0,0,66,66,0,1,0,1,0
16694,28,0,0,66,66,0,1,0,1,0
8327,28,0,0,70,70,0,1,0,1,0
16247,28,0,0,70,70,0,1,0,1,0
20366,28,0,0,70,70,0,1,0,1,0
16011,28,0,0,70,70,0,1,0,1,0
19944,28,0,0,70,70,0,1,0,1,0
12110,28,0,0,66,66,0,1,0,1,0
10126,28,0,0,70,70,0,1,0,1,0
18698,28,0,0,66,66,0,1,0,1,0
14925,28,0,0,70,70,0,1,0,1,0
21739,28,0,0,70,70,0,1,0,1,0
8633,28,0,0,70,70,0,1,0,1,0
20987,28,0,0,70,70,0,1,0,1,0
8469,28,0,0,70,70,0,1,0,1,0
14934,28,0,0,66,66,0,1,0,1,0
21131,28,0,0,70,70,0,1,0,1,0
16155,28,0,0,70,70,0,1,0,1,0
22301,28,0,0,70,70,0,1,0,1,0
20999,28,0,0,70,70,0,1,0,1,0
20207,28,0,0,66,66,0,1,0,1,0
10010,28,0,0,66,66,0,1,0,1,0
20344,28,0,0,70,70,0,1,0,1,0
21019,28,0,0,66,66,0,1,0,1,0
9942,28,0,0,70,70,0,1,0,1,0
9535,28,0,0,66,66,0,1,0,1,0
21738,28,0,0,70,70,0,1,0,1,0
19242,28,0,0,70,70,0,1,0,1,0
22213,28,0,0,70,70,0,1,0,1,0
11416,28,0,0,66,66,0,1,0,1,0
10017,28,0,0,66,66,0,1,0,1,0
11280,28,0,0,70,70,0,1,0,1,0
12767,28,0,0,70,70,0,1,0,1,0
9854,28,0,0,70,70,0,1,0,1,0
14327,28,0,0,70,70,0,1,0,1,0
9754,28,0,0,70,70,0,1,0,1,0
17432,28,0,0,70,70,0,1,0,1,0
13818,28,0,0,70,70,0,1,0,1,0
18503,28,0,0,66,66,0,1,0,1,0
13485,28,0,0,66,66,0,1,0,1,0
14509,28,0,0,70,70,0,1,0,1,0
17078,28,0,0,70,70,0,1,0,1,0
16706,28,0,0,66,66,0,1,0,1,0
9611,28,0,0,66,66,0,1,0,1,0
14648,28,0,0,70,70,0,1,0,1,0
10998,28,0,0,70,70,0,1,0,1,0
9714,28,0,0,70,70,0,1,0,1,0
12542,28,0,0,70,70,0,1,0,1,0
14863,28,0,0,70,70,0,1,0,1,0
20019,28,0,0,70,70,0,1,0,1,0
18436,28,0,0,70,70,0,1,0,1,0
13950,28,0,0,66,66,0,1,0,1,0
18108,28,0,0,70,70,0,1,0,1,0
16976,28,0,0,70,70,0,1,0,1,0
12803,28,0,0,70,70,0,1,0,1,0
14866,28,0,0,70,70,0,1,0,1,0
20255,28,0,0,70,70,0,1,0,1,0
12831,28,0,0,70,70,0,1,0,1,0
10519,28,0,0,66,66,0,1,0,1,0
9009,28,0,0,70,70,0,1,0,1,0
11189,28,0,0,66,66,0,1,0,1,0
10446,28,0,0,66,66,0,1,0,1,0
15077,28,0,0,66,66,0,1,0,1,0
14604,28,0,0,70,70,0,1,0,1,0
17483,28,0,0,70,70,0,1,0,1,0
8879,28,0,0,66,66,0,1,0,1,0
14719,28,0,0,70,70,0,1,0,1,0
17546,28,0,0,70,70,0,1,0,1,0
19675,28,0,0,70,70,0,1,0,1,0
19598,28,0,0,66,66,0,1,0,1,0
10279,28,0,0,66,66,0,1,0,1,0
22399,28,0,0,66,66,0,1,0,1,0
18921,28,0,0,70,70,0,1,0,1,0
9496,28,0,0,66,66,0,1,0,1,0
18344,28,0,0,66,66,0,1,0,1,0
10891,28,0,0,70,70,0,1,0,1,0
14968,28,0,0,70,70,0,1,0,1,0
9759,28,0,0,70,70,0,1,0,1,0
16514,28,0,0,66,66,0,1,0,1,0
13743,28,0,0,66,66,0,1,0,1,0
9258,28,0,0,70,70,0,1,0,1,0
20314,28,0,0,70,70,0,1,0,1,0
17073,28,0,0,70,70,0,1,0,1,0
14599,28,0,0,70,70,0,1,0,1,0
9835,28,0,0,66,66,0,1,0,1,0
22145,28,0,0,66,66,0,1,0,1,0
21316,28,0,0,66,66,0,1,0,1,0
15909,28,0,0,66,66,0,1,0,1,0
21220,28,0,0,70,70,0,1,0,1,0
15469,28,0,0,70,70,0,1,0,1,0
15859,28,0,0,66,66,0,1,0,1,0
21553,28,0,0,66,66,0,1,0,1,0
22211,28,0,0,70,70,0,1,0,1,0
14080,28,0,0,70,70,0,1,0,1,0
13324,28,0,0,66,66,0,1,0,1,0
11219,28,0,0,70,70,0,1,0,1,0
9298,28,0,0,70,70,0,1,0,1,0
21473,28,0,0,70,70,0,1,0,1,0
10329,28,0,0,70,70,0,1,0,1,0
8807,28,0,0,70,70,0,1,0,1,0
8538,28,0,0,70,70,0,1,0,1,0
15946,28,0,0,70,70,0,1,0,1,0
22650,28,0,0,70,70,0,1,0,1,0
8548,28,0,0,66,66,0,1,0,1,0
17631,28,0,0,70,70,0,1,0,1,0
21140,28,0,0,70,70,0,1,0,1,0
8948,28,0,0,70,70,0,1,0,1,0
19194,28,0,0,70,70,0,1,0,1,0
14214,28,0,0,70,70,0,1,0,1,0
10223,28,0,0,66,66,0,1,0,1,0
16648,28,0,0,70,70,0,1,0,1,0
9077,28,0,0,70,70,0,1,0,1,0
15092,28,0,0,70,70,0,1,0,1,0
19153,28,0,0,70,70,0,1,0,1,0
21459,28,0,0,70,70,0,1,0,1,0
14731,28,0,0,66,66,0,1,0,1,0
11513,28,0,0,66,66,0,1,0,1,0
9171,28,0,0,70,70,0,1,0,1,0
15375,28,0,0,70,70,0,1,0,1,0
17626,28,0,0,70,70,0,1,0,1,0
13058,28,0,0,70,70,0,1,0,1,0
20352,28,0,0,66,66,0,1,0,1,0
11721,28,0,0,70,70,0,1,0,1,0
16137,28,0,0,66,66,0,1,0,1,0
14565,28,0,0,70,70,0,1,0,1,0
22514,28,0,0,66,66,0,1,0,1,0
13778,28,0,0,70,70,0,1,0,1,0
18438,28,0,0,70,70,0,1,0,1,0
11671,28,0,0,70,70,0,1,0,1,0
16123,28,0,0,66,66,0,1,0,1,0
16665,28,0,0,66,66,0,1,0,1,0
14196,28,0,0,70,70,0,1,0,1,0
15971,28,0,0,70,70,0,1,0,1,0
20742,28,0,0,66,66,0,1,0,1,0
19632,28,0,0,70,70,0,1,0,1,0
21896,28,0,0,70,70,0,1,0,1,0
20082,28,0,0,70,70,0,1,0,1,0
10319,28,0,0,70,70,0,1,0,1,0
14107,28,0,0,66,66,0,1,0,1,0
14132,28,0,0,66,66,0,1,0,1,0
20459,28,0,0,70,70,0,1,0,1,0
10137,28,0,0,70,70,0,1,0,1,0
10286,28,0,0,70,70,0,1,0,1,0
20064,28,0,0,70,70,0,1,0,1,0
10162,28,0,0,70,70,0,1,0,1,0
12500,28,0,0,70,70,0,1,0,1,0
20966,28,0,0,66,66,0,1,0,1,0
11585,28,0,0,70,70,0,1,0,1,0
11044,28,0,0,70,70,0,1,0,1,0
20708,28,0,0,70,70,0,1,0,1,0
9366,28,0,0,70,70,0,1,0,1,0
9430,28,0,0,66,66,0,1,0,1,0
15797,28,0,0,70,70,0,1,0,1,0
19018,28,0,0,70,70,0,1,0,1,0
21160,28,0,0,70,70,0,1,0,1,0
12982,28,0,0,70,70,0,1,0,1,0
12392,28,0,0,66,66,0,1,0,1,0
15206,28,0,0,66,66,0,1,0,1,0
14542,28,0,0,70,70,0,1,0,1,0
16409,28,0,0,70,70,0,1,0,1,0
17147,28,0,0,70,70,0,1,0,1,0
16714,28,0,0,70,70,0,1,0,1,0
10230,28,0,0,66,66,0,1,0,1,0
15272,28,0,0,70,70,0,1,0,1,0
16153,28,0,0,70,70,0,1,0,1,0
17685,28,0,0,66,66,0,1,0,1,0
20792,28,0,0,70,70,0,1,0,1,0
9071,28,0,0,70,70,0,1,0,1,0
17950,28,0,0,66,66,0,1,0,1,0
9677,28,0,0,70,70,0,1,0,1,0
17269,28,0,0,70,70,0,1,0,1,0
21597,28,0,0,66,66,0,1,0,1,0
18439,28,0,0,70,70,0,1,0,1,0
9049,28,0,0,70,70,0,1,0,1,0
17265,28,0,0,70,70,0,1,0,1,0
18232,28,0,0,66,66,0,1,0,1,0
9213,28,0,0,70,70,0,1,0,1,0
19983,28,0,0,70,70,0,1,0,1,0
17600,28,0,0,70,70,0,1,0,1,0
18745,28,0,0,70,70,0,1,0,1,0
9241,28,0,0,70,70,0,1,0,1,0
13479,28,0,0,70,70,0,1,0,1,0
17354,28,0,0,70,70,0,1,0,1,0
11427,28,0,0,70,70,0,1,0,1,0
18705,28,0,0,66,66,0,1,0,1,0
9239,28,0,0,70,70,0,1,0,1,0
10076,28,0,0,70,70,0,1,0,1,0
20320,28,0,0,70,70,0,1,0,1,0
20721,28,0,0,70,70,0,1,0,1,0
18492,28,0,0,70,70,0,1,0,1,0
10390,28,0,0,70,70,0,1,0,1,0
11408,28,0,0,66,66,0,1,0,1,0
9497,28,0,0,70,70,0,1,0,1,0
20461,28,0,0,70,70,0,1,0,1,0
16951,28,0,0,70,70,0,1,0,1,0
18048,28,0,0,66,66,0,1,0,1,0
16279,28,0,0,70,70,0,1,0,1,0
11583,28,0,0,70,70,0,1,0,1,0
14591,28,0,0,66,66,0,1,0,1,0
13850,28,0,0,70,70,0,1,0,1,0
9818,28,0,0,66,66,0,1,0,1,0
20042,28,0,0,70,70,0,1,0,1,0
15556,28,0,0,66,66,0,1,0,1,0
12630,28,0,0,66,66,0,1,0,1,0
10513,28,0,0,70,70,0,1,0,1,0
10633,28,0,0,70,70,0,1,0,1,0
9203,28,0,0,70,70,0,1,0,1,0
19537,28,0,0,70,70,0,1,0,1,0
10021,28,0,0,70,70,0,1,0,1,0
10382,28,0,0,70,70,0,1,0,1,0
17937,28,0,0,70,70,0,1,0,1,0
22394,28,0,0,66,66,0,1,0,1,0
13113,28,0,0,70,70,0,1,0,1,0
19177,28,0,0,70,70,0,1,0,1,0
21704,28,0,0,70,70,0,1,0,1,0
13513,28,0,0,66,66,0,1,0,1,0
19956,28,0,0,70,70,0,1,0,1,0
21314,28,0,0,70,70,0,1,0,1,0
20296,28,0,0,70,70,0,1,0,1,0
8510,28,0,0,70,70,0,1,0,1,0
12741,28,0,0,66,66,0,1,0,1,0
15971,28,0,0,70,70,0,1,0,1,0
19068,28,0,0,70,70,0,1,0,1,0
12276,28,0,0,66,66,0,1,0,1,0
17675,28,0,0,66,66,0,1,0,1,0
9505,28,0,0,70,70,0,1,0,1,0
10364,28,0,0,70,70,0,1,0,1,0
20262,28,0,0,66,66,0,1,0,1,0
14502,28,0,0,70,70,0,1,0,1,0
19276,28,0,0,70,70,0,1,0,1,0
20701,28,0,0,70,70,0,1,0,1,0
8423,28,0,0,70,70,0,1,0,1,0
10268,28,0,0,70,70,0,1,0,1,0
18822,28,0,0,66,66,0,1,0,1,0
17658,28,0,0,70,70,0,1,0,1,0
20254,28,0,0,66,66,0,1,0,1,0
15710,28,0,0,70,70,0,1,0,1,0
17011,28,0,0,66,66,0,1,0,1,0
8944,28,0,0,66,66,0,1,0,1,0
9946,28,0,0,66,66,0,1,0,1,0
20599,28,0,0,70,70,0,1,0,1,0
15150,28,0,0,70,70,0,1,0,1,0
14052,28,0,0,66,66,0,1,0,1,0
9797,28,0,0,70,70,0,1,0,1,0
15646,28,0,0,66,66,0,1,0,1,0
12421,28,0,0,66,66,0,1,0,1,0
10659,28,0,0,66,66,0,1,0,1,0
11195,28,0,0,70,70,0,1,0,1,0
14921,28,0,0,70,70,0,1,0,1,0
20671,28,0,0,66,66,0,1,0,1,0
21491,28,0,0,70,70,0,1,0,1,0
17992,28,0,0,70,70,0,1,0,1,0
11522,28,0,0,66,66,0,1,0,1,0
19474,28,0,0,70,70,0,1,0,1,0
8939,28,0,0,70,70,0,1,0,1,0
13882,28,0,0,70,70,0,1,0,1,0
15303,28,0,0,70,70,0,1,0,1,0
8807,28,0,0,70,70,0,1,0,1,0
13842,28,0,0,70,70,0,1,0,1,0
15359,28,0,0,70,70,0,1,0,1,0
22704,28,0,0,66,66,0,1,0,1,0
8611,28,0,0,70,70,0,1,0,1,0
12588,28,0,0,70,70,0,1,0,1,0
8922,28,0,0,70,70,0,1,0,1,0
18570,28,0,0,66,66,0,1,0,1,0
22100,28,0,0,66,66,0,1,0,1,0
21660,28,0,0,70,70,0,1,0,1,0
11504,28,0,0,70,70,0,1,0,1,0
21020,28,0,0,66,66,0,1,0,1,0
19057,28,0,0,70,70,0,1,0,1,0
20892,28,0,0,66,66,0,1,0,1,0
8779,28,0,0,66,66,0,1,0,1,0
10553,28,0,0,70,70,0,1,0,1,0
13361,28,0,0,66,66,0,1,0,1,0
19402,28,0,0,70,70,0,1,0,1,0
21982,28,0,0,66,66,0,1,0,1,0
22518,28,0,0,70,70,0,1,0,1,0
14053,28,0,0,66,66,0,1,0,1,0
13310,28,0,0,70,70,0,1,0,1,0
18942,28,0,0,70,70,0,1,0,1,0
19562,28,0,0,70,70,0,1,0,1,0
15446,28,0,0,70,70,0,1,0,1,0
16268,28,0,0,70,70,0,1,0,1,0
18909,28,0,0,70,70,0,1,0,1,0
11572,28,0,0,70,70,0,1,0,1,0
21074,28,0,0,70,70,0,1,0,1,0
10824,28,0,0,70,70,0,1,0,1,0
16699,28,0,0,66,66,0,1,0,1,0
10385,28,0,0,66,66,0,1,0,1,0
14475,28,0,0,70,70,0,1,0,1,0
20482,28,0,0,70,70,0,1,0,1,0
11407,28,0,0,70,70,0,1,0,1,0
17358,28,0,0,70,70,0,1,0,1,0
16872,28,0,0,70,70,0,1,0,1,0
16516,28,0,0,70,70,0,1,0,1,0
21185,28,0,0,70,70,0,1,0,1,0
21051,28,0,0,70,70,0,1,0,1,0
10346,28,0,0,66,66,0,1,0,1,0
16079,28,0,0,66,66,0,1,0,1,0
9812,28,0,0,66,66,0,1,0,1,0
17562,28,0,0,70,70,0,1,0,1,0
12720,28,0,0,66,66,0,1,0,1,0
22609,28,0,0,70,70,0,1,0,1,0
13054,28,0,0,70,70,0,1,0,1,0
8564,28,0,0,70,70,0,1,0,1,0
10057,28,0,0,70,70,0,1,0,1,0
9542,28,0,0,70,70,0,1,0,1,0
14989,28,0,0,70,70,0,1,0,1,0
19970,28,0,0,70,70,0,1,0,1,0
13051,28,0,0,70,70,0,1,0,1,0
19277,28,0,0,70,70,0,1,0,1,0
12197,28,0,0,66,66,0,1,0,1,0
8705,28,0,0,70,70,0,1,0,1,0
9332,28,0,0,66,66,0,1,0,1,0
20970,28,0,0,70,70,0,1,0,1,0
13999,28,0,0,70,70,0,1,0,1,0
14256,28,0,0,66,66,0,1,0,1,0
15947,28,0,0,70,70,0,1,0,1,0
21036,28,0,0,70,70,0,1,0,1,0
8490,28,0,0,70,70,0,1,0,1,0
15513,28,0,0,70,70,0,1,0,1,0
22594,28,0,0,66,66,0,1,0,1,0
20762,28,0,0,70,70,0,1,0,1,0
9212,28,0,0,70,70,0,1,0,1,0
11390,28,0,0,70,70,0,1,0,1,0
22669,28,0,0,66,66,0,1,0,1,0
18396,28,0,0,66,66,0,1,0,1,0
18578,28,0,0,66,66,0,1,0,1,0
19152,28,0,0,66,66,0,1,0,1,0
11691,28,0,0,66,66,0,1,0,1,0
17255,28,0,0,66,66,0,1,0,1,0
11941,28,0,0,70,70,0,1,0,1,0
20985,28,0,0,70,70,0,1,0,1,0
13473,28,0,0,66,66,0,1,0,1,0
8659,28,0,0,70,70,0,1,0,1,0
10409,28,0,0,70,70,0,1,0,1,0
9343,28,0,0,70,70,0,1,0,1,0
21146,28,0,0,66,66,0,1,0,1,0
20323,28,0,0,70,70,0,1,0,1,0
17622,28,0,0,66,66,0,1,0,1,0
18653,28,0,0,70,70,0,1,0,1,0
19854,28,0,0,70,70,0,1,0,1,0
17454,28,0,0,66,66,0,1,0,1,0
14470,28,0,0,70,70,0,1,0,1,0
9328,28,0,0,70,70,0,1,0,1,0
13399,28,0,0,70,70,0,1,0,1,0
18619,28,0,0,70,70,0,1,0,1,0
12157,28,0,0,70,70,0,1,0,1,0
19766,28,0,0,70,70,0,1,0,1,0
15043,28,0,0,70,70,0,1,0,1,0
15205,28,0,0,66,66,0,1,0,1,0
16655,28,0,0,66,66,0,1,0,1,0
15801,28,0,0,70,70,0,1,0,1,0
16685,28,0,0,70,70,0,1,0,1,0
9168,28,0,0,70,70,0,1,0,1,0
20022,28,0,0,66,66,0,1,0,1,0
9863,28,0,0,66,66,0,1,0,1,0
20301,28,0,0,70,70,0,1,0,1,0
13389,28,0,0,66,66,0,1,0,1,0
17447,28,0,0,70,70,0,1,0,1,0
9497,28,0,0,66,66,0,1,0,1,0
17446,28,0,0,70,70,0,1,0,1,0
18865,28,0,0,70,70,0,1,0,1,0
15863,28,0,0,70,70,0,1,0,1,0
21320,28,0,0,70,70,0,1,0,1,0
19121,28,0,0,70,70,0,1,0,1,0
19458,28,0,0,66,66,0,1,0,1,0
10190,28,0,0,66,66,0,1,0,1,0
15440,28,0,0,66,66,0,1,0,1,0
20909,28,0,0,70,70,0,1,0,1,0
11251,28,0,0,70,70,0,1,0,1,0
18572,28,0,0,70,70,0,1,0,1,0
12998,28,0,0,70,70,0,1,0,1,0
10040,28,0,0,66,66,0,1,0,1,0
17574,28,0,0,66,66,0,1,0,1,0
16611,28,0,0,70,70,0,1,0,1,0
17073,28,0,0,66,66,0,1,0,1,0
21266,28,0,0,70,70,0,1,0,1,0
15997,28,0,0,70,70,0,1,0,1,0
12868,28,0,0,66,66,0,1,0,1,0
20880,28,0,0,70,70,0,1,0,1,0
11857,28,0,0,70,70,0,1,0,1,0
14078,28,0,0,70,70,0,1,0,1,0
14276,28,0,0,70,70,0,1,0,1,0
20745,28,0,0,70,70,0,1,0,1,0
12825,28,0,0,70,70,0,1,0,1,0
9702,28,0,0,70,70,0,1,0,1,0
8791,28,0,0,70,70,0,1,0,1,0
14246,28,0,0,70,70,0,1,0,1,0
10359,28,0,0,66,66,0,1,0,1,0
13852,28,0,0,70,70,0,1,0,1,0
16814,28,0,0,70,70,0,1,0,1,0
11168,28,0,0,70,70,0,1,0,1,0
20002,28,0,0,70,70,0,1,0,1,0
8845,28,0,0,70,70,0,1,0,1,0
11601,28,0,0,70,70,0,1,0,1,0
17418,28,0,0,66,66,0,1,0,1,0
19285,28,0,0,66,66,0,1,0,1,0
15887,28,0,0,66,66,0,1,0,1,0
10830,28,0,0,70,70,0,1,0,1,0
19545,28,0,0,70,70,0,1,0,1,0
21971,28,0,0,66,66,0,1,0,1,0
9312,28,0,0,66,66,0,1,0,1,0
18090,28,0,0,66,66,0,1,0,1,0
18533,28,0,0,70,70,0,1,0,1,0
13208,28,0,0,70,70,0,1,0,1,0
17004,28,0,0,70,70,0,1,0,1,0
20584,28,0,0,70,70,0,1,0,1,0
20336,28,0,0,70,70,0,1,0,1,0
10829,28,0,0,70,70,0,1,0,1,0
20278,28,0,0,66,66,0,1,0,1,0
9198,28,0,0,70,70,0,1,0,1,0
11662,28,0,0,66,66,0,1,0,1,0
10164,28,0,0,70,70,0,1,0,1,0
16654,28,0,0,66,66,0,1,0,1,0
15798,28,0,0,70,70,0,1,0,1,0
9136,28,0,0,66,66,0,1,0,1,0
18057,28,0,0,70,70,0,1,0,1,0
8472,28,0,0,70,70,0,1,0,1,0
20495,28,0,0,70,70,0,1,0,1,0
17775,28,0,0,70,70,0,1,0,1,0
20058,28,0,0,66,66,0,1,0,1,0
20025,28,0,0,66,66,0,1,0,1,0
12717,28,0,0,70,70,0,1,0,1,0
12514,28,0,0,70,70,0,1,0,1,0
21002,28,0,0,70,70,0,1,0,1,0
12112,28,0,0,70,70,0,1,0,1,0
15878,28,0,0,70,70,0,1,0,1,0
12095,28,0,0,70,70,0,1,0,1,0
20841,28,0,0,66,66,0,1,0,1,0
10034,28,0,0,70,70,0,1,0,1,0
14944,28,0,0,70,70,0,1,0,1,0
16622,28,0,0,70,70,0,1,0,1,0
10355,28,0,0,70,70,0,1,0,1,0
11209,28,0,0,70,70,0,1,0,1,0
18904,28,0,0,70,70,0,1,0,1,0
17639,28,0,0,66,66,0,1,0,1,0
9112,28,0,0,70,70,0,1,0,1,0
12092,28,0,0,70,70,0,1,0,1,0
9982,28,0,0,70,70,0,1,0,1,0
15589,28,0,0,66,66,0,1,0,1,0
20067,28,0,0,66,66,0,1,0,1,0
11037,28,0,0,66,66,0,1,0,1,0
17542,28,0,0,66,66,0,1,0,1,0
20681,28,0,0,66,66,0,1,0,1,0
15245,28,0,0,66,66,0,1,0,1,0
19896,28,0,0,70,70,0,1,0,1,0
15266,28,0,0,66,66,0,1,0,1,0
18533,28,0,0,70,70,0,1,0,1,0
13572,28,0,0,66,66,0,1,0,1,0
14473,28,0,0,66,66,0,1,0,1,0
11054,28,0,0,70,70,0,1,0,1,0
15684,28,0,0,66,66,0,1,0,1,0
16202,28,0,0,70,70,0,1,0,1,0
16901,28,0,0,66,66,0,1,0,1,0
21942,28,0,0,66,66,0,1,0,1,0
9838,28,0,0,70,70,0,1,0,1,0
8574,28,0,0,66,66,0,1,0,1,0
18182,28,0,0,70,70,0,1,0,1,0
13518,28,0,0,66,66,0,1,0,1,0
20649,28,0,0,66,66,0,1,0,1,0
14690,28,0,0,70,70,0,1,0,1,0
14303,28,0,0,70,70,0,1,0,1,0
22281,28,0,0,70,70,0,1,0,1,0
14612,28,0,0,70,70,0,1,0,1,0
22466,28,0,0,70,70,0,1,0,1,0
15530,28,0,0,70,70,0,1,0,1,0
16491,28,0,0,70,70,0,1,0,1,0
16021,28,0,0,70,70,0,1,0,1,0
14480,28,0,0,66,66,0,1,0,1,0
13897,28,0,0,70,70,0,1,0,1,0
15555,28,0,0,70,70,0,1,0,1,0
17674,28,0,0,70,70,0,1,0,1,0
11993,28,0,0,70,70,0,1,0,1,0
8892,28,0,0,66,66,0,1,0,1,0
9411,28,0,0,70,70,0,1,0,1,0
12141,28,0,0,70,70,0,1,0,1,0
9482,28,0,0,66,66,0,1,0,1,0
12953,28,0,0,66,66,0,1,0,1,0
16346,28,0,0,66,66,0,1,0,1,0
18349,28,0,0,70,70,0,1,0,1,0
13552,28,0,0,70,70,0,1,0,1,0
18303,28,0,0,70,70,0,1,0,1,0
9161,28,0,0,66,66,0,1,0,1,0
9033,28,0,0,66,66,0,1,0,1,0
17679,28,0,0,70,70,0,1,0,1,0
9939,28,0,0,70,70,0,1,0,1,0
19837,28,0,0,70,70,0,1,0,1,0
20380,28,0,0,70,70,0,1,0,1,0
21481,28,0,0,70,70,0,1,0,1,0
10013,28,0,0,66,66,0,1,0,1,0
16182,28,0,0,70,70,0,1,0,1,0
17127,28,0,0,66,66,0,1,0,1,0
12417,28,0,0,70,70,0,1,0,1,0
13265,28,0,0,70,70,0,1,0,1,0
13715,28,0,0,66,66,0,1,0,1,0
22387,28,0,0,70,70,0,1,0,1,0
14787,28,0,0,66,66,0,1,0,1,0
13611,28,0,0,70,70,0,1,0,1,0
8731,28,0,0,70,70,0,1,0,1,0
22248,28,0,0,70,70,0,1,0,1,0
10722,28,0,0,70,70,0,1,0,1,0
13780,28,0,0,70,70,0,1,0,1,0
13065,28,0,0,70,70,0,1,0,1,0
13973,28,0,0,70,70,0,1,0,1,0
17189,28,0,0,70,70,0,1,0,1,0
21406,28,0,0,70,70,0,1,0,1,0
20128,28,0,0,70,70,0,1,0,1,0
17601,28,0,0,66,66,0,1,0,1,0
11904,28,0,0,66,66,0,1,0,1,0
22676,28,0,0,70,70,0,1,0,1,0
17904,28,0,0,70,70,0,1,0,1,0
9997,28,0,0,66,66,0,1,0,1,0
11444,28,0,0,66,66,0,1,0,1,0
9500,28,0,0,66,66,0,1,0,1,0
15176,28,0,0,70,70,0,1,0,1,0
21745,28,0,0,70,70,0,1,0,1,0
13863,28,0,0,66,66,0,1,0,1,0
15988,28,0,0,66,66,0,1,0,1,0
16498,28,0,0,66,66,0,1,0,1,0
9345,28,0,0,70,70,0,1,0,1,0
12995,28,0,0,66,66,0,1,0,1,0
9708,28,0,0,66,66,0,1,0,1,0
20266,28,0,0,70,70,0,1,0,1,0
12810,28,0,0,70,70,0,1,0,1,0
8979,28,0,0,70,70,0,1,0,1,0
14779,28,0,0,70,70,0,1,0,1,0
19007,28,0,0,70,70,0,1,0,1,0
14188,28,0,0,70,70,0,1,0,1,0
8671,28,0,0,66,66,0,1,0,1,0
14306,28,0,0,66,66,0,1,0,1,0
14218,28,0,0,70,70,0,1,0,1,0
11037,28,0,0,70,70,0,1,0,1,0
13376,28,0,0,70,70,0,1,0,1,0
13853,28,0,0,70,70,0,1,0,1,0
18681,28,0,0,70,70,0,1,0,1,0
13575,28,0,0,70,70,0,1,0,1,0
20148,28,0,0,70,70,0,1,0,1,0
19434,28,0,0,70,70,0,1,0,1,0
14356,28,0,0,70,70,0,1,0,1,0
17663,28,0,0,70,70,0,1,0,1,0
12888,28,0,0,70,70,0,1,0,1,0
10060,28,0,0,70,70,0,1,0,1,0
18843,28,0,0,70,70,0,1,0,1,0
12993,28,0,0,70,70,0,1,0,1,0
10712,28,0,0,70,70,0,1,0,1,0
11931,28,0,0,66,66,0,1,0,1,0
15163,28,0,0,70,70,0,1,0,1,0
14740,28,0,0,70,70,0,1,0,1,0
22583,28,0,0,66,66,0,1,0,1,0
12341,28,0,0,66,66,0,1,0,1,0
12634,28,0,0,70,70,0,1,0,1,0
15212,28,0,0,70,70,0,1,0,1,0
9457,28,0,0,70,70,0,1,0,1,0
22026,28,0,0,70,70,0,1,0,1,0
12486,28,0,0,70,70,0,1,0,1,0
12034,28,0,0,70,70,0,1,0,1,0
21949,28,0,0,70,70,0,1,0,1,0
18579,28,0,0,70,70,0,1,0,1,0
9557,28,0,0,66,66,0,1,0,1,0
14311,28,0,0,70,70,0,1,0,1,0
15861,28,0,0,70,70,0,1,0,1,0
9221,28,0,0,70,70,0,1,0,1,0
14964,28,0,0,70,70,0,1,0,1,0
17746,28,0,0,70,70,0,1,0,1,0
19415,28,0,0,70,70,0,1,0,1,0
8977,28,0,0,70,70,0,1,0,1,0
9725,28,0,0,66,66,0,1,0,1,0
19920,28,0,0,70,70,0,1,0,1,0
19912,28,0,0,66,66,0,1,0,1,0
16931,28,0,0,66,66,0,1,0,1,0
18483,28,0,0,70,70,0,1,0,1,0
9303,28,0,0,66,66,0,1,0,1,0
20275,28,0,0,70,70,0,1,0,1,0
19681,28,0,0,70,70,0,1,0,1,0
19775,28,0,0,66,66,0,1,0,1,0
9434,28,0,0,66,66,0,1,0,1,0
20146,28,0,0,70,70,0,1,0,1,0
12919,28,0,0,70,70,0,1,0,1,0
11119,28,0,0,70,70,0,1,0,1,0
15773,28,0,0,70,70,0,1,0,1,0
19897,28,0,0,70,70,0,1,0,1,0
18288,28,0,0,70,70,0,1,0,1,0
9829,28,0,0,70,70,0,1,0,1,0
20337,28,0,0,70,70,0,1,0,1,0
17112,28,0,0,70,70,0,1,0,1,0
8935,28,0,0,70,70,0,1,0,1,0
22588,28,0,0,70,70,0,1,0,1,0
18856,28,0,0,70,70,0,1,0,1,0
14521,28,0,0,70,70,0,1,0,1,0
22122,28,0,0,70,70,0,1,0,1,0
21248,28,0,0,66,66,0,1,0,1,0
16675,28,0,0,66,66,0,1,0,1,0
11145,28,0,0,66,66,0,1,0,1,0
21345,28,0,0,70,70,0,1,0,1,0
20667,28,0,0,70,70,0,1,0,1,0
19312,28,0,0,70,70,0,1,0,1,0
17956,28,0,0,70,70,0,1,0,1,0
15519,28,0,0,66,66,0,1,0,1,0
22053,28,0,0,66,66,0,1,0,1,0
9031,28,0,0,70,70,0,1,0,1,0
10000,28,0,0,66,66,0,1,0,1,0
12639,28,0,0,70,70,0,1,0,1,0
16335,28,0,0,66,66,0,1,0,1,0
14756,28,0,0,70,70,0,1,0,1,0
12348,28,0,0,70,70,0,1,0,1,0
15675,28,0,0,70,70,0,1,0,1,0
14669,28,0,0,70,70,0,1,0,1,0
22144,28,0,0,70,70,0,1,0,1,0
22652,28,0,0,70,70,0,1,0,1,0
17184,28,0,0,70,70,0,1,0,1,0
9164,28,0,0,70,70,0,1,0,1,0
18904,28,0,0,66,66,0,1,0,1,0
11855,28,0,0,70,70,0,1,0,1,0
13685,28,0,0,70,70,0,1,0,1,0
15808,28,0,0,70,70,0,1,0,1,0
18859,28,0,0,70,70,0,1,0,1,0
13560,28,0,0,70,70,0,1,0,1,0
19893,28,0,0,70,70,0,1,0,1,0
9992,28,0,0,70,70,0,1,0,1,0
9052,28,0,0,70,70,0,1,0,1,0
14220,28,0,0,70,70,0,1,0,1,0
18568,28,0,0,66,66,0,1,0,1,0
18917,28,0,0,70,70,0,1,0,1,0
13621,28,0,0,66,66,0,1,0,1,0
13527,28,0,0,70,70,0,1,0,1,0
9444,28,0,0,70,70,0,1,0,1,0
8622,28,0,0,70,70,0,1,0,1,0
19195,28,0,0,66,66,0,1,0,1,0
19078,28,0,0,70,70,0,1,0,1,0
13152,28,0,0,70,70,0,1,0,1,0
17561,28,0,0,66,66,0,1,0,1,0
17647,28,0,0,66,66,0,1,0,1,0
9565,28,0,0,66,66,0,1,0,1,0
9483,28,0,0,66,66,0,1,0,1,0
10000,28,0,0,66,66,0,1,0,1,0
20217,28,0,0,66,66,0,1,0,1,0
21722,28,0,0,66,66,0,1,0,1,0
9855,28,0,0,70,70,0,1,0,1,0
12877,28,0,0,70,70,0,1,0,1,0
18034,28,0,0,70,70,0,1,0,1,0
17467,28,0,0,70,70,0,1,0,1,0
12010,28,0,0,70,70,0,1,0,1,0
13875,28,0,0,66,66,0,1,0,1,0
17627,28,0,0,66,66,0,1,0,1,0
17195,28,0,0,66,66,0,1,0,1,0
16468,28,0,0,70,70,0,1,0,1,0
18539,28,0,0,70,70,0,1,0,1,0
16395,28,0,0,66,66,0,1,0,1,0
20192,28,0,0,70,70,0,1,0,1,0
13184,28,0,0,70,70,0,1,0,1,0
12901,28,0,0,66,66,0,1,0,1,0
10073,28,0,0,70,70,0,1,0,1,0
12854,28,0,0,70,70,0,1,0,1,0
16945,28,0,0,70,70,0,1,0,1,0
13067,28,0,0,70,70,0,1,0,1,0
9360,28,0,0,66,66,0,1,0,1,0
11194,28,0,0,70,70,0,1,0,1,0
12377,28,0,0,70,70,0,1,0,1,0
17525,28,0,0,70,70,0,1,0,1,0
12617,28,0,0,70,70,0,1,0,1,0
19363,28,0,0,70,70,0,1,0,1,0
22121,28,0,0,66,66,0,1,0,1,0
9004,28,0,0,66,66,0,1,0,1,0
22687,28,0,0,70,70,0,1,0,1,0
21868,28,0,0,70,70,0,1,0,1,0
16918,28,0,0,70,70,0,1,0,1,0
17139,28,0,0,66,66,0,1,0,1,0
14055,28,0,0,66,66,0,1,0,1,0
20245,28,0,0,70,70,0,1,0,1,0
11721,28,0,0,70,70,0,1,0,1,0
21501,28,0,0,70,70,0,1,0,1,0
17706,28,0,0,66,66,0,1,0,1,0
16345,28,0,0,70,70,0,1,0,1,0
11885,28,0,0,66,66,0,1,0,1,0
22148,28,0,0,66,66,0,1,0,1,0
16207,28,0,0,70,70,0,1,0,1,0
13921,28,0,0,70,70,0,1,0,1,0
17651,28,0,0,66,66,0,1,0,1,0
13892,28,0,0,70,70,0,1,0,1,0
16612,28,0,0,70,70,0,1,0,1,0
21616,28,0,0,66,66,0,1,0,1,0
18981,28,0,0,70,70,0,1,0,1,0
11180,28,0,0,70,70,0,1,0,1,0
19557,28,0,0,66,66,0,1,0,1,0
9983,28,0,0,70,70,0,1,0,1,0
11623,28,0,0,66,66,0,1,0,1,0
11488,28,0,0,70,70,0,1,0,1,0
10862,28,0,0,66,66,0,1,0,1,0
11802,28,0,0,70,70,0,1,0,1,0
22069,28,0,0,70,70,0,1,0,1,0
15829,28,0,0,66,66,0,1,0,1,0
16087,28,0,0,66,66,0,1,0,1,0
17488,28,0,0,70,70,0,1,0,1,0
15882,28,0,0,70,70,0,1,0,1,0
8577,28,0,0,66,66,0,1,0,1,0
10386,28,0,0,70,70,0,1,0,1,0
15721,28,0,0,70,70,0,1,0,1,0
15027,28,0,0,66,66,0,1,0,1,0
10166,28,0,0,66,66,0,1,0,1,0
11649,28,0,0,66,66,0,1,0,1,0
20642,28,0,0,70,70,0,1,0,1,0
8726,28,0,0,70,70,0,1,0,1,0
16685,28,0,0,70,70,0,1,0,1,0
10294,28,0,0,66,66,0,1,0,1,0
15776,28,0,0,70,70,0,1,0,1,0
19922,28,0,0,70,70,0,1,0,1,0
13785,28,0,0,70,70,0,1,0,1,0
11346,28,0,0,70,70,0,1,0,1,0
9826,28,0,0,66,66,0,1,0,1,0
13425,28,0,0,66,66,0,1,0,1,0
20016,28,0,0,70,70,0,1,0,1,0
13905,28,0,0,70,70,0,1,0,1,0
18318,28,0,0,66,66,0,1,0,1,0
18841,28,0,0,66,66,0,1,0,1,0
17564,28,0,0,70,70,0,1,0,1,0
18547,28,0,0,66,66,0,1,0,1,0
12704,28,0,0,70,70,0,1,0,1,0
20157,28,0,0,66,66,0,1,0,1,0
12513,28,0,0,66,66,0,1,0,1,0
19733,28,0,0,70,70,0,1,0,1,0
18051,28,0,0,70,70,0,1,0,1,0
21474,28,0,0,66,66,0,1,0,1,0
8875,28,0,0,70,70,0,1,0,1,0
16828,28,0,0,70,70,0,1,0,1,0
21071,28,0,0,66,66,0,1,0,1,0
14464,28,0,0,70,70,0,1,0,1,0
16145,28,0,0,70,70,0,1,0,1,0
13214,28,0,0,66,66,0,1,0,1,0
9753,28,0,0,70,70,0,1,0,1,0
19910,28,0,0,70,70,0,1,0,1,0
21621,28,0,0,66,66,0,1,0,1,0
16238,28,0,0,66,66,0,1,0,1,0
17327,28,0,0,70,70,0,1,0,1,0
11464,28,0,0,66,66,0,1,0,1,0
18818,28,0,0,70,70,0,1,0,1,0
12783,28,0,0,70,70,0,1,0,1,0
17909,28,0,0,70,70,0,1,0,1,0
22431,28,0,0,66,66,0,1,0,1,0
20340,28,0,0,66,66,0,1,0,1,0
14908,28,0,0,66,66,0,1,0,1,0
10783,28,0,0,66,66,0,1,0,1,0
20905,28,0,0,70,70,0,1,0,1,0
18408,28,0,0,70,70,0,1,0,1,0
9336,28,0,0,70,70,0,1,0,1,0
18846,28,0,0,70,70,0,1,0,1,0
19614,28,0,0,70,70,0,1,0,1,0
15850,28,0,0,70,70,0,1,0,1,0
18259,28,0,0,66,66,0,1,0,1,0
22056,28,0,0,70,70,0,1,0,1,0
18781,28,0,0,70,70,0,1,0,1,0
10219,28,0,0,66,66,0,1,0,1,0
16956,28,0,0,70,70,0,1,0,1,0
13834,28,0,0,66,66,0,1,0,1,0
12818,28,0,0,70,70,0,1,0,1,0
13814,28,0,0,70,70,0,1,0,1,0
9200,28,0,0,66,66,0,1,0,1,0
8674,28,0,0,70,70,0,1,0,1,0
13931,28,0,0,66,66,0,1,0,1,0
21358,28,0,0,70,70,0,1,0,1,0
8456,28,0,0,70,70,0,1,0,1,0
14333,28,0,0,70,70,0,1,0,1,0
11798,28,0,0,70,70,0,1,0,1,0
19180,28,0,0,70,70,0,1,0,1,0
18687,28,0,0,66,66,0,1,0,1,0
22263,28,0,0,70,70,0,1,0,1,0
12518,28,0,0,70,70,0,1,0,1,0
14983,28,0,0,70,70,0,1,0,1,0
11126,28,0,0,70,70,0,1,0,1,0
21483,28,0,0,70,70,0,1,0,1,0
17563,28,0,0,66,66,0,1,0,1,0
12621,28,0,0,70,70,0,1,0,1,0
13691,28,0,0,66,66,0,1,0,1,0
9194,28,0,0,66,66,0,1,0,1,0
19119,28,0,0,70,70,0,1,0,1,0
21917,28,0,0,70,70,0,1,0,1,0
17361,28,0,0,66,66,0,1,0,1,0
9077,28,0,0,70,70,0,1,0,1,0
16410,28,0,0,66,66,0,1,0,1,0
22432,28,0,0,70,70,0,1,0,1,0
13099,28,0,0,70,70,0,1,0,1,0
18545,28,0,0,70,70,0,1,0,1,0
17419,28,0,0,70,70,0,1,0,1,0
13441,28,0,0,70,70,0,1,0,1,0
20024,28,0,0,66,66,0,1,0,1,0
21130,28,0,0,70,70,0,1,0,1,0
12974,28,0,0,70,70,0,1,0,1,0
17949,28,0,0,66,66,0,1,0,1,0
15740,28,0,0,70,70,0,1,0,1,0
19926,28,0,0,66,66,0,1,0,1,0
9409,28,0,0,70,70,0,1,0,1,0
8606,28,0,0,66,66,0,1,0,1,0
13545,28,0,0,70,70,0,1,0,1,0
15514,28,0,0,70,70,0,1,0,1,0
16815,28,0,0,70,70,0,1,0,1,0
20206,28,0,0,70,70,0,1,0,1,0
22441,28,0,0,66,66,0,1,0,1,0
9967,28,0,0,70,70,0,1,0,1,0
13704,28,0,0,70,70,0,1,0,1,0
14783,28,0,0,66,66,0,1,0,1,0
10074,28,0,0,70,70,0,1,0,1,0
11829,28,0,0,66,66,0,1,0,1,0
18335,28,0,0,66,66,0,1,0,1,0
10581,28,0,0,70,70,0,1,0,1,0
12586,28,0,0,70,70,0,1,0,1,0
9247,28,0,0,70,70,0,1,0,1,0
16881,28,0,0,70,70,0,1,0,1,0
20430,28,0,0,70,70,0,1,0,1,0
9826,28,0,0,70,70,0,1,0,1,0
12770,28,0,0,66,66,0,1,0,1,0
10440,28,0,0,66,66,0,1,0,1,0
10971,28,0,0,66,66,0,1,0,1,0
20263,28,0,0,70,70,0,1,0,1,0
15782,28,0,0,70,70,0,1,0,1,0
13713,28,0,0,70,70,0,1,0,1,0
17820,28,0,0,70,70,0,1,0,1,0
14368,28,0,0,66,66,0,1,0,1,0
17246,28,0,0,66,66,0,1,0,1,0
10658,28,0,0,66,66,0,1,0,1,0
12261,28,0,0,66,66,0,1,0,1,0
22084,28,0,0,70,70,0,1,0,1,0
15566,28,0,0,70,70,0,1,0,1,0
13650,28,0,0,66,66,0,1,0,1,0
22402,28,0,0,66,66,0,1,0,1,0
16201,28,0,0,66,66,0,1,0,1,0
19047,28,0,0,70,70,0,1,0,1,0
17335,28,0,0,70,70,0,1,0,1,0
15329,28,0,0,70,70,0,1,0,1,0
13525,28,0,0,66,66,0,1,0,1,0
18577,28,0,0,70,70,0,1,0,1,0
9959,28,0,0,70,70,0,1,0,1,0
18178,28,0,0,70,70,0,1,0,1,0
12389,28,0,0,70,70,0,1,0,1,0
11653,28,0,0,70,70,0,1,0,1,0
10222,28,0,0,66,66,0,1,0,1,0
11493,28,0,0,70,70,0,1,0,1,0
17264,28,0,0,66,66,0,1,0,1,0
18421,28,0,0,70,70,0,1,0,1,0
22096,28,0,0,70,70,0,1,0,1,0
9981,28,0,0,66,66,0,1,0,1,0
20590,28,0,0,70,70,0,1,0,1,0
13617,28,0,0,70,70,0,1,0,1,0
10620,28,0,0,70,70,0,1,0,1,0
20005,28,0,0,70,70,0,1,0,1,0
20068,28,0,0,66,66,0,1,0,1,0
21169,28,0,0,70,70,0,1,0,1,0
18114,28,0,0,70,70,0,1,0,1,0
14336,28,0,0,70,70,0,1,0,1,0
17427,28,0,0,70,70,0,1,0,1,0
13635,28,0,0,70,70,0,1,0,1,0
11070,28,0,0,66,66,0,1,0,1,0
9817,28,0,0,70,70,0,1,0,1,0
19079,28,0,0,66,66,0,1,0,1,0
15367,28,0,0,70,70,0,1,0,1,0
21124,28,0,0,70,70,0,1,0,1,0
11399,28,0,0,70,70,0,1,0,1,0
12800,28,0,0,66,66,0,1,0,1,0
17028,28,0,0,70,70,0,1,0,1,0
14224,28,0,0,70,70,0,1,0,1,0
9356,28,0,0,70,70,0,1,0,1,0
13915,28,0,0,70,70,0,1,0,1,0
16281,28,0,0,70,70,0,1,0,1,0
14490,28,0,0,66,66,0,1,0,1,0
18075,28,0,0,66,66,0,1,0,1,0
14580,28,0,0,70,70,0,1,0,1,0
16509,28,0,0,70,70,0,1,0,1,0
10861,28,0,0,66,66,0,1,0,1,0
20167,28,0,0,66,66,0,1,0,1,0
19441,28,0,0,70,70,0,1,0,1,0
15427,28,0,0,70,70,0,1,0,1,0
22179,28,0,0,70,70,0,1,0,1,0
21032,28,0,0,66,66,0,1,0,1,0
16910,28,0,0,66,66,0,1,0,1,0
16589,28,0,0,70,70,0,1,0,1,0
11254,28,0,0,70,70,0,1,0,1,0
20408,28,0,0,66,66,0,1,0,1,0
22557,28,0,0,70,70,0,1,0,1,0
21318,28,0,0,70,70,0,1,0,1,0
13989,28,0,0,70,70,0,1,0,1,0
18973,28,0,0,66,66,0,1,0,1,0
19627,28,0,0,70,70,0,1,0,1,0
20241,28,0,0,70,70,0,1,0,1,0
20616,28,0,0,70,70,0,1,0,1,0
13837,28,0,0,66,66,0,1,0,1,0
13176,28,0,0,66,66,0,1,0,1,0
20974,28,0,0,66,66,0,1,0,1,0
17190,28,0,0,66,66,0,1,0,1,0
20308,28,0,0,70,70,0,1,0,1,0
21706,28,0,0,70,70,0,1,0,1,0
14530,28,0,0,66,66,0,1,0,1,0
11805,28,0,0,70,70,0,1,0,1,0
19455,28,0,0,70,70,0,1,0,1,0
10332,28,0,0,66,66,0,1,0,1,0
19215,28,0,0,70,70,0,1,0,1,0
9443,28,0,0,70,70,0,1,0,1,0
17396,28,0,0,70,70,0,1,0,1,0
20385,28,0,0,70,70,0,1,0,1,0
14577,28,0,0,70,70,0,1,0,1,0
12995,28,0,0,70,70,0,1,0,1,0
21114,28,0,0,70,70,0,1,0,1,0
16427,28,0,0,70,70,0,1,0,1,0
11217,28,0,0,70,70,0,1,0,1,0
21609,28,0,0,66,66,0,1,0,1,0
13645,28,0,0,70,70,0,1,0,1,0
11601,28,0,0,66,66,0,1,0,1,0
12410,28,0,0,66,66,0,1,0,1,0
11346,28,0,0,66,66,0,1,0,1,0
11370,28,0,0,70,70,0,1,0,1,0
22275,28,0,0,66,66,0,1,0,1,0
20968,28,0,0,70,70,0,1,0,1,0
16025,28,0,0,66,66,0,1,0,1,0
16869,28,0,0,70,70,0,1,0,1,0
15030,28,0,0,66,66,0,1,0,1,0
8478,28,0,0,66,66,0,1,0,1,0
14456,28,0,0,66,66,0,1,0,1,0
9988,28,0,0,70,70,0,1,0,1,0
14198,28,0,0,70,70,0,1,0,1,0
17531,28,0,0,70,70,0,1,0,1,0
18805,28,0,0,70,70,0,1,0,1,0
10004,28,0,0,70,70,0,1,0,1,0
19436,28,0,0,66,66,0,1,0,1,0
9836,28,0,0,70,70,0,1,0,1,0
11697,28,0,0,70,70,0,1,0,1,0
19357,28,0,0,66,66,0,1,0,1,0
14123,28,0,0,70,70,0,1,0,1,0
16736,28,0,0,70,70,0,1,0,1,0
17747,28,0,0,66,66,0,1,0,1,0
21573,28,0,0,66,66,0,1,0,1,0
11893,28,0,0,70,70,0,1,0,1,0
10094,28,0,0,70,70,0,1,0,1,0
13389,28,0,0,70,70,0,1,0,1,0
21656,28,0,0,70,70,0,1,0,1,0
9495,28,0,0,66,66,0,1,0,1,0
14122,28,0,0,70,70,0,1,0,1,0
21403,28,0,0,70,70,0,1,0,1,0
18877,28,0,0,66,66,0,1,0,1,0
9630,28,0,0,66,66,0,1,0,1,0
11946,28,0,0,66,66,0,1,0,1,0
11490,28,0,0,70,70,0,1,0,1,0
12371,28,0,0,70,70,0,1,0,1,0
21679,28,0,0,70,70,0,1,0,1,0
9101,28,0,0,70,70,0,1,0,1,0
21433,28,0,0,66,66,0,1,0,1,0
10240,28,0,0,66,66,0,1,0,1,0
9322,28,0,0,70,70,0,1,0,1,0
12763,28,0,0,70,70,0,1,0,1,0
16234,28,0,0,70,70,0,1,0,1,0
9852,28,0,0,70,70,0,1,0,1,0
18112,28,0,0,70,70,0,1,0,1,0
10423,28,0,0,66,66,0,1,0,1,0
14044,28,0,0,70,70,0,1,0,1,0
19009,28,0,0,66,66,0,1,0,1,0
9593,28,0,0,70,70,0,1,0,1,0
17919,28,0,0,66,66,0,1,0,1,0
9059,28,0,0,70,70,0,1,0,1,0
19540,28,0,0,66,66,0,1,0,1,0
14820,28,0,0,66,66,0,1,0,1,0
19957,28,0,0,70,70,0,1,0,1,0
14894,28,0,0,70,70,0,1,0,1,0
11420,28,0,0,66,66,0,1,0,1,0
8668,28,0,0,70,70,0,1,0,1,0
17193,28,0,0,70,70,0,1,0,1,0
12121,28,0,0,70,70,0,1,0,1,0
21479,28,0,0,70,70,0,1,0,1,0
17829,28,0,0,70,70,0,1,0,1,0
19826,28,0,0,66,66,0,1,0,1,0
20165,28,0,0,70,70,0,1,0,1,0
13771,28,0,0,70,70,0,1,0,1,0
11100,28,0,0,66,66,0,1,0,1,0
8394,28,0,0,66,66,0,1,0,1,0
14484,28,0,0,66,66,0,1,0,1,0
11294,28,0,0,70,70,0,1,0,1,0
13897,28,0,0,70,70,0,1,0,1,0
12190,28,0,0,70,70,0,1,0,1,0
14771,28,0,0,70,70,0,1,0,1,0
17060,28,0,0,66,66,0,1,0,1,0
22448,28,0,0,66,66,0,1,0,1,0
19053,28,0,0,66,66,0,1,0,1,0
16267,28,0,0,70,70,0,1,0,1,0
20139,28,0,0,70,70,0,1,0,1,0
11952,28,0,0,66,66,0,1,0,1,0
15807,28,0,0,66,66,0,1,0,1,0
15088,28,0,0,70,70,0,1,0,1,0
19589,28,0,0,70,70,0,1,0,1,0
13368,28,0,0,70,70,0,1,0,1,0
17267,28,0,0,70,70,0,1,0,1,0
19300,28,0,0,70,70,0,1,0,1,0
20632,28,0,0,70,70,0,1,0,1,0
20226,28,0,0,66,66,0,1,0,1,0
22217,28,0,0,66,66,0,1,0,1,0
21769,28,0,0,70,70,0,1,0,1,0
13523,28,0,0,66,66,0,1,0,1,0
20857,28,0,0,70,70,0,1,0,1,0
9723,28,0,0,70,70,0,1,0,1,0
14156,28,0,0,70,70,0,1,0,1,0
17316,28,0,0,70,70,0,1,0,1,0
22090,28,0,0,70,70,0,1,0,1,0
19360,28,0,0,66,66,0,1,0,1,0
18773,28,0,0,66,66,0,1,0,1,0
10225,28,0,0,66,66,0,1,0,1,0
9568,28,0,0,70,70,0,1,0,1,0
19787,28,0,0,66,66,0,1,0,1,0
20072,28,0,0,70,70,0,1,0,1,0
17906,28,0,0,66,66,0,1,0,1,0
18625,28,0,0,70,70,0,1,0,1,0
17544,28,0,0,66,66,0,1,0,1,0
20840,28,0,0,70,70,0,1,0,1,0
12181,28,0,0,66,66,0,1,0,1,0
18482,28,0,0,66,66,0,1,0,1,0
20081,28,0,0,70,70,0,1,0,1,0
16778,28,0,0,70,70,0,1,0,1,0
20401,28,0,0,66,66,0,1,0,1,0
14176,28,0,0,66,66,0,1,0,1,0
13270,28,0,0,70,70,0,1,0,1,0
21659,28,0,0,70,70,0,1,0,1,0
18319,28,0,0,70,70,0,1,0,1,0
14903,28,0,0,66,66,0,1,0,1,0
13264,28,0,0,70,70,0,1,0,1,0
11027,28,0,0,66,66,0,1,0,1,0
21197,28,0,0,70,70,0,1,0,1,0
21518,28,0,0,70,70,0,1,0,1,0
10836,28,0,0,70,70,0,1,0,1,0
12978,28,0,0,66,66,0,1,0,1,0
14372,28,0,0,70,70,0,1,0,1,0
21264,28,0,0,66,66,0,1,0,1,0
19840,28,0,0,66,66,0,1,0,1,0
13309,28,0,0,70,70,0,1,0,1,0
16136,28,0,0,70,70,0,1,0,1,0
9435,28,0,0,66,66,0,1,0,1,0
21491,28,0,0,66,66,0,1,0,1,0
8594,28,0,0,70,70,0,1,0,1,0
13385,28,0,0,70,70,0,1,0,1,0
18592,28,0,0,70,70,0,1,0,1,0
19101,28,0,0,70,70,0,1,0,1,0
9163,28,0,0,70,70,0,1,0,1,0
13738,28,0,0,66,66,0,1,0,1,0
20720,28,0,0,70,70,0,1,0,1,0
11311,28,0,0,66,66,0,1,0,1,0
8716,28,0,0,70,70,0,1,0,1,0
13874,28,0,0,70,70,0,1,0,1,0
19245,28,0,0,70,70,0,1,0,1,0
12174,28,0,0,70,70,0,1,0,1,0
19429,28,0,0,70,70,0,1,0,1,0
16036,28,0,0,70,70,0,1,0,1,0
21200,28,0,0,70,70,0,1,0,1,0
11565,28,0,0,70,70,0,1,0,1,0
18988,28,0,0,70,70,0,1,0,1,0
18676,28,0,0,70,70,0,1,0,1,0
14650,28,0,0,66,66,0,1,0,1,0
9799,28,0,0,70,70,0,1,0,1,0
10886,28,0,0,66,66,0,1,0,1,0
15395,28,0,0,66,66,0,1,0,1,0
19353,28,0,0,70,70,0,1,0,1,0
18114,28,0,0,70,70,0,1,0,1,0
12218,28,0,0,70,70,0,1,0,1,0
13530,28,0,0,66,66,0,1,0,1,0
13849,28,0,0,70,70,0,1,0,1,0
10799,28,0,0,66,66,0,1,0,1,0
20947,28,0,0,70,70,0,1,0,1,0
14352,28,0,0,70,70,0,1,0,1,0
9789,28,0,0,70,70,0,1,0,1,0
17843,28,0,0,66,66,0,1,0,1,0
16248,28,0,0,70,70,0,1,0,1,0
20242,28,0,0,66,66,0,1,0,1,0
8421,28,0,0,66,66,0,1,0,1,0
8884,28,0,0,66,66,0,1,0,1,0
19420,28,0,0,66,66,0,1,0,1,0
16043,28,0,0,70,70,0,1,0,1,0
11250,28,0,0,70,70,0,1,0,1,0
11721,28,0,0,66,66,0,1,0,1,0
17738,28,0,0,70,70,0,1,0,1,0
17811,28,0,0,70,70,0,1,0,1,0
12133,28,0,0,70,70,0,1,0,1,0
10081,28,0,0,70,70,0,1,0,1,0
10754,28,0,0,70,70,0,1,0,1,0
17500,28,0,0,66,66,0,1,0,1,0
18462,28,0,0,70,70,0,1,0,1,0
20761,28,0,0,70,70,0,1,0,1,0
16592,28,0,0,70,70,0,1,0,1,0
12368,28,0,0,66,66,0,1,0,1,0
14428,28,0,0,66,66,0,1,0,1,0
10172,28,0,0,66,66,0,1,0,1,0
8488,28,0,0,70,70,0,1,0,1,0
13290,28,0,0,70,70,0,1,0,1,0
21986,28,0,0,70,70,0,1,0,1,0
13853,28,0,0,70,70,0,1,0,1,0
18307,28,0,0,66,66,0,1,0,1,0
13977,28,0,0,70,70,0,1,0,1,0
9806,28,0,0,66,66,0,1,0,1,0
10639,28,0,0,70,70,0,1,0,1,0
10556,28,0,0,70,70,0,1,0,1,0
20736,28,0,0,70,70,0,1,0,1,0
8654,28,0,0,70,70,0,1,0,1,0
10671,28,0,0,70,70,0,1,0,1,0
17801,28,0,0,66,66,0,1,0,1,0
20293,28,0,0,66,66,0,1,0,1,0
19476,28,0,0,66,66,0,1,0,1,0
18851,28,0,0,70,70,0,1,0,1,0
21813,28,0,0,70,70,0,1,0,1,0
17757,28,0,0,70,70,0,1,0,1,0
18035,28,0,0,70,70,0,1,0,1,0
10144,28,0,0,70,70,0,1,0,1,0
11738,28,0,0,70,70,0,1,0,1,0
16872,28,0,0,70,70,0,1,0,1,0
20069,28,0,0,70,70,0,1,0,1,0
10121,28,0,0,70,70,0,1,0,1,0
17408,28,0,0,66,66,0,1,0,1,0
14927,28,0,0,70,70,0,1,0,1,0
18581,28,0,0,70,70,0,1,0,1,0
12942,28,0,0,70,70,0,1,0,1,0
16814,28,0,0,66,66,0,1,0,1,0
21976,28,0,0,66,66,0,1,0,1,0
16045,28,0,0,70,70,0,1,0,1,0
8862,28,0,0,66,66,0,1,0,1,0
15905,28,0,0,70,70,0,1,0,1,0
11769,28,0,0,70,70,0,1,0,1,0
14813,28,0,0,66,66,0,1,0,1,0
13470,28,0,0,70,70,0,1,0,1,0
14232,28,0,0,66,66,0,1,0,1,0
17763,28,0,0,66,66,0,1,0,1,0
22029,28,0,0,66,66,0,1,0,1,0
12851,28,0,0,70,70,0,1,0,1,0
16253,28,0,0,70,70,0,1,0,1,0
17179,28,0,0,70,70,0,1,0,1,0
11364,28,0,0,70,70,0,1,0,1,0
19838,28,0,0,66,66,0,1,0,1,0
22177,28,0,0,70,70,0,1,0,1,0
22411,28,0,0,70,70,0,1,0,1,0
17125,28,0,0,66,66,0,1,0,1,0
18624,28,0,0,70,70,0,1,0,1,0
19272,28,0,0,70,70,0,1,0,1,0
22518,28,0,0,66,66,0,1,0,1,0
17656,28,0,0,70,70,0,1,0,1,0
14172,28,0,0,70,70,0,1,0,1,0
18420,28,0,0,66,66,0,1,0,1,0
19762,28,0,0,70,70,0,1,0,1,0
17918,28,0,0,70,70,0,1,0,1,0
15838,28,0,0,70,70,0,1,0,1,0
9142,28,0,0,70,70,0,1,0,1,0
16398,28,0,0,70,70,0,1,0,1,0
9081,28,0,0,70,70,0,1,0,1,0
14225,28,0,0,70,70,0,1,0,1,0
16353,28,0,0,66,66,0,1,0,1,0
12842,28,0,0,66,66,0,1,0,1,0
15969,28,0,0,70,70,0,1,0,1,0
21265,28,0,0,70,70,0,1,0,1,0
16911,28,0,0,66,66,0,1,0,1,0
20222,28,0,0,70,70,0,1,0,1,0
22357,28,0,0,70,70,0,1,0,1,0
10199,28,0,0,66,66,0,1,0,1,0
19645,28,0,0,70,70,0,1,0,1,0
13640,28,0,0,70,70,0,1,0,1,0
10127,28,0,0,70,70,0,1,0,1,0
21532,28,0,0,66,66,0,1,0,1,0
16396,28,0,0,70,70,0,1,0,1,0
20541,28,0,0,66,66,0,1,0,1,0
19608,28,0,0,66,66,0,1,0,1,0
11731,28,0,0,70,70,0,1,0,1,0
13612,28,0,0,66,66,0,1,0,1,0
16574,28,0,0,70,70,0,1,0,1,0
10382,28,0,0,66,66,0,1,0,1,0
13812,28,0,0,70,70,0,1,0,1,0
17720,28,0,0,70,70,0,1,0,1,0
10818,28,0,0,70,70,0,1,0,1,0
19057,28,0,0,66,66,0,1,0,1,0
22279,28,0,0,70,70,0,1,0,1,0
14407,28,0,0,70,70,0,1,0,1,0
12182,28,0,0,70,70,0,1,0,1,0
9235,28,0,0,70,70,0,1,0,1,0
18865,28,0,0,66,66,0,1,0,1,0
11318,28,0,0,66,66,0,1,0,1,0
13141,28,0,0,70,70,0,1,0,1,0
16340,28,0,0,66,66,0,1,0,1,0
21376,28,0,0,66,66,0,1,0,1,0
20259,28,0,0,66,66,0,1,0,1,0
16106,28,0,0,70,70,0,1,0,1,0
18089,28,0,0,70,70,0,1,0,1,0
13980,28,0,0,70,70,0,1,0,1,0
11850,28,0,0,70,70,0,1,0,1,0
14681,28,0,0,70,70,0,1,0,1,0
18908,28,0,0,66,66,0,1,0,1,0
20816,28,0,0,66,66,0,1,0,1,0
17030,28,0,0,70,70,0,1,0,1,0
20297,28,0,0,66,66,0,1,0,1,0
9014,28,0,0,70,70,0,1,0,1,0
16041,28,0,0,70,70,0,1,0,1,0
17630,28,0,0,70,70,0,1,0,1,0
22057,28,0,0,70,70,0,1,0,1,0
19882,28,0,0,70,70,0,1,0,1,0
17790,28,0,0,70,70,0,1,0,1,0
20922,28,0,0,70,70,0,1,0,1,0
11594,28,0,0,70,70,0,1,0,1,0
18308,28,0,0,70,70,0,1,0,1,0
21451,28,0,0,66,66,0,1,0,1,0
14233,28,0,0,70,70,0,1,0,1,0
14629,28,0,0,70,70,0,1,0,1,0
12526,28,0,0,66,66,0,1,0,1,0
8708,28,0,0,66,66,0,1,0,1,0
19743,28,0,0,66,66,0,1,0,1,0
13046,28,0,0,66,66,0,1,0,1,0
22117,28,0,0,70,70,0,1,0,1,0
10378,28,0,0,70,70,0,1,0,1,0
8794,28,0,0,70,70,0,1,0,1,0
21663,28,0,0,70,70,0,1,0,1,0
15310,28,0,0,70,70,0,1,0,1,0
13031,28,0,0,70,70,0,1,0,1,0
20694,28,0,0,66,66,0,1,0,1,0
18863,28,0,0,70,70,0,1,0,1,0
15843,28,0,0,70,70,0,1,0,1,0
14181,28,0,0,70,70,0,1,0,1,0
12497,28,0,0,70,70,0,1,0,1,0
17247,28,0,0,66,66,0,1,0,1,0
16995,28,0,0,70,70,0,1,0,1,0
20272,28,0,0,66,66,0,1,0,1,0
17709,28,0,0,70,70,0,1,0,1,0
20194,28,0,0,70,70,0,1,0,1,0
16757,28,0,0,70,70,0,1,0,1,0
19111,28,0,0,70,70,0,1,0,1,0
17732,28,0,0,66,66,0,1,0,1,0
16372,28,0,0,66,66,0,1,0,1,0
20860,28,0,0,66,66,0,1,0,1,0
11452,28,0,0,70,70,0,1,0,1,0
11975,28,0,0,70,70,0,1,0,1,0
14373,28,0,0,70,70,0,1,0,1,0
21235,28,0,0,66,66,0,1,0,1,0
16638,28,0,0,70,70,0,1,0,1,0
21561,28,0,0,70,70,0,1,0,1,0
21410,28,0,0,70,70,0,1,0,1,0
10542,28,0,0,70,70,0,1,0,1,0
19629,28,0,0,66,66,0,1,0,1,0
16068,28,0,0,70,70,0,1,0,1,0
20173,28,0,0,70,70,0,1,0,1,0
15408,28,0,0,70,70,0,1,0,1,0
15214,28,0,0,70,70,0,1,0,1,0
21887,28,0,0,66,66,0,1,0,1,0
9335,28,0,0,70,70,0,1,0,1,0
21345,28,0,0,70,70,0,1,0,1,0
11724,28,0,0,70,70,0,1,0,1,0
9999,28,0,0,70,70,0,1,0,1,0
13193,28,0,0,70,70,0,1,0,1,0
20470,28,0,0,70,70,0,1,0,1,0
19687,28,0,0,70,70,0,1,0,1,0
22280,28,0,0,70,70,0,1,0,1,0
15787,28,0,0,70,70,0,1,0,1,0
20537,28,0,0,70,70,0,1,0,1,0
9279,28,0,0,70,70,0,1,0,1,0
9690,28,0,0,66,66,0,1,0,1,0
9656,28,0,0,70,70,0,1,0,1,0
9253,28,0,0,66,66,0,1,0,1,0
22381,28,0,0,66,66,0,1,0,1,0
16161,28,0,0,66,66,0,1,0,1,0
22348,28,0,0,70,70,0,1,0,1,0
18507,28,0,0,70,70,0,1,0,1,0
19904,28,0,0,70,70,0,1,0,1,0
19821,28,0,0,70,70,0,1,0,1,0
21908,28,0,0,66,66,0,1,0,1,0
20318,28,0,0,70,70,0,1,0,1,0
15748,28,0,0,70,70,0,1,0,1,0
14620,28,0,0,70,70,0,1,0,1,0
21754,28,0,0,70,70,0,1,0,1,0
10066,28,0,0,66,66,0,1,0,1,0
21906,28,0,0,66,66,0,1,0,1,0
15148,28,0,0,70,70,0,1,0,1,0
12258,28,0,0,70,70,0,1,0,1,0
16988,28,0,0,66,66,0,1,0,1,0
10841,28,0,0,70,70,0,1,0,1,0
21190,28,0,0,66,66,0,1,0,1,0
15035,28,0,0,66,66,0,1,0,1,0
10027,28,0,0,70,70,0,1,0,1,0
8534,28,0,0,70,70,0,1,0,1,0
12824,28,0,0,70,70,0,1,0,1,0
18367,28,0,0,70,70,0,1,0,1,0
19493,28,0,0,70,70,0,1,0,1,0
10161,28,0,0,70,70,0,1,0,1,0
19101,28,0,0,70,70,0,1,0,1,0
10910,28,0,0,70,70,0,1,0,1,0
12082,28,0,0,70,70,0,1,0,1,0
15756,28,0,0,70,70,0,1,0,1,0
10199,28,0,0,70,70,0,1,0,1,0
18202,28,0,0,70,70,0,1,0,1,0
20850,28,0,0,70,70,0,1,0,1,0
22692,28,0,0,70,70,0,1,0,1,0
19799,28,0,0,70,70,0,1,0,1,0
10271,28,0,0,70,70,0,1,0,1,0
11634,28,0,0,70,70,0,1,0,1,0
9733,28,0,0,66,66,0,1,0,1,0
12470,28,0,0,66,66,0,1,0,1,0
18564,28,0,0,66,66,0,1,0,1,0
20953,28,0,0,70,70,0,1,0,1,0
19461,28,0,0,70,70,0,1,0,1,0
9679,28,0,0,70,70,0,1,0,1,0
13306,28,0,0,66,66,0,1,0,1,0
11221,28,0,0,70,70,0,1,0,1,0
21697,28,0,0,70,70,0,1,0,1,0
14146,28,0,0,70,70,0,1,0,1,0
12318,28,0,0,70,70,0,1,0,1,0
14828,28,0,0,70,70,0,1,0,1,0
19480,28,0,0,66,66,0,1,0,1,0
9975,28,0,0,70,70,0,1,0,1,0
15112,28,0,0,70,70,0,1,0,1,0
16667,28,0,0,66,66,0,1,0,1,0
12124,28,0,0,70,70,0,1,0,1,0
11992,28,0,0,70,70,0,1,0,1,0
11640,28,0,0,70,70,0,1,0,1,0
18455,28,0,0,70,70,0,1,0,1,0
10135,28,0,0,70,70,0,1,0,1,0
10667,28,0,0,66,66,0,1,0,1,0
14659,28,0,0,70,70,0,1,0,1,0
19955,28,0,0,70,70,0,1,0,1,0
9227,28,0,0,66,66,0,1,0,1,0
9377,28,0,0,66,66,0,1,0,1,0
20756,28,0,0,70,70,0,1,0,1,0
15059,28,0,0,66,66,0,1,0,1,0
15703,28,0,0,70,70,0,1,0,1,0
15984,28,0,0,66,66,0,1,0,1,0
17904,28,0,0,66,66,0,1,0,1,0
9601,28,0,0,70,70,0,1,0,1,0
14146,28,0,0,70,70,0,1,0,1,0
18021,28,0,0,70,70,0,1,0,1,0
10888,28,0,0,70,70,0,1,0,1,0
10079,28,0,0,70,70,0,1,0,1,0
19275,28,0,0,70,70,0,1,0,1,0
10163,28,0,0,70,70,0,1,0,1,0
17977,28,0,0,70,70,0,1,0,1,0
16450,28,0,0,66,66,0,1,0,1,0
13414,28,0,0,70,70,0,1,0,1,0
18293,28,0,0,70,70,0,1,0,1,0
18289,28,0,0,66,66,0,1,0,1,0
19170,28,0,0,70,70,0,1,0,1,0
17839,28,0,0,70,70,0,1,0,1,0
11408,28,0,0,70,70,0,1,0,1,0
18853,28,0,0,70,70,0,1,0,1,0
10184,28,0,0,70,70,0,1,0,1,0
9275,28,0,0,70,70,0,1,0,1,0
13566,28,0,0,70,70,0,1,0,1,0
10715,28,0,0,66,66,0,1,0,1,0
18117,28,0,0,70,70,0,1,0,1,0
14425,28,0,0,66,66,0,1,0,1,0
11912,28,0,0,70,70,0,1,0,1,0
12058,28,0,0,66,66,0,1,0,1,0
16094,28,0,0,66,66,0,1,0,1,0
10593,28,0,0,70,70,0,1,0,1,0
8963,28,0,0,70,70,0,1,0,1,0
15121,28,0,0,70,70,0,1,0,1,0
11677,28,0,0,66,66,0,1,0,1,0
22134,28,0,0,70,70,0,1,0,1,0
19474,28,0,0,66,66,0,1,0,1,0
11438,28,0,0,70,70,0,1,0,1,0
18248,28,0,0,70,70,0,1,0,1,0
10989,28,0,0,70,70,0,1,0,1,0
18738,28,0,0,70,70,0,1,0,1,0
17774,28,0,0,70,70,0,1,0,1,0
11366,28,0,0,70,70,0,1,0,1,0
11460,28,0,0,66,66,0,1,0,1,0
20804,28,0,0,66,66,0,1,0,1,0
9376,28,0,0,66,66,0,1,0,1,0
22388,28,0,0,70,70,0,1,0,1,0
10938,28,0,0,66,66,0,1,0,1,0
17740,28,0,0,70,70,0,1,0,1,0
10310,28,0,0,70,70,0,1,0,1,0
8889,28,0,0,70,70,0,1,0,1,0
17689,28,0,0,70,70,0,1,0,1,0
10305,28,0,0,70,70,0,1,0,1,0
12282,28,0,0,66,66,0,1,0,1,0
12879,28,0,0,70,70,0,1,0,1,0
18231,28,0,0,70,70,0,1,0,1,0
21377,28,0,0,70,70,0,1,0,1,0
14979,28,0,0,70,70,0,1,0,1,0
8881,28,0,0,66,66,0,1,0,1,0
16855,28,0,0,66,66,0,1,0,1,0
17162,28,0,0,70,70,0,1,0,1,0
19314,28,0,0,66,66,0,1,0,1,0
20123,28,0,0,66,66,0,1,0,1,0
22186,28,0,0,70,70,0,1,0,1,0
20776,28,0,0,70,70,0,1,0,1,0
13545,28,0,0,70,70,0,1,0,1,0
8919,28,0,0,70,70,0,1,0,1,0
10012,28,0,0,70,70,0,1,0,1,0
22201,28,0,0,70,70,0,1,0,1,0
13116,28,0,0,66,66,0,1,0,1,0
17503,28,0,0,70,70,0,1,0,1,0
21940,28,0,0,70,70,0,1,0,1,0
21612,28,0,0,70,70,0,1,0,1,0
9058,28,0,0,66,66,0,1,0,1,0
10186,28,0,0,66,66,0,1,0,1,0
9431,28,0,0,66,66,0,1,0,1,0
19377,28,0,0,66,66,0,1,0,1,0
19038,28,0,0,66,66,0,1,0,1,0
8665,28,0,0,70,70,0,1,0,1,0
13377,28,0,0,66,66,0,1,0,1,0
17585,28,0,0,66,66,0,1,0,1,0
19070,28,0,0,70,70,0,1,0,1,0
14497,28,0,0,66,66,0,1,0,1,0
15018,28,0,0,70,70,0,1,0,1,0
10723,28,0,0,70,70,0,1,0,1,0
20582,28,0,0,70,70,0,1,0,1,0
13488,28,0,0,66,66,0,1,0,1,0
19030,28,0,0,70,70,0,1,0,1,0
20938,28,0,0,66,66,0,1,0,1,0
12422,28,0,0,70,70,0,1,0,1,0
13713,28,0,0,70,70,0,1,0,1,0
8433,28,0,0,70,70,0,1,0,1,0
16798,28,0,0,66,66,0,1,0,1,0
8653,28,0,0,66,66,0,1,0,1,0
20872,28,0,0,66,66,0,1,0,1,0
19169,28,0,0,70,70,0,1,0,1,0
19414,28,0,0,70,70,0,1,0,1,0
21705,28,0,0,70,70,0,1,0,1,0
19851,28,0,0,70,70,0,1,0,1,0
9890,28,0,0,70,70,0,1,0,1,0
10163,28,0,0,66,66,0,1,0,1,0
11368,28,0,0,70,70,0,1,0,1,0
10210,28,0,0,66,66,0,1,0,1,0
9893,28,0,0,66,66,0,1,0,1,0
17730,28,0,0,70,70,0,1,0,1,0
9284,28,0,0,70,70,0,1,0,1,0
12781,28,0,0,66,66,0,1,0,1,0
17344,28,0,0,70,70,0,1,0,1,0
17055,28,0,0,66,66,0,1,0,1,0
21421,28,0,0,70,70,0,1,0,1,0
16657,28,0,0,66,66,0,1,0,1,0
21143,28,0,0,66,66,0,1,0,1,0
16725,28,0,0,70,70,0,1,0,1,0
16782,28,0,0,66,66,0,1,0,1,0
16323,28,0,0,70,70,0,1,0,1,0
14279,28,0,0,70,70,0,1,0,1,0
17660,28,0,0,70,70,0,1,0,1,0
9224,28,0,0,70,70,0,1,0,1,0
17656,28,0,0,66,66,0,1,0,1,0
17416,28,0,0,70,70,0,1,0,1,0
12528,28,0,0,70,70,0,1,0,1,0
15757,28,0,0,70,70,0,1,0,1,0
12148,28,0,0,70,70,0,1,0,1,0
9462,28,0,0,70,70,0,1,0,1,0
19529,28,0,0,70,70,0,1,0,1,0
15157,28,0,0,70,70,0,1,0,1,0
16708,28,0,0,66,66,0,1,0,1,0
20365,28,0,0,70,70,0,1,0,1,0
15641,28,0,0,70,70,0,1,0,1,0
20939,28,0,0,70,70,0,1,0,1,0
9741,28,0,0,70,70,0,1,0,1,0
9521,28,0,0,70,70,0,1,0,1,0
8536,28,0,0,70,70,0,1,0,1,0
11441,28,0,0,70,70,0,1,0,1,0
8690,28,0,0,66,66,0,1,0,1,0
18860,28,0,0,70,70,0,1,0,1,0
17324,28,0,0,70,70,0,1,0,1,0
18415,28,0,0,70,70,0,1,0,1,0
20166,28,0,0,66,66,0,1,0,1,0
16841,28,0,0,70,70,0,1,0,1,0
11570,28,0,0,70,70,0,1,0,1,0
16731,28,0,0,70,70,0,1,0,1,0
20172,28,0,0,70,70,0,1,0,1,0
14189,28,0,0,70,70,0,1,0,1,0
11717,28,0,0,66,66,0,1,0,1,0
14648,28,0,0,66,66,0,1,0,1,0
13134,28,0,0,70,70,0,1,0,1,0
18401,28,0,0,70,70,0,1,0,1,0
11258,28,0,0,70,70,0,1,0,1,0
20680,28,0,0,66,66,0,1,0,1,0
17749,28,0,0,70,70,0,1,0,1,0
20690,28,0,0,66,66,0,1,0,1,0
8699,28,0,0,70,70,0,1,0,1,0
22100,28,0,0,70,70,0,1,0,1,0
15390,28,0,0,70,70,0,1,0,1,0
9895,28,0,0,70,70,0,1,0,1,0
21237,28,0,0,66,66,0,1,0,1,0
16152,28,0,0,66,66,0,1,0,1,0
18004,28,0,0,70,70,0,1,0,1,0
17676,28,0,0,70,70,0,1,0,1,0
9118,28,0,0,66,66,0,1,0,1,0
13862,28,0,0,70,70,0,1,0,1,0
20576,28,0,0,70,70,0,1,0,1,0
13622,28,0,0,66,66,0,1,0,1,0
22614,28,0,0,70,70,0,1,0,1,0
15409,28,0,0,70,70,0,1,0,1,0
15936,28,0,0,70,70,0,1,0,1,0
13773,28,0,0,66,66,0,1,0,1,0
8893,28,0,0,70,70,0,1,0,1,0
13260,28,0,0,66,66,0,1,0,1,0
10494,28,0,0,70,70,0,1,0,1,0
20464,28,0,0,70,70,0,1,0,1,0
18064,28,0,0,70,70,0,1,0,1,0
9494,28,0,0,66,66,0,1,0,1,0
11079,28,0,0,70,70,0,1,0,1,0
13773,28,0,0,70,70,0,1,0,1,0
10575,28,0,0,70,70,0,1,0,1,0
12928,28,0,0,70,70,0,1,0,1,0
16687,28,0,0,70,70,0,1,0,1,0
9541,28,0,0,70,70,0,1,0,1,0
20240,28,0,0,70,70,0,1,0,1,0
18145,28,0,0,66,66,0,1,0,1,0
14529,28,0,0,66,66,0,1,0,1,0
22579,28,0,0,70,70,0,1,0,1,0
15364,28,0,0,70,70,0,1,0,1,0
14468,28,0,0,70,70,0,1,0,1,0
8874,28,0,0,70,70,0,1,0,1,0
12405,28,0,0,66,66,0,1,0,1,0
17834,28,0,0,70,70,0,1,0,1,0
15167,28,0,0,70,70,0,1,0,1,0
12558,28,0,0,70,70,0,1,0,1,0
14365,28,0,0,66,66,0,1,0,1,0
13252,28,0,0,70,70,0,1,0,1,0
9572,28,0,0,70,70,0,1,0,1,0
11472,28,0,0,70,70,0,1,0,1,0
22193,28,0,0,70,70,0,1,0,1,0
9619,28,0,0,70,70,0,1,0,1,0
11356,28,0,0,70,70,0,1,0,1,0
11395,28,0,0,66,66,0,1,0,1,0
15365,28,0,0,66,66,0,1,0,1,0
14134,28,0,0,70,70,0,1,0,1,0
20799,28,0,0,70,70,0,1,0,1,0
9339,28,0,0,70,70,0,1,0,1,0
12869,28,0,0,70,70,0,1,0,1,0
11723,28,0,0,70,70,0,1,0,1,0
12441,28,0,0,70,70,0,1,0,1,0
21791,28,0,0,70,70,0,1,0,1,0
17344,28,0,0,70,70,0,1,0,1,0
19558,28,0,0,70,70,0,1,0,1,0
13977,28,0,0,66,66,0,1,0,1,0
18600,28,0,0,70,70,0,1,0,1,0
18196,28,0,0,66,66,0,1,0,1,0
10529,28,0,0,70,70,0,1,0,1,0
14762,28,0,0,70,70,0,1,0,1,0
9161,28,0,0,70,70,0,1,0,1,0
12004,28,0,0,66,66,0,1,0,1,0
22565,28,0,0,66,66,0,1,0,1,0
21122,28,0,0,66,66,0,1,0,1,0
21821,28,0,0,70,70,0,1,0,1,0
20598,28,0,0,70,70,0,1,0,1,0
16849,28,0,0,66,66,0,1,0,1,0
15284,28,0,0,66,66,0,1,0,1,0
22638,28,0,0,66,66,0,1,0,1,0
22022,28,0,0,70,70,0,1,0,1,0
12837,28,0,0,70,70,0,1,0,1,0
20208,28,0,0,70,70,0,1,0,1,0
15320,28,0,0,66,66,0,1,0,1,0
15879,28,0,0,70,70,0,1,0,1,0
22270,28,0,0,70,70,0,1,0,1,0
15534,28,0,0,66,66,0,1,0,1,0
16857,28,0,0,70,70,0,1,0,1,0
15914,28,0,0,70,70,0,1,0,1,0
17386,28,0,0,66,66,0,1,0,1,0
18952,28,0,0,70,70,0,1,0,1,0
13658,28,0,0,70,70,0,1,0,1,0
9803,28,0,0,66,66,0,1,0,1,0
19427,28,0,0,70,70,0,1,0,1,0
19795,28,0,0,66,66,0,1,0,1,0
16278,28,0,0,66,66,0,1,0,1,0
19403,28,0,0,66,66,0,1,0,1,0
17121,28,0,0,70,70,0,1,0,1,0
21162,28,0,0,66,66,0,1,0,1,0
9038,28,0,0,70,70,0,1,0,1,0
11420,28,0,0,70,70,0,1,0,1,0
21226,28,0,0,70,70,0,1,0,1,0
10704,28,0,0,70,70,0,1,0,1,0
9988,28,0,0,66,66,0,1,0,1,0
11463,28,0,0,70,70,0,1,0,1,0
9269,28,0,0,70,70,0,1,0,1,0
18900,28,0,0,66,66,0,1,0,1,0
18502,28,0,0,66,66,0,1,0,1,0
8973,28,0,0,70,70,0,1,0,1,0
18378,28,0,0,70,70,0,1,0,1,0
15557,28,0,0,70,70,0,1,0,1,0
13307,28,0,0,70,70,0,1,0,1,0
13421,28,0,0,70,70,0,1,0,1,0
9984,28,0,0,66,66,0,1,0,1,0
11825,28,0,0,66,66,0,1,0,1,0
12197,28,0,0,70,70,0,1,0,1,0
12529,28,0,0,70,70,0,1,0,1,0
8349,28,0,0,66,66,0,1,0,1,0
14361,28,0,0,66,66,0,1,0,1,0
12929,28,0,0,70,70,0,1,0,1,0
20940,28,0,0,70,70,0,1,0,1,0
18983,28,0,0,66,66,0,1,0,1,0
8771,28,0,0,70,70,0,1,0,1,0
17445,28,0,0,70,70,0,1,0,1,0
13869,28,0,0,66,66,0,1,0,1,0
19384,28,0,0,66,66,0,1,0,1,0
11957,28,0,0,70,70,0,1,0,1,0
21840,28,0,0,70,70,0,1,0,1,0
13168,28,0,0,70,70,0,1,0,1,0
20005,28,0,0,70,70,0,1,0,1,0
17470,28,0,0,70,70,0,1,0,1,0
17661,28,0,0,70,70,0,1,0,1,0
16054,28,0,0,70,70,0,1,0,1,0
14905,28,0,0,66,66,0,1,0,1,0
9817,28,0,0,66,66,0,1,0,1,0
16340,28,0,0,70,70,0,1,0,1,0
15851,28,0,0,70,70,0,1,0,1,0
9665,28,0,0,70,70,0,1,0,1,0
16758,28,0,0,70,70,0,1,0,1,0
21186,28,0,0,66,66,0,1,0,1,0
10535,28,0,0,70,70,0,1,0,1,0
17583,28,0,0,70,70,0,1,0,1,0
19690,28,0,0,70,70,0,1,0,1,0
16593,28,0,0,66,66,0,1,0,1,0
9071,28,0,0,70,70,0,1,0,1,0
21072,28,0,0,66,66,0,1,0,1,0
9619,28,0,0,66,66,0,1,0,1,0
11250,28,0,0,70,70,0,1,0,1,0
10059,28,0,0,66,66,0,1,0,1,0
21307,28,0,0,70,70,0,1,0,1,0
21080,28,0,0,70,70,0,1,0,1,0
11169,28,0,0,66,66,0,1,0,1,0
13272,28,0,0,66,66,0,1,0,1,0
17126,28,0,0,66,66,0,1,0,1,0
22138,28,0,0,70,70,0,1,0,1,0
17084,28,0,0,66,66,0,1,0,1,0
9939,28,0,0,66,66,0,1,0,1,0
10106,28,0,0,66,66,0,1,0,1,0
12829,28,0,0,70,70,0,1,0,1,0
11882,28,0,0,70,70,0,1,0,1,0
16447,28,0,0,70,70,0,1,0,1,0
16898,28,0,0,70,70,0,1,0,1,0
16767,28,0,0,70,70,0,1,0,1,0
10742,28,0,0,70,70,0,1,0,1,0
12505,28,0,0,70,70,0,1,0,1,0
9672,28,0,0,70,70,0,1,0,1,0
19860,28,0,0,66,66,0,1,0,1,0
20696,28,0,0,70,70,0,1,0,1,0
8788,28,0,0,66,66,0,1,0,1,0
10564,28,0,0,66,66,0,1,0,1,0
16423,28,0,0,70,70,0,1,0,1,0
12604,28,0,0,70,70,0,1,0,1,0
15057,28,0,0,66,66,0,1,0,1,0
14489,28,0,0,70,70,0,1,0,1,0
10512,28,0,0,70,70,0,1,0,1,0
21637,28,0,0,70,70,0,1,0,1,0
16759,28,0,0,66,66,0,1,0,1,0
18487,28,0,0,70,70,0,1,0,1,0
13435,28,0,0,66,66,0,1,0,1,0
19839,28,0,0,70,70,0,1,0,1,0
9533,28,0,0,70,70,0,1,0,1,0
18227,28,0,0,70,70,0,1,0,1,0
11304,28,0,0,66,66,0,1,0,1,0
10961,28,0,0,70,70,0,1,0,1,0
10177,28,0,0,66,66,0,1,0,1,0
19374,28,0,0,70,70,0,1,0,1,0
9135,28,0,0,66,66,0,1,0,1,0
20527,28,0,0,66,66,0,1,0,1,0
20199,28,0,0,70,70,0,1,0,1,0
10701,28,0,0,70,70,0,1,0,1,0
10404,28,0,0,70,70,0,1,0,1,0
21506,28,0,0,70,70,0,1,0,1,0
21845,28,0,0,70,70,0,1,0,1,0
18698,28,0,0,70,70,0,1,0,1,0
16786,28,0,0,70,70,0,1,0,1,0
12705,28,0,0,66,66,0,1,0,1,0
21261,28,0,0,70,70,0,1,0,1,0
15132,28,0,0,70,70,0,1,0,1,0
20490,28,0,0,70,70,0,1,0,1,0
19071,28,0,0,66,66,0,1,0,1,0
17201,28,0,0,70,70,0,1,0,1,0
20856,28,0,0,70,70,0,1,0,1,0
11791,28,0,0,70,70,0,1,0,1,0
9473,28,0,0,70,70,0,1,0,1,0
8436,28,0,0,70,70,0,1,0,1,0
18831,28,0,0,70,70,0,1,0,1,0
9689,28,0,0,66,66,0,1,0,1,0
13201,28,0,0,66,66,0,1,0,1,0
9940,28,0,0,66,66,0,1,0,1,0
14611,28,0,0,66,66,0,1,0,1,0
14674,28,0,0,70,70,0,1,0,1,0
18014,28,0,0,70,70,0,1,0,1,0
16391,28,0,0,66,66,0,1,0,1,0
21933,28,0,0,70,70,0,1,0,1,0
20928,28,0,0,70,70,0,1,0,1,0
15907,28,0,0,66,66,0,1,0,1,0
14106,28,0,0,66,66,0,1,0,1,0
12985,28,0,0,70,70,0,1,0,1,0
19670,28,0,0,66,66,0,1,0,1,0
9496,28,0,0,66,66,0,1,0,1,0
11832,28,0,0,66,66,0,1,0,1,0
16616,28,0,0,70,70,0,1,0,1,0
20716,28,0,0,70,70,0,1,0,1,0
10519,28,0,0,70,70,0,1,0,1,0
9674,28,0,0,70,70,0,1,0,1,0
12219,28,0,0,70,70,0,1,0,1,0
15692,28,0,0,70,70,0,1,0,1,0
16805,28,0,0,70,70,0,1,0,1,0
14353,28,0,0,70,70,0,1,0,1,0
10396,28,0,0,66,66,0,1,0,1,0
20814,28,0,0,66,66,0,1,0,1,0
18643,28,0,0,66,66,0,1,0,1,0
15775,28,0,0,70,70,0,1,0,1,0
19169,28,0,0,66,66,0,1,0,1,0
20121,28,0,0,66,66,0,1,0,1,0
16158,28,0,0,70,70,0,1,0,1,0
9440,28,0,0,70,70,0,1,0,1,0
19180,28,0,0,70,70,0,1,0,1,0
20959,28,0,0,66,66,0,1,0,1,0
22140,28,0,0,70,70,0,1,0,1,0
19122,28,0,0,70,70,0,1,0,1,0
10098,28,0,0,70,70,0,1,0,1,0
9833,28,0,0,66,66,0,1,0,1,0
19359,28,0,0,66,66,0,1,0,1,0
8540,28,0,0,70,70,0,1,0,1,0
22035,28,0,0,70,70,0,1,0,1,0
18980,28,0,0,70,70,0,1,0,1,0
11699,28,0,0,66,66,0,1,0,1,0
20815,28,0,0,70,70,0,1,0,1,0
17839,28,0,0,66,66,0,1,0,1,0
14197,28,0,0,70,70,0,1,0,1,0
9566,28,0,0,66,66,0,1,0,1,0
20995,28,0,0,70,70,0,1,0,1,0
21912,28,0,0,70,70,0,1,0,1,0
15782,28,0,0,66,66,0,1,0,1,0
17259,28,0,0,70,70,0,1,0,1,0
8446,28,0,0,70,70,0,1,0,1,0
14093,28,0,0,70,70,0,1,0,1,0
16117,28,0,0,70,70,0,1,0,1,0
9343,28,0,0,70,70,0,1,0,1,0
14429,28,0,0,70,70,0,1,0,1,0
16857,28,0,0,66,66,0,1,0,1,0
21161,28,0,0,70,70,0,1,0,1,0
17374,28,0,0,66,66,0,1,0,1,0
18598,28,0,0,70,70,0,1,0,1,0
9849,28,0,0,70,70,0,1,0,1,0
20500,28,0,0,70,70,0,1,0,1,0
17654,28,0,0,66,66,0,1,0,1,0
9253,28,0,0,70,70,0,1,0,1,0
9947,28,0,0,66,66,0,1,0,1,0
14046,28,0,0,70,70,0,1,0,1,0
20027,28,0,0,70,70,0,1,0,1,0
15973,28,0,0,70,70,0,1,0,1,0
13493,28,0,0,66,66,0,1,0,1,0
9914,28,0,0,70,70,0,1,0,1,0
13696,28,0,0,70,70,0,1,0,1,0
17168,28,0,0,66,66,0,1,0,1,0
19046,28,0,0,70,70,0,1,0,1,0
21143,28,0,0,70,70,0,1,0,1,0
20511,28,0,0,70,70,0,1,0,1,0
20050,28,0,0,70,70,0,1,0,1,0
9105,28,0,0,70,70,0,1,0,1,0
11559,28,0,0,66,66,0,1,0,1,0
12864,28,0,0,70,70,0,1,0,1,0
9184,28,0,0,70,70,0,1,0,1,0
18480,28,0,0,66,66,0,1,0,1,0
10891,28,0,0,70,70,0,1,0,1,0
20659,28,0,0,70,70,0,1,0,1,0
10234,28,0,0,70,70,0,1,0,1,0
15695,28,0,0,70,70,0,1,0,1,0
19473,28,0,0,70,70,0,1,0,1,0
21953,28,0,0,66,66,0,1,0,1,0
16335,28,0,0,70,70,0,1,0,1,0
12695,28,0,0,70,70,0,1,0,1,0
14463,28,0,0,70,70,0,1,0,1,0
9307,28,0,0,70,70,0,1,0,1,0
11104,28,0,0,70,70,0,1,0,1,0
11327,28,0,0,70,70,0,1,0,1,0
12103,28,0,0,70,70,0,1,0,1,0
10199,28,0,0,66,66,0,1,0,1,0
12985,28,0,0,70,70,0,1,0,1,0
18777,28,0,0,70,70,0,1,0,1,0
10389,28,0,0,70,70,0,1,0,1,0
15815,28,0,0,66,66,0,1,0,1,0
16790,28,0,0,70,70,0,1,0,1,0
20157,28,0,0,70,70,0,1,0,1,0
16296,28,0,0,66,66,0,1,0,1,0
14796,28,0,0,70,70,0,1,0,1,0
13199,28,0,0,70,70,0,1,0,1,0
21093,28,0,0,70,70,0,1,0,1,0
18482,28,0,0,70,70,0,1,0,1,0
16688,28,0,0,70,70,0,1,0,1,0
10205,28,0,0,70,70,0,1,0,1,0
14746,28,0,0,70,70,0,1,0,1,0
13558,28,0,0,70,70,0,1,0,1,0
13344,28,0,0,66,66,0,1,0,1,0
20747,28,0,0,70,70,0,1,0,1,0
18143,28,0,0,66,66,0,1,0,1,0
15247,28,0,0,70,70,0,1,0,1,0
15882,28,0,0,70,70,0,1,0,1,0
19769,28,0,0,70,70,0,1,0,1,0
15553,28,0,0,66,66,0,1,0,1,0
15281,28,0,0,70,70,0,1,0,1,0
18615,28,0,0,70,70,0,1,0,1,0
12585,28,0,0,70,70,0,1,0,1,0
14625,28,0,0,66,66,0,1,0,1,0
9994,28,0,0,70,70,0,1,0,1,0
17338,28,0,0,70,70,0,1,0,1,0
20717,28,0,0,70,70,0,1,0,1,0
10927,28,0,0,66,66,0,1,0,1,0
11448,28,0,0,70,70,0,1,0,1,0
16337,28,0,0,70,70,0,1,0,1,0
17549,28,0,0,66,66,0,1,0,1,0
21638,28,0,0,70,70,0,1,0,1,0
16433,28,0,0,66,66,0,1,0,1,0
14253,28,0,0,66,66,0,1,0,1,0
19140,28,0,0,70,70,0,1,0,1,0
19196,28,0,0,70,70,0,1,0,1,0
10049,28,0,0,70,70,0,1,0,1,0
11517,28,0,0,66,66,0,1,0,1,0
21559,28,0,0,66,66,0,1,0,1,0
15537,28,0,0,70,70,0,1,0,1,0
12555,28,0,0,70,70,0,1,0,1,0
18689,28,0,0,70,70,0,1,0,1,0
16479,28,0,0,70,70,0,1,0,1,0
16658,28,0,0,66,66,0,1,0,1,0
18670,28,0,0,70,70,0,1,0,1,0
19006,28,0,0,70,70,0,1,0,1,0
11090,28,0,0,70,70,0,1,0,1,0
13684,28,0,0,70,70,0,1,0,1,0
13517,28,0,0,70,70,0,1,0,1,0
9730,28,0,0,70,70,0,1,0,1,0
19176,28,0,0,70,70,0,1,0,1,0
22285,28,0,0,70,70,0,1,0,1,0
21607,28,0,0,66,66,0,1,0,1,0
14809,28,0,0,70,70,0,1,0,1,0
20794,28,0,0,70,70,0,1,0,1,0
13941,28,0,0,70,70,0,1,0,1,0
20462,28,0,0,70,70,0,1,0,1,0
16625,28,0,0,70,70,0,1,0,1,0
17998,28,0,0,70,70,0,1,0,1,0
15081,28,0,0,66,66,0,1,0,1,0
18590,28,0,0,70,70,0,1,0,1,0
10656,28,0,0,70,70,0,1,0,1,0
10499,28,0,0,70,70,0,1,0,1,0
13482,28,0,0,70,70,0,1,0,1,0
13818,28,0,0,70,70,0,1,0,1,0
18203,28,0,0,70,70,0,1,0,1,0
20071,28,0,0,70,70,0,1,0,1,0
11506,28,0,0,66,66,0,1,0,1,0
22528,28,0,0,66,66,0,1,0,1,0
13604,28,0,0,70,70,0,1,0,1,0
21888,28,0,0,66,66,0,1,0,1,0
19706,28,0,0,70,70,0,1,0,1,0
16219,28,0,0,70,70,0,1,0,1,0
21701,28,0,0,70,70,0,1,0,1,0
8956,28,0,0,66,66,0,1,0,1,0
18870,28,0,0,70,70,0,1,0,1,0
22557,28,0,0,70,70,0,1,0,1,0
9882,28,0,0,66,66,0,1,0,1,0
17461,28,0,0,70,70,0,1,0,1,0
10968,28,0,0,70,70,0,1,0,1,0
10293,28,0,0,66,66,0,1,0,1,0
10168,28,0,0,70,70,0,1,0,1,0
19132,28,0,0,70,70,0,1,0,1,0
20375,28,0,0,70,70,0,1,0,1,0
16730,28,0,0,70,70,0,1,0,1,0
10171,28,0,0,66,66,0,1,0,1,0
20721,28,0,0,70,70,0,1,0,1,0
21916,28,0,0,66,66,0,1,0,1,0
9881,28,0,0,70,70,0,1,0,1,0
10099,28,0,0,70,70,0,1,0,1,0
17777,28,0,0,70,70,0,1,0,1,0
13642,28,0,0,66,66,0,1,0,1,0
16539,28,0,0,70,70,0,1,0,1,0
20331,28,0,0,66,66,0,1,0,1,0
10726,28,0,0,70,70,0,1,0,1,0
21860,28,0,0,66,66,0,1,0,1,0
11071,28,0,0,66,66,0,1,0,1,0
15656,28,0,0,70,70,0,1,0,1,0
16514,28,0,0,70,70,0,1,0,1,0
22548,28,0,0,70,70,0,1,0,1,0
12054,28,0,0,70,70,0,1,0,1,0
13379,28,0,0,66,66,0,1,0,1,0
12567,28,0,0,70,70,0,1,0,1,0
13034,28,0,0,70,70,0,1,0,1,0
15123,28,0,0,70,70,0,1,0,1,0
12266,28,0,0,70,70,0,1,0,1,0
10222,28,0,0,70,70,0,1,0,1,0
17376,28,0,0,70,70,0,1,0,1,0
21821,28,0,0,70,70,0,1,0,1,0
15610,28,0,0,70,70,0,1,0,1,0
20732,28,0,0,70,70,0,1,0,1,0
11465,28,0,0,66,66,0,1,0,1,0
19560,28,0,0,70,70,0,1,0,1,0
22151,28,0,0,70,70,0,1,0,1,0
14100,28,0,0,70,70,0,1,0,1,0
9274,28,0,0,70,70,0,1,0,1,0
9779,28,0,0,70,70,0,1,0,1,0
9629,28,0,0,66,66,0,1,0,1,0
13566,28,0,0,66,66,0,1,0,1,0
17456,28,0,0,66,66,0,1,0,1,0
13312,28,0,0,70,70,0,1,0,1,0
20356,28,0,0,70,70,0,1,0,1,0
18920,28,0,0,70,70,0,1,0,1,0
21350,28,0,0,70,70,0,1,0,1,0
9106,28,0,0,70,70,0,1,0,1,0
20812,28,0,0,70,70,0,1,0,1,0
15599,28,0,0,70,70,0,1,0,1,0
9187,28,0,0,66,66,0,1,0,1,0
9548,28,0,0,70,70,0,1,0,1,0
13004,28,0,0,70,70,0,1,0,1,0
12839,28,0,0,66,66,0,1,0,1,0
22012,28,0,0,66,66,0,1,0,1,0
21435,28,0,0,66,66,0,1,0,1,0
12843,28,0,0,66,66,0,1,0,1,0
12335,28,0,0,70,70,0,1,0,1,0
18057,28,0,0,66,66,0,1,0,1,0
16495,28,0,0,70,70,0,1,0,1,0
22362,28,0,0,70,70,0,1,0,1,0
15216,28,0,0,66,66,0,1,0,1,0
9225,28,0,0,70,70,0,1,0,1,0
9420,28,0,0,70,70,0,1,0,1,0
13329,28,0,0,70,70,0,1,0,1,0
20376,28,0,0,66,66,0,1,0,1,0
19498,28,0,0,66,66,0,1,0,1,0
18644,28,0,0,70,70,0,1,0,1,0
15128,28,0,0,70,70,0,1,0,1,0
11487,28,0,0,70,70,0,1,0,1,0
17552,28,0,0,66,66,0,1,0,1,0
15473,28,0,0,70,70,0,1,0,1,0
8947,28,0,0,70,70,0,1,0,1,0
18566,28,0,0,66,66,0,1,0,1,0
20161,28,0,0,70,70,0,1,0,1,0
10391,28,0,0,70,70,0,1,0,1,0
14273,28,0,0,70,70,0,1,0,1,0
12859,28,0,0,70,70,0,1,0,1,0
22266,28,0,0,70,70,0,1,0,1,0
9631,28,0,0,70,70,0,1,0,1,0
14790,28,0,0,70,70,0,1,0,1,0
19425,28,0,0,66,66,0,1,0,1,0
20138,28,0,0,70,70,0,1,0,1,0
21168,28,0,0,70,70,0,1,0,1,0
8546,28,0,0,66,66,0,1,0,1,0
15394,28,0,0,66,66,0,1,0,1,0
16135,28,0,0,66,66,0,1,0,1,0
11883,28,0,0,70,70,0,1,0,1,0
9576,28,0,0,66,66,0,1,0,1,0
12512,28,0,0,70,70,0,1,0,1,0
8799,28,0,0,70,70,0,1,0,1,0
21725,28,0,0,70,70,0,1,0,1,0
17526,28,0,0,66,66,0,1,0,1,0
20463,28,0,0,66,66,0,1,0,1,0
9622,28,0,0,70,70,0,1,0,1,0
19526,28,0,0,70,70,0,1,0,1,0
12505,28,0,0,70,70,0,1,0,1,0
9995,28,0,0,66,66,0,1,0,1,0
19579,28,0,0,70,70,0,1,0,1,0
19015,28,0,0,70,70,0,1,0,1,0
16840,28,0,0,70,70,0,1,0,1,0
13331,28,0,0,70,70,0,1,0,1,0
16956,28,0,0,70,70,0,1,0,1,0
8628,28,0,0,66,66,0,1,0,1,0
11556,28,0,0,70,70,0,1,0,1,0
19243,28,0,0,66,66,0,1,0,1,0
10172,28,0,0,70,70,0,1,0,1,0
9610,28,0,0,66,66,0,1,0,1,0
8614,28,0,0,70,70,0,1,0,1,0
19442,28,0,0,70,70,0,1,0,1,0
16294,28,0,0,70,70,0,1,0,1,0
10948,28,0,0,70,70,0,1,0,1,0
9865,28,0,0,70,70,0,1,0,1,0
17597,28,0,0,66,66,0,1,0,1,0
14340,28,0,0,70,70,0,1,0,1,0
10912,28,0,0,70,70,0,1,0,1,0
19144,28,0,0,70,70,0,1,0,1,0
22676,28,0,0,70,70,0,1,0,1,0
9818,28,0,0,66,66,0,1,0,1,0
17978,28,0,0,70,70,0,1,0,1,0
18226,28,0,0,70,70,0,1,0,1,0
20544,28,0,0,70,70,0,1,0,1,0
17404,28,0,0,66,66,0,1,0,1,0
10537,28,0,0,70,70,0,1,0,1,0
18872,28,0,0,70,70,0,1,0,1,0
20015,28,0,0,70,70,0,1,0,1,0
9864,28,0,0,66,66,0,1,0,1,0
17520,28,0,0,66,66,0,1,0,1,0
12659,28,0,0,70,70,0,1,0,1,0
11432,28,0,0,70,70,0,1,0,1,0
9098,28,0,0,70,70,0,1,0,1,0
19367,28,0,0,66,66,0,1,0,1,0
14396,28,0,0,66,66,0,1,0,1,0
22350,28,0,0,70,70,0,1,0,1,0
13944,28,0,0,70,70,0,1,0,1,0
19679,28,0,0,66,66,0,1,0,1,0
11389,28,0,0,70,70,0,1,0,1,0
10943,28,0,0,70,70,0,1,0,1,0
18807,28,0,0,70,70,0,1,0,1,0
17077,28,0,0,70,70,0,1,0,1,0
22463,28,0,0,70,70,0,1,0,1,0
22445,28,0,0,70,70,0,1,0,1,0
17159,28,0,0,70,70,0,1,0,1,0
21783,28,0,0,66,66,0,1,0,1,0
11102,28,0,0,66,66,0,1,0,1,0
16224,28,0,0,70,70,0,1,0,1,0
8919,28,0,0,70,70,0,1,0,1,0
11685,28,0,0,70,70,0,1,0,1,0
14037,28,0,0,66,66,0,1,0,1,0
20990,28,0,0,70,70,0,1,0,1,0
13771,28,0,0,70,70,0,1,0,1,0
12351,28,0,0,70,70,0,1,0,1,0
8701,28,0,0,66,66,0,1,0,1,0
11147,28,0,0,70,70,0,1,0,1,0
13544,28,0,0,70,70,0,1,0,1,0
14120,28,0,0,66,66,0,1,0,1,0
19330,28,0,0,70,70,0,1,0,1,0
9863,28,0,0,70,70,0,1,0,1,0
11317,28,0,0,70,70,0,1,0,1,0
17249,28,0,0,70,70,0,1,0,1,0
16869,28,0,0,66,66,0,1,0,1,0
20476,28,0,0,70,70,0,1,0,1,0
10012,28,0,0,70,70,0,1,0,1,0
18699,28,0,0,70,70,0,1,0,1,0
9375,28,0,0,66,66,0,1,0,1,0
11150,28,0,0,70,70,0,1,0,1,0
14613,28,0,0,70,70,0,1,0,1,0
10803,28,0,0,66,66,0,1,0,1,0
13486,28,0,0,70,70,0,1,0,1,0
16000,28,0,0,70,70,0,1,0,1,0
12803,28,0,0,70,70,0,1,0,1,0
14221,28,0,0,70,70,0,1,0,1,0
13142,28,0,0,70,70,0,1,0,1,0
20885,28,0,0,70,70,0,1,0,1,0
14309,28,0,0,66,66,0,1,0,1,0
12335,28,0,0,70,70,0,1,0,1,0
8851,28,0,0,70,70,0,1,0,1,0
11686,28,0,0,70,70,0,1,0,1,0
8530,28,0,0,70,70,0,1,0,1,0
12270,28,0,0,70,70,0,1,0,1,0
18724,28,0,0,70,70,0,1,0,1,0
10031,28,0,0,70,70,0,1,0,1,0
8562,28,0,0,66,66,0,1,0,1,0
20335,28,0,0,70,70,0,1,0,1,0
13416,28,0,0,70,70,0,1,0,1,0
19586,28,0,0,70,70,0,1,0,1,0
10025,28,0,0,70,70,0,1,0,1,0
12479,28,0,0,70,70,0,1,0,1,0
8617,28,0,0,70,70,0,1,0,1,0
9918,28,0,0,70,70,0,1,0,1,0
12819,28,0,0,70,70,0,1,0,1,0
21943,28,0,0,70,70,0,1,0,1,0
9559,28,0,0,66,66,0,1,0,1,0
14052,28,0,0,70,70,0,1,0,1,0
12147,28,0,0,66,66,0,1,0,1,0
21857,28,0,0,66,66,0,1,0,1,0
20328,28,0,0,66,66,0,1,0,1,0
20807,28,0,0,70,70,0,1,0,1,0
11474,28,0,0,66,66,0,1,0,1,0
9666,28,0,0,70,70,0,1,0,1,0
13545,28,0,0,70,70,0,1,0,1,0
22700,28,0,0,70,70,0,1,0,1,0
10521,28,0,0,70,70,0,1,0,1,0
13165,28,0,0,70,70,0,1,0,1,0
22091,28,0,0,66,66,0,1,0,1,0
10109,28,0,0,70,70,0,1,0,1,0
21076,28,0,0,66,66,0,1,0,1,0
14342,28,0,0,70,70,0,1,0,1,0
19238,28,0,0,70,70,0,1,0,1,0
21142,28,0,0,70,70,0,1,0,1,0
21268,28,0,0,66,66,0,1,0,1,0
14211,28,0,0,66,66,0,1,0,1,0
20988,28,0,0,70,70,0,1,0,1,0
9796,28,0,0,70,70,0,1,0,1,0
12984,28,0,0,66,66,0,1,0,1,0
17603,28,0,0,70,70,0,1,0,1,0
9125,28,0,0,70,70,0,1,0,1,0
8920,28,0,0,70,70,0,1,0,1,0
8674,28,0,0,66,66,0,1,0,1,0
17439,28,0,0,70,70,0,1,0,1,0
19103,28,0,0,70,70,0,1,0,1,0
10554,28,0,0,66,66,0,1,0,1,0
20195,28,0,0,66,66,0,1,0,1,0
15900,28,0,0,70,70,0,1,0,1,0
9640,28,0,0,70,70,0,1,0,1,0
12930,28,0,0,70,70,0,1,0,1,0
19877,28,0,0,66,66,0,1,0,1,0
19613,28,0,0,66,66,0,1,0,1,0
18614,28,0,0,70,70,0,1,0,1,0
16878,28,0,0,70,70,0,1,0,1,0
11839,28,0,0,70,70,0,1,0,1,0
18995,28,0,0,66,66,0,1,0,1,0
15330,28,0,0,70,70,0,1,0,1,0
17308,28,0,0,70,70,0,1,0,1,0
18251,28,0,0,70,70,0,1,0,1,0
20901,28,0,0,70,70,0,1,0,1,0
18791,28,0,0,66,66,0,1,0,1,0
17938,28,0,0,70,70,0,1,0,1,0
17797,28,0,0,66,66,0,1,0,1,0
17794,28,0,0,70,70,0,1,0,1,0
15664,28,0,0,66,66,0,1,0,1,0
10438,28,0,0,70,70,0,1,0,1,0
17307,28,0,0,66,66,0,1,0,1,0
21590,28,0,0,70,70,0,1,0,1,0
17213,28,0,0,66,66,0,1,0,1,0
19115,28,0,0,70,70,0,1,0,1,0
15687,28,0,0,70,70,0,1,0,1,0
18820,28,0,0,70,70,0,1,0,1,0
11580,28,0,0,70,70,0,1,0,1,0
18093,28,0,0,70,70,0,1,0,1,0
18322,28,0,0,66,66,0,1,0,1,0
21059,28,0,0,66,66,0,1,0,1,0
9869,28,0,0,70,70,0,1,0,1,0
21880,28,0,0,70,70,0,1,0,1,0
13080,28,0,0,70,70,0,1,0,1,0
13117,28,0,0,70,70,0,1,0,1,0
19551,28,0,0,70,70,0,1,0,1,0
17550,28,0,0,66,66,0,1,0,1,0
12016,28,0,0,70,70,0,1,0,1,0
14196,28,0,0,66,66,0,1,0,1,0
17560,28,0,0,70,70,0,1,0,1,0
9957,28,0,0,70,70,0,1,0,1,0
20049,28,0,0,70,70,0,1,0,1,0
18083,28,0,0,70,70,0,1,0,1,0
15599,28,0,0,66,66,0,1,0,1,0
14293,28,0,0,70,70,0,1,0,1,0
12101,28,0,0,70,70,0,1,0,1,0
16807,28,0,0,70,70,0,1,0,1,0
14287,28,0,0,70,70,0,1,0,1,0
17592,28,0,0,70,70,0,1,0,1,0
9878,28,0,0,66,66,0,1,0,1,0
9296,28,0,0,70,70,0,1,0,1,0
15089,28,0,0,66,66,0,1,0,1,0
10992,28,0,0,66,66,0,1,0,1,0
21247,28,0,0,66,66,0,1,0,1,0
17525,28,0,0,66,66,0,1,0,1,0
19450,28,0,0,70,70,0,1,0,1,0
11750,28,0,0,70,70,0,1,0,1,0
20460,28,0,0,70,70,0,1,0,1,0
19064,28,0,0,66,66,0,1,0,1,0
9281,28,0,0,66,66,0,1,0,1,0
18509,28,0,0,66,66,0,1,0,1,0
12046,28,0,0,70,70,0,1,0,1,0
15160,28,0,0,70,70,0,1,0,1,0
8744,28,0,0,70,70,0,1,0,1,0
22337,28,0,0,70,70,0,1,0,1,0
17885,28,0,0,70,70,0,1,0,1,0
9884,28,0,0,66,66,0,1,0,1,0
20178,28,0,0,66,66,0,1,0,1,0
16955,28,0,0,70,70,0,1,0,1,0
17995,28,0,0,70,70,0,1,0,1,0
8616,28,0,0,70,70,0,1,0,1,0
8926,28,0,0,70,70,0,1,0,1,0
12280,28,0,0,66,66,0,1,0,1,0
18713,28,0,0,70,70,0,1,0,1,0
20865,28,0,0,70,70,0,1,0,1,0
20080,28,0,0,66,66,0,1,0,1,0
14585,28,0,0,70,70,0,1,0,1,0
20524,28,0,0,66,66,0,1,0,1,0
14242,28,0,0,66,66,0,1,0,1,0
16921,28,0,0,66,66,0,1,0,1,0
18758,28,0,0,70,70,0,1,0,1,0
20237,28,0,0,70,70,0,1,0,1,0
22104,28,0,0,70,70,0,1,0,1,0
9030,28,0,0,70,70,0,1,0,1,0
11657,28,0,0,70,70,0,1,0,1,0
14270,28,0,0,70,70,0,1,0,1,0
22142,28,0,0,70,70,0,1,0,1,0
14687,28,0,0,70,70,0,1,0,1,0
19953,28,0,0,70,70,0,1,0,1,0
21376,28,0,0,70,70,0,1,0,1,0
17551,28,0,0,70,70,0,1,0,1,0
13278,28,0,0,70,70,0,1,0,1,0
10311,28,0,0,70,70,0,1,0,1,0
19342,28,0,0,66,66,0,1,0,1,0
14104,28,0,0,70,70,0,1,0,1,0
10552,28,0,0,70,70,0,1,0,1,0
19192,28,0,0,70,70,0,1,0,1,0
21674,28,0,0,70,70,0,1,0,1,0
11122,28,0,0,66,66,0,1,0,1,0
21189,28,0,0,66,66,0,1,0,1,0
19309,28,0,0,70,70,0,1,0,1,0
13168,28,0,0,66,66,0,1,0,1,0
13505,28,0,0,70,70,0,1,0,1,0
17330,28,0,0,66,66,0,1,0,1,0
16280,28,0,0,66,66,0,1,0,1,0
14485,28,0,0,70,70,0,1,0,1,0
21283,28,0,0,70,70,0,1,0,1,0
17188,28,0,0,70,70,0,1,0,1,0
9710,28,0,0,70,70,0,1,0,1,0
14427,28,0,0,70,70,0,1,0,1,0
21467,28,0,0,70,70,0,1,0,1,0
22360,28,0,0,70,70,0,1,0,1,0
22169,28,0,0,70,70,0,1,0,1,0
9028,28,0,0,70,70,0,1,0,1,0
15793,28,0,0,70,70,0,1,0,1,0
15026,28,0,0,70,70,0,1,0,1,0
19479,28,0,0,70,70,0,1,0,1,0
18287,28,0,0,70,70,0,1,0,1,0
19484,28,0,0,70,70,0,1,0,1,0
18200,28,0,0,70,70,0,1,0,1,0
12536,28,0,0,66,66,0,1,0,1,0
18205,28,0,0,70,70,0,1,0,1,0
15602,28,0,0,70,70,0,1,0,1,0
20489,28,0,0,70,70,0,1,0,1,0
18279,28,0,0,66,66,0,1,0,1,0
9957,28,0,0,66,66,0,1,0,1,0
21019,28,0,0,70,70,0,1,0,1,0
21188,28,0,0,70,70,0,1,0,1,0
18643,28,0,0,70,70,0,1,0,1,0
19916,28,0,0,70,70,0,1,0,1,0
9674,28,0,0,70,70,0,1,0,1,0
12201,28,0,0,66,66,0,1,0,1,0
12331,28,0,0,66,66,0,1,0,1,0
9874,28,0,0,66,66,0,1,0,1,0
18240,28,0,0,66,66,0,1,0,1,0
20047,28,0,0,66,66,0,1,0,1,0
19297,28,0,0,70,70,0,1,0,1,0
10343,28,0,0,66,66,0,1,0,1,0
15159,28,0,0,70,70,0,1,0,1,0
18486,28,0,0,70,70,0,1,0,1,0
17955,28,0,0,70,70,0,1,0,1,0
13523,28,0,0,70,70,0,1,0,1,0
14109,28,0,0,66,66,0,1,0,1,0
8657,28,0,0,70,70,0,1,0,1,0
15487,28,0,0,66,66,0,1,0,1,0
20545,28,0,0,66,66,0,1,0,1,0
11759,28,0,0,66,66,0,1,0,1,0
16616,28,0,0,66,66,0,1,0,1,0
22445,28,0,0,70,70,0,1,0,1,0
11591,28,0,0,70,70,0,1,0,1,0
9046,28,0,0,70,70,0,1,0,1,0
21100,28,0,0,66,66,0,1,0,1,0
16615,28,0,0,70,70,0,1,0,1,0
21907,28,0,0,66,66,0,1,0,1,0
22365,28,0,0,70,70,0,1,0,1,0
13909,28,0,0,70,70,0,1,0,1,0
21073,28,0,0,66,66,0,1,0,1,0
21968,28,0,0,70,70,0,1,0,1,0
11230,28,0,0,66,66,0,1,0,1,0
21721,28,0,0,70,70,0,1,0,1,0
9982,28,0,0,66,66,0,1,0,1,0
20564,28,0,0,70,70,0,1,0,1,0
10001,28,0,0,66,66,0,1,0,1,0
15756,28,0,0,70,70,0,1,0,1,0
12446,28,0,0,70,70,0,1,0,1,0
14426,28,0,0,70,70,0,1,0,1,0
13229,28,0,0,70,70,0,1,0,1,0
15970,28,0,0,66,66,0,1,0,1,0
11922,28,0,0,70,70,0,1,0,1,0
19178,28,0,0,66,66,0,1,0,1,0
15644,28,0,0,66,66,0,1,0,1,0
12847,28,0,0,70,70,0,1,0,1,0
13478,28,0,0,70,70,0,1,0,1,0
8378,28,0,0,70,70,0,1,0,1,0
9257,28,0,0,66,66,0,1,0,1,0
14507,28,0,0,70,70,0,1,0,1,0
9567,28,0,0,70,70,0,1,0,1,0
12369,28,0,0,70,70,0,1,0,1,0
10471,28,0,0,70,70,0,1,0,1,0
14663,28,0,0,66,66,0,1,0,1,0
10459,28,0,0,66,66,0,1,0,1,0
19585,28,0,0,70,70,0,1,0,1,0
9939,28,0,0,66,66,0,1,0,1,0
18051,28,0,0,66,66,0,1,0,1,0
16653,28,0,0,66,66,0,1,0,1,0
21735,28,0,0,70,70,0,1,0,1,0
9791,28,0,0,66,66,0,1,0,1,0
10236,28,0,0,70,70,0,1,0,1,0
18628,28,0,0,70,70,0,1,0,1,0
10321,28,0,0,70,70,0,1,0,1,0
14148,28,0,0,70,70,0,1,0,1,0
14134,28,0,0,70,70,0,1,0,1,0
22320,28,0,0,70,70,0,1,0,1,0
18376,28,0,0,70,70,0,1,0,1,0
20175,28,0,0,70,70,0,1,0,1,0
15723,28,0,0,70,70,0,1,0,1,0
13808,28,0,0,66,66,0,1,0,1,0
10302,28,0,0,66,66,0,1,0,1,0
21709,28,0,0,66,66,0,1,0,1,0
11323,28,0,0,70,70,0,1,0,1,0
10014,28,0,0,70,70,0,1,0,1,0
14872,28,0,0,70,70,0,1,0,1,0
10602,28,0,0,70,70,0,1,0,1,0
14236,28,0,0,66,66,0,1,0,1,0
9674,28,0,0,70,70,0,1,0,1,0
17784,28,0,0,66,66,0,1,0,1,0
21328,28,0,0,70,70,0,1,0,1,0
16966,28,0,0,70,70,0,1,0,1,0
11786,28,0,0,70,70,0,1,0,1,0
13826,28,0,0,70,70,0,1,0,1,0
16868,28,0,0,70,70,0,1,0,1,0
19707,28,0,0,70,70,0,1,0,1,0
14057,28,0,0,70,70,0,1,0,1,0
15930,28,0,0,70,70,0,1,0,1,0
16103,28,0,0,70,70,0,1,0,1,0
19696,28,0,0,70,70,0,1,0,1,0
8959,28,0,0,70,70,0,1,0,1,0
10628,28,0,0,70,70,0,1,0,1,0
19093,28,0,0,70,70,0,1,0,1,0
17133,28,0,0,70,70,0,1,0,1,0
10543,28,0,0,70,70,0,1,0,1,0
19940,28,0,0,66,66,0,1,0,1,0
17491,28,0,0,66,66,0,1,0,1,0
18281,28,0,0,70,70,0,1,0,1,0
19616,28,0,0,70,70,0,1,0,1,0
9851,28,0,0,70,70,0,1,0,1,0
15858,28,0,0,70,70,0,1,0,1,0
22642,28,0,0,66,66,0,1,0,1,0
12924,28,0,0,70,70,0,1,0,1,0
17725,28,0,0,70,70,0,1,0,1,0
12757,28,0,0,66,66,0,1,0,1,0
20365,28,0,0,70,70,0,1,0,1,0
17280,28,0,0,66,66,0,1,0,1,0
9562,28,0,0,66,66,0,1,0,1,0
21816,28,0,0,66,66,0,1,0,1,0
14740,28,0,0,66,66,0,1,0,1,0
20722,28,0,0,66,66,0,1,0,1,0
12944,28,0,0,70,70,0,1,0,1,0
13765,28,0,0,66,66,0,1,0,1,0
18686,28,0,0,70,70,0,1,0,1,0
10215,28,0,0,70,70,0,1,0,1,0
10792,28,0,0,66,66,0,1,0,1,0
9330,28,0,0,70,70,0,1,0,1,0
8814,28,0,0,66,66,0,1,0,1,0
19582,28,0,0,66,66,0,1,0,1,0
12245,28,0,0,70,70,0,1,0,1,0
14382,28,0,0,66,66,0,1,0,1,0
20835,28,0,0,70,70,0,1,0,1,0
21252,28,0,0,70,70,0,1,0,1,0
10295,28,0,0,66,66,0,1,0,1,0
20648,28,0,0,66,66,0,1,0,1,0
17095,28,0,0,70,70,0,1,0,1,0
17979,28,0,0,70,70,0,1,0,1,0
18931,28,0,0,70,70,0,1,0,1,0
19048,28,0,0,70,70,0,1,0,1,0
18895,28,0,0,66,66,0,1,0,1,0
13610,28,0,0,70,70,0,1,0,1,0
16069,28,0,0,66,66,0,1,0,1,0
16932,28,0,0,70,70,0,1,0,1,0
10037,28,0,0,70,70,0,1,0,1,0
21379,28,0,0,70,70,0,1,0,1,0
14890,28,0,0,66,66,0,1,0,1,0
10441,28,0,0,66,66,0,1,0,1,0
13437,28,0,0,66,66,0,1,0,1,0
11877,28,0,0,70,70,0,1,0,1,0
12721,28,0,0,66,66,0,1,0,1,0
8399,28,0,0,70,70,0,1,0,1,0
10976,28,0,0,70,70,0,1,0,1,0
8636,28,0,0,66,66,0,1,0,1,0
22034,28,0,0,70,70,0,1,0,1,0
14305,28,0,0,66,66,0,1,0,1,0
10944,28,0,0,66,66,0,1,0,1,0
11525,28,0,0,66,66,0,1,0,1,0
13542,28,0,0,70,70,0,1,0,1,0
17411,28,0,0,70,70,0,1,0,1,0
20832,28,0,0,66,66,0,1,0,1,0
9036,28,0,0,70,70,0,1,0,1,0
21487,28,0,0,70,70,0,1,0,1,0
10459,28,0,0,70,70,0,1,0,1,0
13126,28,0,0,70,70,0,1,0,1,0
13402,28,0,0,70,70,0,1,0,1,0
9152,28,0,0,70,70,0,1,0,1,0
11770,28,0,0,66,66,0,1,0,1,0
11994,28,0,0,70,70,0,1,0,1,0
18204,28,0,0,66,66,0,1,0,1,0
21998,28,0,0,70,70,0,1,0,1,0
9416,28,0,0,66,66,0,1,0,1,0
17336,28,0,0,70,70,0,1,0,1,0
14364,28,0,0,66,66,0,1,0,1,0
15094,28,0,0,70,70,0,1,0,1,0
17061,28,0,0,70,70,0,1,0,1,0
16633,28,0,0,70,70,0,1,0,1,0
20429,28,0,0,70,70,0,1,0,1,0
21955,28,0,0,70,70,0,1,0,1,0
18186,28,0,0,66,66,0,1,0,1,0
9722,28,0,0,66,66,0,1,0,1,0
11329,28,0,0,70,70,0,1,0,1,0
14976,28,0,0,66,66,0,1,0,1,0
8989,28,0,0,66,66,0,1,0,1,0
9202,28,0,0,70,70,0,1,0,1,0
21938,28,0,0,70,70,0,1,0,1,0
12597,28,0,0,66,66,0,1,0,1,0
11385,28,0,0,70,70,0,1,0,1,0
10657,28,0,0,70,70,0,1,0,1,0
8747,28,0,0,70,70,0,1,0,1,0
17339,28,0,0,70,70,0,1,0,1,0
18954,28,0,0,70,70,0,1,0,1,0
13347,28,0,0,70,70,0,1,0,1,0
12931,28,0,0,70,70,0,1,0,1,0
13146,28,0,0,70,70,0,1,0,1,0
14929,28,0,0,70,70,0,1,0,1,0
14755,28,0,0,70,70,0,1,0,1,0
9797,28,0,0,66,66,0,1,0,1,0
16378,28,0,0,70,70,0,1,0,1,0
13678,28,0,0,70,70,0,1,0,1,0
12970,28,0,0,70,70,0,1,0,1,0
9642,28,0,0,70,70,0,1,0,1,0
19114,28,0,0,70,70,0,1,0,1,0
16587,28,0,0,66,66,0,1,0,1,0
18538,28,0,0,70,70,0,1,0,1,0
10302,28,0,0,70,70,0,1,0,1,0
21726,28,0,0,70,70,0,1,0,1,0
16525,28,0,0,70,70,0,1,0,1,0
20661,28,0,0,70,70,0,1,0,1,0
10177,28,0,0,66,66,0,1,0,1,0
21120,28,0,0,66,66,0,1,0,1,0
16650,28,0,0,66,66,0,1,0,1,0
13791,28,0,0,66,66,0,1,0,1,0
19687,28,0,0,66,66,0,1,0,1,0
20888,28,0,0,70,70,0,1,0,1,0
8907,28,0,0,66,66,0,1,0,1,0
11231,28,0,0,70,70,0,1,0,1,0
9188,28,0,0,70,70,0,1,0,1,0
17349,28,0,0,70,70,0,1,0,1,0
18750,28,0,0,70,70,0,1,0,1,0
9272,28,0,0,70,70,0,1,0,1,0
19488,28,0,0,70,70,0,1,0,1,0
14492,28,0,0,70,70,0,1,0,1,0
13513,28,0,0,70,70,0,1,0,1,0
18476,28,0,0,70,70,0,1,0,1,0
19652,28,0,0,66,66,0,1,0,1,0
22361,28,0,0,70,70,0,1,0,1,0
10145,28,0,0,70,70,0,1,0,1,0
14718,28,0,0,66,66,0,1,0,1,0
8398,28,0,0,70,70,0,1,0,1,0
9209,28,0,0,66,66,0,1,0,1,0
11335,28,0,0,70,70,0,1,0,1,0
9668,28,0,0,70,70,0,1,0,1,0
13057,28,0,0,66,66,0,1,0,1,0
11940,28,0,0,66,66,0,1,0,1,0
22191,28,0,0,70,70,0,1,0,1,0
19885,28,0,0,70,70,0,1,0,1,0
18395,28,0,0,70,70,0,1,0,1,0
17877,28,0,0,70,70,0,1,0,1,0
21795,28,0,0,70,70,0,1,0,1,0
17782,28,0,0,66,66,0,1,0,1,0
10238,28,0,0,66,66,0,1,0,1,0
12795,28,0,0,70,70,0,1,0,1,0
16640,28,0,0,70,70,0,1,0,1,0
22513,28,0,0,66,66,0,1,0,1,0
11514,28,0,0,70,70,0,1,0,1,0
10682,28,0,0,70,70,0,1,0,1,0
20815,28,0,0,66,66,0,1,0,1,0
9158,28,0,0,70,70,0,1,0,1,0
14263,28,0,0,70,70,0,1,0,1,0
20312,28,0,0,70,70,0,1,0,1,0
14160,28,0,0,66,66,0,1,0,1,0
13619,28,0,0,66,66,0,1,0,1,0
9075,28,0,0,66,66,0,1,0,1,0
9223,28,0,0,70,70,0,1,0,1,0
10159,28,0,0,66,66,0,1,0,1,0
19726,28,0,0,66,66,0,1,0,1,0
19465,28,0,0,70,70,0,1,0,1,0
20596,28,0,0,66,66,0,1,0,1,0
22095,28,0,0,66,66,0,1,0,1,0
20817,28,0,0,70,70,0,1,0,1,0
19305,28,0,0,66,66,0,1,0,1,0
8374,28,0,0,70,70,0,1,0,1,0
17016,28,0,0,70,70,0,1,0,1,0
11799,28,0,0,70,70,0,1,0,1,0
15452,28,0,0,70,70,0,1,0,1,0
13924,28,0,0,70,70,0,1,0,1,0
9998,28,0,0,66,66,0,1,0,1,0
17678,28,0,0,70,70,0,1,0,1,0
19464,28,0,0,70,70,0,1,0,1,0
13250,28,0,0,70,70,0,1,0,1,0
20985,28,0,0,66,66,0,1,0,1,0
14491,28,0,0,70,70,0,1,0,1,0
16755,28,0,0,66,66,0,1,0,1,0
11669,28,0,0,70,70,0,1,0,1,0
12899,28,0,0,70,70,0,1,0,1,0
21319,28,0,0,70,70,0,1,0,1,0
18825,28,0,0,70,70,0,1,0,1,0
19527,28,0,0,70,70,0,1,0,1,0
14768,28,0,0,66,66,0,1,0,1,0
13417,28,0,0,70,70,0,1,0,1,0
12646,28,0,0,70,70,0,1,0,1,0
13499,28,0,0,70,70,0,1,0,1,0
20558,28,0,0,66,66,0,1,0,1,0
8403,28,0,0,70,70,0,1,0,1,0
9431,28,0,0,70,70,0,1,0,1,0
21628,28,0,0,70,70,0,1,0,1,0
19875,28,0,0,70,70,0,1,0,1,0
16603,28,0,0,70,70,0,1,0,1,0
12881,28,0,0,70,70,0,1,0,1,0
16909,28,0,0,66,66,0,1,0,1,0
16715,28,0,0,66,66,0,1,0,1,0
22210,28,0,0,66,66,0,1,0,1,0
12591,28,0,0,66,66,0,1,0,1,0
11118,28,0,0,66,66,0,1,0,1,0
10526,28,0,0,70,70,0,1,0,1,0
13781,28,0,0,70,70,0,1,0,1,0
11862,28,0,0,70,70,0,1,0,1,0
19148,28,0,0,66,66,0,1,0,1,0
21171,28,0,0,66,66,0,1,0,1,0
17557,28,0,0,70,70,0,1,0,1,0
14882,28,0,0,70,70,0,1,0,1,0
22624,28,0,0,66,66,0,1,0,1,0
16713,28,0,0,70,70,0,1,0,1,0
19978,28,0,0,70,70,0,1,0,1,0
15064,28,0,0,70,70,0,1,0,1,0
11229,28,0,0,66,66,0,1,0,1,0
10549,28,0,0,70,70,0,1,0,1,0
20057,28,0,0,70,70,0,1,0,1,0
14336,28,0,0,70,70,0,1,0,1,0
20386,28,0,0,70,70,0,1,0,1,0
18999,28,0,0,70,70,0,1,0,1,0
13481,28,0,0,70,70,0,1,0,1,0
14517,28,0,0,70,70,0,1,0,1,0
19946,28,0,0,70,70,0,1,0,1,0
11430,28,0,0,66,66,0,1,0,1,0
10739,28,0,0,70,70,0,1,0,1,0
18254,28,0,0,70,70,0,1,0,1,0
20824,28,0,0,70,70,0,1,0,1,0
10136,28,0,0,70,70,0,1,0,1,0
22019,28,0,0,70,70,0,1,0,1,0
13223,28,0,0,66,66,0,1,0,1,0
18024,28,0,0,66,66,0,1,0,1,0
17353,28,0,0,66,66,0,1,0,1,0
20036,28,0,0,70,70,0,1,0,1,0
13767,28,0,0,70,70,0,1,0,1,0
13407,28,0,0,70,70,0,1,0,1,0
22199,28,0,0,66,66,0,1,0,1,0
19977,28,0,0,70,70,0,1,0,1,0
10622,28,0,0,70,70,0,1,0,1,0
19500,28,0,0,66,66,0,1,0,1,0
8734,28,0,0,70,70,0,1,0,1,0
10857,28,0,0,66,66,0,1,0,1,0
10330,28,0,0,70,70,0,1,0,1,0
16862,28,0,0,70,70,0,1,0,1,0
15379,28,0,0,70,70,0,1,0,1,0
19415,28,0,0,70,70,0,1,0,1,0
10728,28,0,0,66,66,0,1,0,1,0
18810,28,0,0,70,70,0,1,0,1,0
8506,28,0,0,70,70,0,1,0,1,0
18252,28,0,0,70,70,0,1,0,1,0
13494,28,0,0,70,70,0,1,0,1,0
14056,28,0,0,66,66,0,1,0,1,0
16876,28,0,0,70,70,0,1,0,1,0
10719,28,0,0,70,70,0,1,0,1,0
19255,28,0,0,70,70,0,1,0,1,0
11630,28,0,0,70,70,0,1,0,1,0
20607,28,0,0,70,70,0,1,0,1,0
14260,28,0,0,70,70,0,1,0,1,0
15227,28,0,0,70,70,0,1,0,1,0
15029,28,0,0,66,66,0,1,0,1,0
11658,28,0,0,70,70,0,1,0,1,0
20138,28,0,0,66,66,0,1,0,1,0
16219,28,0,0,70,70,0,1,0,1,0
19147,28,0,0,66,66,0,1,0,1,0
10373,28,0,0,70,70,0,1,0,1,0
20418,28,0,0,70,70,0,1,0,1,0
20263,28,0,0,66,66,0,1,0,1,0
12286,28,0,0,66,66,0,1,0,1,0
13961,28,0,0,70,70,0,1,0,1,0
14272,28,0,0,70,70,0,1,0,1,0
18241,28,0,0,66,66,0,1,0,1,0
13181,28,0,0,70,70,0,1,0,1,0
9622,28,0,0,66,66,0,1,0,1,0
22055,28,0,0,70,70,0,1,0,1,0
22309,28,0,0,66,66,0,1,0,1,0
10978,28,0,0,70,70,0,1,0,1,0
9625,28,0,0,70,70,0,1,0,1,0
14362,28,0,0,70,70,0,1,0,1,0
9620,28,0,0,70,70,0,1,0,1,0
18532,28,0,0,70,70,0,1,0,1,0
19325,28,0,0,70,70,0,1,0,1,0
14095,28,0,0,70,70,0,1,0,1,0
15574,28,0,0,70,70,0,1,0,1,0
10060,28,0,0,66,66,0,1,0,1,0
20581,28,0,0,70,70,0,1,0,1,0
19888,28,0,0,66,66,0,1,0,1,0
18527,28,0,0,70,70,0,1,0,1,0
10335,28,0,0,70,70,0,1,0,1,0
17233,28,0,0,66,66,0,1,0,1,0
11934,28,0,0,70,70,0,1,0,1,0
18840,28,0,0,70,70,0,1,0,1,0
15988,28,0,0,70,70,0,1,0,1,0
22002,28,0,0,70,70,0,1,0,1,0
14023,28,0,0,70,70,0,1,0,1,0
12424,28,0,0,66,66,0,1,0,1,0
20951,28,0,0,70,70,0,1,0,1,0
12307,28,0,0,70,70,0,1,0,1,0
21918,28,0,0,70,70,0,1,0,1,0
11420,28,0,0,70,70,0,1,0,1,0
11566,28,0,0,66,66,0,1,0,1,0
20592,28,0,0,70,70,0,1,0,1,0
21675,28,0,0,70,70,0,1,0,1,0
17952,28,0,0,70,70,0,1,0,1,0
16034,28,0,0,70,70,0,1,0,1,0
9750,28,0,0,66,66,0,1,0,1,0
13631,28,0,0,70,70,0,1,0,1,0
9891,28,0,0,70,70,0,1,0,1,0
18553,28,0,0,70,70,0,1,0,1,0
17223,28,0,0,70,70,0,1,0,1,0
20074,28,0,0,70,70,0,1,0,1,0
19338,28,0,0,70,70,0,1,0,1,0
16016,28,0,0,66,66,0,1,0,1,0
10602,28,0,0,70,70,0,1,0,1,0
17999,28,0,0,70,70,0,1,0,1,0
22465,28,0,0,66,66,0,1,0,1,0
18667,28,0,0,66,66,0,1,0,1,0
16586,28,0,0,70,70,0,1,0,1,0
9137,28,0,0,70,70,0,1,0,1,0
14985,28,0,0,66,66,0,1,0,1,0
17215,28,0,0,66,66,0,1,0,1,0
9922,28,0,0,70,70,0,1,0,1,0
19113,28,0,0,66,66,0,1,0,1,0
20167,28,0,0,70,70,0,1,0,1,0
19099,28,0,0,66,66,0,1,0,1,0
8878,28,0,0,70,70,0,1,0,1,0
16809,28,0,0,66,66,0,1,0,1,0
11516,28,0,0,70,70,0,1,0,1,0
19781,28,0,0,70,70,0,1,0,1,0
15017,28,0,0,70,70,0,1,0,1,0
16899,28,0,0,66,66,0,1,0,1,0
13996,28,0,0,70,70,0,1,0,1,0
19297,28,0,0,66,66,0,1,0,1,0
19052,28,0,0,66,66,0,1,0,1,0
16472,28,0,0,70,70,0,1,0,1,0
16566,28,0,0,66,66,0,1,0,1,0
15627,28,0,0,70,70,0,1,0,1,0
14713,28,0,0,66,66,0,1,0,1,0
15956,28,0,0,66,66,0,1,0,1,0
16240,28,0,0,66,66,0,1,0,1,0
14411,28,0,0,70,70,0,1,0,1,0
17836,28,0,0,66,66,0,1,0,1,0
10505,28,0,0,66,66,0,1,0,1,0
9815,28,0,0,66,66,0,1,0,1,0
13861,28,0,0,66,66,0,1,0,1,0
21095,28,0,0,70,70,0,1,0,1,0
21365,28,0,0,70,70,0,1,0,1,0
18934,28,0,0,70,70,0,1,0,1,0
18677,28,0,0,66,66,0,1,0,1,0
15296,28,0,0,70,70,0,1,0,1,0
14672,28,0,0,70,70,0,1,0,1,0
18943,28,0,0,70,70,0,1,0,1,0
10108,28,0,0,70,70,0,1,0,1,0
11879,28,0,0,70,70,0,1,0,1,0
11366,28,0,0,70,70,0,1,0,1,0
8916,28,0,0,66,66,0,1,0,1,0
13746,28,0,0,66,66,0,1,0,1,0
15901,28,0,0,70,70,0,1,0,1,0
16494,28,0,0,66,66,0,1,0,1,0
12581,28,0,0,70,70,0,1,0,1,0
21694,28,0,0,70,70,0,1,0,1,0
10201,28,0,0,70,70,0,1,0,1,0
22667,28,0,0,66,66,0,1,0,1,0
8450,28,0,0,70,70,0,1,0,1,0
20749,28,0,0,66,66,0,1,0,1,0
15678,28,0,0,70,70,0,1,0,1,0
13907,28,0,0,70,70,0,1,0,1,0
21005,28,0,0,66,66,0,1,0,1,0
16556,28,0,0,70,70,0,1,0,1,0
15813,28,0,0,70,70,0,1,0,1,0
15841,28,0,0,66,66,0,1,0,1,0
10934,28,0,0,70,70,0,1,0,1,0
13308,28,0,0,70,70,0,1,0,1,0
8640,28,0,0,70,70,0,1,0,1,0
8781,28,0,0,66,66,0,1,0,1,0
16142,28,0,0,70,70,0,1,0,1,0
14545,28,0,0,70,70,0,1,0,1,0
21157,28,0,0,70,70,0,1,0,1,0
22419,28,0,0,70,70,0,1,0,1,0
17664,28,0,0,70,70,0,1,0,1,0
12886,28,0,0,66,66,0,1,0,1,0
11778,28,0,0,70,70,0,1,0,1,0
21264,28,0,0,70,70,0,1,0,1,0
18485,28,0,0,70,70,0,1,0,1,0
18090,28,0,0,70,70,0,1,0,1,0
13627,28,0,0,66,66,0,1,0,1,0
18836,28,0,0,66,66,0,1,0,1,0
11361,28,0,0,66,66,0,1,0,1,0
21391,28,0,0,66,66,0,1,0,1,0
12122,28,0,0,70,70,0,1,0,1,0
10361,28,0,0,70,70,0,1,0,1,0
21178,28,0,0,70,70,0,1,0,1,0
11283,28,0,0,70,70,0,1,0,1,0
14401,28,0,0,70,70,0,1,0,1,0
12377,28,0,0,70,70,0,1,0,1,0
9556,28,0,0,70,70,0,1,0,1,0
19803,28,0,0,70,70,0,1,0,1,0
19017,28,0,0,70,70,0,1,0,1,0
18725,28,0,0,70,70,0,1,0,1,0
18819,28,0,0,70,70,0,1,0,1,0
16226,28,0,0,66,66,0,1,0,1,0
18782,28,0,0,70,70,0,1,0,1,0
19528,28,0,0,66,66,0,1,0,1,0
14798,28,0,0,70,70,0,1,0,1,0
12546,28,0,0,70,70,0,1,0,1,0
19700,28,0,0,70,70,0,1,0,1,0
11082,28,0,0,70,70,0,1,0,1,0
14941,28,0,0,70,70,0,1,0,1,0
9525,28,0,0,66,66,0,1,0,1,0
19083,28,0,0,70,70,0,1,0,1,0
12510,28,0,0,70,70,0,1,0,1,0
10052,28,0,0,66,66,0,1,0,1,0
20813,28,0,0,66,66,0,1,0,1,0
20472,28,0,0,66,66,0,1,0,1,0
19567,28,0,0,70,70,0,1,0,1,0
9098,28,0,0,70,70,0,1,0,1,0
10818,28,0,0,66,66,0,1,0,1,0
8677,28,0,0,66,66,0,1,0,1,0
8493,28,0,0,66,66,0,1,0,1,0
15359,28,0,0,66,66,0,1,0,1,0
15415,28,0,0,66,66,0,1,0,1,0
21162,28,0,0,70,70,0,1,0,1,0
10604,28,0,0,70,70,0,1,0,1,0
21554,28,0,0,70,70,0,1,0,1,0
20760,28,0,0,70,70,0,1,0,1,0
22585,28,0,0,66,66,0,1,0,1,0
15552,28,0,0,70,70,0,1,0,1,0
9437,28,0,0,70,70,0,1,0,1,0
19548,28,0,0,70,70,0,1,0,1,0
11505,28,0,0,70,70,0,1,0,1,0
10296,28,0,0,66,66,0,1,0,1,0
10113,28,0,0,66,66,0,1,0,1,0
13736,28,0,0,70,70,0,1,0,1,0
9499,28,0,0,70,70,0,1,0,1,0
17158,28,0,0,66,66,0,1,0,1,0
11562,28,0,0,66,66,0,1,0,1,0
13828,28,0,0,66,66,0,1,0,1,0
15194,28,0,0,70,70,0,1,0,1,0
9753,28,0,0,66,66,0,1,0,1,0
8526,28,0,0,70,70,0,1,0,1,0
11665,28,0,0,70,70,0,1,0,1,0
14288,28,0,0,70,70,0,1,0,1,0
11820,28,0,0,66,66,0,1,0,1,0
15778,28,0,0,66,66,0,1,0,1,0
16788,28,0,0,70,70,0,1,0,1,0
11406,28,0,0,66,66,0,1,0,1,0
9423,28,0,0,70,70,0,1,0,1,0
21825,28,0,0,70,70,0,1,0,1,0
14548,28,0,0,66,66,0,1,0,1,0
11156,28,0,0,70,70,0,1,0,1,0
15067,28,0,0,66,66,0,1,0,1,0
19602,28,0,0,70,70,0,1,0,1,0
13998,28,0,0,70,70,0,1,0,1,0
20412,28,0,0,70,70,0,1,0,1,0
18826,28,0,0,70,70,0,1,0,1,0
12323,28,0,0,70,70,0,1,0,1,0
19016,28,0,0,66,66,0,1,0,1,0
13582,28,0,0,70,70,0,1,0,1,0
22267,28,0,0,70,70,0,1,0,1,0
18645,28,0,0,66,66,0,1,0,1,0
12600,28,0,0,70,70,0,1,0,1,0
16430,28,0,0,70,70,0,1,0,1,0
17472,28,0,0,66,66,0,1,0,1,0
13988,28,0,0,66,66,0,1,0,1,0
15586,28,0,0,70,70,0,1,0,1,0
16426,28,0,0,70,70,0,1,0,1,0
21070,28,0,0,70,70,0,1,0,1,0
21826,28,0,0,70,70,0,1,0,1,0
12332,28,0,0,70,70,0,1,0,1,0
12597,28,0,0,70,70,0,1,0,1,0
11956,28,0,0,66,66,0,1,0,1,0
18881,28,0,0,70,70,0,1,0,1,0
13881,28,0,0,70,70,0,1,0,1,0
20783,28,0,0,66,66,0,1,0,1,0
15934,28,0,0,70,70,0,1,0,1,0
18760,28,0,0,66,66,0,1,0,1,0
15420,28,0,0,70,70,0,1,0,1,0
18139,28,0,0,70,70,0,1,0,1,0
18159,28,0,0,70,70,0,1,0,1,0
9740,28,0,0,70,70,0,1,0,1,0
10960,28,0,0,70,70,0,1,0,1,0
14344,28,0,0,70,70,0,1,0,1,0
20811,28,0,0,70,70,0,1,0,1,0
17409,28,0,0,66,66,0,1,0,1,0
9706,28,0,0,66,66,0,1,0,1,0
14481,28,0,0,66,66,0,1,0,1,0
13698,28,0,0,70,70,0,1,0,1,0
22521,28,0,0,70,70,0,1,0,1,0
9925,28,0,0,70,70,0,1,0,1,0
14313,28,0,0,70,70,0,1,0,1,0
14912,28,0,0,70,70,0,1,0,1,0
18208,28,0,0,66,66,0,1,0,1,0
19682,28,0,0,70,70,0,1,0,1,0
14618,28,0,0,70,70,0,1,0,1,0
19071,28,0,0,70,70,0,1,0,1,0
13997,28,0,0,70,70,0,1,0,1,0
11152,28,0,0,70,70,0,1,0,1,0
10380,28,0,0,70,70,0,1,0,1,0
9786,28,0,0,70,70,0,1,0,1,0
8577,28,0,0,70,70,0,1,0,1,0
21669,28,0,0,66,66,0,1,0,1,0
9827,28,0,0,70,70,0,1,0,1,0
9908,28,0,0,66,66,0,1,0,1,0
9957,28,0,0,66,66,0,1,0,1,0
14267,28,0,0,70,70,0,1,0,1,0
13845,28,0,0,66,66,0,1,0,1,0
21023,28,0,0,66,66,0,1,0,1,0
12663,28,0,0,66,66,0,1,0,1,0
16235,28,0,0,70,70,0,1,0,1,0
16555,28,0,0,70,70,0,1,0,1,0
22505,28,0,0,70,70,0,1,0,1,0
13728,28,0,0,70,70,0,1,0,1,0
12911,28,0,0,66,66,0,1,0,1,0
8450,28,0,0,66,66,0,1,0,1,0
18274,28,0,0,66,66,0,1,0,1,0
15392,28,0,0,66,66,0,1,0,1,0
21728,28,0,0,66,66,0,1,0,1,0
8677,28,0,0,70,70,0,1,0,1,0
21328,28,0,0,70,70,0,1,0,1,0
13890,28,0,0,70,70,0,1,0,1,0
19836,28,0,0,70,70,0,1,0,1,0
17497,28,0,0,70,70,0,1,0,1,0
13373,28,0,0,66,66,0,1,0,1,0
16948,28,0,0,70,70,0,1,0,1,0
9157,28,0,0,70,70,0,1,0,1,0
13424,28,0,0,66,66,0,1,0,1,0
10076,28,0,0,70,70,0,1,0,1,0
21650,28,0,0,66,66,0,1,0,1,0
18800,28,0,0,70,70,0,1,0,1,0
14876,28,0,0,70,70,0,1,0,1,0
21206,28,0,0,70,70,0,1,0,1,0
13728,28,0,0,70,70,0,1,0,1,0
20321,28,0,0,70,70,0,1,0,1,0
9868,28,0,0,70,70,0,1,0,1,0
13353,28,0,0,70,70,0,1,0,1,0
22461,28,0,0,66,66,0,1,0,1,0
16159,28,0,0,70,70,0,1,0,1,0
9941,28,0,0,66,66,0,1,0,1,0
9467,28,0,0,70,70,0,1,0,1,0
16524,28,0,0,70,70,0,1,0,1,0
20242,28,0,0,70,70,0,1,0,1,0
19270,28,0,0,70,70,0,1,0,1,0
16171,28,0,0,70,70,0,1,0,1,0
9084,28,0,0,70,70,0,1,0,1,0
13858,28,0,0,70,70,0,1,0,1,0
11491,28,0,0,66,66,0,1,0,1,0
17158,28,0,0,70,70,0,1,0,1,0
18152,28,0,0,66,66,0,1,0,1,0
12234,28,0,0,70,70,0,1,0,1,0
10551,28,0,0,70,70,0,1,0,1,0
16822,28,0,0,66,66,0,1,0,1,0
13169,28,0,0,70,70,0,1,0,1,0
19637,28,0,0,66,66,0,1,0,1,0
19196,28,0,0,66,66,0,1,0,1,0
18529,28,0,0,66,66,0,1,0,1,0
17202,28,0,0,70,70,0,1,0,1,0
18992,28,0,0,70,70,0,1,0,1,0
10058,28,0,0,66,66,0,1,0,1,0
16677,28,0,0,66,66,0,1,0,1,0
9686,28,0,0,66,66,0,1,0,1,0
22176,28,0,0,70,70,0,1,0,1,0
16140,28,0,0,70,70,0,1,0,1,0
22024,28,0,0,70,70,0,1,0,1,0
20904,28,0,0,70,70,0,1,0,1,0
22181,28,0,0,70,70,0,1,0,1,0
18640,28,0,0,70,70,0,1,0,1,0
13761,28,0,0,66,66,0,1,0,1,0
16906,28,0,0,70,70,0,1,0,1,0
9701,28,0,0,70,70,0,1,0,1,0
11480,28,0,0,66,66,0,1,0,1,0
21207,28,0,0,66,66,0,1,0,1,0
17403,28,0,0,70,70,0,1,0,1,0
18341,28,0,0,70,70,0,1,0,1,0
10069,28,0,0,70,70,0,1,0,1,0
13782,28,0,0,70,70,0,1,0,1,0
8574,28,0,0,70,70,0,1,0,1,0
19097,28,0,0,70,70,0,1,0,1,0
12329,28,0,0,66,66,0,1,0,1,0
18380,28,0,0,70,70,0,1,0,1,0
15535,28,0,0,66,66,0,1,0,1,0
22427,28,0,0,70,70,0,1,0,1,0
11005,28,0,0,66,66,0,1,0,1,0
22111,28,0,0,70,70,0,1,0,1,0
17537,28,0,0,70,70,0,1,0,1,0
16626,28,0,0,66,66,0,1,0,1,0
15063,28,0,0,70,70,0,1,0,1,0
21551,28,0,0,66,66,0,1,0,1,0
11720,28,0,0,70,70,0,1,0,1,0
18673,28,0,0,70,70,0,1,0,1,0
15109,28,0,0,70,70,0,1,0,1,0
19272,28,0,0,66,66,0,1,0,1,0
12681,28,0,0,66,66,0,1,0,1,0
18059,28,0,0,70,70,0,1,0,1,0
10587,28,0,0,70,70,0,1,0,1,0
13488,28,0,0,70,70,0,1,0,1,0
19050,28,0,0,66,66,0,1,0,1,0
8387,28,0,0,66,66,0,1,0,1,0
21915,28,0,0,70,70,0,1,0,1,0
17903,28,0,0,66,66,0,1,0,1,0
12609,28,0,0,70,70,0,1,0,1,0
22469,28,0,0,66,66,0,1,0,1,0
12846,28,0,0,70,70,0,1,0,1,0
9320,28,0,0,70,70,0,1,0,1,0
17187,28,0,0,70,70,0,1,0,1,0
17429,28,0,0,70,70,0,1,0,1,0
14490,28,0,0,70,70,0,1,0,1,0
13962,28,0,0,70,70,0,1,0,1,0
20491,28,0,0,66,66,0,1,0,1,0
14455,28,0,0,70,70,0,1,0,1,0
14549,28,0,0,66,66,0,1,0,1,0
9503,28,0,0,70,70,0,1,0,1,0
11667,28,0,0,66,66,0,1,0,1,0
9609,28,0,0,66,66,0,1,0,1,0
19074,28,0,0,70,70,0,1,0,1,0
13660,28,0,0,70,70,0,1,0,1,0
18515,28,0,0,70,70,0,1,0,1,0
16282,28,0,0,70,70,0,1,0,1,0
17936,28,0,0,70,70,0,1,0,1,0
21238,28,0,0,70,70,0,1,0,1,0
9923,28,0,0,70,70,0,1,0,1,0
18650,28,0,0,70,70,0,1,0,1,0
12525,28,0,0,66,66,0,1,0,1,0
10034,28,0,0,70,70,0,1,0,1,0
22584,28,0,0,66,66,0,1,0,1,0
15220,28,0,0,66,66,0,1,0,1,0
11891,28,0,0,66,66,0,1,0,1,0
8432,28,0,0,70,70,0,1,0,1,0
13856,28,0,0,66,66,0,1,0,1,0
20964,28,0,0,70,70,0,1,0,1,0
16541,28,0,0,70,70,0,1,0,1,0
17839,28,0,0,70,70,0,1,0,1,0
9170,28,0,0,70,70,0,1,0,1,0
8977,28,0,0,70,70,0,1,0,1,0
9264,28,0,0,70,70,0,1,0,1,0
10154,28,0,0,66,66,0,1,0,1,0
8561,28,0,0,70,70,0,1,0,1,0
12248,28,0,0,70,70,0,1,0,1,0
16341,28,0,0,66,66,0,1,0,1,0
9256,28,0,0,66,66,0,1,0,1,0
22520,28,0,0,66,66,0,1,0,1,0
13624,28,0,0,66,66,0,1,0,1,0
13573,28,0,0,70,70,0,1,0,1,0
16509,28,0,0,66,66,0,1,0,1,0
16399,28,0,0,66,66,0,1,0,1,0
11537,28,0,0,70,70,0,1,0,1,0
10391,28,0,0,70,70,0,1,0,1,0
10531,28,0,0,70,70,0,1,0,1,0
13972,28,0,0,70,70,0,1,0,1,0
8871,28,0,0,70,70,0,1,0,1,0
21450,28,0,0,70,70,0,1,0,1,0
10394,28,0,0,70,70,0,1,0,1,0
18679,28,0,0,66,66,0,1,0,1,0
10272,28,0,0,70,70,0,1,0,1,0
15299,28,0,0,70,70,0,1,0,1,0
9597,28,0,0,70,70,0,1,0,1,0
12046,28,0,0,70,70,0,1,0,1,0
9875,28,0,0,70,70,0,1,0,1,0
16198,28,0,0,70,70,0,1,0,1,0
13789,28,0,0,70,70,0,1,0,1,0
11176,28,0,0,70,70,0,1,0,1,0
12622,28,0,0,70,70,0,1,0,1,0
17655,28,0,0,66,66,0,1,0,1,0
9521,28,0,0,70,70,0,1,0,1,0
16982,28,0,0,66,66,0,1,0,1,0
15407,28,0,0,70,70,0,1,0,1,0
15193,28,0,0,70,70,0,1,0,1,0
22334,28,0,0,66,66,0,1,0,1,0
17432,28,0,0,66,66,0,1,0,1,0
15618,28,0,0,70,70,0,1,0,1,0
16672,28,0,0,70,70,0,1,0,1,0
8394,28,0,0,70,70,0,1,0,1,0
18832,28,0,0,70,70,0,1,0,1,0
16570,28,0,0,70,70,0,1,0,1,0
9580,28,0,0,70,70,0,1,0,1,0
12726,28,0,0,70,70,0,1,0,1,0
16627,28,0,0,70,70,0,1,0,1,0
16750,28,0,0,70,70,0,1,0,1,0
17517,28,0,0,66,66,0,1,0,1,0
13798,28,0,0,70,70,0,1,0,1,0
16239,28,0,0,66,66,0,1,0,1,0
20732,28,0,0,66,66,0,1,0,1,0
22273,28,0,0,66,66,0,1,0,1,0
15413,28,0,0,66,66,0,1,0,1,0
21749,28,0,0,70,70,0,1,0,1,0
14322,28,0,0,70,70,0,1,0,1,0
9643,28,0,0,66,66,0,1,0,1,0
22562,28,0,0,66,66,0,1,0,1,0
10039,28,0,0,66,66,0,1,0,1,0
9826,28,0,0,70,70,0,1,0,1,0
20595,28,0,0,66,66,0,1,0,1,0
9748,28,0,0,70,70,0,1,0,1,0
16751,28,0,0,70,70,0,1,0,1,0
11796,28,0,0,66,66,0,1,0,1,0
10279,28,0,0,70,70,0,1,0,1,0
16347,28,0,0,70,70,0,1,0,1,0
10916,28,0,0,70,70,0,1,0,1,0
18172,28,0,0,70,70,0,1,0,1,0
22653,28,0,0,70,70,0,1,0,1,0
12365,28,0,0,70,70,0,1,0,1,0
16881,28,0,0,70,70,0,1,0,1,0
11105,28,0,0,70,70,0,1,0,1,0
22351,28,0,0,70,70,0,1,0,1,0
9102,28,0,0,70,70,0,1,0,1,0
8662,28,0,0,70,70,0,1,0,1,0
13048,28,0,0,70,70,0,1,0,1,0
18278,28,0,0,70,70,0,1,0,1,0
9005,28,0,0,70,70,0,1,0,1,0
10517,28,0,0,70,70,0,1,0,1,0
20852,28,0,0,70,70,0,1,0,1,0
8362,28,0,0,70,70,0,1,0,1,0
10841,28,0,0,70,70,0,1,0,1,0
16294,28,0,0,66,66,0,1,0,1,0
10842,28,0,0,70,70,0,1,0,1,0
13008,28,0,0,70,70,0,1,0,1,0
20457,28,0,0,66,66,0,1,0,1,0
10977,28,0,0,70,70,0,1,0,1,0
16040,28,0,0,70,70,0,1,0,1,0
19499,28,0,0,70,70,0,1,0,1,0
11508,28,0,0,70,70,0,1,0,1,0
20297,28,0,0,70,70,0,1,0,1,0
16061,28,0,0,70,70,0,1,0,1,0
8660,28,0,0,70,70,0,1,0,1,0
18273,28,0,0,70,70,0,1,0,1,0
9291,28,0,0,70,70,0,1,0,1,0
17142,28,0,0,70,70,0,1,0,1,0
10307,28,0,0,70,70,0,1,0,1,0
20614,28,0,0,70,70,0,1,0,1,0
10596,28,0,0,70,70,0,1,0,1,0
14911,28,0,0,70,70,0,1,0,1,0
21580,28,0,0,70,70,0,1,0,1,0
14329,28,0,0,70,70,0,1,0,1,0
12554,28,0,0,66,66,0,1,0,1,0
19568,28,0,0,66,66,0,1,0,1,0
18027,28,0,0,66,66,0,1,0,1,0
16636,28,0,0,70,70,0,1,0,1,0
19117,28,0,0,66,66,0,1,0,1,0
10195,28,0,0,70,70,0,1,0,1,0
12729,28,0,0,70,70,0,1,0,1,0
10735,28,0,0,66,66,0,1,0,1,0
11767,28,0,0,70,70,0,1,0,1,0
22014,28,0,0,66,66,0,1,0,1,0
16193,28,0,0,66,66,0,1,0,1,0
19654,28,0,0,66,66,0,1,0,1,0
13175,28,0,0,70,70,0,1,0,1,0
8472,28,0,0,70,70,0,1,0,1,0
13111,28,0,0,66,66,0,1,0,1,0
11526,28,0,0,66,66,0,1,0,1,0
14620,28,0,0,70,70,0,1,0,1,0
9401,28,0,0,70,70,0,1,0,1,0
19887,28,0,0,70,70,0,1,0,1,0
18045,28,0,0,70,70,0,1,0,1,0
14366,28,0,0,66,66,0,1,0,1,0
10255,28,0,0,70,70,0,1,0,1,0
9361,28,0,0,70,70,0,1,0,1,0
15481,28,0,0,70,70,0,1,0,1,0
19802,28,0,0,70,70,0,1,0,1,0
21569,28,0,0,70,70,0,1,0,1,0
15923,28,0,0,70,70,0,1,0,1,0
20906,28,0,0,66,66,0,1,0,1,0
20179,28,0,0,70,70,0,1,0,1,0
10484,28,0,0,66,66,0,1,0,1,0
19876,28,0,0,70,70,0,1,0,1,0
17387,28,0,0,70,70,0,1,0,1,0
22509,28,0,0,70,70,0,1,0,1,0
14085,28,0,0,70,70,0,1,0,1,0
21834,28,0,0,66,66,0,1,0,1,0
15628,28,0,0,70,70,0,1,0,1,0
8577,28,0,0,70,70,0,1,0,1,0
19294,28,0,0,66,66,0,1,0,1,0
9411,28,0,0,70,70,0,1,0,1,0
15076,28,0,0,70,70,0,1,0,1,0
16030,28,0,0,66,66,0,1,0,1,0
15350,28,0,0,70,70,0,1,0,1,0
17413,28,0,0,66,66,0,1,0,1,0
10631,28,0,0,70,70,0,1,0,1,0
18748,28,0,0,70,70,0,1,0,1,0
12814,28,0,0,70,70,0,1,0,1,0
19973,28,0,0,70,70,0,1,0,1,0
17057,28,0,0,70,70,0,1,0,1,0
14163,28,0,0,70,70,0,1,0,1,0
12737,28,0,0,66,66,0,1,0,1,0
16474,28,0,0,70,70,0,1,0,1,0
22288,28,0,0,70,70,0,1,0,1,0
20001,28,0,0,70,70,0,1,0,1,0
19683,28,0,0,70,70,0,1,0,1,0
14114,28,0,0,70,70,0,1,0,1,0
16028,28,0,0,70,70,0,1,0,1,0
10665,28,0,0,70,70,0,1,0,1,0
19240,28,0,0,66,66,0,1,0,1,0
17034,28,0,0,70,70,0,1,0,1,0
16138,28,0,0,70,70,0,1,0,1,0
11399,28,0,0,66,66,0,1,0,1,0
14095,28,0,0,70,70,0,1,0,1,0
19827,28,0,0,70,70,0,1,0,1,0
17407,28,0,0,66,66,0,1,0,1,0
15968,28,0,0,70,70,0,1,0,1,0
21521,28,0,0,70,70,0,1,0,1,0
17804,28,0,0,70,70,0,1,0,1,0
8526,28,0,0,66,66,0,1,0,1,0
16673,28,0,0,70,70,0,1,0,1,0
15095,28,0,0,70,70,0,1,0,1,0
20295,28,0,0,70,70,0,1,0,1,0
10873,28,0,0,70,70,0,1,0,1,0
18369,28,0,0,66,66,0,1,0,1,0
8696,28,0,0,66,66,0,1,0,1,0
16715,28,0,0,70,70,0,1,0,1,0
14187,28,0,0,70,70,0,1,0,1,0
19824,28,0,0,70,70,0,1,0,1,0
11445,28,0,0,70,70,0,1,0,1,0
14413,28,0,0,66,66,0,1,0,1,0
19773,28,0,0,70,70,0,1,0,1,0
10149,28,0,0,70,70,0,1,0,1,0
10730,28,0,0,70,70,0,1,0,1,0
19263,28,0,0,70,70,0,1,0,1,0
13686,28,0,0,70,70,0,1,0,1,0
12287,28,0,0,70,70,0,1,0,1,0
18260,28,0,0,66,66,0,1,0,1,0
11322,28,0,0,66,66,0,1,0,1,0
14440,28,0,0,70,70,0,1,0,1,0
10254,28,0,0,70,70,0,1,0,1,0
15805,28,0,0,70,70,0,1,0,1,0
18619,28,0,0,66,66,0,1,0,1,0
21355,28,0,0,70,70,0,1,0,1,0
14604,28,0,0,70,70,0,1,0,1,0
13525,28,0,0,70,70,0,1,0,1,0
21911,28,0,0,70,70,0,1,0,1,0
17090,28,0,0,70,70,0,1,0,1,0
14456,28,0,0,70,70,0,1,0,1,0
20580,28,0,0,70,70,0,1,0,1,0
20211,28,0,0,70,70,0,1,0,1,0
10363,28,0,0,70,70,0,1,0,1,0
12730,28,0,0,70,70,0,1,0,1,0
19618,28,0,0,70,70,0,1,0,1,0
12313,28,0,0,70,70,0,1,0,1,0
9926,28,0,0,70,70,0,1,0,1,0
11049,28,0,0,70,70,0,1,0,1,0
12126,28,0,0,66,66,0,1,0,1,0
12344,28,0,0,66,66,0,1,0,1,0
11632,28,0,0,70,70,0,1,0,1,0
16223,28,0,0,70,70,0,1,0,1,0
12077,28,0,0,70,70,0,1,0,1,0
15719,28,0,0,66,66,0,1,0,1,0
16587,28,0,0,70,70,0,1,0,1,0
18285,28,0,0,70,70,0,1,0,1,0
15910,28,0,0,66,66,0,1,0,1,0
21668,28,0,0,66,66,0,1,0,1,0
20265,28,0,0,70,70,0,1,0,1,0
18102,28,0,0,66,66,0,1,0,1,0
10896,28,0,0,70,70,0,1,0,1,0
19090,28,0,0,66,66,0,1,0,1,0
21218,28,0,0,70,70,0,1,0,1,0
15312,28,0,0,70,70,0,1,0,1,0
15962,28,0,0,70,70,0,1,0,1,0
16721,28,0,0,66,66,0,1,0,1,0
22073,28,0,0,66,66,0,1,0,1,0
13256,28,0,0,70,70,0,1,0,1,0
11138,28,0,0,66,66,0,1,0,1,0
16237,28,0,0,66,66,0,1,0,1,0
18518,28,0,0,66,66,0,1,0,1,0
20268,28,0,0,70,70,0,1,0,1,0
16043,28,0,0,70,70,0,1,0,1,0
12634,28,0,0,70,70,0,1,0,1,0
11209,28,0,0,70,70,0,1,0,1,0
8366,28,0,0,66,66,0,1,0,1,0
17002,28,0,0,66,66,0,1,0,1,0
13417,28,0,0,66,66,0,1,0,1,0
15590,28,0,0,66,66,0,1,0,1,0
14141,28,0,0,70,70,0,1,0,1,0
18340,28,0,0,70,70,0,1,0,1,0
16031,28,0,0,66,66,0,1,0,1,0
19920,28,0,0,66,66,0,1,0,1,0
22327,28,0,0,66,66,0,1,0,1,0
19266,28,0,0,66,66,0,1,0,1,0
11764,28,0,0,70,70,0,1,0,1,0
14190,28,0,0,66,66,0,1,0,1,0
21418,28,0,0,66,66,0,1,0,1,0
22529,28,0,0,70,70,0,1,0,1,0
19606,28,0,0,66,66,0,1,0,1,0
13689,28,0,0,66,66,0,1,0,1,0
19146,28,0,0,66,66,0,1,0,1,0
15366,28,0,0,70,70,0,1,0,1,0
19182,28,0,0,70,70,0,1,0,1,0
11621,28,0,0,70,70,0,1,0,1,0
13675,28,0,0,70,70,0,1,0,1,0
20339,28,0,0,70,70,0,1,0,1,0
8689,28,0,0,70,70,0,1,0,1,0
22658,28,0,0,66,66,0,1,0,1,0
19939,28,0,0,70,70,0,1,0,1,0
13809,28,0,0,66,66,0,1,0,1,0
20127,28,0,0,70,70,0,1,0,1,0
14170,28,0,0,70,70,0,1,0,1,0
14923,28,0,0,66,66,0,1,0,1,0
21768,28,0,0,70,70,0,1,0,1,0
19289,28,0,0,66,66,0,1,0,1,0
14034,28,0,0,70,70,0,1,0,1,0
16336,28,0,0,70,70,0,1,0,1,0
17448,28,0,0,66,66,0,1,0,1,0
16093,28,0,0,66,66,0,1,0,1,0
19922,28,0,0,66,66,0,1,0,1,0
14526,28,0,0,70,70,0,1,0,1,0
20378,28,0,0,66,66,0,1,0,1,0
18320,28,0,0,70,70,0,1,0,1,0
16384,28,0,0,66,66,0,1,0,1,0
17462,28,0,0,70,70,0,1,0,1,0
15897,28,0,0,70,70,0,1,0,1,0
13258,28,0,0,70,70,0,1,0,1,0
17130,28,0,0,66,66,0,1,0,1,0
20431,28,0,0,70,70,0,1,0,1,0
9314,28,0,0,66,66,0,1,0,1,0
10178,28,0,0,66,66,0,1,0,1,0
20118,28,0,0,66,66,0,1,0,1,0
12211,28,0,0,70,70,0,1,0,1,0
22268,28,0,0,70,70,0,1,0,1,0
15714,28,0,0,66,66,0,1,0,1,0
10606,28,0,0,70,70,0,1,0,1,0
16320,28,0,0,70,70,0,1,0,1,0
19284,28,0,0,66,66,0,1,0,1,0
14895,28,0,0,70,70,0,1,0,1,0
22374,28,0,0,70,70,0,1,0,1,0
20465,28,0,0,66,66,0,1,0,1,0
19553,28,0,0,70,70,0,1,0,1,0
13342,28,0,0,70,70,0,1,0,1,0
19959,28,0,0,66,66,0,1,0,1,0
20040,28,0,0,70,70,0,1,0,1,0
21357,28,0,0,66,66,0,1,0,1,0
19907,28,0,0,70,70,0,1,0,1,0
13469,28,0,0,66,66,0,1,0,1,0
21643,28,0,0,70,70,0,1,0,1,0
10380,28,0,0,70,70,0,1,0,1,0
17852,28,0,0,70,70,0,1,0,1,0
13978,28,0,0,70,70,0,1,0,1,0
21853,28,0,0,70,70,0,1,0,1,0
9626,28,0,0,66,66,0,1,0,1,0
21853,28,0,0,66,66,0,1,0,1,0
19058,28,0,0,70,70,0,1,0,1,0
10001,28,0,0,70,70,0,1,0,1,0
8589,28,0,0,70,70,0,1,0,1,0
16695,28,0,0,70,70,0,1,0,1,0
12557,28,0,0,70,70,0,1,0,1,0
12557,28,0,0,70,70,0,1,0,1,0
13211,28,0,0,70,70,0,1,0,1,0
21576,28,0,0,70,70,0,1,0,1,0
13082,28,0,0,66,66,0,1,0,1,0
17607,28,0,0,70,70,0,1,0,1,0
19413,28,0,0,70,70,0,1,0,1,0
12235,28,0,0,70,70,0,1,0,1,0
21165,28,0,0,70,70,0,1,0,1,0
20072,28,0,0,66,66,0,1,0,1,0
19025,28,0,0,70,70,0,1,0,1,0
14295,28,0,0,70,70,0,1,0,1,0
16513,28,0,0,70,70,0,1,0,1,0
16779,28,0,0,70,70,0,1,0,1,0
9705,28,0,0,70,70,0,1,0,1,0
19810,28,0,0,70,70,0,1,0,1,0
18020,28,0,0,70,70,0,1,0,1,0
13557,28,0,0,66,66,0,1,0,1,0
16629,28,0,0,66,66,0,1,0,1,0
19576,28,0,0,66,66,0,1,0,1,0
19615,28,0,0,70,70,0,1,0,1,0
18413,28,0,0,70,70,0,1,0,1,0
22150,28,0,0,66,66,0,1,0,1,0
22159,28,0,0,70,70,0,1,0,1,0
20806,28,0,0,70,70,0,1,0,1,0
11197,28,0,0,66,66,0,1,0,1,0
22482,28,0,0,70,70,0,1,0,1,0
21835,28,0,0,70,70,0,1,0,1,0
13714,28,0,0,70,70,0,1,0,1,0
18566,28,0,0,70,70,0,1,0,1,0
19566,28,0,0,70,70,0,1,0,1,0
19938,28,0,0,70,70,0,1,0,1,0
10116,28,0,0,70,70,0,1,0,1,0
10185,28,0,0,66,66,0,1,0,1,0
20085,28,0,0,70,70,0,1,0,1,0
20209,28,0,0,66,66,0,1,0,1,0
12866,28,0,0,66,66,0,1,0,1,0
14786,28,0,0,66,66,0,1,0,1,0
15216,28,0,0,70,70,0,1,0,1,0
9549,28,0,0,70,70,0,1,0,1,0
21613,28,0,0,66,66,0,1,0,1,0
13031,28,0,0,70,70,0,1,0,1,0
12757,28,0,0,70,70,0,1,0,1,0
20957,28,0,0,66,66,0,1,0,1,0
14482,28,0,0,66,66,0,1,0,1,0
15914,28,0,0,70,70,0,1,0,1,0
16163,28,0,0,66,66,0,1,0,1,0
21934,28,0,0,66,66,0,1,0,1,0
14301,28,0,0,66,66,0,1,0,1,0
21061,28,0,0,70,70,0,1,0,1,0
17514,28,0,0,70,70,0,1,0,1,0
17292,28,0,0,66,66,0,1,0,1,0
9076,28,0,0,70,70,0,1,0,1,0
15973,28,0,0,66,66,0,1,0,1,0
21296,28,0,0,66,66,0,1,0,1,0
14236,28,0,0,70,70,0,1,0,1,0
9748,28,0,0,66,66,0,1,0,1,0
16438,28,0,0,70,70,0,1,0,1,0
9467,28,0,0,70,70,0,1,0,1,0
16234,28,0,0,66,66,0,1,0,1,0
22132,28,0,0,66,66,0,1,0,1,0
16024,28,0,0,66,66,0,1,0,1,0
19880,28,0,0,70,70,0,1,0,1,0
11164,28,0,0,70,70,0,1,0,1,0
19634,28,0,0,70,70,0,1,0,1,0
13360,28,0,0,66,66,0,1,0,1,0
9745,28,0,0,66,66,0,1,0,1,0
22391,28,0,0,70,70,0,1,0,1,0
12916,28,0,0,66,66,0,1,0,1,0
19823,28,0,0,70,70,0,1,0,1,0
12884,28,0,0,66,66,0,1,0,1,0
11791,28,0,0,66,66,0,1,0,1,0
17245,28,0,0,70,70,0,1,0,1,0
17207,28,0,0,70,70,0,1,0,1,0
12342,28,0,0,66,66,0,1,0,1,0
21719,28,0,0,70,70,0,1,0,1,0
16572,28,0,0,66,66,0,1,0,1,0
18945,28,0,0,70,70,0,1,0,1,0
22337,28,0,0,66,66,0,1,0,1,0
20675,28,0,0,70,70,0,1,0,1,0
10452,28,0,0,70,70,0,1,0,1,0
19134,28,0,0,66,66,0,1,0,1,0
16852,28,0,0,66,66,0,1,0,1,0
11614,28,0,0,66,66,0,1,0,1,0
17831,28,0,0,66,66,0,1,0,1,0
12470,28,0,0,70,70,0,1,0,1,0
18022,28,0,0,70,70,0,1,0,1,0
21183,28,0,0,70,70,0,1,0,1,0
10660,28,0,0,66,66,0,1,0,1,0
21809,28,0,0,66,66,0,1,0,1,0
19838,28,0,0,70,70,0,1,0,1,0
9852,28,0,0,66,66,0,1,0,1,0
20971,28,0,0,70,70,0,1,0,1,0
14555,28,0,0,70,70,0,1,0,1,0
21714,28,0,0,70,70,0,1,0,1,0
19774,28,0,0,66,66,0,1,0,1,0
11198,28,0,0,66,66,0,1,0,1,0
20503,28,0,0,70,70,0,1,0,1,0
22302,28,0,0,66,66,0,1,0,1,0
14458,28,0,0,70,70,0,1,0,1,0
9258,28,0,0,70,70,0,1,0,1,0
20277,28,0,0,70,70,0,1,0,1,0
14137,28,0,0,70,70,0,1,0,1,0
11650,28,0,0,70,70,0,1,0,1,0
14245,28,0,0,66,66,0,1,0,1,0
16449,28,0,0,66,66,0,1,0,1,0
18591,28,0,0,70,70,0,1,0,1,0
18757,28,0,0,70,70,0,1,0,1,0
9491,28,0,0,70,70,0,1,0,1,0
11364,28,0,0,66,66,0,1,0,1,0
21549,28,0,0,66,66,0,1,0,1,0
20152,28,0,0,70,70,0,1,0,1,0
10387,28,0,0,70,70,0,1,0,1,0
12714,28,0,0,70,70,0,1,0,1,0
11638,28,0,0,70,70,0,1,0,1,0
13448,28,0,0,70,70,0,1,0,1,0
11892,28,0,0,66,66,0,1,0,1,0
19609,28,0,0,70,70,0,1,0,1,0
13745,28,0,0,70,70,0,1,0,1,0
14269,28,0,0,70,70,0,1,0,1,0
18966,28,0,0,70,70,0,1,0,1,0
13879,28,0,0,70,70,0,1,0,1,0
12669,28,0,0,66,66,0,1,0,1,0
18932,28,0,0,66,66,0,1,0,1,0
16871,28,0,0,70,70,0,1,0,1,0
22705,28,0,0,70,70,0,1,0,1,0
21016,28,0,0,66,66,0,1,0,1,0
19252,28,0,0,70,70,0,1,0,1,0
22455,28,0,0,66,66,0,1,0,1,0
15730,28,0,0,70,70,0,1,0,1,0
20734,28,0,0,70,70,0,1,0,1,0
9400,28,0,0,70,70,0,1,0,1,0
13188,28,0,0,70,70,0,1,0,1,0
16968,28,0,0,70,70,0,1,0,1,0
21594,28,0,0,66,66,0,1,0,1,0
15705,28,0,0,66,66,0,1,0,1,0
9562,28,0,0,70,70,0,1,0,1,0
9716,28,0,0,70,70,0,1,0,1,0
13368,28,0,0,70,70,0,1,0,1,0
9654,28,0,0,70,70,0,1,0,1,0
18071,28,0,0,70,70,0,1,0,1,0
13100,28,0,0,66,66,0,1,0,1,0
20094,28,0,0,70,70,0,1,0,1,0
20884,28,0,0,66,66,0,1,0,1,0
17363,28,0,0,66,66,0,1,0,1,0
17702,28,0,0,70,70,0,1,0,1,0
21695,28,0,0,70,70,0,1,0,1,0
13263,28,0,0,70,70,0,1,0,1,0
15138,28,0,0,66,66,0,1,0,1,0
16055,28,0,0,70,70,0,1,0,1,0
21089,28,0,0,70,70,0,1,0,1,0
9520,28,0,0,70,70,0,1,0,1,0
15752,28,0,0,70,70,0,1,0,1,0
9888,28,0,0,70,70,0,1,0,1,0
16117,28,0,0,70,70,0,1,0,1,0
9044,28,0,0,70,70,0,1,0,1,0
20161,28,0,0,70,70,0,1,0,1,0
13432,28,0,0,70,70,0,1,0,1,0
21325,28,0,0,70,70,0,1,0,1,0
12013,28,0,0,66,66,0,1,0,1,0
16756,28,0,0,66,66,0,1,0,1,0
17093,28,0,0,66,66,0,1,0,1,0
21300,28,0,0,70,70,0,1,0,1,0
14801,28,0,0,70,70,0,1,0,1,0
18316,28,0,0,70,70,0,1,0,1,0
10658,28,0,0,70,70,0,1,0,1,0
17162,28,0,0,70,70,0,1,0,1,0
22560,28,0,0,70,70,0,1,0,1,0
10414,28,0,0,70,70,0,1,0,1,0
20267,28,0,0,70,70,0,1,0,1,0
12331,28,0,0,70,70,0,1,0,1,0
11882,28,0,0,70,70,0,1,0,1,0
8519,28,0,0,70,70,0,1,0,1,0
18843,28,0,0,70,70,0,1,0,1,0
20958,28,0,0,66,66,0,1,0,1,0
21956,28,0,0,66,66,0,1,0,1,0
10953,28,0,0,70,70,0,1,0,1,0
11540,28,0,0,70,70,0,1,0,1,0
9546,28,0,0,70,70,0,1,0,1,0
12826,28,0,0,66,66,0,1,0,1,0
19066,28,0,0,70,70,0,1,0,1,0
14089,28,0,0,70,70,0,1,0,1,0
16196,28,0,0,66,66,0,1,0,1,0
9444,28,0,0,70,70,0,1,0,1,0
16753,28,0,0,66,66,0,1,0,1,0
21681,28,0,0,66,66,0,1,0,1,0
14223,28,0,0,70,70,0,1,0,1,0
9904,28,0,0,70,70,0,1,0,1,0
12598,28,0,0,70,70,0,1,0,1,0
17696,28,0,0,66,66,0,1,0,1,0
13050,28,0,0,70,70,0,1,0,1,0
18780,28,0,0,66,66,0,1,0,1,0
9787,28,0,0,70,70,0,1,0,1,0
13427,28,0,0,70,70,0,1,0,1,0
17223,28,0,0,66,66,0,1,0,1,0
8880,28,0,0,66,66,0,1,0,1,0
15097,28,0,0,70,70,0,1,0,1,0
13638,28,0,0,66,66,0,1,0,1,0
20525,28,0,0,66,66,0,1,0,1,0
13943,28,0,0,70,70,0,1,0,1,0
13674,28,0,0,70,70,0,1,0,1,0
9700,28,0,0,70,70,0,1,0,1,0
13932,28,0,0,66,66,0,1,0,1,0
14077,28,0,0,70,70,0,1,0,1,0
19076,28,0,0,70,70,0,1,0,1,0
13806,28,0,0,70,70,0,1,0,1,0
21775,28,0,0,70,70,0,1,0,1,0
17421,28,0,0,70,70,0,1,0,1,0
15577,28,0,0,70,70,0,1,0,1,0
13270,28,0,0,66,66,0,1,0,1,0
9754,28,0,0,70,70,0,1,0,1,0
10191,28,0,0,70,70,0,1,0,1,0
14589,28,0,0,70,70,0,1,0,1,0
9764,28,0,0,66,66,0,1,0,1,0
22717,28,0,0,70,70,0,1,0,1,0
12080,28,0,0,70,70,0,1,0,1,0
21935,28,0,0,70,70,0,1,0,1,0
18141,28,0,0,70,70,0,1,0,1,0
11774,28,0,0,66,66,0,1,0,1,0
20383,28,0,0,66,66,0,1,0,1,0
18358,28,0,0,70,70,0,1,0,1,0
19407,28,0,0,66,66,0,1,0,1,0
15033,28,0,0,70,70,0,1,0,1,0
10219,28,0,0,70,70,0,1,0,1,0
17443,28,0,0,66,66,0,1,0,1,0
21997,28,0,0,70,70,0,1,0,1,0
10987,28,0,0,66,66,0,1,0,1,0
11317,28,0,0,70,70,0,1,0,1,0
16835,28,0,0,70,70,0,1,0,1,0
9398,28,0,0,66,66,0,1,0,1,0
20399,28,0,0,70,70,0,1,0,1,0
8945,28,0,0,66,66,0,1,0,1,0
9960,28,0,0,70,70,0,1,0,1,0
12374,28,0,0,70,70,0,1,0,1,0
11380,28,0,0,66,66,0,1,0,1,0
12433,28,0,0,70,70,0,1,0,1,0
18454,28,0,0,70,70,0,1,0,1,0
13313,28,0,0,66,66,0,1,0,1,0
9604,28,0,0,70,70,0,1,0,1,0
20801,28,0,0,70,70,0,1,0,1,0
20660,28,0,0,70,70,0,1,0,1,0
10175,28,0,0,70,70,0,1,0,1,0
22719,28,0,0,66,66,0,1,0,1,0
20178,28,0,0,70,70,0,1,0,1,0
19865,28,0,0,66,66,0,1,0,1,0
8492,28,0,0,70,70,0,1,0,1,0
18684,28,0,0,66,66,0,1,0,1,0
11042,28,0,0,66,66,0,1,0,1,0
11235,28,0,0,70,70,0,1,0,1,0
9259,28,0,0,66,66,0,1,0,1,0
15347,28,0,0,70,70,0,1,0,1,0
11333,28,0,0,70,70,0,1,0,1,0
19189,28,0,0,66,66,0,1,0,1,0
19570,28,0,0,70,70,0,1,0,1,0
19098,28,0,0,70,70,0,1,0,1,0
20141,28,0,0,70,70,0,1,0,1,0
10151,28,0,0,70,70,0,1,0,1,0
15940,28,0,0,70,70,0,1,0,1,0
16323,28,0,0,70,70,0,1,0,1,0
15213,28,0,0,70,70,0,1,0,1,0
19987,28,0,0,70,70,0,1,0,1,0
21872,28,0,0,70,70,0,1,0,1,0
10081,28,0,0,70,70,0,1,0,1,0
11997,28,0,0,70,70,0,1,0,1,0
17921,28,0,0,70,70,0,1,0,1,0
12653,28,0,0,70,70,0,1,0,1,0
22450,28,0,0,70,70,0,1,0,1,0
17440,28,0,0,66,66,0,1,0,1,0
9626,28,0,0,70,70,0,1,0,1,0
19501,28,0,0,70,70,0,1,0,1,0
20406,28,0,0,70,70,0,1,0,1,0
10150,28,0,0,70,70,0,1,0,1,0
13995,28,0,0,70,70,0,1,0,1,0
12232,28,0,0,70,70,0,1,0,1,0
19059,28,0,0,70,70,0,1,0,1,0
17845,28,0,0,70,70,0,1,0,1,0
19945,28,0,0,66,66,0,1,0,1,0
20373,28,0,0,70,70,0,1,0,1,0
16079,28,0,0,70,70,0,1,0,1,0
9420,28,0,0,66,66,0,1,0,1,0
19956,28,0,0,70,70,0,1,0,1,0
21325,28,0,0,70,70,0,1,0,1,0
21097,28,0,0,70,70,0,1,0,1,0
13230,28,0,0,66,66,0,1,0,1,0
22430,28,0,0,70,70,0,1,0,1,0
14137,28,0,0,70,70,0,1,0,1,0
14909,28,0,0,66,66,0,1,0,1,0
20791,28,0,0,66,66,0,1,0,1,0
13541,28,0,0,70,70,0,1,0,1,0
21886,28,0,0,70,70,0,1,0,1,0
22672,28,0,0,70,70,0,1,0,1,0
9565,28,0,0,70,70,0,1,0,1,0
11452,28,0,0,70,70,0,1,0,1,0
18892,28,0,0,70,70,0,1,0,1,0
10251,28,0,0,70,70,0,1,0,1,0
19457,28,0,0,70,70,0,1,0,1,0
9729,28,0,0,70,70,0,1,0,1,0
18697,28,0,0,70,70,0,1,0,1,0
18226,28,0,0,70,70,0,1,0,1,0
11429,28,0,0,70,70,0,1,0,1,0
9279,28,0,0,70,70,0,1,0,1,0
20201,28,0,0,66,66,0,1,0,1,0
10434,28,0,0,66,66,0,1,0,1,0
9016,28,0,0,70,70,0,1,0,1,0
16513,28,0,0,66,66,0,1,0,1,0
21770,28,0,0,70,70,0,1,0,1,0
21085,28,0,0,70,70,0,1,0,1,0
22559,28,0,0,70,70,0,1,0,1,0
19746,28,0,0,70,70,0,1,0,1,0
21988,28,0,0,66,66,0,1,0,1,0
22297,28,0,0,70,70,0,1,0,1,0
20946,28,0,0,70,70,0,1,0,1,0
17290,28,0,0,70,70,0,1,0,1,0
18319,28,0,0,66,66,0,1,0,1,0
21213,28,0,0,66,66,0,1,0,1,0
13722,28,0,0,70,70,0,1,0,1,0
19371,28,0,0,70,70,0,1,0,1,0
20952,28,0,0,70,70,0,1,0,1,0
16173,28,0,0,70,70,0,1,0,1,0
20823,28,0,0,70,70,0,1,0,1,0
20700,28,0,0,70,70,0,1,0,1,0
17135,28,0,0,66,66,0,1,0,1,0
19626,28,0,0,70,70,0,1,0,1,0
21148,28,0,0,70,70,0,1,0,1,0
18774,28,0,0,66,66,0,1,0,1,0
16455,28,0,0,66,66,0,1,0,1,0
16784,28,0,0,70,70,0,1,0,1,0
17862,28,0,0,70,70,0,1,0,1,0
19880,28,0,0,70,70,0,1,0,1,0
16926,28,0,0,70,70,0,1,0,1,0
11228,28,0,0,70,70,0,1,0,1,0
20969,28,0,0,70,70,0,1,0,1,0
15184,28,0,0,66,66,0,1,0,1,0
10743,28,0,0,66,66,0,1,0,1,0
9102,28,0,0,70,70,0,1,0,1,0
13822,28,0,0,70,70,0,1,0,1,0
14475,28,0,0,66,66,0,1,0,1,0
15881,28,0,0,70,70,0,1,0,1,0
22400,28,0,0,66,66,0,1,0,1,0
8356,28,0,0,70,70,0,1,0,1,0
20228,28,0,0,70,70,0,1,0,1,0
15718,28,0,0,66,66,0,1,0,1,0
13430,28,0,0,70,70,0,1,0,1,0
16083,28,0,0,66,66,0,1,0,1,0
12779,28,0,0,66,66,0,1,0,1,0
20611,28,0,0,66,66,0,1,0,1,0
9647,28,0,0,66,66,0,1,0,1,0
10282,28,0,0,70,70,0,1,0,1,0
8978,28,0,0,70,70,0,1,0,1,0
16385,28,0,0,66,66,0,1,0,1,0
10412,28,0,0,70,70,0,1,0,1,0
17040,28,0,0,70,70,0,1,0,1,0
20396,28,0,0,66,66,0,1,0,1,0
20326,28,0,0,70,70,0,1,0,1,0
9087,28,0,0,70,70,0,1,0,1,0
21702,28,0,0,70,70,0,1,0,1,0
20769,28,0,0,70,70,0,1,0,1,0
19736,28,0,0,70,70,0,1,0,1,0
11237,28,0,0,70,70,0,1,0,1,0
18373,28,0,0,66,66,0,1,0,1,0
21408,28,0,0,70,70,0,1,0,1,0
9661,28,0,0,70,70,0,1,0,1,0
21199,28,0,0,66,66,0,1,0,1,0
16742,28,0,0,66,66,0,1,0,1,0
22103,28,0,0,70,70,0,1,0,1,0
17223,28,0,0,70,70,0,1,0,1,0
17086,28,0,0,70,70,0,1,0,1,0
15890,28,0,0,66,66,0,1,0,1,0
20747,28,0,0,66,66,0,1,0,1,0
8409,28,0,0,70,70,0,1,0,1,0
18711,28,0,0,70,70,0,1,0,1,0
14883,28,0,0,70,70,0,1,0,1,0
15661,28,0,0,70,70,0,1,0,1,0
20169,28,0,0,66,66,0,1,0,1,0
17252,28,0,0,66,66,0,1,0,1,0
9781,28,0,0,66,66,0,1,0,1,0
15614,28,0,0,70,70,0,1,0,1,0
14080,28,0,0,70,70,0,1,0,1,0
19467,28,0,0,70,70,0,1,0,1,0
21962,28,0,0,66,66,0,1,0,1,0
20151,28,0,0,70,70,0,1,0,1,0
16428,28,0,0,70,70,0,1,0,1,0
20367,28,0,0,70,70,0,1,0,1,0
12349,28,0,0,70,70,0,1,0,1,0
10856,28,0,0,70,70,0,1,0,1,0
12443,28,0,0,70,70,0,1,0,1,0
16813,28,0,0,70,70,0,1,0,1,0
11995,28,0,0,70,70,0,1,0,1,0
11548,28,0,0,66,66,0,1,0,1,0
13810,28,0,0,66,66,0,1,0,1,0
9349,28,0,0,66,66,0,1,0,1,0
20728,28,0,0,66,66,0,1,0,1,0
13709,28,0,0,70,70,0,1,0,1,0
16566,28,0,0,70,70,0,1,0,1,0
13722,28,0,0,70,70,0,1,0,1,0
22268,28,0,0,70,70,0,1,0,1,0
13788,28,0,0,70,70,0,1,0,1,0
21793,28,0,0,70,70,0,1,0,1,0
15814,28,0,0,70,70,0,1,0,1,0
9449,28,0,0,70,70,0,1,0,1,0
19378,28,0,0,70,70,0,1,0,1,0
18406,28,0,0,66,66,0,1,0,1,0
19619,28,0,0,66,66,0,1,0,1,0
9726,28,0,0,70,70,0,1,0,1,0
17458,28,0,0,66,66,0,1,0,1,0
17002,28,0,0,70,70,0,1,0,1,0
13170,28,0,0,66,66,0,1,0,1,0
10195,28,0,0,66,66,0,1,0,1,0
10010,28,0,0,70,70,0,1,0,1,0
8371,28,0,0,66,66,0,1,0,1,0
20302,28,0,0,70,70,0,1,0,1,0
15014,28,0,0,66,66,0,1,0,1,0
15009,28,0,0,70,70,0,1,0,1,0
10092,28,0,0,66,66,0,1,0,1,0
12207,28,0,0,66,66,0,1,0,1,0
10504,28,0,0,66,66,0,1,0,1,0
19971,28,0,0,70,70,0,1,0,1,0
16305,28,0,0,70,70,0,1,0,1,0
13462,28,0,0,70,70,0,1,0,1,0
9281,28,0,0,70,70,0,1,0,1,0
16557,28,0,0,70,70,0,1,0,1,0
15067,28,0,0,70,70,0,1,0,1,0
19855,28,0,0,70,70,0,1,0,1,0
12656,28,0,0,70,70,0,1,0,1,0
11172,28,0,0,70,70,0,1,0,1,0
20325,28,0,0,66,66,0,1,0,1,0
9945,28,0,0,70,70,0,1,0,1,0
16871,28,0,0,70,70,0,1,0,1,0
18804,28,0,0,70,70,0,1,0,1,0
13202,28,0,0,70,70,0,1,0,1,0
8609,28,0,0,70,70,0,1,0,1,0
13938,28,0,0,66,66,0,1,0,1,0
10349,28,0,0,66,66,0,1,0,1,0
10574,28,0,0,66,66,0,1,0,1,0
17061,28,0,0,66,66,0,1,0,1,0
17701,28,0,0,66,66,0,1,0,1,0
19039,28,0,0,66,66,0,1,0,1,0
12112,28,0,0,66,66,0,1,0,1,0
20220,28,0,0,70,70,0,1,0,1,0
21533,28,0,0,70,70,0,1,0,1,0
10002,28,0,0,70,70,0,1,0,1,0
21011,28,0,0,66,66,0,1,0,1,0
18499,28,0,0,66,66,0,1,0,1,0
19151,28,0,0,66,66,0,1,0,1,0
17041,28,0,0,66,66,0,1,0,1,0
10239,28,0,0,66,66,0,1,0,1,0
10910,28,0,0,70,70,0,1,0,1,0
19139,28,0,0,70,70,0,1,0,1,0
9608,28,0,0,70,70,0,1,0,1,0
13163,28,0,0,70,70,0,1,0,1,0
18732,28,0,0,66,66,0,1,0,1,0
16209,28,0,0,70,70,0,1,0,1,0
17649,28,0,0,66,66,0,1,0,1,0
15967,28,0,0,66,66,0,1,0,1,0
18417,28,0,0,70,70,0,1,0,1,0
11732,28,0,0,70,70,0,1,0,1,0
9433,28,0,0,66,66,0,1,0,1,0
8518,28,0,0,70,70,0,1,0,1,0
22276,28,0,0,70,70,0,1,0,1,0
21547,28,0,0,66,66,0,1,0,1,0
13325,28,0,0,66,66,0,1,0,1,0
19833,28,0,0,66,66,0,1,0,1,0
11722,28,0,0,66,66,0,1,0,1,0
18963,28,0,0,66,66,0,1,0,1,0
20523,28,0,0,70,70,0,1,0,1,0
21829,28,0,0,70,70,0,1,0,1,0
15518,28,0,0,70,70,0,1,0,1,0
8768,28,0,0,70,70,0,1,0,1,0
17791,28,0,0,70,70,0,1,0,1,0
16631,28,0,0,70,70,0,1,0,1,0
19778,28,0,0,66,66,0,1,0,1,0
20154,28,0,0,66,66,0,1,0,1,0
15762,28,0,0,66,66,0,1,0,1,0
17395,28,0,0,66,66,0,1,0,1,0
17533,28,0,0,70,70,0,1,0,1,0
20998,28,0,0,70,70,0,1,0,1,0
16544,28,0,0,66,66,0,1,0,1,0
13993,28,0,0,70,70,0,1,0,1,0
14228,28,0,0,66,66,0,1,0,1,0
12885,28,0,0,66,66,0,1,0,1,0
21472,28,0,0,70,70,0,1,0,1,0
19298,28,0,0,66,66,0,1,0,1,0
18607,28,0,0,70,70,0,1,0,1,0
20198,28,0,0,70,70,0,1,0,1,0
16172,28,0,0,70,70,0,1,0,1,0
11866,28,0,0,70,70,0,1,0,1,0
12122,28,0,0,70,70,0,1,0,1,0
9798,28,0,0,66,66,0,1,0,1,0
21294,28,0,0,66,66,0,1,0,1,0
12880,28,0,0,70,70,0,1,0,1,0
8854,28,0,0,70,70,0,1,0,1,0
14341,28,0,0,70,70,0,1,0,1,0
18375,28,0,0,66,66,0,1,0,1,0
11725,28,0,0,66,66,0,1,0,1,0
19463,28,0,0,70,70,0,1,0,1,0
12178,28,0,0,66,66,0,1,0,1,0
8999,28,0,0,70,70,0,1,0,1,0
10087,28,0,0,70,70,0,1,0,1,0
17721,28,0,0,70,70,0,1,0,1,0
12255,28,0,0,70,70,0,1,0,1,0
20955,28,0,0,70,70,0,1,0,1,0
18469,28,0,0,66,66,0,1,0,1,0
14972,28,0,0,66,66,0,1,0,1,0
20691,28,0,0,70,70,0,1,0,1,0
18219,28,0,0,66,66,0,1,0,1,0
14124,28,0,0,70,70,0,1,0,1,0
9769,28,0,0,70,70,0,1,0,1,0
9706,28,0,0,66,66,0,1,0,1,0
19123,28,0,0,70,70,0,1,0,1,0
9598,28,0,0,70,70,0,1,0,1,0
17851,28,0,0,70,70,0,1,0,1,0
14615,28,0,0,66,66,0,1,0,1,0
9624,28,0,0,66,66,0,1,0,1,0
16520,28,0,0,66,66,0,1,0,1,0
20251,28,0,0,70,70,0,1,0,1,0
12407,28,0,0,70,70,0,1,0,1,0
19710,28,0,0,66,66,0,1,0,1,0
20498,28,0,0,70,70,0,1,0,1,0
18543,28,0,0,70,70,0,1,0,1,0
9297,28,0,0,70,70,0,1,0,1,0
16254,28,0,0,70,70,0,1,0,1,0
21599,28,0,0,70,70,0,1,0,1,0
21150,28,0,0,66,66,0,1,0,1,0
15495,28,0,0,70,70,0,1,0,1,0
20366,28,0,0,70,70,0,1,0,1,0
12031,28,0,0,66,66,0,1,0,1,0
13898,28,0,0,70,70,0,1,0,1,0
14219,28,0,0,70,70,0,1,0,1,0
9347,28,0,0,70,70,0,1,0,1,0
13113,28,0,0,70,70,0,1,0,1,0
8950,28,0,0,70,70,0,1,0,1,0
8876,28,0,0,70,70,0,1,0,1,0
11174,28,0,0,70,70,0,1,0,1,0
19773,28,0,0,66,66,0,1,0,1,0
12163,28,0,0,70,70,0,1,0,1,0
11394,28,0,0,66,66,0,1,0,1,0
12692,28,0,0,70,70,0,1,0,1,0
20136,28,0,0,70,70,0,1,0,1,0
19784,28,0,0,70,70,0,1,0,1,0
13902,28,0,0,70,70,0,1,0,1,0
14087,28,0,0,70,70,0,1,0,1,0
12947,28,0,0,70,70,0,1,0,1,0
21629,28,0,0,70,70,0,1,0,1,0
22671,28,0,0,70,70,0,1,0,1,0
18779,28,0,0,66,66,0,1,0,1,0
14485,28,0,0,66,66,0,1,0,1,0
18331,28,0,0,70,70,0,1,0,1,0
11938,28,0,0,70,70,0,1,0,1,0
14154,28,0,0,70,70,0,1,0,1,0
18348,28,0,0,70,70,0,1,0,1,0
16842,28,0,0,66,66,0,1,0,1,0
10835,28,0,0,70,70,0,1,0,1,0
22420,28,0,0,70,70,0,1,0,1,0
14694,28,0,0,70,70,0,1,0,1,0
19653,28,0,0,66,66,0,1,0,1,0
16691,28,0,0,70,70,0,1,0,1,0
19688,28,0,0,66,66,0,1,0,1,0
17255,28,0,0,70,70,0,1,0,1,0
12453,28,0,0,66,66,0,1,0,1,0
10362,28,0,0,66,66,0,1,0,1,0
20856,28,0,0,70,70,0,1,0,1,0
17358,28,0,0,66,66,0,1,0,1,0
9773,28,0,0,66,66,0,1,0,1,0
22342,28,0,0,66,66,0,1,0,1,0
16326,28,0,0,66,66,0,1,0,1,0
16738,28,0,0,70,70,0,1,0,1,0
8809,28,0,0,70,70,0,1,0,1,0
18024,28,0,0,70,70,0,1,0,1,0
11926,28,0,0,70,70,0,1,0,1,0
13532,28,0,0,70,70,0,1,0,1,0
16612,28,0,0,66,66,0,1,0,1,0
20891,28,0,0,70,70,0,1,0,1,0
19496,28,0,0,70,70,0,1,0,1,0
20292,28,0,0,66,66,0,1,0,1,0
8684,28,0,0,70,70,0,1,0,1,0
9749,28,0,0,70,70,0,1,0,1,0
9815,28,0,0,66,66,0,1,0,1,0
21797,28,0,0,70,70,0,1,0,1,0
21123,28,0,0,66,66,0,1,0,1,0
15985,28,0,0,70,70,0,1,0,1,0
22595,28,0,0,70,70,0,1,0,1,0
20886,28,0,0,70,70,0,1,0,1,0
21085,28,0,0,66,66,0,1,0,1,0
17106,28,0,0,70,70,0,1,0,1,0
16351,28,0,0,70,70,0,1,0,1,0
14788,28,0,0,70,70,0,1,0,1,0
9992,28,0,0,66,66,0,1,0,1,0
11464,28,0,0,70,70,0,1,0,1,0
16252,28,0,0,70,70,0,1,0,1,0
18227,28,0,0,70,70,0,1,0,1,0
14943,28,0,0,70,70,0,1,0,1,0
12480,28,0,0,70,70,0,1,0,1,0
21742,28,0,0,66,66,0,1,0,1,0
15711,28,0,0,70,70,0,1,0,1,0
12430,28,0,0,70,70,0,1,0,1,0
16048,28,0,0,70,70,0,1,0,1,0
17092,28,0,0,70,70,0,1,0,1,0
11733,28,0,0,66,66,0,1,0,1,0
9197,28,0,0,70,70,0,1,0,1,0
17470,28,0,0,66,66,0,1,0,1,0
15788,28,0,0,70,70,0,1,0,1,0
22239,28,0,0,70,70,0,1,0,1,0
20414,28,0,0,70,70,0,1,0,1,0
11828,28,0,0,70,70,0,1,0,1,0
21333,28,0,0,70,70,0,1,0,1,0
9325,28,0,0,70,70,0,1,0,1,0
15238,28,0,0,70,70,0,1,0,1,0
14099,28,0,0,70,70,0,1,0,1,0
9368,28,0,0,70,70,0,1,0,1,0
15248,28,0,0,70,70,0,1,0,1,0
19435,28,0,0,70,70,0,1,0,1,0
18311,28,0,0,70,70,0,1,0,1,0
8909,28,0,0,66,66,0,1,0,1,0
19299,28,0,0,70,70,0,1,0,1,0
19989,28,0,0,70,70,0,1,0,1,0
15834,28,0,0,66,66,0,1,0,1,0
8586,28,0,0,70,70,0,1,0,1,0
15819,28,0,0,70,70,0,1,0,1,0
10029,28,0,0,70,70,0,1,0,1,0
11984,28,0,0,66,66,0,1,0,1,0
20204,28,0,0,66,66,0,1,0,1,0
21877,28,0,0,70,70,0,1,0,1,0
18757,28,0,0,70,70,0,1,0,1,0
19088,28,0,0,66,66,0,1,0,1,0
14663,28,0,0,70,70,0,1,0,1,0
14575,28,0,0,70,70,0,1,0,1,0
11242,28,0,0,66,66,0,1,0,1,0
15575,28,0,0,70,70,0,1,0,1,0
21841,28,0,0,66,66,0,1,0,1,0
13338,28,0,0,66,66,0,1,0,1,0
15479,28,0,0,70,70,0,1,0,1,0
18381,28,0,0,66,66,0,1,0,1,0
17309,28,0,0,70,70,0,1,0,1,0
11666,28,0,0,66,66,0,1,0,1,0
17014,28,0,0,66,66,0,1,0,1,0
20739,28,0,0,70,70,0,1,0,1,0
15224,28,0,0,66,66,0,1,0,1,0
17515,28,0,0,70,70,0,1,0,1,0
21462,28,0,0,70,70,0,1,0,1,0
16571,28,0,0,70,70,0,1,0,1,0
18705,28,0,0,70,70,0,1,0,1,0
15089,28,0,0,70,70,0,1,0,1,0
14836,28,0,0,66,66,0,1,0,1,0
11946,28,0,0,70,70,0,1,0,1,0
18842,28,0,0,70,70,0,1,0,1,0
19551,28,0,0,66,66,0,1,0,1,0
16459,28,0,0,70,70,0,1,0,1,0
9868,28,0,0,66,66,0,1,0,1,0
19698,28,0,0,66,66,0,1,0,1,0
21713,28,0,0,70,70,0,1,0,1,0
11388,28,0,0,66,66,0,1,0,1,0
13857,28,0,0,66,66,0,1,0,1,0
13605,28,0,0,70,70,0,1,0,1,0
14163,28,0,0,70,70,0,1,0,1,0
18073,28,0,0,70,70,0,1,0,1,0
19320,28,0,0,70,70,0,1,0,1,0
17624,28,0,0,70,70,0,1,0,1,0
12756,28,0,0,70,70,0,1,0,1,0
10165,28,0,0,66,66,0,1,0,1,0
14249,28,0,0,70,70,0,1,0,1,0
21378,28,0,0,66,66,0,1,0,1,0
14945,28,0,0,70,70,0,1,0,1,0
12130,28,0,0,66,66,0,1,0,1,0
22436,28,0,0,70,70,0,1,0,1,0
10513,28,0,0,66,66,0,1,0,1,0
19809,28,0,0,70,70,0,1,0,1,0
14543,28,0,0,66,66,0,1,0,1,0
10655,28,0,0,66,66,0,1,0,1,0
14151,28,0,0,70,70,0,1,0,1,0
8338,28,0,0,70,70,0,1,0,1,0
18419,28,0,0,66,66,0,1,0,1,0
17405,28,0,0,70,70,0,1,0,1,0
12822,28,0,0,70,70,0,1,0,1,0
20609,28,0,0,70,70,0,1,0,1,0
21787,28,0,0,70,70,0,1,0,1,0
11326,28,0,0,70,70,0,1,0,1,0
14429,28,0,0,66,66,0,1,0,1,0
16366,28,0,0,70,70,0,1,0,1,0
18007,28,0,0,66,66,0,1,0,1,0
19142,28,0,0,70,70,0,1,0,1,0
13724,28,0,0,70,70,0,1,0,1,0
22305,28,0,0,70,70,0,1,0,1,0
13877,28,0,0,70,70,0,1,0,1,0
17473,28,0,0,70,70,0,1,0,1,0
20620,28,0,0,66,66,0,1,0,1,0
21138,28,0,0,70,70,0,1,0,1,0
20309,28,0,0,70,70,0,1,0,1,0
18407,28,0,0,70,70,0,1,0,1,0
18718,28,0,0,66,66,0,1,0,1,0
22113,28,0,0,70,70,0,1,0,1,0
17609,28,0,0,70,70,0,1,0,1,0
8629,28,0,0,70,70,0,1,0,1,0
9961,28,0,0,70,70,0,1,0,1,0
16286,28,0,0,66,66,0,1,0,1,0
19633,28,0,0,70,70,0,1,0,1,0
16033,28,0,0,70,70,0,1,0,1,0
18867,28,0,0,70,70,0,1,0,1,0
14178,28,0,0,66,66,0,1,0,1,0
21469,28,0,0,70,70,0,1,0,1,0
16610,28,0,0,66,66,0,1,0,1,0
13912,28,0,0,70,70,0,1,0,1,0
10360,28,0,0,70,70,0,1,0,1,0
14563,28,0,0,70,70,0,1,0,1,0
13741,28,0,0,70,70,0,1,0,1,0
14122,28,0,0,70,70,0,1,0,1,0
22382,28,0,0,70,70,0,1,0,1,0
18174,28,0,0,66,66,0,1,0,1,0
16904,28,0,0,66,66,0,1,0,1,0
9439,28,0,0,70,70,0,1,0,1,0
21750,28,0,0,70,70,0,1,0,1,0
17907,28,0,0,66,66,0,1,0,1,0
22112,28,0,0,70,70,0,1,0,1,0
19597,28,0,0,66,66,0,1,0,1,0
15411,28,0,0,70,70,0,1,0,1,0
19412,28,0,0,66,66,0,1,0,1,0
9655,28,0,0,66,66,0,1,0,1,0
9129,28,0,0,70,70,0,1,0,1,0
14782,28,0,0,70,70,0,1,0,1,0
10636,28,0,0,66,66,0,1,0,1,0
21870,28,0,0,70,70,0,1,0,1,0
14528,28,0,0,70,70,0,1,0,1,0
18629,28,0,0,70,70,0,1,0,1,0
11345,28,0,0,66,66,0,1,0,1,0
9227,28,0,0,70,70,0,1,0,1,0
21375,28,0,0,66,66,0,1,0,1,0
10312,28,0,0,70,70,0,1,0,1,0
12488,28,0,0,66,66,0,1,0,1,0
22099,28,0,0,70,70,0,1,0,1,0
19735,28,0,0,66,66,0,1,0,1,0
21527,28,0,0,70,70,0,1,0,1,0
9315,28,0,0,66,66,0,1,0,1,0
17696,28,0,0,70,70,0,1,0,1,0
11594,28,0,0,70,70,0,1,0,1,0
22488,28,0,0,70,70,0,1,0,1,0
17766,28,0,0,70,70,0,1,0,1,0
14010,28,0,0,70,70,0,1,0,1,0
16418,28,0,0,66,66,0,1,0,1,0
22390,28,0,0,70,70,0,1,0,1,0
22710,28,0,0,66,66,0,1,0,1,0
9487,28,0,0,66,66,0,1,0,1,0
21112,28,0,0,70,70,0,1,0,1,0
10174,28,0,0,70,70,0,1,0,1,0
20874,28,0,0,66,66,0,1,0,1,0
19118,28,0,0,70,70,0,1,0,1,0
10162,28,0,0,70,70,0,1,0,1,0
16773,28,0,0,66,66,0,1,0,1,0
16776,28,0,0,70,70,0,1,0,1,0
21088,28,0,0,70,70,0,1,0,1,0
21493,28,0,0,70,70,0,1,0,1,0
19470,28,0,0,70,70,0,1,0,1,0
9938,28,0,0,70,70,0,1,0,1,0
14585,28,0,0,70,70,0,1,0,1,0
13737,28,0,0,70,70,0,1,0,1,0
19889,28,0,0,66,66,0,1,0,1,0
10107,28,0,0,66,66,0,1,0,1,0
12362,28,0,0,66,66,0,1,0,1,0
19298,28,0,0,70,70,0,1,0,1,0
18735,28,0,0,70,70,0,1,0,1,0
16929,28,0,0,70,70,0,1,0,1,0
19049,28,0,0,70,70,0,1,0,1,0
14222,28,0,0,66,66,0,1,0,1,0
11434,28,0,0,70,70,0,1,0,1,0
19818,28,0,0,66,66,0,1,0,1,0
16679,28,0,0,70,70,0,1,0,1,0
21803,28,0,0,70,70,0,1,0,1,0
15626,28,0,0,70,70,0,1,0,1,0
10453,28,0,0,66,66,0,1,0,1,0
14973,28,0,0,66,66,0,1,0,1,0
12127,28,0,0,66,66,0,1,0,1,0
8823,28,0,0,70,70,0,1,0,1,0
13315,28,0,0,70,70,0,1,0,1,0
13399,28,0,0,66,66,0,1,0,1,0
19452,28,0,0,66,66,0,1,0,1,0
10716,28,0,0,66,66,0,1,0,1,0
18434,28,0,0,66,66,0,1,0,1,0
18583,28,0,0,66,66,0,1,0,1,0
17563,28,0,0,70,70,0,1,0,1,0
17099,28,0,0,70,70,0,1,0,1,0
10912,28,0,0,66,66,0,1,0,1,0
21252,28,0,0,66,66,0,1,0,1,0
14262,28,0,0,70,70,0,1,0,1,0
20083,28,0,0,66,66,0,1,0,1,0
9542,28,0,0,66,66,0,1,0,1,0
16698,28,0,0,70,70,0,1,0,1,0
12355,28,0,0,70,70,0,1,0,1,0
17238,28,0,0,66,66,0,1,0,1,0
16822,28,0,0,70,70,0,1,0,1,0
10440,28,0,0,70,70,0,1,0,1,0
9770,28,0,0,66,66,0,1,0,1,0
14581,28,0,0,70,70,0,1,0,1,0
18835,28,0,0,66,66,0,1,0,1,0
19694,28,0,0,66,66,0,1,0,1,0
10388,28,0,0,70,70,0,1,0,1,0
13644,28,0,0,70,70,0,1,0,1,0
11320,28,0,0,66,66,0,1,0,1,0
13879,28,0,0,70,70,0,1,0,1,0
10560,28,0,0,66,66,0,1,0,1,0
16177,28,0,0,70,70,0,1,0,1,0
19056,28,0,0,66,66,0,1,0,1,0
18925,28,0,0,70,70,0,1,0,1,0
17654,28,0,0,70,70,0,1,0,1,0
14746,28,0,0,66,66,0,1,0,1,0
17139,28,0,0,70,70,0,1,0,1,0
17647,28,0,0,70,70,0,1,0,1,0
13272,28,0,0,70,70,0,1,0,1,0
22059,28,0,0,70,70,0,1,0,1,0
20511,28,0,0,66,66,0,1,0,1,0
10492,28,0,0,70,70,0,1,0,1,0
13616,28,0,0,66,66,0,1,0,1,0
15510,28,0,0,70,70,0,1,0,1,0
10276,28,0,0,66,66,0,1,0,1,0
12022,28,0,0,70,70,0,1,0,1,0
9559,28,0,0,66,66,0,1,0,1,0
10855,28,0,0,70,70,0,1,0,1,0
14845,28,0,0,70,70,0,1,0,1,0
12693,28,0,0,70,70,0,1,0,1,0
13314,28,0,0,70,70,0,1,0,1,0
16652,28,0,0,70,70,0,1,0,1,0
16186,28,0,0,70,70,0,1,0,1,0
19102,28,0,0,70,70,0,1,0,1,0
13254,28,0,0,70,70,0,1,0,1,0
16354,28,0,0,70,70,0,1,0,1,0
16793,28,0,0,70,70,0,1,0,1,0
17841,28,0,0,66,66,0,1,0,1,0
12469,28,0,0,66,66,0,1,0,1,0
18360,28,0,0,70,70,0,1,0,1,0
14773,28,0,0,70,70,0,1,0,1,0
14421,28,0,0,70,70,0,1,0,1,0
12239,28,0,0,70,70,0,1,0,1,0
17522,28,0,0,70,70,0,1,0,1,0
18959,28,0,0,70,70,0,1,0,1,0
15250,28,0,0,70,70,0,1,0,1,0
12489,28,0,0,70,70,0,1,0,1,0
9100,28,0,0,70,70,0,1,0,1,0
13585,28,0,0,70,70,0,1,0,1,0
16812,28,0,0,70,70,0,1,0,1,0
19238,28,0,0,66,66,0,1,0,1,0
10043,28,0,0,70,70,0,1,0,1,0
19706,28,0,0,66,66,0,1,0,1,0
13807,28,0,0,70,70,0,1,0,1,0
19770,28,0,0,70,70,0,1,0,1,0
18752,28,0,0,70,70,0,1,0,1,0
8434,28,0,0,66,66,0,1,0,1,0
13936,28,0,0,66,66,0,1,0,1,0
14925,28,0,0,66,66,0,1,0,1,0
17556,28,0,0,70,70,0,1,0,1,0
13181,28,0,0,70,70,0,1,0,1,0
12719,28,0,0,66,66,0,1,0,1,0
14374,28,0,0,70,70,0,1,0,1,0
10233,28,0,0,70,70,0,1,0,1,0
11527,28,0,0,70,70,0,1,0,1,0
17591,28,0,0,70,70,0,1,0,1,0
16902,28,0,0,70,70,0,1,0,1,0
20853,28,0,0,70,70,0,1,0,1,0
19193,28,0,0,66,66,0,1,0,1,0
12175,28,0,0,70,70,0,1,0,1,0
14952,28,0,0,66,66,0,1,0,1,0
17506,28,0,0,66,66,0,1,0,1,0
19599,28,0,0,70,70,0,1,0,1,0
14759,28,0,0,70,70,0,1,0,1,0
8935,28,0,0,70,70,0,1,0,1,0
9509,28,0,0,66,66,0,1,0,1,0
11378,28,0,0,66,66,0,1,0,1,0
22563,28,0,0,70,70,0,1,0,1,0
10316,28,0,0,66,66,0,1,0,1,0
20114,28,0,0,70,70,0,1,0,1,0
16293,28,0,0,70,70,0,1,0,1,0
18294,28,0,0,70,70,0,1,0,1,0
9074,28,0,0,66,66,0,1,0,1,0
15546,28,0,0,70,70,0,1,0,1,0
9905,28,0,0,70,70,0,1,0,1,0
16515,28,0,0,70,70,0,1,0,1,0
10196,28,0,0,70,70,0,1,0,1,0
21700,28,0,0,70,70,0,1,0,1,0
20496,28,0,0,70,70,0,1,0,1,0
21846,28,0,0,66,66,0,1,0,1,0
14279,28,0,0,70,70,0,1,0,1,0
15388,28,0,0,70,70,0,1,0,1,0
21667,28,0,0,66,66,0,1,0,1,0
13956,28,0,0,66,66,0,1,0,1,0
13910,28,0,0,70,70,0,1,0,1,0
8513,28,0,0,70,70,0,1,0,1,0
11649,28,0,0,70,70,0,1,0,1,0
14996,28,0,0,70,70,0,1,0,1,0
9323,28,0,0,70,70,0,1,0,1,0
13692,28,0,0,70,70,0,1,0,1,0
17710,28,0,0,66,66,0,1,0,1,0
19192,28,0,0,70,70,0,1,0,1,0
17828,28,0,0,70,70,0,1,0,1,0
11610,28,0,0,70,70,0,1,0,1,0
15533,28,0,0,70,70,0,1,0,1,0
14725,28,0,0,70,70,0,1,0,1,0
20214,28,0,0,70,70,0,1,0,1,0
13434,28,0,0,70,70,0,1,0,1,0
9897,28,0,0,70,70,0,1,0,1,0
10235,28,0,0,66,66,0,1,0,1,0
20107,28,0,0,70,70,0,1,0,1,0
11937,28,0,0,66,66,0,1,0,1,0
18847,28,0,0,70,70,0,1,0,1,0
18664,28,0,0,70,70,0,1,0,1,0
20979,28,0,0,70,70,0,1,0,1,0
9282,28,0,0,70,70,0,1,0,1,0
19909,28,0,0,70,70,0,1,0,1,0
11257,28,0,0,70,70,0,1,0,1,0
20844,28,0,0,70,70,0,1,0,1,0
22071,28,0,0,66,66,0,1,0,1,0
10911,28,0,0,66,66,0,1,0,1,0
13425,28,0,0,70,70,0,1,0,1,0
14619,28,0,0,66,66,0,1,0,1,0
13303,28,0,0,70,70,0,1,0,1,0
12950,28,0,0,70,70,0,1,0,1,0
22705,28,0,0,70,70,0,1,0,1,0
12013,28,0,0,70,70,0,1,0,1,0
16443,28,0,0,70,70,0,1,0,1,0
18021,28,0,0,66,66,0,1,0,1,0
19454,28,0,0,66,66,0,1,0,1,0
19984,28,0,0,70,70,0,1,0,1,0
12993,28,0,0,66,66,0,1,0,1,0
13588,28,0,0,70,70,0,1,0,1,0
8900,28,0,0,66,66,0,1,0,1,0
20045,28,0,0,70,70,0,1,0,1,0
21494,28,0,0,66,66,0,1,0,1,0
20118,28,0,0,70,70,0,1,0,1,0
20516,28,0,0,70,70,0,1,0,1,0
15349,28,0,0,66,66,0,1,0,1,0
9590,28,0,0,70,70,0,1,0,1,0
13808,28,0,0,70,70,0,1,0,1,0
20122,28,0,0,70,70,0,1,0,1,0
12654,28,0,0,66,66,0,1,0,1,0
16783,28,0,0,70,70,0,1,0,1,0
14458,28,0,0,70,70,0,1,0,1,0
22271,28,0,0,66,66,0,1,0,1,0
13070,28,0,0,70,70,0,1,0,1,0
10856,28,0,0,66,66,0,1,0,1,0
19650,28,0,0,70,70,0,1,0,1,0
20558,28,0,0,70,70,0,1,0,1,0
14324,28,0,0,70,70,0,1,0,1,0
20936,28,0,0,66,66,0,1,0,1,0
20833,28,0,0,70,70,0,1,0,1,0
20654,28,0,0,70,70,0,1,0,1,0
21482,28,0,0,66,66,0,1,0,1,0
18256,28,0,0,70,70,0,1,0,1,0
13857,28,0,0,70,70,0,1,0,1,0
11618,28,0,0,70,70,0,1,0,1,0
9073,28,0,0,66,66,0,1,0,1,0
13633,28,0,0,70,70,0,1,0,1,0
19457,28,0,0,66,66,0,1,0,1,0
17328,28,0,0,70,70,0,1,0,1,0
13166,28,0,0,70,70,0,1,0,1,0
22237,28,0,0,70,70,0,1,0,1,0
9439,28,0,0,66,66,0,1,0,1,0
9856,28,0,0,70,70,0,1,0,1,0
11178,28,0,0,66,66,0,1,0,1,0
12452,28,0,0,70,70,0,1,0,1,0
10047,28,0,0,66,66,0,1,0,1,0
15049,28,0,0,70,70,0,1,0,1,0
12512,28,0,0,70,70,0,1,0,1,0
9940,28,0,0,66,66,0,1,0,1,0
18662,28,0,0,70,70,0,1,0,1,0
9064,28,0,0,70,70,0,1,0,1,0
20018,28,0,0,66,66,0,1,0,1,0
14322,28,0,0,70,70,0,1,0,1,0
15330,28,0,0,66,66,0,1,0,1,0
16793,28,0,0,66,66,0,1,0,1,0
17330,28,0,0,70,70,0,1,0,1,0
13459,28,0,0,66,66,0,1,0,1,0
11139,28,0,0,70,70,0,1,0,1,0
16095,28,0,0,70,70,0,1,0,1,0
20778,28,0,0,66,66,0,1,0,1,0
18023,28,0,0,66,66,0,1,0,1,0
14623,28,0,0,70,70,0,1,0,1,0
11645,28,0,0,70,70,0,1,0,1,0
15307,28,0,0,70,70,0,1,0,1,0
9499,28,0,0,66,66,0,1,0,1,0
13699,28,0,0,70,70,0,1,0,1,0
9420,28,0,0,70,70,0,1,0,1,0
10867,28,0,0,70,70,0,1,0,1,0
16192,28,0,0,70,70,0,1,0,1,0
18067,28,0,0,66,66,0,1,0,1,0
17731,28,0,0,66,66,0,1,0,1,0
16932,28,0,0,66,66,0,1,0,1,0
11563,28,0,0,66,66,0,1,0,1,0
20675,28,0,0,70,70,0,1,0,1,0
18185,28,0,0,70,70,0,1,0,1,0
19396,28,0,0,70,70,0,1,0,1,0
18872,28,0,0,70,70,0,1,0,1,0
21434,28,0,0,70,70,0,1,0,1,0
16667,28,0,0,70,70,0,1,0,1,0
14100,28,0,0,70,70,0,1,0,1,0
16018,28,0,0,70,70,0,1,0,1,0
8502,28,0,0,70,70,0,1,0,1,0
11098,28,0,0,70,70,0,1,0,1,0
16015,28,0,0,66,66,0,1,0,1,0
11889,28,0,0,66,66,0,1,0,1,0
11607,28,0,0,66,66,0,1,0,1,0
11086,28,0,0,70,70,0,1,0,1,0
18940,28,0,0,70,70,0,1,0,1,0
16101,28,0,0,70,70,0,1,0,1,0
17392,28,0,0,66,66,0,1,0,1,0
16815,28,0,0,70,70,0,1,0,1,0
16385,28,0,0,70,70,0,1,0,1,0
12092,28,0,0,70,70,0,1,0,1,0
18896,28,0,0,70,70,0,1,0,1,0
11118,28,0,0,70,70,0,1,0,1,0
20597,28,0,0,70,70,0,1,0,1,0
18316,28,0,0,70,70,0,1,0,1,0
8953,28,0,0,70,70,0,1,0,1,0
13271,28,0,0,70,70,0,1,0,1,0
10662,28,0,0,70,70,0,1,0,1,0
19449,28,0,0,70,70,0,1,0,1,0
17533,28,0,0,70,70,0,1,0,1,0
13300,28,0,0,70,70,0,1,0,1,0
19223,28,0,0,70,70,0,1,0,1,0
18563,28,0,0,70,70,0,1,0,1,0
20084,28,0,0,70,70,0,1,0,1,0
20873,28,0,0,66,66,0,1,0,1,0
21757,28,0,0,70,70,0,1,0,1,0
9638,28,0,0,66,66,0,1,0,1,0
11720,28,0,0,66,66,0,1,0,1,0
19511,28,0,0,66,66,0,1,0,1,0
8955,28,0,0,70,70,0,1,0,1,0
18621,28,0,0,66,66,0,1,0,1,0
11861,28,0,0,70,70,0,1,0,1,0
17418,28,0,0,70,70,0,1,0,1,0
11884,28,0,0,66,66,0,1,0,1,0
13283,28,0,0,70,70,0,1,0,1,0
11605,28,0,0,70,70,0,1,0,1,0
18217,28,0,0,66,66,0,1,0,1,0
15288,28,0,0,70,70,0,1,0,1,0
21268,28,0,0,70,70,0,1,0,1,0
13578,28,0,0,70,70,0,1,0,1,0
17934,28,0,0,70,70,0,1,0,1,0
11249,28,0,0,66,66,0,1,0,1,0
11334,28,0,0,70,70,0,1,0,1,0
18833,28,0,0,66,66,0,1,0,1,0
17085,28,0,0,70,70,0,1,0,1,0
12189,28,0,0,66,66,0,1,0,1,0
20197,28,0,0,66,66,0,1,0,1,0
8357,28,0,0,70,70,0,1,0,1,0
14682,28,0,0,66,66,0,1,0,1,0
15170,28,0,0,70,70,0,1,0,1,0
17899,28,0,0,70,70,0,1,0,1,0
15915,28,0,0,70,70,0,1,0,1,0
10416,28,0,0,70,70,0,1,0,1,0
11019,28,0,0,66,66,0,1,0,1,0
12657,28,0,0,70,70,0,1,0,1,0
13602,28,0,0,70,70,0,1,0,1,0
16364,28,0,0,66,66,0,1,0,1,0
8686,28,0,0,66,66,0,1,0,1,0
16060,28,0,0,70,70,0,1,0,1,0
10449,28,0,0,70,70,0,1,0,1,0
9965,28,0,0,70,70,0,1,0,1,0
16552,28,0,0,70,70,0,1,0,1,0
20765,28,0,0,70,70,0,1,0,1,0
13584,28,0,0,70,70,0,1,0,1,0
18192,28,0,0,70,70,0,1,0,1,0
17153,28,0,0,70,70,0,1,0,1,0
10637,28,0,0,70,70,0,1,0,1,0
21108,28,0,0,66,66,0,1,0,1,0
11261,28,0,0,66,66,0,1,0,1,0
8822,28,0,0,66,66,0,1,0,1,0
10042,28,0,0,70,70,0,1,0,1,0
13567,28,0,0,66,66,0,1,0,1,0
15406,28,0,0,70,70,0,1,0,1,0
9571,28,0,0,66,66,0,1,0,1,0
21182,28,0,0,66,66,0,1,0,1,0
14479,28,0,0,70,70,0,1,0,1,0
16946,28,0,0,70,70,0,1,0,1,0
18719,28,0,0,66,66,0,1,0,1,0
13110,28,0,0,66,66,0,1,0,1,0
10902,28,0,0,70,70,0,1,0,1,0
17779,28,0,0,70,70,0,1,0,1,0
9480,28,0,0,66,66,0,1,0,1,0
12049,28,0,0,70,70,0,1,0,1,0
22644,28,0,0,70,70,0,1,0,1,0
10812,28,0,0,70,70,0,1,0,1,0
15825,28,0,0,70,70,0,1,0,1,0
12158,28,0,0,66,66,0,1,0,1,0
12182,28,0,0,66,66,0,1,0,1,0
9494,28,0,0,70,70,0,1,0,1,0
21228,28,0,0,70,70,0,1,0,1,0
13669,28,0,0,66,66,0,1,0,1,0
10864,28,0,0,66,66,0,1,0,1,0
21847,28,0,0,70,70,0,1,0,1,0
13315,28,0,0,66,66,0,1,0,1,0
17365,28,0,0,66,66,0,1,0,1,0
9738,28,0,0,70,70,0,1,0,1,0
18374,28,0,0,66,66,0,1,0,1,0
11547,28,0,0,66,66,0,1,0,1,0
8682,28,0,0,70,70,0,1,0,1,0
9176,28,0,0,70,70,0,1,0,1,0
12008,28,0,0,70,70,0,1,0,1,0
9750,28,0,0,70,70,0,1,0,1,0
16442,28,0,0,66,66,0,1,0,1,0
14054,28,0,0,70,70,0,1,0,1,0
11046,28,0,0,70,70,0,1,0,1,0
17500,28,0,0,70,70,0,1,0,1,0
15312,28,0,0,70,70,0,1,0,1,0
20624,28,0,0,70,70,0,1,0,1,0
21642,28,0,0,66,66,0,1,0,1,0
13383,28,0,0,70,70,0,1,0,1,0
20120,28,0,0,70,70,0,1,0,1,0
18078,28,0,0,70,70,0,1,0,1,0
20104,28,0,0,70,70,0,1,0,1,0
19552,28,0,0,70,70,0,1,0,1,0
18099,28,0,0,70,70,0,1,0,1,0
21071,28,0,0,70,70,0,1,0,1,0
21243,28,0,0,70,70,0,1,0,1,0
20720,28,0,0,70,70,0,1,0,1,0
12876,28,0,0,70,70,0,1,0,1,0
10585,28,0,0,70,70,0,1,0,1,0
8580,28,0,0,66,66,0,1,0,1,0
10609,28,0,0,70,70,0,1,0,1,0
12283,28,0,0,70,70,0,1,0,1,0
17905,28,0,0,70,70,0,1,0,1,0
10174,28,0,0,66,66,0,1,0,1,0
10297,28,0,0,66,66,0,1,0,1,0
20711,28,0,0,66,66,0,1,0,1,0
13692,28,0,0,66,66,0,1,0,1,0
10709,28,0,0,70,70,0,1,0,1,0
22612,28,0,0,66,66,0,1,0,1,0
19173,28,0,0,70,70,0,1,0,1,0
13315,28,0,0,70,70,0,1,0,1,0
10477,28,0,0,70,70,0,1,0,1,0
20264,28,0,0,70,70,0,1,0,1,0
15484,28,0,0,70,70,0,1,0,1,0
12167,28,0,0,66,66,0,1,0,1,0
14160,28,0,0,70,70,0,1,0,1,0
8998,28,0,0,70,70,0,1,0,1,0
11918,28,0,0,70,70,0,1,0,1,0
18464,28,0,0,70,70,0,1,0,1,0
9756,28,0,0,70,70,0,1,0,1,0
21426,28,0,0,70,70,0,1,0,1,0
17944,28,0,0,70,70,0,1,0,1,0
15536,28,0,0,66,66,0,1,0,1,0
20784,28,0,0,70,70,0,1,0,1,0
14126,28,0,0,70,70,0,1,0,1,0
11929,28,0,0,70,70,0,1,0,1,0
9921,28,0,0,70,70,0,1,0,1,0
21488,28,0,0,66,66,0,1,0,1,0
13323,28,0,0,66,66,0,1,0,1,0
8827,28,0,0,70,70,0,1,0,1,0
14272,28,0,0,70,70,0,1,0,1,0
21339,28,0,0,66,66,0,1,0,1,0
17150,28,0,0,70,70,0,1,0,1,0
16334,28,0,0,70,70,0,1,0,1,0
21164,28,0,0,70,70,0,1,0,1,0
10105,28,0,0,66,66,0,1,0,1,0
18399,28,0,0,70,70,0,1,0,1,0
9828,28,0,0,70,70,0,1,0,1,0
11996,28,0,0,70,70,0,1,0,1,0
12417,28,0,0,70,70,0,1,0,1,0
17422,28,0,0,70,70,0,1,0,1,0
10350,28,0,0,66,66,0,1,0,1,0
17940,28,0,0,70,70,0,1,0,1,0
14865,28,0,0,70,70,0,1,0,1,0
17535,28,0,0,70,70,0,1,0,1,0
9621,28,0,0,66,66,0,1,0,1,0
20125,28,0,0,70,70,0,1,0,1,0
9202,28,0,0,70,70,0,1,0,1,0
13428,28,0,0,70,70,0,1,0,1,0
22481,28,0,0,70,70,0,1,0,1,0
8542,28,0,0,70,70,0,1,0,1,0
19912,28,0,0,70,70,0,1,0,1,0
13072,28,0,0,70,70,0,1,0,1,0
10401,28,0,0,70,70,0,1,0,1,0
11364,28,0,0,70,70,0,1,0,1,0
21600,28,0,0,66,66,0,1,0,1,0
13064,28,0,0,66,66,0,1,0,1,0
16856,28,0,0,70,70,0,1,0,1,0
21184,28,0,0,70,70,0,1,0,1,0
22398,28,0,0,66,66,0,1,0,1,0
12081,28,0,0,66,66,0,1,0,1,0
20819,28,0,0,70,70,0,1,0,1,0
15292,28,0,0,70,70,0,1,0,1,0
20874,28,0,0,70,70,0,1,0,1,0
15314,28,0,0,70,70,0,1,0,1,0
18703,28,0,0,66,66,0,1,0,1,0
17672,28,0,0,70,70,0,1,0,1,0
10247,28,0,0,70,70,0,1,0,1,0
9274,28,0,0,70,70,0,1,0,1,0
18223,28,0,0,70,70,0,1,0,1,0
11592,28,0,0,66,66,0,1,0,1,0
21565,28,0,0,70,70,0,1,0,1,0
22153,28,0,0,70,70,0,1,0,1,0
15087,28,0,0,66,66,0,1,0,1,0
18890,28,0,0,70,70,0,1,0,1,0
11959,28,0,0,66,66,0,1,0,1,0
9757,28,0,0,70,70,0,1,0,1,0
21719,28,0,0,66,66,0,1,0,1,0
11574,28,0,0,70,70,0,1,0,1,0
11915,28,0,0,66,66,0,1,0,1,0
10948,28,0,0,66,66,0,1,0,1,0
13708,28,0,0,66,66,0,1,0,1,0
18056,28,0,0,70,70,0,1,0,1,0
9254,28,0,0,70,70,0,1,0,1,0
16195,28,0,0,70,70,0,1,0,1,0
18962,28,0,0,70,70,0,1,0,1,0
21387,28,0,0,70,70,0,1,0,1,0
11466,28,0,0,70,70,0,1,0,1,0
18951,28,0,0,66,66,0,1,0,1,0
21626,28,0,0,70,70,0,1,0,1,0
10593,28,0,0,70,70,0,1,0,1,0
10290,28,0,0,70,70,0,1,0,1,0
15083,28,0,0,70,70,0,1,0,1,0
13859,28,0,0,66,66,0,1,0,1,0
10608,28,0,0,66,66,0,1,0,1,0
16356,28,0,0,70,70,0,1,0,1,0
19124,28,0,0,70,70,0,1,0,1,0
8453,28,0,0,66,66,0,1,0,1,0
11533,28,0,0,66,66,0,1,0,1,0
18086,28,0,0,70,70,0,1,0,1,0
9267,28,0,0,70,70,0,1,0,1,0
9768,28,0,0,70,70,0,1,0,1,0
16292,28,0,0,70,70,0,1,0,1,0
11713,28,0,0,66,66,0,1,0,1,0
21135,28,0,0,66,66,0,1,0,1,0
19994,28,0,0,70,70,0,1,0,1,0
20916,28,0,0,70,70,0,1,0,1,0
9054,28,0,0,70,70,0,1,0,1,0
10194,28,0,0,70,70,0,1,0,1,0
8830,28,0,0,66,66,0,1,0,1,0
21970,28,0,0,66,66,0,1,0,1,0
9776,28,0,0,70,70,0,1,0,1,0
20782,28,0,0,70,70,0,1,0,1,0
22673,28,0,0,70,70,0,1,0,1,0
21857,28,0,0,70,70,0,1,0,1,0
17999,28,0,0,70,70,0,1,0,1,0
16339,28,0,0,66,66,0,1,0,1,0
22451,28,0,0,70,70,0,1,0,1,0
22384,28,0,0,70,70,0,1,0,1,0
14612,28,0,0,66,66,0,1,0,1,0
10710,28,0,0,70,70,0,1,0,1,0
17410,28,0,0,66,66,0,1,0,1,0
12354,28,0,0,70,70,0,1,0,1,0
20398,28,0,0,70,70,0,1,0,1,0
22391,28,0,0,70,70,0,1,0,1,0
9880,28,0,0,66,66,0,1,0,1,0
20481,28,0,0,70,70,0,1,0,1,0
11841,28,0,0,70,70,0,1,0,1,0
16535,28,0,0,70,70,0,1,0,1,0
14759,28,0,0,70,70,0,1,0,1,0
12840,28,0,0,70,70,0,1,0,1,0
12000,28,0,0,66,66,0,1,0,1,0
13967,28,0,0,70,70,0,1,0,1,0
22613,28,0,0,70,70,0,1,0,1,0
13934,28,0,0,66,66,0,1,0,1,0
16388,28,0,0,66,66,0,1,0,1,0
9885,28,0,0,66,66,0,1,0,1,0
15348,28,0,0,70,70,0,1,0,1,0
19126,28,0,0,66,66,0,1,0,1,0
18317,28,0,0,70,70,0,1,0,1,0
17816,28,0,0,66,66,0,1,0,1,0
21570,28,0,0,70,70,0,1,0,1,0
10757,28,0,0,70,70,0,1,0,1,0
9920,28,0,0,70,70,0,1,0,1,0
10192,28,0,0,66,66,0,1,0,1,0
9420,28,0,0,70,70,0,1,0,1,0
11513,28,0,0,70,70,0,1,0,1,0
16228,28,0,0,70,70,0,1,0,1,0
10423,28,0,0,70,70,0,1,0,1,0
21965,28,0,0,70,70,0,1,0,1,0
22453,28,0,0,70,70,0,1,0,1,0
14260,28,0,0,70,70,0,1,0,1,0
13609,28,0,0,70,70,0,1,0,1,0
14346,28,0,0,70,70,0,1,0,1,0
21224,28,0,0,66,66,0,1,0,1,0
8885,28,0,0,70,70,0,1,0,1,0
19647,28,0,0,70,70,0,1,0,1,0
16483,28,0,0,70,70,0,1,0,1,0
14498,28,0,0,70,70,0,1,0,1,0
22130,28,0,0,66,66,0,1,0,1,0
13072,28,0,0,66,66,0,1,0,1,0
21652,28,0,0,70,70,0,1,0,1,0
9177,28,0,0,70,70,0,1,0,1,0
10577,28,0,0,70,70,0,1,0,1,0
8686,28,0,0,70,70,0,1,0,1,0
15409,28,0,0,66,66,0,1,0,1,0
11375,28,0,0,66,66,0,1,0,1,0
19697,28,0,0,70,70,0,1,0,1,0
13847,28,0,0,70,70,0,1,0,1,0
13656,28,0,0,70,70,0,1,0,1,0
19188,28,0,0,66,66,0,1,0,1,0
17932,28,0,0,66,66,0,1,0,1,0
20867,28,0,0,66,66,0,1,0,1,0
11296,28,0,0,70,70,0,1,0,1,0
9530,28,0,0,70,70,0,1,0,1,0
10668,28,0,0,66,66,0,1,0,1,0
19847,28,0,0,70,70,0,1,0,1,0
10854,28,0,0,70,70,0,1,0,1,0
12734,28,0,0,70,70,0,1,0,1,0
19871,28,0,0,70,70,0,1,0,1,0
11767,28,0,0,70,70,0,1,0,1,0
15527,28,0,0,70,70,0,1,0,1,0
12133,28,0,0,66,66,0,1,0,1,0
8467,28,0,0,66,66,0,1,0,1,0
9737,28,0,0,66,66,0,1,0,1,0
19667,28,0,0,66,66,0,1,0,1,0
16795,28,0,0,66,66,0,1,0,1,0
15381,28,0,0,70,70,0,1,0,1,0
10486,28,0,0,66,66,0,1,0,1,0
17824,28,0,0,70,70,0,1,0,1,0
11660,28,0,0,70,70,0,1,0,1,0
8567,28,0,0,70,70,0,1,0,1,0
11270,28,0,0,70,70,0,1,0,1,0
10356,28,0,0,70,70,0,1,0,1,0
12644,28,0,0,70,70,0,1,0,1,0
20383,28,0,0,70,70,0,1,0,1,0
15473,28,0,0,66,66,0,1,0,1,0
15410,28,0,0,66,66,0,1,0,1,0
17228,28,0,0,70,70,0,1,0,1,0
20868,28,0,0,66,66,0,1,0,1,0
10957,28,0,0,70,70,0,1,0,1,0
9599,28,0,0,70,70,0,1,0,1,0
18518,28,0,0,70,70,0,1,0,1,0
12658,28,0,0,66,66,0,1,0,1,0
14542,28,0,0,66,66,0,1,0,1,0
21661,28,0,0,70,70,0,1,0,1,0
14448,28,0,0,70,70,0,1,0,1,0
13296,28,0,0,70,70,0,1,0,1,0
11109,28,0,0,70,70,0,1,0,1,0
18765,28,0,0,70,70,0,1,0,1,0
21431,28,0,0,66,66,0,1,0,1,0
11124,28,0,0,70,70,0,1,0,1,0
9152,28,0,0,70,70,0,1,0,1,0
9544,28,0,0,70,70,0,1,0,1,0
21544,28,0,0,70,70,0,1,0,1,0
12959,28,0,0,70,70,0,1,0,1,0
17793,28,0,0,70,70,0,1,0,1,0
8624,28,0,0,66,66,0,1,0,1,0
16609,28,0,0,66,66,0,1,0,1,0
12613,28,0,0,66,66,0,1,0,1,0
18004,28,0,0,70,70,0,1,0,1,0
12809,28,0,0,70,70,0,1,0,1,0
9908,28,0,0,70,70,0,1,0,1,0
11102,28,0,0,70,70,0,1,0,1,0
13052,28,0,0,70,70,0,1,0,1,0
19656,28,0,0,66,66,0,1,0,1,0
9181,28,0,0,70,70,0,1,0,1,0
10170,28,0,0,66,66,0,1,0,1,0
17972,28,0,0,66,66,0,1,0,1,0
20487,28,0,0,70,70,0,1,0,1,0
13436,28,0,0,70,70,0,1,0,1,0
20997,28,0,0,70,70,0,1,0,1,0
20336,28,0,0,70,70,0,1,0,1,0
15440,28,0,0,70,70,0,1,0,1,0
9938,28,0,0,66,66,0,1,0,1,0
9135,28,0,0,70,70,0,1,0,1,0
9373,28,0,0,70,70,0,1,0,1,0
11121,28,0,0,66,66,0,1,0,1,0
12003,28,0,0,66,66,0,1,0,1,0
22214,28,0,0,70,70,0,1,0,1,0
12249,28,0,0,66,66,0,1,0,1,0
21372,28,0,0,70,70,0,1,0,1,0
22520,28,0,0,70,70,0,1,0,1,0
8618,28,0,0,70,70,0,1,0,1,0
17887,28,0,0,70,70,0,1,0,1,0
8504,28,0,0,70,70,0,1,0,1,0
18678,28,0,0,66,66,0,1,0,1,0
8786,28,0,0,70,70,0,1,0,1,0
15470,28,0,0,66,66,0,1,0,1,0
22666,28,0,0,70,70,0,1,0,1,0
15836,28,0,0,66,66,0,1,0,1,0
14210,28,0,0,70,70,0,1,0,1,0
21392,28,0,0,70,70,0,1,0,1,0
8328,28,0,0,70,70,0,1,0,1,0
10061,28,0,0,66,66,0,1,0,1,0
19293,28,0,0,70,70,0,1,0,1,0
17523,28,0,0,70,70,0,1,0,1,0
14852,28,0,0,70,70,0,1,0,1,0
21711,28,0,0,66,66,0,1,0,1,0
17942,28,0,0,70,70,0,1,0,1,0
11040,28,0,0,66,66,0,1,0,1,0
9294,28,0,0,70,70,0,1,0,1,0
18411,28,0,0,70,70,0,1,0,1,0
21148,28,0,0,70,70,0,1,0,1,0
9627,28,0,0,70,70,0,1,0,1,0
18353,28,0,0,66,66,0,1,0,1,0
12371,28,0,0,66,66,0,1,0,1,0
9607,28,0,0,70,70,0,1,0,1,0
8727,28,0,0,70,70,0,1,0,1,0
20339,28,0,0,70,70,0,1,0,1,0
16113,28,0,0,70,70,0,1,0,1,0
13626,28,0,0,70,70,0,1,0,1,0
19376,28,0,0,70,70,0,1,0,1,0
20473,28,0,0,66,66,0,1,0,1,0
16944,28,0,0,66,66,0,1,0,1,0
21910,28,0,0,70,70,0,1,0,1,0
18837,28,0,0,66,66,0,1,0,1,0
18507,28,0,0,70,70,0,1,0,1,0
11123,28,0,0,70,70,0,1,0,1,0
12113,28,0,0,66,66,0,1,0,1,0
14598,28,0,0,66,66,0,1,0,1,0
15620,28,0,0,66,66,0,1,0,1,0
9570,28,0,0,70,70,0,1,0,1,0
11314,28,0,0,66,66,0,1,0,1,0
14405,28,0,0,70,70,0,1,0,1,0
21397,28,0,0,70,70,0,1,0,1,0
10097,28,0,0,70,70,0,1,0,1,0
17498,28,0,0,66,66,0,1,0,1,0
19720,28,0,0,70,70,0,1,0,1,0
17641,28,0,0,66,66,0,1,0,1,0
20245,28,0,0,70,70,0,1,0,1,0
15351,28,0,0,66,66,0,1,0,1,0
19760,28,0,0,66,66,0,1,0,1,0
21352,28,0,0,70,70,0,1,0,1,0
20464,28,0,0,66,66,0,1,0,1,0
19149,28,0,0,66,66,0,1,0,1,0
11757,28,0,0,66,66,0,1,0,1,0
21072,28,0,0,70,70,0,1,0,1,0
8350,28,0,0,66,66,0,1,0,1,0
15948,28,0,0,70,70,0,1,0,1,0
15942,28,0,0,66,66,0,1,0,1,0
14954,28,0,0,66,66,0,1,0,1,0
15779,28,0,0,66,66,0,1,0,1,0
17047,28,0,0,70,70,0,1,0,1,0
20271,28,0,0,70,70,0,1,0,1,0
21090,28,0,0,70,70,0,1,0,1,0
9455,28,0,0,66,66,0,1,0,1,0
20344,28,0,0,66,66,0,1,0,1,0
19881,28,0,0,66,66,0,1,0,1,0
13979,28,0,0,70,70,0,1,0,1,0
13673,28,0,0,70,70,0,1,0,1,0
8844,28,0,0,70,70,0,1,0,1,0
13380,28,0,0,70,70,0,1,0,1,0
9695,28,0,0,70,70,0,1,0,1,0
14008,28,0,0,66,66,0,1,0,1,0
18378,28,0,0,70,70,0,1,0,1,0
15910,28,0,0,70,70,0,1,0,1,0
9491,28,0,0,66,66,0,1,0,1,0
13500,28,0,0,70,70,0,1,0,1,0
12206,28,0,0,70,70,0,1,0,1,0
11357,28,0,0,66,66,0,1,0,1,0
12983,28,0,0,70,70,0,1,0,1,0
13982,28,0,0,70,70,0,1,0,1,0
21878,28,0,0,66,66,0,1,0,1,0
14208,28,0,0,70,70,0,1,0,1,0
11990,28,0,0,70,70,0,1,0,1,0
22700,28,0,0,70,70,0,1,0,1,0
21842,28,0,0,70,70,0,1,0,1,0
19996,28,0,0,70,70,0,1,0,1,0
14139,28,0,0,70,70,0,1,0,1,0
19332,28,0,0,70,70,0,1,0,1,0
9401,28,0,0,66,66,0,1,0,1,0
19787,28,0,0,70,70,0,1,0,1,0
17007,28,0,0,70,70,0,1,0,1,0
14857,28,0,0,70,70,0,1,0,1,0
15091,28,0,0,66,66,0,1,0,1,0
19943,28,0,0,70,70,0,1,0,1,0
17742,28,0,0,66,66,0,1,0,1,0
20725,28,0,0,66,66,0,1,0,1,0
11917,28,0,0,70,70,0,1,0,1,0
17285,28,0,0,70,70,0,1,0,1,0
9053,28,0,0,70,70,0,1,0,1,0
8868,28,0,0,70,70,0,1,0,1,0
21442,28,0,0,70,70,0,1,0,1,0
19904,28,0,0,66,66,0,1,0,1,0
14041,28,0,0,70,70,0,1,0,1,0
17234,28,0,0,70,70,0,1,0,1,0
21136,28,0,0,66,66,0,1,0,1,0
8843,28,0,0,70,70,0,1,0,1,0
10426,28,0,0,70,70,0,1,0,1,0
21286,28,0,0,70,70,0,1,0,1,0
15066,28,0,0,70,70,0,1,0,1,0
15904,28,0,0,66,66,0,1,0,1,0
19341,28,0,0,66,66,0,1,0,1,0
9997,28,0,0,66,66,0,1,0,1,0
18771,28,0,0,70,70,0,1,0,1,0
21522,28,0,0,70,70,0,1,0,1,0
20799,28,0,0,66,66,0,1,0,1,0
19692,28,0,0,70,70,0,1,0,1,0
19890,28,0,0,70,70,0,1,0,1,0
17617,28,0,0,70,70,0,1,0,1,0
14424,28,0,0,70,70,0,1,0,1,0
16413,28,0,0,70,70,0,1,0,1,0
15651,28,0,0,70,70,0,1,0,1,0
16013,28,0,0,66,66,0,1,0,1,0
20646,28,0,0,70,70,0,1,0,1,0
15215,28,0,0,70,70,0,1,0,1,0
14591,28,0,0,70,70,0,1,0,1,0
12383,28,0,0,70,70,0,1,0,1,0
11304,28,0,0,70,70,0,1,0,1,0
17974,28,0,0,70,70,0,1,0,1,0
21267,28,0,0,66,66,0,1,0,1,0
9067,28,0,0,70,70,0,1,0,1,0
22053,28,0,0,70,70,0,1,0,1,0
13471,28,0,0,66,66,0,1,0,1,0
16146,28,0,0,70,70,0,1,0,1,0
11307,28,0,0,70,70,0,1,0,1,0
10184,28,0,0,66,66,0,1,0,1,0
20366,28,0,0,66,66,0,1,0,1,0
18954,28,0,0,70,70,0,1,0,1,0
19782,28,0,0,66,66,0,1,0,1,0
15941,28,0,0,70,70,0,1,0,1,0
10638,28,0,0,66,66,0,1,0,1,0
20542,28,0,0,66,66,0,1,0,1,0
16196,28,0,0,70,70,0,1,0,1,0
14967,28,0,0,66,66,0,1,0,1,0
10116,28,0,0,66,66,0,1,0,1,0
10811,28,0,0,66,66,0,1,0,1,0
13782,28,0,0,70,70,0,1,0,1,0
15262,28,0,0,70,70,0,1,0,1,0
19825,28,0,0,66,66,0,1,0,1,0
18654,28,0,0,70,70,0,1,0,1,0
9824,28,0,0,70,70,0,1,0,1,0
14091,28,0,0,66,66,0,1,0,1,0
15715,28,0,0,66,66,0,1,0,1,0
16071,28,0,0,66,66,0,1,0,1,0
16026,28,0,0,66,66,0,1,0,1,0
19750,28,0,0,70,70,0,1,0,1,0
21751,28,0,0,70,70,0,1,0,1,0
13878,28,0,0,70,70,0,1,0,1,0
19018,28,0,0,70,70,0,1,0,1,0
8438,28,0,0,66,66,0,1,0,1,0
12523,28,0,0,66,66,0,1,0,1,0
9561,28,0,0,66,66,0,1,0,1,0
14439,28,0,0,70,70,0,1,0,1,0
20017,28,0,0,70,70,0,1,0,1,0
10710,28,0,0,70,70,0,1,0,1,0
17406,28,0,0,70,70,0,1,0,1,0
8431,28,0,0,66,66,0,1,0,1,0
18343,28,0,0,70,70,0,1,0,1,0
13372,28,0,0,66,66,0,1,0,1,0
17855,28,0,0,70,70,0,1,0,1,0
18637,28,0,0,66,66,0,1,0,1,0
21313,28,0,0,66,66,0,1,0,1,0
8381,28,0,0,70,70,0,1,0,1,0
20599,28,0,0,66,66,0,1,0,1,0
16302,28,0,0,70,70,0,1,0,1,0
18887,28,0,0,70,70,0,1,0,1,0
21243,28,0,0,70,70,0,1,0,1,0
20658,28,0,0,66,66,0,1,0,1,0
12675,28,0,0,66,66,0,1,0,1,0
22530,28,0,0,70,70,0,1,0,1,0
20694,28,0,0,70,70,0,1,0,1,0
21582,28,0,0,70,70,0,1,0,1,0
10287,28,0,0,70,70,0,1,0,1,0
20294,28,0,0,66,66,0,1,0,1,0
9891,28,0,0,66,66,0,1,0,1,0
13201,28,0,0,70,70,0,1,0,1,0
12849,28,0,0,70,70,0,1,0,1,0
16933,28,0,0,70,70,0,1,0,1,0
12285,28,0,0,66,66,0,1,0,1,0
21138,28,0,0,66,66,0,1,0,1,0
10077,28,0,0,66,66,0,1,0,1,0
17734,28,0,0,66,66,0,1,0,1,0
13330,28,0,0,66,66,0,1,0,1,0
8873,28,0,0,70,70,0,1,0,1,0
18708,28,0,0,70,70,0,1,0,1,0
16676,28,0,0,70,70,0,1,0,1,0
11894,28,0,0,70,70,0,1,0,1,0
13385,28,0,0,70,70,0,1,0,1,0
11488,28,0,0,70,70,0,1,0,1,0
19737,28,0,0,70,70,0,1,0,1,0
9131,28,0,0,70,70,0,1,0,1,0
12322,28,0,0,70,70,0,1,0,1,0
11942,28,0,0,70,70,0,1,0,1,0
15593,28,0,0,70,70,0,1,0,1,0
12497,28,0,0,66,66,0,1,0,1,0
19452,28,0,0,70,70,0,1,0,1,0
15360,28,0,0,70,70,0,1,0,1,0
13000,28,0,0,66,66,0,1,0,1,0
10433,28,0,0,70,70,0,1,0,1,0
17633,28,0,0,70,70,0,1,0,1,0
10789,28,0,0,70,70,0,1,0,1,0
13118,28,0,0,70,70,0,1,0,1,0
18200,28,0,0,66,66,0,1,0,1,0
15615,28,0,0,66,66,0,1,0,1,0
17553,28,0,0,70,70,0,1,0,1,0
12726,28,0,0,70,70,0,1,0,1,0
10572,28,0,0,66,66,0,1,0,1,0
22603,28,0,0,70,70,0,1,0,1,0
21067,28,0,0,70,70,0,1,0,1,0
11771,28,0,0,66,66,0,1,0,1,0
15459,28,0,0,70,70,0,1,0,1,0
10241,28,0,0,66,66,0,1,0,1,0
12294,28,0,0,70,70,0,1,0,1,0
21613,28,0,0,70,70,0,1,0,1,0
18140,28,0,0,70,70,0,1,0,1,0
16445,28,0,0,70,70,0,1,0,1,0
18437,28,0,0,70,70,0,1,0,1,0
9174,28,0,0,70,70,0,1,0,1,0
13185,28,0,0,66,66,0,1,0,1,0
8931,28,0,0,66,66,0,1,0,1,0
10786,28,0,0,70,70,0,1,0,1,0
18087,28,0,0,66,66,0,1,0,1,0
15163,28,0,0,70,70,0,1,0,1,0
8553,28,0,0,70,70,0,1,0,1,0
9794,28,0,0,70,70,0,1,0,1,0
20919,28,0,0,66,66,0,1,0,1,0
17122,28,0,0,70,70,0,1,0,1,0
15546,28,0,0,70,70,0,1,0,1,0
14094,28,0,0,70,70,0,1,0,1,0
22039,28,0,0,70,70,0,1,0,1,0
17902,28,0,0,70,70,0,1,0,1,0
8477,28,0,0,70,70,0,1,0,1,0
12078,28,0,0,66,66,0,1,0,1,0
19913,28,0,0,66,66,0,1,0,1,0
12265,28,0,0,70,70,0,1,0,1,0
9322,28,0,0,66,66,0,1,0,1,0
18683,28,0,0,70,70,0,1,0,1,0
15670,28,0,0,70,70,0,1,0,1,0
10539,28,0,0,70,70,0,1,0,1,0
9133,28,0,0,70,70,0,1,0,1,0
13242,28,0,0,70,70,0,1,0,1,0
16359,28,0,0,70,70,0,1,0,1,0
16473,28,0,0,66,66,0,1,0,1,0
9700,28,0,0,70,70,0,1,0,1,0
14658,28,0,0,70,70,0,1,0,1,0
14605,28,0,0,66,66,0,1,0,1,0
22581,28,0,0,70,70,0,1,0,1,0
21526,28,0,0,70,70,0,1,0,1,0
15045,28,0,0,70,70,0,1,0,1,0
22532,28,0,0,70,70,0,1,0,1,0
16285,28,0,0,70,70,0,1,0,1,0
17519,28,0,0,70,70,0,1,0,1,0
9398,28,0,0,70,70,0,1,0,1,0
19150,28,0,0,66,66,0,1,0,1,0
9716,28,0,0,70,70,0,1,0,1,0
12992,28,0,0,70,70,0,1,0,1,0
16212,28,0,0,70,70,0,1,0,1,0
20330,28,0,0,70,70,0,1,0,1,0
20391,28,0,0,70,70,0,1,0,1,0
15645,28,0,0,66,66,0,1,0,1,0
13786,28,0,0,70,70,0,1,0,1,0
10717,28,0,0,70,70,0,1,0,1,0
13150,28,0,0,70,70,0,1,0,1,0
12499,28,0,0,70,70,0,1,0,1,0
16893,28,0,0,70,70,0,1,0,1,0
9342,28,0,0,70,70,0,1,0,1,0
17130,28,0,0,70,70,0,1,0,1,0
19610,28,0,0,66,66,0,1,0,1,0
20556,28,0,0,66,66,0,1,0,1,0
19832,28,0,0,66,66,0,1,0,1,0
12883,28,0,0,70,70,0,1,0,1,0
10658,28,0,0,70,70,0,1,0,1,0
18344,28,0,0,70,70,0,1,0,1,0
21027,28,0,0,66,66,0,1,0,1,0
9294,28,0,0,70,70,0,1,0,1,0
10398,28,0,0,70,70,0,1,0,1,0
20458,28,0,0,70,70,0,1,0,1,0
17877,28,0,0,70,70,0,1,0,1,0
15108,28,0,0,70,70,0,1,0,1,0
19941,28,0,0,70,70,0,1,0,1,0
10161,28,0,0,70,70,0,1,0,1,0
17698,28,0,0,66,66,0,1,0,1,0
8949,28,0,0,70,70,0,1,0,1,0
20981,28,0,0,70,70,0,1,0,1,0
9007,28,0,0,66,66,0,1,0,1,0
18855,28,0,0,70,70,0,1,0,1,0
8722,28,0,0,70,70,0,1,0,1,0
15921,28,0,0,70,70,0,1,0,1,0
16940,28,0,0,70,70,0,1,0,1,0
15291,28,0,0,70,70,0,1,0,1,0
19850,28,0,0,66,66,0,1,0,1,0
9436,28,0,0,66,66,0,1,0,1,0
22037,28,0,0,70,70,0,1,0,1,0
22501,28,0,0,70,70,0,1,0,1,0
21180,28,0,0,70,70,0,1,0,1,0
12976,28,0,0,66,66,0,1,0,1,0
17313,28,0,0,70,70,0,1,0,1,0
9317,28,0,0,66,66,0,1,0,1,0
15580,28,0,0,70,70,0,1,0,1,0
8930,28,0,0,66,66,0,1,0,1,0
18203,28,0,0,70,70,0,1,0,1,0
17002,28,0,0,70,70,0,1,0,1,0
15664,28,0,0,70,70,0,1,0,1,0
15342,28,0,0,70,70,0,1,0,1,0
17334,28,0,0,70,70,0,1,0,1,0
14237,28,0,0,66,66,0,1,0,1,0
10129,28,0,0,70,70,0,1,0,1,0
9973,28,0,0,66,66,0,1,0,1,0
22718,28,0,0,70,70,0,1,0,1,0
19127,28,0,0,70,70,0,1,0,1,0
10568,28,0,0,70,70,0,1,0,1,0
10990,28,0,0,66,66,0,1,0,1,0
12251,28,0,0,70,70,0,1,0,1,0
15918,28,0,0,66,66,0,1,0,1,0
12643,28,0,0,66,66,0,1,0,1,0
11927,28,0,0,70,70,0,1,0,1,0
20782,28,0,0,66,66,0,1,0,1,0
17460,28,0,0,66,66,0,1,0,1,0
18664,28,0,0,66,66,0,1,0,1,0
19660,28,0,0,70,70,0,1,0,1,0
20798,28,0,0,66,66,0,1,0,1,0
9402,28,0,0,70,70,0,1,0,1,0
16695,28,0,0,70,70,0,1,0,1,0
13926,28,0,0,70,70,0,1,0,1,0
22338,28,0,0,66,66,0,1,0,1,0
13559,28,0,0,70,70,0,1,0,1,0
10603,28,0,0,70,70,0,1,0,1,0
14608,28,0,0,70,70,0,1,0,1,0
16982,28,0,0,70,70,0,1,0,1,0
20843,28,0,0,70,70,0,1,0,1,0
20826,28,0,0,66,66,0,1,0,1,0
9690,28,0,0,66,66,0,1,0,1,0
11768,28,0,0,70,70,0,1,0,1,0
20230,28,0,0,66,66,0,1,0,1,0
18438,28,0,0,66,66,0,1,0,1,0
9722,28,0,0,70,70,0,1,0,1,0
11454,28,0,0,70,70,0,1,0,1,0
12838,28,0,0,66,66,0,1,0,1,0
22458,28,0,0,70,70,0,1,0,1,0
22336,28,0,0,70,70,0,1,0,1,0
21380,28,0,0,66,66,0,1,0,1,0
18190,28,0,0,66,66,0,1,0,1,0
10232,28,0,0,66,66,0,1,0,1,0
8867,28,0,0,70,70,0,1,0,1,0
14180,28,0,0,66,66,0,1,0,1,0
14677,28,0,0,70,70,0,1,0,1,0
22649,28,0,0,70,70,0,1,0,1,0
18965,28,0,0,70,70,0,1,0,1,0
19384,28,0,0,70,70,0,1,0,1,0
12562,28,0,0,70,70,0,1,0,1,0
13126,28,0,0,70,70,0,1,0,1,0
10007,28,0,0,70,70,0,1,0,1,0
21537,28,0,0,70,70,0,1,0,1,0
9484,28,0,0,66,66,0,1,0,1,0
19975,28,0,0,70,70,0,1,0,1,0
16327,28,0,0,66,66,0,1,0,1,0
11397,28,0,0,70,70,0,1,0,1,0
8523,28,0,0,66,66,0,1,0,1,0
9042,28,0,0,66,66,0,1,0,1,0
9802,28,0,0,70,70,0,1,0,1,0
21510,28,0,0,70,70,0,1,0,1,0
9538,28,0,0,70,70,0,1,0,1,0
22564,28,0,0,66,66,0,1,0,1,0
15754,28,0,0,70,70,0,1,0,1,0
9903,28,0,0,70,70,0,1,0,1,0
11115,28,0,0,66,66,0,1,0,1,0
15002,28,0,0,70,70,0,1,0,1,0
14372,28,0,0,70,70,0,1,0,1,0
18448,28,0,0,70,70,0,1,0,1,0
15086,28,0,0,70,70,0,1,0,1,0
14204,28,0,0,66,66,0,1,0,1,0
13839,28,0,0,70,70,0,1,0,1,0
18876,28,0,0,66,66,0,1,0,1,0
18674,28,0,0,66,66,0,1,0,1,0
11553,28,0,0,70,70,0,1,0,1,0
8991,28,0,0,66,66,0,1,0,1,0
14964,28,0,0,70,70,0,1,0,1,0
9649,28,0,0,70,70,0,1,0,1,0
16832,28,0,0,70,70,0,1,0,1,0
13374,28,0,0,66,66,0,1,0,1,0
17876,28,0,0,70,70,0,1,0,1,0
14460,28,0,0,70,70,0,1,0,1,0
13476,28,0,0,66,66,0,1,0,1,0
12670,28,0,0,70,70,0,1,0,1,0
9747,28,0,0,70,70,0,1,0,1,0
15696,28,0,0,70,70,0,1,0,1,0
20240,28,0,0,66,66,0,1,0,1,0
18606,28,0,0,70,70,0,1,0,1,0
9920,28,0,0,70,70,0,1,0,1,0
8697,28,0,0,66,66,0,1,0,1,0
14956,28,0,0,66,66,0,1,0,1,0
8882,28,0,0,66,66,0,1,0,1,0
8998,28,0,0,70,70,0,1,0,1,0
13732,28,0,0,70,70,0,1,0,1,0
18712,28,0,0,70,70,0,1,0,1,0
20297,28,0,0,70,70,0,1,0,1,0
13131,28,0,0,66,66,0,1,0,1,0
15387,28,0,0,70,70,0,1,0,1,0
19845,28,0,0,70,70,0,1,0,1,0
12787,28,0,0,66,66,0,1,0,1,0
12415,28,0,0,70,70,0,1,0,1,0
19556,28,0,0,70,70,0,1,0,1,0
18762,28,0,0,70,70,0,1,0,1,0
10541,28,0,0,66,66,0,1,0,1,0
19397,28,0,0,70,70,0,1,0,1,0
15279,28,0,0,70,70,0,1,0,1,0
8742,28,0,0,70,70,0,1,0,1,0
18191,28,0,0,70,70,0,1,0,1,0
22017,28,0,0,70,70,0,1,0,1,0
14084,28,0,0,66,66,0,1,0,1,0
21787,28,0,0,70,70,0,1,0,1,0
9508,28,0,0,70,70,0,1,0,1,0
8419,28,0,0,70,70,0,1,0,1,0
9371,28,0,0,66,66,0,1,0,1,0
11560,28,0,0,66,66,0,1,0,1,0
22031,28,0,0,66,66,0,1,0,1,0
15231,28,0,0,66,66,0,1,0,1,0
21045,28,0,0,70,70,0,1,0,1,0
8558,28,0,0,66,66,0,1,0,1,0
16657,28,0,0,70,70,0,1,0,1,0
22185,28,0,0,70,70,0,1,0,1,0
9605,28,0,0,66,66,0,1,0,1,0
14342,28,0,0,70,70,0,1,0,1,0
15724,28,0,0,70,70,0,1,0,1,0
10003,28,0,0,70,70,0,1,0,1,0
12346,28,0,0,66,66,0,1,0,1,0
22082,28,0,0,70,70,0,1,0,1,0
11487,28,0,0,66,66,0,1,0,1,0
14665,28,0,0,66,66,0,1,0,1,0
8716,28,0,0,70,70,0,1,0,1,0
21608,28,0,0,70,70,0,1,0,1,0
18196,28,0,0,70,70,0,1,0,1,0
15772,28,0,0,70,70,0,1,0,1,0
19375,28,0,0,70,70,0,1,0,1,0
18500,28,0,0,66,66,0,1,0,1,0
11695,28,0,0,70,70,0,1,0,1,0
12068,28,0,0,66,66,0,1,0,1,0
18850,28,0,0,66,66,0,1,0,1,0
14985,28,0,0,70,70,0,1,0,1,0
8610,28,0,0,70,70,0,1,0,1,0
8385,28,0,0,70,70,0,1,0,1,0
16813,28,0,0,66,66,0,1,0,1,0
9250,28,0,0,70,70,0,1,0,1,0
18128,28,0,0,66,66,0,1,0,1,0
14025,28,0,0,70,70,0,1,0,1,0
14780,28,0,0,66,66,0,1,0,1,0
9828,28,0,0,70,70,0,1,0,1,0
19661,28,0,0,70,70,0,1,0,1,0
16930,28,0,0,66,66,0,1,0,1,0
17304,28,0,0,70,70,0,1,0,1,0
17454,28,0,0,70,70,0,1,0,1,0
9983,28,0,0,66,66,0,1,0,1,0
21301,28,0,0,70,70,0,1,0,1,0
10278,28,0,0,66,66,0,1,0,1,0
9634,28,0,0,70,70,0,1,0,1,0
11208,28,0,0,70,70,0,1,0,1,0
18666,28,0,0,70,70,0,1,0,1,0
19677,28,0,0,70,70,0,1,0,1,0
19752,28,0,0,70,70,0,1,0,1,0
14446,28,0,0,70,70,0,1,0,1,0
14001,28,0,0,70,70,0,1,0,1,0
20869,28,0,0,70,70,0,1,0,1,0
13635,28,0,0,70,70,0,1,0,1,0
14586,28,0,0,70,70,0,1,0,1,0
13585,28,0,0,66,66,0,1,0,1,0
15229,28,0,0,70,70,0,1,0,1,0
22355,28,0,0,66,66,0,1,0,1,0
12896,28,0,0,66,66,0,1,0,1,0
18706,28,0,0,70,70,0,1,0,1,0
19037,28,0,0,70,70,0,1,0,1,0
20177,28,0,0,70,70,0,1,0,1,0
17237,28,0,0,70,70,0,1,0,1,0
13446,28,0,0,70,70,0,1,0,1,0
20039,28,0,0,66,66,0,1,0,1,0
9368,28,0,0,70,70,0,1,0,1,0
10750,28,0,0,66,66,0,1,0,1,0
8957,28,0,0,70,70,0,1,0,1,0
20217,28,0,0,70,70,0,1,0,1,0
17673,28,0,0,70,70,0,1,0,1,0
10791,28,0,0,66,66,0,1,0,1,0
20652,28,0,0,70,70,0,1,0,1,0
9613,28,0,0,66,66,0,1,0,1,0
21784,28,0,0,66,66,0,1,0,1,0
19672,28,0,0,66,66,0,1,0,1,0
17643,28,0,0,66,66,0,1,0,1,0
15668,28,0,0,70,70,0,1,0,1,0
12435,28,0,0,70,70,0,1,0,1,0
20793,28,0,0,66,66,0,1,0,1,0
10900,28,0,0,66,66,0,1,0,1,0
18493,28,0,0,70,70,0,1,0,1,0
21862,28,0,0,70,70,0,1,0,1,0
9145,28,0,0,70,70,0,1,0,1,0
12262,28,0,0,70,70,0,1,0,1,0
13951,28,0,0,70,70,0,1,0,1,0
9687,28,0,0,66,66,0,1,0,1,0
12175,28,0,0,66,66,0,1,0,1,0
12187,28,0,0,70,70,0,1,0,1,0
12275,28,0,0,66,66,0,1,0,1,0
16884,28,0,0,70,70,0,1,0,1,0
9216,28,0,0,70,70,0,1,0,1,0
14574,28,0,0,66,66,0,1,0,1,0
11379,28,0,0,70,70,0,1,0,1,0
8567,28,0,0,66,66,0,1,0,1,0
8961,28,0,0,66,66,0,1,0,1,0
19160,28,0,0,70,70,0,1,0,1,0
20639,28,0,0,70,70,0,1,0,1,0
22085,28,0,0,70,70,0,1,0,1,0
8942,28,0,0,66,66,0,1,0,1,0
9128,28,0,0,70,70,0,1,0,1,0
12060,28,0,0,70,70,0,1,0,1,0
9017,28,0,0,70,70,0,1,0,1,0
16398,28,0,0,66,66,0,1,0,1,0
13298,28,0,0,66,66,0,1,0,1,0
12714,28,0,0,70,70,0,1,0,1,0
15923,28,0,0,70,70,0,1,0,1,0
16029,28,0,0,66,66,0,1,0,1,0
9350,28,0,0,70,70,0,1,0,1,0
16255,28,0,0,66,66,0,1,0,1,0
14504,28,0,0,70,70,0,1,0,1,0
19883,28,0,0,70,70,0,1,0,1,0
21439,28,0,0,70,70,0,1,0,1,0
18526,28,0,0,66,66,0,1,0,1,0
13273,28,0,0,70,70,0,1,0,1,0
18692,28,0,0,70,70,0,1,0,1,0
13106,28,0,0,66,66,0,1,0,1,0
15655,28,0,0,70,70,0,1,0,1,0
14661,28,0,0,70,70,0,1,0,1,0
22380,28,0,0,66,66,0,1,0,1,0
18152,28,0,0,70,70,0,1,0,1,0
17579,28,0,0,70,70,0,1,0,1,0
20405,28,0,0,70,70,0,1,0,1,0
8975,28,0,0,70,70,0,1,0,1,0
14247,28,0,0,70,70,0,1,0,1,0
20246,28,0,0,70,70,0,1,0,1,0
16730,28,0,0,70,70,0,1,0,1,0
20962,28,0,0,70,70,0,1,0,1,0
19900,28,0,0,70,70,0,1,0,1,0
8974,28,0,0,70,70,0,1,0,1,0
9754,28,0,0,66,66,0,1,0,1,0
16273,28,0,0,66,66,0,1,0,1,0
9882,28,0,0,70,70,0,1,0,1,0
9980,28,0,0,66,66,0,1,0,1,0
14058,28,0,0,66,66,0,1,0,1,0
16850,28,0,0,66,66,0,1,0,1,0
16361,28,0,0,66,66,0,1,0,1,0
13829,28,0,0,70,70,0,1,0,1,0
14503,28,0,0,66,66,0,1,0,1,0
11302,28,0,0,66,66,0,1,0,1,0
20135,28,0,0,70,70,0,1,0,1,0
19957,28,0,0,70,70,0,1,0,1,0
14684,28,0,0,66,66,0,1,0,1,0
14852,28,0,0,66,66,0,1,0,1,0
15421,28,0,0,70,70,0,1,0,1,0
11003,28,0,0,70,70,0,1,0,1,0
13837,28,0,0,70,70,0,1,0,1,0
13068,28,0,0,70,70,0,1,0,1,0
14402,28,0,0,70,70,0,1,0,1,0
11769,28,0,0,70,70,0,1,0,1,0
14208,28,0,0,70,70,0,1,0,1,0
13624,28,0,0,70,70,0,1,0,1,0
15363,28,0,0,66,66,0,1,0,1,0
17752,28,0,0,66,66,0,1,0,1,0
11042,28,0,0,70,70,0,1,0,1,0
21004,28,0,0,66,66,0,1,0,1,0
9556,28,0,0,66,66,0,1,0,1,0
22587,28,0,0,66,66,0,1,0,1,0
8532,28,0,0,70,70,0,1,0,1,0
9478,28,0,0,70,70,0,1,0,1,0
21066,28,0,0,70,70,0,1,0,1,0
11747,28,0,0,70,70,0,1,0,1,0
9628,28,0,0,66,66,0,1,0,1,0
10917,28,0,0,70,70,0,1,0,1,0
14691,28,0,0,66,66,0,1,0,1,0
10108,28,0,0,70,70,0,1,0,1,0
17275,28,0,0,70,70,0,1,0,1,0
14119,28,0,0,70,70,0,1,0,1,0
17529,28,0,0,66,66,0,1,0,1,0
13247,28,0,0,70,70,0,1,0,1,0
12545,28,0,0,66,66,0,1,0,1,0
17071,28,0,0,70,70,0,1,0,1,0
21556,28,0,0,70,70,0,1,0,1,0
16987,28,0,0,70,70,0,1,0,1,0
10119,28,0,0,66,66,0,1,0,1,0
10039,28,0,0,70,70,0,1,0,1,0
18788,28,0,0,70,70,0,1,0,1,0
16667,28,0,0,70,70,0,1,0,1,0
10397,28,0,0,70,70,0,1,0,1,0
11543,28,0,0,70,70,0,1,0,1,0
18086,28,0,0,66,66,0,1,0,1,0
22058,28,0,0,70,70,0,1,0,1,0
11639,28,0,0,70,70,0,1,0,1,0
10239,28,0,0,66,66,0,1,0,1,0
20626,28,0,0,66,66,0,1,0,1,0
22635,28,0,0,70,70,0,1,0,1,0
14213,28,0,0,70,70,0,1,0,1,0
13512,28,0,0,66,66,0,1,0,1,0
16986,28,0,0,66,66,0,1,0,1,0
12342,28,0,0,70,70,0,1,0,1,0
20477,28,0,0,70,70,0,1,0,1,0
17902,28,0,0,66,66,0,1,0,1,0
11965,28,0,0,66,66,0,1,0,1,0
18187,28,0,0,70,70,0,1,0,1,0
10354,28,0,0,70,70,0,1,0,1,0
22228,28,0,0,70,70,0,1,0,1,0
20592,28,0,0,66,66,0,1,0,1,0
20147,28,0,0,70,70,0,1,0,1,0
19602,28,0,0,66,66,0,1,0,1,0
10243,28,0,0,66,66,0,1,0,1,0
21029,28,0,0,70,70,0,1,0,1,0
21121,28,0,0,66,66,0,1,0,1,0
20542,28,0,0,70,70,0,1,0,1,0
15683,28,0,0,70,70,0,1,0,1,0
19868,28,0,0,70,70,0,1,0,1,0
19434,28,0,0,70,70,0,1,0,1,0
16892,28,0,0,70,70,0,1,0,1,0
8555,28,0,0,70,70,0,1,0,1,0
13010,28,0,0,70,70,0,1,0,1,0
16803,28,0,0,70,70,0,1,0,1,0
10501,28,0,0,66,66,0,1,0,1,0
22318,28,0,0,70,70,0,1,0,1,0
10481,28,0,0,70,70,0,1,0,1,0
11428,28,0,0,70,70,0,1,0,1,0
17243,28,0,0,70,70,0,1,0,1,0
22632,28,0,0,70,70,0,1,0,1,0
22064,28,0,0,66,66,0,1,0,1,0
12192,28,0,0,66,66,0,1,0,1,0
21396,28,0,0,70,70,0,1,0,1,0
19874,28,0,0,66,66,0,1,0,1,0
19733,28,0,0,70,70,0,1,0,1,0
17182,28,0,0,66,66,0,1,0,1,0
13969,28,0,0,70,70,0,1,0,1,0
9357,28,0,0,66,66,0,1,0,1,0
15418,28,0,0,70,70,0,1,0,1,0
14162,28,0,0,70,70,0,1,0,1,0
14133,28,0,0,70,70,0,1,0,1,0
14304,28,0,0,70,70,0,1,0,1,0
9531,28,0,0,70,70,0,1,0,1,0
16801,28,0,0,66,66,0,1,0,1,0
18063,28,0,0,70,70,0,1,0,1,0
20710,28,0,0,70,70,0,1,0,1,0
20203,28,0,0,70,70,0,1,0,1,0
19963,28,0,0,66,66,0,1,0,1,0
19423,28,0,0,66,66,0,1,0,1,0
18952,28,0,0,70,70,0,1,0,1,0
12817,28,0,0,70,70,0,1,0,1,0
14751,28,0,0,70,70,0,1,0,1,0
14173,28,0,0,66,66,0,1,0,1,0
12742,28,0,0,70,70,0,1,0,1,0
10336,28,0,0,66,66,0,1,0,1,0
10422,28,0,0,70,70,0,1,0,1,0
14147,28,0,0,70,70,0,1,0,1,0
17900,28,0,0,70,70,0,1,0,1,0
20827,28,0,0,70,70,0,1,0,1,0
9687,28,0,0,66,66,0,1,0,1,0
17408,28,0,0,70,70,0,1,0,1,0
16556,28,0,0,66,66,0,1,0,1,0
21693,28,0,0,70,70,0,1,0,1,0
13874,28,0,0,70,70,0,1,0,1,0
15718,28,0,0,70,70,0,1,0,1,0
15593,28,0,0,66,66,0,1,0,1,0
20903,28,0,0,70,70,0,1,0,1,0
9937,28,0,0,66,66,0,1,0,1,0
20635,28,0,0,70,70,0,1,0,1,0
8830,28,0,0,70,70,0,1,0,1,0
14560,28,0,0,70,70,0,1,0,1,0
11336,28,0,0,70,70,0,1,0,1,0
10652,28,0,0,70,70,0,1,0,1,0
12064,28,0,0,66,66,0,1,0,1,0
16913,28,0,0,70,70,0,1,0,1,0
12641,28,0,0,70,70,0,1,0,1,0
19952,28,0,0,70,70,0,1,0,1,0
19981,28,0,0,70,70,0,1,0,1,0
8902,28,0,0,70,70,0,1,0,1,0
21995,28,0,0,70,70,0,1,0,1,0
16858,28,0,0,70,70,0,1,0,1,0
16081,28,0,0,70,70,0,1,0,1,0
9792,28,0,0,70,70,0,1,0,1,0
14986,28,0,0,70,70,0,1,0,1,0
14376,28,0,0,66,66,0,1,0,1,0
8946,28,0,0,70,70,0,1,0,1,0
21191,28,0,0,70,70,0,1,0,1,0
13876,28,0,0,70,70,0,1,0,1,0
21610,28,0,0,70,70,0,1,0,1,0
21026,28,0,0,70,70,0,1,0,1,0
17853,28,0,0,66,66,0,1,0,1,0
20474,28,0,0,66,66,0,1,0,1,0
11865,28,0,0,70,70,0,1,0,1,0
13327,28,0,0,70,70,0,1,0,1,0
21660,28,0,0,70,70,0,1,0,1,0
10975,28,0,0,70,70,0,1,0,1,0
11116,28,0,0,70,70,0,1,0,1,0
20218,28,0,0,70,70,0,1,0,1,0
17751,28,0,0,70,70,0,1,0,1,0
21585,28,0,0,70,70,0,1,0,1,0
8434,28,0,0,70,70,0,1,0,1,0
13849,28,0,0,70,70,0,1,0,1,0
8833,28,0,0,70,70,0,1,0,1,0
21151,28,0,0,70,70,0,1,0,1,0
11824,28,0,0,66,66,0,1,0,1,0
8690,28,0,0,70,70,0,1,0,1,0
14980,28,0,0,66,66,0,1,0,1,0
20797,28,0,0,70,70,0,1,0,1,0
12900,28,0,0,70,70,0,1,0,1,0
8810,28,0,0,70,70,0,1,0,1,0
9008,28,0,0,66,66,0,1,0,1,0
12706,28,0,0,70,70,0,1,0,1,0
9445,28,0,0,70,70,0,1,0,1,0
19032,28,0,0,70,70,0,1,0,1,0
15235,28,0,0,66,66,0,1,0,1,0
13086,28,0,0,70,70,0,1,0,1,0
19926,28,0,0,70,70,0,1,0,1,0
21509,28,0,0,66,66,0,1,0,1,0
9069,28,0,0,66,66,0,1,0,1,0
13076,28,0,0,66,66,0,1,0,1,0
20074,28,0,0,66,66,0,1,0,1,0
20422,28,0,0,66,66,0,1,0,1,0
19751,28,0,0,70,70,0,1,0,1,0
19335,28,0,0,70,70,0,1,0,1,0
15544,28,0,0,70,70,0,1,0,1,0
16201,28,0,0,70,70,0,1,0,1,0
12452,28,0,0,66,66,0,1,0,1,0
12719,28,0,0,70,70,0,1,0,1,0
22278,28,0,0,66,66,0,1,0,1,0
11642,28,0,0,70,70,0,1,0,1,0
11396,28,0,0,70,70,0,1,0,1,0
13367,28,0,0,70,70,0,1,0,1,0
19695,28,0,0,66,66,0,1,0,1,0
9489,28,0,0,66,66,0,1,0,1,0
13520,28,0,0,66,66,0,1,0,1,0
20713,28,0,0,70,70,0,1,0,1,0
13920,28,0,0,70,70,0,1,0,1,0
21793,28,0,0,70,70,0,1,0,1,0
11872,28,0,0,66,66,0,1,0,1,0
13510,28,0,0,70,70,0,1,0,1,0
13431,28,0,0,70,70,0,1,0,1,0
13574,28,0,0,70,70,0,1,0,1,0
19718,28,0,0,70,70,0,1,0,1,0
11116,28,0,0,66,66,0,1,0,1,0
18143,28,0,0,70,70,0,1,0,1,0
12811,28,0,0,70,70,0,1,0,1,0
15140,28,0,0,66,66,0,1,0,1,0
10021,28,0,0,70,70,0,1,0,1,0
14306,28,0,0,70,70,0,1,0,1,0
19723,28,0,0,70,70,0,1,0,1,0
17862,28,0,0,66,66,0,1,0,1,0
18156,28,0,0,70,70,0,1,0,1,0
21310,28,0,0,66,66,0,1,0,1,0
10813,28,0,0,66,66,0,1,0,1,0
16867,28,0,0,70,70,0,1,0,1,0
10995,28,0,0,70,70,0,1,0,1,0
17413,28,0,0,70,70,0,1,0,1,0
10526,28,0,0,66,66,0,1,0,1,0
19100,28,0,0,70,70,0,1,0,1,0
18833,28,0,0,70,70,0,1,0,1,0
14591,28,0,0,70,70,0,1,0,1,0
9946,28,0,0,66,66,0,1,0,1,0
9393,28,0,0,66,66,0,1,0,1,0
11843,28,0,0,70,70,0,1,0,1,0
9688,28,0,0,70,70,0,1,0,1,0
12346,28,0,0,70,70,0,1,0,1,0
8593,28,0,0,70,70,0,1,0,1,0
19911,28,0,0,66,66,0,1,0,1,0
15223,28,0,0,66,66,0,1,0,1,0
13338,28,0,0,70,70,0,1,0,1,0
16398,28,0,0,70,70,0,1,0,1,0
21706,28,0,0,66,66,0,1,0,1,0
16585,28,0,0,70,70,0,1,0,1,0
10785,28,0,0,70,70,0,1,0,1,0
10071,28,0,0,66,66,0,1,0,1,0
10863,28,0,0,66,66,0,1,0,1,0
17879,28,0,0,70,70,0,1,0,1,0
20588,28,0,0,70,70,0,1,0,1,0
12799,28,0,0,70,70,0,1,0,1,0
19437,28,0,0,70,70,0,1,0,1,0
10342,28,0,0,66,66,0,1,0,1,0
15569,28,0,0,70,70,0,1,0,1,0
19116,28,0,0,66,66,0,1,0,1,0
14982,28,0,0,70,70,0,1,0,1,0
20811,28,0,0,70,70,0,1,0,1,0
19444,28,0,0,66,66,0,1,0,1,0
12217,28,0,0,70,70,0,1,0,1,0
10201,28,0,0,66,66,0,1,0,1,0
18713,28,0,0,70,70,0,1,0,1,0
13922,28,0,0,70,70,0,1,0,1,0
22360,28,0,0,70,70,0,1,0,1,0
13174,28,0,0,66,66,0,1,0,1,0
9851,28,0,0,70,70,0,1,0,1,0
13015,28,0,0,66,66,0,1,0,1,0
18468,28,0,0,70,70,0,1,0,1,0
20173,28,0,0,66,66,0,1,0,1,0
14708,28,0,0,70,70,0,1,0,1,0
13820,28,0,0,70,70,0,1,0,1,0
20043,28,0,0,70,70,0,1,0,1,0
13685,28,0,0,70,70,0,1,0,1,0
17672,28,0,0,70,70,0,1,0,1,0
21782,28,0,0,66,66,0,1,0,1,0
21517,28,0,0,70,70,0,1,0,1,0
16690,28,0,0,70,70,0,1,0,1,0
19877,28,0,0,70,70,0,1,0,1,0
12267,28,0,0,66,66,0,1,0,1,0
9785,28,0,0,70,70,0,1,0,1,0
10185,28,0,0,66,66,0,1,0,1,0
20848,28,0,0,70,70,0,1,0,1,0
15692,28,0,0,66,66,0,1,0,1,0
8828,28,0,0,70,70,0,1,0,1,0
19608,28,0,0,70,70,0,1,0,1,0
16721,28,0,0,70,70,0,1,0,1,0
11912,28,0,0,66,66,0,1,0,1,0
11817,28,0,0,70,70,0,1,0,1,0
21595,28,0,0,70,70,0,1,0,1,0
14126,28,0,0,70,70,0,1,0,1,0
16304,28,0,0,66,66,0,1,0,1,0
14126,28,0,0,70,70,0,1,0,1,0
17887,28,0,0,66,66,0,1,0,1,0
14571,28,0,0,70,70,0,1,0,1,0
10747,28,0,0,70,70,0,1,0,1,0
14904,28,0,0,70,70,0,1,0,1,0
13131,28,0,0,70,70,0,1,0,1,0
9006,28,0,0,66,66,0,1,0,1,0
17490,28,0,0,70,70,0,1,0,1,0
18272,28,0,0,66,66,0,1,0,1,0
15983,28,0,0,70,70,0,1,0,1,0
15795,28,0,0,70,70,0,1,0,1,0
9304,28,0,0,70,70,0,1,0,1,0
10018,28,0,0,66,66,0,1,0,1,0
9138,28,0,0,70,70,0,1,0,1,0
19854,28,0,0,70,70,0,1,0,1,0
16093,28,0,0,70,70,0,1,0,1,0
15028,28,0,0,70,70,0,1,0,1,0
9546,28,0,0,66,66,0,1,0,1,0
22691,28,0,0,66,66,0,1,0,1,0
11668,28,0,0,66,66,0,1,0,1,0
14203,28,0,0,70,70,0,1,0,1,0
11910,28,0,0,70,70,0,1,0,1,0
20582,28,0,0,66,66,0,1,0,1,0
16142,28,0,0,66,66,0,1,0,1,0
10042,28,0,0,66,66,0,1,0,1,0
13935,28,0,0,70,70,0,1,0,1,0
21677,28,0,0,70,70,0,1,0,1,0
13717,28,0,0,70,70,0,1,0,1,0
11943,28,0,0,70,70,0,1,0,1,0
9110,28,0,0,70,70,0,1,0,1,0
17637,28,0,0,66,66,0,1,0,1,0
14426,28,0,0,66,66,0,1,0,1,0
20780,28,0,0,66,66,0,1,0,1,0
19624,28,0,0,70,70,0,1,0,1,0
20854,28,0,0,70,70,0,1,0,1,0
10624,28,0,0,66,66,0,1,0,1,0
15323,28,0,0,70,70,0,1,0,1,0
9205,28,0,0,66,66,0,1,0,1,0
16709,28,0,0,70,70,0,1,0,1,0
21497,28,0,0,66,66,0,1,0,1,0
9067,28,0,0,66,66,0,1,0,1,0
20741,28,0,0,66,66,0,1,0,1,0
11853,28,0,0,66,66,0,1,0,1,0
12769,28,0,0,70,70,0,1,0,1,0
17709,28,0,0,70,70,0,1,0,1,0
13109,28,0,0,66,66,0,1,0,1,0
15429,28,0,0,70,70,0,1,0,1,0
13781,28,0,0,70,70,0,1,0,1,0
14700,28,0,0,70,70,0,1,0,1,0
18417,28,0,0,70,70,0,1,0,1,0
12587,28,0,0,70,70,0,1,0,1,0
20256,28,0,0,70,70,0,1,0,1,0
9840,28,0,0,66,66,0,1,0,1,0
22250,28,0,0,70,70,0,1,0,1,0
9183,28,0,0,66,66,0,1,0,1,0
14644,28,0,0,70,70,0,1,0,1,0
18616,28,0,0,70,70,0,1,0,1,0
8958,28,0,0,70,70,0,1,0,1,0
22682,28,0,0,70,70,0,1,0,1,0
15343,28,0,0,70,70,0,1,0,1,0
14412,28,0,0,66,66,0,1,0,1,0
12200,28,0,0,66,66,0,1,0,1,0
13311,28,0,0,70,70,0,1,0,1,0
9934,28,0,0,66,66,0,1,0,1,0
10083,28,0,0,70,70,0,1,0,1,0
20702,28,0,0,70,70,0,1,0,1,0
14300,28,0,0,70,70,0,1,0,1,0
18425,28,0,0,70,70,0,1,0,1,0
8693,28,0,0,66,66,0,1,0,1,0
14961,28,0,0,70,70,0,1,0,1,0
15448,28,0,0,70,70,0,1,0,1,0
17888,28,0,0,66,66,0,1,0,1,0
11631,28,0,0,70,70,0,1,0,1,0
13609,28,0,0,70,70,0,1,0,1,0
10499,28,0,0,66,66,0,1,0,1,0
13756,28,0,0,66,66,0,1,0,1,0
12220,28,0,0,70,70,0,1,0,1,0
9358,28,0,0,66,66,0,1,0,1,0
12208,28,0,0,70,70,0,1,0,1,0
17832,28,0,0,70,70,0,1,0,1,0
20212,28,0,0,70,70,0,1,0,1,0
10432,28,0,0,66,66,0,1,0,1,0
15280,28,0,0,66,66,0,1,0,1,0
20908,28,0,0,66,66,0,1,0,1,0
18501,28,0,0,66,66,0,1,0,1,0
12409,28,0,0,70,70,0,1,0,1,0
11069,28,0,0,70,70,0,1,0,1,0
19158,28,0,0,70,70,0,1,0,1,0
15616,28,0,0,66,66,0,1,0,1,0
14844,28,0,0,66,66,0,1,0,1,0
14201,28,0,0,70,70,0,1,0,1,0
20422,28,0,0,70,70,0,1,0,1,0
19875,28,0,0,66,66,0,1,0,1,0
13739,28,0,0,70,70,0,1,0,1,0
17079,28,0,0,70,70,0,1,0,1,0
17359,28,0,0,70,70,0,1,0,1,0
9444,28,0,0,70,70,0,1,0,1,0
9631,28,0,0,70,70,0,1,0,1,0
11250,28,0,0,66,66,0,1,0,1,0
15258,28,0,0,70,70,0,1,0,1,0
22666,28,0,0,70,70,0,1,0,1,0
16725,28,0,0,70,70,0,1,0,1,0
21734,28,0,0,66,66,0,1,0,1,0
12764,28,0,0,70,70,0,1,0,1,0
17693,28,0,0,70,70,0,1,0,1,0
13010,28,0,0,66,66,0,1,0,1,0
16233,28,0,0,70,70,0,1,0,1,0
12172,28,0,0,70,70,0,1,0,1,0
9490,28,0,0,66,66,0,1,0,1,0
11985,28,0,0,66,66,0,1,0,1,0
16854,28,0,0,66,66,0,1,0,1,0
18925,28,0,0,70,70,0,1,0,1,0
9662,28,0,0,66,66,0,1,0,1,0
17909,28,0,0,70,70,0,1,0,1,0
15290,28,0,0,70,70,0,1,0,1,0
15465,28,0,0,70,70,0,1,0,1,0
13651,28,0,0,70,70,0,1,0,1,0
19033,28,0,0,70,70,0,1,0,1,0
9898,28,0,0,70,70,0,1,0,1,0
13432,28,0,0,66,66,0,1,0,1,0
16545,28,0,0,66,66,0,1,0,1,0
11606,28,0,0,66,66,0,1,0,1,0
21871,28,0,0,70,70,0,1,0,1,0
11881,28,0,0,70,70,0,1,0,1,0
15874,28,0,0,70,70,0,1,0,1,0
13629,28,0,0,70,70,0,1,0,1,0
13969,28,0,0,70,70,0,1,0,1,0
18604,28,0,0,70,70,0,1,0,1,0
22114,28,0,0,70,70,0,1,0,1,0
15446,28,0,0,70,70,0,1,0,1,0
8954,28,0,0,70,70,0,1,0,1,0
15540,28,0,0,66,66,0,1,0,1,0
9759,28,0,0,70,70,0,1,0,1,0
12338,28,0,0,70,70,0,1,0,1,0
19468,28,0,0,70,70,0,1,0,1,0
13610,28,0,0,70,70,0,1,0,1,0
13828,28,0,0,70,70,0,1,0,1,0
11186,28,0,0,66,66,0,1,0,1,0
11173,28,0,0,66,66,0,1,0,1,0
14106,28,0,0,70,70,0,1,0,1,0
8424,28,0,0,70,70,0,1,0,1,0
22317,28,0,0,70,70,0,1,0,1,0
13045,28,0,0,66,66,0,1,0,1,0
17450,28,0,0,70,70,0,1,0,1,0
19055,28,0,0,66,66,0,1,0,1,0
13300,28,0,0,66,66,0,1,0,1,0
20075,28,0,0,66,66,0,1,0,1,0
14962,28,0,0,66,66,0,1,0,1,0
16596,28,0,0,70,70,0,1,0,1,0
21337,28,0,0,66,66,0,1,0,1,0
10836,28,0,0,70,70,0,1,0,1,0
21796,28,0,0,70,70,0,1,0,1,0
20572,28,0,0,70,70,0,1,0,1,0
11015,28,0,0,70,70,0,1,0,1,0
9539,28,0,0,70,70,0,1,0,1,0
16101,28,0,0,66,66,0,1,0,1,0
9086,28,0,0,70,70,0,1,0,1,0
17616,28,0,0,66,66,0,1,0,1,0
8878,28,0,0,66,66,0,1,0,1,0
14527,28,0,0,66,66,0,1,0,1,0
20449,28,0,0,70,70,0,1,0,1,0
19051,28,0,0,70,70,0,1,0,1,0
10819,28,0,0,70,70,0,1,0,1,0
18662,28,0,0,70,70,0,1,0,1,0
15542,28,0,0,66,66,0,1,0,1,0
16809,28,0,0,70,70,0,1,0,1,0
16578,28,0,0,70,70,0,1,0,1,0
10813,28,0,0,70,70,0,1,0,1,0
9973,28,0,0,70,70,0,1,0,1,0
12212,28,0,0,70,70,0,1,0,1,0
19005,28,0,0,70,70,0,1,0,1,0
9626,28,0,0,66,66,0,1,0,1,0
18605,28,0,0,66,66,0,1,0,1,0
22552,28,0,0,66,66,0,1,0,1,0
21602,28,0,0,70,70,0,1,0,1,0
21457,28,0,0,66,66,0,1,0,1,0
14657,28,0,0,70,70,0,1,0,1,0
17745,28,0,0,70,70,0,1,0,1,0
15886,28,0,0,70,70,0,1,0,1,0
15719,28,0,0,70,70,0,1,0,1,0
14666,28,0,0,66,66,0,1,0,1,0
16874,28,0,0,70,70,0,1,0,1,0
13979,28,0,0,70,70,0,1,0,1,0
18016,28,0,0,70,70,0,1,0,1,0
8721,28,0,0,70,70,0,1,0,1,0
14179,28,0,0,70,70,0,1,0,1,0
9816,28,0,0,70,70,0,1,0,1,0
15601,28,0,0,70,70,0,1,0,1,0
14135,28,0,0,66,66,0,1,0,1,0
16816,28,0,0,70,70,0,1,0,1,0
17574,28,0,0,70,70,0,1,0,1,0
13061,28,0,0,66,66,0,1,0,1,0
22243,28,0,0,70,70,0,1,0,1,0
13888,28,0,0,66,66,0,1,0,1,0
12685,28,0,0,70,70,0,1,0,1,0
17555,28,0,0,70,70,0,1,0,1,0
13231,28,0,0,70,70,0,1,0,1,0
11869,28,0,0,70,70,0,1,0,1,0
20052,28,0,0,70,70,0,1,0,1,0
10160,28,0,0,70,70,0,1,0,1,0
22404,28,0,0,70,70,0,1,0,1,0
20368,28,0,0,66,66,0,1,0,1,0
18901,28,0,0,66,66,0,1,0,1,0
22184,28,0,0,70,70,0,1,0,1,0
11057,28,0,0,66,66,0,1,0,1,0
12305,28,0,0,66,66,0,1,0,1,0
10375,28,0,0,70,70,0,1,0,1,0
15661,28,0,0,66,66,0,1,0,1,0
20887,28,0,0,70,70,0,1,0,1,0
13534,28,0,0,66,66,0,1,0,1,0
9475,28,0,0,70,70,0,1,0,1,0
17634,28,0,0,70,70,0,1,0,1,0
10375,28,0,0,70,70,0,1,0,1,0
17817,28,0,0,66,66,0,1,0,1,0
14400,28,0,0,70,70,0,1,0,1,0
12788,28,0,0,66,66,0,1,0,1,0
9952,28,0,0,70,70,0,1,0,1,0
11305,28,0,0,66,66,0,1,0,1,0
13171,28,0,0,66,66,0,1,0,1,0
9118,28,0,0,70,70,0,1,0,1,0
9670,28,0,0,66,66,0,1,0,1,0
13605,28,0,0,70,70,0,1,0,1,0
12718,28,0,0,66,66,0,1,0,1,0
14673,28,0,0,70,70,0,1,0,1,0
20679,28,0,0,66,66,0,1,0,1,0
20767,28,0,0,70,70,0,1,0,1,0
15503,28,0,0,70,70,0,1,0,1,0
12481,28,0,0,70,70,0,1,0,1,0
20836,28,0,0,70,70,0,1,0,1,0
21924,28,0,0,66,66,0,1,0,1,0
10889,28,0,0,66,66,0,1,0,1,0
9616,28,0,0,66,66,0,1,0,1,0
11776,28,0,0,70,70,0,1,0,1,0
12467,28,0,0,70,70,0,1,0,1,0
13550,28,0,0,70,70,0,1,0,1,0
12722,28,0,0,66,66,0,1,0,1,0
10549,28,0,0,66,66,0,1,0,1,0
22049,28,0,0,66,66,0,1,0,1,0
10190,28,0,0,70,70,0,1,0,1,0
16425,28,0,0,70,70,0,1,0,1,0
16251,28,0,0,70,70,0,1,0,1,0
19517,28,0,0,66,66,0,1,0,1,0
19388,28,0,0,70,70,0,1,0,1,0
14781,28,0,0,70,70,0,1,0,1,0
9488,28,0,0,70,70,0,1,0,1,0
12839,28,0,0,70,70,0,1,0,1,0
20049,28,0,0,70,70,0,1,0,1,0
12981,28,0,0,70,70,0,1,0,1,0
14318,28,0,0,70,70,0,1,0,1,0
10976,28,0,0,70,70,0,1,0,1,0
10911,28,0,0,70,70,0,1,0,1,0
15412,28,0,0,70,70,0,1,0,1,0
21038,28,0,0,70,70,0,1,0,1,0
16817,28,0,0,66,66,0,1,0,1,0
9669,28,0,0,70,70,0,1,0,1,0
22087,28,0,0,66,66,0,1,0,1,0
9007,28,0,0,70,70,0,1,0,1,0
12376,28,0,0,70,70,0,1,0,1,0
12474,28,0,0,70,70,0,1,0,1,0
8923,28,0,0,70,70,0,1,0,1,0
10384,28,0,0,70,70,0,1,0,1,0
10757,28,0,0,66,66,0,1,0,1,0
13245,28,0,0,70,70,0,1,0,1,0
22707,28,0,0,66,66,0,1,0,1,0
10059,28,0,0,66,66,0,1,0,1,0
10764,28,0,0,70,70,0,1,0,1,0
13148,28,0,0,70,70,0,1,0,1,0
14005,28,0,0,66,66,0,1,0,1,0
10622,28,0,0,70,70,0,1,0,1,0
15989,28,0,0,70,70,0,1,0,1,0
9386,28,0,0,66,66,0,1,0,1,0
18504,28,0,0,70,70,0,1,0,1,0
16656,28,0,0,66,66,0,1,0,1,0
9431,28,0,0,70,70,0,1,0,1,0
20229,28,0,0,70,70,0,1,0,1,0
19657,28,0,0,66,66,0,1,0,1,0
13959,28,0,0,66,66,0,1,0,1,0
13579,28,0,0,70,70,0,1,0,1,0
9289,28,0,0,70,70,0,1,0,1,0
18071,28,0,0,66,66,0,1,0,1,0
10151,28,0,0,70,70,0,1,0,1,0
9292,28,0,0,70,70,0,1,0,1,0
15825,28,0,0,66,66,0,1,0,1,0
16264,28,0,0,70,70,0,1,0,1,0
13501,28,0,0,66,66,0,1,0,1,0
15862,28,0,0,66,66,0,1,0,1,0
20009,28,0,0,66,66,0,1,0,1,0
10952,28,0,0,70,70,0,1,0,1,0
12978,28,0,0,70,70,0,1,0,1,0
19404,28,0,0,66,66,0,1,0,1,0
16604,28,0,0,70,70,0,1,0,1,0
8751,28,0,0,66,66,0,1,0,1,0
12882,28,0,0,66,66,0,1,0,1,0
11633,28,0,0,70,70,0,1,0,1,0
18362,28,0,0,70,70,0,1,0,1,0
19310,28,0,0,66,66,0,1,0,1,0
9091,28,0,0,66,66,0,1,0,1,0
9501,28,0,0,70,70,0,1,0,1,0
13012,28,0,0,70,70,0,1,0,1,0
9201,28,0,0,70,70,0,1,0,1,0
19293,28,0,0,66,66,0,1,0,1,0
16776,28,0,0,70,70,0,1,0,1,0
16550,28,0,0,70,70,0,1,0,1,0
10721,28,0,0,70,70,0,1,0,1,0
17995,28,0,0,70,70,0,1,0,1,0
12592,28,0,0,66,66,0,1,0,1,0
16977,28,0,0,70,70,0,1,0,1,0
19440,28,0,0,70,70,0,1,0,1,0
17290,28,0,0,66,66,0,1,0,1,0
14420,28,0,0,70,70,0,1,0,1,0
22062,28,0,0,70,70,0,1,0,1,0
10785,28,0,0,70,70,0,1,0,1,0
20425,28,0,0,70,70,0,1,0,1,0
20751,28,0,0,70,70,0,1,0,1,0
13987,28,0,0,66,66,0,1,0,1,0
9216,28,0,0,66,66,0,1,0,1,0
13793,28,0,0,66,66,0,1,0,1,0
14335,28,0,0,70,70,0,1,0,1,0
9472,28,0,0,70,70,0,1,0,1,0
21202,28,0,0,70,70,0,1,0,1,0
19983,28,0,0,66,66,0,1,0,1,0
21923,28,0,0,70,70,0,1,0,1,0
22606,28,0,0,70,70,0,1,0,1,0
15274,28,0,0,70,70,0,1,0,1,0
9409,28,0,0,66,66,0,1,0,1,0
13475,28,0,0,66,66,0,1,0,1,0
15538,28,0,0,70,70,0,1,0,1,0
13693,28,0,0,70,70,0,1,0,1,0
16515,28,0,0,66,66,0,1,0,1,0
19719,28,0,0,66,66,0,1,0,1,0
20781,28,0,0,70,70,0,1,0,1,0
10228,28,0,0,66,66,0,1,0,1,0
20415,28,0,0,70,70,0,1,0,1,0
16518,28,0,0,70,70,0,1,0,1,0
21508,28,0,0,70,70,0,1,0,1,0
19239,28,0,0,66,66,0,1,0,1,0
12608,28,0,0,66,66,0,1,0,1,0
8700,28,0,0,70,70,0,1,0,1,0
21432,28,0,0,70,70,0,1,0,1,0
20257,28,0,0,70,70,0,1,0,1,0
17267,28,0,0,70,70,0,1,0,1,0
20232,28,0,0,70,70,0,1,0,1,0
17859,28,0,0,70,70,0,1,0,1,0
16598,28,0,0,66,66,0,1,0,1,0
9998,28,0,0,70,70,0,1,0,1,0
10108,28,0,0,66,66,0,1,0,1,0
16945,28,0,0,66,66,0,1,0,1,0
20982,28,0,0,70,70,0,1,0,1,0
20236,28,0,0,70,70,0,1,0,1,0
16837,28,0,0,70,70,0,1,0,1,0
14454,28,0,0,66,66,0,1,0,1,0
21075,28,0,0,66,66,0,1,0,1,0
21000,28,0,0,70,70,0,1,0,1,0
19201,28,0,0,66,66,0,1,0,1,0
15472,28,0,0,66,66,0,1,0,1,0
12132,28,0,0,66,66,0,1,0,1,0
10366,28,0,0,70,70,0,1,0,1,0
18436,28,0,0,66,66,0,1,0,1,0
16883,28,0,0,70,70,0,1,0,1,0
9827,28,0,0,70,70,0,1,0,1,0
9304,28,0,0,66,66,0,1,0,1,0
9587,28,0,0,66,66,0,1,0,1,0
11386,28,0,0,70,70,0,1,0,1,0
20577,28,0,0,70,70,0,1,0,1,0
17776,28,0,0,70,70,0,1,0,1,0
8689,28,0,0,70,70,0,1,0,1,0
11893,28,0,0,70,70,0,1,0,1,0
11807,28,0,0,66,66,0,1,0,1,0
10677,28,0,0,66,66,0,1,0,1,0
10272,28,0,0,70,70,0,1,0,1,0
17698,28,0,0,70,70,0,1,0,1,0
17367,28,0,0,70,70,0,1,0,1,0
10248,28,0,0,70,70,0,1,0,1,0
17712,28,0,0,70,70,0,1,0,1,0
20847,28,0,0,70,70,0,1,0,1,0
20898,28,0,0,70,70,0,1,0,1,0
8770,28,0,0,70,70,0,1,0,1,0
19604,28,0,0,66,66,0,1,0,1,0
20948,28,0,0,70,70,0,1,0,1,0
12438,28,0,0,70,70,0,1,0,1,0
10484,28,0,0,70,70,0,1,0,1,0
14811,28,0,0,70,70,0,1,0,1,0
18471,28,0,0,70,70,0,1,0,1,0
13222,28,0,0,70,70,0,1,0,1,0
11106,28,0,0,70,70,0,1,0,1,0
21503,28,0,0,70,70,0,1,0,1,0
10275,28,0,0,70,70,0,1,0,1,0
13257,28,0,0,70,70,0,1,0,1,0
16761,28,0,0,66,66,0,1,0,1,0
14464,28,0,0,66,66,0,1,0,1,0
9783,28,0,0,70,70,0,1,0,1,0
21293,28,0,0,66,66,0,1,0,1,0
9228,28,0,0,70,70,0,1,0,1,0
15400,28,0,0,70,70,0,1,0,1,0
15215,28,0,0,66,66,0,1,0,1,0
15050,28,0,0,66,66,0,1,0,1,0
9329,28,0,0,70,70,0,1,0,1,0
14181,28,0,0,66,66,0,1,0,1,0
19460,28,0,0,66,66,0,1,0,1,0
20361,28,0,0,70,70,0,1,0,1,0
18270,28,0,0,70,70,0,1,0,1,0
10435,28,0,0,70,70,0,1,0,1,0
10845,28,0,0,70,70,0,1,0,1,0
19392,28,0,0,70,70,0,1,0,1,0
15358,28,0,0,70,70,0,1,0,1,0
10704,28,0,0,70,70,0,1,0,1,0
14025,28,0,0,70,70,0,1,0,1,0
13119,28,0,0,70,70,0,1,0,1,0
20037,28,0,0,70,70,0,1,0,1,0
17727,28,0,0,70,70,0,1,0,1,0
9995,28,0,0,66,66,0,1,0,1,0
11863,28,0,0,70,70,0,1,0,1,0
9299,28,0,0,70,70,0,1,0,1,0
19299,28,0,0,70,70,0,1,0,1,0
14818,28,0,0,70,70,0,1,0,1,0
19584,28,0,0,70,70,0,1,0,1,0
19204,28,0,0,66,66,0,1,0,1,0
11036,28,0,0,70,70,0,1,0,1,0
12085,28,0,0,66,66,0,1,0,1,0
9453,28,0,0,70,70,0,1,0,1,0
14349,28,0,0,70,70,0,1,0,1,0
20346,28,0,0,70,70,0,1,0,1,0
16836,28,0,0,70,70,0,1,0,1,0
18368,28,0,0,70,70,0,1,0,1,0
20461,28,0,0,70,70,0,1,0,1,0
21235,28,0,0,70,70,0,1,0,1,0
18531,28,0,0,70,70,0,1,0,1,0
15183,28,0,0,70,70,0,1,0,1,0
12009,28,0,0,70,70,0,1,0,1,0
14564,28,0,0,66,66,0,1,0,1,0
16430,28,0,0,70,70,0,1,0,1,0
9370,28,0,0,70,70,0,1,0,1,0
14064,28,0,0,70,70,0,1,0,1,0
19668,28,0,0,70,70,0,1,0,1,0
9159,28,0,0,70,70,0,1,0,1,0
13156,28,0,0,66,66,0,1,0,1,0
20726,28,0,0,70,70,0,1,0,1,0
20041,28,0,0,66,66,0,1,0,1,0
15676,28,0,0,66,66,0,1,0,1,0
17483,28,0,0,66,66,0,1,0,1,0
9573,28,0,0,70,70,0,1,0,1,0
19482,28,0,0,70,70,0,1,0,1,0
21363,28,0,0,66,66,0,1,0,1,0
22156,28,0,0,70,70,0,1,0,1,0
14938,28,0,0,70,70,0,1,0,1,0
8829,28,0,0,70,70,0,1,0,1,0
11716,28,0,0,70,70,0,1,0,1,0
19216,28,0,0,70,70,0,1,0,1,0
11202,28,0,0,66,66,0,1,0,1,0
18690,28,0,0,70,70,0,1,0,1,0
16080,28,0,0,66,66,0,1,0,1,0
21654,28,0,0,70,70,0,1,0,1,0
17425,28,0,0,66,66,0,1,0,1,0
19199,28,0,0,66,66,0,1,0,1,0
13069,28,0,0,70,70,0,1,0,1,0
9017,28,0,0,66,66,0,1,0,1,0
19323,28,0,0,70,70,0,1,0,1,0
22565,28,0,0,70,70,0,1,0,1,0
17038,28,0,0,66,66,0,1,0,1,0
15230,28,0,0,70,70,0,1,0,1,0
11338,28,0,0,70,70,0,1,0,1,0
16066,28,0,0,66,66,0,1,0,1,0
21455,28,0,0,70,70,0,1,0,1,0
13361,28,0,0,70,70,0,1,0,1,0
17169,28,0,0,70,70,0,1,0,1,0
13973,28,0,0,70,70,0,1,0,1,0
14489,28,0,0,70,70,0,1,0,1,0
11325,28,0,0,70,70,0,1,0,1,0
12265,28,0,0,70,70,0,1,0,1,0
11651,28,0,0,66,66,0,1,0,1,0
16645,28,0,0,66,66,0,1,0,1,0
16187,28,0,0,70,70,0,1,0,1,0
15726,28,0,0,70,70,0,1,0,1,0
14089,28,0,0,70,70,0,1,0,1,0
18399,28,0,0,66,66,0,1,0,1,0
21007,28,0,0,70,70,0,1,0,1,0
15687,28,0,0,70,70,0,1,0,1,0
19002,28,0,0,70,70,0,1,0,1,0
8850,28,0,0,66,66,0,1,0,1,0
16903,28,0,0,66,66,0,1,0,1,0
17627,28,0,0,70,70,0,1,0,1,0
10140,28,0,0,66,66,0,1,0,1,0
16557,28,0,0,66,66,0,1,0,1,0
21422,28,0,0,70,70,0,1,0,1,0
20403,28,0,0,70,70,0,1,0,1,0
10213,28,0,0,70,70,0,1,0,1,0
8515,28,0,0,70,70,0,1,0,1,0
15485,28,0,0,70,70,0,1,0,1,0
11794,28,0,0,70,70,0,1,0,1,0
10553,28,0,0,66,66,0,1,0,1,0
11546,28,0,0,70,70,0,1,0,1,0
17881,28,0,0,70,70,0,1,0,1,0
13750,28,0,0,70,70,0,1,0,1,0
13941,28,0,0,70,70,0,1,0,1,0
10492,28,0,0,70,70,0,1,0,1,0
11169,28,0,0,70,70,0,1,0,1,0
16584,28,0,0,70,70,0,1,0,1,0
15975,28,0,0,70,70,0,1,0,1,0
19019,28,0,0,66,66,0,1,0,1,0
17959,28,0,0,70,70,0,1,0,1,0
18941,28,0,0,70,70,0,1,0,1,0
9032,28,0,0,70,70,0,1,0,1,0
10020,28,0,0,70,70,0,1,0,1,0
10500,28,0,0,66,66,0,1,0,1,0
20738,28,0,0,70,70,0,1,0,1,0
12118,28,0,0,70,70,0,1,0,1,0
10221,28,0,0,70,70,0,1,0,1,0
9485,28,0,0,70,70,0,1,0,1,0
18976,28,0,0,70,70,0,1,0,1,0
16503,28,0,0,70,70,0,1,0,1,0
12525,28,0,0,70,70,0,1,0,1,0
12517,28,0,0,66,66,0,1,0,1,0
9482,28,0,0,66,66,0,1,0,1,0
16352,28,0,0,70,70,0,1,0,1,0
20830,28,0,0,66,66,0,1,0,1,0
11194,28,0,0,70,70,0,1,0,1,0
18631,28,0,0,70,70,0,1,0,1,0
18307,28,0,0,70,70,0,1,0,1,0
21077,28,0,0,66,66,0,1,0,1,0
20066,28,0,0,66,66,0,1,0,1,0
9949,28,0,0,70,70,0,1,0,1,0
9417,28,0,0,70,70,0,1,0,1,0
18895,28,0,0,70,70,0,1,0,1,0
19858,28,0,0,66,66,0,1,0,1,0
11588,28,0,0,70,70,0,1,0,1,0
21311,28,0,0,66,66,0,1,0,1,0
20384,28,0,0,66,66,0,1,0,1,0
17897,28,0,0,70,70,0,1,0,1,0
9140,28,0,0,70,70,0,1,0,1,0
9301,28,0,0,70,70,0,1,0,1,0
18245,28,0,0,70,70,0,1,0,1,0
8913,28,0,0,70,70,0,1,0,1,0
11689,28,0,0,70,70,0,1,0,1,0
18829,28,0,0,70,70,0,1,0,1,0
15621,28,0,0,70,70,0,1,0,1,0
19872,28,0,0,70,70,0,1,0,1,0
20853,28,0,0,66,66,0,1,0,1,0
9416,28,0,0,70,70,0,1,0,1,0
9777,28,0,0,70,70,0,1,0,1,0
9922,28,0,0,66,66,0,1,0,1,0
13750,28,0,0,70,70,0,1,0,1,0
9940,28,0,0,70,70,0,1,0,1,0
22096,28,0,0,70,70,0,1,0,1,0
22177,28,0,0,66,66,0,1,0,1,0
11206,28,0,0,70,70,0,1,0,1,0
9909,28,0,0,70,70,0,1,0,1,0
9550,28,0,0,70,70,0,1,0,1,0
15215,28,0,0,70,70,0,1,0,1,0
15322,28,0,0,70,70,0,1,0,1,0
15261,28,0,0,70,70,0,1,0,1,0
20883,28,0,0,70,70,0,1,0,1,0
20930,28,0,0,66,66,0,1,0,1,0
13678,28,0,0,70,70,0,1,0,1,0
10616,28,0,0,66,66,0,1,0,1,0
19149,28,0,0,70,70,0,1,0,1,0
18013,28,0,0,70,70,0,1,0,1,0
8612,28,0,0,70,70,0,1,0,1,0
21578,28,0,0,70,70,0,1,0,1,0
15611,28,0,0,70,70,0,1,0,1,0
13579,28,0,0,70,70,0,1,0,1,0
21284,28,0,0,66,66,0,1,0,1,0
20640,28,0,0,66,66,0,1,0,1,0
17665,28,0,0,66,66,0,1,0,1,0
14632,28,0,0,70,70,0,1,0,1,0
12696,28,0,0,70,70,0,1,0,1,0
14619,28,0,0,70,70,0,1,0,1,0
9910,28,0,0,70,70,0,1,0,1,0
22523,28,0,0,70,70,0,1,0,1,0
13597,28,0,0,70,70,0,1,0,1,0
22076,28,0,0,70,70,0,1,0,1,0
21185,28,0,0,66,66,0,1,0,1,0
14550,28,0,0,66,66,0,1,0,1,0
12589,28,0,0,66,66,0,1,0,1,0
21309,28,0,0,70,70,0,1,0,1,0
22551,28,0,0,70,70,0,1,0,1,0
20638,28,0,0,70,70,0,1,0,1,0
19539,28,0,0,70,70,0,1,0,1,0
16712,28,0,0,66,66,0,1,0,1,0
17310,28,0,0,66,66,0,1,0,1,0
16235,28,0,0,66,66,0,1,0,1,0
11602,28,0,0,70,70,0,1,0,1,0
19816,28,0,0,70,70,0,1,0,1,0
8943,28,0,0,66,66,0,1,0,1,0
17306,28,0,0,66,66,0,1,0,1,0
19901,28,0,0,70,70,0,1,0,1,0
11161,28,0,0,70,70,0,1,0,1,0
12388,28,0,0,70,70,0,1,0,1,0
9682,28,0,0,66,66,0,1,0,1,0
17343,28,0,0,70,70,0,1,0,1,0
14368,28,0,0,70,70,0,1,0,1,0
19086,28,0,0,70,70,0,1,0,1,0
12444,28,0,0,70,70,0,1,0,1,0
14200,28,0,0,70,70,0,1,0,1,0
22274,28,0,0,66,66,0,1,0,1,0
8734,28,0,0,66,66,0,1,0,1,0
16806,28,0,0,66,66,0,1,0,1,0
17095,28,0,0,70,70,0,1,0,1,0
9252,28,0,0,70,70,0,1,0,1,0
16535,28,0,0,70,70,0,1,0,1,0
21568,28,0,0,66,66,0,1,0,1,0
16994,28,0,0,70,70,0,1,0,1,0
13779,28,0,0,70,70,0,1,0,1,0
12067,28,0,0,70,70,0,1,0,1,0
14995,28,0,0,70,70,0,1,0,1,0
15650,28,0,0,70,70,0,1,0,1,0
16711,28,0,0,70,70,0,1,0,1,0
22529,28,0,0,70,70,0,1,0,1,0
9312,28,0,0,70,70,0,1,0,1,0
20896,28,0,0,70,70,0,1,0,1,0
13752,28,0,0,70,70,0,1,0,1,0
21568,28,0,0,70,70,0,1,0,1,0
15029,28,0,0,70,70,0,1,0,1,0
17079,28,0,0,70,70,0,1,0,1,0
20480,28,0,0,70,70,0,1,0,1,0
20221,28,0,0,70,70,0,1,0,1,0
9902,28,0,0,66,66,0,1,0,1,0
12522,28,0,0,66,66,0,1,0,1,0
12741,28,0,0,70,70,0,1,0,1,0
17115,28,0,0,70,70,0,1,0,1,0
18913,28,0,0,70,70,0,1,0,1,0
15659,28,0,0,70,70,0,1,0,1,0
22266,28,0,0,70,70,0,1,0,1,0
10406,28,0,0,70,70,0,1,0,1,0
17843,28,0,0,70,70,0,1,0,1,0
15657,28,0,0,66,66,0,1,0,1,0
8915,28,0,0,70,70,0,1,0,1,0
13765,28,0,0,70,70,0,1,0,1,0
18763,28,0,0,66,66,0,1,0,1,0
18949,28,0,0,66,66,0,1,0,1,0
18834,28,0,0,66,66,0,1,0,1,0
11515,28,0,0,66,66,0,1,0,1,0
12969,28,0,0,66,66,0,1,0,1,0
19228,28,0,0,66,66,0,1,0,1,0
13005,28,0,0,70,70,0,1,0,1,0
19801,28,0,0,70,70,0,1,0,1,0
13904,28,0,0,70,70,0,1,0,1,0
10374,28,0,0,70,70,0,1,0,1,0
19550,28,0,0,66,66,0,1,0,1,0
9580,28,0,0,66,66,0,1,0,1,0
11532,28,0,0,70,70,0,1,0,1,0
12562,28,0,0,70,70,0,1,0,1,0
21221,28,0,0,70,70,0,1,0,1,0
10626,28,0,0,70,70,0,1,0,1,0
18803,28,0,0,70,70,0,1,0,1,0
20541,28,0,0,70,70,0,1,0,1,0
11362,28,0,0,66,66,0,1,0,1,0
9924,28,0,0,70,70,0,1,0,1,0
9844,28,0,0,70,70,0,1,0,1,0
13138,28,0,0,66,66,0,1,0,1,0
13032,28,0,0,70,70,0,1,0,1,0
21224,28,0,0,70,70,0,1,0,1,0
21724,28,0,0,66,66,0,1,0,1,0
12402,28,0,0,70,70,0,1,0,1,0
20421,28,0,0,66,66,0,1,0,1,0
12134,28,0,0,70,70,0,1,0,1,0
19172,28,0,0,70,70,0,1,0,1,0
11567,28,0,0,70,70,0,1,0,1,0
21550,28,0,0,66,66,0,1,0,1,0
19248,28,0,0,70,70,0,1,0,1,0
16269,28,0,0,70,70,0,1,0,1,0
9434,28,0,0,70,70,0,1,0,1,0
15828,28,0,0,66,66,0,1,0,1,0
14040,28,0,0,70,70,0,1,0,1,0
9751,28,0,0,66,66,0,1,0,1,0
17516,28,0,0,70,70,0,1,0,1,0
22141,28,0,0,70,70,0,1,0,1,0
13249,28,0,0,70,70,0,1,0,1,0
19405,28,0,0,66,66,0,1,0,1,0
20087,28,0,0,70,70,0,1,0,1,0
9171,28,0,0,66,66,0,1,0,1,0
14067,28,0,0,70,70,0,1,0,1,0
17402,28,0,0,66,66,0,1,0,1,0
14871,28,0,0,70,70,0,1,0,1,0
21524,28,0,0,70,70,0,1,0,1,0
12497,28,0,0,70,70,0,1,0,1,0
13603,28,0,0,70,70,0,1,0,1,0
9212,28,0,0,70,70,0,1,0,1,0
19511,28,0,0,70,70,0,1,0,1,0
16140,28,0,0,66,66,0,1,0,1,0
10477,28,0,0,70,70,0,1,0,1,0
20329,28,0,0,70,70,0,1,0,1,0
16900,28,0,0,66,66,0,1,0,1,0
15792,28,0,0,70,70,0,1,0,1,0
9466,28,0,0,70,70,0,1,0,1,0
8892,28,0,0,70,70,0,1,0,1,0
10156,28,0,0,70,70,0,1,0,1,0
16215,28,0,0,70,70,0,1,0,1,0
20290,28,0,0,66,66,0,1,0,1,0
8745,28,0,0,70,70,0,1,0,1,0
10589,28,0,0,70,70,0,1,0,1,0
9464,28,0,0,70,70,0,1,0,1,0
21209,28,0,0,70,70,0,1,0,1,0
9104,28,0,0,66,66,0,1,0,1,0
18736,28,0,0,70,70,0,1,0,1,0
19971,28,0,0,66,66,0,1,0,1,0
20377,28,0,0,70,70,0,1,0,1,0
21546,28,0,0,66,66,0,1,0,1,0
10055,28,0,0,66,66,0,1,0,1,0
12801,28,0,0,70,70,0,1,0,1,0
12943,28,0,0,70,70,0,1,0,1,0
17905,28,0,0,66,66,0,1,0,1,0
12951,28,0,0,66,66,0,1,0,1,0
14135,28,0,0,70,70,0,1,0,1,0
21901,28,0,0,70,70,0,1,0,1,0
9783,28,0,0,66,66,0,1,0,1,0
11855,28,0,0,70,70,0,1,0,1,0
19179,28,0,0,70,70,0,1,0,1,0
19444,28,0,0,70,70,0,1,0,1,0
12961,28,0,0,70,70,0,1,0,1,0
11677,28,0,0,70,70,0,1,0,1,0
11743,28,0,0,70,70,0,1,0,1,0
14964,28,0,0,66,66,0,1,0,1,0
12752,28,0,0,70,70,0,1,0,1,0
21753,28,0,0,66,66,0,1,0,1,0
19886,28,0,0,70,70,0,1,0,1,0
17497,28,0,0,68,68,0,1,0,1,0
16657,28,0,0,70,70,0,1,0,1,0
16615,28,0,0,70,70,0,1,0,1,0
9613,28,0,0,67,67,0,1,0,1,0
9060,28,0,0,66,66,0,1,0,1,0
19340,28,0,0,66,66,0,1,0,1,0
15710,28,0,0,70,70,0,1,0,1,0
15248,28,0,0,70,70,0,1,0,1,0
10028,28,0,0,70,70,0,1,0,1,0
16523,28,0,0,69,69,0,1,0,1,0
18147,28,0,0,66,66,0,1,0,1,0
16632,28,0,0,70,70,0,1,0,1,0
14094,28,0,0,70,70,0,1,0,1,0
9409,28,0,0,70,70,0,1,0,1,0
16714,28,0,0,70,70,0,1,0,1,0
14052,28,0,0,66,66,0,1,0,1,0
15034,28,0,0,67,67,0,1,0,1,0
11862,28,0,0,70,70,0,1,0,1,0
16690,28,0,0,70,70,0,1,0,1,0
19225,28,0,0,70,70,0,1,0,1,0
20016,28,0,0,70,70,0,1,0,1,0
22325,28,0,0,66,66,0,1,0,1,0
15553,28,0,0,70,70,0,1,0,1,0
10013,28,0,0,66,66,0,1,0,1,0
21966,28,0,0,67,67,0,1,0,1,0
17788,28,0,0,70,70,0,1,0,1,0
16509,28,0,0,70,70,0,1,0,1,0
17852,28,0,0,70,70,0,1,0,1,0
9556,28,0,0,66,66,0,1,0,1,0
18712,28,0,0,70,70,0,1,0,1,0
12669,28,0,0,70,70,0,1,0,1,0
19651,28,0,0,66,66,0,1,0,1,0
16473,28,0,0,70,70,0,1,0,1,0
18086,28,0,0,66,66,0,1,0,1,0
8746,28,0,0,70,70,0,1,0,1,0
8628,28,0,0,67,67,0,1,0,1,0
16656,28,0,0,66,66,0,1,0,1,0
14140,28,0,0,70,70,0,1,0,1,0
20937,28,0,0,70,70,0,1,0,1,0
13578,28,0,0,70,70,0,1,0,1,0
20866,28,0,0,66,66,0,1,0,1,0
13714,28,0,0,68,68,0,1,0,1,0
12470,28,0,0,68,68,0,1,0,1,0
13889,28,0,0,69,69,0,1,0,1,0
16831,28,0,0,67,67,0,1,0,1,0
22565,28,0,0,69,69,0,1,0,1,0
16323,28,0,0,68,68,0,1,0,1,0
19954,28,0,0,70,70,0,1,0,1,0
10278,28,0,0,69,69,0,1,0,1,0
19596,28,0,0,70,70,0,1,0,1,0
10281,28,0,0,70,70,0,1,0,1,0
17561,28,0,0,70,70,0,1,0,1,0
9559,28,0,0,68,68,0,1,0,1,0
15154,28,0,0,66,66,0,1,0,1,0
15290,28,0,0,70,70,0,1,0,1,0
19839,28,0,0,66,66,0,1,0,1,0
19102,28,0,0,70,70,0,1,0,1,0
18852,28,0,0,70,70,0,1,0,1,0
20383,28,0,0,69,69,0,1,0,1,0
9904,28,0,0,70,70,0,1,0,1,0
9612,28,0,0,70,70,0,1,0,1,0
14137,28,0,0,70,70,0,1,0,1,0
13328,28,0,0,70,70,0,1,0,1,0
9938,28,0,0,66,66,0,1,0,1,0
9435,28,0,0,66,66,0,1,0,1,0
9956,28,0,0,70,70,0,1,0,1,0
12564,28,0,0,70,70,0,1,0,1,0
12636,28,0,0,70,70,0,1,0,1,0
19629,28,0,0,67,67,0,1,0,1,0
12544,28,0,0,66,66,0,1,0,1,0
15816,28,0,0,67,67,0,1,0,1,0
17852,28,0,0,70,70,0,1,0,1,0
8879,28,0,0,66,66,0,1,0,1,0
18196,28,0,0,66,66,0,1,0,1,0
12222,28,0,0,66,66,0,1,0,1,0
20296,28,0,0,70,70,0,1,0,1,0
18503,28,0,0,66,66,0,1,0,1,0
9047,28,0,0,70,70,0,1,0,1,0
8649,28,0,0,70,70,0,1,0,1,0
11460,28,0,0,66,66,0,1,0,1,0
19877,28,0,0,66,66,0,1,0,1,0
21240,28,0,0,70,70,0,1,0,1,0
14161,28,0,0,68,68,0,1,0,1,0
16398,28,0,0,70,70,0,1,0,1,0
18226,28,0,0,70,70,0,1,0,1,0
15467,28,0,0,66,66,0,1,0,1,0
20185,28,0,0,70,70,0,1,0,1,0
14862,28,0,0,66,66,0,1,0,1,0
17972,28,0,0,70,70,0,1,0,1,0
20086,28,0,0,70,70,0,1,0,1,0
14422,28,0,0,70,70,0,1,0,1,0
19390,28,0,0,70,70,0,1,0,1,0
17255,28,0,0,68,68,0,1,0,1,0
11386,28,0,0,70,70,0,1,0,1,0
18196,28,0,0,69,69,0,1,0,1,0
14372,28,0,0,70,70,0,1,0,1,0
16325,28,0,0,66,66,0,1,0,1,0
11323,28,0,0,70,70,0,1,0,1,0
9693,28,0,0,70,70,0,1,0,1,0
20239,28,0,0,68,68,0,1,0,1,0
15087,28,0,0,66,66,0,1,0,1,0
20151,28,0,0,70,70,0,1,0,1,0
20783,28,0,0,70,70,0,1,0,1,0
15958,28,0,0,66,66,0,1,0,1,0
13647,28,0,0,70,70,0,1,0,1,0
8414,28,0,0,66,66,0,1,0,1,0
22247,28,0,0,70,70,0,1,0,1,0
12468,28,0,0,66,66,0,1,0,1,0
14262,28,0,0,69,69,0,1,0,1,0
11604,28,0,0,68,68,0,1,0,1,0
15048,28,0,0,70,70,0,1,0,1,0
13611,28,0,0,70,70,0,1,0,1,0
16857,28,0,0,70,70,0,1,0,1,0
13976,28,0,0,66,66,0,1,0,1,0
16998,28,0,0,70,70,0,1,0,1,0
15513,28,0,0,70,70,0,1,0,1,0
17877,28,0,0,67,67,0,1,0,1,0
17607,28,0,0,70,70,0,1,0,1,0
12171,28,0,0,70,70,0,1,0,1,0
8753,28,0,0,66,66,0,1,0,1,0
22089,28,0,0,66,66,0,1,0,1,0
13086,28,0,0,70,70,0,1,0,1,0
12926,28,0,0,70,70,0,1,0,1,0
12317,28,0,0,70,70,0,1,0,1,0
10242,28,0,0,66,66,0,1,0,1,0
12609,28,0,0,69,69,0,1,0,1,0
18893,28,0,0,70,70,0,1,0,1,0
15131,28,0,0,70,70,0,1,0,1,0
11173,28,0,0,70,70,0,1,0,1,0
15109,28,0,0,66,66,0,1,0,1,0
22530,28,0,0,70,70,0,1,0,1,0
21701,28,0,0,70,70,0,1,0,1,0
22197,28,0,0,66,66,0,1,0,1,0
16014,28,0,0,66,66,0,1,0,1,0
17818,28,0,0,68,68,0,1,0,1,0
13069,28,0,0,70,70,0,1,0,1,0
9017,28,0,0,67,67,0,1,0,1,0
19377,28,0,0,68,68,0,1,0,1,0
12838,28,0,0,66,66,0,1,0,1,0
17792,28,0,0,70,70,0,1,0,1,0
19724,28,0,0,70,70,0,1,0,1,0
18463,28,0,0,70,70,0,1,0,1,0
16028,28,0,0,70,70,0,1,0,1,0
19772,28,0,0,66,66,0,1,0,1,0
22704,28,0,0,66,66,0,1,0,1,0
20288,28,0,0,69,69,0,1,0,1,0
18775,28,0,0,70,70,0,1,0,1,0
20539,28,0,0,66,66,0,1,0,1,0
17235,28,0,0,66,66,0,1,0,1,0
16874,28,0,0,70,70,0,1,0,1,0
11853,28,0,0,66,66,0,1,0,1,0
19579,28,0,0,70,70,0,1,0,1,0
21677,28,0,0,70,70,0,1,0,1,0
18888,28,0,0,70,70,0,1,0,1,0
15540,28,0,0,66,66,0,1,0,1,0
13428,28,0,0,70,70,0,1,0,1,0
15044,28,0,0,70,70,0,1,0,1,0
9939,28,0,0,66,66,0,1,0,1,0
20916,28,0,0,69,69,0,1,0,1,0
12876,28,0,0,70,70,0,1,0,1,0
14825,28,0,0,70,70,0,1,0,1,0
14322,28,0,0,70,70,0,1,0,1,0
15412,28,0,0,66,66,0,1,0,1,0
10184,28,0,0,66,66,0,1,0,1,0
20740,28,0,0,66,66,0,1,0,1,0
15662,28,0,0,70,70,0,1,0,1,0
9170,28,0,0,70,70,0,1,0,1,0
16776,28,0,0,70,70,0,1,0,1,0
17005,28,0,0,66,66,0,1,0,1,0
21310,28,0,0,66,66,0,1,0,1,0
14211,28,0,0,70,70,0,1,0,1,0
8742,28,0,0,70,70,0,1,0,1,0
22089,28,0,0,70,70,0,1,0,1,0
10103,28,0,0,66,66,0,1,0,1,0
15928,28,0,0,70,70,0,1,0,1,0
9487,28,0,0,66,66,0,1,0,1,0
11339,28,0,0,70,70,0,1,0,1,0
17189,28,0,0,70,70,0,1,0,1,0
12365,28,0,0,66,66,0,1,0,1,0
10841,28,0,0,70,70,0,1,0,1,0
10230,28,0,0,66,66,0,1,0,1,0
15757,28,0,0,70,70,0,1,0,1,0
13944,28,0,0,70,70,0,1,0,1,0
10585,28,0,0,70,70,0,1,0,1,0
9620,28,0,0,70,70,0,1,0,1,0
13973,28,0,0,70,70,0,1,0,1,0
15311,28,0,0,70,70,0,1,0,1,0
22437,28,0,0,70,70,0,1,0,1,0
15023,28,0,0,70,70,0,1,0,1,0
17423,28,0,0,67,67,0,1,0,1,0
9343,28,0,0,70,70,0,1,0,1,0
17183,28,0,0,66,66,0,1,0,1,0
20886,28,0,0,70,70,0,1,0,1,0
17426,28,0,0,67,67,0,1,0,1,0
12567,28,0,0,70,70,0,1,0,1,0
17602,28,0,0,70,70,0,1,0,1,0
12394,28,0,0,66,66,0,1,0,1,0
16404,28,0,0,69,69,0,1,0,1,0
12751,28,0,0,70,70,0,1,0,1,0
16522,28,0,0,68,68,0,1,0,1,0
18894,28,0,0,70,70,0,1,0,1,0
17956,28,0,0,70,70,0,1,0,1,0
16068,28,0,0,66,66,0,1,0,1,0
9769,28,0,0,66,66,0,1,0,1,0
16909,28,0,0,66,66,0,1,0,1,0
15780,28,0,0,66,66,0,1,0,1,0
18607,28,0,0,70,70,0,1,0,1,0
17404,28,0,0,66,66,0,1,0,1,0
10888,28,0,0,68,68,0,1,0,1,0
11771,28,0,0,67,67,0,1,0,1,0
13474,28,0,0,66,66,0,1,0,1,0
17831,28,0,0,70,70,0,1,0,1,0
14475,28,0,0,66,66,0,1,0,1,0
11553,28,0,0,70,70,0,1,0,1,0
20726,28,0,0,66,66,0,1,0,1,0
21368,28,0,0,70,70,0,1,0,1,0
21694,28,0,0,70,70,0,1,0,1,0
19846,28,0,0,70,70,0,1,0,1,0
16445,28,0,0,70,70,0,1,0,1,0
9565,28,0,0,70,70,0,1,0,1,0
15545,28,0,0,70,70,0,1,0,1,0
8676,28,0,0,66,66,0,1,0,1,0
16092,28,0,0,66,66,0,1,0,1,0
10637,28,0,0,66,66,0,1,0,1,0
19850,28,0,0,70,70,0,1,0,1,0
17953,28,0,0,70,70,0,1,0,1,0
11913,28,0,0,70,70,0,1,0,1,0
22046,28,0,0,68,68,0,1,0,1,0
12694,28,0,0,70,70,0,1,0,1,0
14389,28,0,0,69,69,0,1,0,1,0
20226,28,0,0,70,70,0,1,0,1,0
20419,28,0,0,68,68,0,1,0,1,0
22402,28,0,0,69,69,0,1,0,1,0
22036,28,0,0,70,70,0,1,0,1,0
19180,28,0,0,70,70,0,1,0,1,0
16425,28,0,0,70,70,0,1,0,1,0
16396,28,0,0,70,70,0,1,0,1,0
22339,28,0,0,66,66,0,1,0,1,0
15439,28,0,0,70,70,0,1,0,1,0
9999,28,0,0,70,70,0,1,0,1,0
16844,28,0,0,66,66,0,1,0,1,0
12371,28,0,0,70,70,0,1,0,1,0
10190,28,0,0,70,70,0,1,0,1,0
17040,28,0,0,70,70,0,1,0,1,0
17343,28,0,0,70,70,0,1,0,1,0
14024,28,0,0,70,70,0,1,0,1,0
21900,28,0,0,70,70,0,1,0,1,0
20226,28,0,0,70,70,0,1,0,1,0
21227,28,0,0,70,70,0,1,0,1,0
13566,28,0,0,66,66,0,1,0,1,0
9769,28,0,0,66,66,0,1,0,1,0
22648,28,0,0,70,70,0,1,0,1,0
22042,28,0,0,70,70,0,1,0,1,0
12004,28,0,0,69,69,0,1,0,1,0
20201,28,0,0,70,70,0,1,0,1,0
12837,28,0,0,70,70,0,1,0,1,0
20776,28,0,0,70,70,0,1,0,1,0
9497,28,0,0,66,66,0,1,0,1,0
19760,28,0,0,66,66,0,1,0,1,0
18620,28,0,0,66,66,0,1,0,1,0
10669,28,0,0,66,66,0,1,0,1,0
17775,28,0,0,70,70,0,1,0,1,0
12989,28,0,0,70,70,0,1,0,1,0
21283,28,0,0,70,70,0,1,0,1,0
20143,28,0,0,70,70,0,1,0,1,0
19513,28,0,0,68,68,0,1,0,1,0
20678,28,0,0,70,70,0,1,0,1,0
16079,28,0,0,70,70,0,1,0,1,0
21235,28,0,0,66,66,0,1,0,1,0
19293,28,0,0,69,69,0,1,0,1,0
8558,28,0,0,66,66,0,1,0,1,0
13100,28,0,0,66,66,0,1,0,1,0
11144,28,0,0,70,70,0,1,0,1,0
20267,28,0,0,70,70,0,1,0,1,0
22141,28,0,0,70,70,0,1,0,1,0
10484,28,0,0,70,70,0,1,0,1,0
16705,28,0,0,69,69,0,1,0,1,0
9342,28,0,0,70,70,0,1,0,1,0
11639,28,0,0,70,70,0,1,0,1,0
16962,28,0,0,70,70,0,1,0,1,0
15056,28,0,0,69,69,0,1,0,1,0
10395,28,0,0,70,70,0,1,0,1,0
9901,28,0,0,66,66,0,1,0,1,0
21912,28,0,0,70,70,0,1,0,1,0
12567,28,0,0,70,70,0,1,0,1,0
10684,28,0,0,70,70,0,1,0,1,0
17682,28,0,0,69,69,0,1,0,1,0
16208,28,0,0,67,67,0,1,0,1,0
14606,28,0,0,69,69,0,1,0,1,0
17459,28,0,0,70,70,0,1,0,1,0
21598,28,0,0,66,66,0,1,0,1,0
8871,28,0,0,70,70,0,1,0,1,0
17880,28,0,0,70,70,0,1,0,1,0
15183,28,0,0,70,70,0,1,0,1,0
13828,28,0,0,67,67,0,1,0,1,0
20461,28,0,0,70,70,0,1,0,1,0
11407,28,0,0,66,66,0,1,0,1,0
22360,28,0,0,70,70,0,1,0,1,0
14478,28,0,0,66,66,0,1,0,1,0
20243,28,0,0,70,70,0,1,0,1,0
13126,28,0,0,70,70,0,1,0,1,0
14722,28,0,0,66,66,0,1,0,1,0
12842,28,0,0,66,66,0,1,0,1,0
20229,28,0,0,70,70,0,1,0,1,0
10200,28,0,0,70,70,0,1,0,1,0
10916,28,0,0,70,70,0,1,0,1,0
9667,28,0,0,70,70,0,1,0,1,0
15224,28,0,0,66,66,0,1,0,1,0
20150,28,0,0,70,70,0,1,0,1,0
8669,28,0,0,70,70,0,1,0,1,0
9188,28,0,0,67,67,0,1,0,1,0
12219,28,0,0,70,70,0,1,0,1,0
21749,28,0,0,70,70,0,1,0,1,0
14450,28,0,0,70,70,0,1,0,1,0
11994,28,0,0,70,70,0,1,0,1,0
12822,28,0,0,70,70,0,1,0,1,0
20212,28,0,0,70,70,0,1,0,1,0
16141,28,0,0,66,66,0,1,0,1,0
9995,28,0,0,66,66,0,1,0,1,0
16382,28,0,0,70,70,0,1,0,1,0
15709,28,0,0,69,69,0,1,0,1,0
22360,28,0,0,70,70,0,1,0,1,0
10224,28,0,0,67,67,0,1,0,1,0
13943,28,0,0,70,70,0,1,0,1,0
14257,28,0,0,67,67,0,1,0,1,0
14133,28,0,0,70,70,0,1,0,1,0
11212,28,0,0,70,70,0,1,0,1,0
19356,28,0,0,66,66,0,1,0,1,0
13380,28,0,0,70,70,0,1,0,1,0
8709,28,0,0,66,66,0,1,0,1,0
10185,28,0,0,66,66,0,1,0,1,0
10346,28,0,0,66,66,0,1,0,1,0
20843,28,0,0,67,67,0,1,0,1,0
13972,28,0,0,70,70,0,1,0,1,0
19598,28,0,0,67,67,0,1,0,1,0
16024,28,0,0,66,66,0,1,0,1,0
8431,28,0,0,66,66,0,1,0,1,0
16512,28,0,0,66,66,0,1,0,1,0
11638,28,0,0,70,70,0,1,0,1,0
16729,28,0,0,70,70,0,1,0,1,0
8791,28,0,0,70,70,0,1,0,1,0
8587,28,0,0,70,70,0,1,0,1,0
20296,28,0,0,70,70,0,1,0,1,0
12371,28,0,0,70,70,0,1,0,1,0
16444,28,0,0,70,70,0,1,0,1,0
16428,28,0,0,70,70,0,1,0,1,0
9753,28,0,0,66,66,0,1,0,1,0
17605,28,0,0,70,70,0,1,0,1,0
18117,28,0,0,70,70,0,1,0,1,0
11335,28,0,0,70,70,0,1,0,1,0
11994,28,0,0,70,70,0,1,0,1,0
9163,28,0,0,70,70,0,1,0,1,0
21834,28,0,0,70,70,0,1,0,1,0
13665,28,0,0,70,70,0,1,0,1,0
17554,28,0,0,70,70,0,1,0,1,0
17091,28,0,0,68,68,0,1,0,1,0
11767,28,0,0,70,70,0,1,0,1,0
19553,28,0,0,70,70,0,1,0,1,0
15226,28,0,0,69,69,0,1,0,1,0
10838,28,0,0,70,70,0,1,0,1,0
9586,28,0,0,66,66,0,1,0,1,0
21900,28,0,0,70,70,0,1,0,1,0
18494,28,0,0,66,66,0,1,0,1,0
8546,28,0,0,67,67,0,1,0,1,0
9667,28,0,0,68,68,0,1,0,1,0
17799,28,0,0,67,67,0,1,0,1,0
13256,28,0,0,70,70,0,1,0,1,0
18502,28,0,0,66,66,0,1,0,1,0
16728,28,0,0,70,70,0,1,0,1,0
14208,28,0,0,70,70,0,1,0,1,0
19163,28,0,0,69,69,0,1,0,1,0
21508,28,0,0,66,66,0,1,0,1,0
12568,28,0,0,70,70,0,1,0,1,0
16043,28,0,0,70,70,0,1,0,1,0
9996,28,0,0,66,66,0,1,0,1,0
9228,28,0,0,70,70,0,1,0,1,0
21872,28,0,0,70,70,0,1,0,1,0
16794,28,0,0,70,70,0,1,0,1,0
15919,28,0,0,70,70,0,1,0,1,0
19194,28,0,0,70,70,0,1,0,1,0
16010,28,0,0,69,69,0,1,0,1,0
14303,28,0,0,70,70,0,1,0,1,0
11218,28,0,0,70,70,0,1,0,1,0
10976,28,0,0,70,70,0,1,0,1,0
8400,28,0,0,70,70,0,1,0,1,0
20267,28,0,0,70,70,0,1,0,1,0
12335,28,0,0,70,70,0,1,0,1,0
16801,28,0,0,70,70,0,1,0,1,0
16706,28,0,0,66,66,0,1,0,1,0
9573,28,0,0,70,70,0,1,0,1,0
13045,28,0,0,66,66,0,1,0,1,0
11584,28,0,0,70,70,0,1,0,1,0
10411,28,0,0,70,70,0,1,0,1,0
22387,28,0,0,70,70,0,1,0,1,0
10222,28,0,0,66,66,0,1,0,1,0
20856,28,0,0,70,70,0,1,0,1,0
20459,28,0,0,70,70,0,1,0,1,0
18309,28,0,0,70,70,0,1,0,1,0
17515,28,0,0,70,70,0,1,0,1,0
19536,28,0,0,70,70,0,1,0,1,0
9432,28,0,0,66,66,0,1,0,1,0
20655,28,0,0,70,70,0,1,0,1,0
11380,28,0,0,69,69,0,1,0,1,0
11115,28,0,0,66,66,0,1,0,1,0
10477,28,0,0,70,70,0,1,0,1,0
21492,28,0,0,70,70,0,1,0,1,0
8869,28,0,0,70,70,0,1,0,1,0
18851,28,0,0,70,70,0,1,0,1,0
15759,28,0,0,68,68,0,1,0,1,0
13486,28,0,0,70,70,0,1,0,1,0
16509,28,0,0,70,70,0,1,0,1,0
9968,28,0,0,70,70,0,1,0,1,0
10162,28,0,0,70,70,0,1,0,1,0
9184,28,0,0,70,70,0,1,0,1,0
12033,28,0,0,70,70,0,1,0,1,0
8927,28,0,0,66,66,0,1,0,1,0
21907,28,0,0,66,66,0,1,0,1,0
18380,28,0,0,67,67,0,1,0,1,0
9960,28,0,0,69,69,0,1,0,1,0
12720,28,0,0,66,66,0,1,0,1,0
20656,28,0,0,67,67,0,1,0,1,0
9923,28,0,0,70,70,0,1,0,1,0
14179,28,0,0,69,69,0,1,0,1,0
11267,28,0,0,70,70,0,1,0,1,0
9937,28,0,0,66,66,0,1,0,1,0
14928,28,0,0,70,70,0,1,0,1,0
8881,28,0,0,66,66,0,1,0,1,0
22149,28,0,0,66,66,0,1,0,1,0
9536,28,0,0,66,66,0,1,0,1,0
9668,28,0,0,70,70,0,1,0,1,0
14867,28,0,0,70,70,0,1,0,1,0
10172,28,0,0,66,66,0,1,0,1,0
19442,28,0,0,70,70,0,1,0,1,0
22439,28,0,0,68,68,0,1,0,1,0
19964,28,0,0,66,66,0,1,0,1,0
21231,28,0,0,70,70,0,1,0,1,0
13011,28,0,0,69,69,0,1,0,1,0
19735,28,0,0,70,70,0,1,0,1,0
18748,28,0,0,70,70,0,1,0,1,0
13596,28,0,0,70,70,0,1,0,1,0
11046,28,0,0,70,70,0,1,0,1,0
14603,28,0,0,70,70,0,1,0,1,0
20647,28,0,0,70,70,0,1,0,1,0
12983,28,0,0,68,68,0,1,0,1,0
11210,28,0,0,70,70,0,1,0,1,0
12839,28,0,0,66,66,0,1,0,1,0
13941,28,0,0,70,70,0,1,0,1,0
15204,28,0,0,67,67,0,1,0,1,0
9434,28,0,0,66,66,0,1,0,1,0
14598,28,0,0,69,69,0,1,0,1,0
15463,28,0,0,70,70,0,1,0,1,0
15350,28,0,0,70,70,0,1,0,1,0
19731,28,0,0,70,70,0,1,0,1,0
13953,28,0,0,70,70,0,1,0,1,0
9576,28,0,0,67,67,0,1,0,1,0
17248,28,0,0,66,66,0,1,0,1,0
11882,28,0,0,70,70,0,1,0,1,0
19746,28,0,0,70,70,0,1,0,1,0
16793,28,0,0,70,70,0,1,0,1,0
16306,28,0,0,66,66,0,1,0,1,0
12354,28,0,0,69,69,0,1,0,1,0
13416,28,0,0,70,70,0,1,0,1,0
11368,28,0,0,70,70,0,1,0,1,0
13851,28,0,0,70,70,0,1,0,1,0
16093,28,0,0,66,66,0,1,0,1,0
17780,28,0,0,68,68,0,1,0,1,0
18744,28,0,0,70,70,0,1,0,1,0
9252,28,0,0,70,70,0,1,0,1,0
16024,28,0,0,70,70,0,1,0,1,0
18231,28,0,0,70,70,0,1,0,1,0
16428,28,0,0,70,70,0,1,0,1,0
15480,28,0,0,70,70,0,1,0,1,0
20027,28,0,0,66,66,0,1,0,1,0
10613,28,0,0,66,66,0,1,0,1,0
17672,28,0,0,70,70,0,1,0,1,0
12976,28,0,0,70,70,0,1,0,1,0
14025,28,0,0,70,70,0,1,0,1,0
13978,28,0,0,70,70,0,1,0,1,0
19596,28,0,0,70,70,0,1,0,1,0
17589,28,0,0,69,69,0,1,0,1,0
20715,28,0,0,70,70,0,1,0,1,0
20345,28,0,0,70,70,0,1,0,1,0
20168,28,0,0,66,66,0,1,0,1,0
20173,28,0,0,66,66,0,1,0,1,0
12720,28,0,0,66,66,0,1,0,1,0
12926,28,0,0,70,70,0,1,0,1,0
9366,28,0,0,70,70,0,1,0,1,0
17535,28,0,0,70,70,0,1,0,1,0
22524,28,0,0,70,70,0,1,0,1,0
9907,28,0,0,66,66,0,1,0,1,0
16942,28,0,0,66,66,0,1,0,1,0
13698,28,0,0,70,70,0,1,0,1,0
19824,28,0,0,70,70,0,1,0,1,0
14224,28,0,0,69,69,0,1,0,1,0
13709,28,0,0,70,70,0,1,0,1,0
22162,28,0,0,70,70,0,1,0,1,0
12598,28,0,0,70,70,0,1,0,1,0
9162,28,0,0,70,70,0,1,0,1,0
19869,28,0,0,70,70,0,1,0,1,0
12103,28,0,0,70,70,0,1,0,1,0
15223,28,0,0,66,66,0,1,0,1,0
12257,28,0,0,68,68,0,1,0,1,0
20738,28,0,0,69,69,0,1,0,1,0
14248,28,0,0,66,66,0,1,0,1,0
16835,28,0,0,69,69,0,1,0,1,0
15710,28,0,0,66,66,0,1,0,1,0
10349,28,0,0,66,66,0,1,0,1,0
9920,28,0,0,70,70,0,1,0,1,0
10160,28,0,0,70,70,0,1,0,1,0
9309,28,0,0,70,70,0,1,0,1,0
13842,28,0,0,70,70,0,1,0,1,0
12772,28,0,0,67,67,0,1,0,1,0
10423,28,0,0,69,69,0,1,0,1,0
10146,28,0,0,66,66,0,1,0,1,0
16053,28,0,0,69,69,0,1,0,1,0
19973,28,0,0,70,70,0,1,0,1,0
13387,28,0,0,70,70,0,1,0,1,0
17958,28,0,0,70,70,0,1,0,1,0
12369,28,0,0,67,67,0,1,0,1,0
16795,28,0,0,66,66,0,1,0,1,0
20422,28,0,0,66,66,0,1,0,1,0
10090,28,0,0,70,70,0,1,0,1,0
20232,28,0,0,70,70,0,1,0,1,0
10856,28,0,0,67,67,0,1,0,1,0
11866,28,0,0,70,70,0,1,0,1,0
9348,28,0,0,70,70,0,1,0,1,0
11914,28,0,0,67,67,0,1,0,1,0
21904,28,0,0,66,66,0,1,0,1,0
14978,28,0,0,70,70,0,1,0,1,0
21034,28,0,0,70,70,0,1,0,1,0
21546,28,0,0,66,66,0,1,0,1,0
19509,28,0,0,68,68,0,1,0,1,0
15776,28,0,0,66,66,0,1,0,1,0
17482,28,0,0,67,67,0,1,0,1,0
12789,28,0,0,66,66,0,1,0,1,0
9785,28,0,0,70,70,0,1,0,1,0
16652,28,0,0,66,66,0,1,0,1,0
19942,28,0,0,70,70,0,1,0,1,0
9765,28,0,0,67,67,0,1,0,1,0
13579,28,0,0,70,70,0,1,0,1,0
12400,28,0,0,66,66,0,1,0,1,0
21060,28,0,0,68,68,0,1,0,1,0
21492,28,0,0,66,66,0,1,0,1,0
17998,28,0,0,70,70,0,1,0,1,0
9152,28,0,0,68,68,0,1,0,1,0
13164,28,0,0,70,70,0,1,0,1,0
9052,28,0,0,70,70,0,1,0,1,0
22150,28,0,0,69,69,0,1,0,1,0
17488,28,0,0,69,69,0,1,0,1,0
10781,28,0,0,68,68,0,1,0,1,0
17181,28,0,0,70,70,0,1,0,1,0
19299,28,0,0,70,70,0,1,0,1,0
19773,28,0,0,66,66,0,1,0,1,0
12823,28,0,0,70,70,0,1,0,1,0
21782,28,0,0,66,66,0,1,0,1,0
9184,28,0,0,66,66,0,1,0,1,0
17678,28,0,0,70,70,0,1,0,1,0
15749,28,0,0,68,68,0,1,0,1,0
17739,28,0,0,70,70,0,1,0,1,0
14547,28,0,0,66,66,0,1,0,1,0
19312,28,0,0,69,69,0,1,0,1,0
19924,28,0,0,66,66,0,1,0,1,0
20405,28,0,0,70,70,0,1,0,1,0
9868,28,0,0,70,70,0,1,0,1,0
9565,28,0,0,66,66,0,1,0,1,0
9647,28,0,0,67,67,0,1,0,1,0
20980,28,0,0,70,70,0,1,0,1,0
10104,28,0,0,66,66,0,1,0,1,0
9759,28,0,0,70,70,0,1,0,1,0
14271,28,0,0,70,70,0,1,0,1,0
9754,28,0,0,70,70,0,1,0,1,0
9754,28,0,0,66,66,0,1,0,1,0
16250,28,0,0,70,70,0,1,0,1,0
12844,28,0,0,66,66,0,1,0,1,0
17972,28,0,0,70,70,0,1,0,1,0
19702,28,0,0,70,70,0,1,0,1,0
9171,28,0,0,70,70,0,1,0,1,0
22103,28,0,0,68,68,0,1,0,1,0
17627,28,0,0,70,70,0,1,0,1,0
21723,28,0,0,70,70,0,1,0,1,0
20066,28,0,0,66,66,0,1,0,1,0
16752,28,0,0,70,70,0,1,0,1,0
10433,28,0,0,70,70,0,1,0,1,0
20645,28,0,0,70,70,0,1,0,1,0
10132,28,0,0,66,66,0,1,0,1,0
20720,28,0,0,70,70,0,1,0,1,0
14917,28,0,0,70,70,0,1,0,1,0
13264,28,0,0,70,70,0,1,0,1,0
21252,28,0,0,69,69,0,1,0,1,0
13840,28,0,0,70,70,0,1,0,1,0
9692,28,0,0,66,66,0,1,0,1,0
19374,28,0,0,70,70,0,1,0,1,0
14900,28,0,0,70,70,0,1,0,1,0
14732,28,0,0,67,67,0,1,0,1,0
22406,28,0,0,68,68,0,1,0,1,0
19602,28,0,0,66,66,0,1,0,1,0
14750,28,0,0,70,70,0,1,0,1,0
21408,28,0,0,70,70,0,1,0,1,0
18317,28,0,0,70,70,0,1,0,1,0
14297,28,0,0,70,70,0,1,0,1,0
22046,28,0,0,70,70,0,1,0,1,0
14771,28,0,0,70,70,0,1,0,1,0
13841,28,0,0,70,70,0,1,0,1,0
18353,28,0,0,68,68,0,1,0,1,0
20271,28,0,0,70,70,0,1,0,1,0
13574,28,0,0,70,70,0,1,0,1,0
17851,28,0,0,70,70,0,1,0,1,0
10439,28,0,0,70,70,0,1,0,1,0
20498,28,0,0,70,70,0,1,0,1,0
19047,28,0,0,70,70,0,1,0,1,0
16061,28,0,0,70,70,0,1,0,1,0
10289,28,0,0,70,70,0,1,0,1,0
9813,28,0,0,66,66,0,1,0,1,0
13740,28,0,0,66,66,0,1,0,1,0
10376,28,0,0,70,70,0,1,0,1,0
10348,28,0,0,66,66,0,1,0,1,0
14829,28,0,0,70,70,0,1,0,1,0
22210,28,0,0,66,66,0,1,0,1,0
16811,28,0,0,70,70,0,1,0,1,0
13268,28,0,0,68,68,0,1,0,1,0
16180,28,0,0,70,70,0,1,0,1,0
19273,28,0,0,70,70,0,1,0,1,0
18411,28,0,0,70,70,0,1,0,1,0
17159,28,0,0,70,70,0,1,0,1,0
20120,28,0,0,70,70,0,1,0,1,0
11779,28,0,0,70,70,0,1,0,1,0
20068,28,0,0,66,66,0,1,0,1,0
18935,28,0,0,70,70,0,1,0,1,0
17455,28,0,0,66,66,0,1,0,1,0
12584,28,0,0,70,70,0,1,0,1,0
17630,28,0,0,70,70,0,1,0,1,0
8534,28,0,0,68,68,0,1,0,1,0
9660,28,0,0,68,68,0,1,0,1,0
20753,28,0,0,70,70,0,1,0,1,0
10083,28,0,0,69,69,0,1,0,1,0
10441,28,0,0,68,68,0,1,0,1,0
20234,28,0,0,70,70,0,1,0,1,0
9255,28,0,0,66,66,0,1,0,1,0
10605,28,0,0,70,70,0,1,0,1,0
16501,28,0,0,70,70,0,1,0,1,0
19921,28,0,0,70,70,0,1,0,1,0
11536,28,0,0,70,70,0,1,0,1,0
11401,28,0,0,70,70,0,1,0,1,0
20781,28,0,0,70,70,0,1,0,1,0
20256,28,0,0,70,70,0,1,0,1,0
20572,28,0,0,70,70,0,1,0,1,0
20859,28,0,0,66,66,0,1,0,1,0
11492,28,0,0,70,70,0,1,0,1,0
19890,28,0,0,70,70,0,1,0,1,0
21331,28,0,0,70,70,0,1,0,1,0
16611,28,0,0,70,70,0,1,0,1,0
21347,28,0,0,70,70,0,1,0,1,0
19112,28,0,0,68,68,0,1,0,1,0
19148,28,0,0,67,67,0,1,0,1,0
11516,28,0,0,68,68,0,1,0,1,0
12451,28,0,0,70,70,0,1,0,1,0
10359,28,0,0,66,66,0,1,0,1,0
9431,28,0,0,66,66,0,1,0,1,0
15058,28,0,0,66,66,0,1,0,1,0
9223,28,0,0,70,70,0,1,0,1,0
16496,28,0,0,66,66,0,1,0,1,0
18396,28,0,0,66,66,0,1,0,1,0
10287,28,0,0,70,70,0,1,0,1,0
14826,28,0,0,70,70,0,1,0,1,0
14371,28,0,0,70,70,0,1,0,1,0
8886,28,0,0,70,70,0,1,0,1,0
15237,28,0,0,70,70,0,1,0,1,0
8926,28,0,0,68,68,0,1,0,1,0
18236,28,0,0,70,70,0,1,0,1,0
21488,28,0,0,66,66,0,1,0,1,0
12443,28,0,0,70,70,0,1,0,1,0
14605,28,0,0,66,66,0,1,0,1,0
21189,28,0,0,66,66,0,1,0,1,0
20096,28,0,0,70,70,0,1,0,1,0
16779,28,0,0,70,70,0,1,0,1,0
22132,28,0,0,66,66,0,1,0,1,0
20176,28,0,0,70,70,0,1,0,1,0
9826,28,0,0,70,70,0,1,0,1,0
16199,28,0,0,70,70,0,1,0,1,0
14724,28,0,0,66,66,0,1,0,1,0
17265,28,0,0,70,70,0,1,0,1,0
15536,28,0,0,70,70,0,1,0,1,0
16248,28,0,0,70,70,0,1,0,1,0
13525,28,0,0,70,70,0,1,0,1,0
14439,28,0,0,70,70,0,1,0,1,0
17140,28,0,0,68,68,0,1,0,1,0
13274,28,0,0,70,70,0,1,0,1,0
22075,28,0,0,66,66,0,1,0,1,0
10528,28,0,0,70,70,0,1,0,1,0
21086,28,0,0,68,68,0,1,0,1,0
17366,28,0,0,70,70,0,1,0,1,0
16104,28,0,0,70,70,0,1,0,1,0
16576,28,0,0,70,70,0,1,0,1,0
12241,28,0,0,66,66,0,1,0,1,0
9316,28,0,0,70,70,0,1,0,1,0
15644,28,0,0,66,66,0,1,0,1,0
19606,28,0,0,66,66,0,1,0,1,0
11795,28,0,0,66,66,0,1,0,1,0
15393,28,0,0,66,66,0,1,0,1,0
18053,28,0,0,70,70,0,1,0,1,0
11043,28,0,0,70,70,0,1,0,1,0
9855,28,0,0,70,70,0,1,0,1,0
16901,28,0,0,70,70,0,1,0,1,0
16625,28,0,0,70,70,0,1,0,1,0
14544,28,0,0,68,68,0,1,0,1,0
19750,28,0,0,70,70,0,1,0,1,0
14133,28,0,0,70,70,0,1,0,1,0
10232,28,0,0,68,68,0,1,0,1,0
11362,28,0,0,66,66,0,1,0,1,0
16736,28,0,0,70,70,0,1,0,1,0
21678,28,0,0,70,70,0,1,0,1,0
16150,28,0,0,66,66,0,1,0,1,0
9195,28,0,0,70,70,0,1,0,1,0
17121,28,0,0,70,70,0,1,0,1,0
10703,28,0,0,70,70,0,1,0,1,0
20855,28,0,0,70,70,0,1,0,1,0
17124,28,0,0,69,69,0,1,0,1,0
13125,28,0,0,66,66,0,1,0,1,0
14758,28,0,0,70,70,0,1,0,1,0
16611,28,0,0,70,70,0,1,0,1,0
19851,28,0,0,70,70,0,1,0,1,0
14612,28,0,0,70,70,0,1,0,1,0
18975,28,0,0,70,70,0,1,0,1,0
13360,28,0,0,66,66,0,1,0,1,0
9540,28,0,0,70,70,0,1,0,1,0
11613,28,0,0,66,66,0,1,0,1,0
13126,28,0,0,69,69,0,1,0,1,0
17906,28,0,0,66,66,0,1,0,1,0
16782,28,0,0,66,66,0,1,0,1,0
12993,28,0,0,70,70,0,1,0,1,0
13165,28,0,0,70,70,0,1,0,1,0
10363,28,0,0,70,70,0,1,0,1,0
14160,28,0,0,67,67,0,1,0,1,0
14197,28,0,0,66,66,0,1,0,1,0
9499,28,0,0,66,66,0,1,0,1,0
18281,28,0,0,70,70,0,1,0,1,0
14868,28,0,0,70,70,0,1,0,1,0
20205,28,0,0,70,70,0,1,0,1,0
12557,28,0,0,70,70,0,1,0,1,0
9111,28,0,0,70,70,0,1,0,1,0
16067,28,0,0,70,70,0,1,0,1,0
18419,28,0,0,66,66,0,1,0,1,0
11731,28,0,0,70,70,0,1,0,1,0
20458,28,0,0,70,70,0,1,0,1,0
11956,28,0,0,66,66,0,1,0,1,0
16830,28,0,0,70,70,0,1,0,1,0
22064,28,0,0,70,70,0,1,0,1,0
12690,28,0,0,70,70,0,1,0,1,0
22157,28,0,0,70,70,0,1,0,1,0
15141,28,0,0,68,68,0,1,0,1,0
20266,28,0,0,70,70,0,1,0,1,0
20357,28,0,0,70,70,0,1,0,1,0
20971,28,0,0,66,66,0,1,0,1,0
9997,28,0,0,66,66,0,1,0,1,0
17156,28,0,0,70,70,0,1,0,1,0
22105,28,0,0,70,70,0,1,0,1,0
21149,28,0,0,67,67,0,1,0,1,0
21596,28,0,0,66,66,0,1,0,1,0
19100,28,0,0,70,70,0,1,0,1,0
10659,28,0,0,67,67,0,1,0,1,0
16809,28,0,0,70,70,0,1,0,1,0
12718,28,0,0,66,66,0,1,0,1,0
17828,28,0,0,70,70,0,1,0,1,0
8698,28,0,0,68,68,0,1,0,1,0
16780,28,0,0,70,70,0,1,0,1,0
12921,28,0,0,70,70,0,1,0,1,0
16025,28,0,0,67,67,0,1,0,1,0
19452,28,0,0,70,70,0,1,0,1,0
8869,28,0,0,70,70,0,1,0,1,0
18015,28,0,0,70,70,0,1,0,1,0
9216,28,0,0,70,70,0,1,0,1,0
22297,28,0,0,70,70,0,1,0,1,0
17190,28,0,0,70,70,0,1,0,1,0
12025,28,0,0,70,70,0,1,0,1,0
20414,28,0,0,70,70,0,1,0,1,0
16352,28,0,0,70,70,0,1,0,1,0
10059,28,0,0,66,66,0,1,0,1,0
15182,28,0,0,66,66,0,1,0,1,0
21853,28,0,0,68,68,0,1,0,1,0
15673,28,0,0,70,70,0,1,0,1,0
9333,28,0,0,70,70,0,1,0,1,0
18627,28,0,0,70,70,0,1,0,1,0
10675,28,0,0,66,66,0,1,0,1,0
19365,28,0,0,67,67,0,1,0,1,0
11897,28,0,0,70,70,0,1,0,1,0
22025,28,0,0,70,70,0,1,0,1,0
16279,28,0,0,70,70,0,1,0,1,0
9143,28,0,0,70,70,0,1,0,1,0
17977,28,0,0,70,70,0,1,0,1,0
19100,28,0,0,68,68,0,1,0,1,0
21537,28,0,0,70,70,0,1,0,1,0
15472,28,0,0,67,67,0,1,0,1,0
9006,28,0,0,66,66,0,1,0,1,0
12962,28,0,0,70,70,0,1,0,1,0
19462,28,0,0,70,70,0,1,0,1,0
20879,28,0,0,70,70,0,1,0,1,0
10175,28,0,0,70,70,0,1,0,1,0
9070,28,0,0,70,70,0,1,0,1,0
19751,28,0,0,70,70,0,1,0,1,0
10611,28,0,0,66,66,0,1,0,1,0
15972,28,0,0,70,70,0,1,0,1,0
15246,28,0,0,70,70,0,1,0,1,0
20208,28,0,0,70,70,0,1,0,1,0
19227,28,0,0,66,66,0,1,0,1,0
14801,28,0,0,67,67,0,1,0,1,0
18761,28,0,0,70,70,0,1,0,1,0
10731,28,0,0,67,67,0,1,0,1,0
12803,28,0,0,70,70,0,1,0,1,0
22399,28,0,0,70,70,0,1,0,1,0
14785,28,0,0,66,66,0,1,0,1,0
12147,28,0,0,70,70,0,1,0,1,0
19386,28,0,0,70,70,0,1,0,1,0
12108,28,0,0,70,70,0,1,0,1,0
9714,28,0,0,68,68,0,1,0,1,0
14055,28,0,0,70,70,0,1,0,1,0
13084,28,0,0,70,70,0,1,0,1,0
16991,28,0,0,70,70,0,1,0,1,0
11933,28,0,0,67,67,0,1,0,1,0
13610,28,0,0,70,70,0,1,0,1,0
21643,28,0,0,70,70,0,1,0,1,0
15914,28,0,0,70,70,0,1,0,1,0
15216,28,0,0,66,66,0,1,0,1,0
15283,28,0,0,66,66,0,1,0,1,0
13843,28,0,0,70,70,0,1,0,1,0
14699,28,0,0,69,69,0,1,0,1,0
14176,28,0,0,66,66,0,1,0,1,0
13399,28,0,0,67,67,0,1,0,1,0
18977,28,0,0,70,70,0,1,0,1,0
21432,28,0,0,66,66,0,1,0,1,0
11362,28,0,0,66,66,0,1,0,1,0
18377,28,0,0,68,68,0,1,0,1,0
8527,28,0,0,66,66,0,1,0,1,0
9101,28,0,0,70,70,0,1,0,1,0
9315,28,0,0,70,70,0,1,0,1,0
10144,28,0,0,70,70,0,1,0,1,0
15175,28,0,0,69,69,0,1,0,1,0
17721,28,0,0,70,70,0,1,0,1,0
12504,28,0,0,67,67,0,1,0,1,0
13013,28,0,0,67,67,0,1,0,1,0
12321,28,0,0,70,70,0,1,0,1,0
19695,28,0,0,70,70,0,1,0,1,0
11560,28,0,0,66,66,0,1,0,1,0
21239,28,0,0,70,70,0,1,0,1,0
19888,28,0,0,70,70,0,1,0,1,0
16009,28,0,0,70,70,0,1,0,1,0
21320,28,0,0,70,70,0,1,0,1,0
11945,28,0,0,66,66,0,1,0,1,0
13579,28,0,0,70,70,0,1,0,1,0
16943,28,0,0,70,70,0,1,0,1,0
15159,28,0,0,70,70,0,1,0,1,0
21964,28,0,0,70,70,0,1,0,1,0
22064,28,0,0,69,69,0,1,0,1,0
21782,28,0,0,66,66,0,1,0,1,0
17008,28,0,0,67,67,0,1,0,1,0
18563,28,0,0,69,69,0,1,0,1,0
20104,28,0,0,70,70,0,1,0,1,0
16871,28,0,0,70,70,0,1,0,1,0
19275,28,0,0,70,70,0,1,0,1,0
10127,28,0,0,70,70,0,1,0,1,0
9756,28,0,0,68,68,0,1,0,1,0
19117,28,0,0,70,70,0,1,0,1,0
10115,28,0,0,66,66,0,1,0,1,0
22286,28,0,0,70,70,0,1,0,1,0
19313,28,0,0,66,66,0,1,0,1,0
22043,28,0,0,70,70,0,1,0,1,0
9125,28,0,0,70,70,0,1,0,1,0
8853,28,0,0,69,69,0,1,0,1,0
17592,28,0,0,70,70,0,1,0,1,0
19271,28,0,0,70,70,0,1,0,1,0
12581,28,0,0,70,70,0,1,0,1,0
17418,28,0,0,70,70,0,1,0,1,0
14300,28,0,0,66,66,0,1,0,1,0
12512,28,0,0,70,70,0,1,0,1,0
21843,28,0,0,66,66,0,1,0,1,0
13510,28,0,0,70,70,0,1,0,1,0
9368,28,0,0,70,70,0,1,0,1,0
13383,28,0,0,70,70,0,1,0,1,0
13481,28,0,0,70,70,0,1,0,1,0
14811,28,0,0,70,70,0,1,0,1,0
15365,28,0,0,67,67,0,1,0,1,0
15423,28,0,0,70,70,0,1,0,1,0
11400,28,0,0,66,66,0,1,0,1,0
15659,28,0,0,70,70,0,1,0,1,0
21279,28,0,0,70,70,0,1,0,1,0
9564,28,0,0,66,66,0,1,0,1,0
19955,28,0,0,70,70,0,1,0,1,0
16468,28,0,0,70,70,0,1,0,1,0
14084,28,0,0,66,66,0,1,0,1,0
10476,28,0,0,70,70,0,1,0,1,0
11902,28,0,0,67,67,0,1,0,1,0
17952,28,0,0,70,70,0,1,0,1,0
14990,28,0,0,70,70,0,1,0,1,0
12150,28,0,0,70,70,0,1,0,1,0
8397,28,0,0,68,68,0,1,0,1,0
19754,28,0,0,66,66,0,1,0,1,0
11018,28,0,0,66,66,0,1,0,1,0
22705,28,0,0,70,70,0,1,0,1,0
14260,28,0,0,70,70,0,1,0,1,0
12238,28,0,0,70,70,0,1,0,1,0
9981,28,0,0,66,66,0,1,0,1,0
20340,28,0,0,66,66,0,1,0,1,0
17952,28,0,0,70,70,0,1,0,1,0
22472,28,0,0,66,66,0,1,0,1,0
11209,28,0,0,70,70,0,1,0,1,0
11667,28,0,0,66,66,0,1,0,1,0
20639,28,0,0,66,66,0,1,0,1,0
13542,28,0,0,70,70,0,1,0,1,0
13596,28,0,0,70,70,0,1,0,1,0
19941,28,0,0,66,66,0,1,0,1,0
13967,28,0,0,70,70,0,1,0,1,0
19567,28,0,0,70,70,0,1,0,1,0
17772,28,0,0,70,70,0,1,0,1,0
12884,28,0,0,66,66,0,1,0,1,0
9687,28,0,0,66,66,0,1,0,1,0
13229,28,0,0,70,70,0,1,0,1,0
15095,28,0,0,67,67,0,1,0,1,0
21143,28,0,0,66,66,0,1,0,1,0
14234,28,0,0,68,68,0,1,0,1,0
9626,28,0,0,66,66,0,1,0,1,0
9510,28,0,0,68,68,0,1,0,1,0
13932,28,0,0,70,70,0,1,0,1,0
19904,28,0,0,70,70,0,1,0,1,0
20200,28,0,0,66,66,0,1,0,1,0
19961,28,0,0,70,70,0,1,0,1,0
19295,28,0,0,70,70,0,1,0,1,0
16509,28,0,0,70,70,0,1,0,1,0
12607,28,0,0,70,70,0,1,0,1,0
14504,28,0,0,70,70,0,1,0,1,0
22471,28,0,0,69,69,0,1,0,1,0
12207,28,0,0,67,67,0,1,0,1,0
11249,28,0,0,67,67,0,1,0,1,0
21840,28,0,0,70,70,0,1,0,1,0
20710,28,0,0,70,70,0,1,0,1,0
15362,28,0,0,66,66,0,1,0,1,0
19465,28,0,0,70,70,0,1,0,1,0
13603,28,0,0,70,70,0,1,0,1,0
12066,28,0,0,70,70,0,1,0,1,0
13327,28,0,0,66,66,0,1,0,1,0
18643,28,0,0,67,67,0,1,0,1,0
18135,28,0,0,70,70,0,1,0,1,0
16222,28,0,0,70,70,0,1,0,1,0
21713,28,0,0,66,66,0,1,0,1,0
13861,28,0,0,70,70,0,1,0,1,0
18835,28,0,0,66,66,0,1,0,1,0
15708,28,0,0,67,67,0,1,0,1,0
22288,28,0,0,70,70,0,1,0,1,0
16103,28,0,0,70,70,0,1,0,1,0
16354,28,0,0,70,70,0,1,0,1,0
11171,28,0,0,70,70,0,1,0,1,0
13616,28,0,0,68,68,0,1,0,1,0
21014,28,0,0,66,66,0,1,0,1,0
21833,28,0,0,69,69,0,1,0,1,0
20644,28,0,0,70,70,0,1,0,1,0
14119,28,0,0,70,70,0,1,0,1,0
9936,28,0,0,66,66,0,1,0,1,0
12032,28,0,0,70,70,0,1,0,1,0
21731,28,0,0,67,67,0,1,0,1,0
10065,28,0,0,66,66,0,1,0,1,0
16611,28,0,0,66,66,0,1,0,1,0
22023,28,0,0,70,70,0,1,0,1,0
15550,28,0,0,70,70,0,1,0,1,0
12881,28,0,0,69,69,0,1,0,1,0
16883,28,0,0,69,69,0,1,0,1,0
21612,28,0,0,66,66,0,1,0,1,0
16686,28,0,0,70,70,0,1,0,1,0
20272,28,0,0,70,70,0,1,0,1,0
11594,28,0,0,70,70,0,1,0,1,0
11799,28,0,0,70,70,0,1,0,1,0
17953,28,0,0,70,70,0,1,0,1,0
9735,28,0,0,70,70,0,1,0,1,0
17972,28,0,0,70,70,0,1,0,1,0
18114,28,0,0,70,70,0,1,0,1,0
10602,28,0,0,70,70,0,1,0,1,0
10821,28,0,0,70,70,0,1,0,1,0
21923,28,0,0,67,67,0,1,0,1,0
12383,28,0,0,70,70,0,1,0,1,0
11200,28,0,0,66,66,0,1,0,1,0
18203,28,0,0,70,70,0,1,0,1,0
15032,28,0,0,66,66,0,1,0,1,0
19857,28,0,0,70,70,0,1,0,1,0
18774,28,0,0,66,66,0,1,0,1,0
13245,28,0,0,70,70,0,1,0,1,0
11467,28,0,0,70,70,0,1,0,1,0
21657,28,0,0,70,70,0,1,0,1,0
17583,28,0,0,68,68,0,1,0,1,0
16029,28,0,0,66,66,0,1,0,1,0
11607,28,0,0,66,66,0,1,0,1,0
20344,28,0,0,70,70,0,1,0,1,0
8956,28,0,0,66,66,0,1,0,1,0
10910,28,0,0,70,70,0,1,0,1,0
9443,28,0,0,70,70,0,1,0,1,0
11668,28,0,0,66,66,0,1,0,1,0
10118,28,0,0,70,70,0,1,0,1,0
14456,28,0,0,70,70,0,1,0,1,0
19781,28,0,0,69,69,0,1,0,1,0
9661,28,0,0,67,67,0,1,0,1,0
19484,28,0,0,70,70,0,1,0,1,0
9671,28,0,0,68,68,0,1,0,1,0
14687,28,0,0,70,70,0,1,0,1,0
21984,28,0,0,68,68,0,1,0,1,0
8875,28,0,0,70,70,0,1,0,1,0
11543,28,0,0,70,70,0,1,0,1,0
13099,28,0,0,70,70,0,1,0,1,0
14974,28,0,0,66,66,0,1,0,1,0
20675,28,0,0,70,70,0,1,0,1,0
13002,28,0,0,66,66,0,1,0,1,0
17348,28,0,0,70,70,0,1,0,1,0
19056,28,0,0,66,66,0,1,0,1,0
22238,28,0,0,70,70,0,1,0,1,0
9692,28,0,0,66,66,0,1,0,1,0
18072,28,0,0,66,66,0,1,0,1,0
13837,28,0,0,68,68,0,1,0,1,0
10600,28,0,0,70,70,0,1,0,1,0
21067,28,0,0,70,70,0,1,0,1,0
20402,28,0,0,69,69,0,1,0,1,0
11628,28,0,0,70,70,0,1,0,1,0
15899,28,0,0,70,70,0,1,0,1,0
20015,28,0,0,70,70,0,1,0,1,0
19599,28,0,0,66,66,0,1,0,1,0
12920,28,0,0,70,70,0,1,0,1,0
17557,28,0,0,70,70,0,1,0,1,0
15791,28,0,0,70,70,0,1,0,1,0
9567,28,0,0,66,66,0,1,0,1,0
19570,28,0,0,70,70,0,1,0,1,0
19112,28,0,0,70,70,0,1,0,1,0
20865,28,0,0,69,69,0,1,0,1,0
18021,28,0,0,70,70,0,1,0,1,0
14725,28,0,0,70,70,0,1,0,1,0
20782,28,0,0,70,70,0,1,0,1,0
12003,28,0,0,66,66,0,1,0,1,0
9665,28,0,0,70,70,0,1,0,1,0
16991,28,0,0,66,66,0,1,0,1,0
11118,28,0,0,70,70,0,1,0,1,0
14739,28,0,0,66,66,0,1,0,1,0
20929,28,0,0,67,67,0,1,0,1,0
14218,28,0,0,70,70,0,1,0,1,0
9996,28,0,0,66,66,0,1,0,1,0
11277,28,0,0,70,70,0,1,0,1,0
12370,28,0,0,66,66,0,1,0,1,0
9916,28,0,0,67,67,0,1,0,1,0
21391,28,0,0,69,69,0,1,0,1,0
17658,28,0,0,70,70,0,1,0,1,0
12453,28,0,0,66,66,0,1,0,1,0
12920,28,0,0,70,70,0,1,0,1,0
17952,28,0,0,66,66,0,1,0,1,0
20727,28,0,0,66,66,0,1,0,1,0
20479,28,0,0,70,70,0,1,0,1,0
14408,28,0,0,69,69,0,1,0,1,0
12111,28,0,0,66,66,0,1,0,1,0
13250,28,0,0,70,70,0,1,0,1,0
14031,28,0,0,70,70,0,1,0,1,0
17536,28,0,0,70,70,0,1,0,1,0
12963,28,0,0,70,70,0,1,0,1,0
13402,28,0,0,70,70,0,1,0,1,0
13499,28,0,0,70,70,0,1,0,1,0
20935,28,0,0,70,70,0,1,0,1,0
20228,28,0,0,70,70,0,1,0,1,0
22704,28,0,0,70,70,0,1,0,1,0
8640,28,0,0,70,70,0,1,0,1,0
9201,28,0,0,66,66,0,1,0,1,0
19871,28,0,0,70,70,0,1,0,1,0
20695,28,0,0,66,66,0,1,0,1,0
15222,28,0,0,66,66,0,1,0,1,0
14312,28,0,0,70,70,0,1,0,1,0
13619,28,0,0,70,70,0,1,0,1,0
17562,28,0,0,66,66,0,1,0,1,0
11401,28,0,0,70,70,0,1,0,1,0
13283,28,0,0,70,70,0,1,0,1,0
12643,28,0,0,70,70,0,1,0,1,0
20874,28,0,0,68,68,0,1,0,1,0
11593,28,0,0,70,70,0,1,0,1,0
17563,28,0,0,67,67,0,1,0,1,0
17952,28,0,0,67,67,0,1,0,1,0
22593,28,0,0,66,66,0,1,0,1,0
19859,28,0,0,70,70,0,1,0,1,0
12701,28,0,0,70,70,0,1,0,1,0
15937,28,0,0,70,70,0,1,0,1,0
21460,28,0,0,70,70,0,1,0,1,0
18997,28,0,0,66,66,0,1,0,1,0
14474,28,0,0,70,70,0,1,0,1,0
13543,28,0,0,70,70,0,1,0,1,0
9401,28,0,0,70,70,0,1,0,1,0
17940,28,0,0,70,70,0,1,0,1,0
9133,28,0,0,70,70,0,1,0,1,0
12685,28,0,0,70,70,0,1,0,1,0
20458,28,0,0,70,70,0,1,0,1,0
22473,28,0,0,66,66,0,1,0,1,0
16055,28,0,0,70,70,0,1,0,1,0
18900,28,0,0,66,66,0,1,0,1,0
11893,28,0,0,70,70,0,1,0,1,0
11736,28,0,0,66,66,0,1,0,1,0
19116,28,0,0,66,66,0,1,0,1,0
12347,28,0,0,67,67,0,1,0,1,0
19894,28,0,0,70,70,0,1,0,1,0
22041,28,0,0,70,70,0,1,0,1,0
10376,28,0,0,70,70,0,1,0,1,0
14187,28,0,0,70,70,0,1,0,1,0
16293,28,0,0,66,66,0,1,0,1,0
10943,28,0,0,70,70,0,1,0,1,0
20954,28,0,0,70,70,0,1,0,1,0
19041,28,0,0,70,70,0,1,0,1,0
19691,28,0,0,70,70,0,1,0,1,0
8798,28,0,0,70,70,0,1,0,1,0
12885,28,0,0,66,66,0,1,0,1,0
15643,28,0,0,66,66,0,1,0,1,0
16153,28,0,0,67,67,0,1,0,1,0
12817,28,0,0,70,70,0,1,0,1,0
20626,28,0,0,67,67,0,1,0,1,0
14789,28,0,0,68,68,0,1,0,1,0
15215,28,0,0,69,69,0,1,0,1,0
10541,28,0,0,70,70,0,1,0,1,0
14710,28,0,0,66,66,0,1,0,1,0
22504,28,0,0,70,70,0,1,0,1,0
12969,28,0,0,66,66,0,1,0,1,0
21518,28,0,0,70,70,0,1,0,1,0
10604,28,0,0,70,70,0,1,0,1,0
10794,28,0,0,67,67,0,1,0,1,0
10173,28,0,0,66,66,0,1,0,1,0
13586,28,0,0,70,70,0,1,0,1,0
9641,28,0,0,70,70,0,1,0,1,0
10624,28,0,0,70,70,0,1,0,1,0
13640,28,0,0,70,70,0,1,0,1,0
17489,28,0,0,70,70,0,1,0,1,0
12751,28,0,0,70,70,0,1,0,1,0
9620,28,0,0,66,66,0,1,0,1,0
18506,28,0,0,70,70,0,1,0,1,0
9043,28,0,0,68,68,0,1,0,1,0
14490,28,0,0,70,70,0,1,0,1,0
20304,28,0,0,67,67,0,1,0,1,0
21907,28,0,0,66,66,0,1,0,1,0
16335,28,0,0,70,70,0,1,0,1,0
20813,28,0,0,66,66,0,1,0,1,0
20829,28,0,0,70,70,0,1,0,1,0
19482,28,0,0,70,70,0,1,0,1,0
20070,28,0,0,70,70,0,1,0,1,0
11124,28,0,0,70,70,0,1,0,1,0
20133,28,0,0,67,67,0,1,0,1,0
15718,28,0,0,68,68,0,1,0,1,0
16192,28,0,0,66,66,0,1,0,1,0
14473,28,0,0,70,70,0,1,0,1,0
17631,28,0,0,70,70,0,1,0,1,0
17386,28,0,0,70,70,0,1,0,1,0
13625,28,0,0,70,70,0,1,0,1,0
9018,28,0,0,70,70,0,1,0,1,0
18226,28,0,0,70,70,0,1,0,1,0
12240,28,0,0,66,66,0,1,0,1,0
22086,28,0,0,70,70,0,1,0,1,0
12481,28,0,0,66,66,0,1,0,1,0
20970,28,0,0,70,70,0,1,0,1,0
19550,28,0,0,66,66,0,1,0,1,0
14195,28,0,0,69,69,0,1,0,1,0
16211,28,0,0,70,70,0,1,0,1,0
15032,28,0,0,66,66,0,1,0,1,0
9582,28,0,0,66,66,0,1,0,1,0
12468,28,0,0,66,66,0,1,0,1,0
10402,28,0,0,70,70,0,1,0,1,0
14480,28,0,0,66,66,0,1,0,1,0
12526,28,0,0,70,70,0,1,0,1,0
15934,28,0,0,66,66,0,1,0,1,0
20246,28,0,0,70,70,0,1,0,1,0
8436,28,0,0,68,68,0,1,0,1,0
21308,28,0,0,70,70,0,1,0,1,0
13057,28,0,0,70,70,0,1,0,1,0
12007,28,0,0,70,70,0,1,0,1,0
20403,28,0,0,70,70,0,1,0,1,0
8629,28,0,0,70,70,0,1,0,1,0
18821,28,0,0,67,67,0,1,0,1,0
21347,28,0,0,70,70,0,1,0,1,0
8947,28,0,0,70,70,0,1,0,1,0
18484,28,0,0,70,70,0,1,0,1,0
18316,28,0,0,70,70,0,1,0,1,0
12249,28,0,0,69,69,0,1,0,1,0
11487,28,0,0,70,70,0,1,0,1,0
16454,28,0,0,66,66,0,1,0,1,0
11504,28,0,0,70,70,0,1,0,1,0
16611,28,0,0,70,70,0,1,0,1,0
13859,28,0,0,70,70,0,1,0,1,0
9263,28,0,0,70,70,0,1,0,1,0
13051,28,0,0,70,70,0,1,0,1,0
16586,28,0,0,70,70,0,1,0,1,0
9432,28,0,0,66,66,0,1,0,1,0
10855,28,0,0,67,67,0,1,0,1,0
10576,28,0,0,70,70,0,1,0,1,0
12528,28,0,0,70,70,0,1,0,1,0
19115,28,0,0,66,66,0,1,0,1,0
15447,28,0,0,70,70,0,1,0,1,0
9240,28,0,0,66,66,0,1,0,1,0
16655,28,0,0,66,66,0,1,0,1,0
15427,28,0,0,70,70,0,1,0,1,0
16011,28,0,0,68,68,0,1,0,1,0
21568,28,0,0,67,67,0,1,0,1,0
11046,28,0,0,70,70,0,1,0,1,0
20582,28,0,0,68,68,0,1,0,1,0
13251,28,0,0,70,70,0,1,0,1,0
12291,28,0,0,70,70,0,1,0,1,0
20043,28,0,0,66,66,0,1,0,1,0
14611,28,0,0,70,70,0,1,0,1,0
11887,28,0,0,66,66,0,1,0,1,0
16766,28,0,0,70,70,0,1,0,1,0
14649,28,0,0,66,66,0,1,0,1,0
17072,28,0,0,66,66,0,1,0,1,0
20725,28,0,0,66,66,0,1,0,1,0
19602,28,0,0,70,70,0,1,0,1,0
9101,28,0,0,70,70,0,1,0,1,0
10585,28,0,0,70,70,0,1,0,1,0
16713,28,0,0,70,70,0,1,0,1,0
17270,28,0,0,70,70,0,1,0,1,0
10712,28,0,0,70,70,0,1,0,1,0
15553,28,0,0,70,70,0,1,0,1,0
15584,28,0,0,67,67,0,1,0,1,0
14179,28,0,0,66,66,0,1,0,1,0
21877,28,0,0,66,66,0,1,0,1,0
20252,28,0,0,70,70,0,1,0,1,0
10824,28,0,0,70,70,0,1,0,1,0
17858,28,0,0,66,66,0,1,0,1,0
16034,28,0,0,70,70,0,1,0,1,0
21917,28,0,0,70,70,0,1,0,1,0
9490,28,0,0,66,66,0,1,0,1,0
19685,28,0,0,66,66,0,1,0,1,0
16944,28,0,0,66,66,0,1,0,1,0
19205,28,0,0,70,70,0,1,0,1,0
20696,28,0,0,70,70,0,1,0,1,0
16207,28,0,0,66,66,0,1,0,1,0
20070,28,0,0,66,66,0,1,0,1,0
15815,28,0,0,70,70,0,1,0,1,0
12344,28,0,0,66,66,0,1,0,1,0
16906,28,0,0,70,70,0,1,0,1,0
15181,28,0,0,70,70,0,1,0,1,0
17116,28,0,0,70,70,0,1,0,1,0
10811,28,0,0,66,66,0,1,0,1,0
14711,28,0,0,70,70,0,1,0,1,0
14883,28,0,0,69,69,0,1,0,1,0
13558,28,0,0,70,70,0,1,0,1,0
11365,28,0,0,70,70,0,1,0,1,0
12802,28,0,0,67,67,0,1,0,1,0
10504,28,0,0,66,66,0,1,0,1,0
21445,28,0,0,70,70,0,1,0,1,0
17940,28,0,0,70,70,0,1,0,1,0
17648,28,0,0,66,66,0,1,0,1,0
8947,28,0,0,70,70,0,1,0,1,0
13271,28,0,0,70,70,0,1,0,1,0
17365,28,0,0,67,67,0,1,0,1,0
13827,28,0,0,67,67,0,1,0,1,0
16062,28,0,0,70,70,0,1,0,1,0
16664,28,0,0,66,66,0,1,0,1,0
12823,28,0,0,70,70,0,1,0,1,0
21222,28,0,0,70,70,0,1,0,1,0
8921,28,0,0,70,70,0,1,0,1,0
19057,28,0,0,66,66,0,1,0,1,0
20922,28,0,0,70,70,0,1,0,1,0
18504,28,0,0,70,70,0,1,0,1,0
9474,28,0,0,70,70,0,1,0,1,0
19334,28,0,0,70,70,0,1,0,1,0
15839,28,0,0,66,66,0,1,0,1,0
12281,28,0,0,66,66,0,1,0,1,0
19921,28,0,0,66,66,0,1,0,1,0
9225,28,0,0,70,70,0,1,0,1,0
13977,28,0,0,70,70,0,1,0,1,0
10149,28,0,0,70,70,0,1,0,1,0
18437,28,0,0,70,70,0,1,0,1,0
18224,28,0,0,70,70,0,1,0,1,0
22436,28,0,0,70,70,0,1,0,1,0
12450,28,0,0,66,66,0,1,0,1,0
12772,28,0,0,68,68,0,1,0,1,0
8401,28,0,0,70,70,0,1,0,1,0
21713,28,0,0,70,70,0,1,0,1,0
19962,28,0,0,68,68,0,1,0,1,0
10448,28,0,0,69,69,0,1,0,1,0
9304,28,0,0,66,66,0,1,0,1,0
10627,28,0,0,70,70,0,1,0,1,0
21898,28,0,0,70,70,0,1,0,1,0
10278,28,0,0,69,69,0,1,0,1,0
9687,28,0,0,66,66,0,1,0,1,0
13125,28,0,0,68,68,0,1,0,1,0
14311,28,0,0,70,70,0,1,0,1,0
19386,28,0,0,68,68,0,1,0,1,0
15350,28,0,0,70,70,0,1,0,1,0
19680,28,0,0,70,70,0,1,0,1,0
16903,28,0,0,70,70,0,1,0,1,0
12342,28,0,0,66,66,0,1,0,1,0
18920,28,0,0,70,70,0,1,0,1,0
17525,28,0,0,68,68,0,1,0,1,0
19032,28,0,0,70,70,0,1,0,1,0
14351,28,0,0,70,70,0,1,0,1,0
12211,28,0,0,70,70,0,1,0,1,0
19502,28,0,0,66,66,0,1,0,1,0
13113,28,0,0,70,70,0,1,0,1,0
21546,28,0,0,66,66,0,1,0,1,0
17142,28,0,0,66,66,0,1,0,1,0
19101,28,0,0,70,70,0,1,0,1,0
12547,28,0,0,70,70,0,1,0,1,0
17337,28,0,0,70,70,0,1,0,1,0
20697,28,0,0,70,70,0,1,0,1,0
11803,28,0,0,68,68,0,1,0,1,0
9466,28,0,0,70,70,0,1,0,1,0
10589,28,0,0,70,70,0,1,0,1,0
11819,28,0,0,66,66,0,1,0,1,0
10480,28,0,0,70,70,0,1,0,1,0
22024,28,0,0,70,70,0,1,0,1,0
18831,28,0,0,70,70,0,1,0,1,0
20984,28,0,0,70,70,0,1,0,1,0
19180,28,0,0,70,70,0,1,0,1,0
20147,28,0,0,70,70,0,1,0,1,0
9786,28,0,0,70,70,0,1,0,1,0
19769,28,0,0,70,70,0,1,0,1,0
9798,28,0,0,66,66,0,1,0,1,0
11769,28,0,0,70,70,0,1,0,1,0
21596,28,0,0,66,66,0,1,0,1,0
19068,28,0,0,70,70,0,1,0,1,0
21773,28,0,0,70,70,0,1,0,1,0
18226,28,0,0,70,70,0,1,0,1,0
21623,28,0,0,69,69,0,1,0,1,0
15747,28,0,0,69,69,0,1,0,1,0
18833,28,0,0,66,66,0,1,0,1,0
20952,28,0,0,70,70,0,1,0,1,0
9163,28,0,0,70,70,0,1,0,1,0
19671,28,0,0,70,70,0,1,0,1,0
16362,28,0,0,70,70,0,1,0,1,0
19860,28,0,0,69,69,0,1,0,1,0
16037,28,0,0,70,70,0,1,0,1,0
10179,28,0,0,66,66,0,1,0,1,0
20199,28,0,0,69,69,0,1,0,1,0
16881,28,0,0,70,70,0,1,0,1,0
21109,28,0,0,70,70,0,1,0,1,0
15902,28,0,0,70,70,0,1,0,1,0
21638,28,0,0,70,70,0,1,0,1,0
20738,28,0,0,66,66,0,1,0,1,0
13726,28,0,0,70,70,0,1,0,1,0
16442,28,0,0,70,70,0,1,0,1,0
11082,28,0,0,70,70,0,1,0,1,0
21214,28,0,0,70,70,0,1,0,1,0
13368,28,0,0,70,70,0,1,0,1,0
22390,28,0,0,70,70,0,1,0,1,0
21442,28,0,0,70,70,0,1,0,1,0
20268,28,0,0,70,70,0,1,0,1,0
15933,28,0,0,68,68,0,1,0,1,0
12453,28,0,0,67,67,0,1,0,1,0
9904,28,0,0,70,70,0,1,0,1,0
13808,28,0,0,66,66,0,1,0,1,0
15888,28,0,0,66,66,0,1,0,1,0
8608,28,0,0,68,68,0,1,0,1,0
19912,28,0,0,70,70,0,1,0,1,0
11772,28,0,0,66,66,0,1,0,1,0
21430,28,0,0,70,70,0,1,0,1,0
10361,28,0,0,70,70,0,1,0,1,0
15230,28,0,0,66,66,0,1,0,1,0
12175,28,0,0,66,66,0,1,0,1,0
14395,28,0,0,66,66,0,1,0,1,0
18856,28,0,0,67,67,0,1,0,1,0
18757,28,0,0,70,70,0,1,0,1,0
11540,28,0,0,70,70,0,1,0,1,0
15719,28,0,0,70,70,0,1,0,1,0
20529,28,0,0,67,67,0,1,0,1,0
20413,28,0,0,70,70,0,1,0,1,0
11612,28,0,0,66,66,0,1,0,1,0
22569,28,0,0,70,70,0,1,0,1,0
8502,28,0,0,70,70,0,1,0,1,0
10441,28,0,0,70,70,0,1,0,1,0
10552,28,0,0,70,70,0,1,0,1,0
20021,28,0,0,66,66,0,1,0,1,0
12112,28,0,0,66,66,0,1,0,1,0
21693,28,0,0,70,70,0,1,0,1,0
20383,28,0,0,70,70,0,1,0,1,0
19390,28,0,0,70,70,0,1,0,1,0
14997,28,0,0,70,70,0,1,0,1,0
13973,28,0,0,70,70,0,1,0,1,0
18834,28,0,0,66,66,0,1,0,1,0
14819,28,0,0,67,67,0,1,0,1,0
15539,28,0,0,66,66,0,1,0,1,0
18352,28,0,0,70,70,0,1,0,1,0
19500,28,0,0,66,66,0,1,0,1,0
19789,28,0,0,69,69,0,1,0,1,0
22409,28,0,0,70,70,0,1,0,1,0
10291,28,0,0,66,66,0,1,0,1,0
9944,28,0,0,66,66,0,1,0,1,0
21995,28,0,0,70,70,0,1,0,1,0
19885,28,0,0,66,66,0,1,0,1,0
20539,28,0,0,66,66,0,1,0,1,0
18667,28,0,0,66,66,0,1,0,1,0
17365,28,0,0,69,69,0,1,0,1,0
20131,28,0,0,70,70,0,1,0,1,0
20693,28,0,0,66,66,0,1,0,1,0
12123,28,0,0,67,67,0,1,0,1,0
22649,28,0,0,70,70,0,1,0,1,0
19511,28,0,0,68,68,0,1,0,1,0
14964,28,0,0,69,69,0,1,0,1,0
9000,28,0,0,70,70,0,1,0,1,0
22032,28,0,0,66,66,0,1,0,1,0
14123,28,0,0,70,70,0,1,0,1,0
19571,28,0,0,70,70,0,1,0,1,0
10343,28,0,0,66,66,0,1,0,1,0
13513,28,0,0,66,66,0,1,0,1,0
17534,28,0,0,70,70,0,1,0,1,0
12080,28,0,0,66,66,0,1,0,1,0
20765,28,0,0,70,70,0,1,0,1,0
16787,28,0,0,70,70,0,1,0,1,0
9295,28,0,0,70,70,0,1,0,1,0
13848,28,0,0,70,70,0,1,0,1,0
20149,28,0,0,70,70,0,1,0,1,0
22700,28,0,0,70,70,0,1,0,1,0
20412,28,0,0,70,70,0,1,0,1,0
20823,28,0,0,70,70,0,1,0,1,0
21843,28,0,0,66,66,0,1,0,1,0
15905,28,0,0,67,67,0,1,0,1,0
10411,28,0,0,70,70,0,1,0,1,0
13310,28,0,0,70,70,0,1,0,1,0
18662,28,0,0,68,68,0,1,0,1,0
19005,28,0,0,70,70,0,1,0,1,0
21550,28,0,0,66,66,0,1,0,1,0
11104,28,0,0,70,70,0,1,0,1,0
22200,28,0,0,69,69,0,1,0,1,0
15657,28,0,0,66,66,0,1,0,1,0
16789,28,0,0,70,70,0,1,0,1,0
9479,28,0,0,70,70,0,1,0,1,0
20777,28,0,0,66,66,0,1,0,1,0
19698,28,0,0,70,70,0,1,0,1,0
14238,28,0,0,70,70,0,1,0,1,0
14562,28,0,0,70,70,0,1,0,1,0
19310,28,0,0,70,70,0,1,0,1,0
14881,28,0,0,70,70,0,1,0,1,0
19454,28,0,0,66,66,0,1,0,1,0
11102,28,0,0,67,67,0,1,0,1,0
15246,28,0,0,70,70,0,1,0,1,0
9649,28,0,0,70,70,0,1,0,1,0
10256,28,0,0,67,67,0,1,0,1,0
14607,28,0,0,70,70,0,1,0,1,0
9920,28,0,0,68,68,0,1,0,1,0
20231,28,0,0,70,70,0,1,0,1,0
9359,28,0,0,70,70,0,1,0,1,0
18260,28,0,0,70,70,0,1,0,1,0
22071,28,0,0,66,66,0,1,0,1,0
21137,28,0,0,70,70,0,1,0,1,0
13342,28,0,0,69,69,0,1,0,1,0
21432,28,0,0,70,70,0,1,0,1,0
21781,28,0,0,66,66,0,1,0,1,0
19122,28,0,0,70,70,0,1,0,1,0
11491,28,0,0,70,70,0,1,0,1,0
14482,28,0,0,66,66,0,1,0,1,0
10059,28,0,0,66,66,0,1,0,1,0
19576,28,0,0,66,66,0,1,0,1,0
11945,28,0,0,66,66,0,1,0,1,0
15960,28,0,0,68,68,0,1,0,1,0
9292,28,0,0,70,70,0,1,0,1,0
18052,28,0,0,66,66,0,1,0,1,0
14197,28,0,0,70,70,0,1,0,1,0
20224,28,0,0,70,70,0,1,0,1,0
17802,28,0,0,66,66,0,1,0,1,0
9768,28,0,0,70,70,0,1,0,1,0
13736,28,0,0,70,70,0,1,0,1,0
19555,28,0,0,70,70,0,1,0,1,0
15486,28,0,0,68,68,0,1,0,1,0
11452,28,0,0,70,70,0,1,0,1,0
11881,28,0,0,70,70,0,1,0,1,0
19298,28,0,0,70,70,0,1,0,1,0
9202,28,0,0,70,70,0,1,0,1,0
14723,28,0,0,66,66,0,1,0,1,0
14612,28,0,0,68,68,0,1,0,1,0
12816,28,0,0,70,70,0,1,0,1,0
18918,28,0,0,70,70,0,1,0,1,0
19608,28,0,0,66,66,0,1,0,1,0
16193,28,0,0,66,66,0,1,0,1,0
13996,28,0,0,66,66,0,1,0,1,0
17977,28,0,0,70,70,0,1,0,1,0
19854,28,0,0,70,70,0,1,0,1,0
20033,28,0,0,70,70,0,1,0,1,0
20294,28,0,0,70,70,0,1,0,1,0
8492,28,0,0,66,66,0,1,0,1,0
10028,28,0,0,70,70,0,1,0,1,0
22642,28,0,0,66,66,0,1,0,1,0
16452,28,0,0,66,66,0,1,0,1,0
8574,28,0,0,70,70,0,1,0,1,0
18452,28,0,0,70,70,0,1,0,1,0
18607,28,0,0,68,68,0,1,0,1,0
18062,28,0,0,70,70,0,1,0,1,0
14221,28,0,0,70,70,0,1,0,1,0
18313,28,0,0,69,69,0,1,0,1,0
14106,28,0,0,66,66,0,1,0,1,0
8797,28,0,0,70,70,0,1,0,1,0
12456,28,0,0,70,70,0,1,0,1,0
21638,28,0,0,70,70,0,1,0,1,0
8448,28,0,0,70,70,0,1,0,1,0
16711,28,0,0,70,70,0,1,0,1,0
9070,28,0,0,66,66,0,1,0,1,0
18436,28,0,0,70,70,0,1,0,1,0
16012,28,0,0,67,67,0,1,0,1,0
11240,28,0,0,68,68,0,1,0,1,0
15057,28,0,0,70,70,0,1,0,1,0
17537,28,0,0,70,70,0,1,0,1,0
20446,28,0,0,69,69,0,1,0,1,0
9496,28,0,0,66,66,0,1,0,1,0
19195,28,0,0,69,69,0,1,0,1,0
17253,28,0,0,66,66,0,1,0,1,0
21846,28,0,0,66,66,0,1,0,1,0
10542,28,0,0,70,70,0,1,0,1,0
10160,28,0,0,70,70,0,1,0,1,0
12450,28,0,0,66,66,0,1,0,1,0
13314,28,0,0,70,70,0,1,0,1,0
14780,28,0,0,66,66,0,1,0,1,0
16140,28,0,0,66,66,0,1,0,1,0
17797,28,0,0,66,66,0,1,0,1,0
20632,28,0,0,67,67,0,1,0,1,0
19502,28,0,0,70,70,0,1,0,1,0
20898,28,0,0,67,67,0,1,0,1,0
15969,28,0,0,66,66,0,1,0,1,0
13722,28,0,0,70,70,0,1,0,1,0
13756,28,0,0,68,68,0,1,0,1,0
14815,28,0,0,70,70,0,1,0,1,0
13953,28,0,0,70,70,0,1,0,1,0
9973,28,0,0,70,70,0,1,0,1,0
19015,28,0,0,66,66,0,1,0,1,0
16789,28,0,0,70,70,0,1,0,1,0
21086,28,0,0,70,70,0,1,0,1,0
14152,28,0,0,70,70,0,1,0,1,0
20851,28,0,0,70,70,0,1,0,1,0
19570,28,0,0,70,70,0,1,0,1,0
9802,28,0,0,70,70,0,1,0,1,0
18072,28,0,0,66,66,0,1,0,1,0
15926,28,0,0,70,70,0,1,0,1,0
22395,28,0,0,66,66,0,1,0,1,0
17266,28,0,0,70,70,0,1,0,1,0
12943,28,0,0,70,70,0,1,0,1,0
8670,28,0,0,70,70,0,1,0,1,0
9919,28,0,0,66,66,0,1,0,1,0
19246,28,0,0,70,70,0,1,0,1,0
10665,28,0,0,69,69,0,1,0,1,0
14661,28,0,0,67,67,0,1,0,1,0
10526,28,0,0,70,70,0,1,0,1,0
16184,28,0,0,66,66,0,1,0,1,0
9995,28,0,0,66,66,0,1,0,1,0
10167,28,0,0,66,66,0,1,0,1,0
10487,28,0,0,67,67,0,1,0,1,0
18182,28,0,0,70,70,0,1,0,1,0
19215,28,0,0,70,70,0,1,0,1,0
12778,28,0,0,66,66,0,1,0,1,0
20954,28,0,0,70,70,0,1,0,1,0
22056,28,0,0,70,70,0,1,0,1,0
14108,28,0,0,66,66,0,1,0,1,0
12738,28,0,0,68,68,0,1,0,1,0
10701,28,0,0,70,70,0,1,0,1,0
12878,28,0,0,70,70,0,1,0,1,0
10041,28,0,0,66,66,0,1,0,1,0
14370,28,0,0,70,70,0,1,0,1,0
18405,28,0,0,70,70,0,1,0,1,0
12007,28,0,0,70,70,0,1,0,1,0
18779,28,0,0,66,66,0,1,0,1,0
20726,28,0,0,70,70,0,1,0,1,0
22141,28,0,0,70,70,0,1,0,1,0
17304,28,0,0,70,70,0,1,0,1,0
15969,28,0,0,70,70,0,1,0,1,0
11102,28,0,0,70,70,0,1,0,1,0
21916,28,0,0,70,70,0,1,0,1,0
13027,28,0,0,70,70,0,1,0,1,0
9816,28,0,0,66,66,0,1,0,1,0
10783,28,0,0,66,66,0,1,0,1,0
9686,28,0,0,66,66,0,1,0,1,0
18401,28,0,0,70,70,0,1,0,1,0
15321,28,0,0,69,69,0,1,0,1,0
11142,28,0,0,66,66,0,1,0,1,0
18598,28,0,0,68,68,0,1,0,1,0
10374,28,0,0,70,70,0,1,0,1,0
18830,28,0,0,70,70,0,1,0,1,0
16428,28,0,0,70,70,0,1,0,1,0
12588,28,0,0,70,70,0,1,0,1,0
10934,28,0,0,66,66,0,1,0,1,0
15521,28,0,0,70,70,0,1,0,1,0
20950,28,0,0,70,70,0,1,0,1,0
8567,28,0,0,69,69,0,1,0,1,0
19386,28,0,0,66,66,0,1,0,1,0
20947,28,0,0,70,70,0,1,0,1,0
14384,28,0,0,67,67,0,1,0,1,0
11009,28,0,0,67,67,0,1,0,1,0
15321,28,0,0,69,69,0,1,0,1,0
20696,28,0,0,70,70,0,1,0,1,0
19499,28,0,0,67,67,0,1,0,1,0
9058,28,0,0,69,69,0,1,0,1,0
10909,28,0,0,70,70,0,1,0,1,0
19860,28,0,0,68,68,0,1,0,1,0
14105,28,0,0,70,70,0,1,0,1,0
10073,28,0,0,70,70,0,1,0,1,0
11408,28,0,0,67,67,0,1,0,1,0
10628,28,0,0,70,70,0,1,0,1,0
15288,28,0,0,70,70,0,1,0,1,0
15471,28,0,0,70,70,0,1,0,1,0
20713,28,0,0,68,68,0,1,0,1,0
22033,28,0,0,66,66,0,1,0,1,0
10671,28,0,0,66,66,0,1,0,1,0
17732,28,0,0,70,70,0,1,0,1,0
14284,28,0,0,70,70,0,1,0,1,0
15025,28,0,0,70,70,0,1,0,1,0
18069,28,0,0,66,66,0,1,0,1,0
14468,28,0,0,70,70,0,1,0,1,0
17327,28,0,0,68,68,0,1,0,1,0
19329,28,0,0,70,70,0,1,0,1,0
15847,28,0,0,70,70,0,1,0,1,0
14972,28,0,0,70,70,0,1,0,1,0
14863,28,0,0,69,69,0,1,0,1,0
20647,28,0,0,70,70,0,1,0,1,0
10278,28,0,0,68,68,0,1,0,1,0
17860,28,0,0,70,70,0,1,0,1,0
21326,28,0,0,70,70,0,1,0,1,0
19338,28,0,0,70,70,0,1,0,1,0
19840,28,0,0,70,70,0,1,0,1,0
13878,28,0,0,70,70,0,1,0,1,0
11931,28,0,0,70,70,0,1,0,1,0
22527,28,0,0,70,70,0,1,0,1,0
16077,28,0,0,66,66,0,1,0,1,0
19897,28,0,0,70,70,0,1,0,1,0
19405,28,0,0,70,70,0,1,0,1,0
14689,28,0,0,70,70,0,1,0,1,0
11949,28,0,0,66,66,0,1,0,1,0
17258,28,0,0,70,70,0,1,0,1,0
18240,28,0,0,66,66,0,1,0,1,0
21429,28,0,0,67,67,0,1,0,1,0
8754,28,0,0,66,66,0,1,0,1,0
13819,28,0,0,69,69,0,1,0,1,0
19049,28,0,0,67,67,0,1,0,1,0
15342,28,0,0,70,70,0,1,0,1,0
14900,28,0,0,70,70,0,1,0,1,0
13877,28,0,0,70,70,0,1,0,1,0
16093,28,0,0,66,66,0,1,0,1,0
16736,28,0,0,70,70,0,1,0,1,0
22141,28,0,0,70,70,0,1,0,1,0
15600,28,0,0,70,70,0,1,0,1,0
9839,28,0,0,66,66,0,1,0,1,0
14384,28,0,0,66,66,0,1,0,1,0
20938,28,0,0,66,66,0,1,0,1,0
17751,28,0,0,67,67,0,1,0,1,0
8999,28,0,0,70,70,0,1,0,1,0
19212,28,0,0,67,67,0,1,0,1,0
17709,28,0,0,68,68,0,1,0,1,0
9134,28,0,0,70,70,0,1,0,1,0
12822,28,0,0,70,70,0,1,0,1,0
22660,28,0,0,70,70,0,1,0,1,0
20648,28,0,0,66,66,0,1,0,1,0
13752,28,0,0,66,66,0,1,0,1,0
22717,28,0,0,68,68,0,1,0,1,0
9908,28,0,0,70,70,0,1,0,1,0
17720,28,0,0,70,70,0,1,0,1,0
18629,28,0,0,70,70,0,1,0,1,0
20514,28,0,0,69,69,0,1,0,1,0
18777,28,0,0,66,66,0,1,0,1,0
15610,28,0,0,69,69,0,1,0,1,0
11401,28,0,0,66,66,0,1,0,1,0
9203,28,0,0,70,70,0,1,0,1,0
17858,28,0,0,68,68,0,1,0,1,0
8629,28,0,0,68,68,0,1,0,1,0
9881,28,0,0,66,66,0,1,0,1,0
12367,28,0,0,70,70,0,1,0,1,0
16655,28,0,0,66,66,0,1,0,1,0
8453,28,0,0,68,68,0,1,0,1,0
15278,28,0,0,70,70,0,1,0,1,0
14386,28,0,0,69,69,0,1,0,1,0
8592,28,0,0,70,70,0,1,0,1,0
9622,28,0,0,66,66,0,1,0,1,0
8964,28,0,0,70,70,0,1,0,1,0
18802,28,0,0,70,70,0,1,0,1,0
10904,28,0,0,70,70,0,1,0,1,0
16543,28,0,0,67,67,0,1,0,1,0
21425,28,0,0,70,70,0,1,0,1,0
13509,28,0,0,66,66,0,1,0,1,0
10059,28,0,0,67,67,0,1,0,1,0
8851,28,0,0,70,70,0,1,0,1,0
9201,28,0,0,70,70,0,1,0,1,0
11486,28,0,0,69,69,0,1,0,1,0
14464,28,0,0,67,67,0,1,0,1,0
8785,28,0,0,70,70,0,1,0,1,0
20815,28,0,0,70,70,0,1,0,1,0
9196,28,0,0,70,70,0,1,0,1,0
20886,28,0,0,70,70,0,1,0,1,0
20263,28,0,0,70,70,0,1,0,1,0
20341,28,0,0,66,66,0,1,0,1,0
9864,28,0,0,66,66,0,1,0,1,0
20054,28,0,0,68,68,0,1,0,1,0
10043,28,0,0,66,66,0,1,0,1,0
17445,28,0,0,66,66,0,1,0,1,0
20469,28,0,0,69,69,0,1,0,1,0
19823,28,0,0,70,70,0,1,0,1,0
10160,28,0,0,70,70,0,1,0,1,0
9568,28,0,0,70,70,0,1,0,1,0
18404,28,0,0,70,70,0,1,0,1,0
13819,28,0,0,70,70,0,1,0,1,0
21541,28,0,0,70,70,0,1,0,1,0
14782,28,0,0,66,66,0,1,0,1,0
19228,28,0,0,66,66,0,1,0,1,0
19829,28,0,0,66,66,0,1,0,1,0
15572,28,0,0,70,70,0,1,0,1,0
9893,28,0,0,70,70,0,1,0,1,0
19073,28,0,0,70,70,0,1,0,1,0
11890,28,0,0,66,66,0,1,0,1,0
22339,28,0,0,68,68,0,1,0,1,0
14543,28,0,0,67,67,0,1,0,1,0
17439,28,0,0,68,68,0,1,0,1,0
13006,28,0,0,70,70,0,1,0,1,0
13759,28,0,0,69,69,0,1,0,1,0
19081,28,0,0,70,70,0,1,0,1,0
20778,28,0,0,70,70,0,1,0,1,0
11935,28,0,0,66,66,0,1,0,1,0
19034,28,0,0,70,70,0,1,0,1,0
12974,28,0,0,69,69,0,1,0,1,0
20811,28,0,0,70,70,0,1,0,1,0
17534,28,0,0,70,70,0,1,0,1,0
21335,28,0,0,67,67,0,1,0,1,0
13417,28,0,0,69,69,0,1,0,1,0
14528,28,0,0,69,69,0,1,0,1,0
15971,28,0,0,66,66,0,1,0,1,0
9421,28,0,0,70,70,0,1,0,1,0
9432,28,0,0,66,66,0,1,0,1,0
13818,28,0,0,70,70,0,1,0,1,0
20475,28,0,0,70,70,0,1,0,1,0
14480,28,0,0,66,66,0,1,0,1,0
15650,28,0,0,70,70,0,1,0,1,0
8750,28,0,0,66,66,0,1,0,1,0
11814,28,0,0,70,70,0,1,0,1,0
16348,28,0,0,70,70,0,1,0,1,0
9630,28,0,0,70,70,0,1,0,1,0
20371,28,0,0,70,70,0,1,0,1,0
10402,28,0,0,70,70,0,1,0,1,0
10440,28,0,0,70,70,0,1,0,1,0
9940,28,0,0,66,66,0,1,0,1,0
20463,28,0,0,66,66,0,1,0,1,0
13472,28,0,0,66,66,0,1,0,1,0
21378,28,0,0,70,70,0,1,0,1,0
21332,28,0,0,70,70,0,1,0,1,0
17055,28,0,0,66,66,0,1,0,1,0
14185,28,0,0,70,70,0,1,0,1,0
9903,28,0,0,68,68,0,1,0,1,0
9571,28,0,0,67,67,0,1,0,1,0
18227,28,0,0,70,70,0,1,0,1,0
12512,28,0,0,70,70,0,1,0,1,0
19414,28,0,0,70,70,0,1,0,1,0
9199,28,0,0,70,70,0,1,0,1,0
20958,28,0,0,66,66,0,1,0,1,0
13971,28,0,0,70,70,0,1,0,1,0
9660,28,0,0,70,70,0,1,0,1,0
15723,28,0,0,70,70,0,1,0,1,0
16503,28,0,0,70,70,0,1,0,1,0
9571,28,0,0,70,70,0,1,0,1,0
12900,28,0,0,66,66,0,1,0,1,0
9536,28,0,0,67,67,0,1,0,1,0
21255,28,0,0,66,66,0,1,0,1,0
15902,28,0,0,67,67,0,1,0,1,0
20459,28,0,0,70,70,0,1,0,1,0
19148,28,0,0,66,66,0,1,0,1,0
20822,28,0,0,70,70,0,1,0,1,0
11859,28,0,0,70,70,0,1,0,1,0
17311,28,0,0,66,66,0,1,0,1,0
17010,28,0,0,70,70,0,1,0,1,0
15861,28,0,0,66,66,0,1,0,1,0
15922,28,0,0,69,69,0,1,0,1,0
11105,28,0,0,70,70,0,1,0,1,0
10065,28,0,0,66,66,0,1,0,1,0
19397,28,0,0,70,70,0,1,0,1,0
17461,28,0,0,70,70,0,1,0,1,0
20690,28,0,0,66,66,0,1,0,1,0
22319,28,0,0,70,70,0,1,0,1,0
8574,28,0,0,70,70,0,1,0,1,0
19003,28,0,0,70,70,0,1,0,1,0
13557,28,0,0,69,69,0,1,0,1,0
21661,28,0,0,70,70,0,1,0,1,0
10159,28,0,0,66,66,0,1,0,1,0
10990,28,0,0,66,66,0,1,0,1,0
10952,28,0,0,70,70,0,1,0,1,0
14054,28,0,0,70,70,0,1,0,1,0
19773,28,0,0,68,68,0,1,0,1,0
13933,28,0,0,70,70,0,1,0,1,0
12079,28,0,0,70,70,0,1,0,1,0
21470,28,0,0,70,70,0,1,0,1,0
10991,28,0,0,68,68,0,1,0,1,0
13120,28,0,0,69,69,0,1,0,1,0
16793,28,0,0,67,67,0,1,0,1,0
12900,28,0,0,67,67,0,1,0,1,0
17111,28,0,0,70,70,0,1,0,1,0
19911,28,0,0,70,70,0,1,0,1,0
22586,28,0,0,68,68,0,1,0,1,0
10863,28,0,0,66,66,0,1,0,1,0
19465,28,0,0,70,70,0,1,0,1,0
9904,28,0,0,70,70,0,1,0,1,0
13541,28,0,0,70,70,0,1,0,1,0
19433,28,0,0,70,70,0,1,0,1,0
14351,28,0,0,70,70,0,1,0,1,0
18695,28,0,0,70,70,0,1,0,1,0
9838,28,0,0,70,70,0,1,0,1,0
22061,28,0,0,70,70,0,1,0,1,0
15346,28,0,0,70,70,0,1,0,1,0
12510,28,0,0,70,70,0,1,0,1,0
10372,28,0,0,70,70,0,1,0,1,0
14275,28,0,0,70,70,0,1,0,1,0
14868,28,0,0,70,70,0,1,0,1,0
10574,28,0,0,66,66,0,1,0,1,0
9136,28,0,0,70,70,0,1,0,1,0
19671,28,0,0,66,66,0,1,0,1,0
12124,28,0,0,69,69,0,1,0,1,0
14941,28,0,0,70,70,0,1,0,1,0
8466,28,0,0,70,70,0,1,0,1,0
21363,28,0,0,66,66,0,1,0,1,0
11486,28,0,0,70,70,0,1,0,1,0
10504,28,0,0,66,66,0,1,0,1,0
10274,28,0,0,70,70,0,1,0,1,0
10333,28,0,0,66,66,0,1,0,1,0
17028,28,0,0,67,67,0,1,0,1,0
19840,28,0,0,70,70,0,1,0,1,0
15131,28,0,0,70,70,0,1,0,1,0
11919,28,0,0,70,70,0,1,0,1,0
21508,28,0,0,66,66,0,1,0,1,0
20722,28,0,0,70,70,0,1,0,1,0
21473,28,0,0,70,70,0,1,0,1,0
8381,28,0,0,70,70,0,1,0,1,0
10172,28,0,0,66,66,0,1,0,1,0
11858,28,0,0,70,70,0,1,0,1,0
11893,28,0,0,69,69,0,1,0,1,0
19848,28,0,0,70,70,0,1,0,1,0
16782,28,0,0,70,70,0,1,0,1,0
20217,28,0,0,66,66,0,1,0,1,0
11173,28,0,0,70,70,0,1,0,1,0
10638,28,0,0,70,70,0,1,0,1,0
11332,28,0,0,70,70,0,1,0,1,0
16655,28,0,0,70,70,0,1,0,1,0
21897,28,0,0,70,70,0,1,0,1,0
21532,28,0,0,67,67,0,1,0,1,0
17776,28,0,0,70,70,0,1,0,1,0
14305,28,0,0,70,70,0,1,0,1,0
20277,28,0,0,66,66,0,1,0,1,0
9982,28,0,0,68,68,0,1,0,1,0
20294,28,0,0,66,66,0,1,0,1,0
18930,28,0,0,70,70,0,1,0,1,0
19972,28,0,0,70,70,0,1,0,1,0
9522,28,0,0,70,70,0,1,0,1,0
20242,28,0,0,69,69,0,1,0,1,0
21498,28,0,0,70,70,0,1,0,1,0
15214,28,0,0,70,70,0,1,0,1,0
21818,28,0,0,70,70,0,1,0,1,0
11676,28,0,0,70,70,0,1,0,1,0
14134,28,0,0,70,70,0,1,0,1,0
10844,28,0,0,68,68,0,1,0,1,0
12331,28,0,0,66,66,0,1,0,1,0
12976,28,0,0,67,67,0,1,0,1,0
14046,28,0,0,70,70,0,1,0,1,0
13622,28,0,0,70,70,0,1,0,1,0
19555,28,0,0,70,70,0,1,0,1,0
21550,28,0,0,66,66,0,1,0,1,0
11364,28,0,0,70,70,0,1,0,1,0
11427,28,0,0,70,70,0,1,0,1,0
19468,28,0,0,70,70,0,1,0,1,0
14983,28,0,0,70,70,0,1,0,1,0
11034,28,0,0,70,70,0,1,0,1,0
12187,28,0,0,70,70,0,1,0,1,0
19686,28,0,0,66,66,0,1,0,1,0
20216,28,0,0,66,66,0,1,0,1,0
20936,28,0,0,68,68,0,1,0,1,0
15164,28,0,0,70,70,0,1,0,1,0
13915,28,0,0,70,70,0,1,0,1,0
11345,28,0,0,66,66,0,1,0,1,0
21704,28,0,0,70,70,0,1,0,1,0
13738,28,0,0,70,70,0,1,0,1,0
16483,28,0,0,70,70,0,1,0,1,0
9466,28,0,0,70,70,0,1,0,1,0
19016,28,0,0,67,67,0,1,0,1,0
20942,28,0,0,70,70,0,1,0,1,0
19357,28,0,0,70,70,0,1,0,1,0
12695,28,0,0,70,70,0,1,0,1,0
9578,28,0,0,67,67,0,1,0,1,0
11174,28,0,0,70,70,0,1,0,1,0
12346,28,0,0,70,70,0,1,0,1,0
9812,28,0,0,66,66,0,1,0,1,0
15324,28,0,0,70,70,0,1,0,1,0
21882,28,0,0,68,68,0,1,0,1,0
16736,28,0,0,70,70,0,1,0,1,0
17933,28,0,0,67,67,0,1,0,1,0
19005,28,0,0,70,70,0,1,0,1,0
14223,28,0,0,70,70,0,1,0,1,0
15329,28,0,0,70,70,0,1,0,1,0
16195,28,0,0,67,67,0,1,0,1,0
17939,28,0,0,66,66,0,1,0,1,0
22275,28,0,0,67,67,0,1,0,1,0
22088,28,0,0,70,70,0,1,0,1,0
21136,28,0,0,70,70,0,1,0,1,0
11025,28,0,0,66,66,0,1,0,1,0
14526,28,0,0,70,70,0,1,0,1,0
9758,28,0,0,70,70,0,1,0,1,0
10957,28,0,0,70,70,0,1,0,1,0
16680,28,0,0,70,70,0,1,0,1,0
22030,28,0,0,66,66,0,1,0,1,0
20220,28,0,0,70,70,0,1,0,1,0
18242,28,0,0,70,70,0,1,0,1,0
15814,28,0,0,66,66,0,1,0,1,0
9795,28,0,0,70,70,0,1,0,1,0
9730,28,0,0,70,70,0,1,0,1,0
8386,28,0,0,66,66,0,1,0,1,0
16856,28,0,0,70,70,0,1,0,1,0
8889,28,0,0,70,70,0,1,0,1,0
11428,28,0,0,70,70,0,1,0,1,0
18800,28,0,0,70,70,0,1,0,1,0
10911,28,0,0,66,66,0,1,0,1,0
15345,28,0,0,70,70,0,1,0,1,0
16472,28,0,0,70,70,0,1,0,1,0
12377,28,0,0,70,70,0,1,0,1,0
22014,28,0,0,68,68,0,1,0,1,0
16587,28,0,0,70,70,0,1,0,1,0
9559,28,0,0,69,69,0,1,0,1,0
21134,28,0,0,70,70,0,1,0,1,0
21824,28,0,0,70,70,0,1,0,1,0
9974,28,0,0,70,70,0,1,0,1,0
10541,28,0,0,68,68,0,1,0,1,0
16995,28,0,0,69,69,0,1,0,1,0
9920,28,0,0,67,67,0,1,0,1,0
20414,28,0,0,70,70,0,1,0,1,0
14040,28,0,0,70,70,0,1,0,1,0
12210,28,0,0,70,70,0,1,0,1,0
14550,28,0,0,70,70,0,1,0,1,0
17656,28,0,0,66,66,0,1,0,1,0
12535,28,0,0,66,66,0,1,0,1,0
10115,28,0,0,70,70,0,1,0,1,0
20541,28,0,0,69,69,0,1,0,1,0
13175,28,0,0,69,69,0,1,0,1,0
17452,28,0,0,70,70,0,1,0,1,0
15886,28,0,0,67,67,0,1,0,1,0
18875,28,0,0,70,70,0,1,0,1,0
8690,28,0,0,70,70,0,1,0,1,0
10164,28,0,0,70,70,0,1,0,1,0
11827,28,0,0,68,68,0,1,0,1,0
21982,28,0,0,66,66,0,1,0,1,0
18289,28,0,0,70,70,0,1,0,1,0
16900,28,0,0,66,66,0,1,0,1,0
20559,28,0,0,70,70,0,1,0,1,0
10417,28,0,0,70,70,0,1,0,1,0
16397,28,0,0,66,66,0,1,0,1,0
15193,28,0,0,70,70,0,1,0,1,0
8503,28,0,0,70,70,0,1,0,1,0
17109,28,0,0,70,70,0,1,0,1,0
14090,28,0,0,68,68,0,1,0,1,0
20020,28,0,0,68,68,0,1,0,1,0
10176,28,0,0,66,66,0,1,0,1,0
16756,28,0,0,66,66,0,1,0,1,0
9873,28,0,0,70,70,0,1,0,1,0
11011,28,0,0,70,70,0,1,0,1,0
20434,28,0,0,70,70,0,1,0,1,0
12115,28,0,0,70,70,0,1,0,1,0
21901,28,0,0,70,70,0,1,0,1,0
13735,28,0,0,70,70,0,1,0,1,0
21050,28,0,0,70,70,0,1,0,1,0
19653,28,0,0,66,66,0,1,0,1,0
18667,28,0,0,70,70,0,1,0,1,0
13617,28,0,0,66,66,0,1,0,1,0
9549,28,0,0,70,70,0,1,0,1,0
21280,28,0,0,70,70,0,1,0,1,0
10097,28,0,0,70,70,0,1,0,1,0
16995,28,0,0,69,69,0,1,0,1,0
9727,28,0,0,70,70,0,1,0,1,0
13058,28,0,0,66,66,0,1,0,1,0
17092,28,0,0,66,66,0,1,0,1,0
9300,28,0,0,70,70,0,1,0,1,0
12557,28,0,0,70,70,0,1,0,1,0
19211,28,0,0,70,70,0,1,0,1,0
21433,28,0,0,66,66,0,1,0,1,0
12013,28,0,0,70,70,0,1,0,1,0
13441,28,0,0,70,70,0,1,0,1,0
18977,28,0,0,67,67,0,1,0,1,0
18379,28,0,0,70,70,0,1,0,1,0
15413,28,0,0,66,66,0,1,0,1,0
12942,28,0,0,70,70,0,1,0,1,0
16325,28,0,0,66,66,0,1,0,1,0
16455,28,0,0,69,69,0,1,0,1,0
18851,28,0,0,70,70,0,1,0,1,0
10074,28,0,0,70,70,0,1,0,1,0
22545,28,0,0,67,67,0,1,0,1,0
22157,28,0,0,70,70,0,1,0,1,0
12143,28,0,0,70,70,0,1,0,1,0
12078,28,0,0,70,70,0,1,0,1,0
9626,28,0,0,66,66,0,1,0,1,0
9573,28,0,0,70,70,0,1,0,1,0
20121,28,0,0,70,70,0,1,0,1,0
17943,28,0,0,70,70,0,1,0,1,0
8726,28,0,0,70,70,0,1,0,1,0
18401,28,0,0,70,70,0,1,0,1,0
22196,28,0,0,66,66,0,1,0,1,0
10034,28,0,0,70,70,0,1,0,1,0
16017,28,0,0,68,68,0,1,0,1,0
12065,28,0,0,70,70,0,1,0,1,0
19710,28,0,0,67,67,0,1,0,1,0
20329,28,0,0,68,68,0,1,0,1,0
14369,28,0,0,70,70,0,1,0,1,0
11884,28,0,0,66,66,0,1,0,1,0
19463,28,0,0,70,70,0,1,0,1,0
22658,28,0,0,69,69,0,1,0,1,0
17290,28,0,0,66,66,0,1,0,1,0
20756,28,0,0,70,70,0,1,0,1,0
12945,28,0,0,70,70,0,1,0,1,0
22267,28,0,0,70,70,0,1,0,1,0
20392,28,0,0,66,66,0,1,0,1,0
13169,28,0,0,70,70,0,1,0,1,0
18665,28,0,0,66,66,0,1,0,1,0
16175,28,0,0,70,70,0,1,0,1,0
18411,28,0,0,70,70,0,1,0,1,0
11767,28,0,0,70,70,0,1,0,1,0
17140,28,0,0,66,66,0,1,0,1,0
19777,28,0,0,66,66,0,1,0,1,0
16509,28,0,0,66,66,0,1,0,1,0
10296,28,0,0,66,66,0,1,0,1,0
14093,28,0,0,70,70,0,1,0,1,0
20362,28,0,0,66,66,0,1,0,1,0
15707,28,0,0,66,66,0,1,0,1,0
10731,28,0,0,66,66,0,1,0,1,0
12497,28,0,0,70,70,0,1,0,1,0
13609,28,0,0,67,67,0,1,0,1,0
12883,28,0,0,70,70,0,1,0,1,0
20504,28,0,0,66,66,0,1,0,1,0
8831,28,0,0,67,67,0,1,0,1,0
17992,28,0,0,70,70,0,1,0,1,0
9529,28,0,0,70,70,0,1,0,1,0
21788,28,0,0,70,70,0,1,0,1,0
17144,28,0,0,67,67,0,1,0,1,0
9641,28,0,0,66,66,0,1,0,1,0
8489,28,0,0,70,70,0,1,0,1,0
17651,28,0,0,66,66,0,1,0,1,0
10329,28,0,0,66,66,0,1,0,1,0
21723,28,0,0,70,70,0,1,0,1,0
20390,28,0,0,68,68,0,1,0,1,0
21248,28,0,0,66,66,0,1,0,1,0
10654,28,0,0,70,70,0,1,0,1,0
20412,28,0,0,70,70,0,1,0,1,0
9451,28,0,0,70,70,0,1,0,1,0
20310,28,0,0,70,70,0,1,0,1,0
13080,28,0,0,70,70,0,1,0,1,0
20898,28,0,0,70,70,0,1,0,1,0
16734,28,0,0,70,70,0,1,0,1,0
20848,28,0,0,70,70,0,1,0,1,0
20366,28,0,0,68,68,0,1,0,1,0
14587,28,0,0,70,70,0,1,0,1,0
9920,28,0,0,70,70,0,1,0,1,0
22399,28,0,0,66,66,0,1,0,1,0
11935,28,0,0,70,70,0,1,0,1,0
18208,28,0,0,70,70,0,1,0,1,0
12331,28,0,0,70,70,0,1,0,1,0
15685,28,0,0,70,70,0,1,0,1,0
13175,28,0,0,69,69,0,1,0,1,0
18578,28,0,0,66,66,0,1,0,1,0
11761,28,0,0,69,69,0,1,0,1,0
13327,28,0,0,70,70,0,1,0,1,0
21286,28,0,0,70,70,0,1,0,1,0
22706,28,0,0,66,66,0,1,0,1,0
11957,28,0,0,66,66,0,1,0,1,0
8568,28,0,0,66,66,0,1,0,1,0
18494,28,0,0,70,70,0,1,0,1,0
15161,28,0,0,70,70,0,1,0,1,0
12882,28,0,0,66,66,0,1,0,1,0
8989,28,0,0,68,68,0,1,0,1,0
22264,28,0,0,70,70,0,1,0,1,0
16135,28,0,0,66,66,0,1,0,1,0
10185,28,0,0,66,66,0,1,0,1,0
19178,28,0,0,67,67,0,1,0,1,0
10310,28,0,0,70,70,0,1,0,1,0
20023,28,0,0,66,66,0,1,0,1,0
22499,28,0,0,66,66,0,1,0,1,0
10657,28,0,0,70,70,0,1,0,1,0
18711,28,0,0,70,70,0,1,0,1,0
8886,28,0,0,66,66,0,1,0,1,0
12193,28,0,0,70,70,0,1,0,1,0
18818,28,0,0,70,70,0,1,0,1,0
9965,28,0,0,67,67,0,1,0,1,0
18338,28,0,0,68,68,0,1,0,1,0
17557,28,0,0,70,70,0,1,0,1,0
15090,28,0,0,70,70,0,1,0,1,0
17719,28,0,0,70,70,0,1,0,1,0
9279,28,0,0,70,70,0,1,0,1,0
13994,28,0,0,70,70,0,1,0,1,0
21182,28,0,0,67,67,0,1,0,1,0
20526,28,0,0,70,70,0,1,0,1,0
20768,28,0,0,70,70,0,1,0,1,0
21706,28,0,0,67,67,0,1,0,1,0
17209,28,0,0,70,70,0,1,0,1,0
20696,28,0,0,70,70,0,1,0,1,0
22673,28,0,0,70,70,0,1,0,1,0
18449,28,0,0,66,66,0,1,0,1,0
13783,28,0,0,70,70,0,1,0,1,0
20389,28,0,0,70,70,0,1,0,1,0
18415,28,0,0,70,70,0,1,0,1,0
22445,28,0,0,70,70,0,1,0,1,0
10215,28,0,0,70,70,0,1,0,1,0
9047,28,0,0,70,70,0,1,0,1,0
14503,28,0,0,70,70,0,1,0,1,0
12479,28,0,0,70,70,0,1,0,1,0
12083,28,0,0,67,67,0,1,0,1,0
15850,28,0,0,70,70,0,1,0,1,0
14552,28,0,0,70,70,0,1,0,1,0
12573,28,0,0,66,66,0,1,0,1,0
19760,28,0,0,68,68,0,1,0,1,0
17792,28,0,0,70,70,0,1,0,1,0
21325,28,0,0,70,70,0,1,0,1,0
9315,28,0,0,66,66,0,1,0,1,0
16945,28,0,0,70,70,0,1,0,1,0
14451,28,0,0,70,70,0,1,0,1,0
21401,28,0,0,70,70,0,1,0,1,0
13968,28,0,0,70,70,0,1,0,1,0
9323,28,0,0,70,70,0,1,0,1,0
9938,28,0,0,66,66,0,1,0,1,0
20345,28,0,0,70,70,0,1,0,1,0
18745,28,0,0,70,70,0,1,0,1,0
17407,28,0,0,70,70,0,1,0,1,0
13660,28,0,0,70,70,0,1,0,1,0
11649,28,0,0,69,69,0,1,0,1,0
9264,28,0,0,70,70,0,1,0,1,0
14030,28,0,0,70,70,0,1,0,1,0
12885,28,0,0,70,70,0,1,0,1,0
15387,28,0,0,69,69,0,1,0,1,0
22691,28,0,0,70,70,0,1,0,1,0
15875,28,0,0,70,70,0,1,0,1,0
17828,28,0,0,70,70,0,1,0,1,0
10387,28,0,0,70,70,0,1,0,1,0
16556,28,0,0,66,66,0,1,0,1,0
18186,28,0,0,70,70,0,1,0,1,0
10027,28,0,0,67,67,0,1,0,1,0
20923,28,0,0,70,70,0,1,0,1,0
11857,28,0,0,70,70,0,1,0,1,0
13628,28,0,0,70,70,0,1,0,1,0
22288,28,0,0,70,70,0,1,0,1,0
9688,28,0,0,66,66,0,1,0,1,0
16028,28,0,0,70,70,0,1,0,1,0
15616,28,0,0,67,67,0,1,0,1,0
21394,28,0,0,70,70,0,1,0,1,0
17921,28,0,0,70,70,0,1,0,1,0
11407,28,0,0,66,66,0,1,0,1,0
8810,28,0,0,70,70,0,1,0,1,0
14201,28,0,0,70,70,0,1,0,1,0
8693,28,0,0,66,66,0,1,0,1,0
10976,28,0,0,70,70,0,1,0,1,0
22358,28,0,0,68,68,0,1,0,1,0
21612,28,0,0,70,70,0,1,0,1,0
11485,28,0,0,70,70,0,1,0,1,0
21378,28,0,0,70,70,0,1,0,1,0
18780,28,0,0,67,67,0,1,0,1,0
11705,28,0,0,66,66,0,1,0,1,0
22086,28,0,0,66,66,0,1,0,1,0
10007,28,0,0,69,69,0,1,0,1,0
14347,28,0,0,70,70,0,1,0,1,0
16158,28,0,0,70,70,0,1,0,1,0
17365,28,0,0,69,69,0,1,0,1,0
18765,28,0,0,69,69,0,1,0,1,0
8878,28,0,0,66,66,0,1,0,1,0
12283,28,0,0,66,66,0,1,0,1,0
15329,28,0,0,70,70,0,1,0,1,0
12314,28,0,0,70,70,0,1,0,1,0
10826,28,0,0,70,70,0,1,0,1,0
17938,28,0,0,70,70,0,1,0,1,0
18318,28,0,0,70,70,0,1,0,1,0
20950,28,0,0,70,70,0,1,0,1,0
17386,28,0,0,67,67,0,1,0,1,0
9551,28,0,0,70,70,0,1,0,1,0
19097,28,0,0,70,70,0,1,0,1,0
12126,28,0,0,66,66,0,1,0,1,0
16812,28,0,0,70,70,0,1,0,1,0
17809,28,0,0,70,70,0,1,0,1,0
11320,28,0,0,66,66,0,1,0,1,0
15344,28,0,0,70,70,0,1,0,1,0
14307,28,0,0,66,66,0,1,0,1,0
20213,28,0,0,70,70,0,1,0,1,0
11250,28,0,0,70,70,0,1,0,1,0
17809,28,0,0,68,68,0,1,0,1,0
13537,28,0,0,70,70,0,1,0,1,0
20298,28,0,0,70,70,0,1,0,1,0
21293,28,0,0,66,66,0,1,0,1,0
9884,28,0,0,66,66,0,1,0,1,0
18605,28,0,0,68,68,0,1,0,1,0
17876,28,0,0,70,70,0,1,0,1,0
16820,28,0,0,66,66,0,1,0,1,0
18570,28,0,0,66,66,0,1,0,1,0
12216,28,0,0,70,70,0,1,0,1,0
21750,28,0,0,70,70,0,1,0,1,0
20953,28,0,0,70,70,0,1,0,1,0
10475,28,0,0,70,70,0,1,0,1,0
12606,28,0,0,70,70,0,1,0,1,0
18850,28,0,0,66,66,0,1,0,1,0
15360,28,0,0,70,70,0,1,0,1,0
10734,28,0,0,66,66,0,1,0,1,0
16673,28,0,0,70,70,0,1,0,1,0
9254,28,0,0,66,66,0,1,0,1,0
19180,28,0,0,70,70,0,1,0,1,0
11333,28,0,0,70,70,0,1,0,1,0
16949,28,0,0,70,70,0,1,0,1,0
12643,28,0,0,70,70,0,1,0,1,0
18250,28,0,0,70,70,0,1,0,1,0
12191,28,0,0,70,70,0,1,0,1,0
20577,28,0,0,70,70,0,1,0,1,0
10474,28,0,0,70,70,0,1,0,1,0
9170,28,0,0,67,67,0,1,0,1,0
16585,28,0,0,70,70,0,1,0,1,0
18319,28,0,0,66,66,0,1,0,1,0
21678,28,0,0,70,70,0,1,0,1,0
13973,28,0,0,70,70,0,1,0,1,0
9480,28,0,0,66,66,0,1,0,1,0
17658,28,0,0,70,70,0,1,0,1,0
16666,28,0,0,70,70,0,1,0,1,0
8560,28,0,0,70,70,0,1,0,1,0
15678,28,0,0,70,70,0,1,0,1,0
11638,28,0,0,70,70,0,1,0,1,0
20905,28,0,0,70,70,0,1,0,1,0
9357,28,0,0,66,66,0,1,0,1,0
11604,28,0,0,66,66,0,1,0,1,0
18272,28,0,0,66,66,0,1,0,1,0
21137,28,0,0,70,70,0,1,0,1,0
16587,28,0,0,67,67,0,1,0,1,0
9070,28,0,0,70,70,0,1,0,1,0
13879,28,0,0,70,70,0,1,0,1,0
21965,28,0,0,70,70,0,1,0,1,0
18271,28,0,0,66,66,0,1,0,1,0
9097,28,0,0,70,70,0,1,0,1,0
11791,28,0,0,69,69,0,1,0,1,0
18949,28,0,0,66,66,0,1,0,1,0
11881,28,0,0,70,70,0,1,0,1,0
18230,28,0,0,70,70,0,1,0,1,0
18560,28,0,0,70,70,0,1,0,1,0
18408,28,0,0,70,70,0,1,0,1,0
9608,28,0,0,68,68,0,1,0,1,0
16786,28,0,0,70,70,0,1,0,1,0
10239,28,0,0,66,66,0,1,0,1,0
14311,28,0,0,70,70,0,1,0,1,0
8430,28,0,0,67,67,0,1,0,1,0
21753,28,0,0,70,70,0,1,0,1,0
13467,28,0,0,70,70,0,1,0,1,0
14510,28,0,0,70,70,0,1,0,1,0
20893,28,0,0,66,66,0,1,0,1,0
17448,28,0,0,66,66,0,1,0,1,0
9610,28,0,0,66,66,0,1,0,1,0
9357,28,0,0,66,66,0,1,0,1,0
14886,28,0,0,67,67,0,1,0,1,0
9551,28,0,0,66,66,0,1,0,1,0
15835,28,0,0,67,67,0,1,0,1,0
19938,28,0,0,70,70,0,1,0,1,0
13837,28,0,0,70,70,0,1,0,1,0
13008,28,0,0,70,70,0,1,0,1,0
13487,28,0,0,70,70,0,1,0,1,0
19135,28,0,0,66,66,0,1,0,1,0
12751,28,0,0,70,70,0,1,0,1,0
13374,28,0,0,70,70,0,1,0,1,0
18747,28,0,0,70,70,0,1,0,1,0
9486,28,0,0,70,70,0,1,0,1,0
17827,28,0,0,70,70,0,1,0,1,0
12079,28,0,0,67,67,0,1,0,1,0
20300,28,0,0,70,70,0,1,0,1,0
21547,28,0,0,66,66,0,1,0,1,0
9945,28,0,0,70,70,0,1,0,1,0
14985,28,0,0,70,70,0,1,0,1,0
19752,28,0,0,70,70,0,1,0,1,0
22114,28,0,0,70,70,0,1,0,1,0
12723,28,0,0,66,66,0,1,0,1,0
17577,28,0,0,70,70,0,1,0,1,0
13690,28,0,0,66,66,0,1,0,1,0
12217,28,0,0,70,70,0,1,0,1,0
8932,28,0,0,67,67,0,1,0,1,0
21366,28,0,0,70,70,0,1,0,1,0
17138,28,0,0,70,70,0,1,0,1,0
11664,28,0,0,66,66,0,1,0,1,0
9610,28,0,0,66,66,0,1,0,1,0
9301,28,0,0,69,69,0,1,0,1,0
18919,28,0,0,70,70,0,1,0,1,0
21997,28,0,0,70,70,0,1,0,1,0
13695,28,0,0,70,70,0,1,0,1,0
9952,28,0,0,70,70,0,1,0,1,0
14546,28,0,0,66,66,0,1,0,1,0
18866,28,0,0,70,70,0,1,0,1,0
14852,28,0,0,66,66,0,1,0,1,0
14982,28,0,0,70,70,0,1,0,1,0
14462,28,0,0,70,70,0,1,0,1,0
15206,28,0,0,66,66,0,1,0,1,0
11377,28,0,0,66,66,0,1,0,1,0
19571,28,0,0,70,70,0,1,0,1,0
8644,28,0,0,70,70,0,1,0,1,0
12017,28,0,0,70,70,0,1,0,1,0
16014,28,0,0,67,67,0,1,0,1,0
12839,28,0,0,69,69,0,1,0,1,0
15476,28,0,0,66,66,0,1,0,1,0
14757,28,0,0,70,70,0,1,0,1,0
20147,28,0,0,70,70,0,1,0,1,0
19298,28,0,0,70,70,0,1,0,1,0
16929,28,0,0,68,68,0,1,0,1,0
14885,28,0,0,67,67,0,1,0,1,0
16856,28,0,0,66,66,0,1,0,1,0
16193,28,0,0,68,68,0,1,0,1,0
21247,28,0,0,66,66,0,1,0,1,0
17460,28,0,0,69,69,0,1,0,1,0
18823,28,0,0,70,70,0,1,0,1,0
11615,28,0,0,66,66,0,1,0,1,0
21532,28,0,0,66,66,0,1,0,1,0
9125,28,0,0,70,70,0,1,0,1,0
16326,28,0,0,66,66,0,1,0,1,0
15693,28,0,0,70,70,0,1,0,1,0
16557,28,0,0,70,70,0,1,0,1,0
14176,28,0,0,66,66,0,1,0,1,0
19676,28,0,0,66,66,0,1,0,1,0
19866,28,0,0,68,68,0,1,0,1,0
10816,28,0,0,70,70,0,1,0,1,0
19586,28,0,0,70,70,0,1,0,1,0
21666,28,0,0,66,66,0,1,0,1,0
12740,28,0,0,70,70,0,1,0,1,0
21543,28,0,0,70,70,0,1,0,1,0
20713,28,0,0,70,70,0,1,0,1,0
9495,28,0,0,66,66,0,1,0,1,0
16687,28,0,0,70,70,0,1,0,1,0
10058,28,0,0,66,66,0,1,0,1,0
18549,28,0,0,66,66,0,1,0,1,0
9679,28,0,0,67,67,0,1,0,1,0
18328,28,0,0,66,66,0,1,0,1,0
11578,28,0,0,70,70,0,1,0,1,0
21235,28,0,0,67,67,0,1,0,1,0
14126,28,0,0,70,70,0,1,0,1,0
14478,28,0,0,66,66,0,1,0,1,0
20312,28,0,0,70,70,0,1,0,1,0
15139,28,0,0,66,66,0,1,0,1,0
12588,28,0,0,70,70,0,1,0,1,0
8961,28,0,0,66,66,0,1,0,1,0
22141,28,0,0,70,70,0,1,0,1,0
17222,28,0,0,70,70,0,1,0,1,0
19710,28,0,0,68,68,0,1,0,1,0
19481,28,0,0,70,70,0,1,0,1,0
16085,28,0,0,66,66,0,1,0,1,0
17245,28,0,0,66,66,0,1,0,1,0
9478,28,0,0,67,67,0,1,0,1,0
11640,28,0,0,70,70,0,1,0,1,0
11938,28,0,0,70,70,0,1,0,1,0
17338,28,0,0,70,70,0,1,0,1,0
14404,28,0,0,70,70,0,1,0,1,0
13290,28,0,0,70,70,0,1,0,1,0
11101,28,0,0,66,66,0,1,0,1,0
20376,28,0,0,66,66,0,1,0,1,0
21480,28,0,0,70,70,0,1,0,1,0
11104,28,0,0,70,70,0,1,0,1,0
11665,28,0,0,67,67,0,1,0,1,0
19885,28,0,0,70,70,0,1,0,1,0
11632,28,0,0,70,70,0,1,0,1,0
10836,28,0,0,70,70,0,1,0,1,0
12950,28,0,0,66,66,0,1,0,1,0
14769,28,0,0,68,68,0,1,0,1,0
15374,28,0,0,68,68,0,1,0,1,0
9910,28,0,0,70,70,0,1,0,1,0
9944,28,0,0,66,66,0,1,0,1,0
8629,28,0,0,70,70,0,1,0,1,0
16714,28,0,0,70,70,0,1,0,1,0
15216,28,0,0,66,66,0,1,0,1,0
14662,28,0,0,70,70,0,1,0,1,0
16738,28,0,0,70,70,0,1,0,1,0
9137,28,0,0,70,70,0,1,0,1,0
14843,28,0,0,70,70,0,1,0,1,0
22398,28,0,0,66,66,0,1,0,1,0
14086,28,0,0,70,70,0,1,0,1,0
13307,28,0,0,68,68,0,1,0,1,0
20595,28,0,0,66,66,0,1,0,1,0
19334,28,0,0,70,70,0,1,0,1,0
11638,28,0,0,70,70,0,1,0,1,0
18480,28,0,0,70,70,0,1,0,1,0
18202,28,0,0,70,70,0,1,0,1,0
22213,28,0,0,67,67,0,1,0,1,0
22465,28,0,0,66,66,0,1,0,1,0
17858,28,0,0,66,66,0,1,0,1,0
10721,28,0,0,70,70,0,1,0,1,0
22520,28,0,0,67,67,0,1,0,1,0
10008,28,0,0,70,70,0,1,0,1,0
15281,28,0,0,66,66,0,1,0,1,0
14147,28,0,0,70,70,0,1,0,1,0
15161,28,0,0,69,69,0,1,0,1,0
21832,28,0,0,66,66,0,1,0,1,0
16649,28,0,0,66,66,0,1,0,1,0
11284,28,0,0,66,66,0,1,0,1,0
19840,28,0,0,70,70,0,1,0,1,0
16800,28,0,0,66,66,0,1,0,1,0
10037,28,0,0,70,70,0,1,0,1,0
9134,28,0,0,66,66,0,1,0,1,0
15788,28,0,0,70,70,0,1,0,1,0
18643,28,0,0,70,70,0,1,0,1,0
10168,28,0,0,70,70,0,1,0,1,0
15095,28,0,0,67,67,0,1,0,1,0
19160,28,0,0,66,66,0,1,0,1,0
22112,28,0,0,70,70,0,1,0,1,0
8905,28,0,0,67,67,0,1,0,1,0
14612,28,0,0,69,69,0,1,0,1,0
20045,28,0,0,70,70,0,1,0,1,0
13528,28,0,0,66,66,0,1,0,1,0
20593,28,0,0,70,70,0,1,0,1,0
14306,28,0,0,66,66,0,1,0,1,0
21802,28,0,0,70,70,0,1,0,1,0
21600,28,0,0,67,67,0,1,0,1,0
12695,28,0,0,70,70,0,1,0,1,0
9991,28,0,0,70,70,0,1,0,1,0
12469,28,0,0,66,66,0,1,0,1,0
9437,28,0,0,70,70,0,1,0,1,0
9857,28,0,0,70,70,0,1,0,1,0
17782,28,0,0,66,66,0,1,0,1,0
18556,28,0,0,70,70,0,1,0,1,0
16497,28,0,0,69,69,0,1,0,1,0
19391,28,0,0,66,66,0,1,0,1,0
17471,28,0,0,68,68,0,1,0,1,0
10035,28,0,0,70,70,0,1,0,1,0
13254,28,0,0,70,70,0,1,0,1,0
12787,28,0,0,67,67,0,1,0,1,0
21402,28,0,0,70,70,0,1,0,1,0
19243,28,0,0,70,70,0,1,0,1,0
8944,28,0,0,66,66,0,1,0,1,0
15463,28,0,0,66,66,0,1,0,1,0
20980,28,0,0,66,66,0,1,0,1,0
17456,28,0,0,66,66,0,1,0,1,0
21693,28,0,0,70,70,0,1,0,1,0
8629,28,0,0,70,70,0,1,0,1,0
19811,28,0,0,70,70,0,1,0,1,0
20709,28,0,0,70,70,0,1,0,1,0
20831,28,0,0,68,68,0,1,0,1,0
13457,28,0,0,66,66,0,1,0,1,0
8906,28,0,0,66,66,0,1,0,1,0
21585,28,0,0,70,70,0,1,0,1,0
17683,28,0,0,70,70,0,1,0,1,0
11932,28,0,0,66,66,0,1,0,1,0
13291,28,0,0,70,70,0,1,0,1,0
19788,28,0,0,67,67,0,1,0,1,0
13625,28,0,0,70,70,0,1,0,1,0
16972,28,0,0,70,70,0,1,0,1,0
17549,28,0,0,66,66,0,1,0,1,0
19571,28,0,0,70,70,0,1,0,1,0
11168,28,0,0,69,69,0,1,0,1,0
9346,28,0,0,70,70,0,1,0,1,0
16959,28,0,0,70,70,0,1,0,1,0
21675,28,0,0,70,70,0,1,0,1,0
16311,28,0,0,70,70,0,1,0,1,0
12090,28,0,0,70,70,0,1,0,1,0
11119,28,0,0,70,70,0,1,0,1,0
21161,28,0,0,70,70,0,1,0,1,0
16253,28,0,0,70,70,0,1,0,1,0
13781,28,0,0,70,70,0,1,0,1,0
20321,28,0,0,70,70,0,1,0,1,0
17932,28,0,0,67,67,0,1,0,1,0
17831,28,0,0,69,69,0,1,0,1,0
15183,28,0,0,66,66,0,1,0,1,0
8395,28,0,0,70,70,0,1,0,1,0
13889,28,0,0,69,69,0,1,0,1,0
9558,28,0,0,66,66,0,1,0,1,0
18963,28,0,0,66,66,0,1,0,1,0
18409,28,0,0,70,70,0,1,0,1,0
22138,28,0,0,70,70,0,1,0,1,0
16389,28,0,0,70,70,0,1,0,1,0
14700,28,0,0,70,70,0,1,0,1,0
10960,28,0,0,70,70,0,1,0,1,0
19664,28,0,0,70,70,0,1,0,1,0
21263,28,0,0,70,70,0,1,0,1,0
19053,28,0,0,66,66,0,1,0,1,0
9091,28,0,0,67,67,0,1,0,1,0
20640,28,0,0,70,70,0,1,0,1,0
19376,28,0,0,69,69,0,1,0,1,0
16467,28,0,0,69,69,0,1,0,1,0
21740,28,0,0,66,66,0,1,0,1,0
19111,28,0,0,68,68,0,1,0,1,0
22181,28,0,0,70,70,0,1,0,1,0
19281,28,0,0,67,67,0,1,0,1,0
9484,28,0,0,70,70,0,1,0,1,0
22237,28,0,0,70,70,0,1,0,1,0
17855,28,0,0,70,70,0,1,0,1,0
18136,28,0,0,70,70,0,1,0,1,0
12640,28,0,0,70,70,0,1,0,1,0
10048,28,0,0,69,69,0,1,0,1,0
14983,28,0,0,68,68,0,1,0,1,0
21293,28,0,0,68,68,0,1,0,1,0
19147,28,0,0,66,66,0,1,0,1,0
16585,28,0,0,70,70,0,1,0,1,0
8930,28,0,0,66,66,0,1,0,1,0
16792,28,0,0,70,70,0,1,0,1,0
11748,28,0,0,70,70,0,1,0,1,0
10000,28,0,0,70,70,0,1,0,1,0
17304,28,0,0,70,70,0,1,0,1,0
19402,28,0,0,66,66,0,1,0,1,0
11451,28,0,0,70,70,0,1,0,1,0
14840,28,0,0,69,69,0,1,0,1,0
9073,28,0,0,66,66,0,1,0,1,0
19431,28,0,0,70,70,0,1,0,1,0
17490,28,0,0,66,66,0,1,0,1,0
20412,28,0,0,70,70,0,1,0,1,0
10640,28,0,0,70,70,0,1,0,1,0
17004,28,0,0,70,70,0,1,0,1,0
12422,28,0,0,70,70,0,1,0,1,0
13909,28,0,0,70,70,0,1,0,1,0
13933,28,0,0,66,66,0,1,0,1,0
8506,28,0,0,70,70,0,1,0,1,0
18508,28,0,0,66,66,0,1,0,1,0
16136,28,0,0,66,66,0,1,0,1,0
13578,28,0,0,70,70,0,1,0,1,0
19463,28,0,0,70,70,0,1,0,1,0
17201,28,0,0,70,70,0,1,0,1,0
20495,28,0,0,70,70,0,1,0,1,0
18843,28,0,0,70,70,0,1,0,1,0
10234,28,0,0,70,70,0,1,0,1,0
17159,28,0,0,70,70,0,1,0,1,0
9608,28,0,0,66,66,0,1,0,1,0
12235,28,0,0,70,70,0,1,0,1,0
11569,28,0,0,70,70,0,1,0,1,0
18764,28,0,0,69,69,0,1,0,1,0
10990,28,0,0,68,68,0,1,0,1,0
14259,28,0,0,70,70,0,1,0,1,0
12983,28,0,0,66,66,0,1,0,1,0
8879,28,0,0,66,66,0,1,0,1,0
19145,28,0,0,70,70,0,1,0,1,0
16758,28,0,0,66,66,0,1,0,1,0
21085,28,0,0,67,67,0,1,0,1,0
16182,28,0,0,70,70,0,1,0,1,0
9019,28,0,0,70,70,0,1,0,1,0
17957,28,0,0,70,70,0,1,0,1,0
11207,28,0,0,70,70,0,1,0,1,0
11169,28,0,0,67,67,0,1,0,1,0
11970,28,0,0,70,70,0,1,0,1,0
18989,28,0,0,70,70,0,1,0,1,0
20970,28,0,0,70,70,0,1,0,1,0
21852,28,0,0,66,66,0,1,0,1,0
20065,28,0,0,66,66,0,1,0,1,0
22072,28,0,0,66,66,0,1,0,1,0
19387,28,0,0,70,70,0,1,0,1,0
17343,28,0,0,70,70,0,1,0,1,0
22237,28,0,0,70,70,0,1,0,1,0
11302,28,0,0,66,66,0,1,0,1,0
19890,28,0,0,70,70,0,1,0,1,0
18503,28,0,0,66,66,0,1,0,1,0
11470,28,0,0,70,70,0,1,0,1,0
13624,28,0,0,70,70,0,1,0,1,0
9258,28,0,0,66,66,0,1,0,1,0
14763,28,0,0,68,68,0,1,0,1,0
11406,28,0,0,66,66,0,1,0,1,0
10915,28,0,0,70,70,0,1,0,1,0
14658,28,0,0,70,70,0,1,0,1,0
10920,28,0,0,67,67,0,1,0,1,0
16166,28,0,0,70,70,0,1,0,1,0
22150,28,0,0,66,66,0,1,0,1,0
9877,28,0,0,70,70,0,1,0,1,0
19508,28,0,0,66,66,0,1,0,1,0
9696,28,0,0,70,70,0,1,0,1,0
13476,28,0,0,66,66,0,1,0,1,0
14780,28,0,0,67,67,0,1,0,1,0
17313,28,0,0,66,66,0,1,0,1,0
12657,28,0,0,66,66,0,1,0,1,0
20493,28,0,0,70,70,0,1,0,1,0
19599,28,0,0,70,70,0,1,0,1,0
16136,28,0,0,67,67,0,1,0,1,0
13551,28,0,0,70,70,0,1,0,1,0
16633,28,0,0,70,70,0,1,0,1,0
10362,28,0,0,67,67,0,1,0,1,0
17127,28,0,0,66,66,0,1,0,1,0
22401,28,0,0,66,66,0,1,0,1,0
16737,28,0,0,70,70,0,1,0,1,0
10948,28,0,0,67,67,0,1,0,1,0
9607,28,0,0,70,70,0,1,0,1,0
16691,28,0,0,68,68,0,1,0,1,0
19179,28,0,0,70,70,0,1,0,1,0
12440,28,0,0,70,70,0,1,0,1,0
11797,28,0,0,69,69,0,1,0,1,0
12558,28,0,0,70,70,0,1,0,1,0
12397,28,0,0,66,66,0,1,0,1,0
17013,28,0,0,68,68,0,1,0,1,0
12039,28,0,0,70,70,0,1,0,1,0
10908,28,0,0,70,70,0,1,0,1,0
20598,28,0,0,66,66,0,1,0,1,0
17125,28,0,0,66,66,0,1,0,1,0
19374,28,0,0,70,70,0,1,0,1,0
10418,28,0,0,70,70,0,1,0,1,0
21047,28,0,0,70,70,0,1,0,1,0
9436,28,0,0,66,66,0,1,0,1,0
18245,28,0,0,70,70,0,1,0,1,0
8427,28,0,0,70,70,0,1,0,1,0
16816,28,0,0,67,67,0,1,0,1,0
11326,28,0,0,70,70,0,1,0,1,0
11101,28,0,0,68,68,0,1,0,1,0
12322,28,0,0,70,70,0,1,0,1,0
20316,28,0,0,70,70,0,1,0,1,0
9973,28,0,0,70,70,0,1,0,1,0
21046,28,0,0,67,67,0,1,0,1,0
20018,28,0,0,66,66,0,1,0,1,0
17677,28,0,0,70,70,0,1,0,1,0
10974,28,0,0,70,70,0,1,0,1,0
9562,28,0,0,66,66,0,1,0,1,0
19145,28,0,0,70,70,0,1,0,1,0
9827,28,0,0,70,70,0,1,0,1,0
8486,28,0,0,70,70,0,1,0,1,0
19551,28,0,0,70,70,0,1,0,1,0
22546,28,0,0,69,69,0,1,0,1,0
21856,28,0,0,70,70,0,1,0,1,0
9113,28,0,0,70,70,0,1,0,1,0
19970,28,0,0,69,69,0,1,0,1,0
21678,28,0,0,70,70,0,1,0,1,0
20589,28,0,0,68,68,0,1,0,1,0
15973,28,0,0,68,68,0,1,0,1,0
13327,28,0,0,70,70,0,1,0,1,0
13268,28,0,0,70,70,0,1,0,1,0
18406,28,0,0,70,70,0,1,0,1,0
8447,28,0,0,68,68,0,1,0,1,0
10233,28,0,0,70,70,0,1,0,1,0
16691,28,0,0,67,67,0,1,0,1,0
17417,28,0,0,66,66,0,1,0,1,0
20144,28,0,0,70,70,0,1,0,1,0
22216,28,0,0,66,66,0,1,0,1,0
9818,28,0,0,66,66,0,1,0,1,0
15659,28,0,0,66,66,0,1,0,1,0
8589,28,0,0,70,70,0,1,0,1,0
13501,28,0,0,70,70,0,1,0,1,0
17160,28,0,0,70,70,0,1,0,1,0
19786,28,0,0,66,66,0,1,0,1,0
9029,28,0,0,70,70,0,1,0,1,0
22099,28,0,0,68,68,0,1,0,1,0
8853,28,0,0,70,70,0,1,0,1,0
16924,28,0,0,66,66,0,1,0,1,0
20390,28,0,0,70,70,0,1,0,1,0
20387,28,0,0,70,70,0,1,0,1,0
20558,28,0,0,67,67,0,1,0,1,0
11486,28,0,0,70,70,0,1,0,1,0
15577,28,0,0,70,70,0,1,0,1,0
8963,28,0,0,70,70,0,1,0,1,0
19912,28,0,0,66,66,0,1,0,1,0
22043,28,0,0,70,70,0,1,0,1,0
16433,28,0,0,66,66,0,1,0,1,0
10306,28,0,0,70,70,0,1,0,1,0
12490,28,0,0,66,66,0,1,0,1,0
9558,28,0,0,70,70,0,1,0,1,0
16685,28,0,0,70,70,0,1,0,1,0
9816,28,0,0,66,66,0,1,0,1,0
10010,28,0,0,66,66,0,1,0,1,0
10516,28,0,0,70,70,0,1,0,1,0
10743,28,0,0,70,70,0,1,0,1,0
14980,28,0,0,70,70,0,1,0,1,0
19411,28,0,0,70,70,0,1,0,1,0
13416,28,0,0,67,67,0,1,0,1,0
14316,28,0,0,70,70,0,1,0,1,0
10519,28,0,0,70,70,0,1,0,1,0
9017,28,0,0,66,66,0,1,0,1,0
12458,28,0,0,70,70,0,1,0,1,0
11416,28,0,0,68,68,0,1,0,1,0
16513,28,0,0,70,70,0,1,0,1,0
13495,28,0,0,70,70,0,1,0,1,0
19129,28,0,0,70,70,0,1,0,1,0
10629,28,0,0,70,70,0,1,0,1,0
17905,28,0,0,66,66,0,1,0,1,0
17344,28,0,0,70,70,0,1,0,1,0
18604,28,0,0,70,70,0,1,0,1,0
21543,28,0,0,70,70,0,1,0,1,0
8523,28,0,0,66,66,0,1,0,1,0
8613,28,0,0,70,70,0,1,0,1,0
20464,28,0,0,66,66,0,1,0,1,0
10296,28,0,0,66,66,0,1,0,1,0
10069,28,0,0,70,70,0,1,0,1,0
12751,28,0,0,70,70,0,1,0,1,0
9132,28,0,0,66,66,0,1,0,1,0
21604,28,0,0,70,70,0,1,0,1,0
13596,28,0,0,70,70,0,1,0,1,0
11606,28,0,0,66,66,0,1,0,1,0
9670,28,0,0,70,70,0,1,0,1,0
16616,28,0,0,67,67,0,1,0,1,0
13211,28,0,0,70,70,0,1,0,1,0
10014,28,0,0,66,66,0,1,0,1,0
9999,28,0,0,70,70,0,1,0,1,0
8443,28,0,0,68,68,0,1,0,1,0
16653,28,0,0,66,66,0,1,0,1,0
21378,28,0,0,67,67,0,1,0,1,0
8623,28,0,0,66,66,0,1,0,1,0
10433,28,0,0,66,66,0,1,0,1,0
20900,28,0,0,70,70,0,1,0,1,0
19951,28,0,0,70,70,0,1,0,1,0
21426,28,0,0,70,70,0,1,0,1,0
9257,28,0,0,66,66,0,1,0,1,0
18704,28,0,0,68,68,0,1,0,1,0
14854,28,0,0,67,67,0,1,0,1,0
11345,28,0,0,66,66,0,1,0,1,0
13330,28,0,0,66,66,0,1,0,1,0
19200,28,0,0,66,66,0,1,0,1,0
8432,28,0,0,69,69,0,1,0,1,0
13174,28,0,0,66,66,0,1,0,1,0
16524,28,0,0,69,69,0,1,0,1,0
19894,28,0,0,70,70,0,1,0,1,0
13857,28,0,0,70,70,0,1,0,1,0
11237,28,0,0,70,70,0,1,0,1,0
17354,28,0,0,70,70,0,1,0,1,0
17952,28,0,0,66,66,0,1,0,1,0
11229,28,0,0,66,66,0,1,0,1,0
21713,28,0,0,70,70,0,1,0,1,0
16497,28,0,0,70,70,0,1,0,1,0
22177,28,0,0,66,66,0,1,0,1,0
16145,28,0,0,69,69,0,1,0,1,0
21933,28,0,0,67,67,0,1,0,1,0
16910,28,0,0,66,66,0,1,0,1,0
11358,28,0,0,66,66,0,1,0,1,0
13743,28,0,0,66,66,0,1,0,1,0
9495,28,0,0,66,66,0,1,0,1,0
9296,28,0,0,70,70,0,1,0,1,0
11273,28,0,0,70,70,0,1,0,1,0
13368,28,0,0,70,70,0,1,0,1,0
14368,28,0,0,70,70,0,1,0,1,0
19206,28,0,0,70,70,0,1,0,1,0
16943,28,0,0,66,66,0,1,0,1,0
9669,28,0,0,70,70,0,1,0,1,0
20017,28,0,0,69,69,0,1,0,1,0
21798,28,0,0,68,68,0,1,0,1,0
20104,28,0,0,68,68,0,1,0,1,0
21336,28,0,0,66,66,0,1,0,1,0
15065,28,0,0,70,70,0,1,0,1,0
8731,28,0,0,70,70,0,1,0,1,0
21163,28,0,0,70,70,0,1,0,1,0
9988,28,0,0,66,66,0,1,0,1,0
14326,28,0,0,70,70,0,1,0,1,0
18852,28,0,0,69,69,0,1,0,1,0
11450,28,0,0,70,70,0,1,0,1,0
22017,28,0,0,70,70,0,1,0,1,0
21831,28,0,0,66,66,0,1,0,1,0
15606,28,0,0,70,70,0,1,0,1,0
21162,28,0,0,70,70,0,1,0,1,0
14037,28,0,0,66,66,0,1,0,1,0
17805,28,0,0,70,70,0,1,0,1,0
17621,28,0,0,70,70,0,1,0,1,0
13385,28,0,0,70,70,0,1,0,1,0
12480,28,0,0,70,70,0,1,0,1,0
20497,28,0,0,70,70,0,1,0,1,0
14743,28,0,0,70,70,0,1,0,1,0
11375,28,0,0,66,66,0,1,0,1,0
21820,28,0,0,69,69,0,1,0,1,0
19853,28,0,0,70,70,0,1,0,1,0
19679,28,0,0,68,68,0,1,0,1,0
22083,28,0,0,70,70,0,1,0,1,0
20728,28,0,0,66,66,0,1,0,1,0
19237,28,0,0,66,66,0,1,0,1,0
21861,28,0,0,69,69,0,1,0,1,0
15008,28,0,0,70,70,0,1,0,1,0
9933,28,0,0,66,66,0,1,0,1,0
15973,28,0,0,66,66,0,1,0,1,0
20608,28,0,0,70,70,0,1,0,1,0
16362,28,0,0,69,69,0,1,0,1,0
13109,28,0,0,66,66,0,1,0,1,0
13862,28,0,0,66,66,0,1,0,1,0
20147,28,0,0,70,70,0,1,0,1,0
10304,28,0,0,70,70,0,1,0,1,0
12600,28,0,0,70,70,0,1,0,1,0
20509,28,0,0,70,70,0,1,0,1,0
19654,28,0,0,66,66,0,1,0,1,0
10743,28,0,0,70,70,0,1,0,1,0
17259,28,0,0,66,66,0,1,0,1,0
12532,28,0,0,69,69,0,1,0,1,0
21115,28,0,0,69,69,0,1,0,1,0
15782,28,0,0,66,66,0,1,0,1,0
12302,28,0,0,68,68,0,1,0,1,0
10394,28,0,0,66,66,0,1,0,1,0
20277,28,0,0,70,70,0,1,0,1,0
10386,28,0,0,70,70,0,1,0,1,0
11012,28,0,0,70,70,0,1,0,1,0
12845,28,0,0,66,66,0,1,0,1,0
9704,28,0,0,70,70,0,1,0,1,0
13436,28,0,0,70,70,0,1,0,1,0
22118,28,0,0,70,70,0,1,0,1,0
20841,28,0,0,66,66,0,1,0,1,0
19802,28,0,0,66,66,0,1,0,1,0
9951,28,0,0,70,70,0,1,0,1,0
14269,28,0,0,70,70,0,1,0,1,0
18765,28,0,0,66,66,0,1,0,1,0
16371,28,0,0,68,68,0,1,0,1,0
22595,28,0,0,70,70,0,1,0,1,0
20609,28,0,0,70,70,0,1,0,1,0
9069,28,0,0,70,70,0,1,0,1,0
10481,28,0,0,70,70,0,1,0,1,0
19910,28,0,0,68,68,0,1,0,1,0
9171,28,0,0,67,67,0,1,0,1,0
13064,28,0,0,69,69,0,1,0,1,0
21591,28,0,0,70,70,0,1,0,1,0
21825,28,0,0,70,70,0,1,0,1,0
11781,28,0,0,70,70,0,1,0,1,0
22556,28,0,0,70,70,0,1,0,1,0
14120,28,0,0,67,67,0,1,0,1,0
16292,28,0,0,68,68,0,1,0,1,0
9479,28,0,0,66,66,0,1,0,1,0
22183,28,0,0,70,70,0,1,0,1,0
12452,28,0,0,67,67,0,1,0,1,0
13793,28,0,0,67,67,0,1,0,1,0
9750,28,0,0,70,70,0,1,0,1,0
14475,28,0,0,66,66,0,1,0,1,0
21819,28,0,0,70,70,0,1,0,1,0
20263,28,0,0,67,67,0,1,0,1,0
16201,28,0,0,68,68,0,1,0,1,0
9124,28,0,0,70,70,0,1,0,1,0
9891,28,0,0,70,70,0,1,0,1,0
20064,28,0,0,70,70,0,1,0,1,0
14365,28,0,0,66,66,0,1,0,1,0
16812,28,0,0,70,70,0,1,0,1,0
18595,28,0,0,70,70,0,1,0,1,0
8727,28,0,0,70,70,0,1,0,1,0
9908,28,0,0,70,70,0,1,0,1,0
9902,28,0,0,66,66,0,1,0,1,0
20729,28,0,0,66,66,0,1,0,1,0
11229,28,0,0,66,66,0,1,0,1,0
17057,28,0,0,67,67,0,1,0,1,0
14884,28,0,0,70,70,0,1,0,1,0
13686,28,0,0,70,70,0,1,0,1,0
21225,28,0,0,67,67,0,1,0,1,0
18544,28,0,0,70,70,0,1,0,1,0
9546,28,0,0,70,70,0,1,0,1,0
19686,28,0,0,66,66,0,1,0,1,0
12331,28,0,0,66,66,0,1,0,1,0
14095,28,0,0,70,70,0,1,0,1,0
12239,28,0,0,66,66,0,1,0,1,0
11015,28,0,0,70,70,0,1,0,1,0
21750,28,0,0,70,70,0,1,0,1,0
12738,28,0,0,67,67,0,1,0,1,0
16626,28,0,0,68,68,0,1,0,1,0
21026,28,0,0,70,70,0,1,0,1,0
21680,28,0,0,70,70,0,1,0,1,0
12056,28,0,0,70,70,0,1,0,1,0
8878,28,0,0,66,66,0,1,0,1,0
17389,28,0,0,70,70,0,1,0,1,0
14009,28,0,0,68,68,0,1,0,1,0
17565,28,0,0,70,70,0,1,0,1,0
10060,28,0,0,66,66,0,1,0,1,0
20733,28,0,0,66,66,0,1,0,1,0
9043,28,0,0,68,68,0,1,0,1,0
21077,28,0,0,66,66,0,1,0,1,0
20222,28,0,0,70,70,0,1,0,1,0
17092,28,0,0,70,70,0,1,0,1,0
10668,28,0,0,66,66,0,1,0,1,0
22405,28,0,0,66,66,0,1,0,1,0
16351,28,0,0,70,70,0,1,0,1,0
11273,28,0,0,70,70,0,1,0,1,0
13604,28,0,0,70,70,0,1,0,1,0
10438,28,0,0,70,70,0,1,0,1,0
19793,28,0,0,66,66,0,1,0,1,0
15710,28,0,0,70,70,0,1,0,1,0
13761,28,0,0,68,68,0,1,0,1,0
22518,28,0,0,66,66,0,1,0,1,0
21026,28,0,0,69,69,0,1,0,1,0
11388,28,0,0,66,66,0,1,0,1,0
20625,28,0,0,67,67,0,1,0,1,0
16509,28,0,0,66,66,0,1,0,1,0
10251,28,0,0,70,70,0,1,0,1,0
22259,28,0,0,69,69,0,1,0,1,0
14604,28,0,0,70,70,0,1,0,1,0
12181,28,0,0,66,66,0,1,0,1,0
12497,28,0,0,67,67,0,1,0,1,0
11194,28,0,0,70,70,0,1,0,1,0
13959,28,0,0,66,66,0,1,0,1,0
8785,28,0,0,66,66,0,1,0,1,0
20625,28,0,0,66,66,0,1,0,1,0
21267,28,0,0,70,70,0,1,0,1,0
10475,28,0,0,70,70,0,1,0,1,0
11969,28,0,0,70,70,0,1,0,1,0
17959,28,0,0,70,70,0,1,0,1,0
19025,28,0,0,70,70,0,1,0,1,0
18231,28,0,0,66,66,0,1,0,1,0
12305,28,0,0,66,66,0,1,0,1,0
15139,28,0,0,66,66,0,1,0,1,0
17737,28,0,0,70,70,0,1,0,1,0
19632,28,0,0,70,70,0,1,0,1,0
15972,28,0,0,66,66,0,1,0,1,0
12347,28,0,0,66,66,0,1,0,1,0
16055,28,0,0,70,70,0,1,0,1,0
16708,28,0,0,66,66,0,1,0,1,0
15437,28,0,0,70,70,0,1,0,1,0
18414,28,0,0,70,70,0,1,0,1,0
13603,28,0,0,70,70,0,1,0,1,0
18358,28,0,0,70,70,0,1,0,1,0
12193,28,0,0,70,70,0,1,0,1,0
19856,28,0,0,67,67,0,1,0,1,0
13504,28,0,0,70,70,0,1,0,1,0
9030,28,0,0,70,70,0,1,0,1,0
19972,28,0,0,69,69,0,1,0,1,0
16635,28,0,0,70,70,0,1,0,1,0
18156,28,0,0,70,70,0,1,0,1,0
14724,28,0,0,66,66,0,1,0,1,0
17886,28,0,0,68,68,0,1,0,1,0
20884,28,0,0,67,67,0,1,0,1,0
9893,28,0,0,70,70,0,1,0,1,0
22387,28,0,0,70,70,0,1,0,1,0
19855,28,0,0,70,70,0,1,0,1,0
8718,28,0,0,70,70,0,1,0,1,0
17233,28,0,0,66,66,0,1,0,1,0
17674,28,0,0,66,66,0,1,0,1,0
9711,28,0,0,70,70,0,1,0,1,0
15045,28,0,0,70,70,0,1,0,1,0
8592,28,0,0,70,70,0,1,0,1,0
10551,28,0,0,69,69,0,1,0,1,0
18770,28,0,0,68,68,0,1,0,1,0
13007,28,0,0,66,66,0,1,0,1,0
16710,28,0,0,70,70,0,1,0,1,0
17727,28,0,0,69,69,0,1,0,1,0
20622,28,0,0,66,66,0,1,0,1,0
8954,28,0,0,70,70,0,1,0,1,0
11304,28,0,0,66,66,0,1,0,1,0
19617,28,0,0,70,70,0,1,0,1,0
9376,28,0,0,70,70,0,1,0,1,0
21455,28,0,0,70,70,0,1,0,1,0
16867,28,0,0,70,70,0,1,0,1,0
16234,28,0,0,66,66,0,1,0,1,0
9804,28,0,0,70,70,0,1,0,1,0
21970,28,0,0,66,66,0,1,0,1,0
12282,28,0,0,69,69,0,1,0,1,0
11957,28,0,0,70,70,0,1,0,1,0
19974,28,0,0,70,70,0,1,0,1,0
14894,28,0,0,70,70,0,1,0,1,0
13811,28,0,0,70,70,0,1,0,1,0
22611,28,0,0,70,70,0,1,0,1,0
16977,28,0,0,70,70,0,1,0,1,0
20644,28,0,0,70,70,0,1,0,1,0
10844,28,0,0,69,69,0,1,0,1,0
18423,28,0,0,70,70,0,1,0,1,0
13857,28,0,0,67,67,0,1,0,1,0
15940,28,0,0,70,70,0,1,0,1,0
19655,28,0,0,66,66,0,1,0,1,0
17082,28,0,0,68,68,0,1,0,1,0
13644,28,0,0,70,70,0,1,0,1,0
10177,28,0,0,66,66,0,1,0,1,0
12445,28,0,0,70,70,0,1,0,1,0
19648,28,0,0,70,70,0,1,0,1,0
14544,28,0,0,66,66,0,1,0,1,0
14690,28,0,0,66,66,0,1,0,1,0
17686,28,0,0,70,70,0,1,0,1,0
8558,28,0,0,66,66,0,1,0,1,0
20015,28,0,0,68,68,0,1,0,1,0
21795,28,0,0,70,70,0,1,0,1,0
20703,28,0,0,70,70,0,1,0,1,0
20256,28,0,0,66,66,0,1,0,1,0
20367,28,0,0,67,67,0,1,0,1,0
10527,28,0,0,67,67,0,1,0,1,0
19682,28,0,0,70,70,0,1,0,1,0
17499,28,0,0,67,67,0,1,0,1,0
14794,28,0,0,70,70,0,1,0,1,0
18846,28,0,0,70,70,0,1,0,1,0
10184,28,0,0,70,70,0,1,0,1,0
21108,28,0,0,69,69,0,1,0,1,0
16193,28,0,0,70,70,0,1,0,1,0
9537,28,0,0,69,69,0,1,0,1,0
19699,28,0,0,70,70,0,1,0,1,0
18292,28,0,0,70,70,0,1,0,1,0
22282,28,0,0,70,70,0,1,0,1,0
18319,28,0,0,66,66,0,1,0,1,0
15518,28,0,0,67,67,0,1,0,1,0
16080,28,0,0,70,70,0,1,0,1,0
9500,28,0,0,66,66,0,1,0,1,0
10730,28,0,0,66,66,0,1,0,1,0
11708,28,0,0,68,68,0,1,0,1,0
14827,28,0,0,70,70,0,1,0,1,0
9324,28,0,0,70,70,0,1,0,1,0
9826,28,0,0,70,70,0,1,0,1,0
8944,28,0,0,66,66,0,1,0,1,0
13786,28,0,0,70,70,0,1,0,1,0
9216,28,0,0,70,70,0,1,0,1,0
14069,28,0,0,70,70,0,1,0,1,0
19787,28,0,0,69,69,0,1,0,1,0
11369,28,0,0,70,70,0,1,0,1,0
18705,28,0,0,67,67,0,1,0,1,0
11980,28,0,0,70,70,0,1,0,1,0
20496,28,0,0,70,70,0,1,0,1,0
15475,28,0,0,70,70,0,1,0,1,0
21610,28,0,0,70,70,0,1,0,1,0
11746,28,0,0,70,70,0,1,0,1,0
18997,28,0,0,66,66,0,1,0,1,0
10559,28,0,0,66,66,0,1,0,1,0
11391,28,0,0,70,70,0,1,0,1,0
13810,28,0,0,70,70,0,1,0,1,0
10741,28,0,0,70,70,0,1,0,1,0
17214,28,0,0,66,66,0,1,0,1,0
17248,28,0,0,66,66,0,1,0,1,0
17524,28,0,0,70,70,0,1,0,1,0
16900,28,0,0,66,66,0,1,0,1,0
11699,28,0,0,66,66,0,1,0,1,0
12838,28,0,0,70,70,0,1,0,1,0
8543,28,0,0,68,68,0,1,0,1,0
17583,28,0,0,70,70,0,1,0,1,0
9467,28,0,0,70,70,0,1,0,1,0
20853,28,0,0,67,67,0,1,0,1,0
18503,28,0,0,66,66,0,1,0,1,0
10758,28,0,0,67,67,0,1,0,1,0
10552,28,0,0,66,66,0,1,0,1,0
10280,28,0,0,70,70,0,1,0,1,0
18878,28,0,0,66,66,0,1,0,1,0
15956,28,0,0,70,70,0,1,0,1,0
22354,28,0,0,70,70,0,1,0,1,0
9652,28,0,0,70,70,0,1,0,1,0
16144,28,0,0,69,69,0,1,0,1,0
13298,28,0,0,66,66,0,1,0,1,0
16625,28,0,0,67,67,0,1,0,1,0
20966,28,0,0,66,66,0,1,0,1,0
19474,28,0,0,70,70,0,1,0,1,0
12288,28,0,0,68,68,0,1,0,1,0
19088,28,0,0,67,67,0,1,0,1,0
13851,28,0,0,70,70,0,1,0,1,0
20385,28,0,0,70,70,0,1,0,1,0
15983,28,0,0,70,70,0,1,0,1,0
14812,28,0,0,67,67,0,1,0,1,0
11767,28,0,0,70,70,0,1,0,1,0
12985,28,0,0,70,70,0,1,0,1,0
10221,28,0,0,70,70,0,1,0,1,0
10952,28,0,0,70,70,0,1,0,1,0
18478,28,0,0,70,70,0,1,0,1,0
15165,28,0,0,70,70,0,1,0,1,0
19122,28,0,0,70,70,0,1,0,1,0
9211,28,0,0,69,69,0,1,0,1,0
9570,28,0,0,70,70,0,1,0,1,0
21443,28,0,0,70,70,0,1,0,1,0
14222,28,0,0,70,70,0,1,0,1,0
11513,28,0,0,70,70,0,1,0,1,0
16638,28,0,0,70,70,0,1,0,1,0
10721,28,0,0,70,70,0,1,0,1,0
20147,28,0,0,70,70,0,1,0,1,0
16163,28,0,0,66,66,0,1,0,1,0
20595,28,0,0,70,70,0,1,0,1,0
21861,28,0,0,70,70,0,1,0,1,0
10114,28,0,0,70,70,0,1,0,1,0
18067,28,0,0,70,70,0,1,0,1,0
19112,28,0,0,70,70,0,1,0,1,0
20153,28,0,0,66,66,0,1,0,1,0
17826,28,0,0,70,70,0,1,0,1,0
17214,28,0,0,66,66,0,1,0,1,0
11559,28,0,0,66,66,0,1,0,1,0
9344,28,0,0,70,70,0,1,0,1,0
15048,28,0,0,67,67,0,1,0,1,0
22086,28,0,0,68,68,0,1,0,1,0
19588,28,0,0,70,70,0,1,0,1,0
18666,28,0,0,69,69,0,1,0,1,0
11602,28,0,0,70,70,0,1,0,1,0
18014,28,0,0,70,70,0,1,0,1,0
20849,28,0,0,70,70,0,1,0,1,0
13062,28,0,0,66,66,0,1,0,1,0
9571,28,0,0,70,70,0,1,0,1,0
20313,28,0,0,70,70,0,1,0,1,0
9761,28,0,0,70,70,0,1,0,1,0
11121,28,0,0,70,70,0,1,0,1,0
8472,28,0,0,70,70,0,1,0,1,0
14582,28,0,0,66,66,0,1,0,1,0
11513,28,0,0,66,66,0,1,0,1,0
15660,28,0,0,66,66,0,1,0,1,0
13685,28,0,0,68,68,0,1,0,1,0
18020,28,0,0,70,70,0,1,0,1,0
9839,28,0,0,70,70,0,1,0,1,0
20711,28,0,0,67,67,0,1,0,1,0
15903,28,0,0,66,66,0,1,0,1,0
9039,28,0,0,70,70,0,1,0,1,0
13574,28,0,0,70,70,0,1,0,1,0
19697,28,0,0,70,70,0,1,0,1,0
21288,28,0,0,69,69,0,1,0,1,0
13685,28,0,0,66,66,0,1,0,1,0
8909,28,0,0,67,67,0,1,0,1,0
11556,28,0,0,70,70,0,1,0,1,0
13609,28,0,0,70,70,0,1,0,1,0
13439,28,0,0,70,70,0,1,0,1,0
18964,28,0,0,68,68,0,1,0,1,0
17956,28,0,0,70,70,0,1,0,1,0
16140,28,0,0,70,70,0,1,0,1,0
18776,28,0,0,69,69,0,1,0,1,0
12167,28,0,0,70,70,0,1,0,1,0
9941,28,0,0,70,70,0,1,0,1,0
19390,28,0,0,70,70,0,1,0,1,0
13602,28,0,0,70,70,0,1,0,1,0
17267,28,0,0,69,69,0,1,0,1,0
15155,28,0,0,66,66,0,1,0,1,0
12045,28,0,0,70,70,0,1,0,1,0
17384,28,0,0,67,67,0,1,0,1,0
20375,28,0,0,68,68,0,1,0,1,0
18748,28,0,0,70,70,0,1,0,1,0
19484,28,0,0,70,70,0,1,0,1,0
15756,28,0,0,70,70,0,1,0,1,0
21138,28,0,0,70,70,0,1,0,1,0
21319,28,0,0,70,70,0,1,0,1,0
19563,28,0,0,70,70,0,1,0,1,0
21955,28,0,0,68,68,0,1,0,1,0
20329,28,0,0,69,69,0,1,0,1,0
22268,28,0,0,70,70,0,1,0,1,0
18618,28,0,0,67,67,0,1,0,1,0
21478,28,0,0,66,66,0,1,0,1,0
20463,28,0,0,70,70,0,1,0,1,0
16248,28,0,0,70,70,0,1,0,1,0
21651,28,0,0,69,69,0,1,0,1,0
20657,28,0,0,66,66,0,1,0,1,0
11327,28,0,0,70,70,0,1,0,1,0
17746,28,0,0,70,70,0,1,0,1,0
9733,28,0,0,70,70,0,1,0,1,0
10835,28,0,0,70,70,0,1,0,1,0
21771,28,0,0,70,70,0,1,0,1,0
13673,28,0,0,70,70,0,1,0,1,0
16875,28,0,0,70,70,0,1,0,1,0
11555,28,0,0,70,70,0,1,0,1,0
15774,28,0,0,70,70,0,1,0,1,0
13692,28,0,0,70,70,0,1,0,1,0
13140,28,0,0,70,70,0,1,0,1,0
17304,28,0,0,70,70,0,1,0,1,0
9378,28,0,0,67,67,0,1,0,1,0
20218,28,0,0,70,70,0,1,0,1,0
13950,28,0,0,66,66,0,1,0,1,0
16556,28,0,0,69,69,0,1,0,1,0
20852,28,0,0,70,70,0,1,0,1,0
10564,28,0,0,66,66,0,1,0,1,0
16845,28,0,0,66,66,0,1,0,1,0
21769,28,0,0,70,70,0,1,0,1,0
21476,28,0,0,70,70,0,1,0,1,0
12567,28,0,0,70,70,0,1,0,1,0
10057,28,0,0,66,66,0,1,0,1,0
11705,28,0,0,66,66,0,1,0,1,0
11501,28,0,0,70,70,0,1,0,1,0
16190,28,0,0,66,66,0,1,0,1,0
22167,28,0,0,70,70,0,1,0,1,0
18343,28,0,0,70,70,0,1,0,1,0
8503,28,0,0,70,70,0,1,0,1,0
21029,28,0,0,68,68,0,1,0,1,0
19733,28,0,0,68,68,0,1,0,1,0
10219,28,0,0,67,67,0,1,0,1,0
21902,28,0,0,70,70,0,1,0,1,0
13164,28,0,0,70,70,0,1,0,1,0
20609,28,0,0,70,70,0,1,0,1,0
11684,28,0,0,66,66,0,1,0,1,0
9474,28,0,0,70,70,0,1,0,1,0
20821,28,0,0,70,70,0,1,0,1,0
21517,28,0,0,70,70,0,1,0,1,0
12688,28,0,0,70,70,0,1,0,1,0
17521,28,0,0,70,70,0,1,0,1,0
21472,28,0,0,67,67,0,1,0,1,0
15291,28,0,0,70,70,0,1,0,1,0
9894,28,0,0,66,66,0,1,0,1,0
13414,28,0,0,70,70,0,1,0,1,0
13837,28,0,0,68,68,0,1,0,1,0
21988,28,0,0,66,66,0,1,0,1,0
12087,28,0,0,67,67,0,1,0,1,0
17235,28,0,0,70,70,0,1,0,1,0
19716,28,0,0,70,70,0,1,0,1,0
19193,28,0,0,70,70,0,1,0,1,0
18617,28,0,0,70,70,0,1,0,1,0
8993,28,0,0,70,70,0,1,0,1,0
14247,28,0,0,70,70,0,1,0,1,0
14927,28,0,0,66,66,0,1,0,1,0
12587,28,0,0,70,70,0,1,0,1,0
10140,28,0,0,69,69,0,1,0,1,0
19336,28,0,0,70,70,0,1,0,1,0
20432,28,0,0,70,70,0,1,0,1,0
14657,28,0,0,70,70,0,1,0,1,0
8700,28,0,0,70,70,0,1,0,1,0
17554,28,0,0,70,70,0,1,0,1,0
13407,28,0,0,70,70,0,1,0,1,0
19356,28,0,0,66,66,0,1,0,1,0
12529,28,0,0,66,66,0,1,0,1,0
14121,28,0,0,66,66,0,1,0,1,0
16510,28,0,0,66,66,0,1,0,1,0
15705,28,0,0,66,66,0,1,0,1,0
20343,28,0,0,66,66,0,1,0,1,0
21861,28,0,0,70,70,0,1,0,1,0
17584,28,0,0,66,66,0,1,0,1,0
9044,28,0,0,70,70,0,1,0,1,0
9051,28,0,0,70,70,0,1,0,1,0
8557,28,0,0,68,68,0,1,0,1,0
21361,28,0,0,70,70,0,1,0,1,0
21796,28,0,0,70,70,0,1,0,1,0
11544,28,0,0,68,68,0,1,0,1,0
12884,28,0,0,70,70,0,1,0,1,0
21765,28,0,0,66,66,0,1,0,1,0
9757,28,0,0,70,70,0,1,0,1,0
17247,28,0,0,66,66,0,1,0,1,0
9247,28,0,0,70,70,0,1,0,1,0
10613,28,0,0,66,66,0,1,0,1,0
17937,28,0,0,70,70,0,1,0,1,0
17343,28,0,0,70,70,0,1,0,1,0
18536,28,0,0,70,70,0,1,0,1,0
9272,28,0,0,70,70,0,1,0,1,0
9196,28,0,0,69,69,0,1,0,1,0
17561,28,0,0,68,68,0,1,0,1,0
13845,28,0,0,67,67,0,1,0,1,0
13628,28,0,0,70,70,0,1,0,1,0
19972,28,0,0,70,70,0,1,0,1,0
17372,28,0,0,66,66,0,1,0,1,0
21909,28,0,0,68,68,0,1,0,1,0
12511,28,0,0,70,70,0,1,0,1,0
15596,28,0,0,66,66,0,1,0,1,0
12045,28,0,0,70,70,0,1,0,1,0
9919,28,0,0,70,70,0,1,0,1,0
11819,28,0,0,66,66,0,1,0,1,0
21087,28,0,0,70,70,0,1,0,1,0
21546,28,0,0,70,70,0,1,0,1,0
20101,28,0,0,70,70,0,1,0,1,0
9420,28,0,0,70,70,0,1,0,1,0
14227,28,0,0,66,66,0,1,0,1,0
14458,28,0,0,70,70,0,1,0,1,0
10000,28,0,0,66,66,0,1,0,1,0
18720,28,0,0,66,66,0,1,0,1,0
13085,28,0,0,69,69,0,1,0,1,0
17972,28,0,0,69,69,0,1,0,1,0
21236,28,0,0,69,69,0,1,0,1,0
14666,28,0,0,66,66,0,1,0,1,0
17919,28,0,0,70,70,0,1,0,1,0
19339,28,0,0,67,67,0,1,0,1,0
22183,28,0,0,70,70,0,1,0,1,0
12007,28,0,0,70,70,0,1,0,1,0
15055,28,0,0,70,70,0,1,0,1,0
19147,28,0,0,70,70,0,1,0,1,0
16994,28,0,0,69,69,0,1,0,1,0
19971,28,0,0,70,70,0,1,0,1,0
9626,28,0,0,70,70,0,1,0,1,0
13828,28,0,0,66,66,0,1,0,1,0
21089,28,0,0,70,70,0,1,0,1,0
16593,28,0,0,70,70,0,1,0,1,0
16475,28,0,0,70,70,0,1,0,1,0
19273,28,0,0,70,70,0,1,0,1,0
22259,28,0,0,69,69,0,1,0,1,0
22597,28,0,0,66,66,0,1,0,1,0
21048,28,0,0,70,70,0,1,0,1,0
10381,28,0,0,70,70,0,1,0,1,0
17741,28,0,0,70,70,0,1,0,1,0
9815,28,0,0,66,66,0,1,0,1,0
10690,28,0,0,70,70,0,1,0,1,0
15831,28,0,0,68,68,0,1,0,1,0
14967,28,0,0,70,70,0,1,0,1,0
16652,28,0,0,66,66,0,1,0,1,0
16713,28,0,0,66,66,0,1,0,1,0
17234,28,0,0,68,68,0,1,0,1,0
10779,28,0,0,70,70,0,1,0,1,0
22385,28,0,0,70,70,0,1,0,1,0
21871,28,0,0,70,70,0,1,0,1,0
11461,28,0,0,66,66,0,1,0,1,0
10425,28,0,0,70,70,0,1,0,1,0
13697,28,0,0,66,66,0,1,0,1,0
11322,28,0,0,70,70,0,1,0,1,0
9037,28,0,0,70,70,0,1,0,1,0
8892,28,0,0,70,70,0,1,0,1,0
20488,28,0,0,70,70,0,1,0,1,0
22064,28,0,0,70,70,0,1,0,1,0
17597,28,0,0,70,70,0,1,0,1,0
12290,28,0,0,70,70,0,1,0,1,0
13991,28,0,0,66,66,0,1,0,1,0
15467,28,0,0,69,69,0,1,0,1,0
20504,28,0,0,66,66,0,1,0,1,0
14319,28,0,0,70,70,0,1,0,1,0
22463,28,0,0,70,70,0,1,0,1,0
12440,28,0,0,70,70,0,1,0,1,0
11778,28,0,0,70,70,0,1,0,1,0
17887,28,0,0,66,66,0,1,0,1,0
12261,28,0,0,70,70,0,1,0,1,0
17896,28,0,0,70,70,0,1,0,1,0
9985,28,0,0,66,66,0,1,0,1,0
14846,28,0,0,70,70,0,1,0,1,0
10915,28,0,0,70,70,0,1,0,1,0
16711,28,0,0,66,66,0,1,0,1,0
17904,28,0,0,70,70,0,1,0,1,0
15410,28,0,0,66,66,0,1,0,1,0
15480,28,0,0,70,70,0,1,0,1,0
18402,28,0,0,70,70,0,1,0,1,0
16981,28,0,0,70,70,0,1,0,1,0
19708,28,0,0,66,66,0,1,0,1,0
8743,28,0,0,70,70,0,1,0,1,0
22611,28,0,0,70,70,0,1,0,1,0
14246,28,0,0,70,70,0,1,0,1,0
17824,28,0,0,70,70,0,1,0,1,0
12099,28,0,0,70,70,0,1,0,1,0
19584,28,0,0,70,70,0,1,0,1,0
9729,28,0,0,70,70,0,1,0,1,0
18089,28,0,0,70,70,0,1,0,1,0
8972,28,0,0,70,70,0,1,0,1,0
13853,28,0,0,70,70,0,1,0,1,0
14407,28,0,0,70,70,0,1,0,1,0
13271,28,0,0,66,66,0,1,0,1,0
12993,28,0,0,68,68,0,1,0,1,0
10062,28,0,0,66,66,0,1,0,1,0
10740,28,0,0,68,68,0,1,0,1,0
11828,28,0,0,66,66,0,1,0,1,0
13909,28,0,0,70,70,0,1,0,1,0
14061,28,0,0,70,70,0,1,0,1,0
20675,28,0,0,70,70,0,1,0,1,0
14976,28,0,0,67,67,0,1,0,1,0
8926,28,0,0,70,70,0,1,0,1,0
11141,28,0,0,66,66,0,1,0,1,0
15714,28,0,0,66,66,0,1,0,1,0
13484,28,0,0,70,70,0,1,0,1,0
9795,28,0,0,70,70,0,1,0,1,0
13415,28,0,0,70,70,0,1,0,1,0
18529,28,0,0,66,66,0,1,0,1,0
18372,28,0,0,66,66,0,1,0,1,0
18856,28,0,0,66,66,0,1,0,1,0
9667,28,0,0,70,70,0,1,0,1,0
19949,28,0,0,70,70,0,1,0,1,0
10733,28,0,0,66,66,0,1,0,1,0
16611,28,0,0,70,70,0,1,0,1,0
14869,28,0,0,70,70,0,1,0,1,0
22527,28,0,0,70,70,0,1,0,1,0
20748,28,0,0,66,66,0,1,0,1,0
17597,28,0,0,70,70,0,1,0,1,0
18644,28,0,0,70,70,0,1,0,1,0
14425,28,0,0,70,70,0,1,0,1,0
13307,28,0,0,70,70,0,1,0,1,0
10653,28,0,0,70,70,0,1,0,1,0
22278,28,0,0,67,67,0,1,0,1,0
10143,28,0,0,70,70,0,1,0,1,0
18902,28,0,0,66,66,0,1,0,1,0
14186,28,0,0,70,70,0,1,0,1,0
11677,28,0,0,67,67,0,1,0,1,0
20544,28,0,0,66,66,0,1,0,1,0
18441,28,0,0,67,67,0,1,0,1,0
8954,28,0,0,70,70,0,1,0,1,0
10856,28,0,0,66,66,0,1,0,1,0
9837,28,0,0,70,70,0,1,0,1,0
10912,28,0,0,70,70,0,1,0,1,0
11294,28,0,0,70,70,0,1,0,1,0
14587,28,0,0,70,70,0,1,0,1,0
20023,28,0,0,66,66,0,1,0,1,0
13659,28,0,0,70,70,0,1,0,1,0
15517,28,0,0,70,70,0,1,0,1,0
20135,28,0,0,67,67,0,1,0,1,0
14161,28,0,0,67,67,0,1,0,1,0
17281,28,0,0,66,66,0,1,0,1,0
20134,28,0,0,66,66,0,1,0,1,0
19608,28,0,0,70,70,0,1,0,1,0
10943,28,0,0,69,69,0,1,0,1,0
19170,28,0,0,66,66,0,1,0,1,0
16614,28,0,0,70,70,0,1,0,1,0
10480,28,0,0,70,70,0,1,0,1,0
14032,28,0,0,70,70,0,1,0,1,0
22030,28,0,0,66,66,0,1,0,1,0
9110,28,0,0,70,70,0,1,0,1,0
9054,28,0,0,70,70,0,1,0,1,0
14618,28,0,0,70,70,0,1,0,1,0
10786,28,0,0,70,70,0,1,0,1,0
9611,28,0,0,66,66,0,1,0,1,0
9354,28,0,0,70,70,0,1,0,1,0
11960,28,0,0,70,70,0,1,0,1,0
18943,28,0,0,69,69,0,1,0,1,0
8821,28,0,0,66,66,0,1,0,1,0
18470,28,0,0,66,66,0,1,0,1,0
17649,28,0,0,66,66,0,1,0,1,0
10478,28,0,0,70,70,0,1,0,1,0
17485,28,0,0,70,70,0,1,0,1,0
14341,28,0,0,70,70,0,1,0,1,0
21008,28,0,0,68,68,0,1,0,1,0
15086,28,0,0,68,68,0,1,0,1,0
20437,28,0,0,70,70,0,1,0,1,0
19435,28,0,0,70,70,0,1,0,1,0
8435,28,0,0,70,70,0,1,0,1,0
10231,28,0,0,68,68,0,1,0,1,0
22667,28,0,0,70,70,0,1,0,1,0
9863,28,0,0,66,66,0,1,0,1,0
21878,28,0,0,70,70,0,1,0,1,0
9343,28,0,0,70,70,0,1,0,1,0
12505,28,0,0,70,70,0,1,0,1,0
17951,28,0,0,68,68,0,1,0,1,0
14364,28,0,0,66,66,0,1,0,1,0
18021,28,0,0,70,70,0,1,0,1,0
19732,28,0,0,70,70,0,1,0,1,0
13047,28,0,0,66,66,0,1,0,1,0
13939,28,0,0,70,70,0,1,0,1,0
17938,28,0,0,70,70,0,1,0,1,0
9643,28,0,0,70,70,0,1,0,1,0
9559,28,0,0,66,66,0,1,0,1,0
12344,28,0,0,66,66,0,1,0,1,0
17634,28,0,0,69,69,0,1,0,1,0
18573,28,0,0,70,70,0,1,0,1,0
19457,28,0,0,66,66,0,1,0,1,0
8504,28,0,0,70,70,0,1,0,1,0
21933,28,0,0,70,70,0,1,0,1,0
21300,28,0,0,70,70,0,1,0,1,0
13996,28,0,0,70,70,0,1,0,1,0
22451,28,0,0,70,70,0,1,0,1,0
11406,28,0,0,66,66,0,1,0,1,0
15192,28,0,0,70,70,0,1,0,1,0
20338,28,0,0,66,66,0,1,0,1,0
22318,28,0,0,70,70,0,1,0,1,0
19086,28,0,0,70,70,0,1,0,1,0
21084,28,0,0,70,70,0,1,0,1,0
20234,28,0,0,70,70,0,1,0,1,0
13725,28,0,0,70,70,0,1,0,1,0
14134,28,0,0,70,70,0,1,0,1,0
9771,28,0,0,67,67,0,1,0,1,0
9928,28,0,0,66,66,0,1,0,1,0
10917,28,0,0,68,68,0,1,0,1,0
22393,28,0,0,69,69,0,1,0,1,0
9255,28,0,0,66,66,0,1,0,1,0
12064,28,0,0,67,67,0,1,0,1,0
9197,28,0,0,70,70,0,1,0,1,0
14610,28,0,0,70,70,0,1,0,1,0
14544,28,0,0,66,66,0,1,0,1,0
20719,28,0,0,70,70,0,1,0,1,0
19943,28,0,0,70,70,0,1,0,1,0
13069,28,0,0,70,70,0,1,0,1,0
18242,28,0,0,70,70,0,1,0,1,0
16663,28,0,0,70,70,0,1,0,1,0
8353,28,0,0,67,67,0,1,0,1,0
12248,28,0,0,68,68,0,1,0,1,0
9098,28,0,0,70,70,0,1,0,1,0
21736,28,0,0,66,66,0,1,0,1,0
21568,28,0,0,66,66,0,1,0,1,0
13063,28,0,0,66,66,0,1,0,1,0
13166,28,0,0,70,70,0,1,0,1,0
22430,28,0,0,68,68,0,1,0,1,0
9851,28,0,0,69,69,0,1,0,1,0
9508,28,0,0,66,66,0,1,0,1,0
9783,28,0,0,67,67,0,1,0,1,0
18948,28,0,0,66,66,0,1,0,1,0
20046,28,0,0,70,70,0,1,0,1,0
12174,28,0,0,70,70,0,1,0,1,0
10436,28,0,0,66,66,0,1,0,1,0
14206,28,0,0,68,68,0,1,0,1,0
10241,28,0,0,66,66,0,1,0,1,0
21714,28,0,0,66,66,0,1,0,1,0
21261,28,0,0,70,70,0,1,0,1,0
19675,28,0,0,66,66,0,1,0,1,0
10328,28,0,0,69,69,0,1,0,1,0
17310,28,0,0,66,66,0,1,0,1,0
11375,28,0,0,68,68,0,1,0,1,0
16686,28,0,0,70,70,0,1,0,1,0
11769,28,0,0,70,70,0,1,0,1,0
21907,28,0,0,66,66,0,1,0,1,0
19736,28,0,0,69,69,0,1,0,1,0
12813,28,0,0,70,70,0,1,0,1,0
9017,28,0,0,68,68,0,1,0,1,0
11400,28,0,0,70,70,0,1,0,1,0
17534,28,0,0,70,70,0,1,0,1,0
21694,28,0,0,70,70,0,1,0,1,0
17246,28,0,0,67,67,0,1,0,1,0
19148,28,0,0,66,66,0,1,0,1,0
18058,28,0,0,70,70,0,1,0,1,0
9172,28,0,0,70,70,0,1,0,1,0
19205,28,0,0,66,66,0,1,0,1,0
14911,28,0,0,70,70,0,1,0,1,0
11316,28,0,0,66,66,0,1,0,1,0
16625,28,0,0,67,67,0,1,0,1,0
12390,28,0,0,68,68,0,1,0,1,0
11153,28,0,0,70,70,0,1,0,1,0
8682,28,0,0,70,70,0,1,0,1,0
12868,28,0,0,66,66,0,1,0,1,0
21050,28,0,0,70,70,0,1,0,1,0
14491,28,0,0,70,70,0,1,0,1,0
9735,28,0,0,70,70,0,1,0,1,0
9782,28,0,0,70,70,0,1,0,1,0
11180,28,0,0,66,66,0,1,0,1,0
16716,28,0,0,70,70,0,1,0,1,0
15850,28,0,0,70,70,0,1,0,1,0
14095,28,0,0,70,70,0,1,0,1,0
17470,28,0,0,70,70,0,1,0,1,0
10530,28,0,0,70,70,0,1,0,1,0
19050,28,0,0,70,70,0,1,0,1,0
17182,28,0,0,66,66,0,1,0,1,0
17288,28,0,0,70,70,0,1,0,1,0
9219,28,0,0,70,70,0,1,0,1,0
16140,28,0,0,66,66,0,1,0,1,0
11663,28,0,0,67,67,0,1,0,1,0
21037,28,0,0,69,69,0,1,0,1,0
16622,28,0,0,70,70,0,1,0,1,0
14073,28,0,0,70,70,0,1,0,1,0
16674,28,0,0,67,67,0,1,0,1,0
19598,28,0,0,66,66,0,1,0,1,0
12878,28,0,0,70,70,0,1,0,1,0
15080,28,0,0,66,66,0,1,0,1,0
11515,28,0,0,66,66,0,1,0,1,0
19787,28,0,0,70,70,0,1,0,1,0
16793,28,0,0,67,67,0,1,0,1,0
8686,28,0,0,70,70,0,1,0,1,0
19611,28,0,0,66,66,0,1,0,1,0
13921,28,0,0,70,70,0,1,0,1,0
9714,28,0,0,69,69,0,1,0,1,0
12872,28,0,0,66,66,0,1,0,1,0
8974,28,0,0,70,70,0,1,0,1,0
9619,28,0,0,70,70,0,1,0,1,0
16816,28,0,0,68,68,0,1,0,1,0
13736,28,0,0,70,70,0,1,0,1,0
10012,28,0,0,70,70,0,1,0,1,0
20402,28,0,0,70,70,0,1,0,1,0
22202,28,0,0,66,66,0,1,0,1,0
19823,28,0,0,70,70,0,1,0,1,0
13609,28,0,0,69,69,0,1,0,1,0
13675,28,0,0,70,70,0,1,0,1,0
16443,28,0,0,70,70,0,1,0,1,0
8876,28,0,0,70,70,0,1,0,1,0
17655,28,0,0,70,70,0,1,0,1,0
9901,28,0,0,66,66,0,1,0,1,0
12949,28,0,0,70,70,0,1,0,1,0
12471,28,0,0,66,66,0,1,0,1,0
16204,28,0,0,68,68,0,1,0,1,0
19101,28,0,0,70,70,0,1,0,1,0
19442,28,0,0,70,70,0,1,0,1,0
8466,28,0,0,70,70,0,1,0,1,0
16346,28,0,0,70,70,0,1,0,1,0
20556,28,0,0,67,67,0,1,0,1,0
20527,28,0,0,67,67,0,1,0,1,0
10295,28,0,0,66,66,0,1,0,1,0
13168,28,0,0,70,70,0,1,0,1,0
12643,28,0,0,70,70,0,1,0,1,0
9726,28,0,0,70,70,0,1,0,1,0
17131,28,0,0,70,70,0,1,0,1,0
20441,28,0,0,70,70,0,1,0,1,0
22716,28,0,0,70,70,0,1,0,1,0
22715,28,0,0,70,70,0,1,0,1,0
13174,28,0,0,66,66,0,1,0,1,0
14238,28,0,0,66,66,0,1,0,1,0
19999,28,0,0,70,70,0,1,0,1,0
10010,28,0,0,70,70,0,1,0,1,0
13473,28,0,0,70,70,0,1,0,1,0
11169,28,0,0,70,70,0,1,0,1,0
13469,28,0,0,70,70,0,1,0,1,0
17649,28,0,0,66,66,0,1,0,1,0
14093,28,0,0,70,70,0,1,0,1,0
19534,28,0,0,70,70,0,1,0,1,0
14135,28,0,0,70,70,0,1,0,1,0
10132,28,0,0,66,66,0,1,0,1,0
11504,28,0,0,70,70,0,1,0,1,0
21093,28,0,0,70,70,0,1,0,1,0
13193,28,0,0,70,70,0,1,0,1,0
12868,28,0,0,66,66,0,1,0,1,0
10456,28,0,0,70,70,0,1,0,1,0
12672,28,0,0,67,67,0,1,0,1,0
17720,28,0,0,70,70,0,1,0,1,0
12715,28,0,0,70,70,0,1,0,1,0
17940,28,0,0,70,70,0,1,0,1,0
19960,28,0,0,66,66,0,1,0,1,0
15364,28,0,0,66,66,0,1,0,1,0
11068,28,0,0,68,68,0,1,0,1,0
18559,28,0,0,70,70,0,1,0,1,0
20251,28,0,0,70,70,0,1,0,1,0
15096,28,0,0,70,70,0,1,0,1,0
20162,28,0,0,70,70,0,1,0,1,0
16736,28,0,0,70,70,0,1,0,1,0
18756,28,0,0,70,70,0,1,0,1,0
16248,28,0,0,70,70,0,1,0,1,0
22550,28,0,0,66,66,0,1,0,1,0
22151,28,0,0,68,68,0,1,0,1,0
22132,28,0,0,66,66,0,1,0,1,0
22429,28,0,0,67,67,0,1,0,1,0
18087,28,0,0,66,66,0,1,0,1,0
10481,28,0,0,70,70,0,1,0,1,0
10430,28,0,0,70,70,0,1,0,1,0
14580,28,0,0,70,70,0,1,0,1,0
20921,28,0,0,68,68,0,1,0,1,0
16265,28,0,0,70,70,0,1,0,1,0
21165,28,0,0,70,70,0,1,0,1,0
17781,28,0,0,67,67,0,1,0,1,0
9179,28,0,0,70,70,0,1,0,1,0
9804,28,0,0,66,66,0,1,0,1,0
9868,28,0,0,70,70,0,1,0,1,0
9829,28,0,0,70,70,0,1,0,1,0
21735,28,0,0,70,70,0,1,0,1,0
11556,28,0,0,70,70,0,1,0,1,0
11639,28,0,0,70,70,0,1,0,1,0
17743,28,0,0,66,66,0,1,0,1,0
22161,28,0,0,70,70,0,1,0,1,0
16595,28,0,0,70,70,0,1,0,1,0
9101,28,0,0,70,70,0,1,0,1,0
11764,28,0,0,70,70,0,1,0,1,0
11537,28,0,0,70,70,0,1,0,1,0
13878,28,0,0,70,70,0,1,0,1,0
15578,28,0,0,70,70,0,1,0,1,0
15062,28,0,0,70,70,0,1,0,1,0
17446,28,0,0,66,66,0,1,0,1,0
16835,28,0,0,70,70,0,1,0,1,0
15881,28,0,0,70,70,0,1,0,1,0
12876,28,0,0,70,70,0,1,0,1,0
12644,28,0,0,70,70,0,1,0,1,0
14272,28,0,0,70,70,0,1,0,1,0
10499,28,0,0,66,66,0,1,0,1,0
16762,28,0,0,70,70,0,1,0,1,0
15360,28,0,0,68,68,0,1,0,1,0
21912,28,0,0,69,69,0,1,0,1,0
12345,28,0,0,66,66,0,1,0,1,0
19045,28,0,0,70,70,0,1,0,1,0
11555,28,0,0,70,70,0,1,0,1,0
19781,28,0,0,70,70,0,1,0,1,0
12210,28,0,0,70,70,0,1,0,1,0
21075,28,0,0,66,66,0,1,0,1,0
19608,28,0,0,66,66,0,1,0,1,0
13967,28,0,0,70,70,0,1,0,1,0
13664,28,0,0,70,70,0,1,0,1,0
22196,28,0,0,70,70,0,1,0,1,0
17461,28,0,0,70,70,0,1,0,1,0
19055,28,0,0,66,66,0,1,0,1,0
10709,28,0,0,70,70,0,1,0,1,0
20340,28,0,0,70,70,0,1,0,1,0
21635,28,0,0,70,70,0,1,0,1,0
8660,28,0,0,66,66,0,1,0,1,0
21755,28,0,0,69,69,0,1,0,1,0
10444,28,0,0,66,66,0,1,0,1,0
16491,28,0,0,67,67,0,1,0,1,0
17158,28,0,0,70,70,0,1,0,1,0
17545,28,0,0,68,68,0,1,0,1,0
12152,28,0,0,70,70,0,1,0,1,0
17182,28,0,0,66,66,0,1,0,1,0
9881,28,0,0,68,68,0,1,0,1,0
10227,28,0,0,66,66,0,1,0,1,0
21457,28,0,0,70,70,0,1,0,1,0
11118,28,0,0,66,66,0,1,0,1,0
17351,28,0,0,70,70,0,1,0,1,0
16458,28,0,0,69,69,0,1,0,1,0
20997,28,0,0,70,70,0,1,0,1,0
14126,28,0,0,70,70,0,1,0,1,0
10552,28,0,0,66,66,0,1,0,1,0
22398,28,0,0,66,66,0,1,0,1,0
11122,28,0,0,70,70,0,1,0,1,0
9526,28,0,0,66,66,0,1,0,1,0
18774,28,0,0,66,66,0,1,0,1,0
12556,28,0,0,69,69,0,1,0,1,0
10396,28,0,0,70,70,0,1,0,1,0
19375,28,0,0,70,70,0,1,0,1,0
19946,28,0,0,70,70,0,1,0,1,0
20481,28,0,0,70,70,0,1,0,1,0
15923,28,0,0,70,70,0,1,0,1,0
21149,28,0,0,66,66,0,1,0,1,0
11194,28,0,0,69,69,0,1,0,1,0
20888,28,0,0,70,70,0,1,0,1,0
16152,28,0,0,66,66,0,1,0,1,0
13366,28,0,0,70,70,0,1,0,1,0
12029,28,0,0,66,66,0,1,0,1,0
11116,28,0,0,66,66,0,1,0,1,0
15746,28,0,0,69,69,0,1,0,1,0
10358,28,0,0,66,66,0,1,0,1,0
17207,28,0,0,70,70,0,1,0,1,0
14993,28,0,0,70,70,0,1,0,1,0
9516,28,0,0,66,66,0,1,0,1,0
16397,28,0,0,66,66,0,1,0,1,0
19851,28,0,0,66,66,0,1,0,1,0
21723,28,0,0,67,67,0,1,0,1,0
17556,28,0,0,70,70,0,1,0,1,0
9525,28,0,0,66,66,0,1,0,1,0
16334,28,0,0,70,70,0,1,0,1,0
22303,28,0,0,70,70,0,1,0,1,0
9747,28,0,0,70,70,0,1,0,1,0
11763,28,0,0,70,70,0,1,0,1,0
9673,28,0,0,70,70,0,1,0,1,0
10403,28,0,0,69,69,0,1,0,1,0
8973,28,0,0,70,70,0,1,0,1,0
21219,28,0,0,70,70,0,1,0,1,0
13968,28,0,0,70,70,0,1,0,1,0
12928,28,0,0,70,70,0,1,0,1,0
12495,28,0,0,67,67,0,1,0,1,0
18139,28,0,0,69,69,0,1,0,1,0
12641,28,0,0,70,70,0,1,0,1,0
22201,28,0,0,66,66,0,1,0,1,0
17751,28,0,0,67,67,0,1,0,1,0
21723,28,0,0,70,70,0,1,0,1,0
20805,28,0,0,70,70,0,1,0,1,0
17358,28,0,0,70,70,0,1,0,1,0
11864,28,0,0,70,70,0,1,0,1,0
21084,28,0,0,70,70,0,1,0,1,0
14343,28,0,0,70,70,0,1,0,1,0
17421,28,0,0,70,70,0,1,0,1,0
10222,28,0,0,66,66,0,1,0,1,0
11547,28,0,0,67,67,0,1,0,1,0
20833,28,0,0,67,67,0,1,0,1,0
16855,28,0,0,70,70,0,1,0,1,0
12675,28,0,0,66,66,0,1,0,1,0
17290,28,0,0,68,68,0,1,0,1,0
10969,28,0,0,67,67,0,1,0,1,0
17121,28,0,0,69,69,0,1,0,1,0
14147,28,0,0,70,70,0,1,0,1,0
18406,28,0,0,70,70,0,1,0,1,0
18240,28,0,0,66,66,0,1,0,1,0
16931,28,0,0,66,66,0,1,0,1,0
9689,28,0,0,70,70,0,1,0,1,0
16334,28,0,0,69,69,0,1,0,1,0
14459,28,0,0,70,70,0,1,0,1,0
21550,28,0,0,66,66,0,1,0,1,0
9777,28,0,0,70,70,0,1,0,1,0
20514,28,0,0,70,70,0,1,0,1,0
9576,28,0,0,70,70,0,1,0,1,0
16717,28,0,0,66,66,0,1,0,1,0
12181,28,0,0,66,66,0,1,0,1,0
10829,28,0,0,70,70,0,1,0,1,0
9722,28,0,0,70,70,0,1,0,1,0
19120,28,0,0,70,70,0,1,0,1,0
11686,28,0,0,70,70,0,1,0,1,0
10555,28,0,0,69,69,0,1,0,1,0
10363,28,0,0,70,70,0,1,0,1,0
14431,28,0,0,70,70,0,1,0,1,0
9434,28,0,0,66,66,0,1,0,1,0
12189,28,0,0,70,70,0,1,0,1,0
16695,28,0,0,66,66,0,1,0,1,0
14945,28,0,0,70,70,0,1,0,1,0
16167,28,0,0,70,70,0,1,0,1,0
13810,28,0,0,70,70,0,1,0,1,0
9764,28,0,0,70,70,0,1,0,1,0
16848,28,0,0,70,70,0,1,0,1,0
20256,28,0,0,70,70,0,1,0,1,0
10785,28,0,0,70,70,0,1,0,1,0
9956,28,0,0,68,68,0,1,0,1,0
17809,28,0,0,69,69,0,1,0,1,0
21142,28,0,0,70,70,0,1,0,1,0
19293,28,0,0,70,70,0,1,0,1,0
9322,28,0,0,70,70,0,1,0,1,0
17265,28,0,0,70,70,0,1,0,1,0
9235,28,0,0,70,70,0,1,0,1,0
12761,28,0,0,70,70,0,1,0,1,0
11543,28,0,0,70,70,0,1,0,1,0
21323,28,0,0,70,70,0,1,0,1,0
19054,28,0,0,66,66,0,1,0,1,0
14737,28,0,0,66,66,0,1,0,1,0
19635,28,0,0,67,67,0,1,0,1,0
10061,28,0,0,66,66,0,1,0,1,0
21711,28,0,0,66,66,0,1,0,1,0
13626,28,0,0,66,66,0,1,0,1,0
14903,28,0,0,66,66,0,1,0,1,0
21268,28,0,0,67,67,0,1,0,1,0
21444,28,0,0,70,70,0,1,0,1,0
16143,28,0,0,70,70,0,1,0,1,0
13727,28,0,0,70,70,0,1,0,1,0
13933,28,0,0,70,70,0,1,0,1,0
16508,28,0,0,66,66,0,1,0,1,0
9700,28,0,0,70,70,0,1,0,1,0
12880,28,0,0,70,70,0,1,0,1,0
12423,28,0,0,67,67,0,1,0,1,0
14261,28,0,0,70,70,0,1,0,1,0
17790,28,0,0,70,70,0,1,0,1,0
13581,28,0,0,70,70,0,1,0,1,0
10361,28,0,0,70,70,0,1,0,1,0
22286,28,0,0,70,70,0,1,0,1,0
14462,28,0,0,70,70,0,1,0,1,0
20550,28,0,0,67,67,0,1,0,1,0
14401,28,0,0,70,70,0,1,0,1,0
16597,28,0,0,70,70,0,1,0,1,0
16259,28,0,0,70,70,0,1,0,1,0
11629,28,0,0,70,70,0,1,0,1,0
12883,28,0,0,66,66,0,1,0,1,0
13977,28,0,0,70,70,0,1,0,1,0
18861,28,0,0,70,70,0,1,0,1,0
17648,28,0,0,66,66,0,1,0,1,0
10812,28,0,0,67,67,0,1,0,1,0
13249,28,0,0,70,70,0,1,0,1,0
13372,28,0,0,66,66,0,1,0,1,0
14674,28,0,0,70,70,0,1,0,1,0
22500,28,0,0,67,67,0,1,0,1,0
17333,28,0,0,68,68,0,1,0,1,0
9960,28,0,0,70,70,0,1,0,1,0
22398,28,0,0,66,66,0,1,0,1,0
13736,28,0,0,70,70,0,1,0,1,0
12740,28,0,0,67,67,0,1,0,1,0
9510,28,0,0,66,66,0,1,0,1,0
13544,28,0,0,70,70,0,1,0,1,0
10861,28,0,0,66,66,0,1,0,1,0
20557,28,0,0,70,70,0,1,0,1,0
17230,28,0,0,70,70,0,1,0,1,0
16764,28,0,0,70,70,0,1,0,1,0
10585,28,0,0,70,70,0,1,0,1,0
21494,28,0,0,66,66,0,1,0,1,0
9274,28,0,0,70,70,0,1,0,1,0
20821,28,0,0,70,70,0,1,0,1,0
10627,28,0,0,70,70,0,1,0,1,0
12891,28,0,0,70,70,0,1,0,1,0
13052,28,0,0,70,70,0,1,0,1,0
15421,28,0,0,70,70,0,1,0,1,0
22066,28,0,0,70,70,0,1,0,1,0
10129,28,0,0,70,70,0,1,0,1,0
11939,28,0,0,70,70,0,1,0,1,0
13229,28,0,0,66,66,0,1,0,1,0
18831,28,0,0,70,70,0,1,0,1,0
11554,28,0,0,70,70,0,1,0,1,0
10156,28,0,0,66,66,0,1,0,1,0
20716,28,0,0,70,70,0,1,0,1,0
19910,28,0,0,67,67,0,1,0,1,0
14194,28,0,0,70,70,0,1,0,1,0
16324,28,0,0,68,68,0,1,0,1,0
14748,28,0,0,68,68,0,1,0,1,0
19112,28,0,0,66,66,0,1,0,1,0
16365,28,0,0,66,66,0,1,0,1,0
20122,28,0,0,70,70,0,1,0,1,0
20870,28,0,0,70,70,0,1,0,1,0
9763,28,0,0,68,68,0,1,0,1,0
11719,28,0,0,70,70,0,1,0,1,0
13698,28,0,0,70,70,0,1,0,1,0
12989,28,0,0,70,70,0,1,0,1,0
10411,28,0,0,70,70,0,1,0,1,0
10551,28,0,0,69,69,0,1,0,1,0
18718,28,0,0,66,66,0,1,0,1,0
21739,28,0,0,67,67,0,1,0,1,0
12110,28,0,0,68,68,0,1,0,1,0
13677,28,0,0,70,70,0,1,0,1,0
9654,28,0,0,67,67,0,1,0,1,0
16330,28,0,0,69,69,0,1,0,1,0
10652,28,0,0,70,70,0,1,0,1,0
19537,28,0,0,70,70,0,1,0,1,0
13838,28,0,0,70,70,0,1,0,1,0
11487,28,0,0,70,70,0,1,0,1,0
22024,28,0,0,70,70,0,1,0,1,0
17942,28,0,0,70,70,0,1,0,1,0
12659,28,0,0,68,68,0,1,0,1,0
12205,28,0,0,66,66,0,1,0,1,0
21885,28,0,0,70,70,0,1,0,1,0
16877,28,0,0,70,70,0,1,0,1,0
14371,28,0,0,70,70,0,1,0,1,0
14725,28,0,0,66,66,0,1,0,1,0
20063,28,0,0,70,70,0,1,0,1,0
16339,28,0,0,70,70,0,1,0,1,0
16856,28,0,0,70,70,0,1,0,1,0
10474,28,0,0,70,70,0,1,0,1,0
8881,28,0,0,66,66,0,1,0,1,0
11084,28,0,0,70,70,0,1,0,1,0
12983,28,0,0,68,68,0,1,0,1,0
17709,28,0,0,66,66,0,1,0,1,0
16904,28,0,0,70,70,0,1,0,1,0
19854,28,0,0,70,70,0,1,0,1,0
12333,28,0,0,70,70,0,1,0,1,0
19047,28,0,0,70,70,0,1,0,1,0
16930,28,0,0,66,66,0,1,0,1,0
15459,28,0,0,67,67,0,1,0,1,0
8730,28,0,0,70,70,0,1,0,1,0
19284,28,0,0,66,66,0,1,0,1,0
11356,28,0,0,68,68,0,1,0,1,0
16900,28,0,0,70,70,0,1,0,1,0
10716,28,0,0,70,70,0,1,0,1,0
21583,28,0,0,70,70,0,1,0,1,0
17242,28,0,0,70,70,0,1,0,1,0
9579,28,0,0,66,66,0,1,0,1,0
20024,28,0,0,66,66,0,1,0,1,0
12125,28,0,0,66,66,0,1,0,1,0
12821,28,0,0,70,70,0,1,0,1,0
19330,28,0,0,70,70,0,1,0,1,0
18183,28,0,0,70,70,0,1,0,1,0
16409,28,0,0,70,70,0,1,0,1,0
17791,28,0,0,70,70,0,1,0,1,0
20046,28,0,0,67,67,0,1,0,1,0
19557,28,0,0,70,70,0,1,0,1,0
14134,28,0,0,70,70,0,1,0,1,0
18271,28,0,0,67,67,0,1,0,1,0
22610,28,0,0,70,70,0,1,0,1,0
20857,28,0,0,66,66,0,1,0,1,0
11777,28,0,0,70,70,0,1,0,1,0
17723,28,0,0,70,70,0,1,0,1,0
9806,28,0,0,66,66,0,1,0,1,0
16186,28,0,0,70,70,0,1,0,1,0
13399,28,0,0,69,69,0,1,0,1,0
18318,28,0,0,66,66,0,1,0,1,0
20739,28,0,0,66,66,0,1,0,1,0
19018,28,0,0,68,68,0,1,0,1,0
14648,28,0,0,67,67,0,1,0,1,0
14001,28,0,0,70,70,0,1,0,1,0
17637,28,0,0,66,66,0,1,0,1,0
11464,28,0,0,70,70,0,1,0,1,0
8674,28,0,0,70,70,0,1,0,1,0
14064,28,0,0,70,70,0,1,0,1,0
16690,28,0,0,70,70,0,1,0,1,0
10413,28,0,0,70,70,0,1,0,1,0
10293,28,0,0,66,66,0,1,0,1,0
21936,28,0,0,70,70,0,1,0,1,0
21184,28,0,0,70,70,0,1,0,1,0
10573,28,0,0,66,66,0,1,0,1,0
17973,28,0,0,70,70,0,1,0,1,0
22056,28,0,0,69,69,0,1,0,1,0
17499,28,0,0,66,66,0,1,0,1,0
9982,28,0,0,66,66,0,1,0,1,0
19750,28,0,0,70,70,0,1,0,1,0
20939,28,0,0,70,70,0,1,0,1,0
14543,28,0,0,66,66,0,1,0,1,0
16258,28,0,0,70,70,0,1,0,1,0
17428,28,0,0,66,66,0,1,0,1,0
11378,28,0,0,68,68,0,1,0,1,0
16109,28,0,0,70,70,0,1,0,1,0
12779,28,0,0,66,66,0,1,0,1,0
21109,28,0,0,70,70,0,1,0,1,0
10359,28,0,0,66,66,0,1,0,1,0
19320,28,0,0,70,70,0,1,0,1,0
11361,28,0,0,66,66,0,1,0,1,0
14943,28,0,0,70,70,0,1,0,1,0
14370,28,0,0,66,66,0,1,0,1,0
22518,28,0,0,70,70,0,1,0,1,0
17379,28,0,0,70,70,0,1,0,1,0
18380,28,0,0,69,69,0,1,0,1,0
9891,28,0,0,70,70,0,1,0,1,0
21128,28,0,0,70,70,0,1,0,1,0
18306,28,0,0,66,66,0,1,0,1,0
18652,28,0,0,70,70,0,1,0,1,0
22274,28,0,0,66,66,0,1,0,1,0
10537,28,0,0,70,70,0,1,0,1,0
15203,28,0,0,68,68,0,1,0,1,0
13805,28,0,0,66,66,0,1,0,1,0
20527,28,0,0,67,67,0,1,0,1,0
12368,28,0,0,67,67,0,1,0,1,0
9498,28,0,0,66,66,0,1,0,1,0
18231,28,0,0,66,66,0,1,0,1,0
19238,28,0,0,66,66,0,1,0,1,0
16280,28,0,0,66,66,0,1,0,1,0
11890,28,0,0,66,66,0,1,0,1,0
11399,28,0,0,70,70,0,1,0,1,0
21825,28,0,0,70,70,0,1,0,1,0
11719,28,0,0,66,66,0,1,0,1,0
17022,28,0,0,70,70,0,1,0,1,0
18767,28,0,0,70,70,0,1,0,1,0
16691,28,0,0,70,70,0,1,0,1,0
16797,28,0,0,68,68,0,1,0,1,0
19921,28,0,0,67,67,0,1,0,1,0
17233,28,0,0,70,70,0,1,0,1,0
16246,28,0,0,70,70,0,1,0,1,0
10839,28,0,0,70,70,0,1,0,1,0
22323,28,0,0,67,67,0,1,0,1,0
18180,28,0,0,70,70,0,1,0,1,0
19201,28,0,0,66,66,0,1,0,1,0
13699,28,0,0,70,70,0,1,0,1,0
9916,28,0,0,70,70,0,1,0,1,0
10078,28,0,0,70,70,0,1,0,1,0
16219,28,0,0,70,70,0,1,0,1,0
21594,28,0,0,66,66,0,1,0,1,0
16987,28,0,0,69,69,0,1,0,1,0
18505,28,0,0,70,70,0,1,0,1,0
11937,28,0,0,70,70,0,1,0,1,0
13921,28,0,0,70,70,0,1,0,1,0
19261,28,0,0,70,70,0,1,0,1,0
12967,28,0,0,68,68,0,1,0,1,0
21807,28,0,0,66,66,0,1,0,1,0
18593,28,0,0,70,70,0,1,0,1,0
13644,28,0,0,70,70,0,1,0,1,0
17610,28,0,0,68,68,0,1,0,1,0
17695,28,0,0,70,70,0,1,0,1,0
11669,28,0,0,70,70,0,1,0,1,0
9796,28,0,0,70,70,0,1,0,1,0
20745,28,0,0,68,68,0,1,0,1,0
17085,28,0,0,68,68,0,1,0,1,0
8770,28,0,0,70,70,0,1,0,1,0
18349,28,0,0,70,70,0,1,0,1,0
11891,28,0,0,66,66,0,1,0,1,0
22275,28,0,0,67,67,0,1,0,1,0
20479,28,0,0,68,68,0,1,0,1,0
12969,28,0,0,70,70,0,1,0,1,0
11115,28,0,0,66,66,0,1,0,1,0
19609,28,0,0,66,66,0,1,0,1,0
16901,28,0,0,66,66,0,1,0,1,0
16459,28,0,0,70,70,0,1,0,1,0
8723,28,0,0,70,70,0,1,0,1,0
12720,28,0,0,66,66,0,1,0,1,0
11777,28,0,0,70,70,0,1,0,1,0
22214,28,0,0,68,68,0,1,0,1,0
14174,28,0,0,70,70,0,1,0,1,0
10773,28,0,0,70,70,0,1,0,1,0
21113,28,0,0,70,70,0,1,0,1,0
19802,28,0,0,66,66,0,1,0,1,0
16865,28,0,0,70,70,0,1,0,1,0
18162,28,0,0,70,70,0,1,0,1,0
10198,28,0,0,70,70,0,1,0,1,0
9483,28,0,0,66,66,0,1,0,1,0
10513,28,0,0,66,66,0,1,0,1,0
21675,28,0,0,70,70,0,1,0,1,0
17133,28,0,0,69,69,0,1,0,1,0
10163,28,0,0,70,70,0,1,0,1,0
9368,28,0,0,70,70,0,1,0,1,0
9607,28,0,0,67,67,0,1,0,1,0
16715,28,0,0,66,66,0,1,0,1,0
17640,28,0,0,69,69,0,1,0,1,0
12415,28,0,0,68,68,0,1,0,1,0
9056,28,0,0,66,66,0,1,0,1,0
15459,28,0,0,68,68,0,1,0,1,0
11966,28,0,0,67,67,0,1,0,1,0
22023,28,0,0,70,70,0,1,0,1,0
19079,28,0,0,66,66,0,1,0,1,0
11705,28,0,0,66,66,0,1,0,1,0
10134,28,0,0,70,70,0,1,0,1,0
16041,28,0,0,70,70,0,1,0,1,0
16956,28,0,0,68,68,0,1,0,1,0
19425,28,0,0,66,66,0,1,0,1,0
12526,28,0,0,67,67,0,1,0,1,0
8589,28,0,0,70,70,0,1,0,1,0
20868,28,0,0,66,66,0,1,0,1,0
19834,28,0,0,66,66,0,1,0,1,0
8642,28,0,0,70,70,0,1,0,1,0
14724,28,0,0,66,66,0,1,0,1,0
20440,28,0,0,66,66,0,1,0,1,0
10799,28,0,0,66,66,0,1,0,1,0
8956,28,0,0,70,70,0,1,0,1,0
12951,28,0,0,66,66,0,1,0,1,0
8920,28,0,0,70,70,0,1,0,1,0
18664,28,0,0,69,69,0,1,0,1,0
22446,28,0,0,68,68,0,1,0,1,0
21093,28,0,0,66,66,0,1,0,1,0
12997,28,0,0,70,70,0,1,0,1,0
10909,28,0,0,70,70,0,1,0,1,0
19808,28,0,0,70,70,0,1,0,1,0
17329,28,0,0,70,70,0,1,0,1,0
9401,28,0,0,70,70,0,1,0,1,0
13257,28,0,0,70,70,0,1,0,1,0
15066,28,0,0,66,66,0,1,0,1,0
19098,28,0,0,69,69,0,1,0,1,0
17491,28,0,0,66,66,0,1,0,1,0
13211,28,0,0,70,70,0,1,0,1,0
12006,28,0,0,69,69,0,1,0,1,0
22551,28,0,0,70,70,0,1,0,1,0
15001,28,0,0,70,70,0,1,0,1,0
18894,28,0,0,70,70,0,1,0,1,0
13514,28,0,0,70,70,0,1,0,1,0
10027,28,0,0,70,70,0,1,0,1,0
13665,28,0,0,70,70,0,1,0,1,0
15645,28,0,0,66,66,0,1,0,1,0
12590,28,0,0,66,66,0,1,0,1,0
17702,28,0,0,66,66,0,1,0,1,0
11659,28,0,0,70,70,0,1,0,1,0
14991,28,0,0,70,70,0,1,0,1,0
22447,28,0,0,70,70,0,1,0,1,0
9068,28,0,0,70,70,0,1,0,1,0
21604,28,0,0,70,70,0,1,0,1,0
20473,28,0,0,70,70,0,1,0,1,0
15284,28,0,0,66,66,0,1,0,1,0
13175,28,0,0,66,66,0,1,0,1,0
11485,28,0,0,70,70,0,1,0,1,0
9758,28,0,0,70,70,0,1,0,1,0
18821,28,0,0,66,66,0,1,0,1,0
13740,28,0,0,66,66,0,1,0,1,0
22501,28,0,0,70,70,0,1,0,1,0
11322,28,0,0,66,66,0,1,0,1,0
15727,28,0,0,70,70,0,1,0,1,0
19357,28,0,0,68,68,0,1,0,1,0
11532,28,0,0,66,66,0,1,0,1,0
16172,28,0,0,70,70,0,1,0,1,0
19498,28,0,0,70,70,0,1,0,1,0
18683,28,0,0,66,66,0,1,0,1,0
15239,28,0,0,70,70,0,1,0,1,0
18419,28,0,0,66,66,0,1,0,1,0
20263,28,0,0,68,68,0,1,0,1,0
10871,28,0,0,70,70,0,1,0,1,0
13094,28,0,0,70,70,0,1,0,1,0
16760,28,0,0,66,66,0,1,0,1,0
15028,28,0,0,70,70,0,1,0,1,0
20040,28,0,0,70,70,0,1,0,1,0
9447,28,0,0,70,70,0,1,0,1,0
21998,28,0,0,70,70,0,1,0,1,0
21497,28,0,0,66,66,0,1,0,1,0
16280,28,0,0,66,66,0,1,0,1,0
10305,28,0,0,70,70,0,1,0,1,0
19236,28,0,0,68,68,0,1,0,1,0
20791,28,0,0,68,68,0,1,0,1,0
8944,28,0,0,66,66,0,1,0,1,0
15787,28,0,0,70,70,0,1,0,1,0
13053,28,0,0,70,70,0,1,0,1,0
18780,28,0,0,67,67,0,1,0,1,0
19926,28,0,0,70,70,0,1,0,1,0
19097,28,0,0,67,67,0,1,0,1,0
11803,28,0,0,70,70,0,1,0,1,0
20776,28,0,0,70,70,0,1,0,1,0
19355,28,0,0,66,66,0,1,0,1,0
20661,28,0,0,70,70,0,1,0,1,0
15365,28,0,0,70,70,0,1,0,1,0
11349,28,0,0,68,68,0,1,0,1,0
13717,28,0,0,69,69,0,1,0,1,0
14386,28,0,0,66,66,0,1,0,1,0
18674,28,0,0,66,66,0,1,0,1,0
11827,28,0,0,66,66,0,1,0,1,0
19925,28,0,0,70,70,0,1,0,1,0
9134,28,0,0,70,70,0,1,0,1,0
16738,28,0,0,70,70,0,1,0,1,0
11042,28,0,0,66,66,0,1,0,1,0
10861,28,0,0,66,66,0,1,0,1,0
18819,28,0,0,69,69,0,1,0,1,0
13416,28,0,0,70,70,0,1,0,1,0
22360,28,0,0,70,70,0,1,0,1,0
19970,28,0,0,70,70,0,1,0,1,0
10355,28,0,0,70,70,0,1,0,1,0
9052,28,0,0,70,70,0,1,0,1,0
19367,28,0,0,70,70,0,1,0,1,0
10589,28,0,0,70,70,0,1,0,1,0
22364,28,0,0,70,70,0,1,0,1,0
9409,28,0,0,70,70,0,1,0,1,0
21651,28,0,0,66,66,0,1,0,1,0
15973,28,0,0,69,69,0,1,0,1,0
9501,28,0,0,66,66,0,1,0,1,0
14900,28,0,0,70,70,0,1,0,1,0
10595,28,0,0,70,70,0,1,0,1,0
19414,28,0,0,70,70,0,1,0,1,0
15404,28,0,0,70,70,0,1,0,1,0
20296,28,0,0,70,70,0,1,0,1,0
10245,28,0,0,70,70,0,1,0,1,0
14591,28,0,0,70,70,0,1,0,1,0
16930,28,0,0,68,68,0,1,0,1,0
21813,28,0,0,69,69,0,1,0,1,0
13752,28,0,0,66,66,0,1,0,1,0
22401,28,0,0,66,66,0,1,0,1,0
8705,28,0,0,69,69,0,1,0,1,0
11084,28,0,0,70,70,0,1,0,1,0
13067,28,0,0,70,70,0,1,0,1,0
15644,28,0,0,66,66,0,1,0,1,0
17521,28,0,0,70,70,0,1,0,1,0
13602,28,0,0,70,70,0,1,0,1,0
10127,28,0,0,70,70,0,1,0,1,0
17676,28,0,0,70,70,0,1,0,1,0
8587,28,0,0,70,70,0,1,0,1,0
21456,28,0,0,66,66,0,1,0,1,0
9739,28,0,0,70,70,0,1,0,1,0
21612,28,0,0,68,68,0,1,0,1,0
18627,28,0,0,70,70,0,1,0,1,0
10675,28,0,0,66,66,0,1,0,1,0
22389,28,0,0,70,70,0,1,0,1,0
13055,28,0,0,66,66,0,1,0,1,0
11399,28,0,0,70,70,0,1,0,1,0
21785,28,0,0,68,68,0,1,0,1,0
8786,28,0,0,68,68,0,1,0,1,0
16941,28,0,0,66,66,0,1,0,1,0
16641,28,0,0,68,68,0,1,0,1,0
10158,28,0,0,70,70,0,1,0,1,0
16555,28,0,0,70,70,0,1,0,1,0
20457,28,0,0,66,66,0,1,0,1,0
16537,28,0,0,70,70,0,1,0,1,0
9496,28,0,0,66,66,0,1,0,1,0
22139,28,0,0,70,70,0,1,0,1,0
16138,28,0,0,66,66,0,1,0,1,0
9444,28,0,0,70,70,0,1,0,1,0
11778,28,0,0,70,70,0,1,0,1,0
13759,28,0,0,69,69,0,1,0,1,0
13271,28,0,0,70,70,0,1,0,1,0
16024,28,0,0,66,66,0,1,0,1,0
15184,28,0,0,66,66,0,1,0,1,0
8496,28,0,0,70,70,0,1,0,1,0
18829,28,0,0,70,70,0,1,0,1,0
16234,28,0,0,66,66,0,1,0,1,0
11567,28,0,0,70,70,0,1,0,1,0
20049,28,0,0,70,70,0,1,0,1,0
14841,28,0,0,66,66,0,1,0,1,0
20383,28,0,0,66,66,0,1,0,1,0
9840,28,0,0,70,70,0,1,0,1,0
16861,28,0,0,66,66,0,1,0,1,0
12772,28,0,0,69,69,0,1,0,1,0
12863,28,0,0,70,70,0,1,0,1,0
9668,28,0,0,70,70,0,1,0,1,0
21713,28,0,0,67,67,0,1,0,1,0
15303,28,0,0,70,70,0,1,0,1,0
14976,28,0,0,70,70,0,1,0,1,0
19134,28,0,0,66,66,0,1,0,1,0
22520,28,0,0,70,70,0,1,0,1,0
8536,28,0,0,68,68,0,1,0,1,0
8879,28,0,0,66,66,0,1,0,1,0
22585,28,0,0,67,67,0,1,0,1,0
13714,28,0,0,69,69,0,1,0,1,0
18060,28,0,0,70,70,0,1,0,1,0
20596,28,0,0,66,66,0,1,0,1,0
16653,28,0,0,66,66,0,1,0,1,0
13790,28,0,0,70,70,0,1,0,1,0
16097,28,0,0,70,70,0,1,0,1,0
21491,28,0,0,70,70,0,1,0,1,0
9965,28,0,0,66,66,0,1,0,1,0
13373,28,0,0,66,66,0,1,0,1,0
18699,28,0,0,66,66,0,1,0,1,0
11378,28,0,0,70,70,0,1,0,1,0
11440,28,0,0,70,70,0,1,0,1,0
17054,28,0,0,66,66,0,1,0,1,0
8607,28,0,0,66,66,0,1,0,1,0
9866,28,0,0,70,70,0,1,0,1,0
10841,28,0,0,70,70,0,1,0,1,0
19435,28,0,0,69,69,0,1,0,1,0
15109,28,0,0,66,66,0,1,0,1,0
12185,28,0,0,70,70,0,1,0,1,0
16621,28,0,0,70,70,0,1,0,1,0
10844,28,0,0,70,70,0,1,0,1,0
12656,28,0,0,66,66,0,1,0,1,0
9072,28,0,0,69,69,0,1,0,1,0
10502,28,0,0,66,66,0,1,0,1,0
19983,28,0,0,69,69,0,1,0,1,0
12959,28,0,0,70,70,0,1,0,1,0
19598,28,0,0,70,70,0,1,0,1,0
14953,28,0,0,66,66,0,1,0,1,0
19911,28,0,0,66,66,0,1,0,1,0
15538,28,0,0,70,70,0,1,0,1,0
20496,28,0,0,70,70,0,1,0,1,0
16597,28,0,0,66,66,0,1,0,1,0
18526,28,0,0,68,68,0,1,0,1,0
16815,28,0,0,70,70,0,1,0,1,0
19247,28,0,0,70,70,0,1,0,1,0
12780,28,0,0,67,67,0,1,0,1,0
12507,28,0,0,70,70,0,1,0,1,0
8539,28,0,0,70,70,0,1,0,1,0
20431,28,0,0,70,70,0,1,0,1,0
16325,28,0,0,67,67,0,1,0,1,0
14352,28,0,0,70,70,0,1,0,1,0
17952,28,0,0,66,66,0,1,0,1,0
11853,28,0,0,66,66,0,1,0,1,0
9855,28,0,0,70,70,0,1,0,1,0
15694,28,0,0,70,70,0,1,0,1,0
21768,28,0,0,70,70,0,1,0,1,0
22025,28,0,0,70,70,0,1,0,1,0
14219,28,0,0,70,70,0,1,0,1,0
16355,28,0,0,70,70,0,1,0,1,0
13669,28,0,0,66,66,0,1,0,1,0
8811,28,0,0,70,70,0,1,0,1,0
16932,28,0,0,67,67,0,1,0,1,0
10972,28,0,0,70,70,0,1,0,1,0
11862,28,0,0,70,70,0,1,0,1,0
14268,28,0,0,70,70,0,1,0,1,0
9888,28,0,0,70,70,0,1,0,1,0
19067,28,0,0,70,70,0,1,0,1,0
17280,28,0,0,67,67,0,1,0,1,0
17811,28,0,0,67,67,0,1,0,1,0
13472,28,0,0,66,66,0,1,0,1,0
19912,28,0,0,66,66,0,1,0,1,0
12896,28,0,0,70,70,0,1,0,1,0
19218,28,0,0,70,70,0,1,0,1,0
13593,28,0,0,70,70,0,1,0,1,0
11637,28,0,0,70,70,0,1,0,1,0
20955,28,0,0,70,70,0,1,0,1,0
11218,28,0,0,70,70,0,1,0,1,0
14089,28,0,0,68,68,0,1,0,1,0
17307,28,0,0,70,70,0,1,0,1,0
21490,28,0,0,66,66,0,1,0,1,0
19048,28,0,0,70,70,0,1,0,1,0
14711,28,0,0,67,67,0,1,0,1,0
15941,28,0,0,70,70,0,1,0,1,0
17793,28,0,0,70,70,0,1,0,1,0
8785,28,0,0,66,66,0,1,0,1,0
14576,28,0,0,70,70,0,1,0,1,0
17537,28,0,0,70,70,0,1,0,1,0
13845,28,0,0,70,70,0,1,0,1,0
21859,28,0,0,66,66,0,1,0,1,0
16800,28,0,0,66,66,0,1,0,1,0
13779,28,0,0,70,70,0,1,0,1,0
16361,28,0,0,66,66,0,1,0,1,0
17565,28,0,0,70,70,0,1,0,1,0
14056,28,0,0,66,66,0,1,0,1,0
19336,28,0,0,70,70,0,1,0,1,0
14825,28,0,0,70,70,0,1,0,1,0
10278,28,0,0,66,66,0,1,0,1,0
17591,28,0,0,70,70,0,1,0,1,0
15064,28,0,0,70,70,0,1,0,1,0
11310,28,0,0,66,66,0,1,0,1,0
16973,28,0,0,70,70,0,1,0,1,0
10200,28,0,0,66,66,0,1,0,1,0
16685,28,0,0,70,70,0,1,0,1,0
10191,28,0,0,66,66,0,1,0,1,0
17676,28,0,0,70,70,0,1,0,1,0
20626,28,0,0,67,67,0,1,0,1,0
17436,28,0,0,70,70,0,1,0,1,0
17472,28,0,0,70,70,0,1,0,1,0
8562,28,0,0,66,66,0,1,0,1,0
19658,28,0,0,70,70,0,1,0,1,0
9824,28,0,0,70,70,0,1,0,1,0
21357,28,0,0,70,70,0,1,0,1,0
10842,28,0,0,67,67,0,1,0,1,0
22153,28,0,0,70,70,0,1,0,1,0
13621,28,0,0,66,66,0,1,0,1,0
14353,28,0,0,66,66,0,1,0,1,0
22432,28,0,0,70,70,0,1,0,1,0
22094,28,0,0,66,66,0,1,0,1,0
9321,28,0,0,70,70,0,1,0,1,0
22132,28,0,0,66,66,0,1,0,1,0
14738,28,0,0,68,68,0,1,0,1,0
20778,28,0,0,66,66,0,1,0,1,0
14574,28,0,0,69,69,0,1,0,1,0
17163,28,0,0,69,69,0,1,0,1,0
12271,28,0,0,70,70,0,1,0,1,0
16697,28,0,0,66,66,0,1,0,1,0
22704,28,0,0,66,66,0,1,0,1,0
20331,28,0,0,66,66,0,1,0,1,0
20628,28,0,0,70,70,0,1,0,1,0
19179,28,0,0,70,70,0,1,0,1,0
14262,28,0,0,70,70,0,1,0,1,0
9548,28,0,0,70,70,0,1,0,1,0
19945,28,0,0,70,70,0,1,0,1,0
11469,28,0,0,70,70,0,1,0,1,0
14905,28,0,0,70,70,0,1,0,1,0
8674,28,0,0,66,66,0,1,0,1,0
19024,28,0,0,70,70,0,1,0,1,0
10413,28,0,0,70,70,0,1,0,1,0
9894,28,0,0,66,66,0,1,0,1,0
18771,28,0,0,66,66,0,1,0,1,0
20458,28,0,0,70,70,0,1,0,1,0
21294,28,0,0,69,69,0,1,0,1,0
10799,28,0,0,70,70,0,1,0,1,0
20846,28,0,0,70,70,0,1,0,1,0
9943,28,0,0,70,70,0,1,0,1,0
11444,28,0,0,66,66,0,1,0,1,0
13575,28,0,0,70,70,0,1,0,1,0
20781,28,0,0,66,66,0,1,0,1,0
19879,28,0,0,70,70,0,1,0,1,0
9183,28,0,0,70,70,0,1,0,1,0
18539,28,0,0,70,70,0,1,0,1,0
13469,28,0,0,70,70,0,1,0,1,0
19252,28,0,0,67,67,0,1,0,1,0
20717,28,0,0,70,70,0,1,0,1,0
9482,28,0,0,66,66,0,1,0,1,0
21462,28,0,0,70,70,0,1,0,1,0
10725,28,0,0,70,70,0,1,0,1,0
18142,28,0,0,70,70,0,1,0,1,0
12952,28,0,0,66,66,0,1,0,1,0
18696,28,0,0,70,70,0,1,0,1,0
15911,28,0,0,70,70,0,1,0,1,0
10177,28,0,0,66,66,0,1,0,1,0
8592,28,0,0,70,70,0,1,0,1,0
13685,28,0,0,70,70,0,1,0,1,0
16363,28,0,0,66,66,0,1,0,1,0
10028,28,0,0,70,70,0,1,0,1,0
21072,28,0,0,66,66,0,1,0,1,0
16210,28,0,0,70,70,0,1,0,1,0
22666,28,0,0,66,66,0,1,0,1,0
12234,28,0,0,70,70,0,1,0,1,0
10787,28,0,0,70,70,0,1,0,1,0
22403,28,0,0,68,68,0,1,0,1,0
19128,28,0,0,70,70,0,1,0,1,0
13812,28,0,0,70,70,0,1,0,1,0
18204,28,0,0,69,69,0,1,0,1,0
9318,28,0,0,70,70,0,1,0,1,0
16018,28,0,0,70,70,0,1,0,1,0
9371,28,0,0,70,70,0,1,0,1,0
12408,28,0,0,70,70,0,1,0,1,0
8700,28,0,0,70,70,0,1,0,1,0
11216,28,0,0,70,70,0,1,0,1,0
12410,28,0,0,66,66,0,1,0,1,0
11674,28,0,0,70,70,0,1,0,1,0
18662,28,0,0,70,70,0,1,0,1,0
20495,28,0,0,70,70,0,1,0,1,0
17702,28,0,0,69,69,0,1,0,1,0
12884,28,0,0,66,66,0,1,0,1,0
20068,28,0,0,66,66,0,1,0,1,0
15537,28,0,0,70,70,0,1,0,1,0
20877,28,0,0,67,67,0,1,0,1,0
17978,28,0,0,70,70,0,1,0,1,0
21649,28,0,0,66,66,0,1,0,1,0
12887,28,0,0,66,66,0,1,0,1,0
13435,28,0,0,70,70,0,1,0,1,0
20903,28,0,0,70,70,0,1,0,1,0
15460,28,0,0,66,66,0,1,0,1,0
11882,28,0,0,70,70,0,1,0,1,0
17642,28,0,0,66,66,0,1,0,1,0
9197,28,0,0,70,70,0,1,0,1,0
13486,28,0,0,70,70,0,1,0,1,0
21550,28,0,0,66,66,0,1,0,1,0
19722,28,0,0,70,70,0,1,0,1,0
9322,28,0,0,70,70,0,1,0,1,0
18166,28,0,0,66,66,0,1,0,1,0
16139,28,0,0,70,70,0,1,0,1,0
17086,28,0,0,70,70,0,1,0,1,0
13582,28,0,0,70,70,0,1,0,1,0
13916,28,0,0,70,70,0,1,0,1,0
20290,28,0,0,66,66,0,1,0,1,0
14581,28,0,0,66,66,0,1,0,1,0
18187,28,0,0,70,70,0,1,0,1,0
20471,28,0,0,66,66,0,1,0,1,0
14971,28,0,0,66,66,0,1,0,1,0
16588,28,0,0,70,70,0,1,0,1,0
15281,28,0,0,68,68,0,1,0,1,0
21421,28,0,0,70,70,0,1,0,1,0
15658,28,0,0,66,66,0,1,0,1,0
10943,28,0,0,66,66,0,1,0,1,0
20151,28,0,0,69,69,0,1,0,1,0
19080,28,0,0,70,70,0,1,0,1,0
10951,28,0,0,70,70,0,1,0,1,0
11537,28,0,0,70,70,0,1,0,1,0
13096,28,0,0,70,70,0,1,0,1,0
14496,28,0,0,70,70,0,1,0,1,0
21901,28,0,0,70,70,0,1,0,1,0
18280,28,0,0,70,70,0,1,0,1,0
16512,28,0,0,66,66,0,1,0,1,0
9046,28,0,0,70,70,0,1,0,1,0
9134,28,0,0,66,66,0,1,0,1,0
17386,28,0,0,70,70,0,1,0,1,0
14846,28,0,0,68,68,0,1,0,1,0
20872,28,0,0,66,66,0,1,0,1,0
17948,28,0,0,66,66,0,1,0,1,0
15573,28,0,0,70,70,0,1,0,1,0
10713,28,0,0,70,70,0,1,0,1,0
15836,28,0,0,70,70,0,1,0,1,0
8998,28,0,0,70,70,0,1,0,1,0
16147,28,0,0,70,70,0,1,0,1,0
10058,28,0,0,66,66,0,1,0,1,0
9274,28,0,0,68,68,0,1,0,1,0
10674,28,0,0,66,66,0,1,0,1,0
9572,28,0,0,70,70,0,1,0,1,0
17182,28,0,0,66,66,0,1,0,1,0
16705,28,0,0,69,69,0,1,0,1,0
21711,28,0,0,68,68,0,1,0,1,0
17458,28,0,0,66,66,0,1,0,1,0
18405,28,0,0,67,67,0,1,0,1,0
14057,28,0,0,66,66,0,1,0,1,0
17078,28,0,0,70,70,0,1,0,1,0
10656,28,0,0,70,70,0,1,0,1,0
20462,28,0,0,70,70,0,1,0,1,0
15881,28,0,0,70,70,0,1,0,1,0
16210,28,0,0,70,70,0,1,0,1,0
9694,28,0,0,70,70,0,1,0,1,0
12669,28,0,0,69,69,0,1,0,1,0
12498,28,0,0,69,69,0,1,0,1,0
12947,28,0,0,70,70,0,1,0,1,0
16358,28,0,0,70,70,0,1,0,1,0
20658,28,0,0,70,70,0,1,0,1,0
15153,28,0,0,68,68,0,1,0,1,0
12438,28,0,0,70,70,0,1,0,1,0
10686,28,0,0,66,66,0,1,0,1,0
14589,28,0,0,69,69,0,1,0,1,0
17114,28,0,0,69,69,0,1,0,1,0
11893,28,0,0,70,70,0,1,0,1,0
10527,28,0,0,68,68,0,1,0,1,0
12469,28,0,0,66,66,0,1,0,1,0
21202,28,0,0,70,70,0,1,0,1,0
22612,28,0,0,69,69,0,1,0,1,0
11348,28,0,0,68,68,0,1,0,1,0
8724,28,0,0,70,70,0,1,0,1,0
19367,28,0,0,70,70,0,1,0,1,0
17794,28,0,0,66,66,0,1,0,1,0
15814,28,0,0,66,66,0,1,0,1,0
17353,28,0,0,66,66,0,1,0,1,0
17852,28,0,0,70,70,0,1,0,1,0
14087,28,0,0,70,70,0,1,0,1,0
9907,28,0,0,70,70,0,1,0,1,0
9763,28,0,0,66,66,0,1,0,1,0
12769,28,0,0,66,66,0,1,0,1,0
16060,28,0,0,70,70,0,1,0,1,0
18802,28,0,0,70,70,0,1,0,1,0
10240,28,0,0,66,66,0,1,0,1,0
21361,28,0,0,66,66,0,1,0,1,0
12647,28,0,0,66,66,0,1,0,1,0
19117,28,0,0,70,70,0,1,0,1,0
12514,28,0,0,70,70,0,1,0,1,0
18460,28,0,0,70,70,0,1,0,1,0
13793,28,0,0,66,66,0,1,0,1,0
14840,28,0,0,66,66,0,1,0,1,0
20215,28,0,0,70,70,0,1,0,1,0
13429,28,0,0,66,66,0,1,0,1,0
18937,28,0,0,70,70,0,1,0,1,0
22259,28,0,0,67,67,0,1,0,1,0
20904,28,0,0,70,70,0,1,0,1,0
16651,28,0,0,66,66,0,1,0,1,0
19086,28,0,0,68,68,0,1,0,1,0
10284,28,0,0,70,70,0,1,0,1,0
12758,28,0,0,70,70,0,1,0,1,0
8827,28,0,0,70,70,0,1,0,1,0
20444,28,0,0,70,70,0,1,0,1,0
9973,28,0,0,70,70,0,1,0,1,0
21820,28,0,0,70,70,0,1,0,1,0
18754,28,0,0,70,70,0,1,0,1,0
13689,28,0,0,66,66,0,1,0,1,0
9463,28,0,0,70,70,0,1,0,1,0
13379,28,0,0,69,69,0,1,0,1,0
20576,28,0,0,70,70,0,1,0,1,0
20737,28,0,0,70,70,0,1,0,1,0
11514,28,0,0,70,70,0,1,0,1,0
16198,28,0,0,70,70,0,1,0,1,0
16595,28,0,0,70,70,0,1,0,1,0
17920,28,0,0,69,69,0,1,0,1,0
20087,28,0,0,70,70,0,1,0,1,0
18481,28,0,0,69,69,0,1,0,1,0
11828,28,0,0,70,70,0,1,0,1,0
16408,28,0,0,66,66,0,1,0,1,0
20724,28,0,0,66,66,0,1,0,1,0
18844,28,0,0,70,70,0,1,0,1,0
9319,28,0,0,70,70,0,1,0,1,0
16219,28,0,0,70,70,0,1,0,1,0
13997,28,0,0,70,70,0,1,0,1,0
11650,28,0,0,66,66,0,1,0,1,0
12035,28,0,0,70,70,0,1,0,1,0
14455,28,0,0,70,70,0,1,0,1,0
17324,28,0,0,70,70,0,1,0,1,0
10168,28,0,0,70,70,0,1,0,1,0
18730,28,0,0,70,70,0,1,0,1,0
9608,28,0,0,70,70,0,1,0,1,0
13125,28,0,0,66,66,0,1,0,1,0
20972,28,0,0,70,70,0,1,0,1,0
17877,28,0,0,70,70,0,1,0,1,0
8663,28,0,0,70,70,0,1,0,1,0
11827,28,0,0,66,66,0,1,0,1,0
22546,28,0,0,68,68,0,1,0,1,0
19881,28,0,0,70,70,0,1,0,1,0
19179,28,0,0,70,70,0,1,0,1,0
9627,28,0,0,66,66,0,1,0,1,0
16815,28,0,0,66,66,0,1,0,1,0
9921,28,0,0,66,66,0,1,0,1,0
12345,28,0,0,66,66,0,1,0,1,0
22580,28,0,0,66,66,0,1,0,1,0
21568,28,0,0,70,70,0,1,0,1,0
18907,28,0,0,66,66,0,1,0,1,0
13527,28,0,0,70,70,0,1,0,1,0
17936,28,0,0,70,70,0,1,0,1,0
10213,28,0,0,70,70,0,1,0,1,0
20649,28,0,0,66,66,0,1,0,1,0
14588,28,0,0,70,70,0,1,0,1,0
18868,28,0,0,70,70,0,1,0,1,0
9748,28,0,0,70,70,0,1,0,1,0
20243,28,0,0,70,70,0,1,0,1,0
11535,28,0,0,70,70,0,1,0,1,0
13970,28,0,0,70,70,0,1,0,1,0
10375,28,0,0,70,70,0,1,0,1,0
16093,28,0,0,66,66,0,1,0,1,0
8875,28,0,0,70,70,0,1,0,1,0
9908,28,0,0,70,70,0,1,0,1,0
14858,28,0,0,70,70,0,1,0,1,0
8432,28,0,0,68,68,0,1,0,1,0
9212,28,0,0,70,70,0,1,0,1,0
20143,28,0,0,70,70,0,1,0,1,0
20185,28,0,0,69,69,0,1,0,1,0
18355,28,0,0,68,68,0,1,0,1,0
9540,28,0,0,70,70,0,1,0,1,0
18760,28,0,0,66,66,0,1,0,1,0
21862,28,0,0,70,70,0,1,0,1,0
11194,28,0,0,69,69,0,1,0,1,0
20210,28,0,0,70,70,0,1,0,1,0
13367,28,0,0,70,70,0,1,0,1,0
21955,28,0,0,66,66,0,1,0,1,0
12102,28,0,0,70,70,0,1,0,1,0
22704,28,0,0,69,69,0,1,0,1,0
14256,28,0,0,66,66,0,1,0,1,0
17407,28,0,0,66,66,0,1,0,1,0
9290,28,0,0,70,70,0,1,0,1,0
9391,28,0,0,67,67,0,1,0,1,0
18934,28,0,0,66,66,0,1,0,1,0
9919,28,0,0,70,70,0,1,0,1,0
17412,28,0,0,66,66,0,1,0,1,0
13685,28,0,0,70,70,0,1,0,1,0
20762,28,0,0,70,70,0,1,0,1,0
9950,28,0,0,70,70,0,1,0,1,0
16008,28,0,0,70,70,0,1,0,1,0
16195,28,0,0,66,66,0,1,0,1,0
22079,28,0,0,70,70,0,1,0,1,0
17039,28,0,0,68,68,0,1,0,1,0
17878,28,0,0,67,67,0,1,0,1,0
18342,28,0,0,70,70,0,1,0,1,0
10410,28,0,0,70,70,0,1,0,1,0
21638,28,0,0,70,70,0,1,0,1,0
9959,28,0,0,70,70,0,1,0,1,0
13767,28,0,0,68,68,0,1,0,1,0
20489,28,0,0,69,69,0,1,0,1,0
9702,28,0,0,70,70,0,1,0,1,0
20938,28,0,0,66,66,0,1,0,1,0
10120,28,0,0,70,70,0,1,0,1,0
13706,28,0,0,70,70,0,1,0,1,0
16715,28,0,0,66,66,0,1,0,1,0
11631,28,0,0,70,70,0,1,0,1,0
14580,28,0,0,70,70,0,1,0,1,0
13031,28,0,0,70,70,0,1,0,1,0
11533,28,0,0,68,68,0,1,0,1,0
13051,28,0,0,70,70,0,1,0,1,0
17078,28,0,0,70,70,0,1,0,1,0
10837,28,0,0,70,70,0,1,0,1,0
16638,28,0,0,70,70,0,1,0,1,0
15064,28,0,0,70,70,0,1,0,1,0
21695,28,0,0,70,70,0,1,0,1,0
16467,28,0,0,69,69,0,1,0,1,0
13765,28,0,0,66,66,0,1,0,1,0
13156,28,0,0,66,66,0,1,0,1,0
17116,28,0,0,70,70,0,1,0,1,0
20608,28,0,0,70,70,0,1,0,1,0
8471,28,0,0,70,70,0,1,0,1,0
11583,28,0,0,68,68,0,1,0,1,0
16855,28,0,0,70,70,0,1,0,1,0
20236,28,0,0,70,70,0,1,0,1,0
8944,28,0,0,69,69,0,1,0,1,0
21882,28,0,0,66,66,0,1,0,1,0
10738,28,0,0,70,70,0,1,0,1,0
21821,28,0,0,70,70,0,1,0,1,0
10373,28,0,0,70,70,0,1,0,1,0
17854,28,0,0,70,70,0,1,0,1,0
20127,28,0,0,70,70,0,1,0,1,0
21497,28,0,0,69,69,0,1,0,1,0
14259,28,0,0,70,70,0,1,0,1,0
11764,28,0,0,70,70,0,1,0,1,0
19314,28,0,0,66,66,0,1,0,1,0
8979,28,0,0,70,70,0,1,0,1,0
19337,28,0,0,67,67,0,1,0,1,0
20320,28,0,0,70,70,0,1,0,1,0
14713,28,0,0,69,69,0,1,0,1,0
15862,28,0,0,66,66,0,1,0,1,0
19941,28,0,0,70,70,0,1,0,1,0
19903,28,0,0,70,70,0,1,0,1,0
22499,28,0,0,66,66,0,1,0,1,0
10888,28,0,0,66,66,0,1,0,1,0
16083,28,0,0,67,67,0,1,0,1,0
14866,28,0,0,70,70,0,1,0,1,0
9315,28,0,0,70,70,0,1,0,1,0
13116,28,0,0,67,67,0,1,0,1,0
13183,28,0,0,67,67,0,1,0,1,0
9272,28,0,0,70,70,0,1,0,1,0
18877,28,0,0,66,66,0,1,0,1,0
9630,28,0,0,70,70,0,1,0,1,0
19676,28,0,0,70,70,0,1,0,1,0
12680,28,0,0,66,66,0,1,0,1,0
21457,28,0,0,66,66,0,1,0,1,0
16443,28,0,0,66,66,0,1,0,1,0
17541,28,0,0,70,70,0,1,0,1,0
13995,28,0,0,70,70,0,1,0,1,0
10712,28,0,0,70,70,0,1,0,1,0
13512,28,0,0,70,70,0,1,0,1,0
9069,28,0,0,70,70,0,1,0,1,0
12155,28,0,0,70,70,0,1,0,1,0
12268,28,0,0,68,68,0,1,0,1,0
10415,28,0,0,70,70,0,1,0,1,0
9879,28,0,0,70,70,0,1,0,1,0
17751,28,0,0,69,69,0,1,0,1,0
10294,28,0,0,66,66,0,1,0,1,0
10371,28,0,0,69,69,0,1,0,1,0
8616,28,0,0,70,70,0,1,0,1,0
22565,28,0,0,68,68,0,1,0,1,0
17447,28,0,0,66,66,0,1,0,1,0
12526,28,0,0,66,66,0,1,0,1,0
20339,28,0,0,70,70,0,1,0,1,0
18465,28,0,0,70,70,0,1,0,1,0
13651,28,0,0,70,70,0,1,0,1,0
13328,28,0,0,70,70,0,1,0,1,0
9626,28,0,0,70,70,0,1,0,1,0
21723,28,0,0,70,70,0,1,0,1,0
11880,28,0,0,70,70,0,1,0,1,0
18888,28,0,0,66,66,0,1,0,1,0
10073,28,0,0,70,70,0,1,0,1,0
14160,28,0,0,67,67,0,1,0,1,0
21186,28,0,0,66,66,0,1,0,1,0
9972,28,0,0,70,70,0,1,0,1,0
10976,28,0,0,70,70,0,1,0,1,0
9502,28,0,0,70,70,0,1,0,1,0
10440,28,0,0,70,70,0,1,0,1,0
20362,28,0,0,70,70,0,1,0,1,0
9090,28,0,0,69,69,0,1,0,1,0
11381,28,0,0,70,70,0,1,0,1,0
17162,28,0,0,70,70,0,1,0,1,0
16800,28,0,0,70,70,0,1,0,1,0
21160,28,0,0,70,70,0,1,0,1,0
22580,28,0,0,67,67,0,1,0,1,0
14825,28,0,0,70,70,0,1,0,1,0
18044,28,0,0,69,69,0,1,0,1,0
19388,28,0,0,70,70,0,1,0,1,0
10990,28,0,0,66,66,0,1,0,1,0
10855,28,0,0,69,69,0,1,0,1,0
16509,28,0,0,70,70,0,1,0,1,0
21029,28,0,0,66,66,0,1,0,1,0
18181,28,0,0,70,70,0,1,0,1,0
10933,28,0,0,69,69,0,1,0,1,0
19956,28,0,0,70,70,0,1,0,1,0
20166,28,0,0,70,70,0,1,0,1,0
17328,28,0,0,70,70,0,1,0,1,0
17656,28,0,0,67,67,0,1,0,1,0
19498,28,0,0,66,66,0,1,0,1,0
13485,28,0,0,66,66,0,1,0,1,0
17349,28,0,0,70,70,0,1,0,1,0
20953,28,0,0,70,70,0,1,0,1,0
17308,28,0,0,70,70,0,1,0,1,0
9298,28,0,0,70,70,0,1,0,1,0
14802,28,0,0,66,66,0,1,0,1,0
14371,28,0,0,70,70,0,1,0,1,0
10220,28,0,0,70,70,0,1,0,1,0
19669,28,0,0,70,70,0,1,0,1,0
20028,28,0,0,69,69,0,1,0,1,0
14647,28,0,0,68,68,0,1,0,1,0
10869,28,0,0,70,70,0,1,0,1,0
20921,28,0,0,66,66,0,1,0,1,0
13441,28,0,0,66,66,0,1,0,1,0
14401,28,0,0,70,70,0,1,0,1,0
19802,28,0,0,70,70,0,1,0,1,0
21119,28,0,0,67,67,0,1,0,1,0
14320,28,0,0,70,70,0,1,0,1,0
22101,28,0,0,70,70,0,1,0,1,0
8556,28,0,0,68,68,0,1,0,1,0
11102,28,0,0,70,70,0,1,0,1,0
13609,28,0,0,68,68,0,1,0,1,0
14104,28,0,0,70,70,0,1,0,1,0
15128,28,0,0,70,70,0,1,0,1,0
18834,28,0,0,66,66,0,1,0,1,0
20955,28,0,0,69,69,0,1,0,1,0
19003,28,0,0,70,70,0,1,0,1,0
19925,28,0,0,70,70,0,1,0,1,0
17393,28,0,0,66,66,0,1,0,1,0
15774,28,0,0,66,66,0,1,0,1,0
16113,28,0,0,70,70,0,1,0,1,0
17599,28,0,0,70,70,0,1,0,1,0
20728,28,0,0,67,67,0,1,0,1,0
20185,28,0,0,70,70,0,1,0,1,0
20022,28,0,0,66,66,0,1,0,1,0
19192,28,0,0,66,66,0,1,0,1,0
21161,28,0,0,70,70,0,1,0,1,0
15028,28,0,0,70,70,0,1,0,1,0
14430,28,0,0,66,66,0,1,0,1,0
19163,28,0,0,70,70,0,1,0,1,0
15428,28,0,0,70,70,0,1,0,1,0
15964,28,0,0,68,68,0,1,0,1,0
20376,28,0,0,66,66,0,1,0,1,0
9469,28,0,0,66,66,0,1,0,1,0
15465,28,0,0,66,66,0,1,0,1,0
17150,28,0,0,70,70,0,1,0,1,0
19880,28,0,0,70,70,0,1,0,1,0
20257,28,0,0,69,69,0,1,0,1,0
9826,28,0,0,70,70,0,1,0,1,0
21283,28,0,0,70,70,0,1,0,1,0
20941,28,0,0,70,70,0,1,0,1,0
8689,28,0,0,66,66,0,1,0,1,0
17654,28,0,0,68,68,0,1,0,1,0
16505,28,0,0,68,68,0,1,0,1,0
17399,28,0,0,66,66,0,1,0,1,0
9938,28,0,0,66,66,0,1,0,1,0
22388,28,0,0,70,70,0,1,0,1,0
13618,28,0,0,66,66,0,1,0,1,0
14225,28,0,0,70,70,0,1,0,1,0
12975,28,0,0,67,67,0,1,0,1,0
11245,28,0,0,66,66,0,1,0,1,0
11799,28,0,0,70,70,0,1,0,1,0
19736,28,0,0,70,70,0,1,0,1,0
9821,28,0,0,70,70,0,1,0,1,0
17408,28,0,0,66,66,0,1,0,1,0
16612,28,0,0,70,70,0,1,0,1,0
11604,28,0,0,70,70,0,1,0,1,0
21674,28,0,0,70,70,0,1,0,1,0
21340,28,0,0,66,66,0,1,0,1,0
19915,28,0,0,70,70,0,1,0,1,0
20854,28,0,0,70,70,0,1,0,1,0
12404,28,0,0,70,70,0,1,0,1,0
13287,28,0,0,70,70,0,1,0,1,0
8454,28,0,0,67,67,0,1,0,1,0
19163,28,0,0,66,66,0,1,0,1,0
21436,28,0,0,66,66,0,1,0,1,0
17192,28,0,0,70,70,0,1,0,1,0
14262,28,0,0,67,67,0,1,0,1,0
10498,28,0,0,66,66,0,1,0,1,0
17829,28,0,0,70,70,0,1,0,1,0
21676,28,0,0,70,70,0,1,0,1,0
8916,28,0,0,66,66,0,1,0,1,0
8627,28,0,0,69,69,0,1,0,1,0
20099,28,0,0,70,70,0,1,0,1,0
17482,28,0,0,70,70,0,1,0,1,0
18719,28,0,0,66,66,0,1,0,1,0
13071,28,0,0,66,66,0,1,0,1,0
11504,28,0,0,66,66,0,1,0,1,0
15662,28,0,0,66,66,0,1,0,1,0
17737,28,0,0,70,70,0,1,0,1,0
10278,28,0,0,70,70,0,1,0,1,0
16553,28,0,0,66,66,0,1,0,1,0
14270,28,0,0,70,70,0,1,0,1,0
11357,28,0,0,66,66,0,1,0,1,0
8490,28,0,0,70,70,0,1,0,1,0
8939,28,0,0,69,69,0,1,0,1,0
13355,28,0,0,70,70,0,1,0,1,0
12455,28,0,0,70,70,0,1,0,1,0
15835,28,0,0,66,66,0,1,0,1,0
10289,28,0,0,70,70,0,1,0,1,0
11554,28,0,0,70,70,0,1,0,1,0
14699,28,0,0,70,70,0,1,0,1,0
13053,28,0,0,70,70,0,1,0,1,0
21887,28,0,0,66,66,0,1,0,1,0
15777,28,0,0,66,66,0,1,0,1,0
11721,28,0,0,66,66,0,1,0,1,0
20478,28,0,0,66,66,0,1,0,1,0
14780,28,0,0,66,66,0,1,0,1,0
14657,28,0,0,70,70,0,1,0,1,0
11405,28,0,0,70,70,0,1,0,1,0
19839,28,0,0,70,70,0,1,0,1,0
10759,28,0,0,70,70,0,1,0,1,0
21097,28,0,0,68,68,0,1,0,1,0
18150,28,0,0,70,70,0,1,0,1,0
19780,28,0,0,69,69,0,1,0,1,0
22211,28,0,0,70,70,0,1,0,1,0
22583,28,0,0,66,66,0,1,0,1,0
15954,28,0,0,69,69,0,1,0,1,0
16496,28,0,0,69,69,0,1,0,1,0
19598,28,0,0,66,66,0,1,0,1,0
10240,28,0,0,66,66,0,1,0,1,0
20231,28,0,0,70,70,0,1,0,1,0
15878,28,0,0,70,70,0,1,0,1,0
8921,28,0,0,70,70,0,1,0,1,0
10311,28,0,0,70,70,0,1,0,1,0
17852,28,0,0,67,67,0,1,0,1,0
15357,28,0,0,66,66,0,1,0,1,0
14563,28,0,0,70,70,0,1,0,1,0
17773,28,0,0,70,70,0,1,0,1,0
13225,28,0,0,66,66,0,1,0,1,0
22451,28,0,0,69,69,0,1,0,1,0
19243,28,0,0,66,66,0,1,0,1,0
9724,28,0,0,70,70,0,1,0,1,0
13866,28,0,0,70,70,0,1,0,1,0
16893,28,0,0,70,70,0,1,0,1,0
20205,28,0,0,69,69,0,1,0,1,0
15715,28,0,0,66,66,0,1,0,1,0
11720,28,0,0,70,70,0,1,0,1,0
20927,28,0,0,70,70,0,1,0,1,0
20157,28,0,0,70,70,0,1,0,1,0
18771,28,0,0,68,68,0,1,0,1,0
15147,28,0,0,70,70,0,1,0,1,0
22267,28,0,0,70,70,0,1,0,1,0
20401,28,0,0,66,66,0,1,0,1,0
13560,28,0,0,70,70,0,1,0,1,0
22275,28,0,0,66,66,0,1,0,1,0
17246,28,0,0,68,68,0,1,0,1,0
18318,28,0,0,70,70,0,1,0,1,0
14631,28,0,0,70,70,0,1,0,1,0
13850,28,0,0,70,70,0,1,0,1,0
12010,28,0,0,70,70,0,1,0,1,0
14172,28,0,0,68,68,0,1,0,1,0
18399,28,0,0,70,70,0,1,0,1,0
20169,28,0,0,70,70,0,1,0,1,0
20700,28,0,0,70,70,0,1,0,1,0
21852,28,0,0,68,68,0,1,0,1,0
12789,28,0,0,66,66,0,1,0,1,0
10731,28,0,0,66,66,0,1,0,1,0
16638,28,0,0,70,70,0,1,0,1,0
15885,28,0,0,70,70,0,1,0,1,0
16814,28,0,0,70,70,0,1,0,1,0
20322,28,0,0,70,70,0,1,0,1,0
21723,28,0,0,70,70,0,1,0,1,0
12826,28,0,0,70,70,0,1,0,1,0
18399,28,0,0,70,70,0,1,0,1,0
10573,28,0,0,66,66,0,1,0,1,0
10971,28,0,0,70,70,0,1,0,1,0
16110,28,0,0,70,70,0,1,0,1,0
19696,28,0,0,70,70,0,1,0,1,0
10818,28,0,0,70,70,0,1,0,1,0
13541,28,0,0,70,70,0,1,0,1,0
10375,28,0,0,70,70,0,1,0,1,0
9674,28,0,0,70,70,0,1,0,1,0
10453,28,0,0,70,70,0,1,0,1,0
16035,28,0,0,70,70,0,1,0,1,0
14288,28,0,0,67,67,0,1,0,1,0
9981,28,0,0,66,66,0,1,0,1,0
11592,28,0,0,70,70,0,1,0,1,0
11041,28,0,0,69,69,0,1,0,1,0
12609,28,0,0,69,69,0,1,0,1,0
13998,28,0,0,70,70,0,1,0,1,0
9160,28,0,0,70,70,0,1,0,1,0
18533,28,0,0,70,70,0,1,0,1,0
20017,28,0,0,67,67,0,1,0,1,0
21787,28,0,0,70,70,0,1,0,1,0
13527,28,0,0,66,66,0,1,0,1,0
16767,28,0,0,70,70,0,1,0,1,0
9863,28,0,0,66,66,0,1,0,1,0
11397,28,0,0,66,66,0,1,0,1,0
14342,28,0,0,70,70,0,1,0,1,0
12700,28,0,0,70,70,0,1,0,1,0
10635,28,0,0,70,70,0,1,0,1,0
13276,28,0,0,70,70,0,1,0,1,0
11563,28,0,0,66,66,0,1,0,1,0
13117,28,0,0,70,70,0,1,0,1,0
13399,28,0,0,66,66,0,1,0,1,0
9851,28,0,0,70,70,0,1,0,1,0
8480,28,0,0,67,67,0,1,0,1,0
18070,28,0,0,66,66,0,1,0,1,0
10137,28,0,0,70,70,0,1,0,1,0
20964,28,0,0,70,70,0,1,0,1,0
9562,28,0,0,66,66,0,1,0,1,0
17516,28,0,0,70,70,0,1,0,1,0
15312,28,0,0,70,70,0,1,0,1,0
9202,28,0,0,70,70,0,1,0,1,0
10492,28,0,0,70,70,0,1,0,1,0
20396,28,0,0,70,70,0,1,0,1,0
20997,28,0,0,70,70,0,1,0,1,0
17876,28,0,0,70,70,0,1,0,1,0
20336,28,0,0,70,70,0,1,0,1,0
16444,28,0,0,66,66,0,1,0,1,0
8404,28,0,0,70,70,0,1,0,1,0
12948,28,0,0,70,70,0,1,0,1,0
21874,28,0,0,70,70,0,1,0,1,0
16220,28,0,0,70,70,0,1,0,1,0
12750,28,0,0,67,67,0,1,0,1,0
11763,28,0,0,70,70,0,1,0,1,0
10626,28,0,0,70,70,0,1,0,1,0
13550,28,0,0,70,70,0,1,0,1,0
16611,28,0,0,70,70,0,1,0,1,0
11404,28,0,0,66,66,0,1,0,1,0
8656,28,0,0,70,70,0,1,0,1,0
9444,28,0,0,70,70,0,1,0,1,0
19162,28,0,0,66,66,0,1,0,1,0
16233,28,0,0,69,69,0,1,0,1,0
11526,28,0,0,68,68,0,1,0,1,0
11927,28,0,0,70,70,0,1,0,1,0
20366,28,0,0,70,70,0,1,0,1,0
13374,28,0,0,66,66,0,1,0,1,0
16901,28,0,0,66,66,0,1,0,1,0
20374,28,0,0,68,68,0,1,0,1,0
13267,28,0,0,70,70,0,1,0,1,0
8505,28,0,0,70,70,0,1,0,1,0
21845,28,0,0,66,66,0,1,0,1,0
18497,28,0,0,67,67,0,1,0,1,0
18974,28,0,0,69,69,0,1,0,1,0
8856,28,0,0,68,68,0,1,0,1,0
18483,28,0,0,70,70,0,1,0,1,0
14080,28,0,0,70,70,0,1,0,1,0
18344,28,0,0,70,70,0,1,0,1,0
9957,28,0,0,69,69,0,1,0,1,0
13713,28,0,0,70,70,0,1,0,1,0
19100,28,0,0,70,70,0,1,0,1,0
21472,28,0,0,70,70,0,1,0,1,0
19952,28,0,0,70,70,0,1,0,1,0
18859,28,0,0,70,70,0,1,0,1,0
10472,28,0,0,70,70,0,1,0,1,0
11726,28,0,0,66,66,0,1,0,1,0
9134,28,0,0,70,70,0,1,0,1,0
11283,28,0,0,70,70,0,1,0,1,0
20081,28,0,0,68,68,0,1,0,1,0
11373,28,0,0,66,66,0,1,0,1,0
15652,28,0,0,70,70,0,1,0,1,0
21899,28,0,0,70,70,0,1,0,1,0
9956,28,0,0,70,70,0,1,0,1,0
12778,28,0,0,66,66,0,1,0,1,0
14296,28,0,0,70,70,0,1,0,1,0
10098,28,0,0,70,70,0,1,0,1,0
12694,28,0,0,70,70,0,1,0,1,0
9212,28,0,0,66,66,0,1,0,1,0
20068,28,0,0,66,66,0,1,0,1,0
20207,28,0,0,67,67,0,1,0,1,0
14271,28,0,0,70,70,0,1,0,1,0
15452,28,0,0,70,70,0,1,0,1,0
18112,28,0,0,70,70,0,1,0,1,0
13636,28,0,0,70,70,0,1,0,1,0
14713,28,0,0,70,70,0,1,0,1,0
19006,28,0,0,70,70,0,1,0,1,0
13932,28,0,0,70,70,0,1,0,1,0
10727,28,0,0,67,67,0,1,0,1,0
18069,28,0,0,66,66,0,1,0,1,0
17747,28,0,0,70,70,0,1,0,1,0
18889,28,0,0,66,66,0,1,0,1,0
11125,28,0,0,70,70,0,1,0,1,0
9067,28,0,0,66,66,0,1,0,1,0
13531,28,0,0,70,70,0,1,0,1,0
15762,28,0,0,66,66,0,1,0,1,0
17107,28,0,0,70,70,0,1,0,1,0
21713,28,0,0,66,66,0,1,0,1,0
17779,28,0,0,69,69,0,1,0,1,0
11529,28,0,0,70,70,0,1,0,1,0
14644,28,0,0,70,70,0,1,0,1,0
15792,28,0,0,70,70,0,1,0,1,0
8470,28,0,0,70,70,0,1,0,1,0
12126,28,0,0,66,66,0,1,0,1,0
18940,28,0,0,70,70,0,1,0,1,0
13344,28,0,0,67,67,0,1,0,1,0
15140,28,0,0,67,67,0,1,0,1,0
9064,28,0,0,70,70,0,1,0,1,0
16450,28,0,0,66,66,0,1,0,1,0
21534,28,0,0,66,66,0,1,0,1,0
9431,28,0,0,66,66,0,1,0,1,0
13958,28,0,0,70,70,0,1,0,1,0
11993,28,0,0,70,70,0,1,0,1,0
11045,28,0,0,70,70,0,1,0,1,0
10857,28,0,0,66,66,0,1,0,1,0
13338,28,0,0,70,70,0,1,0,1,0
14237,28,0,0,66,66,0,1,0,1,0
9411,28,0,0,70,70,0,1,0,1,0
11863,28,0,0,70,70,0,1,0,1,0
17446,28,0,0,70,70,0,1,0,1,0
21736,28,0,0,66,66,0,1,0,1,0
20081,28,0,0,70,70,0,1,0,1,0
17709,28,0,0,70,70,0,1,0,1,0
19531,28,0,0,70,70,0,1,0,1,0
13668,28,0,0,67,67,0,1,0,1,0
15115,28,0,0,70,70,0,1,0,1,0
17759,28,0,0,70,70,0,1,0,1,0
14188,28,0,0,70,70,0,1,0,1,0
20146,28,0,0,70,70,0,1,0,1,0
14750,28,0,0,70,70,0,1,0,1,0
20583,28,0,0,70,70,0,1,0,1,0
11583,28,0,0,70,70,0,1,0,1,0
16961,28,0,0,69,69,0,1,0,1,0
12996,28,0,0,70,70,0,1,0,1,0
16385,28,0,0,68,68,0,1,0,1,0
13979,28,0,0,70,70,0,1,0,1,0
8523,28,0,0,66,66,0,1,0,1,0
18473,28,0,0,70,70,0,1,0,1,0
12305,28,0,0,70,70,0,1,0,1,0
12354,28,0,0,70,70,0,1,0,1,0
11114,28,0,0,66,66,0,1,0,1,0
9214,28,0,0,68,68,0,1,0,1,0
19477,28,0,0,70,70,0,1,0,1,0
20653,28,0,0,70,70,0,1,0,1,0
11778,28,0,0,70,70,0,1,0,1,0
20401,28,0,0,66,66,0,1,0,1,0
20777,28,0,0,67,67,0,1,0,1,0
13428,28,0,0,70,70,0,1,0,1,0
11584,28,0,0,70,70,0,1,0,1,0
10330,28,0,0,68,68,0,1,0,1,0
18648,28,0,0,70,70,0,1,0,1,0
15615,28,0,0,66,66,0,1,0,1,0
10537,28,0,0,70,70,0,1,0,1,0
12817,28,0,0,70,70,0,1,0,1,0
11779,28,0,0,70,70,0,1,0,1,0
21858,28,0,0,70,70,0,1,0,1,0
10386,28,0,0,70,70,0,1,0,1,0
9956,28,0,0,66,66,0,1,0,1,0
10410,28,0,0,70,70,0,1,0,1,0
10016,28,0,0,66,66,0,1,0,1,0
22583,28,0,0,70,70,0,1,0,1,0
11641,28,0,0,70,70,0,1,0,1,0
17124,28,0,0,68,68,0,1,0,1,0
17394,28,0,0,67,67,0,1,0,1,0
9880,28,0,0,66,66,0,1,0,1,0
16209,28,0,0,70,70,0,1,0,1,0
18632,28,0,0,68,68,0,1,0,1,0
21624,28,0,0,69,69,0,1,0,1,0
15127,28,0,0,70,70,0,1,0,1,0
9112,28,0,0,70,70,0,1,0,1,0
20070,28,0,0,70,70,0,1,0,1,0
10816,28,0,0,70,70,0,1,0,1,0
11233,28,0,0,68,68,0,1,0,1,0
21708,28,0,0,66,66,0,1,0,1,0
22317,28,0,0,70,70,0,1,0,1,0
19983,28,0,0,66,66,0,1,0,1,0
22343,28,0,0,66,66,0,1,0,1,0
9919,28,0,0,70,70,0,1,0,1,0
9230,28,0,0,70,70,0,1,0,1,0
20732,28,0,0,67,67,0,1,0,1,0
19413,28,0,0,70,70,0,1,0,1,0
21145,28,0,0,70,70,0,1,0,1,0
15235,28,0,0,67,67,0,1,0,1,0
10868,28,0,0,70,70,0,1,0,1,0
20002,28,0,0,70,70,0,1,0,1,0
10866,28,0,0,70,70,0,1,0,1,0
11677,28,0,0,66,66,0,1,0,1,0
15610,28,0,0,70,70,0,1,0,1,0
16093,28,0,0,68,68,0,1,0,1,0
14755,28,0,0,70,70,0,1,0,1,0
20028,28,0,0,70,70,0,1,0,1,0
16356,28,0,0,70,70,0,1,0,1,0
14926,28,0,0,67,67,0,1,0,1,0
17192,28,0,0,70,70,0,1,0,1,0
22450,28,0,0,70,70,0,1,0,1,0
9457,28,0,0,66,66,0,1,0,1,0
17722,28,0,0,70,70,0,1,0,1,0
17334,28,0,0,70,70,0,1,0,1,0
10170,28,0,0,66,66,0,1,0,1,0
21084,28,0,0,70,70,0,1,0,1,0
13792,28,0,0,66,66,0,1,0,1,0
17056,28,0,0,67,67,0,1,0,1,0
14172,28,0,0,68,68,0,1,0,1,0
19836,28,0,0,70,70,0,1,0,1,0
20657,28,0,0,66,66,0,1,0,1,0
14211,28,0,0,70,70,0,1,0,1,0
12433,28,0,0,70,70,0,1,0,1,0
15215,28,0,0,70,70,0,1,0,1,0
18851,28,0,0,70,70,0,1,0,1,0
11364,28,0,0,70,70,0,1,0,1,0
21571,28,0,0,67,67,0,1,0,1,0
14238,28,0,0,66,66,0,1,0,1,0
21300,28,0,0,70,70,0,1,0,1,0
9891,28,0,0,68,68,0,1,0,1,0
16726,28,0,0,70,70,0,1,0,1,0
17788,28,0,0,70,70,0,1,0,1,0
16756,28,0,0,66,66,0,1,0,1,0
19292,28,0,0,70,70,0,1,0,1,0
21661,28,0,0,70,70,0,1,0,1,0
18754,28,0,0,70,70,0,1,0,1,0
16696,28,0,0,70,70,0,1,0,1,0
19752,28,0,0,68,68,0,1,0,1,0
10417,28,0,0,70,70,0,1,0,1,0
22316,28,0,0,69,69,0,1,0,1,0
13770,28,0,0,70,70,0,1,0,1,0
10363,28,0,0,70,70,0,1,0,1,0
9860,28,0,0,66,66,0,1,0,1,0
10746,28,0,0,70,70,0,1,0,1,0
17594,28,0,0,66,66,0,1,0,1,0
12642,28,0,0,67,67,0,1,0,1,0
17616,28,0,0,66,66,0,1,0,1,0
16945,28,0,0,70,70,0,1,0,1,0
20972,28,0,0,70,70,0,1,0,1,0
15973,28,0,0,66,66,0,1,0,1,0
12969,28,0,0,66,66,0,1,0,1,0
22578,28,0,0,68,68,0,1,0,1,0
20628,28,0,0,70,70,0,1,0,1,0
13868,28,0,0,66,66,0,1,0,1,0
19821,28,0,0,70,70,0,1,0,1,0
21365,28,0,0,70,70,0,1,0,1,0
18071,28,0,0,67,67,0,1,0,1,0
20869,28,0,0,70,70,0,1,0,1,0
20210,28,0,0,70,70,0,1,0,1,0
11106,28,0,0,70,70,0,1,0,1,0
22519,28,0,0,70,70,0,1,0,1,0
16584,28,0,0,70,70,0,1,0,1,0
12724,28,0,0,67,67,0,1,0,1,0
20021,28,0,0,69,69,0,1,0,1,0
8742,28,0,0,70,70,0,1,0,1,0
18587,28,0,0,70,70,0,1,0,1,0
12979,28,0,0,68,68,0,1,0,1,0
9214,28,0,0,70,70,0,1,0,1,0
10431,28,0,0,70,70,0,1,0,1,0
12684,28,0,0,69,69,0,1,0,1,0
18630,28,0,0,70,70,0,1,0,1,0
21972,28,0,0,66,66,0,1,0,1,0
12442,28,0,0,70,70,0,1,0,1,0
18320,28,0,0,66,66,0,1,0,1,0
20720,28,0,0,70,70,0,1,0,1,0
21661,28,0,0,70,70,0,1,0,1,0
21332,28,0,0,70,70,0,1,0,1,0
9265,28,0,0,70,70,0,1,0,1,0
12718,28,0,0,66,66,0,1,0,1,0
13417,28,0,0,69,69,0,1,0,1,0
11646,28,0,0,67,67,0,1,0,1,0
17543,28,0,0,66,66,0,1,0,1,0
19785,28,0,0,70,70,0,1,0,1,0
13542,28,0,0,70,70,0,1,0,1,0
13735,28,0,0,70,70,0,1,0,1,0
9706,28,0,0,66,66,0,1,0,1,0
8593,28,0,0,70,70,0,1,0,1,0
11690,28,0,0,70,70,0,1,0,1,0
16293,28,0,0,68,68,0,1,0,1,0
19361,28,0,0,68,68,0,1,0,1,0
18878,28,0,0,70,70,0,1,0,1,0
18803,28,0,0,70,70,0,1,0,1,0
16697,28,0,0,70,70,0,1,0,1,0
8948,28,0,0,70,70,0,1,0,1,0
22495,28,0,0,67,67,0,1,0,1,0
15285,28,0,0,66,66,0,1,0,1,0
9323,28,0,0,70,70,0,1,0,1,0
13876,28,0,0,70,70,0,1,0,1,0
15532,28,0,0,70,70,0,1,0,1,0
21548,28,0,0,67,67,0,1,0,1,0
16361,28,0,0,70,70,0,1,0,1,0
11540,28,0,0,70,70,0,1,0,1,0
11891,28,0,0,68,68,0,1,0,1,0
19679,28,0,0,70,70,0,1,0,1,0
13972,28,0,0,70,70,0,1,0,1,0
15231,28,0,0,66,66,0,1,0,1,0
19703,28,0,0,70,70,0,1,0,1,0
15355,28,0,0,66,66,0,1,0,1,0
18257,28,0,0,66,66,0,1,0,1,0
12899,28,0,0,70,70,0,1,0,1,0
22713,28,0,0,70,70,0,1,0,1,0
14122,28,0,0,70,70,0,1,0,1,0
18576,28,0,0,70,70,0,1,0,1,0
17403,28,0,0,70,70,0,1,0,1,0
22556,28,0,0,70,70,0,1,0,1,0
13438,28,0,0,66,66,0,1,0,1,0
11193,28,0,0,69,69,0,1,0,1,0
14811,28,0,0,70,70,0,1,0,1,0
13368,28,0,0,70,70,0,1,0,1,0
9561,28,0,0,66,66,0,1,0,1,0
22429,28,0,0,67,67,0,1,0,1,0
19607,28,0,0,66,66,0,1,0,1,0
10574,28,0,0,69,69,0,1,0,1,0
18899,28,0,0,66,66,0,1,0,1,0
9138,28,0,0,69,69,0,1,0,1,0
11169,28,0,0,66,66,0,1,0,1,0
19557,28,0,0,68,68,0,1,0,1,0
17381,28,0,0,70,70,0,1,0,1,0
21036,28,0,0,70,70,0,1,0,1,0
13449,28,0,0,70,70,0,1,0,1,0
12858,28,0,0,70,70,0,1,0,1,0
18894,28,0,0,70,70,0,1,0,1,0
14300,28,0,0,67,67,0,1,0,1,0
21222,28,0,0,70,70,0,1,0,1,0
12004,28,0,0,66,66,0,1,0,1,0
20827,28,0,0,66,66,0,1,0,1,0
9626,28,0,0,66,66,0,1,0,1,0
21624,28,0,0,66,66,0,1,0,1,0
17707,28,0,0,67,67,0,1,0,1,0
20126,28,0,0,70,70,0,1,0,1,0
8466,28,0,0,70,70,0,1,0,1,0
16637,28,0,0,70,70,0,1,0,1,0
15588,28,0,0,66,66,0,1,0,1,0
16686,28,0,0,70,70,0,1,0,1,0
8949,28,0,0,70,70,0,1,0,1,0
16204,28,0,0,70,70,0,1,0,1,0
12580,28,0,0,70,70,0,1,0,1,0
21207,28,0,0,67,67,0,1,0,1,0
9419,28,0,0,66,66,0,1,0,1,0
13151,28,0,0,70,70,0,1,0,1,0
12483,28,0,0,70,70,0,1,0,1,0
14482,28,0,0,66,66,0,1,0,1,0
13828,28,0,0,70,70,0,1,0,1,0
19397,28,0,0,70,70,0,1,0,1,0
20268,28,0,0,70,70,0,1,0,1,0
16690,28,0,0,70,70,0,1,0,1,0
18054,28,0,0,70,70,0,1,0,1,0
17139,28,0,0,70,70,0,1,0,1,0
13438,28,0,0,70,70,0,1,0,1,0
16927,28,0,0,70,70,0,1,0,1,0
10173,28,0,0,66,66,0,1,0,1,0
8879,28,0,0,66,66,0,1,0,1,0
20679,28,0,0,66,66,0,1,0,1,0
13641,28,0,0,66,66,0,1,0,1,0
13819,28,0,0,70,70,0,1,0,1,0
10435,28,0,0,66,66,0,1,0,1,0
13584,28,0,0,70,70,0,1,0,1,0
22399,28,0,0,69,69,0,1,0,1,0
14173,28,0,0,66,66,0,1,0,1,0
13566,28,0,0,68,68,0,1,0,1,0
14579,28,0,0,70,70,0,1,0,1,0
15805,28,0,0,69,69,0,1,0,1,0
15023,28,0,0,70,70,0,1,0,1,0
16386,28,0,0,66,66,0,1,0,1,0
15409,28,0,0,66,66,0,1,0,1,0
16201,28,0,0,70,70,0,1,0,1,0
10477,28,0,0,70,70,0,1,0,1,0
22469,28,0,0,67,67,0,1,0,1,0
12884,28,0,0,70,70,0,1,0,1,0
11250,28,0,0,70,70,0,1,0,1,0
9958,28,0,0,66,66,0,1,0,1,0
12271,28,0,0,70,70,0,1,0,1,0
11857,28,0,0,70,70,0,1,0,1,0
21793,28,0,0,70,70,0,1,0,1,0
14355,28,0,0,69,69,0,1,0,1,0
18985,28,0,0,68,68,0,1,0,1,0
9836,28,0,0,66,66,0,1,0,1,0
16826,28,0,0,68,68,0,1,0,1,0
10894,28,0,0,70,70,0,1,0,1,0
14362,28,0,0,69,69,0,1,0,1,0
20312,28,0,0,66,66,0,1,0,1,0
21235,28,0,0,66,66,0,1,0,1,0
18719,28,0,0,66,66,0,1,0,1,0
13888,28,0,0,70,70,0,1,0,1,0
12950,28,0,0,66,66,0,1,0,1,0
16514,28,0,0,66,66,0,1,0,1,0
17064,28,0,0,70,70,0,1,0,1,0
14335,28,0,0,70,70,0,1,0,1,0
9465,28,0,0,70,70,0,1,0,1,0
9699,28,0,0,70,70,0,1,0,1,0
16209,28,0,0,70,70,0,1,0,1,0
22026,28,0,0,68,68,0,1,0,1,0
17533,28,0,0,70,70,0,1,0,1,0
14783,28,0,0,66,66,0,1,0,1,0
20525,28,0,0,70,70,0,1,0,1,0
10715,28,0,0,66,66,0,1,0,1,0
16508,28,0,0,66,66,0,1,0,1,0
9171,28,0,0,70,70,0,1,0,1,0
12849,28,0,0,70,70,0,1,0,1,0
13250,28,0,0,70,70,0,1,0,1,0
20114,28,0,0,66,66,0,1,0,1,0
12969,28,0,0,66,66,0,1,0,1,0
16783,28,0,0,66,66,0,1,0,1,0
14079,28,0,0,70,70,0,1,0,1,0
9706,28,0,0,66,66,0,1,0,1,0
16611,28,0,0,70,70,0,1,0,1,0
9436,28,0,0,70,70,0,1,0,1,0
13573,28,0,0,70,70,0,1,0,1,0
19154,28,0,0,70,70,0,1,0,1,0
11777,28,0,0,70,70,0,1,0,1,0
16815,28,0,0,66,66,0,1,0,1,0
10783,28,0,0,70,70,0,1,0,1,0
11769,28,0,0,67,67,0,1,0,1,0
9760,28,0,0,70,70,0,1,0,1,0
21472,28,0,0,70,70,0,1,0,1,0
18835,28,0,0,66,66,0,1,0,1,0
10063,28,0,0,66,66,0,1,0,1,0
16768,28,0,0,70,70,0,1,0,1,0
14095,28,0,0,70,70,0,1,0,1,0
15017,28,0,0,68,68,0,1,0,1,0
12909,28,0,0,66,66,0,1,0,1,0
13274,28,0,0,70,70,0,1,0,1,0
11994,28,0,0,70,70,0,1,0,1,0
11337,28,0,0,70,70,0,1,0,1,0
13433,28,0,0,66,66,0,1,0,1,0
10018,28,0,0,68,68,0,1,0,1,0
17519,28,0,0,70,70,0,1,0,1,0
19578,28,0,0,67,67,0,1,0,1,0
19895,28,0,0,70,70,0,1,0,1,0
8947,28,0,0,70,70,0,1,0,1,0
17489,28,0,0,70,70,0,1,0,1,0
9903,28,0,0,70,70,0,1,0,1,0
12417,28,0,0,70,70,0,1,0,1,0
15552,28,0,0,67,67,0,1,0,1,0
18735,28,0,0,67,67,0,1,0,1,0
9589,28,0,0,70,70,0,1,0,1,0
14672,28,0,0,70,70,0,1,0,1,0
10178,28,0,0,67,67,0,1,0,1,0
13164,28,0,0,70,70,0,1,0,1,0
17796,28,0,0,66,66,0,1,0,1,0
19735,28,0,0,66,66,0,1,0,1,0
8818,28,0,0,69,69,0,1,0,1,0
21860,28,0,0,66,66,0,1,0,1,0
19826,28,0,0,70,70,0,1,0,1,0
12486,28,0,0,70,70,0,1,0,1,0
17692,28,0,0,70,70,0,1,0,1,0
12945,28,0,0,70,70,0,1,0,1,0
15284,28,0,0,66,66,0,1,0,1,0
9588,28,0,0,70,70,0,1,0,1,0
9660,28,0,0,70,70,0,1,0,1,0
22084,28,0,0,68,68,0,1,0,1,0
17780,28,0,0,68,68,0,1,0,1,0
10107,28,0,0,66,66,0,1,0,1,0
17539,28,0,0,66,66,0,1,0,1,0
21536,28,0,0,68,68,0,1,0,1,0
9087,28,0,0,70,70,0,1,0,1,0
17852,28,0,0,70,70,0,1,0,1,0
16195,28,0,0,70,70,0,1,0,1,0
12408,28,0,0,70,70,0,1,0,1,0
21489,28,0,0,70,70,0,1,0,1,0
13698,28,0,0,70,70,0,1,0,1,0
19802,28,0,0,66,66,0,1,0,1,0
20057,28,0,0,67,67,0,1,0,1,0
10320,28,0,0,70,70,0,1,0,1,0
9118,28,0,0,66,66,0,1,0,1,0
11253,28,0,0,70,70,0,1,0,1,0
13179,28,0,0,70,70,0,1,0,1,0
11429,28,0,0,70,70,0,1,0,1,0
13687,28,0,0,66,66,0,1,0,1,0
21226,28,0,0,69,69,0,1,0,1,0
16160,28,0,0,66,66,0,1,0,1,0
13178,28,0,0,70,70,0,1,0,1,0
16041,28,0,0,70,70,0,1,0,1,0
22276,28,0,0,70,70,0,1,0,1,0
17161,28,0,0,70,70,0,1,0,1,0
12249,28,0,0,69,69,0,1,0,1,0
14746,28,0,0,69,69,0,1,0,1,0
8559,28,0,0,70,70,0,1,0,1,0
21970,28,0,0,67,67,0,1,0,1,0
14989,28,0,0,70,70,0,1,0,1,0
19911,28,0,0,66,66,0,1,0,1,0
21138,28,0,0,70,70,0,1,0,1,0
20342,28,0,0,70,70,0,1,0,1,0
15065,28,0,0,70,70,0,1,0,1,0
19456,28,0,0,70,70,0,1,0,1,0
17718,28,0,0,68,68,0,1,0,1,0
13744,28,0,0,66,66,0,1,0,1,0
11217,28,0,0,70,70,0,1,0,1,0
19594,28,0,0,69,69,0,1,0,1,0
16350,28,0,0,70,70,0,1,0,1,0
19649,28,0,0,70,70,0,1,0,1,0
21377,28,0,0,69,69,0,1,0,1,0
14045,28,0,0,70,70,0,1,0,1,0
12027,28,0,0,66,66,0,1,0,1,0
22278,28,0,0,67,67,0,1,0,1,0
11717,28,0,0,66,66,0,1,0,1,0
11469,28,0,0,70,70,0,1,0,1,0
18889,28,0,0,66,66,0,1,0,1,0
17279,28,0,0,66,66,0,1,0,1,0
9605,28,0,0,70,70,0,1,0,1,0
17591,28,0,0,70,70,0,1,0,1,0
14478,28,0,0,70,70,0,1,0,1,0
19787,28,0,0,66,66,0,1,0,1,0
13470,28,0,0,70,70,0,1,0,1,0
22055,28,0,0,70,70,0,1,0,1,0
11379,28,0,0,66,66,0,1,0,1,0
9598,28,0,0,70,70,0,1,0,1,0
15288,28,0,0,70,70,0,1,0,1,0
12434,28,0,0,70,70,0,1,0,1,0
14310,28,0,0,69,69,0,1,0,1,0
9344,28,0,0,70,70,0,1,0,1,0
17076,28,0,0,69,69,0,1,0,1,0
11390,28,0,0,70,70,0,1,0,1,0
10730,28,0,0,68,68,0,1,0,1,0
19722,28,0,0,70,70,0,1,0,1,0
8846,28,0,0,70,70,0,1,0,1,0
21458,28,0,0,68,68,0,1,0,1,0
19687,28,0,0,66,66,0,1,0,1,0
15322,28,0,0,70,70,0,1,0,1,0
13062,28,0,0,66,66,0,1,0,1,0
17640,28,0,0,66,66,0,1,0,1,0
10356,28,0,0,69,69,0,1,0,1,0
10481,28,0,0,69,69,0,1,0,1,0
16360,28,0,0,70,70,0,1,0,1,0
8535,28,0,0,70,70,0,1,0,1,0
13961,28,0,0,70,70,0,1,0,1,0
22597,28,0,0,66,66,0,1,0,1,0
10403,28,0,0,70,70,0,1,0,1,0
18860,28,0,0,70,70,0,1,0,1,0
19022,28,0,0,70,70,0,1,0,1,0
17504,28,0,0,66,66,0,1,0,1,0
12526,28,0,0,66,66,0,1,0,1,0
22566,28,0,0,68,68,0,1,0,1,0
10384,28,0,0,70,70,0,1,0,1,0
17451,28,0,0,70,70,0,1,0,1,0
9484,28,0,0,70,70,0,1,0,1,0
12839,28,0,0,69,69,0,1,0,1,0
12877,28,0,0,70,70,0,1,0,1,0
21184,28,0,0,66,66,0,1,0,1,0
15962,28,0,0,70,70,0,1,0,1,0
15988,28,0,0,69,69,0,1,0,1,0
19951,28,0,0,70,70,0,1,0,1,0
15163,28,0,0,70,70,0,1,0,1,0
20435,28,0,0,67,67,0,1,0,1,0
20195,28,0,0,66,66,0,1,0,1,0
10414,28,0,0,70,70,0,1,0,1,0
18203,28,0,0,70,70,0,1,0,1,0
17092,28,0,0,70,70,0,1,0,1,0
20805,28,0,0,70,70,0,1,0,1,0
8890,28,0,0,70,70,0,1,0,1,0
16081,28,0,0,70,70,0,1,0,1,0
9032,28,0,0,70,70,0,1,0,1,0
15780,28,0,0,66,66,0,1,0,1,0
15905,28,0,0,70,70,0,1,0,1,0
15606,28,0,0,67,67,0,1,0,1,0
18780,28,0,0,67,67,0,1,0,1,0
12494,28,0,0,66,66,0,1,0,1,0
15539,28,0,0,66,66,0,1,0,1,0
19874,28,0,0,69,69,0,1,0,1,0
8608,28,0,0,68,68,0,1,0,1,0
13530,28,0,0,66,66,0,1,0,1,0
10440,28,0,0,67,67,0,1,0,1,0
19172,28,0,0,70,70,0,1,0,1,0
8920,28,0,0,70,70,0,1,0,1,0
14483,28,0,0,66,66,0,1,0,1,0
12131,28,0,0,66,66,0,1,0,1,0
13216,28,0,0,66,66,0,1,0,1,0
18436,28,0,0,70,70,0,1,0,1,0
18417,28,0,0,70,70,0,1,0,1,0
18643,28,0,0,68,68,0,1,0,1,0
14178,28,0,0,66,66,0,1,0,1,0
20366,28,0,0,70,70,0,1,0,1,0
13545,28,0,0,70,70,0,1,0,1,0
19298,28,0,0,70,70,0,1,0,1,0
20615,28,0,0,70,70,0,1,0,1,0
13851,28,0,0,70,70,0,1,0,1,0
11469,28,0,0,70,70,0,1,0,1,0
17523,28,0,0,70,70,0,1,0,1,0
20808,28,0,0,70,70,0,1,0,1,0
12929,28,0,0,70,70,0,1,0,1,0
19988,28,0,0,70,70,0,1,0,1,0
20593,28,0,0,70,70,0,1,0,1,0
13425,28,0,0,70,70,0,1,0,1,0
14222,28,0,0,70,70,0,1,0,1,0
19660,28,0,0,70,70,0,1,0,1,0
13853,28,0,0,70,70,0,1,0,1,0
16378,28,0,0,70,70,0,1,0,1,0
10975,28,0,0,70,70,0,1,0,1,0
15608,28,0,0,70,70,0,1,0,1,0
21287,28,0,0,70,70,0,1,0,1,0
10994,28,0,0,70,70,0,1,0,1,0
15904,28,0,0,66,66,0,1,0,1,0
11074,28,0,0,70,70,0,1,0,1,0
13558,28,0,0,70,70,0,1,0,1,0
21736,28,0,0,70,70,0,1,0,1,0
16540,28,0,0,70,70,0,1,0,1,0
8327,28,0,0,70,70,0,1,0,1,0
22269,28,0,0,70,70,0,1,0,1,0
14372,28,0,0,66,66,0,1,0,1,0
19373,28,0,0,70,70,0,1,0,1,0
13609,28,0,0,70,70,0,1,0,1,0
16245,28,0,0,70,70,0,1,0,1,0
12899,28,0,0,70,70,0,1,0,1,0
18893,28,0,0,70,70,0,1,0,1,0
13372,28,0,0,66,66,0,1,0,1,0
17619,28,0,0,69,69,0,1,0,1,0
15678,28,0,0,70,70,0,1,0,1,0
9318,28,0,0,70,70,0,1,0,1,0
21834,28,0,0,67,67,0,1,0,1,0
9757,28,0,0,70,70,0,1,0,1,0
13225,28,0,0,66,66,0,1,0,1,0
18935,28,0,0,67,67,0,1,0,1,0
16711,28,0,0,66,66,0,1,0,1,0
21285,28,0,0,70,70,0,1,0,1,0
20884,28,0,0,69,69,0,1,0,1,0
11118,28,0,0,70,70,0,1,0,1,0
9748,28,0,0,70,70,0,1,0,1,0
22036,28,0,0,70,70,0,1,0,1,0
17064,28,0,0,70,70,0,1,0,1,0
10543,28,0,0,66,66,0,1,0,1,0
10818,28,0,0,70,70,0,1,0,1,0
20472,28,0,0,66,66,0,1,0,1,0
15777,28,0,0,66,66,0,1,0,1,0
22674,28,0,0,70,70,0,1,0,1,0
16281,28,0,0,68,68,0,1,0,1,0
21430,28,0,0,70,70,0,1,0,1,0
9193,28,0,0,70,70,0,1,0,1,0
14795,28,0,0,70,70,0,1,0,1,0
17904,28,0,0,66,66,0,1,0,1,0
8744,28,0,0,70,70,0,1,0,1,0
19425,28,0,0,68,68,0,1,0,1,0
8494,28,0,0,66,66,0,1,0,1,0
16787,28,0,0,70,70,0,1,0,1,0
10690,28,0,0,70,70,0,1,0,1,0
20215,28,0,0,70,70,0,1,0,1,0
20984,28,0,0,70,70,0,1,0,1,0
17672,28,0,0,70,70,0,1,0,1,0
18864,28,0,0,70,70,0,1,0,1,0
21595,28,0,0,68,68,0,1,0,1,0
9946,28,0,0,67,67,0,1,0,1,0
20263,28,0,0,70,70,0,1,0,1,0
12975,28,0,0,66,66,0,1,0,1,0
20994,28,0,0,70,70,0,1,0,1,0
10952,28,0,0,70,70,0,1,0,1,0
18518,28,0,0,68,68,0,1,0,1,0
19662,28,0,0,70,70,0,1,0,1,0
11632,28,0,0,70,70,0,1,0,1,0
20688,28,0,0,70,70,0,1,0,1,0
18678,28,0,0,66,66,0,1,0,1,0
17972,28,0,0,70,70,0,1,0,1,0
17141,28,0,0,70,70,0,1,0,1,0
17187,28,0,0,66,66,0,1,0,1,0
10836,28,0,0,70,70,0,1,0,1,0
10487,28,0,0,70,70,0,1,0,1,0
14407,28,0,0,70,70,0,1,0,1,0
11946,28,0,0,70,70,0,1,0,1,0
15248,28,0,0,70,70,0,1,0,1,0
8407,28,0,0,70,70,0,1,0,1,0
19498,28,0,0,66,66,0,1,0,1,0
9754,28,0,0,70,70,0,1,0,1,0
10993,28,0,0,70,70,0,1,0,1,0
19337,28,0,0,70,70,0,1,0,1,0
12405,28,0,0,66,66,0,1,0,1,0
20949,28,0,0,70,70,0,1,0,1,0
9451,28,0,0,68,68,0,1,0,1,0
20208,28,0,0,66,66,0,1,0,1,0
14666,28,0,0,66,66,0,1,0,1,0
12692,28,0,0,70,70,0,1,0,1,0
22480,28,0,0,68,68,0,1,0,1,0
9623,28,0,0,66,66,0,1,0,1,0
20399,28,0,0,70,70,0,1,0,1,0
18692,28,0,0,70,70,0,1,0,1,0
17084,28,0,0,69,69,0,1,0,1,0
9860,28,0,0,66,66,0,1,0,1,0
9439,28,0,0,70,70,0,1,0,1,0
19606,28,0,0,66,66,0,1,0,1,0
13071,28,0,0,70,70,0,1,0,1,0
8786,28,0,0,68,68,0,1,0,1,0
8621,28,0,0,70,70,0,1,0,1,0
10552,28,0,0,68,68,0,1,0,1,0
21680,28,0,0,70,70,0,1,0,1,0
21681,28,0,0,70,70,0,1,0,1,0
17996,28,0,0,70,70,0,1,0,1,0
10518,28,0,0,66,66,0,1,0,1,0
10186,28,0,0,70,70,0,1,0,1,0
21957,28,0,0,70,70,0,1,0,1,0
11437,28,0,0,70,70,0,1,0,1,0
10865,28,0,0,69,69,0,1,0,1,0
12256,28,0,0,66,66,0,1,0,1,0
19507,28,0,0,66,66,0,1,0,1,0
21922,28,0,0,70,70,0,1,0,1,0
14825,28,0,0,70,70,0,1,0,1,0
21420,28,0,0,67,67,0,1,0,1,0
17540,28,0,0,66,66,0,1,0,1,0
13847,28,0,0,70,70,0,1,0,1,0
17763,28,0,0,66,66,0,1,0,1,0
9497,28,0,0,70,70,0,1,0,1,0
17520,28,0,0,70,70,0,1,0,1,0
19435,28,0,0,70,70,0,1,0,1,0
19349,28,0,0,70,70,0,1,0,1,0
19695,28,0,0,70,70,0,1,0,1,0
11649,28,0,0,68,68,0,1,0,1,0
18466,28,0,0,70,70,0,1,0,1,0
9137,28,0,0,70,70,0,1,0,1,0
20702,28,0,0,70,70,0,1,0,1,0
11932,28,0,0,70,70,0,1,0,1,0
10640,28,0,0,70,70,0,1,0,1,0
14224,28,0,0,70,70,0,1,0,1,0
19207,28,0,0,69,69,0,1,0,1,0
21237,28,0,0,70,70,0,1,0,1,0
11308,28,0,0,66,66,0,1,0,1,0
9946,28,0,0,66,66,0,1,0,1,0
21319,28,0,0,70,70,0,1,0,1,0
18279,28,0,0,66,66,0,1,0,1,0
9454,28,0,0,66,66,0,1,0,1,0
10165,28,0,0,66,66,0,1,0,1,0
9557,28,0,0,66,66,0,1,0,1,0
22045,28,0,0,70,70,0,1,0,1,0
8465,28,0,0,70,70,0,1,0,1,0
14909,28,0,0,66,66,0,1,0,1,0
12788,28,0,0,68,68,0,1,0,1,0
14481,28,0,0,66,66,0,1,0,1,0
15282,28,0,0,66,66,0,1,0,1,0
20760,28,0,0,70,70,0,1,0,1,0
10042,28,0,0,66,66,0,1,0,1,0
18184,28,0,0,70,70,0,1,0,1,0
14270,28,0,0,70,70,0,1,0,1,0
8700,28,0,0,70,70,0,1,0,1,0
17647,28,0,0,66,66,0,1,0,1,0
22611,28,0,0,70,70,0,1,0,1,0
18336,28,0,0,67,67,0,1,0,1,0
15719,28,0,0,68,68,0,1,0,1,0
21736,28,0,0,66,66,0,1,0,1,0
15094,28,0,0,70,70,0,1,0,1,0
12192,28,0,0,70,70,0,1,0,1,0
16095,28,0,0,70,70,0,1,0,1,0
18558,28,0,0,70,70,0,1,0,1,0
22527,28,0,0,70,70,0,1,0,1,0
13856,28,0,0,66,66,0,1,0,1,0
8467,28,0,0,70,70,0,1,0,1,0
21877,28,0,0,69,69,0,1,0,1,0
11055,28,0,0,66,66,0,1,0,1,0
12978,28,0,0,66,66,0,1,0,1,0
14562,28,0,0,70,70,0,1,0,1,0
9660,28,0,0,70,70,0,1,0,1,0
18086,28,0,0,70,70,0,1,0,1,0
12206,28,0,0,66,66,0,1,0,1,0
11781,28,0,0,70,70,0,1,0,1,0
16179,28,0,0,66,66,0,1,0,1,0
8574,28,0,0,67,67,0,1,0,1,0
18630,28,0,0,66,66,0,1,0,1,0
16062,28,0,0,70,70,0,1,0,1,0
19240,28,0,0,70,70,0,1,0,1,0
9083,28,0,0,70,70,0,1,0,1,0
10240,28,0,0,66,66,0,1,0,1,0
11072,28,0,0,67,67,0,1,0,1,0
13544,28,0,0,70,70,0,1,0,1,0
14484,28,0,0,66,66,0,1,0,1,0
22704,28,0,0,69,69,0,1,0,1,0
15161,28,0,0,70,70,0,1,0,1,0
11375,28,0,0,66,66,0,1,0,1,0
12032,28,0,0,68,68,0,1,0,1,0
22113,28,0,0,70,70,0,1,0,1,0
16899,28,0,0,70,70,0,1,0,1,0
10246,28,0,0,69,69,0,1,0,1,0
14882,28,0,0,70,70,0,1,0,1,0
16714,28,0,0,66,66,0,1,0,1,0
16141,28,0,0,66,66,0,1,0,1,0
9315,28,0,0,67,67,0,1,0,1,0
17407,28,0,0,66,66,0,1,0,1,0
18317,28,0,0,70,70,0,1,0,1,0
8916,28,0,0,70,70,0,1,0,1,0
16692,28,0,0,66,66,0,1,0,1,0
20310,28,0,0,70,70,0,1,0,1,0
19341,28,0,0,66,66,0,1,0,1,0
12767,28,0,0,66,66,0,1,0,1,0
18504,28,0,0,70,70,0,1,0,1,0
9748,28,0,0,70,70,0,1,0,1,0
18698,28,0,0,70,70,0,1,0,1,0
20291,28,0,0,70,70,0,1,0,1,0
8810,28,0,0,66,66,0,1,0,1,0
9828,28,0,0,70,70,0,1,0,1,0
17419,28,0,0,70,70,0,1,0,1,0
11828,28,0,0,66,66,0,1,0,1,0
16633,28,0,0,70,70,0,1,0,1,0
10783,28,0,0,70,70,0,1,0,1,0
11665,28,0,0,66,66,0,1,0,1,0
14054,28,0,0,66,66,0,1,0,1,0
10654,28,0,0,70,70,0,1,0,1,0
15408,28,0,0,70,70,0,1,0,1,0
13741,28,0,0,70,70,0,1,0,1,0
18724,28,0,0,70,70,0,1,0,1,0
21184,28,0,0,66,66,0,1,0,1,0
11525,28,0,0,66,66,0,1,0,1,0
11173,28,0,0,66,66,0,1,0,1,0
21956,28,0,0,66,66,0,1,0,1,0
19312,28,0,0,70,70,0,1,0,1,0
9920,28,0,0,70,70,0,1,0,1,0
9042,28,0,0,70,70,0,1,0,1,0
21345,28,0,0,70,70,0,1,0,1,0
12147,28,0,0,69,69,0,1,0,1,0
15726,28,0,0,70,70,0,1,0,1,0
20234,28,0,0,70,70,0,1,0,1,0
13745,28,0,0,66,66,0,1,0,1,0
21780,28,0,0,66,66,0,1,0,1,0
21166,28,0,0,70,70,0,1,0,1,0
15782,28,0,0,66,66,0,1,0,1,0
17522,28,0,0,70,70,0,1,0,1,0
12789,28,0,0,66,66,0,1,0,1,0
9539,28,0,0,70,70,0,1,0,1,0
22029,28,0,0,66,66,0,1,0,1,0
11406,28,0,0,66,66,0,1,0,1,0
18926,28,0,0,70,70,0,1,0,1,0
10161,28,0,0,70,70,0,1,0,1,0
18392,28,0,0,70,70,0,1,0,1,0
21001,28,0,0,70,70,0,1,0,1,0
14176,28,0,0,66,66,0,1,0,1,0
11444,28,0,0,70,70,0,1,0,1,0
18628,28,0,0,69,69,0,1,0,1,0
20277,28,0,0,70,70,0,1,0,1,0
17422,28,0,0,69,69,0,1,0,1,0
10797,28,0,0,68,68,0,1,0,1,0
16079,28,0,0,68,68,0,1,0,1,0
22029,28,0,0,66,66,0,1,0,1,0
19337,28,0,0,70,70,0,1,0,1,0
19276,28,0,0,70,70,0,1,0,1,0
12991,28,0,0,70,70,0,1,0,1,0
19462,28,0,0,70,70,0,1,0,1,0
19459,28,0,0,70,70,0,1,0,1,0
8918,28,0,0,70,70,0,1,0,1,0
17880,28,0,0,70,70,0,1,0,1,0
17384,28,0,0,67,67,0,1,0,1,0
12404,28,0,0,69,69,0,1,0,1,0
10184,28,0,0,70,70,0,1,0,1,0
10553,28,0,0,67,67,0,1,0,1,0
12822,28,0,0,70,70,0,1,0,1,0
14865,28,0,0,70,70,0,1,0,1,0
20845,28,0,0,70,70,0,1,0,1,0
15280,28,0,0,69,69,0,1,0,1,0
22640,28,0,0,66,66,0,1,0,1,0
20179,28,0,0,70,70,0,1,0,1,0
11664,28,0,0,69,69,0,1,0,1,0
20907,28,0,0,66,66,0,1,0,1,0
18949,28,0,0,66,66,0,1,0,1,0
10656,28,0,0,70,70,0,1,0,1,0
10224,28,0,0,66,66,0,1,0,1,0
17349,28,0,0,69,69,0,1,0,1,0
17208,28,0,0,70,70,0,1,0,1,0
10377,28,0,0,70,70,0,1,0,1,0
9808,28,0,0,68,68,0,1,0,1,0
15876,28,0,0,70,70,0,1,0,1,0
10945,28,0,0,70,70,0,1,0,1,0
14156,28,0,0,70,70,0,1,0,1,0
10972,28,0,0,70,70,0,1,0,1,0
12483,28,0,0,70,70,0,1,0,1,0
20950,28,0,0,70,70,0,1,0,1,0
10135,28,0,0,70,70,0,1,0,1,0
15561,28,0,0,68,68,0,1,0,1,0
18484,28,0,0,70,70,0,1,0,1,0
9776,28,0,0,66,66,0,1,0,1,0
22072,28,0,0,66,66,0,1,0,1,0
9981,28,0,0,70,70,0,1,0,1,0
15813,28,0,0,68,68,0,1,0,1,0
21166,28,0,0,70,70,0,1,0,1,0
11296,28,0,0,70,70,0,1,0,1,0
8404,28,0,0,70,70,0,1,0,1,0
8481,28,0,0,67,67,0,1,0,1,0
10115,28,0,0,66,66,0,1,0,1,0
12557,28,0,0,70,70,0,1,0,1,0
17899,28,0,0,70,70,0,1,0,1,0
15158,28,0,0,69,69,0,1,0,1,0
17352,28,0,0,70,70,0,1,0,1,0
13691,28,0,0,66,66,0,1,0,1,0
21280,28,0,0,70,70,0,1,0,1,0
15757,28,0,0,70,70,0,1,0,1,0
9181,28,0,0,70,70,0,1,0,1,0
12212,28,0,0,70,70,0,1,0,1,0
11513,28,0,0,66,66,0,1,0,1,0
17406,28,0,0,70,70,0,1,0,1,0
20746,28,0,0,70,70,0,1,0,1,0
9825,28,0,0,70,70,0,1,0,1,0
15468,28,0,0,66,66,0,1,0,1,0
13199,28,0,0,68,68,0,1,0,1,0
15715,28,0,0,66,66,0,1,0,1,0
17897,28,0,0,70,70,0,1,0,1,0
17339,28,0,0,70,70,0,1,0,1,0
11272,28,0,0,70,70,0,1,0,1,0
14116,28,0,0,67,67,0,1,0,1,0
13368,28,0,0,70,70,0,1,0,1,0
17878,28,0,0,66,66,0,1,0,1,0
8385,28,0,0,68,68,0,1,0,1,0
13807,28,0,0,70,70,0,1,0,1,0
11335,28,0,0,70,70,0,1,0,1,0
22177,28,0,0,70,70,0,1,0,1,0
11914,28,0,0,70,70,0,1,0,1,0
21674,28,0,0,70,70,0,1,0,1,0
14456,28,0,0,70,70,0,1,0,1,0
17673,28,0,0,70,70,0,1,0,1,0
10018,28,0,0,70,70,0,1,0,1,0
16655,28,0,0,66,66,0,1,0,1,0
20958,28,0,0,66,66,0,1,0,1,0
11657,28,0,0,70,70,0,1,0,1,0
22547,28,0,0,70,70,0,1,0,1,0
9738,28,0,0,70,70,0,1,0,1,0
12081,28,0,0,68,68,0,1,0,1,0
10007,28,0,0,66,66,0,1,0,1,0
21167,28,0,0,67,67,0,1,0,1,0
20249,28,0,0,66,66,0,1,0,1,0
10170,28,0,0,66,66,0,1,0,1,0
20502,28,0,0,70,70,0,1,0,1,0
16193,28,0,0,66,66,0,1,0,1,0
9497,28,0,0,70,70,0,1,0,1,0
19956,28,0,0,70,70,0,1,0,1,0
17622,28,0,0,66,66,0,1,0,1,0
9021,28,0,0,70,70,0,1,0,1,0
12127,28,0,0,66,66,0,1,0,1,0
18901,28,0,0,66,66,0,1,0,1,0
12587,28,0,0,70,70,0,1,0,1,0
10422,28,0,0,70,70,0,1,0,1,0
8544,28,0,0,69,69,0,1,0,1,0
10160,28,0,0,70,70,0,1,0,1,0
14090,28,0,0,70,70,0,1,0,1,0
21988,28,0,0,66,66,0,1,0,1,0
19058,28,0,0,70,70,0,1,0,1,0
13584,28,0,0,70,70,0,1,0,1,0
18653,28,0,0,70,70,0,1,0,1,0
13843,28,0,0,70,70,0,1,0,1,0
9508,28,0,0,70,70,0,1,0,1,0
22494,28,0,0,70,70,0,1,0,1,0
14780,28,0,0,67,67,0,1,0,1,0
14776,28,0,0,70,70,0,1,0,1,0
13578,28,0,0,70,70,0,1,0,1,0
19970,28,0,0,69,69,0,1,0,1,0
15710,28,0,0,66,66,0,1,0,1,0
12451,28,0,0,69,69,0,1,0,1,0
15230,28,0,0,66,66,0,1,0,1,0
16854,28,0,0,70,70,0,1,0,1,0
21842,28,0,0,70,70,0,1,0,1,0
10167,28,0,0,66,66,0,1,0,1,0
17709,28,0,0,67,67,0,1,0,1,0
17138,28,0,0,69,69,0,1,0,1,0
16870,28,0,0,70,70,0,1,0,1,0
17113,28,0,0,69,69,0,1,0,1,0
14561,28,0,0,70,70,0,1,0,1,0
12133,28,0,0,70,70,0,1,0,1,0
9438,28,0,0,70,70,0,1,0,1,0
10440,28,0,0,67,67,0,1,0,1,0
10991,28,0,0,68,68,0,1,0,1,0
18183,28,0,0,70,70,0,1,0,1,0
12054,28,0,0,70,70,0,1,0,1,0
16687,28,0,0,70,70,0,1,0,1,0
22244,28,0,0,68,68,0,1,0,1,0
9672,28,0,0,70,70,0,1,0,1,0
21900,28,0,0,70,70,0,1,0,1,0
20723,28,0,0,66,66,0,1,0,1,0
15536,28,0,0,70,70,0,1,0,1,0
11819,28,0,0,66,66,0,1,0,1,0
9676,28,0,0,70,70,0,1,0,1,0
12371,28,0,0,70,70,0,1,0,1,0
13692,28,0,0,67,67,0,1,0,1,0
12882,28,0,0,70,70,0,1,0,1,0
20793,28,0,0,70,70,0,1,0,1,0
9255,28,0,0,66,66,0,1,0,1,0
19465,28,0,0,70,70,0,1,0,1,0
17651,28,0,0,66,66,0,1,0,1,0
10167,28,0,0,66,66,0,1,0,1,0
18003,28,0,0,70,70,0,1,0,1,0
16524,28,0,0,70,70,0,1,0,1,0
17951,28,0,0,66,66,0,1,0,1,0
14674,28,0,0,70,70,0,1,0,1,0
10975,28,0,0,70,70,0,1,0,1,0
22581,28,0,0,67,67,0,1,0,1,0
10715,28,0,0,66,66,0,1,0,1,0
13541,28,0,0,70,70,0,1,0,1,0
16494,28,0,0,67,67,0,1,0,1,0
18673,28,0,0,69,69,0,1,0,1,0
17831,28,0,0,70,70,0,1,0,1,0
21358,28,0,0,66,66,0,1,0,1,0
21788,28,0,0,70,70,0,1,0,1,0
22282,28,0,0,70,70,0,1,0,1,0
15797,28,0,0,70,70,0,1,0,1,0
10002,28,0,0,70,70,0,1,0,1,0
12704,28,0,0,70,70,0,1,0,1,0
11984,28,0,0,66,66,0,1,0,1,0
11490,28,0,0,70,70,0,1,0,1,0
10232,28,0,0,66,66,0,1,0,1,0
19738,28,0,0,66,66,0,1,0,1,0
9764,28,0,0,70,70,0,1,0,1,0
21680,28,0,0,70,70,0,1,0,1,0
9722,28,0,0,69,69,0,1,0,1,0
18689,28,0,0,70,70,0,1,0,1,0
17852,28,0,0,70,70,0,1,0,1,0
9501,28,0,0,66,66,0,1,0,1,0
15845,28,0,0,66,66,0,1,0,1,0
21610,28,0,0,70,70,0,1,0,1,0
12591,28,0,0,66,66,0,1,0,1,0
21332,28,0,0,70,70,0,1,0,1,0
12108,28,0,0,70,70,0,1,0,1,0
11780,28,0,0,70,70,0,1,0,1,0
11164,28,0,0,70,70,0,1,0,1,0
17332,28,0,0,70,70,0,1,0,1,0
22632,28,0,0,70,70,0,1,0,1,0
10025,28,0,0,68,68,0,1,0,1,0
10136,28,0,0,70,70,0,1,0,1,0
16698,28,0,0,67,67,0,1,0,1,0
19053,28,0,0,66,66,0,1,0,1,0
20277,28,0,0,67,67,0,1,0,1,0
17346,28,0,0,70,70,0,1,0,1,0
16913,28,0,0,70,70,0,1,0,1,0
19997,28,0,0,70,70,0,1,0,1,0
21953,28,0,0,67,67,0,1,0,1,0
11258,28,0,0,69,69,0,1,0,1,0
12602,28,0,0,69,69,0,1,0,1,0
9567,28,0,0,66,66,0,1,0,1,0
10659,28,0,0,68,68,0,1,0,1,0
21956,28,0,0,66,66,0,1,0,1,0
10872,28,0,0,69,69,0,1,0,1,0
18668,28,0,0,70,70,0,1,0,1,0
19402,28,0,0,69,69,0,1,0,1,0
12030,28,0,0,68,68,0,1,0,1,0
16855,28,0,0,70,70,0,1,0,1,0
10187,28,0,0,70,70,0,1,0,1,0
12046,28,0,0,70,70,0,1,0,1,0
11300,28,0,0,66,66,0,1,0,1,0
22120,28,0,0,70,70,0,1,0,1,0
16851,28,0,0,66,66,0,1,0,1,0
16175,28,0,0,70,70,0,1,0,1,0
12376,28,0,0,70,70,0,1,0,1,0
15565,28,0,0,70,70,0,1,0,1,0
17499,28,0,0,66,66,0,1,0,1,0
16492,28,0,0,67,67,0,1,0,1,0
18254,28,0,0,70,70,0,1,0,1,0
16857,28,0,0,70,70,0,1,0,1,0
17038,28,0,0,66,66,0,1,0,1,0
21637,28,0,0,70,70,0,1,0,1,0
10991,28,0,0,70,70,0,1,0,1,0
13242,28,0,0,70,70,0,1,0,1,0
16362,28,0,0,68,68,0,1,0,1,0
14512,28,0,0,70,70,0,1,0,1,0
22265,28,0,0,70,70,0,1,0,1,0
10287,28,0,0,69,69,0,1,0,1,0
17060,28,0,0,66,66,0,1,0,1,0
11978,28,0,0,70,70,0,1,0,1,0
22016,28,0,0,70,70,0,1,0,1,0
10243,28,0,0,66,66,0,1,0,1,0
18418,28,0,0,68,68,0,1,0,1,0
14495,28,0,0,70,70,0,1,0,1,0
13758,28,0,0,70,70,0,1,0,1,0
9806,28,0,0,66,66,0,1,0,1,0
13530,28,0,0,66,66,0,1,0,1,0
13061,28,0,0,66,66,0,1,0,1,0
18683,28,0,0,68,68,0,1,0,1,0
18500,28,0,0,66,66,0,1,0,1,0
14924,28,0,0,66,66,0,1,0,1,0
11189,28,0,0,66,66,0,1,0,1,0
15533,28,0,0,70,70,0,1,0,1,0
13031,28,0,0,70,70,0,1,0,1,0
21227,28,0,0,70,70,0,1,0,1,0
15609,28,0,0,70,70,0,1,0,1,0
16032,28,0,0,70,70,0,1,0,1,0
18767,28,0,0,70,70,0,1,0,1,0
11394,28,0,0,67,67,0,1,0,1,0
10067,28,0,0,66,66,0,1,0,1,0
10159,28,0,0,70,70,0,1,0,1,0
10097,28,0,0,70,70,0,1,0,1,0
16408,28,0,0,66,66,0,1,0,1,0
20865,28,0,0,69,69,0,1,0,1,0
19000,28,0,0,70,70,0,1,0,1,0
19500,28,0,0,66,66,0,1,0,1,0
12041,28,0,0,70,70,0,1,0,1,0
15407,28,0,0,70,70,0,1,0,1,0
15066,28,0,0,70,70,0,1,0,1,0
16782,28,0,0,70,70,0,1,0,1,0
14720,28,0,0,66,66,0,1,0,1,0
12275,28,0,0,66,66,0,1,0,1,0
20647,28,0,0,66,66,0,1,0,1,0
9239,28,0,0,68,68,0,1,0,1,0
22061,28,0,0,70,70,0,1,0,1,0
16170,28,0,0,70,70,0,1,0,1,0
19649,28,0,0,70,70,0,1,0,1,0
18483,28,0,0,70,70,0,1,0,1,0
9981,28,0,0,66,66,0,1,0,1,0
20382,28,0,0,66,66,0,1,0,1,0
20655,28,0,0,70,70,0,1,0,1,0
13778,28,0,0,70,70,0,1,0,1,0
14161,28,0,0,70,70,0,1,0,1,0
14368,28,0,0,70,70,0,1,0,1,0
18393,28,0,0,70,70,0,1,0,1,0
14574,28,0,0,69,69,0,1,0,1,0
12403,28,0,0,67,67,0,1,0,1,0
14248,28,0,0,70,70,0,1,0,1,0
14694,28,0,0,70,70,0,1,0,1,0
8613,28,0,0,70,70,0,1,0,1,0
14202,28,0,0,70,70,0,1,0,1,0
12639,28,0,0,70,70,0,1,0,1,0
22444,28,0,0,70,70,0,1,0,1,0
9341,28,0,0,70,70,0,1,0,1,0
9565,28,0,0,70,70,0,1,0,1,0
14046,28,0,0,70,70,0,1,0,1,0
13772,28,0,0,70,70,0,1,0,1,0
20847,28,0,0,70,70,0,1,0,1,0
10484,28,0,0,69,69,0,1,0,1,0
15909,28,0,0,66,66,0,1,0,1,0
13600,28,0,0,70,70,0,1,0,1,0
20094,28,0,0,70,70,0,1,0,1,0
15128,28,0,0,70,70,0,1,0,1,0
17822,28,0,0,70,70,0,1,0,1,0
9153,28,0,0,66,66,0,1,0,1,0
8635,28,0,0,66,66,0,1,0,1,0
15365,28,0,0,69,69,0,1,0,1,0
9301,28,0,0,69,69,0,1,0,1,0
9688,28,0,0,70,70,0,1,0,1,0
14870,28,0,0,70,70,0,1,0,1,0
16537,28,0,0,70,70,0,1,0,1,0
9737,28,0,0,70,70,0,1,0,1,0
14767,28,0,0,66,66,0,1,0,1,0
9982,28,0,0,66,66,0,1,0,1,0
13149,28,0,0,70,70,0,1,0,1,0
18485,28,0,0,70,70,0,1,0,1,0
14821,28,0,0,67,67,0,1,0,1,0
8791,28,0,0,70,70,0,1,0,1,0
12721,28,0,0,66,66,0,1,0,1,0
13719,28,0,0,70,70,0,1,0,1,0
8415,28,0,0,66,66,0,1,0,1,0
21666,28,0,0,66,66,0,1,0,1,0
10455,28,0,0,70,70,0,1,0,1,0
15446,28,0,0,70,70,0,1,0,1,0
13979,28,0,0,70,70,0,1,0,1,0
12709,28,0,0,70,70,0,1,0,1,0
9644,28,0,0,70,70,0,1,0,1,0
13315,28,0,0,66,66,0,1,0,1,0
18747,28,0,0,70,70,0,1,0,1,0
9007,28,0,0,66,66,0,1,0,1,0
13758,28,0,0,70,70,0,1,0,1,0
8699,28,0,0,70,70,0,1,0,1,0
9117,28,0,0,70,70,0,1,0,1,0
16682,28,0,0,70,70,0,1,0,1,0
21544,28,0,0,70,70,0,1,0,1,0
22266,28,0,0,70,70,0,1,0,1,0
9879,28,0,0,70,70,0,1,0,1,0
20687,28,0,0,68,68,0,1,0,1,0
11852,28,0,0,66,66,0,1,0,1,0
17640,28,0,0,69,69,0,1,0,1,0
12600,28,0,0,70,70,0,1,0,1,0
18648,28,0,0,70,70,0,1,0,1,0
21546,28,0,0,66,66,0,1,0,1,0
14287,28,0,0,70,70,0,1,0,1,0
9957,28,0,0,68,68,0,1,0,1,0
10001,28,0,0,70,70,0,1,0,1,0
14840,28,0,0,69,69,0,1,0,1,0
9480,28,0,0,70,70,0,1,0,1,0
18954,28,0,0,70,70,0,1,0,1,0
8360,28,0,0,70,70,0,1,0,1,0
13522,28,0,0,70,70,0,1,0,1,0
14988,28,0,0,70,70,0,1,0,1,0
17519,28,0,0,66,66,0,1,0,1,0
8949,28,0,0,70,70,0,1,0,1,0
12407,28,0,0,66,66,0,1,0,1,0
18200,28,0,0,70,70,0,1,0,1,0
17834,28,0,0,69,69,0,1,0,1,0
9143,28,0,0,70,70,0,1,0,1,0
10029,28,0,0,70,70,0,1,0,1,0
19300,28,0,0,66,66,0,1,0,1,0
12873,28,0,0,67,67,0,1,0,1,0
18165,28,0,0,66,66,0,1,0,1,0
21261,28,0,0,70,70,0,1,0,1,0
11049,28,0,0,70,70,0,1,0,1,0
18152,28,0,0,70,70,0,1,0,1,0
22058,28,0,0,70,70,0,1,0,1,0
20818,28,0,0,70,70,0,1,0,1,0
12568,28,0,0,70,70,0,1,0,1,0
9465,28,0,0,70,70,0,1,0,1,0
14491,28,0,0,66,66,0,1,0,1,0
18347,28,0,0,70,70,0,1,0,1,0
21708,28,0,0,66,66,0,1,0,1,0
19921,28,0,0,66,66,0,1,0,1,0
10804,28,0,0,66,66,0,1,0,1,0
19627,28,0,0,70,70,0,1,0,1,0
13616,28,0,0,67,67,0,1,0,1,0
18698,28,0,0,66,66,0,1,0,1,0
13419,28,0,0,70,70,0,1,0,1,0
18757,28,0,0,70,70,0,1,0,1,0
9981,28,0,0,70,70,0,1,0,1,0
11673,28,0,0,70,70,0,1,0,1,0
11119,28,0,0,70,70,0,1,0,1,0
20958,28,0,0,66,66,0,1,0,1,0
15745,28,0,0,67,67,0,1,0,1,0
18558,28,0,0,68,68,0,1,0,1,0
17490,28,0,0,67,67,0,1,0,1,0
10070,28,0,0,67,67,0,1,0,1,0
10025,28,0,0,70,70,0,1,0,1,0
16790,28,0,0,70,70,0,1,0,1,0
9444,28,0,0,70,70,0,1,0,1,0
16951,28,0,0,70,70,0,1,0,1,0
15725,28,0,0,70,70,0,1,0,1,0
20720,28,0,0,70,70,0,1,0,1,0
13849,28,0,0,70,70,0,1,0,1,0
17981,28,0,0,70,70,0,1,0,1,0
13773,28,0,0,70,70,0,1,0,1,0
11394,28,0,0,70,70,0,1,0,1,0
13366,28,0,0,70,70,0,1,0,1,0
8527,28,0,0,67,67,0,1,0,1,0
21898,28,0,0,70,70,0,1,0,1,0
18755,28,0,0,70,70,0,1,0,1,0
19715,28,0,0,70,70,0,1,0,1,0
20792,28,0,0,67,67,0,1,0,1,0
10414,28,0,0,70,70,0,1,0,1,0
17879,28,0,0,70,70,0,1,0,1,0
21537,28,0,0,70,70,0,1,0,1,0
14897,28,0,0,70,70,0,1,0,1,0
9757,28,0,0,70,70,0,1,0,1,0
13427,28,0,0,70,70,0,1,0,1,0
10189,28,0,0,70,70,0,1,0,1,0
10401,28,0,0,70,70,0,1,0,1,0
12922,28,0,0,70,70,0,1,0,1,0
12332,28,0,0,70,70,0,1,0,1,0
12488,28,0,0,68,68,0,1,0,1,0
11531,28,0,0,70,70,0,1,0,1,0
12673,28,0,0,70,70,0,1,0,1,0
11826,28,0,0,69,69,0,1,0,1,0
20954,28,0,0,70,70,0,1,0,1,0
17677,28,0,0,70,70,0,1,0,1,0
20396,28,0,0,68,68,0,1,0,1,0
19885,28,0,0,70,70,0,1,0,1,0
19463,28,0,0,70,70,0,1,0,1,0
21319,28,0,0,70,70,0,1,0,1,0
10784,28,0,0,70,70,0,1,0,1,0
17661,28,0,0,70,70,0,1,0,1,0
22361,28,0,0,70,70,0,1,0,1,0
12620,28,0,0,68,68,0,1,0,1,0
8863,28,0,0,66,66,0,1,0,1,0
9733,28,0,0,66,66,0,1,0,1,0
19150,28,0,0,66,66,0,1,0,1,0
12249,28,0,0,70,70,0,1,0,1,0
21996,28,0,0,70,70,0,1,0,1,0
15541,28,0,0,66,66,0,1,0,1,0
17579,28,0,0,70,70,0,1,0,1,0
8650,28,0,0,70,70,0,1,0,1,0
22016,28,0,0,69,69,0,1,0,1,0
9936,28,0,0,66,66,0,1,0,1,0
20919,28,0,0,70,70,0,1,0,1,0
20072,28,0,0,66,66,0,1,0,1,0
21088,28,0,0,70,70,0,1,0,1,0
15295,28,0,0,70,70,0,1,0,1,0
16387,28,0,0,70,70,0,1,0,1,0
17647,28,0,0,68,68,0,1,0,1,0
18021,28,0,0,66,66,0,1,0,1,0
12112,28,0,0,66,66,0,1,0,1,0
14146,28,0,0,70,70,0,1,0,1,0
12303,28,0,0,68,68,0,1,0,1,0
16686,28,0,0,70,70,0,1,0,1,0
21753,28,0,0,70,70,0,1,0,1,0
16737,28,0,0,68,68,0,1,0,1,0
13708,28,0,0,70,70,0,1,0,1,0
9291,28,0,0,70,70,0,1,0,1,0
14810,28,0,0,70,70,0,1,0,1,0
14263,28,0,0,66,66,0,1,0,1,0
12394,28,0,0,67,67,0,1,0,1,0
15129,28,0,0,70,70,0,1,0,1,0
14462,28,0,0,70,70,0,1,0,1,0
19338,28,0,0,70,70,0,1,0,1,0
12705,28,0,0,68,68,0,1,0,1,0
21284,28,0,0,70,70,0,1,0,1,0
15986,28,0,0,67,67,0,1,0,1,0
12775,28,0,0,66,66,0,1,0,1,0
13989,28,0,0,70,70,0,1,0,1,0
9920,28,0,0,70,70,0,1,0,1,0
18014,28,0,0,70,70,0,1,0,1,0
17483,28,0,0,70,70,0,1,0,1,0
22671,28,0,0,70,70,0,1,0,1,0
18987,28,0,0,70,70,0,1,0,1,0
20699,28,0,0,70,70,0,1,0,1,0
14132,28,0,0,67,67,0,1,0,1,0
13850,28,0,0,70,70,0,1,0,1,0
17265,28,0,0,70,70,0,1,0,1,0
13941,28,0,0,70,70,0,1,0,1,0
10245,28,0,0,70,70,0,1,0,1,0
9689,28,0,0,66,66,0,1,0,1,0
20707,28,0,0,70,70,0,1,0,1,0
16037,28,0,0,68,68,0,1,0,1,0
8855,28,0,0,69,69,0,1,0,1,0
10417,28,0,0,70,70,0,1,0,1,0
21084,28,0,0,70,70,0,1,0,1,0
16345,28,0,0,66,66,0,1,0,1,0
14025,28,0,0,70,70,0,1,0,1,0
9030,28,0,0,70,70,0,1,0,1,0
20134,28,0,0,67,67,0,1,0,1,0
13923,28,0,0,70,70,0,1,0,1,0
11461,28,0,0,66,66,0,1,0,1,0
21752,28,0,0,70,70,0,1,0,1,0
22297,28,0,0,70,70,0,1,0,1,0
17724,28,0,0,70,70,0,1,0,1,0
20361,28,0,0,68,68,0,1,0,1,0
9668,28,0,0,70,70,0,1,0,1,0
15984,28,0,0,70,70,0,1,0,1,0
10113,28,0,0,70,70,0,1,0,1,0
21354,28,0,0,70,70,0,1,0,1,0
12772,28,0,0,70,70,0,1,0,1,0
20173,28,0,0,70,70,0,1,0,1,0
8875,28,0,0,70,70,0,1,0,1,0
10165,28,0,0,66,66,0,1,0,1,0
11892,28,0,0,69,69,0,1,0,1,0
21703,28,0,0,70,70,0,1,0,1,0
13705,28,0,0,70,70,0,1,0,1,0
10164,28,0,0,70,70,0,1,0,1,0
11105,28,0,0,70,70,0,1,0,1,0
16463,28,0,0,70,70,0,1,0,1,0
21407,28,0,0,70,70,0,1,0,1,0
20596,28,0,0,70,70,0,1,0,1,0
8574,28,0,0,68,68,0,1,0,1,0
20222,28,0,0,70,70,0,1,0,1,0
20116,28,0,0,66,66,0,1,0,1,0
10553,28,0,0,69,69,0,1,0,1,0
21655,28,0,0,70,70,0,1,0,1,0
20857,28,0,0,68,68,0,1,0,1,0
17709,28,0,0,66,66,0,1,0,1,0
11554,28,0,0,70,70,0,1,0,1,0
11295,28,0,0,70,70,0,1,0,1,0
8699,28,0,0,70,70,0,1,0,1,0
17658,28,0,0,70,70,0,1,0,1,0
10227,28,0,0,66,66,0,1,0,1,0
15776,28,0,0,66,66,0,1,0,1,0
16340,28,0,0,66,66,0,1,0,1,0
14301,28,0,0,66,66,0,1,0,1,0
18837,28,0,0,66,66,0,1,0,1,0
15576,28,0,0,70,70,0,1,0,1,0
9616,28,0,0,70,70,0,1,0,1,0
16509,28,0,0,66,66,0,1,0,1,0
18485,28,0,0,70,70,0,1,0,1,0
14235,28,0,0,66,66,0,1,0,1,0
22017,28,0,0,70,70,0,1,0,1,0
9505,28,0,0,70,70,0,1,0,1,0
20936,28,0,0,70,70,0,1,0,1,0
9415,28,0,0,66,66,0,1,0,1,0
15469,28,0,0,66,66,0,1,0,1,0
20660,28,0,0,70,70,0,1,0,1,0
10588,28,0,0,70,70,0,1,0,1,0
19101,28,0,0,70,70,0,1,0,1,0
20457,28,0,0,68,68,0,1,0,1,0
20365,28,0,0,70,70,0,1,0,1,0
19096,28,0,0,70,70,0,1,0,1,0
10041,28,0,0,70,70,0,1,0,1,0
20480,28,0,0,70,70,0,1,0,1,0
15532,28,0,0,70,70,0,1,0,1,0
13118,28,0,0,70,70,0,1,0,1,0
21092,28,0,0,70,70,0,1,0,1,0
13292,28,0,0,70,70,0,1,0,1,0
19925,28,0,0,70,70,0,1,0,1,0
9506,28,0,0,70,70,0,1,0,1,0
14758,28,0,0,70,70,0,1,0,1,0
14078,28,0,0,70,70,0,1,0,1,0
14277,28,0,0,70,70,0,1,0,1,0
15487,28,0,0,66,66,0,1,0,1,0
10977,28,0,0,70,70,0,1,0,1,0
16044,28,0,0,66,66,0,1,0,1,0
17597,28,0,0,66,66,0,1,0,1,0
17308,28,0,0,70,70,0,1,0,1,0
8434,28,0,0,66,66,0,1,0,1,0
20224,28,0,0,67,67,0,1,0,1,0
17851,28,0,0,70,70,0,1,0,1,0
9457,28,0,0,70,70,0,1,0,1,0
22552,28,0,0,68,68,0,1,0,1,0
19276,28,0,0,70,70,0,1,0,1,0
12989,28,0,0,70,70,0,1,0,1,0
19533,28,0,0,70,70,0,1,0,1,0
21955,28,0,0,66,66,0,1,0,1,0
17402,28,0,0,66,66,0,1,0,1,0
11908,28,0,0,68,68,0,1,0,1,0
9415,28,0,0,66,66,0,1,0,1,0
20003,28,0,0,70,70,0,1,0,1,0
19456,28,0,0,70,70,0,1,0,1,0
14314,28,0,0,70,70,0,1,0,1,0
12198,28,0,0,66,66,0,1,0,1,0
16496,28,0,0,69,69,0,1,0,1,0
14780,28,0,0,66,66,0,1,0,1,0
12808,28,0,0,70,70,0,1,0,1,0
18641,28,0,0,70,70,0,1,0,1,0
14033,28,0,0,70,70,0,1,0,1,0
18590,28,0,0,70,70,0,1,0,1,0
8919,28,0,0,70,70,0,1,0,1,0
16351,28,0,0,68,68,0,1,0,1,0
16554,28,0,0,68,68,0,1,0,1,0
21220,28,0,0,70,70,0,1,0,1,0
17563,28,0,0,70,70,0,1,0,1,0
12617,28,0,0,69,69,0,1,0,1,0
20217,28,0,0,66,66,0,1,0,1,0
10597,28,0,0,69,69,0,1,0,1,0
12209,28,0,0,70,70,0,1,0,1,0
20231,28,0,0,70,70,0,1,0,1,0
21898,28,0,0,70,70,0,1,0,1,0
19871,28,0,0,70,70,0,1,0,1,0
19032,28,0,0,70,70,0,1,0,1,0
12192,28,0,0,70,70,0,1,0,1,0
8639,28,0,0,68,68,0,1,0,1,0
21913,28,0,0,70,70,0,1,0,1,0
11118,28,0,0,66,66,0,1,0,1,0
16383,28,0,0,66,66,0,1,0,1,0
15621,28,0,0,66,66,0,1,0,1,0
18452,28,0,0,68,68,0,1,0,1,0
17782,28,0,0,66,66,0,1,0,1,0
22054,28,0,0,70,70,0,1,0,1,0
18331,28,0,0,69,69,0,1,0,1,0
19024,28,0,0,70,70,0,1,0,1,0
10589,28,0,0,70,70,0,1,0,1,0
18454,28,0,0,70,70,0,1,0,1,0
12798,28,0,0,70,70,0,1,0,1,0
8724,28,0,0,70,70,0,1,0,1,0
16143,28,0,0,70,70,0,1,0,1,0
14176,28,0,0,70,70,0,1,0,1,0
9260,28,0,0,70,70,0,1,0,1,0
14194,28,0,0,70,70,0,1,0,1,0
20713,28,0,0,70,70,0,1,0,1,0
22688,28,0,0,66,66,0,1,0,1,0
17470,28,0,0,66,66,0,1,0,1,0
17381,28,0,0,70,70,0,1,0,1,0
17658,28,0,0,70,70,0,1,0,1,0
20679,28,0,0,66,66,0,1,0,1,0
13723,28,0,0,70,70,0,1,0,1,0
21476,28,0,0,70,70,0,1,0,1,0
16043,28,0,0,70,70,0,1,0,1,0
11508,28,0,0,70,70,0,1,0,1,0
21313,28,0,0,70,70,0,1,0,1,0
8858,28,0,0,67,67,0,1,0,1,0
8922,28,0,0,70,70,0,1,0,1,0
9069,28,0,0,70,70,0,1,0,1,0
12192,28,0,0,70,70,0,1,0,1,0
16295,28,0,0,70,70,0,1,0,1,0
14105,28,0,0,66,66,0,1,0,1,0
10432,28,0,0,66,66,0,1,0,1,0
9016,28,0,0,70,70,0,1,0,1,0
11531,28,0,0,70,70,0,1,0,1,0
14010,28,0,0,68,68,0,1,0,1,0
8973,28,0,0,70,70,0,1,0,1,0
12213,28,0,0,70,70,0,1,0,1,0
14458,28,0,0,70,70,0,1,0,1,0
19405,28,0,0,67,67,0,1,0,1,0
20568,28,0,0,70,70,0,1,0,1,0
21397,28,0,0,70,70,0,1,0,1,0
13343,28,0,0,66,66,0,1,0,1,0
21614,28,0,0,66,66,0,1,0,1,0
10553,28,0,0,69,69,0,1,0,1,0
17388,28,0,0,66,66,0,1,0,1,0
11831,28,0,0,66,66,0,1,0,1,0
9130,28,0,0,70,70,0,1,0,1,0
14598,28,0,0,69,69,0,1,0,1,0
20733,28,0,0,70,70,0,1,0,1,0
15092,28,0,0,70,70,0,1,0,1,0
10385,28,0,0,69,69,0,1,0,1,0
17410,28,0,0,69,69,0,1,0,1,0
15095,28,0,0,70,70,0,1,0,1,0
9989,28,0,0,70,70,0,1,0,1,0
11939,28,0,0,70,70,0,1,0,1,0
19090,28,0,0,66,66,0,1,0,1,0
12167,28,0,0,66,66,0,1,0,1,0
15297,28,0,0,70,70,0,1,0,1,0
19853,28,0,0,66,66,0,1,0,1,0
15730,28,0,0,70,70,0,1,0,1,0
19215,28,0,0,70,70,0,1,0,1,0
13432,28,0,0,70,70,0,1,0,1,0
16193,28,0,0,70,70,0,1,0,1,0
14353,28,0,0,70,70,0,1,0,1,0
11333,28,0,0,70,70,0,1,0,1,0
21450,28,0,0,66,66,0,1,0,1,0
12240,28,0,0,66,66,0,1,0,1,0
17291,28,0,0,66,66,0,1,0,1,0
17887,28,0,0,66,66,0,1,0,1,0
13281,28,0,0,68,68,0,1,0,1,0
15860,28,0,0,68,68,0,1,0,1,0
8349,28,0,0,66,66,0,1,0,1,0
13735,28,0,0,70,70,0,1,0,1,0
9940,28,0,0,66,66,0,1,0,1,0
18623,28,0,0,68,68,0,1,0,1,0
9124,28,0,0,70,70,0,1,0,1,0
9004,28,0,0,66,66,0,1,0,1,0
20594,28,0,0,66,66,0,1,0,1,0
17343,28,0,0,70,70,0,1,0,1,0
13751,28,0,0,70,70,0,1,0,1,0
10627,28,0,0,70,70,0,1,0,1,0
15929,28,0,0,69,69,0,1,0,1,0
21772,28,0,0,70,70,0,1,0,1,0
20397,28,0,0,66,66,0,1,0,1,0
21989,28,0,0,70,70,0,1,0,1,0
14751,28,0,0,70,70,0,1,0,1,0
11607,28,0,0,66,66,0,1,0,1,0
16136,28,0,0,66,66,0,1,0,1,0
12190,28,0,0,70,70,0,1,0,1,0
13462,28,0,0,70,70,0,1,0,1,0
14490,28,0,0,66,66,0,1,0,1,0
12881,28,0,0,70,70,0,1,0,1,0
12286,28,0,0,70,70,0,1,0,1,0
17538,28,0,0,66,66,0,1,0,1,0
12219,28,0,0,70,70,0,1,0,1,0
16233,28,0,0,70,70,0,1,0,1,0
15492,28,0,0,68,68,0,1,0,1,0
9715,28,0,0,68,68,0,1,0,1,0
13501,28,0,0,70,70,0,1,0,1,0
16152,28,0,0,66,66,0,1,0,1,0
17035,28,0,0,68,68,0,1,0,1,0
16494,28,0,0,69,69,0,1,0,1,0
19672,28,0,0,69,69,0,1,0,1,0
20890,28,0,0,70,70,0,1,0,1,0
21729,28,0,0,66,66,0,1,0,1,0
13621,28,0,0,70,70,0,1,0,1,0
19147,28,0,0,66,66,0,1,0,1,0
8536,28,0,0,68,68,0,1,0,1,0
12158,28,0,0,70,70,0,1,0,1,0
17828,28,0,0,70,70,0,1,0,1,0
17132,28,0,0,67,67,0,1,0,1,0
12799,28,0,0,70,70,0,1,0,1,0
20365,28,0,0,68,68,0,1,0,1,0
15050,28,0,0,67,67,0,1,0,1,0
21071,28,0,0,70,70,0,1,0,1,0
15808,28,0,0,66,66,0,1,0,1,0
18499,28,0,0,66,66,0,1,0,1,0
15116,28,0,0,70,70,0,1,0,1,0
18895,28,0,0,70,70,0,1,0,1,0
19195,28,0,0,70,70,0,1,0,1,0
10156,28,0,0,66,66,0,1,0,1,0
14025,28,0,0,70,70,0,1,0,1,0
12689,28,0,0,70,70,0,1,0,1,0
9323,28,0,0,70,70,0,1,0,1,0
13737,28,0,0,66,66,0,1,0,1,0
12911,28,0,0,66,66,0,1,0,1,0
11716,28,0,0,66,66,0,1,0,1,0
10484,28,0,0,70,70,0,1,0,1,0
13469,28,0,0,66,66,0,1,0,1,0
11515,28,0,0,69,69,0,1,0,1,0
19529,28,0,0,68,68,0,1,0,1,0
16026,28,0,0,70,70,0,1,0,1,0
17421,28,0,0,70,70,0,1,0,1,0
12668,28,0,0,70,70,0,1,0,1,0
21712,28,0,0,69,69,0,1,0,1,0
10652,28,0,0,70,70,0,1,0,1,0
16810,28,0,0,66,66,0,1,0,1,0
21616,28,0,0,66,66,0,1,0,1,0
14178,28,0,0,66,66,0,1,0,1,0
20580,28,0,0,70,70,0,1,0,1,0
19536,28,0,0,70,70,0,1,0,1,0
17846,28,0,0,70,70,0,1,0,1,0
19555,28,0,0,70,70,0,1,0,1,0
19633,28,0,0,68,68,0,1,0,1,0
9855,28,0,0,70,70,0,1,0,1,0
10436,28,0,0,66,66,0,1,0,1,0
14186,28,0,0,70,70,0,1,0,1,0
11901,28,0,0,68,68,0,1,0,1,0
8330,28,0,0,70,70,0,1,0,1,0
17384,28,0,0,70,70,0,1,0,1,0
21033,28,0,0,70,70,0,1,0,1,0
22286,28,0,0,70,70,0,1,0,1,0
14854,28,0,0,68,68,0,1,0,1,0
9987,28,0,0,70,70,0,1,0,1,0
11420,28,0,0,69,69,0,1,0,1,0
11333,28,0,0,70,70,0,1,0,1,0
13098,28,0,0,70,70,0,1,0,1,0
18201,28,0,0,70,70,0,1,0,1,0
16859,28,0,0,68,68,0,1,0,1,0
13488,28,0,0,66,66,0,1,0,1,0
20951,28,0,0,70,70,0,1,0,1,0
9680,28,0,0,66,66,0,1,0,1,0
21933,28,0,0,67,67,0,1,0,1,0
18607,28,0,0,70,70,0,1,0,1,0
8659,28,0,0,70,70,0,1,0,1,0
10607,28,0,0,70,70,0,1,0,1,0
13291,28,0,0,70,70,0,1,0,1,0
16674,28,0,0,67,67,0,1,0,1,0
20844,28,0,0,70,70,0,1,0,1,0
20735,28,0,0,70,70,0,1,0,1,0
11442,28,0,0,67,67,0,1,0,1,0
9559,28,0,0,70,70,0,1,0,1,0
13469,28,0,0,66,66,0,1,0,1,0
22321,28,0,0,66,66,0,1,0,1,0
13470,28,0,0,66,66,0,1,0,1,0
21111,28,0,0,70,70,0,1,0,1,0
18851,28,0,0,70,70,0,1,0,1,0
10687,28,0,0,66,66,0,1,0,1,0
12656,28,0,0,70,70,0,1,0,1,0
20175,28,0,0,70,70,0,1,0,1,0
11771,28,0,0,66,66,0,1,0,1,0
20642,28,0,0,70,70,0,1,0,1,0
21935,28,0,0,70,70,0,1,0,1,0
19480,28,0,0,70,70,0,1,0,1,0
14150,28,0,0,70,70,0,1,0,1,0
18693,28,0,0,70,70,0,1,0,1,0
17085,28,0,0,70,70,0,1,0,1,0
17052,28,0,0,66,66,0,1,0,1,0
12595,28,0,0,66,66,0,1,0,1,0
20438,28,0,0,70,70,0,1,0,1,0
9032,28,0,0,66,66,0,1,0,1,0
8707,28,0,0,66,66,0,1,0,1,0
16387,28,0,0,66,66,0,1,0,1,0
9274,28,0,0,70,70,0,1,0,1,0
16808,28,0,0,70,70,0,1,0,1,0
17278,28,0,0,67,67,0,1,0,1,0
12838,28,0,0,70,70,0,1,0,1,0
19823,28,0,0,70,70,0,1,0,1,0
13621,28,0,0,69,69,0,1,0,1,0
13448,28,0,0,70,70,0,1,0,1,0
17697,28,0,0,66,66,0,1,0,1,0
13960,28,0,0,68,68,0,1,0,1,0
20259,28,0,0,66,66,0,1,0,1,0
11523,28,0,0,69,69,0,1,0,1,0
18952,28,0,0,70,70,0,1,0,1,0
20084,28,0,0,70,70,0,1,0,1,0
21222,28,0,0,70,70,0,1,0,1,0
10295,28,0,0,66,66,0,1,0,1,0
12879,28,0,0,70,70,0,1,0,1,0
17709,28,0,0,70,70,0,1,0,1,0
9545,28,0,0,70,70,0,1,0,1,0
21222,28,0,0,70,70,0,1,0,1,0
11934,28,0,0,70,70,0,1,0,1,0
17123,28,0,0,70,70,0,1,0,1,0
12265,28,0,0,70,70,0,1,0,1,0
18420,28,0,0,69,69,0,1,0,1,0
15087,28,0,0,70,70,0,1,0,1,0
15904,28,0,0,66,66,0,1,0,1,0
12444,28,0,0,70,70,0,1,0,1,0
18150,28,0,0,70,70,0,1,0,1,0
13488,28,0,0,69,69,0,1,0,1,0
17709,28,0,0,70,70,0,1,0,1,0
13722,28,0,0,70,70,0,1,0,1,0
9033,28,0,0,66,66,0,1,0,1,0
12311,28,0,0,70,70,0,1,0,1,0
18399,28,0,0,70,70,0,1,0,1,0
10059,28,0,0,70,70,0,1,0,1,0
19277,28,0,0,70,70,0,1,0,1,0
22086,28,0,0,66,66,0,1,0,1,0
9653,28,0,0,70,70,0,1,0,1,0
20541,28,0,0,68,68,0,1,0,1,0
18307,28,0,0,70,70,0,1,0,1,0
14196,28,0,0,70,70,0,1,0,1,0
12787,28,0,0,66,66,0,1,0,1,0
22716,28,0,0,70,70,0,1,0,1,0
13808,28,0,0,70,70,0,1,0,1,0
9644,28,0,0,70,70,0,1,0,1,0
12476,28,0,0,70,70,0,1,0,1,0
11767,28,0,0,70,70,0,1,0,1,0
16629,28,0,0,70,70,0,1,0,1,0
11105,28,0,0,70,70,0,1,0,1,0
8972,28,0,0,70,70,0,1,0,1,0
15063,28,0,0,70,70,0,1,0,1,0
8868,28,0,0,70,70,0,1,0,1,0
16629,28,0,0,66,66,0,1,0,1,0
19944,28,0,0,67,67,0,1,0,1,0
12704,28,0,0,70,70,0,1,0,1,0
21457,28,0,0,68,68,0,1,0,1,0
22520,28,0,0,68,68,0,1,0,1,0
16708,28,0,0,66,66,0,1,0,1,0
19312,28,0,0,70,70,0,1,0,1,0
12846,28,0,0,70,70,0,1,0,1,0
22100,28,0,0,70,70,0,1,0,1,0
10205,28,0,0,70,70,0,1,0,1,0
18069,28,0,0,70,70,0,1,0,1,0
14054,28,0,0,70,70,0,1,0,1,0
9496,28,0,0,66,66,0,1,0,1,0
10620,28,0,0,70,70,0,1,0,1,0
9358,28,0,0,70,70,0,1,0,1,0
9588,28,0,0,70,70,0,1,0,1,0
9168,28,0,0,70,70,0,1,0,1,0
16757,28,0,0,66,66,0,1,0,1,0
9490,28,0,0,66,66,0,1,0,1,0
19628,28,0,0,70,70,0,1,0,1,0
20173,28,0,0,66,66,0,1,0,1,0
13166,28,0,0,70,70,0,1,0,1,0
13527,28,0,0,66,66,0,1,0,1,0
21403,28,0,0,70,70,0,1,0,1,0
18776,28,0,0,66,66,0,1,0,1,0
16623,28,0,0,70,70,0,1,0,1,0
11993,28,0,0,70,70,0,1,0,1,0
11881,28,0,0,70,70,0,1,0,1,0
21468,28,0,0,70,70,0,1,0,1,0
13113,28,0,0,70,70,0,1,0,1,0
9883,28,0,0,66,66,0,1,0,1,0
17360,28,0,0,66,66,0,1,0,1,0
21147,28,0,0,69,69,0,1,0,1,0
22402,28,0,0,70,70,0,1,0,1,0
15031,28,0,0,66,66,0,1,0,1,0
12113,28,0,0,70,70,0,1,0,1,0
21651,28,0,0,69,69,0,1,0,1,0
12375,28,0,0,70,70,0,1,0,1,0
13562,28,0,0,70,70,0,1,0,1,0
15051,28,0,0,70,70,0,1,0,1,0
11114,28,0,0,67,67,0,1,0,1,0
10440,28,0,0,70,70,0,1,0,1,0
19212,28,0,0,67,67,0,1,0,1,0
9983,28,0,0,66,66,0,1,0,1,0
9386,28,0,0,66,66,0,1,0,1,0
20063,28,0,0,69,69,0,1,0,1,0
12919,28,0,0,68,68,0,1,0,1,0
12996,28,0,0,70,70,0,1,0,1,0
12631,28,0,0,69,69,0,1,0,1,0
11151,28,0,0,70,70,0,1,0,1,0
16472,28,0,0,70,70,0,1,0,1,0
10187,28,0,0,70,70,0,1,0,1,0
9061,28,0,0,66,66,0,1,0,1,0
12047,28,0,0,70,70,0,1,0,1,0
17007,28,0,0,69,69,0,1,0,1,0
11271,28,0,0,70,70,0,1,0,1,0
22130,28,0,0,66,66,0,1,0,1,0
18177,28,0,0,70,70,0,1,0,1,0
13459,28,0,0,66,66,0,1,0,1,0
12259,28,0,0,69,69,0,1,0,1,0
16631,28,0,0,70,70,0,1,0,1,0
14562,28,0,0,69,69,0,1,0,1,0
20623,28,0,0,69,69,0,1,0,1,0
17313,28,0,0,70,70,0,1,0,1,0
17482,28,0,0,70,70,0,1,0,1,0
12255,28,0,0,70,70,0,1,0,1,0
13842,28,0,0,70,70,0,1,0,1,0
13743,28,0,0,67,67,0,1,0,1,0
12854,28,0,0,70,70,0,1,0,1,0
9335,28,0,0,70,70,0,1,0,1,0
17536,28,0,0,70,70,0,1,0,1,0
15955,28,0,0,67,67,0,1,0,1,0
11882,28,0,0,70,70,0,1,0,1,0
8872,28,0,0,70,70,0,1,0,1,0
19781,28,0,0,70,70,0,1,0,1,0
17735,28,0,0,66,66,0,1,0,1,0
16191,28,0,0,70,70,0,1,0,1,0
13582,28,0,0,70,70,0,1,0,1,0
20679,28,0,0,67,67,0,1,0,1,0
11451,28,0,0,70,70,0,1,0,1,0
11284,28,0,0,68,68,0,1,0,1,0
9906,28,0,0,70,70,0,1,0,1,0
21705,28,0,0,70,70,0,1,0,1,0
22342,28,0,0,66,66,0,1,0,1,0
10326,28,0,0,66,66,0,1,0,1,0
11068,28,0,0,68,68,0,1,0,1,0
9724,28,0,0,66,66,0,1,0,1,0
8882,28,0,0,66,66,0,1,0,1,0
19490,28,0,0,70,70,0,1,0,1,0
9854,28,0,0,70,70,0,1,0,1,0
16512,28,0,0,66,66,0,1,0,1,0
9370,28,0,0,69,69,0,1,0,1,0
13451,28,0,0,70,70,0,1,0,1,0
14120,28,0,0,66,66,0,1,0,1,0
17353,28,0,0,70,70,0,1,0,1,0
19018,28,0,0,69,69,0,1,0,1,0
17459,28,0,0,66,66,0,1,0,1,0
20478,28,0,0,66,66,0,1,0,1,0
18420,28,0,0,70,70,0,1,0,1,0
17394,28,0,0,67,67,0,1,0,1,0
16784,28,0,0,70,70,0,1,0,1,0
17129,28,0,0,66,66,0,1,0,1,0
12740,28,0,0,70,70,0,1,0,1,0
11320,28,0,0,66,66,0,1,0,1,0
11356,28,0,0,68,68,0,1,0,1,0
12640,28,0,0,70,70,0,1,0,1,0
12770,28,0,0,68,68,0,1,0,1,0
11880,28,0,0,70,70,0,1,0,1,0
13469,28,0,0,67,67,0,1,0,1,0
13544,28,0,0,70,70,0,1,0,1,0
21841,28,0,0,66,66,0,1,0,1,0
19779,28,0,0,66,66,0,1,0,1,0
14489,28,0,0,68,68,0,1,0,1,0
10740,28,0,0,70,70,0,1,0,1,0
9029,28,0,0,70,70,0,1,0,1,0
9973,28,0,0,70,70,0,1,0,1,0
9580,28,0,0,69,69,0,1,0,1,0
14725,28,0,0,70,70,0,1,0,1,0
12643,28,0,0,68,68,0,1,0,1,0
10593,28,0,0,70,70,0,1,0,1,0
10818,28,0,0,66,66,0,1,0,1,0
16778,28,0,0,69,69,0,1,0,1,0
18021,28,0,0,68,68,0,1,0,1,0
13397,28,0,0,70,70,0,1,0,1,0
18021,28,0,0,70,70,0,1,0,1,0
13294,28,0,0,70,70,0,1,0,1,0
9646,28,0,0,66,66,0,1,0,1,0
19950,28,0,0,70,70,0,1,0,1,0
14213,28,0,0,70,70,0,1,0,1,0
15555,28,0,0,70,70,0,1,0,1,0
18500,28,0,0,66,66,0,1,0,1,0
15699,28,0,0,70,70,0,1,0,1,0
21311,28,0,0,66,66,0,1,0,1,0
16460,28,0,0,70,70,0,1,0,1,0
13174,28,0,0,70,70,0,1,0,1,0
14223,28,0,0,70,70,0,1,0,1,0
17595,28,0,0,66,66,0,1,0,1,0
11688,28,0,0,70,70,0,1,0,1,0
13686,28,0,0,70,70,0,1,0,1,0
9937,28,0,0,66,66,0,1,0,1,0
9300,28,0,0,70,70,0,1,0,1,0
20515,28,0,0,70,70,0,1,0,1,0
22000,28,0,0,70,70,0,1,0,1,0
15875,28,0,0,70,70,0,1,0,1,0
10107,28,0,0,66,66,0,1,0,1,0
11562,28,0,0,66,66,0,1,0,1,0
19626,28,0,0,70,70,0,1,0,1,0
13046,28,0,0,66,66,0,1,0,1,0
14712,28,0,0,70,70,0,1,0,1,0
10135,28,0,0,70,70,0,1,0,1,0
19365,28,0,0,70,70,0,1,0,1,0
19626,28,0,0,68,68,0,1,0,1,0
12272,28,0,0,70,70,0,1,0,1,0
17896,28,0,0,70,70,0,1,0,1,0
18440,28,0,0,68,68,0,1,0,1,0
19860,28,0,0,68,68,0,1,0,1,0
9605,28,0,0,70,70,0,1,0,1,0
9133,28,0,0,66,66,0,1,0,1,0
21121,28,0,0,66,66,0,1,0,1,0
20042,28,0,0,68,68,0,1,0,1,0
9868,28,0,0,70,70,0,1,0,1,0
19468,28,0,0,70,70,0,1,0,1,0
18834,28,0,0,66,66,0,1,0,1,0
12152,28,0,0,69,69,0,1,0,1,0
11119,28,0,0,70,70,0,1,0,1,0
12081,28,0,0,67,67,0,1,0,1,0
21070,28,0,0,70,70,0,1,0,1,0
21693,28,0,0,70,70,0,1,0,1,0
8621,28,0,0,66,66,0,1,0,1,0
11122,28,0,0,70,70,0,1,0,1,0
19076,28,0,0,70,70,0,1,0,1,0
10486,28,0,0,66,66,0,1,0,1,0
13798,28,0,0,70,70,0,1,0,1,0
14657,28,0,0,70,70,0,1,0,1,0
8628,28,0,0,66,66,0,1,0,1,0
20291,28,0,0,66,66,0,1,0,1,0
20015,28,0,0,70,70,0,1,0,1,0
22030,28,0,0,66,66,0,1,0,1,0
9282,28,0,0,70,70,0,1,0,1,0
9269,28,0,0,70,70,0,1,0,1,0
13888,28,0,0,70,70,0,1,0,1,0
20874,28,0,0,70,70,0,1,0,1,0
8746,28,0,0,70,70,0,1,0,1,0
21574,28,0,0,66,66,0,1,0,1,0
14195,28,0,0,70,70,0,1,0,1,0
17877,28,0,0,69,69,0,1,0,1,0
20574,28,0,0,70,70,0,1,0,1,0
16669,28,0,0,70,70,0,1,0,1,0
18508,28,0,0,66,66,0,1,0,1,0
20812,28,0,0,70,70,0,1,0,1,0
9627,28,0,0,66,66,0,1,0,1,0
14244,28,0,0,66,66,0,1,0,1,0
9567,28,0,0,69,69,0,1,0,1,0
13892,28,0,0,70,70,0,1,0,1,0
20948,28,0,0,70,70,0,1,0,1,0
8662,28,0,0,70,70,0,1,0,1,0
18877,28,0,0,69,69,0,1,0,1,0
17902,28,0,0,66,66,0,1,0,1,0
13315,28,0,0,69,69,0,1,0,1,0
20900,28,0,0,70,70,0,1,0,1,0
14829,28,0,0,70,70,0,1,0,1,0
17523,28,0,0,66,66,0,1,0,1,0
22587,28,0,0,68,68,0,1,0,1,0
9699,28,0,0,70,70,0,1,0,1,0
10168,28,0,0,66,66,0,1,0,1,0
18537,28,0,0,70,70,0,1,0,1,0
16580,28,0,0,70,70,0,1,0,1,0
21919,28,0,0,70,70,0,1,0,1,0
21408,28,0,0,70,70,0,1,0,1,0
17649,28,0,0,68,68,0,1,0,1,0
12615,28,0,0,69,69,0,1,0,1,0
10541,28,0,0,70,70,0,1,0,1,0
16216,28,0,0,70,70,0,1,0,1,0
12112,28,0,0,66,66,0,1,0,1,0
16784,28,0,0,66,66,0,1,0,1,0
17817,28,0,0,67,67,0,1,0,1,0
18097,28,0,0,70,70,0,1,0,1,0
10254,28,0,0,70,70,0,1,0,1,0
15258,28,0,0,70,70,0,1,0,1,0
15470,28,0,0,66,66,0,1,0,1,0
15311,28,0,0,70,70,0,1,0,1,0
10791,28,0,0,66,66,0,1,0,1,0
15904,28,0,0,70,70,0,1,0,1,0
10593,28,0,0,70,70,0,1,0,1,0
13566,28,0,0,66,66,0,1,0,1,0
17028,28,0,0,70,70,0,1,0,1,0
17328,28,0,0,70,70,0,1,0,1,0
19983,28,0,0,66,66,0,1,0,1,0
15373,28,0,0,67,67,0,1,0,1,0
10708,28,0,0,70,70,0,1,0,1,0
17343,28,0,0,70,70,0,1,0,1,0
20159,28,0,0,70,70,0,1,0,1,0
16278,28,0,0,66,66,0,1,0,1,0
14900,28,0,0,70,70,0,1,0,1,0
22028,28,0,0,66,66,0,1,0,1,0
21532,28,0,0,66,66,0,1,0,1,0
15816,28,0,0,70,70,0,1,0,1,0
9747,28,0,0,66,66,0,1,0,1,0
11548,28,0,0,66,66,0,1,0,1,0
16473,28,0,0,70,70,0,1,0,1,0
9461,28,0,0,70,70,0,1,0,1,0
13610,28,0,0,70,70,0,1,0,1,0
19214,28,0,0,69,69,0,1,0,1,0
21547,28,0,0,67,67,0,1,0,1,0
17351,28,0,0,70,70,0,1,0,1,0
17937,28,0,0,70,70,0,1,0,1,0
10021,28,0,0,70,70,0,1,0,1,0
13846,28,0,0,70,70,0,1,0,1,0
12950,28,0,0,66,66,0,1,0,1,0
21803,28,0,0,70,70,0,1,0,1,0
10987,28,0,0,66,66,0,1,0,1,0
17655,28,0,0,66,66,0,1,0,1,0
8752,28,0,0,67,67,0,1,0,1,0
19101,28,0,0,70,70,0,1,0,1,0
13270,28,0,0,66,66,0,1,0,1,0
11718,28,0,0,70,70,0,1,0,1,0
19626,28,0,0,70,70,0,1,0,1,0
22705,28,0,0,70,70,0,1,0,1,0
19909,28,0,0,70,70,0,1,0,1,0
12523,28,0,0,67,67,0,1,0,1,0
17721,28,0,0,70,70,0,1,0,1,0
10626,28,0,0,70,70,0,1,0,1,0
11070,28,0,0,66,66,0,1,0,1,0
11121,28,0,0,70,70,0,1,0,1,0
12994,28,0,0,66,66,0,1,0,1,0
14108,28,0,0,66,66,0,1,0,1,0
14509,28,0,0,70,70,0,1,0,1,0
13058,28,0,0,68,68,0,1,0,1,0
18864,28,0,0,66,66,0,1,0,1,0
18475,28,0,0,70,70,0,1,0,1,0
16248,28,0,0,70,70,0,1,0,1,0
8700,28,0,0,70,70,0,1,0,1,0
20794,28,0,0,70,70,0,1,0,1,0
13467,28,0,0,70,70,0,1,0,1,0
12258,28,0,0,70,70,0,1,0,1,0
14288,28,0,0,69,69,0,1,0,1,0
17577,28,0,0,70,70,0,1,0,1,0
10174,28,0,0,66,66,0,1,0,1,0
19910,28,0,0,68,68,0,1,0,1,0
20998,28,0,0,70,70,0,1,0,1,0
14560,28,0,0,70,70,0,1,0,1,0
13758,28,0,0,70,70,0,1,0,1,0
13998,28,0,0,70,70,0,1,0,1,0
13809,28,0,0,66,66,0,1,0,1,0
10689,28,0,0,70,70,0,1,0,1,0
18922,28,0,0,70,70,0,1,0,1,0
16036,28,0,0,70,70,0,1,0,1,0
12525,28,0,0,69,69,0,1,0,1,0
12348,28,0,0,70,70,0,1,0,1,0
20656,28,0,0,66,66,0,1,0,1,0
13756,28,0,0,70,70,0,1,0,1,0
17446,28,0,0,70,70,0,1,0,1,0
10008,28,0,0,66,66,0,1,0,1,0
9624,28,0,0,66,66,0,1,0,1,0
20207,28,0,0,66,66,0,1,0,1,0
22065,28,0,0,66,66,0,1,0,1,0
18197,28,0,0,66,66,0,1,0,1,0
19283,28,0,0,66,66,0,1,0,1,0
17257,28,0,0,70,70,0,1,0,1,0
16149,28,0,0,70,70,0,1,0,1,0
12428,28,0,0,68,68,0,1,0,1,0
13485,28,0,0,70,70,0,1,0,1,0
13880,28,0,0,70,70,0,1,0,1,0
15351,28,0,0,66,66,0,1,0,1,0
11512,28,0,0,70,70,0,1,0,1,0
11946,28,0,0,66,66,0,1,0,1,0
13766,28,0,0,69,69,0,1,0,1,0
14101,28,0,0,70,70,0,1,0,1,0
21833,28,0,0,66,66,0,1,0,1,0
15793,28,0,0,69,69,0,1,0,1,0
12242,28,0,0,66,66,0,1,0,1,0
16030,28,0,0,66,66,0,1,0,1,0
14208,28,0,0,70,70,0,1,0,1,0
8617,28,0,0,70,70,0,1,0,1,0
21286,28,0,0,70,70,0,1,0,1,0
17114,28,0,0,70,70,0,1,0,1,0
20577,28,0,0,70,70,0,1,0,1,0
12567,28,0,0,70,70,0,1,0,1,0
11268,28,0,0,70,70,0,1,0,1,0
14722,28,0,0,70,70,0,1,0,1,0
21886,28,0,0,68,68,0,1,0,1,0
11140,28,0,0,70,70,0,1,0,1,0
10222,28,0,0,66,66,0,1,0,1,0
13169,28,0,0,69,69,0,1,0,1,0
20339,28,0,0,68,68,0,1,0,1,0
18942,28,0,0,70,70,0,1,0,1,0
14713,28,0,0,67,67,0,1,0,1,0
20263,28,0,0,70,70,0,1,0,1,0
18872,28,0,0,70,70,0,1,0,1,0
11524,28,0,0,68,68,0,1,0,1,0
16281,28,0,0,70,70,0,1,0,1,0
11445,28,0,0,70,70,0,1,0,1,0
17599,28,0,0,66,66,0,1,0,1,0
17100,28,0,0,70,70,0,1,0,1,0
16824,28,0,0,70,70,0,1,0,1,0
10232,28,0,0,66,66,0,1,0,1,0
15468,28,0,0,70,70,0,1,0,1,0
17565,28,0,0,69,69,0,1,0,1,0
8574,28,0,0,70,70,0,1,0,1,0
13509,28,0,0,69,69,0,1,0,1,0
20841,28,0,0,66,66,0,1,0,1,0
20172,28,0,0,70,70,0,1,0,1,0
16150,28,0,0,70,70,0,1,0,1,0
17781,28,0,0,67,67,0,1,0,1,0
18452,28,0,0,68,68,0,1,0,1,0
19148,28,0,0,67,67,0,1,0,1,0
21668,28,0,0,66,66,0,1,0,1,0
16621,28,0,0,70,70,0,1,0,1,0
18023,28,0,0,66,66,0,1,0,1,0
11081,28,0,0,70,70,0,1,0,1,0
17000,28,0,0,70,70,0,1,0,1,0
12459,28,0,0,70,70,0,1,0,1,0
22590,28,0,0,70,70,0,1,0,1,0
21140,28,0,0,70,70,0,1,0,1,0
14549,28,0,0,66,66,0,1,0,1,0
11832,28,0,0,66,66,0,1,0,1,0
22552,28,0,0,69,69,0,1,0,1,0
12484,28,0,0,70,70,0,1,0,1,0
10423,28,0,0,66,66,0,1,0,1,0
18872,28,0,0,70,70,0,1,0,1,0
19046,28,0,0,70,70,0,1,0,1,0
9353,28,0,0,70,70,0,1,0,1,0
20401,28,0,0,66,66,0,1,0,1,0
18483,28,0,0,67,67,0,1,0,1,0
16068,28,0,0,70,70,0,1,0,1,0
18988,28,0,0,70,70,0,1,0,1,0
15850,28,0,0,70,70,0,1,0,1,0
18144,28,0,0,66,66,0,1,0,1,0
15232,28,0,0,70,70,0,1,0,1,0
9604,28,0,0,67,67,0,1,0,1,0
21886,28,0,0,69,69,0,1,0,1,0
13372,28,0,0,66,66,0,1,0,1,0
9551,28,0,0,69,69,0,1,0,1,0
11945,28,0,0,70,70,0,1,0,1,0
20850,28,0,0,70,70,0,1,0,1,0
9937,28,0,0,66,66,0,1,0,1,0
21830,28,0,0,66,66,0,1,0,1,0
18685,28,0,0,66,66,0,1,0,1,0
9452,28,0,0,66,66,0,1,0,1,0
12416,28,0,0,69,69,0,1,0,1,0
17687,28,0,0,70,70,0,1,0,1,0
14542,28,0,0,69,69,0,1,0,1,0
12686,28,0,0,70,70,0,1,0,1,0
17604,28,0,0,70,70,0,1,0,1,0
14456,28,0,0,70,70,0,1,0,1,0
12156,28,0,0,70,70,0,1,0,1,0
21916,28,0,0,67,67,0,1,0,1,0
9944,28,0,0,66,66,0,1,0,1,0
10080,28,0,0,70,70,0,1,0,1,0
20969,28,0,0,70,70,0,1,0,1,0
18675,28,0,0,68,68,0,1,0,1,0
9530,28,0,0,70,70,0,1,0,1,0
10222,28,0,0,70,70,0,1,0,1,0
12247,28,0,0,70,70,0,1,0,1,0
20957,28,0,0,67,67,0,1,0,1,0
20027,28,0,0,66,66,0,1,0,1,0
14385,28,0,0,68,68,0,1,0,1,0
18705,28,0,0,70,70,0,1,0,1,0
17123,28,0,0,68,68,0,1,0,1,0
17258,28,0,0,66,66,0,1,0,1,0
19958,28,0,0,66,66,0,1,0,1,0
10610,28,0,0,67,67,0,1,0,1,0
13859,28,0,0,70,70,0,1,0,1,0
13003,28,0,0,69,69,0,1,0,1,0
21549,28,0,0,66,66,0,1,0,1,0
14484,28,0,0,66,66,0,1,0,1,0
10184,28,0,0,66,66,0,1,0,1,0
19620,28,0,0,69,69,0,1,0,1,0
10975,28,0,0,70,70,0,1,0,1,0
18152,28,0,0,66,66,0,1,0,1,0
16957,28,0,0,70,70,0,1,0,1,0
20644,28,0,0,70,70,0,1,0,1,0
10161,28,0,0,70,70,0,1,0,1,0
11996,28,0,0,70,70,0,1,0,1,0
16555,28,0,0,70,70,0,1,0,1,0
9421,28,0,0,70,70,0,1,0,1,0
16250,28,0,0,70,70,0,1,0,1,0
13133,28,0,0,69,69,0,1,0,1,0
9790,28,0,0,70,70,0,1,0,1,0
14219,28,0,0,70,70,0,1,0,1,0
21829,28,0,0,70,70,0,1,0,1,0
9706,28,0,0,66,66,0,1,0,1,0
18184,28,0,0,70,70,0,1,0,1,0
11173,28,0,0,70,70,0,1,0,1,0
21071,28,0,0,70,70,0,1,0,1,0
18889,28,0,0,70,70,0,1,0,1,0
8689,28,0,0,69,69,0,1,0,1,0
8806,28,0,0,69,69,0,1,0,1,0
13736,28,0,0,70,70,0,1,0,1,0
9468,28,0,0,68,68,0,1,0,1,0
14526,28,0,0,66,66,0,1,0,1,0
12032,28,0,0,68,68,0,1,0,1,0
8514,28,0,0,70,70,0,1,0,1,0
13784,28,0,0,70,70,0,1,0,1,0
21227,28,0,0,70,70,0,1,0,1,0
21478,28,0,0,66,66,0,1,0,1,0
22648,28,0,0,70,70,0,1,0,1,0
12952,28,0,0,66,66,0,1,0,1,0
18933,28,0,0,68,68,0,1,0,1,0
19926,28,0,0,70,70,0,1,0,1,0
11297,28,0,0,70,70,0,1,0,1,0
11930,28,0,0,70,70,0,1,0,1,0
19078,28,0,0,66,66,0,1,0,1,0
17311,28,0,0,66,66,0,1,0,1,0
10104,28,0,0,66,66,0,1,0,1,0
21899,28,0,0,70,70,0,1,0,1,0
9399,28,0,0,70,70,0,1,0,1,0
16455,28,0,0,68,68,0,1,0,1,0
11567,28,0,0,70,70,0,1,0,1,0
14891,28,0,0,67,67,0,1,0,1,0
15212,28,0,0,66,66,0,1,0,1,0
10711,28,0,0,70,70,0,1,0,1,0
9420,28,0,0,70,70,0,1,0,1,0
12132,28,0,0,66,66,0,1,0,1,0
9412,28,0,0,70,70,0,1,0,1,0
15080,28,0,0,70,70,0,1,0,1,0
14489,28,0,0,70,70,0,1,0,1,0
9372,28,0,0,66,66,0,1,0,1,0
17084,28,0,0,66,66,0,1,0,1,0
18692,28,0,0,70,70,0,1,0,1,0
8949,28,0,0,70,70,0,1,0,1,0
16069,28,0,0,66,66,0,1,0,1,0
21834,28,0,0,70,70,0,1,0,1,0
20277,28,0,0,66,66,0,1,0,1,0
14361,28,0,0,66,66,0,1,0,1,0
9958,28,0,0,70,70,0,1,0,1,0
12200,28,0,0,66,66,0,1,0,1,0
11402,28,0,0,70,70,0,1,0,1,0
8945,28,0,0,70,70,0,1,0,1,0
12720,28,0,0,66,66,0,1,0,1,0
12768,28,0,0,70,70,0,1,0,1,0
21473,28,0,0,66,66,0,1,0,1,0
11086,28,0,0,70,70,0,1,0,1,0
9239,28,0,0,70,70,0,1,0,1,0
14135,28,0,0,70,70,0,1,0,1,0
10261,28,0,0,69,69,0,1,0,1,0
19275,28,0,0,70,70,0,1,0,1,0
8505,28,0,0,70,70,0,1,0,1,0
19912,28,0,0,66,66,0,1,0,1,0
8485,28,0,0,70,70,0,1,0,1,0
15528,28,0,0,70,70,0,1,0,1,0
10001,28,0,0,66,66,0,1,0,1,0
12898,28,0,0,70,70,0,1,0,1,0
14275,28,0,0,70,70,0,1,0,1,0
13416,28,0,0,70,70,0,1,0,1,0
22671,28,0,0,70,70,0,1,0,1,0
18311,28,0,0,67,67,0,1,0,1,0
18495,28,0,0,67,67,0,1,0,1,0
13300,28,0,0,70,70,0,1,0,1,0
22582,28,0,0,70,70,0,1,0,1,0
10081,28,0,0,70,70,0,1,0,1,0
17461,28,0,0,70,70,0,1,0,1,0
16994,28,0,0,70,70,0,1,0,1,0
13942,28,0,0,70,70,0,1,0,1,0
13427,28,0,0,70,70,0,1,0,1,0
9865,28,0,0,70,70,0,1,0,1,0
20808,28,0,0,70,70,0,1,0,1,0
11238,28,0,0,70,70,0,1,0,1,0
22055,28,0,0,70,70,0,1,0,1,0
14188,28,0,0,70,70,0,1,0,1,0
16981,28,0,0,70,70,0,1,0,1,0
18664,28,0,0,69,69,0,1,0,1,0
15948,28,0,0,70,70,0,1,0,1,0
19414,28,0,0,70,70,0,1,0,1,0
20219,28,0,0,70,70,0,1,0,1,0
13679,28,0,0,70,70,0,1,0,1,0
22161,28,0,0,70,70,0,1,0,1,0
22184,28,0,0,70,70,0,1,0,1,0
12233,28,0,0,70,70,0,1,0,1,0
21237,28,0,0,68,68,0,1,0,1,0
14080,28,0,0,69,69,0,1,0,1,0
21750,28,0,0,70,70,0,1,0,1,0
9598,28,0,0,70,70,0,1,0,1,0
15314,28,0,0,66,66,0,1,0,1,0
18401,28,0,0,70,70,0,1,0,1,0
17116,28,0,0,70,70,0,1,0,1,0
15814,28,0,0,69,69,0,1,0,1,0
20474,28,0,0,68,68,0,1,0,1,0
14122,28,0,0,70,70,0,1,0,1,0
16955,28,0,0,70,70,0,1,0,1,0
10393,28,0,0,66,66,0,1,0,1,0
15526,28,0,0,70,70,0,1,0,1,0
13575,28,0,0,70,70,0,1,0,1,0
21853,28,0,0,68,68,0,1,0,1,0
19855,28,0,0,70,70,0,1,0,1,0
11266,28,0,0,70,70,0,1,0,1,0
18551,28,0,0,66,66,0,1,0,1,0
15564,28,0,0,67,67,0,1,0,1,0
9655,28,0,0,66,66,0,1,0,1,0
10330,28,0,0,69,69,0,1,0,1,0
16406,28,0,0,66,66,0,1,0,1,0
19052,28,0,0,66,66,0,1,0,1,0
18402,28,0,0,70,70,0,1,0,1,0
19585,28,0,0,70,70,0,1,0,1,0
14898,28,0,0,70,70,0,1,0,1,0
15341,28,0,0,70,70,0,1,0,1,0
17128,28,0,0,66,66,0,1,0,1,0
8498,28,0,0,66,66,0,1,0,1,0
21264,28,0,0,70,70,0,1,0,1,0
14368,28,0,0,70,70,0,1,0,1,0
20075,28,0,0,70,70,0,1,0,1,0
18504,28,0,0,70,70,0,1,0,1,0
14508,28,0,0,70,70,0,1,0,1,0
22283,28,0,0,70,70,0,1,0,1,0
19126,28,0,0,70,70,0,1,0,1,0
16165,28,0,0,68,68,0,1,0,1,0
17136,28,0,0,70,70,0,1,0,1,0
9607,28,0,0,66,66,0,1,0,1,0
13932,28,0,0,66,66,0,1,0,1,0
13857,28,0,0,70,70,0,1,0,1,0
10051,28,0,0,66,66,0,1,0,1,0
14159,28,0,0,66,66,0,1,0,1,0
14175,28,0,0,66,66,0,1,0,1,0
22299,28,0,0,67,67,0,1,0,1,0
15434,28,0,0,66,66,0,1,0,1,0
9331,28,0,0,67,67,0,1,0,1,0
12444,28,0,0,70,70,0,1,0,1,0
11148,28,0,0,70,70,0,1,0,1,0
19071,28,0,0,67,67,0,1,0,1,0
10829,28,0,0,70,70,0,1,0,1,0
11489,28,0,0,70,70,0,1,0,1,0
19480,28,0,0,66,66,0,1,0,1,0
17409,28,0,0,70,70,0,1,0,1,0
17133,28,0,0,68,68,0,1,0,1,0
21907,28,0,0,66,66,0,1,0,1,0
17187,28,0,0,66,66,0,1,0,1,0
9921,28,0,0,70,70,0,1,0,1,0
14964,28,0,0,68,68,0,1,0,1,0
21911,28,0,0,70,70,0,1,0,1,0
11570,28,0,0,70,70,0,1,0,1,0
13374,28,0,0,66,66,0,1,0,1,0
17478,28,0,0,70,70,0,1,0,1,0
17687,28,0,0,70,70,0,1,0,1,0
20609,28,0,0,67,67,0,1,0,1,0
11720,28,0,0,70,70,0,1,0,1,0
19773,28,0,0,67,67,0,1,0,1,0
20742,28,0,0,66,66,0,1,0,1,0
9551,28,0,0,70,70,0,1,0,1,0
9131,28,0,0,66,66,0,1,0,1,0
13932,28,0,0,66,66,0,1,0,1,0
13626,28,0,0,70,70,0,1,0,1,0
21221,28,0,0,70,70,0,1,0,1,0
22274,28,0,0,66,66,0,1,0,1,0
14355,28,0,0,67,67,0,1,0,1,0
14478,28,0,0,66,66,0,1,0,1,0
9375,28,0,0,66,66,0,1,0,1,0
9722,28,0,0,69,69,0,1,0,1,0
9054,28,0,0,66,66,0,1,0,1,0
10161,28,0,0,70,70,0,1,0,1,0
9121,28,0,0,70,70,0,1,0,1,0
17549,28,0,0,66,66,0,1,0,1,0
11968,28,0,0,70,70,0,1,0,1,0
14314,28,0,0,70,70,0,1,0,1,0
19874,28,0,0,66,66,0,1,0,1,0
19310,28,0,0,70,70,0,1,0,1,0
13291,28,0,0,70,70,0,1,0,1,0
20481,28,0,0,70,70,0,1,0,1,0
19034,28,0,0,70,70,0,1,0,1,0
8978,28,0,0,70,70,0,1,0,1,0
14724,28,0,0,70,70,0,1,0,1,0
20891,28,0,0,70,70,0,1,0,1,0
19434,28,0,0,70,70,0,1,0,1,0
15814,28,0,0,70,70,0,1,0,1,0
12641,28,0,0,70,70,0,1,0,1,0
21597,28,0,0,70,70,0,1,0,1,0
9626,28,0,0,66,66,0,1,0,1,0
10820,28,0,0,70,70,0,1,0,1,0
16558,28,0,0,68,68,0,1,0,1,0
13818,28,0,0,70,70,0,1,0,1,0
20409,28,0,0,70,70,0,1,0,1,0
13063,28,0,0,66,66,0,1,0,1,0
12240,28,0,0,66,66,0,1,0,1,0
9050,28,0,0,70,70,0,1,0,1,0
12195,28,0,0,70,70,0,1,0,1,0
18003,28,0,0,70,70,0,1,0,1,0
19846,28,0,0,70,70,0,1,0,1,0
9133,28,0,0,66,66,0,1,0,1,0
16675,28,0,0,69,69,0,1,0,1,0
9688,28,0,0,70,70,0,1,0,1,0
8590,28,0,0,70,70,0,1,0,1,0
20663,28,0,0,70,70,0,1,0,1,0
22550,28,0,0,70,70,0,1,0,1,0
18798,28,0,0,69,69,0,1,0,1,0
22676,28,0,0,70,70,0,1,0,1,0
9957,28,0,0,66,66,0,1,0,1,0
11270,28,0,0,70,70,0,1,0,1,0
15108,28,0,0,69,69,0,1,0,1,0
19923,28,0,0,70,70,0,1,0,1,0
12750,28,0,0,67,67,0,1,0,1,0
17654,28,0,0,66,66,0,1,0,1,0
20240,28,0,0,70,70,0,1,0,1,0
15215,28,0,0,70,70,0,1,0,1,0
9131,28,0,0,66,66,0,1,0,1,0
11631,28,0,0,70,70,0,1,0,1,0
11183,28,0,0,66,66,0,1,0,1,0
19659,28,0,0,68,68,0,1,0,1,0
16809,28,0,0,66,66,0,1,0,1,0
10613,28,0,0,66,66,0,1,0,1,0
19151,28,0,0,66,66,0,1,0,1,0
20657,28,0,0,66,66,0,1,0,1,0
21652,28,0,0,68,68,0,1,0,1,0
21806,28,0,0,67,67,0,1,0,1,0
13688,28,0,0,66,66,0,1,0,1,0
20170,28,0,0,66,66,0,1,0,1,0
16887,28,0,0,70,70,0,1,0,1,0
12216,28,0,0,70,70,0,1,0,1,0
20426,28,0,0,70,70,0,1,0,1,0
12757,28,0,0,66,66,0,1,0,1,0
19093,28,0,0,70,70,0,1,0,1,0
21674,28,0,0,70,70,0,1,0,1,0
11460,28,0,0,66,66,0,1,0,1,0
19370,28,0,0,70,70,0,1,0,1,0
22053,28,0,0,67,67,0,1,0,1,0
10723,28,0,0,70,70,0,1,0,1,0
19623,28,0,0,70,70,0,1,0,1,0
18416,28,0,0,70,70,0,1,0,1,0
10976,28,0,0,70,70,0,1,0,1,0
11122,28,0,0,70,70,0,1,0,1,0
13068,28,0,0,70,70,0,1,0,1,0
9819,28,0,0,66,66,0,1,0,1,0
18893,28,0,0,66,66,0,1,0,1,0
12969,28,0,0,70,70,0,1,0,1,0
13308,28,0,0,70,70,0,1,0,1,0
12894,28,0,0,66,66,0,1,0,1,0
21034,28,0,0,70,70,0,1,0,1,0
8786,28,0,0,70,70,0,1,0,1,0
10186,28,0,0,70,70,0,1,0,1,0
9130,28,0,0,70,70,0,1,0,1,0
9964,28,0,0,70,70,0,1,0,1,0
15170,28,0,0,69,69,0,1,0,1,0
15128,28,0,0,70,70,0,1,0,1,0
16760,28,0,0,66,66,0,1,0,1,0
20399,28,0,0,70,70,0,1,0,1,0
18683,28,0,0,68,68,0,1,0,1,0
22118,28,0,0,70,70,0,1,0,1,0
9982,28,0,0,66,66,0,1,0,1,0
15692,28,0,0,70,70,0,1,0,1,0
8512,28,0,0,70,70,0,1,0,1,0
18973,28,0,0,66,66,0,1,0,1,0
14698,28,0,0,70,70,0,1,0,1,0
20229,28,0,0,67,67,0,1,0,1,0
10202,28,0,0,70,70,0,1,0,1,0
20207,28,0,0,69,69,0,1,0,1,0
10888,28,0,0,70,70,0,1,0,1,0
14939,28,0,0,70,70,0,1,0,1,0
9130,28,0,0,70,70,0,1,0,1,0
21689,28,0,0,66,66,0,1,0,1,0
9312,28,0,0,70,70,0,1,0,1,0
11239,28,0,0,69,69,0,1,0,1,0
13609,28,0,0,70,70,0,1,0,1,0
12313,28,0,0,70,70,0,1,0,1,0
19871,28,0,0,70,70,0,1,0,1,0
16248,28,0,0,70,70,0,1,0,1,0
15284,28,0,0,66,66,0,1,0,1,0
10500,28,0,0,66,66,0,1,0,1,0
15424,28,0,0,70,70,0,1,0,1,0
10606,28,0,0,69,69,0,1,0,1,0
13486,28,0,0,70,70,0,1,0,1,0
11094,28,0,0,70,70,0,1,0,1,0
12882,28,0,0,70,70,0,1,0,1,0
22037,28,0,0,70,70,0,1,0,1,0
13874,28,0,0,66,66,0,1,0,1,0
8339,28,0,0,69,69,0,1,0,1,0
14237,28,0,0,67,67,0,1,0,1,0
14025,28,0,0,70,70,0,1,0,1,0
9566,28,0,0,66,66,0,1,0,1,0
20208,28,0,0,70,70,0,1,0,1,0
21472,28,0,0,70,70,0,1,0,1,0
10654,28,0,0,70,70,0,1,0,1,0
17407,28,0,0,70,70,0,1,0,1,0
10252,28,0,0,70,70,0,1,0,1,0
8348,28,0,0,66,66,0,1,0,1,0
17412,28,0,0,66,66,0,1,0,1,0
18940,28,0,0,70,70,0,1,0,1,0
16024,28,0,0,66,66,0,1,0,1,0
9722,28,0,0,70,70,0,1,0,1,0
21184,28,0,0,70,70,0,1,0,1,0
18870,28,0,0,70,70,0,1,0,1,0
22160,28,0,0,70,70,0,1,0,1,0
8885,28,0,0,66,66,0,1,0,1,0
8551,28,0,0,67,67,0,1,0,1,0
17998,28,0,0,70,70,0,1,0,1,0
16667,28,0,0,70,70,0,1,0,1,0
19721,28,0,0,70,70,0,1,0,1,0
15063,28,0,0,70,70,0,1,0,1,0
17535,28,0,0,70,70,0,1,0,1,0
19006,28,0,0,70,70,0,1,0,1,0
20070,28,0,0,66,66,0,1,0,1,0
21711,28,0,0,66,66,0,1,0,1,0
8495,28,0,0,69,69,0,1,0,1,0
17597,28,0,0,66,66,0,1,0,1,0
18924,28,0,0,70,70,0,1,0,1,0
13429,28,0,0,70,70,0,1,0,1,0
15341,28,0,0,70,70,0,1,0,1,0
12439,28,0,0,70,70,0,1,0,1,0
9711,28,0,0,67,67,0,1,0,1,0
21553,28,0,0,66,66,0,1,0,1,0
9558,28,0,0,66,66,0,1,0,1,0
13083,28,0,0,67,67,0,1,0,1,0
10519,28,0,0,66,66,0,1,0,1,0
9317,28,0,0,66,66,0,1,0,1,0
9909,28,0,0,70,70,0,1,0,1,0
15327,28,0,0,70,70,0,1,0,1,0
20939,28,0,0,70,70,0,1,0,1,0
17655,28,0,0,70,70,0,1,0,1,0
15751,28,0,0,70,70,0,1,0,1,0
19791,28,0,0,66,66,0,1,0,1,0
15447,28,0,0,70,70,0,1,0,1,0
13070,28,0,0,70,70,0,1,0,1,0
19982,28,0,0,67,67,0,1,0,1,0
14292,28,0,0,70,70,0,1,0,1,0
22073,28,0,0,66,66,0,1,0,1,0
10657,28,0,0,70,70,0,1,0,1,0
10687,28,0,0,66,66,0,1,0,1,0
15097,28,0,0,66,66,0,1,0,1,0
9495,28,0,0,66,66,0,1,0,1,0
20041,28,0,0,69,69,0,1,0,1,0
15682,28,0,0,70,70,0,1,0,1,0
20712,28,0,0,70,70,0,1,0,1,0
17994,28,0,0,70,70,0,1,0,1,0
10474,28,0,0,70,70,0,1,0,1,0
16252,28,0,0,70,70,0,1,0,1,0
14400,28,0,0,70,70,0,1,0,1,0
15960,28,0,0,67,67,0,1,0,1,0
21536,28,0,0,70,70,0,1,0,1,0
20940,28,0,0,70,70,0,1,0,1,0
20316,28,0,0,70,70,0,1,0,1,0
10586,28,0,0,70,70,0,1,0,1,0
11728,28,0,0,70,70,0,1,0,1,0
10160,28,0,0,70,70,0,1,0,1,0
19143,28,0,0,70,70,0,1,0,1,0
12110,28,0,0,70,70,0,1,0,1,0
9221,28,0,0,70,70,0,1,0,1,0
17189,28,0,0,66,66,0,1,0,1,0
13704,28,0,0,70,70,0,1,0,1,0
10199,28,0,0,70,70,0,1,0,1,0
20761,28,0,0,70,70,0,1,0,1,0
21664,28,0,0,66,66,0,1,0,1,0
16828,28,0,0,69,69,0,1,0,1,0
20291,28,0,0,66,66,0,1,0,1,0
14425,28,0,0,70,70,0,1,0,1,0
19856,28,0,0,66,66,0,1,0,1,0
19397,28,0,0,70,70,0,1,0,1,0
10150,28,0,0,70,70,0,1,0,1,0
22336,28,0,0,66,66,0,1,0,1,0
9564,28,0,0,70,70,0,1,0,1,0
21434,28,0,0,70,70,0,1,0,1,0
20544,28,0,0,66,66,0,1,0,1,0
15227,28,0,0,69,69,0,1,0,1,0
13620,28,0,0,66,66,0,1,0,1,0
16651,28,0,0,66,66,0,1,0,1,0
9850,28,0,0,70,70,0,1,0,1,0
11366,28,0,0,70,70,0,1,0,1,0
10143,28,0,0,70,70,0,1,0,1,0
17202,28,0,0,70,70,0,1,0,1,0
10528,28,0,0,70,70,0,1,0,1,0
16685,28,0,0,70,70,0,1,0,1,0
21328,28,0,0,70,70,0,1,0,1,0
11043,28,0,0,70,70,0,1,0,1,0
12231,28,0,0,70,70,0,1,0,1,0
19412,28,0,0,66,66,0,1,0,1,0
20405,28,0,0,70,70,0,1,0,1,0
12800,28,0,0,70,70,0,1,0,1,0
14756,28,0,0,70,70,0,1,0,1,0
18333,28,0,0,67,67,0,1,0,1,0
12619,28,0,0,70,70,0,1,0,1,0
18111,28,0,0,70,70,0,1,0,1,0
16899,28,0,0,66,66,0,1,0,1,0
18842,28,0,0,70,70,0,1,0,1,0
10280,28,0,0,70,70,0,1,0,1,0
16303,28,0,0,70,70,0,1,0,1,0
12992,28,0,0,70,70,0,1,0,1,0
10890,28,0,0,70,70,0,1,0,1,0
12013,28,0,0,70,70,0,1,0,1,0
22177,28,0,0,70,70,0,1,0,1,0
17783,28,0,0,66,66,0,1,0,1,0
13051,28,0,0,70,70,0,1,0,1,0
16757,28,0,0,68,68,0,1,0,1,0
20171,28,0,0,70,70,0,1,0,1,0
10161,28,0,0,70,70,0,1,0,1,0
15552,28,0,0,70,70,0,1,0,1,0
20525,28,0,0,66,66,0,1,0,1,0
10987,28,0,0,66,66,0,1,0,1,0
14104,28,0,0,70,70,0,1,0,1,0
21934,28,0,0,70,70,0,1,0,1,0
22543,28,0,0,66,66,0,1,0,1,0
22501,28,0,0,70,70,0,1,0,1,0
13806,28,0,0,66,66,0,1,0,1,0
11012,28,0,0,70,70,0,1,0,1,0
16832,28,0,0,69,69,0,1,0,1,0
19568,28,0,0,67,67,0,1,0,1,0
17525,28,0,0,67,67,0,1,0,1,0
10975,28,0,0,70,70,0,1,0,1,0
13270,28,0,0,70,70,0,1,0,1,0
13046,28,0,0,66,66,0,1,0,1,0
9273,28,0,0,70,70,0,1,0,1,0
20233,28,0,0,70,70,0,1,0,1,0
16982,28,0,0,66,66,0,1,0,1,0
19181,28,0,0,70,70,0,1,0,1,0
18646,28,0,0,70,70,0,1,0,1,0
16995,28,0,0,68,68,0,1,0,1,0
20272,28,0,0,67,67,0,1,0,1,0
17639,28,0,0,66,66,0,1,0,1,0
10752,28,0,0,70,70,0,1,0,1,0
21680,28,0,0,70,70,0,1,0,1,0
21442,28,0,0,70,70,0,1,0,1,0
14305,28,0,0,70,70,0,1,0,1,0
13100,28,0,0,66,66,0,1,0,1,0
12479,28,0,0,70,70,0,1,0,1,0
14077,28,0,0,70,70,0,1,0,1,0
9571,28,0,0,70,70,0,1,0,1,0
10201,28,0,0,70,70,0,1,0,1,0
12852,28,0,0,70,70,0,1,0,1,0
14606,28,0,0,70,70,0,1,0,1,0
21088,28,0,0,70,70,0,1,0,1,0
9542,28,0,0,70,70,0,1,0,1,0
9159,28,0,0,70,70,0,1,0,1,0
15362,28,0,0,66,66,0,1,0,1,0
17878,28,0,0,67,67,0,1,0,1,0
14147,28,0,0,70,70,0,1,0,1,0
21982,28,0,0,66,66,0,1,0,1,0
22434,28,0,0,70,70,0,1,0,1,0
17402,28,0,0,66,66,0,1,0,1,0
15603,28,0,0,70,70,0,1,0,1,0
15807,28,0,0,69,69,0,1,0,1,0
10412,28,0,0,70,70,0,1,0,1,0
9052,28,0,0,70,70,0,1,0,1,0
20843,28,0,0,70,70,0,1,0,1,0
9561,28,0,0,66,66,0,1,0,1,0
11395,28,0,0,66,66,0,1,0,1,0
14123,28,0,0,70,70,0,1,0,1,0
10374,28,0,0,70,70,0,1,0,1,0
16898,28,0,0,70,70,0,1,0,1,0
9625,28,0,0,66,66,0,1,0,1,0
13715,28,0,0,70,70,0,1,0,1,0
19961,28,0,0,66,66,0,1,0,1,0
15718,28,0,0,66,66,0,1,0,1,0
11793,28,0,0,66,66,0,1,0,1,0
11601,28,0,0,68,68,0,1,0,1,0
18368,28,0,0,70,70,0,1,0,1,0
13164,28,0,0,70,70,0,1,0,1,0
8686,28,0,0,70,70,0,1,0,1,0
19953,28,0,0,70,70,0,1,0,1,0
19774,28,0,0,66,66,0,1,0,1,0
16689,28,0,0,70,70,0,1,0,1,0
16121,28,0,0,66,66,0,1,0,1,0
20234,28,0,0,70,70,0,1,0,1,0
19945,28,0,0,70,70,0,1,0,1,0
17835,28,0,0,66,66,0,1,0,1,0
9000,28,0,0,70,70,0,1,0,1,0
13308,28,0,0,70,70,0,1,0,1,0
9274,28,0,0,70,70,0,1,0,1,0
16175,28,0,0,70,70,0,1,0,1,0
20023,28,0,0,66,66,0,1,0,1,0
11042,28,0,0,70,70,0,1,0,1,0
19870,28,0,0,70,70,0,1,0,1,0
15669,28,0,0,70,70,0,1,0,1,0
17169,28,0,0,68,68,0,1,0,1,0
10380,28,0,0,70,70,0,1,0,1,0
19238,28,0,0,66,66,0,1,0,1,0
21357,28,0,0,67,67,0,1,0,1,0
17265,28,0,0,70,70,0,1,0,1,0
18437,28,0,0,70,70,0,1,0,1,0
13723,28,0,0,70,70,0,1,0,1,0
21036,28,0,0,70,70,0,1,0,1,0
16387,28,0,0,66,66,0,1,0,1,0
12655,28,0,0,70,70,0,1,0,1,0
12354,28,0,0,70,70,0,1,0,1,0
10289,28,0,0,67,67,0,1,0,1,0
22214,28,0,0,66,66,0,1,0,1,0
22632,28,0,0,70,70,0,1,0,1,0
12144,28,0,0,70,70,0,1,0,1,0
14499,28,0,0,69,69,0,1,0,1,0
18535,28,0,0,70,70,0,1,0,1,0
10222,28,0,0,66,66,0,1,0,1,0
16222,28,0,0,70,70,0,1,0,1,0
21607,28,0,0,66,66,0,1,0,1,0
8376,28,0,0,70,70,0,1,0,1,0
17674,28,0,0,70,70,0,1,0,1,0
9497,28,0,0,66,66,0,1,0,1,0
8675,28,0,0,66,66,0,1,0,1,0
20690,28,0,0,66,66,0,1,0,1,0
13623,28,0,0,66,66,0,1,0,1,0
18623,28,0,0,70,70,0,1,0,1,0
20099,28,0,0,70,70,0,1,0,1,0
13868,28,0,0,66,66,0,1,0,1,0
17343,28,0,0,70,70,0,1,0,1,0
22194,28,0,0,67,67,0,1,0,1,0
10173,28,0,0,66,66,0,1,0,1,0
20581,28,0,0,70,70,0,1,0,1,0
17678,28,0,0,70,70,0,1,0,1,0
11595,28,0,0,70,70,0,1,0,1,0
11326,28,0,0,70,70,0,1,0,1,0
13485,28,0,0,70,70,0,1,0,1,0
19101,28,0,0,70,70,0,1,0,1,0
20045,28,0,0,66,66,0,1,0,1,0
21201,28,0,0,69,69,0,1,0,1,0
9323,28,0,0,70,70,0,1,0,1,0
18661,28,0,0,70,70,0,1,0,1,0
20268,28,0,0,70,70,0,1,0,1,0
11623,28,0,0,66,66,0,1,0,1,0
16721,28,0,0,70,70,0,1,0,1,0
19220,28,0,0,70,70,0,1,0,1,0
10357,28,0,0,70,70,0,1,0,1,0
9768,28,0,0,70,70,0,1,0,1,0
17402,28,0,0,66,66,0,1,0,1,0
17237,28,0,0,66,66,0,1,0,1,0
15034,28,0,0,66,66,0,1,0,1,0
12003,28,0,0,67,67,0,1,0,1,0
16931,28,0,0,66,66,0,1,0,1,0
9540,28,0,0,70,70,0,1,0,1,0
14189,28,0,0,67,67,0,1,0,1,0
20676,28,0,0,70,70,0,1,0,1,0
9070,28,0,0,70,70,0,1,0,1,0
20739,28,0,0,66,66,0,1,0,1,0
9668,28,0,0,68,68,0,1,0,1,0
18140,28,0,0,70,70,0,1,0,1,0
16897,28,0,0,70,70,0,1,0,1,0
20293,28,0,0,66,66,0,1,0,1,0
18893,28,0,0,70,70,0,1,0,1,0
14347,28,0,0,70,70,0,1,0,1,0
19087,28,0,0,66,66,0,1,0,1,0
22457,28,0,0,66,66,0,1,0,1,0
20647,28,0,0,70,70,0,1,0,1,0
19293,28,0,0,67,67,0,1,0,1,0
10194,28,0,0,66,66,0,1,0,1,0
22567,28,0,0,66,66,0,1,0,1,0
8721,28,0,0,70,70,0,1,0,1,0
8792,28,0,0,70,70,0,1,0,1,0
14663,28,0,0,66,66,0,1,0,1,0
19048,28,0,0,70,70,0,1,0,1,0
15056,28,0,0,70,70,0,1,0,1,0
15030,28,0,0,66,66,0,1,0,1,0
20396,28,0,0,67,67,0,1,0,1,0
22075,28,0,0,66,66,0,1,0,1,0
17659,28,0,0,70,70,0,1,0,1,0
15640,28,0,0,70,70,0,1,0,1,0
21769,28,0,0,70,70,0,1,0,1,0
11144,28,0,0,70,70,0,1,0,1,0
14089,28,0,0,70,70,0,1,0,1,0
21555,28,0,0,70,70,0,1,0,1,0
12565,28,0,0,70,70,0,1,0,1,0
17243,28,0,0,66,66,0,1,0,1,0
21852,28,0,0,68,68,0,1,0,1,0
15534,28,0,0,66,66,0,1,0,1,0
18438,28,0,0,68,68,0,1,0,1,0
21137,28,0,0,70,70,0,1,0,1,0
18239,28,0,0,68,68,0,1,0,1,0
18023,28,0,0,66,66,0,1,0,1,0
14024,28,0,0,70,70,0,1,0,1,0
9101,28,0,0,70,70,0,1,0,1,0
9999,28,0,0,70,70,0,1,0,1,0
22213,28,0,0,70,70,0,1,0,1,0
9487,28,0,0,70,70,0,1,0,1,0
20444,28,0,0,66,66,0,1,0,1,0
10057,28,0,0,70,70,0,1,0,1,0
16031,28,0,0,68,68,0,1,0,1,0
21406,28,0,0,70,70,0,1,0,1,0
15777,28,0,0,66,66,0,1,0,1,0
17334,28,0,0,70,70,0,1,0,1,0
8588,28,0,0,70,70,0,1,0,1,0
9184,28,0,0,70,70,0,1,0,1,0
17042,28,0,0,70,70,0,1,0,1,0
8742,28,0,0,70,70,0,1,0,1,0
19199,28,0,0,66,66,0,1,0,1,0
14496,28,0,0,70,70,0,1,0,1,0
10337,28,0,0,70,70,0,1,0,1,0
11146,28,0,0,66,66,0,1,0,1,0
9346,28,0,0,70,70,0,1,0,1,0
10626,28,0,0,70,70,0,1,0,1,0
14175,28,0,0,70,70,0,1,0,1,0
22403,28,0,0,70,70,0,1,0,1,0
21673,28,0,0,70,70,0,1,0,1,0
17958,28,0,0,70,70,0,1,0,1,0
15329,28,0,0,70,70,0,1,0,1,0
17334,28,0,0,70,70,0,1,0,1,0
12376,28,0,0,70,70,0,1,0,1,0
19501,28,0,0,70,70,0,1,0,1,0
10541,28,0,0,70,70,0,1,0,1,0
19883,28,0,0,69,69,0,1,0,1,0
19672,28,0,0,66,66,0,1,0,1,0
14273,28,0,0,70,70,0,1,0,1,0
12873,28,0,0,70,70,0,1,0,1,0
12620,28,0,0,70,70,0,1,0,1,0
13690,28,0,0,66,66,0,1,0,1,0
11997,28,0,0,68,68,0,1,0,1,0
20825,28,0,0,66,66,0,1,0,1,0
19310,28,0,0,69,69,0,1,0,1,0
22356,28,0,0,70,70,0,1,0,1,0
17853,28,0,0,66,66,0,1,0,1,0
11316,28,0,0,69,69,0,1,0,1,0
20445,28,0,0,67,67,0,1,0,1,0
12454,28,0,0,69,69,0,1,0,1,0
15094,28,0,0,69,69,0,1,0,1,0
21797,28,0,0,70,70,0,1,0,1,0
12354,28,0,0,70,70,0,1,0,1,0
9443,28,0,0,67,67,0,1,0,1,0
18825,28,0,0,70,70,0,1,0,1,0
22159,28,0,0,70,70,0,1,0,1,0
21542,28,0,0,70,70,0,1,0,1,0
17897,28,0,0,70,70,0,1,0,1,0
17673,28,0,0,70,70,0,1,0,1,0
19894,28,0,0,70,70,0,1,0,1,0
10098,28,0,0,70,70,0,1,0,1,0
10185,28,0,0,66,66,0,1,0,1,0
12181,28,0,0,66,66,0,1,0,1,0
10441,28,0,0,67,67,0,1,0,1,0
16234,28,0,0,66,66,0,1,0,1,0
16798,28,0,0,66,66,0,1,0,1,0
15447,28,0,0,70,70,0,1,0,1,0
16425,28,0,0,70,70,0,1,0,1,0
16626,28,0,0,69,69,0,1,0,1,0
9484,28,0,0,66,66,0,1,0,1,0
11394,28,0,0,66,66,0,1,0,1,0
19696,28,0,0,70,70,0,1,0,1,0
14181,28,0,0,69,69,0,1,0,1,0
14985,28,0,0,70,70,0,1,0,1,0
9688,28,0,0,66,66,0,1,0,1,0
13329,28,0,0,70,70,0,1,0,1,0
8977,28,0,0,70,70,0,1,0,1,0
9706,28,0,0,66,66,0,1,0,1,0
15076,28,0,0,69,69,0,1,0,1,0
17677,28,0,0,70,70,0,1,0,1,0
11368,28,0,0,70,70,0,1,0,1,0
21823,28,0,0,70,70,0,1,0,1,0
13169,28,0,0,70,70,0,1,0,1,0
20760,28,0,0,70,70,0,1,0,1,0
11942,28,0,0,66,66,0,1,0,1,0
14711,28,0,0,66,66,0,1,0,1,0
19172,28,0,0,70,70,0,1,0,1,0
11685,28,0,0,70,70,0,1,0,1,0
22210,28,0,0,69,69,0,1,0,1,0
19744,28,0,0,69,69,0,1,0,1,0
12779,28,0,0,66,66,0,1,0,1,0
9555,28,0,0,70,70,0,1,0,1,0
21219,28,0,0,70,70,0,1,0,1,0
14545,28,0,0,70,70,0,1,0,1,0
19093,28,0,0,70,70,0,1,0,1,0
14363,28,0,0,67,67,0,1,0,1,0
9521,28,0,0,70,70,0,1,0,1,0
20844,28,0,0,70,70,0,1,0,1,0
21201,28,0,0,69,69,0,1,0,1,0
22469,28,0,0,66,66,0,1,0,1,0
18082,28,0,0,70,70,0,1,0,1,0
22137,28,0,0,70,70,0,1,0,1,0
12179,28,0,0,70,70,0,1,0,1,0
16876,28,0,0,70,70,0,1,0,1,0
13610,28,0,0,70,70,0,1,0,1,0
9690,28,0,0,66,66,0,1,0,1,0
20049,28,0,0,70,70,0,1,0,1,0
13078,28,0,0,68,68,0,1,0,1,0
22151,28,0,0,68,68,0,1,0,1,0
20952,28,0,0,70,70,0,1,0,1,0
16032,28,0,0,70,70,0,1,0,1,0
9713,28,0,0,69,69,0,1,0,1,0
19050,28,0,0,69,69,0,1,0,1,0
9087,28,0,0,69,69,0,1,0,1,0
15788,28,0,0,70,70,0,1,0,1,0
17634,28,0,0,70,70,0,1,0,1,0
20263,28,0,0,70,70,0,1,0,1,0
16268,28,0,0,70,70,0,1,0,1,0
17311,28,0,0,66,66,0,1,0,1,0
14976,28,0,0,69,69,0,1,0,1,0
19760,28,0,0,67,67,0,1,0,1,0
16248,28,0,0,70,70,0,1,0,1,0
20685,28,0,0,70,70,0,1,0,1,0
14619,28,0,0,68,68,0,1,0,1,0
9067,28,0,0,70,70,0,1,0,1,0
8684,28,0,0,69,69,0,1,0,1,0
11367,28,0,0,70,70,0,1,0,1,0
9508,28,0,0,69,69,0,1,0,1,0
10079,28,0,0,70,70,0,1,0,1,0
14009,28,0,0,68,68,0,1,0,1,0
21834,28,0,0,69,69,0,1,0,1,0
16944,28,0,0,68,68,0,1,0,1,0
11806,28,0,0,70,70,0,1,0,1,0
17126,28,0,0,66,66,0,1,0,1,0
10174,28,0,0,66,66,0,1,0,1,0
17593,28,0,0,70,70,0,1,0,1,0
15505,28,0,0,70,70,0,1,0,1,0
17264,28,0,0,69,69,0,1,0,1,0
20587,28,0,0,70,70,0,1,0,1,0
15676,28,0,0,70,70,0,1,0,1,0
12853,28,0,0,70,70,0,1,0,1,0
22082,28,0,0,70,70,0,1,0,1,0
11833,28,0,0,66,66,0,1,0,1,0
18089,28,0,0,70,70,0,1,0,1,0
22710,28,0,0,66,66,0,1,0,1,0
12526,28,0,0,66,66,0,1,0,1,0
15683,28,0,0,69,69,0,1,0,1,0
11632,28,0,0,70,70,0,1,0,1,0
12187,28,0,0,70,70,0,1,0,1,0
12669,28,0,0,68,68,0,1,0,1,0
14602,28,0,0,66,66,0,1,0,1,0
20500,28,0,0,70,70,0,1,0,1,0
16396,28,0,0,70,70,0,1,0,1,0
19923,28,0,0,70,70,0,1,0,1,0
9599,28,0,0,70,70,0,1,0,1,0
18874,28,0,0,67,67,0,1,0,1,0
14119,28,0,0,70,70,0,1,0,1,0
12754,28,0,0,67,67,0,1,0,1,0
11114,28,0,0,70,70,0,1,0,1,0
15134,28,0,0,68,68,0,1,0,1,0
16222,28,0,0,70,70,0,1,0,1,0
17457,28,0,0,66,66,0,1,0,1,0
13367,28,0,0,70,70,0,1,0,1,0
12077,28,0,0,69,69,0,1,0,1,0
20158,28,0,0,67,67,0,1,0,1,0
13323,28,0,0,66,66,0,1,0,1,0
11117,28,0,0,66,66,0,1,0,1,0
17292,28,0,0,66,66,0,1,0,1,0
10275,28,0,0,68,68,0,1,0,1,0
10286,28,0,0,70,70,0,1,0,1,0
17654,28,0,0,70,70,0,1,0,1,0
12175,28,0,0,70,70,0,1,0,1,0
16911,28,0,0,67,67,0,1,0,1,0
20420,28,0,0,66,66,0,1,0,1,0
19511,28,0,0,70,70,0,1,0,1,0
13901,28,0,0,70,70,0,1,0,1,0
10349,28,0,0,66,66,0,1,0,1,0
9170,28,0,0,70,70,0,1,0,1,0
11622,28,0,0,68,68,0,1,0,1,0
18569,28,0,0,66,66,0,1,0,1,0
13609,28,0,0,70,70,0,1,0,1,0
14458,28,0,0,70,70,0,1,0,1,0
13064,28,0,0,70,70,0,1,0,1,0
17586,28,0,0,70,70,0,1,0,1,0
12882,28,0,0,70,70,0,1,0,1,0
11327,28,0,0,70,70,0,1,0,1,0
8434,28,0,0,68,68,0,1,0,1,0
22701,28,0,0,70,70,0,1,0,1,0
11798,28,0,0,67,67,0,1,0,1,0
10612,28,0,0,66,66,0,1,0,1,0
16362,28,0,0,70,70,0,1,0,1,0
11585,28,0,0,70,70,0,1,0,1,0
19846,28,0,0,70,70,0,1,0,1,0
10344,28,0,0,66,66,0,1,0,1,0
11327,28,0,0,70,70,0,1,0,1,0
11604,28,0,0,67,67,0,1,0,1,0
21681,28,0,0,70,70,0,1,0,1,0
9836,28,0,0,70,70,0,1,0,1,0
8448,28,0,0,70,70,0,1,0,1,0
16234,28,0,0,70,70,0,1,0,1,0
20528,28,0,0,66,66,0,1,0,1,0
18438,28,0,0,70,70,0,1,0,1,0
11855,28,0,0,70,70,0,1,0,1,0
22277,28,0,0,70,70,0,1,0,1,0
11901,28,0,0,68,68,0,1,0,1,0
18964,28,0,0,70,70,0,1,0,1,0
22097,28,0,0,70,70,0,1,0,1,0
21374,28,0,0,70,70,0,1,0,1,0
16379,28,0,0,69,69,0,1,0,1,0
16780,28,0,0,66,66,0,1,0,1,0
18069,28,0,0,70,70,0,1,0,1,0
10011,28,0,0,70,70,0,1,0,1,0
14152,28,0,0,70,70,0,1,0,1,0
16596,28,0,0,70,70,0,1,0,1,0
8733,28,0,0,70,70,0,1,0,1,0
9607,28,0,0,70,70,0,1,0,1,0
21796,28,0,0,70,70,0,1,0,1,0
14817,28,0,0,70,70,0,1,0,1,0
17390,28,0,0,70,70,0,1,0,1,0
19880,28,0,0,70,70,0,1,0,1,0
15988,28,0,0,69,69,0,1,0,1,0
10407,28,0,0,70,70,0,1,0,1,0
20951,28,0,0,70,70,0,1,0,1,0
20591,28,0,0,70,70,0,1,0,1,0
14172,28,0,0,70,70,0,1,0,1,0
15683,28,0,0,70,70,0,1,0,1,0
17282,28,0,0,70,70,0,1,0,1,0
18353,28,0,0,66,66,0,1,0,1,0
17758,28,0,0,70,70,0,1,0,1,0
19654,28,0,0,66,66,0,1,0,1,0
12991,28,0,0,70,70,0,1,0,1,0
13932,28,0,0,70,70,0,1,0,1,0
13828,28,0,0,70,70,0,1,0,1,0
11042,28,0,0,69,69,0,1,0,1,0
14893,28,0,0,69,69,0,1,0,1,0
17584,28,0,0,66,66,0,1,0,1,0
21409,28,0,0,70,70,0,1,0,1,0
18354,28,0,0,70,70,0,1,0,1,0
17090,28,0,0,70,70,0,1,0,1,0
19824,28,0,0,70,70,0,1,0,1,0
10038,28,0,0,70,70,0,1,0,1,0
20840,28,0,0,70,70,0,1,0,1,0
13045,28,0,0,66,66,0,1,0,1,0
17944,28,0,0,70,70,0,1,0,1,0
13109,28,0,0,66,66,0,1,0,1,0
9897,28,0,0,70,70,0,1,0,1,0
9530,28,0,0,70,70,0,1,0,1,0
15284,28,0,0,66,66,0,1,0,1,0
15772,28,0,0,70,70,0,1,0,1,0
9931,28,0,0,68,68,0,1,0,1,0
9343,28,0,0,70,70,0,1,0,1,0
12132,28,0,0,66,66,0,1,0,1,0
20066,28,0,0,66,66,0,1,0,1,0
14910,28,0,0,70,70,0,1,0,1,0
20578,28,0,0,70,70,0,1,0,1,0
10009,28,0,0,70,70,0,1,0,1,0
18819,28,0,0,66,66,0,1,0,1,0
17977,28,0,0,70,70,0,1,0,1,0
11360,28,0,0,66,66,0,1,0,1,0
17633,28,0,0,70,70,0,1,0,1,0
11958,28,0,0,70,70,0,1,0,1,0
13567,28,0,0,66,66,0,1,0,1,0
17876,28,0,0,70,70,0,1,0,1,0
17288,28,0,0,67,67,0,1,0,1,0
15447,28,0,0,70,70,0,1,0,1,0
16395,28,0,0,66,66,0,1,0,1,0
13431,28,0,0,66,66,0,1,0,1,0
11404,28,0,0,66,66,0,1,0,1,0
13826,28,0,0,70,70,0,1,0,1,0
14989,28,0,0,70,70,0,1,0,1,0
8867,28,0,0,70,70,0,1,0,1,0
12975,28,0,0,66,66,0,1,0,1,0
19955,28,0,0,70,70,0,1,0,1,0
14210,28,0,0,70,70,0,1,0,1,0
11779,28,0,0,70,70,0,1,0,1,0
10691,28,0,0,69,69,0,1,0,1,0
11360,28,0,0,66,66,0,1,0,1,0
18662,28,0,0,70,70,0,1,0,1,0
16926,28,0,0,70,70,0,1,0,1,0
13229,28,0,0,66,66,0,1,0,1,0
19095,28,0,0,70,70,0,1,0,1,0
9883,28,0,0,66,66,0,1,0,1,0
21279,28,0,0,70,70,0,1,0,1,0
21997,28,0,0,70,70,0,1,0,1,0
20221,28,0,0,70,70,0,1,0,1,0
19453,28,0,0,70,70,0,1,0,1,0
21287,28,0,0,70,70,0,1,0,1,0
17831,28,0,0,66,66,0,1,0,1,0
20967,28,0,0,66,66,0,1,0,1,0
15088,28,0,0,70,70,0,1,0,1,0
18920,28,0,0,70,70,0,1,0,1,0
11041,28,0,0,70,70,0,1,0,1,0
22043,28,0,0,70,70,0,1,0,1,0
20397,28,0,0,70,70,0,1,0,1,0
16430,28,0,0,68,68,0,1,0,1,0
8403,28,0,0,70,70,0,1,0,1,0
15745,28,0,0,67,67,0,1,0,1,0
22445,28,0,0,70,70,0,1,0,1,0
20537,28,0,0,69,69,0,1,0,1,0
17518,28,0,0,66,66,0,1,0,1,0
16594,28,0,0,69,69,0,1,0,1,0
16251,28,0,0,70,70,0,1,0,1,0
10342,28,0,0,66,66,0,1,0,1,0
11932,28,0,0,68,68,0,1,0,1,0
11515,28,0,0,70,70,0,1,0,1,0
19314,28,0,0,66,66,0,1,0,1,0
12658,28,0,0,66,66,0,1,0,1,0
20476,28,0,0,68,68,0,1,0,1,0
17419,28,0,0,70,70,0,1,0,1,0
16192,28,0,0,70,70,0,1,0,1,0
16672,28,0,0,70,70,0,1,0,1,0
16738,28,0,0,70,70,0,1,0,1,0
14114,28,0,0,69,69,0,1,0,1,0
22163,28,0,0,70,70,0,1,0,1,0
10044,28,0,0,66,66,0,1,0,1,0
13934,28,0,0,66,66,0,1,0,1,0
18312,28,0,0,66,66,0,1,0,1,0
12600,28,0,0,70,70,0,1,0,1,0
11984,28,0,0,66,66,0,1,0,1,0
11670,28,0,0,70,70,0,1,0,1,0
15310,28,0,0,70,70,0,1,0,1,0
14001,28,0,0,70,70,0,1,0,1,0
22045,28,0,0,70,70,0,1,0,1,0
15291,28,0,0,70,70,0,1,0,1,0
10224,28,0,0,66,66,0,1,0,1,0
9056,28,0,0,70,70,0,1,0,1,0
15756,28,0,0,70,70,0,1,0,1,0
19588,28,0,0,70,70,0,1,0,1,0
15662,28,0,0,70,70,0,1,0,1,0
20982,28,0,0,70,70,0,1,0,1,0
18563,28,0,0,67,67,0,1,0,1,0
12174,28,0,0,70,70,0,1,0,1,0
8716,28,0,0,70,70,0,1,0,1,0
10380,28,0,0,70,70,0,1,0,1,0
15359,28,0,0,68,68,0,1,0,1,0
10890,28,0,0,70,70,0,1,0,1,0
15087,28,0,0,70,70,0,1,0,1,0
12769,28,0,0,70,70,0,1,0,1,0
21753,28,0,0,70,70,0,1,0,1,0
8563,28,0,0,69,69,0,1,0,1,0
13456,28,0,0,66,66,0,1,0,1,0
9482,28,0,0,66,66,0,1,0,1,0
19909,28,0,0,70,70,0,1,0,1,0
17538,28,0,0,69,69,0,1,0,1,0
21567,28,0,0,70,70,0,1,0,1,0
19004,28,0,0,70,70,0,1,0,1,0
16445,28,0,0,70,70,0,1,0,1,0
13532,28,0,0,69,69,0,1,0,1,0
16880,28,0,0,70,70,0,1,0,1,0
20490,28,0,0,69,69,0,1,0,1,0
21353,28,0,0,70,70,0,1,0,1,0
17541,28,0,0,66,66,0,1,0,1,0
17756,28,0,0,70,70,0,1,0,1,0
21404,28,0,0,70,70,0,1,0,1,0
21823,28,0,0,70,70,0,1,0,1,0
17423,28,0,0,68,68,0,1,0,1,0
12417,28,0,0,70,70,0,1,0,1,0
9747,28,0,0,66,66,0,1,0,1,0
21909,28,0,0,66,66,0,1,0,1,0
19099,28,0,0,70,70,0,1,0,1,0
16028,28,0,0,66,66,0,1,0,1,0
10015,28,0,0,66,66,0,1,0,1,0
18628,28,0,0,70,70,0,1,0,1,0
9792,28,0,0,70,70,0,1,0,1,0
15794,28,0,0,70,70,0,1,0,1,0
13110,28,0,0,66,66,0,1,0,1,0
14900,28,0,0,70,70,0,1,0,1,0
13571,28,0,0,66,66,0,1,0,1,0
11945,28,0,0,70,70,0,1,0,1,0
21164,28,0,0,70,70,0,1,0,1,0
16403,28,0,0,66,66,0,1,0,1,0
18170,28,0,0,66,66,0,1,0,1,0
19823,28,0,0,70,70,0,1,0,1,0
9626,28,0,0,66,66,0,1,0,1,0
13413,28,0,0,70,70,0,1,0,1,0
15610,28,0,0,70,70,0,1,0,1,0
8947,28,0,0,70,70,0,1,0,1,0
15215,28,0,0,70,70,0,1,0,1,0
9840,28,0,0,67,67,0,1,0,1,0
16008,28,0,0,70,70,0,1,0,1,0
10909,28,0,0,70,70,0,1,0,1,0
9526,28,0,0,70,70,0,1,0,1,0
17310,28,0,0,66,66,0,1,0,1,0
15834,28,0,0,68,68,0,1,0,1,0
19840,28,0,0,70,70,0,1,0,1,0
20791,28,0,0,66,66,0,1,0,1,0
10717,28,0,0,70,70,0,1,0,1,0
11285,28,0,0,70,70,0,1,0,1,0
11435,28,0,0,70,70,0,1,0,1,0
16464,28,0,0,68,68,0,1,0,1,0
19114,28,0,0,70,70,0,1,0,1,0
9562,28,0,0,70,70,0,1,0,1,0
14801,28,0,0,69,69,0,1,0,1,0
18174,28,0,0,68,68,0,1,0,1,0
21120,28,0,0,66,66,0,1,0,1,0
8780,28,0,0,66,66,0,1,0,1,0
16326,28,0,0,66,66,0,1,0,1,0
17058,28,0,0,66,66,0,1,0,1,0
12729,28,0,0,70,70,0,1,0,1,0
18538,28,0,0,67,67,0,1,0,1,0
22028,28,0,0,66,66,0,1,0,1,0
16866,28,0,0,70,70,0,1,0,1,0
17160,28,0,0,70,70,0,1,0,1,0
21162,28,0,0,70,70,0,1,0,1,0
11302,28,0,0,66,66,0,1,0,1,0
21037,28,0,0,70,70,0,1,0,1,0
16636,28,0,0,70,70,0,1,0,1,0
22450,28,0,0,70,70,0,1,0,1,0
12415,28,0,0,68,68,0,1,0,1,0
10352,28,0,0,68,68,0,1,0,1,0
15278,28,0,0,70,70,0,1,0,1,0
18835,28,0,0,66,66,0,1,0,1,0
17152,28,0,0,70,70,0,1,0,1,0
13576,28,0,0,70,70,0,1,0,1,0
18185,28,0,0,70,70,0,1,0,1,0
18345,28,0,0,70,70,0,1,0,1,0
13329,28,0,0,70,70,0,1,0,1,0
9529,28,0,0,70,70,0,1,0,1,0
20252,28,0,0,69,69,0,1,0,1,0
10911,28,0,0,66,66,0,1,0,1,0
11261,28,0,0,70,70,0,1,0,1,0
10189,28,0,0,70,70,0,1,0,1,0
19675,28,0,0,70,70,0,1,0,1,0
15115,28,0,0,70,70,0,1,0,1,0
14306,28,0,0,70,70,0,1,0,1,0
19769,28,0,0,70,70,0,1,0,1,0
14204,28,0,0,66,66,0,1,0,1,0
20680,28,0,0,66,66,0,1,0,1,0
12007,28,0,0,70,70,0,1,0,1,0
15284,28,0,0,66,66,0,1,0,1,0
22528,28,0,0,70,70,0,1,0,1,0
9491,28,0,0,66,66,0,1,0,1,0
17470,28,0,0,70,70,0,1,0,1,0
9049,28,0,0,70,70,0,1,0,1,0
9113,28,0,0,70,70,0,1,0,1,0
16397,28,0,0,66,66,0,1,0,1,0
22578,28,0,0,67,67,0,1,0,1,0
15142,28,0,0,69,69,0,1,0,1,0
19292,28,0,0,70,70,0,1,0,1,0
16472,28,0,0,67,67,0,1,0,1,0
21121,28,0,0,66,66,0,1,0,1,0
11736,28,0,0,66,66,0,1,0,1,0
15422,28,0,0,70,70,0,1,0,1,0
16801,28,0,0,66,66,0,1,0,1,0
14939,28,0,0,70,70,0,1,0,1,0
14657,28,0,0,70,70,0,1,0,1,0
18289,28,0,0,66,66,0,1,0,1,0
9291,28,0,0,70,70,0,1,0,1,0
19905,28,0,0,70,70,0,1,0,1,0
21377,28,0,0,66,66,0,1,0,1,0
19832,28,0,0,66,66,0,1,0,1,0
8440,28,0,0,67,67,0,1,0,1,0
16162,28,0,0,66,66,0,1,0,1,0
19539,28,0,0,69,69,0,1,0,1,0
22508,28,0,0,70,70,0,1,0,1,0
16459,28,0,0,70,70,0,1,0,1,0
19170,28,0,0,66,66,0,1,0,1,0
20022,28,0,0,66,66,0,1,0,1,0
14406,28,0,0,70,70,0,1,0,1,0
15646,28,0,0,67,67,0,1,0,1,0
17998,28,0,0,70,70,0,1,0,1,0
8958,28,0,0,66,66,0,1,0,1,0
17116,28,0,0,67,67,0,1,0,1,0
15748,28,0,0,70,70,0,1,0,1,0
11560,28,0,0,66,66,0,1,0,1,0
9907,28,0,0,70,70,0,1,0,1,0
19413,28,0,0,70,70,0,1,0,1,0
12139,28,0,0,70,70,0,1,0,1,0
19500,28,0,0,66,66,0,1,0,1,0
9902,28,0,0,68,68,0,1,0,1,0
12771,28,0,0,70,70,0,1,0,1,0
13149,28,0,0,70,70,0,1,0,1,0
19412,28,0,0,66,66,0,1,0,1,0
16885,28,0,0,70,70,0,1,0,1,0
16253,28,0,0,70,70,0,1,0,1,0
13389,28,0,0,67,67,0,1,0,1,0
18466,28,0,0,70,70,0,1,0,1,0
12469,28,0,0,66,66,0,1,0,1,0
12032,28,0,0,67,67,0,1,0,1,0
13376,28,0,0,66,66,0,1,0,1,0
13013,28,0,0,66,66,0,1,0,1,0
19376,28,0,0,70,70,0,1,0,1,0
14707,28,0,0,70,70,0,1,0,1,0
15045,28,0,0,70,70,0,1,0,1,0
19734,28,0,0,70,70,0,1,0,1,0
8936,28,0,0,70,70,0,1,0,1,0
9528,28,0,0,70,70,0,1,0,1,0
20884,28,0,0,70,70,0,1,0,1,0
12585,28,0,0,70,70,0,1,0,1,0
14137,28,0,0,70,70,0,1,0,1,0
16498,28,0,0,70,70,0,1,0,1,0
12479,28,0,0,70,70,0,1,0,1,0
21691,28,0,0,67,67,0,1,0,1,0
13359,28,0,0,70,70,0,1,0,1,0
19335,28,0,0,70,70,0,1,0,1,0
17214,28,0,0,67,67,0,1,0,1,0
16425,28,0,0,70,70,0,1,0,1,0
18222,28,0,0,69,69,0,1,0,1,0
12643,28,0,0,66,66,0,1,0,1,0
20783,28,0,0,70,70,0,1,0,1,0
13272,28,0,0,70,70,0,1,0,1,0
21653,28,0,0,70,70,0,1,0,1,0
13624,28,0,0,70,70,0,1,0,1,0
9297,28,0,0,70,70,0,1,0,1,0
13994,28,0,0,70,70,0,1,0,1,0
14470,28,0,0,70,70,0,1,0,1,0
12368,28,0,0,66,66,0,1,0,1,0
9797,28,0,0,67,67,0,1,0,1,0
16850,28,0,0,66,66,0,1,0,1,0
15941,28,0,0,67,67,0,1,0,1,0
17766,28,0,0,70,70,0,1,0,1,0
20425,28,0,0,70,70,0,1,0,1,0
10156,28,0,0,70,70,0,1,0,1,0
15862,28,0,0,69,69,0,1,0,1,0
9227,28,0,0,66,66,0,1,0,1,0
8547,28,0,0,66,66,0,1,0,1,0
20049,28,0,0,70,70,0,1,0,1,0
13270,28,0,0,66,66,0,1,0,1,0
9835,28,0,0,69,69,0,1,0,1,0
8974,28,0,0,70,70,0,1,0,1,0
12789,28,0,0,67,67,0,1,0,1,0
8359,28,0,0,69,69,0,1,0,1,0
11147,28,0,0,70,70,0,1,0,1,0
13143,28,0,0,70,70,0,1,0,1,0
8926,28,0,0,68,68,0,1,0,1,0
13112,28,0,0,69,69,0,1,0,1,0
12121,28,0,0,70,70,0,1,0,1,0
10441,28,0,0,70,70,0,1,0,1,0
19372,28,0,0,70,70,0,1,0,1,0
15710,28,0,0,66,66,0,1,0,1,0
12197,28,0,0,66,66,0,1,0,1,0
11209,28,0,0,70,70,0,1,0,1,0
19382,28,0,0,68,68,0,1,0,1,0
19113,28,0,0,70,70,0,1,0,1,0
15687,28,0,0,70,70,0,1,0,1,0
21568,28,0,0,67,67,0,1,0,1,0
17442,28,0,0,66,66,0,1,0,1,0
11666,28,0,0,70,70,0,1,0,1,0
11583,28,0,0,70,70,0,1,0,1,0
19974,28,0,0,70,70,0,1,0,1,0
17223,28,0,0,66,66,0,1,0,1,0
17906,28,0,0,66,66,0,1,0,1,0
17059,28,0,0,66,66,0,1,0,1,0
8880,28,0,0,66,66,0,1,0,1,0
17211,28,0,0,70,70,0,1,0,1,0
18975,28,0,0,70,70,0,1,0,1,0
21400,28,0,0,70,70,0,1,0,1,0
16809,28,0,0,70,70,0,1,0,1,0
21201,28,0,0,68,68,0,1,0,1,0
14257,28,0,0,67,67,0,1,0,1,0
13306,28,0,0,66,66,0,1,0,1,0
18422,28,0,0,67,67,0,1,0,1,0
10364,28,0,0,70,70,0,1,0,1,0
13968,28,0,0,68,68,0,1,0,1,0
9341,28,0,0,70,70,0,1,0,1,0
13672,28,0,0,69,69,0,1,0,1,0
13209,28,0,0,70,70,0,1,0,1,0
17853,28,0,0,67,67,0,1,0,1,0
11533,28,0,0,70,70,0,1,0,1,0
19902,28,0,0,68,68,0,1,0,1,0
20504,28,0,0,66,66,0,1,0,1,0
13534,28,0,0,66,66,0,1,0,1,0
20489,28,0,0,70,70,0,1,0,1,0
13889,28,0,0,70,70,0,1,0,1,0
8754,28,0,0,66,66,0,1,0,1,0
13977,28,0,0,70,70,0,1,0,1,0
12510,28,0,0,70,70,0,1,0,1,0
13245,28,0,0,70,70,0,1,0,1,0
18842,28,0,0,70,70,0,1,0,1,0
13738,28,0,0,70,70,0,1,0,1,0
20150,28,0,0,70,70,0,1,0,1,0
17645,28,0,0,66,66,0,1,0,1,0
13850,28,0,0,70,70,0,1,0,1,0
20868,28,0,0,66,66,0,1,0,1,0
17709,28,0,0,69,69,0,1,0,1,0
18943,28,0,0,70,70,0,1,0,1,0
21109,28,0,0,70,70,0,1,0,1,0
11970,28,0,0,70,70,0,1,0,1,0
17715,28,0,0,70,70,0,1,0,1,0
22336,28,0,0,66,66,0,1,0,1,0
20844,28,0,0,70,70,0,1,0,1,0
14057,28,0,0,67,67,0,1,0,1,0
14336,28,0,0,70,70,0,1,0,1,0
10256,28,0,0,68,68,0,1,0,1,0
9904,28,0,0,70,70,0,1,0,1,0
13416,28,0,0,70,70,0,1,0,1,0
9407,28,0,0,70,70,0,1,0,1,0
21497,28,0,0,66,66,0,1,0,1,0
14767,28,0,0,66,66,0,1,0,1,0
22551,28,0,0,70,70,0,1,0,1,0
13059,28,0,0,70,70,0,1,0,1,0
22074,28,0,0,66,66,0,1,0,1,0
15149,28,0,0,70,70,0,1,0,1,0
10667,28,0,0,70,70,0,1,0,1,0
11102,28,0,0,70,70,0,1,0,1,0
20656,28,0,0,69,69,0,1,0,1,0
9817,28,0,0,70,70,0,1,0,1,0
21337,28,0,0,66,66,0,1,0,1,0
20129,28,0,0,70,70,0,1,0,1,0
9929,28,0,0,66,66,0,1,0,1,0
10913,28,0,0,66,66,0,1,0,1,0
12564,28,0,0,70,70,0,1,0,1,0
16941,28,0,0,70,70,0,1,0,1,0
11699,28,0,0,70,70,0,1,0,1,0
18412,28,0,0,70,70,0,1,0,1,0
19908,28,0,0,70,70,0,1,0,1,0
17547,28,0,0,66,66,0,1,0,1,0
16222,28,0,0,70,70,0,1,0,1,0
21004,28,0,0,66,66,0,1,0,1,0
12157,28,0,0,66,66,0,1,0,1,0
11027,28,0,0,70,70,0,1,0,1,0
17956,28,0,0,70,70,0,1,0,1,0
18579,28,0,0,66,66,0,1,0,1,0
22574,28,0,0,70,70,0,1,0,1,0
11104,28,0,0,70,70,0,1,0,1,0
18273,28,0,0,68,68,0,1,0,1,0
17187,28,0,0,70,70,0,1,0,1,0
22534,28,0,0,70,70,0,1,0,1,0
9851,28,0,0,70,70,0,1,0,1,0
9535,28,0,0,70,70,0,1,0,1,0
10224,28,0,0,66,66,0,1,0,1,0
18367,28,0,0,66,66,0,1,0,1,0
13782,28,0,0,70,70,0,1,0,1,0
12158,28,0,0,67,67,0,1,0,1,0
11994,28,0,0,70,70,0,1,0,1,0
14256,28,0,0,70,70,0,1,0,1,0
13264,28,0,0,70,70,0,1,0,1,0
21235,28,0,0,70,70,0,1,0,1,0
11622,28,0,0,68,68,0,1,0,1,0
13531,28,0,0,66,66,0,1,0,1,0
17902,28,0,0,70,70,0,1,0,1,0
20458,28,0,0,70,70,0,1,0,1,0
10784,28,0,0,70,70,0,1,0,1,0
16815,28,0,0,70,70,0,1,0,1,0
18472,28,0,0,70,70,0,1,0,1,0
13068,28,0,0,70,70,0,1,0,1,0
19559,28,0,0,70,70,0,1,0,1,0
21969,28,0,0,70,70,0,1,0,1,0
15905,28,0,0,66,66,0,1,0,1,0
10990,28,0,0,66,66,0,1,0,1,0
11407,28,0,0,66,66,0,1,0,1,0
13480,28,0,0,70,70,0,1,0,1,0
10292,28,0,0,66,66,0,1,0,1,0
10911,28,0,0,70,70,0,1,0,1,0
21533,28,0,0,66,66,0,1,0,1,0
12341,28,0,0,66,66,0,1,0,1,0
19598,28,0,0,67,67,0,1,0,1,0
17758,28,0,0,70,70,0,1,0,1,0
11752,28,0,0,68,68,0,1,0,1,0
9894,28,0,0,70,70,0,1,0,1,0
13352,28,0,0,70,70,0,1,0,1,0
12193,28,0,0,66,66,0,1,0,1,0
9654,28,0,0,70,70,0,1,0,1,0
14147,28,0,0,70,70,0,1,0,1,0
17655,28,0,0,70,70,0,1,0,1,0
18606,28,0,0,70,70,0,1,0,1,0
9484,28,0,0,70,70,0,1,0,1,0
14608,28,0,0,70,70,0,1,0,1,0
16080,28,0,0,66,66,0,1,0,1,0
12620,28,0,0,70,70,0,1,0,1,0
16400,28,0,0,70,70,0,1,0,1,0
10272,28,0,0,70,70,0,1,0,1,0
9955,28,0,0,66,66,0,1,0,1,0
11080,28,0,0,70,70,0,1,0,1,0
20540,28,0,0,70,70,0,1,0,1,0
10222,28,0,0,66,66,0,1,0,1,0
14718,28,0,0,67,67,0,1,0,1,0
18807,28,0,0,70,70,0,1,0,1,0
14137,28,0,0,70,70,0,1,0,1,0
10887,28,0,0,68,68,0,1,0,1,0
15381,28,0,0,70,70,0,1,0,1,0
16358,28,0,0,70,70,0,1,0,1,0
16928,28,0,0,70,70,0,1,0,1,0
19671,28,0,0,70,70,0,1,0,1,0
17743,28,0,0,70,70,0,1,0,1,0
9610,28,0,0,66,66,0,1,0,1,0
10830,28,0,0,70,70,0,1,0,1,0
21917,28,0,0,70,70,0,1,0,1,0
22518,28,0,0,70,70,0,1,0,1,0
22521,28,0,0,70,70,0,1,0,1,0
11975,28,0,0,70,70,0,1,0,1,0
21704,28,0,0,70,70,0,1,0,1,0
17554,28,0,0,70,70,0,1,0,1,0
20265,28,0,0,70,70,0,1,0,1,0
10612,28,0,0,66,66,0,1,0,1,0
9033,28,0,0,70,70,0,1,0,1,0
9991,28,0,0,66,66,0,1,0,1,0
20435,28,0,0,66,66,0,1,0,1,0
9826,28,0,0,70,70,0,1,0,1,0
14332,28,0,0,70,70,0,1,0,1,0
9135,28,0,0,66,66,0,1,0,1,0
15512,28,0,0,70,70,0,1,0,1,0
13997,28,0,0,70,70,0,1,0,1,0
17403,28,0,0,70,70,0,1,0,1,0
8479,28,0,0,70,70,0,1,0,1,0
20439,28,0,0,70,70,0,1,0,1,0
20476,28,0,0,70,70,0,1,0,1,0
12334,28,0,0,69,69,0,1,0,1,0
21337,28,0,0,66,66,0,1,0,1,0
20373,28,0,0,70,70,0,1,0,1,0
21938,28,0,0,70,70,0,1,0,1,0
11831,28,0,0,67,67,0,1,0,1,0
9757,28,0,0,69,69,0,1,0,1,0
15217,28,0,0,66,66,0,1,0,1,0
22131,28,0,0,66,66,0,1,0,1,0
22180,28,0,0,70,70,0,1,0,1,0
9455,28,0,0,66,66,0,1,0,1,0
19187,28,0,0,66,66,0,1,0,1,0
20811,28,0,0,70,70,0,1,0,1,0
9433,28,0,0,66,66,0,1,0,1,0
13627,28,0,0,70,70,0,1,0,1,0
11828,28,0,0,66,66,0,1,0,1,0
16645,28,0,0,68,68,0,1,0,1,0
19578,28,0,0,69,69,0,1,0,1,0
20157,28,0,0,66,66,0,1,0,1,0
18273,28,0,0,67,67,0,1,0,1,0
13850,28,0,0,70,70,0,1,0,1,0
14710,28,0,0,66,66,0,1,0,1,0
9033,28,0,0,70,70,0,1,0,1,0
9629,28,0,0,66,66,0,1,0,1,0
20834,28,0,0,70,70,0,1,0,1,0
17267,28,0,0,70,70,0,1,0,1,0
19665,28,0,0,70,70,0,1,0,1,0
9586,28,0,0,70,70,0,1,0,1,0
20397,28,0,0,66,66,0,1,0,1,0
13114,28,0,0,66,66,0,1,0,1,0
11798,28,0,0,66,66,0,1,0,1,0
11239,28,0,0,70,70,0,1,0,1,0
22149,28,0,0,66,66,0,1,0,1,0
8956,28,0,0,70,70,0,1,0,1,0
11821,28,0,0,66,66,0,1,0,1,0
10359,28,0,0,70,70,0,1,0,1,0
20507,28,0,0,70,70,0,1,0,1,0
9638,28,0,0,66,66,0,1,0,1,0
14713,28,0,0,68,68,0,1,0,1,0
17310,28,0,0,66,66,0,1,0,1,0
18141,28,0,0,69,69,0,1,0,1,0
15032,28,0,0,70,70,0,1,0,1,0
16384,28,0,0,66,66,0,1,0,1,0
12186,28,0,0,70,70,0,1,0,1,0
21490,28,0,0,66,66,0,1,0,1,0
10888,28,0,0,67,67,0,1,0,1,0
11889,28,0,0,66,66,0,1,0,1,0
14341,28,0,0,70,70,0,1,0,1,0
20297,28,0,0,70,70,0,1,0,1,0
18320,28,0,0,70,70,0,1,0,1,0
15559,28,0,0,70,70,0,1,0,1,0
19926,28,0,0,70,70,0,1,0,1,0
9135,28,0,0,66,66,0,1,0,1,0
18292,28,0,0,70,70,0,1,0,1,0
13652,28,0,0,69,69,0,1,0,1,0
21765,28,0,0,66,66,0,1,0,1,0
20832,28,0,0,69,69,0,1,0,1,0
19921,28,0,0,66,66,0,1,0,1,0
8811,28,0,0,70,70,0,1,0,1,0
17515,28,0,0,68,68,0,1,0,1,0
19834,28,0,0,66,66,0,1,0,1,0
15374,28,0,0,68,68,0,1,0,1,0
14257,28,0,0,70,70,0,1,0,1,0
12227,28,0,0,66,66,0,1,0,1,0
19788,28,0,0,70,70,0,1,0,1,0
21244,28,0,0,68,68,0,1,0,1,0
16678,28,0,0,68,68,0,1,0,1,0
9454,28,0,0,69,69,0,1,0,1,0
18040,28,0,0,66,66,0,1,0,1,0
22473,28,0,0,66,66,0,1,0,1,0
14123,28,0,0,66,66,0,1,0,1,0
17622,28,0,0,70,70,0,1,0,1,0
19816,28,0,0,69,69,0,1,0,1,0
14147,28,0,0,70,70,0,1,0,1,0
21072,28,0,0,70,70,0,1,0,1,0
8700,28,0,0,70,70,0,1,0,1,0
22529,28,0,0,70,70,0,1,0,1,0
11603,28,0,0,70,70,0,1,0,1,0
18357,28,0,0,70,70,0,1,0,1,0
21955,28,0,0,68,68,0,1,0,1,0
18059,28,0,0,70,70,0,1,0,1,0
17718,28,0,0,70,70,0,1,0,1,0
13126,28,0,0,70,70,0,1,0,1,0
9675,28,0,0,70,70,0,1,0,1,0
11047,28,0,0,70,70,0,1,0,1,0
10958,28,0,0,70,70,0,1,0,1,0
21547,28,0,0,66,66,0,1,0,1,0
17255,28,0,0,66,66,0,1,0,1,0
17746,28,0,0,67,67,0,1,0,1,0
12656,28,0,0,70,70,0,1,0,1,0
16738,28,0,0,70,70,0,1,0,1,0
16965,28,0,0,70,70,0,1,0,1,0
16208,28,0,0,69,69,0,1,0,1,0
16362,28,0,0,70,70,0,1,0,1,0
15096,28,0,0,67,67,0,1,0,1,0
12567,28,0,0,70,70,0,1,0,1,0
20686,28,0,0,66,66,0,1,0,1,0
9747,28,0,0,70,70,0,1,0,1,0
21448,28,0,0,68,68,0,1,0,1,0
17888,28,0,0,66,66,0,1,0,1,0
17219,28,0,0,68,68,0,1,0,1,0
14614,28,0,0,66,66,0,1,0,1,0
8415,28,0,0,66,66,0,1,0,1,0
10039,28,0,0,67,67,0,1,0,1,0
16856,28,0,0,66,66,0,1,0,1,0
21220,28,0,0,70,70,0,1,0,1,0
11514,28,0,0,68,68,0,1,0,1,0
18020,28,0,0,70,70,0,1,0,1,0
21310,28,0,0,66,66,0,1,0,1,0
20075,28,0,0,66,66,0,1,0,1,0
8808,28,0,0,68,68,0,1,0,1,0
17908,28,0,0,68,68,0,1,0,1,0
12258,28,0,0,70,70,0,1,0,1,0
14687,28,0,0,69,69,0,1,0,1,0
22303,28,0,0,70,70,0,1,0,1,0
19017,28,0,0,70,70,0,1,0,1,0
9140,28,0,0,70,70,0,1,0,1,0
20987,28,0,0,70,70,0,1,0,1,0
10041,28,0,0,70,70,0,1,0,1,0
22465,28,0,0,66,66,0,1,0,1,0
13687,28,0,0,66,66,0,1,0,1,0
9047,28,0,0,70,70,0,1,0,1,0
15885,28,0,0,70,70,0,1,0,1,0
21171,28,0,0,66,66,0,1,0,1,0
12842,28,0,0,66,66,0,1,0,1,0
10199,28,0,0,66,66,0,1,0,1,0
16193,28,0,0,69,69,0,1,0,1,0
17775,28,0,0,70,70,0,1,0,1,0
20646,28,0,0,70,70,0,1,0,1,0
17189,28,0,0,67,67,0,1,0,1,0
13624,28,0,0,70,70,0,1,0,1,0
20935,28,0,0,70,70,0,1,0,1,0
10515,28,0,0,70,70,0,1,0,1,0
9509,28,0,0,67,67,0,1,0,1,0
19207,28,0,0,70,70,0,1,0,1,0
9659,28,0,0,68,68,0,1,0,1,0
22565,28,0,0,66,66,0,1,0,1,0
16578,28,0,0,70,70,0,1,0,1,0
14715,28,0,0,70,70,0,1,0,1,0
15142,28,0,0,69,69,0,1,0,1,0
21505,28,0,0,70,70,0,1,0,1,0
9623,28,0,0,70,70,0,1,0,1,0
19029,28,0,0,70,70,0,1,0,1,0
15839,28,0,0,68,68,0,1,0,1,0
14264,28,0,0,70,70,0,1,0,1,0
19622,28,0,0,70,70,0,1,0,1,0
19939,28,0,0,70,70,0,1,0,1,0
20939,28,0,0,68,68,0,1,0,1,0
13924,28,0,0,70,70,0,1,0,1,0
15927,28,0,0,70,70,0,1,0,1,0
17336,28,0,0,70,70,0,1,0,1,0
16715,28,0,0,69,69,0,1,0,1,0
21318,28,0,0,70,70,0,1,0,1,0
10199,28,0,0,69,69,0,1,0,1,0
16401,28,0,0,70,70,0,1,0,1,0
9615,28,0,0,66,66,0,1,0,1,0
17751,28,0,0,69,69,0,1,0,1,0
20396,28,0,0,70,70,0,1,0,1,0
11047,28,0,0,66,66,0,1,0,1,0
9714,28,0,0,70,70,0,1,0,1,0
15205,28,0,0,66,66,0,1,0,1,0
11562,28,0,0,66,66,0,1,0,1,0
22419,28,0,0,70,70,0,1,0,1,0
8956,28,0,0,70,70,0,1,0,1,0
16075,28,0,0,69,69,0,1,0,1,0
12557,28,0,0,70,70,0,1,0,1,0
13352,28,0,0,70,70,0,1,0,1,0
16323,28,0,0,69,69,0,1,0,1,0
11220,28,0,0,70,70,0,1,0,1,0
21772,28,0,0,70,70,0,1,0,1,0
17328,28,0,0,70,70,0,1,0,1,0
16495,28,0,0,66,66,0,1,0,1,0
15249,28,0,0,70,70,0,1,0,1,0
17651,28,0,0,66,66,0,1,0,1,0
9397,28,0,0,70,70,0,1,0,1,0
22566,28,0,0,66,66,0,1,0,1,0
9498,28,0,0,66,66,0,1,0,1,0
14124,28,0,0,70,70,0,1,0,1,0
16201,28,0,0,69,69,0,1,0,1,0
14349,28,0,0,70,70,0,1,0,1,0
10450,28,0,0,68,68,0,1,0,1,0
21747,28,0,0,70,70,0,1,0,1,0
10545,28,0,0,66,66,0,1,0,1,0
9198,28,0,0,66,66,0,1,0,1,0
20220,28,0,0,70,70,0,1,0,1,0
17514,28,0,0,70,70,0,1,0,1,0
19200,28,0,0,66,66,0,1,0,1,0
22242,28,0,0,70,70,0,1,0,1,0
11097,28,0,0,70,70,0,1,0,1,0
12838,28,0,0,66,66,0,1,0,1,0
21425,28,0,0,69,69,0,1,0,1,0
17399,28,0,0,66,66,0,1,0,1,0
17686,28,0,0,67,67,0,1,0,1,0
9672,28,0,0,70,70,0,1,0,1,0
16345,28,0,0,70,70,0,1,0,1,0
9791,28,0,0,70,70,0,1,0,1,0
16235,28,0,0,66,66,0,1,0,1,0
17821,28,0,0,70,70,0,1,0,1,0
13330,28,0,0,70,70,0,1,0,1,0
9274,28,0,0,70,70,0,1,0,1,0
16609,28,0,0,66,66,0,1,0,1,0
11606,28,0,0,66,66,0,1,0,1,0
20760,28,0,0,70,70,0,1,0,1,0
20371,28,0,0,70,70,0,1,0,1,0
11664,28,0,0,66,66,0,1,0,1,0
17233,28,0,0,70,70,0,1,0,1,0
17247,28,0,0,66,66,0,1,0,1,0
10588,28,0,0,70,70,0,1,0,1,0
21087,28,0,0,70,70,0,1,0,1,0
9256,28,0,0,66,66,0,1,0,1,0
20475,28,0,0,70,70,0,1,0,1,0
18015,28,0,0,70,70,0,1,0,1,0
13969,28,0,0,70,70,0,1,0,1,0
11210,28,0,0,70,70,0,1,0,1,0
17339,28,0,0,70,70,0,1,0,1,0
19685,28,0,0,66,66,0,1,0,1,0
20680,28,0,0,70,70,0,1,0,1,0
22141,28,0,0,70,70,0,1,0,1,0
11747,28,0,0,70,70,0,1,0,1,0
21021,28,0,0,66,66,0,1,0,1,0
19186,28,0,0,68,68,0,1,0,1,0
16610,28,0,0,66,66,0,1,0,1,0
22338,28,0,0,66,66,0,1,0,1,0
12993,28,0,0,70,70,0,1,0,1,0
9258,28,0,0,66,66,0,1,0,1,0
14751,28,0,0,70,70,0,1,0,1,0
15536,28,0,0,66,66,0,1,0,1,0
15661,28,0,0,66,66,0,1,0,1,0
19676,28,0,0,70,70,0,1,0,1,0
14138,28,0,0,70,70,0,1,0,1,0
22148,28,0,0,66,66,0,1,0,1,0
16122,28,0,0,66,66,0,1,0,1,0
20388,28,0,0,70,70,0,1,0,1,0
15159,28,0,0,70,70,0,1,0,1,0
20863,28,0,0,66,66,0,1,0,1,0
16444,28,0,0,66,66,0,1,0,1,0
18618,28,0,0,70,70,0,1,0,1,0
16626,28,0,0,69,69,0,1,0,1,0
12150,28,0,0,68,68,0,1,0,1,0
12956,28,0,0,67,67,0,1,0,1,0
9689,28,0,0,66,66,0,1,0,1,0
11913,28,0,0,68,68,0,1,0,1,0
22285,28,0,0,70,70,0,1,0,1,0
9607,28,0,0,70,70,0,1,0,1,0
10961,28,0,0,70,70,0,1,0,1,0
10482,28,0,0,70,70,0,1,0,1,0
9067,28,0,0,70,70,0,1,0,1,0
21745,28,0,0,70,70,0,1,0,1,0
12478,28,0,0,70,70,0,1,0,1,0
16830,28,0,0,69,69,0,1,0,1,0
10009,28,0,0,70,70,0,1,0,1,0
14119,28,0,0,69,69,0,1,0,1,0
13765,28,0,0,68,68,0,1,0,1,0
14587,28,0,0,70,70,0,1,0,1,0
19535,28,0,0,70,70,0,1,0,1,0
19386,28,0,0,68,68,0,1,0,1,0
15362,28,0,0,70,70,0,1,0,1,0
9317,28,0,0,70,70,0,1,0,1,0
17309,28,0,0,66,66,0,1,0,1,0
20573,28,0,0,70,70,0,1,0,1,0
12142,28,0,0,69,69,0,1,0,1,0
11594,28,0,0,70,70,0,1,0,1,0
21288,28,0,0,70,70,0,1,0,1,0
14024,28,0,0,70,70,0,1,0,1,0
19479,28,0,0,70,70,0,1,0,1,0
10813,28,0,0,68,68,0,1,0,1,0
14206,28,0,0,70,70,0,1,0,1,0
11568,28,0,0,70,70,0,1,0,1,0
20899,28,0,0,70,70,0,1,0,1,0
22213,28,0,0,70,70,0,1,0,1,0
13434,28,0,0,68,68,0,1,0,1,0
9981,28,0,0,66,66,0,1,0,1,0
14203,28,0,0,66,66,0,1,0,1,0
16156,28,0,0,70,70,0,1,0,1,0
10529,28,0,0,67,67,0,1,0,1,0
16000,28,0,0,70,70,0,1,0,1,0
16873,28,0,0,70,70,0,1,0,1,0
15109,28,0,0,68,68,0,1,0,1,0
19431,28,0,0,70,70,0,1,0,1,0
15310,28,0,0,70,70,0,1,0,1,0
15166,28,0,0,70,70,0,1,0,1,0
11049,28,0,0,66,66,0,1,0,1,0
9363,28,0,0,70,70,0,1,0,1,0
18074,28,0,0,66,66,0,1,0,1,0
20293,28,0,0,66,66,0,1,0,1,0
11140,28,0,0,69,69,0,1,0,1,0
12186,28,0,0,70,70,0,1,0,1,0
13500,28,0,0,70,70,0,1,0,1,0
10129,28,0,0,70,70,0,1,0,1,0
11713,28,0,0,66,66,0,1,0,1,0
19801,28,0,0,70,70,0,1,0,1,0
22168,28,0,0,70,70,0,1,0,1,0
17161,28,0,0,70,70,0,1,0,1,0
13558,28,0,0,70,70,0,1,0,1,0
14196,28,0,0,70,70,0,1,0,1,0
13875,28,0,0,70,70,0,1,0,1,0
17846,28,0,0,70,70,0,1,0,1,0
9064,28,0,0,70,70,0,1,0,1,0
14835,28,0,0,66,66,0,1,0,1,0
22238,28,0,0,70,70,0,1,0,1,0
18254,28,0,0,66,66,0,1,0,1,0
8433,28,0,0,69,69,0,1,0,1,0
9997,28,0,0,70,70,0,1,0,1,0
8472,28,0,0,70,70,0,1,0,1,0
9935,28,0,0,66,66,0,1,0,1,0
17701,28,0,0,66,66,0,1,0,1,0
16809,28,0,0,70,70,0,1,0,1,0
19770,28,0,0,70,70,0,1,0,1,0
15861,28,0,0,68,68,0,1,0,1,0
15567,28,0,0,70,70,0,1,0,1,0
14288,28,0,0,70,70,0,1,0,1,0
13951,28,0,0,70,70,0,1,0,1,0
13586,28,0,0,68,68,0,1,0,1,0
8956,28,0,0,70,70,0,1,0,1,0
19735,28,0,0,70,70,0,1,0,1,0
17190,28,0,0,70,70,0,1,0,1,0
11379,28,0,0,69,69,0,1,0,1,0
9555,28,0,0,66,66,0,1,0,1,0
13395,28,0,0,66,66,0,1,0,1,0
19586,28,0,0,70,70,0,1,0,1,0
22070,28,0,0,66,66,0,1,0,1,0
15141,28,0,0,68,68,0,1,0,1,0
19479,28,0,0,70,70,0,1,0,1,0
22361,28,0,0,70,70,0,1,0,1,0
22506,28,0,0,70,70,0,1,0,1,0
11387,28,0,0,70,70,0,1,0,1,0
16965,28,0,0,66,66,0,1,0,1,0
11559,28,0,0,66,66,0,1,0,1,0
16926,28,0,0,70,70,0,1,0,1,0
15003,28,0,0,70,70,0,1,0,1,0
13773,28,0,0,67,67,0,1,0,1,0
19299,28,0,0,66,66,0,1,0,1,0
16711,28,0,0,69,69,0,1,0,1,0
15511,28,0,0,70,70,0,1,0,1,0
10958,28,0,0,70,70,0,1,0,1,0
13567,28,0,0,66,66,0,1,0,1,0
9599,28,0,0,70,70,0,1,0,1,0
18536,28,0,0,70,70,0,1,0,1,0
16455,28,0,0,69,69,0,1,0,1,0
10230,28,0,0,66,66,0,1,0,1,0
20240,28,0,0,70,70,0,1,0,1,0
13228,28,0,0,70,70,0,1,0,1,0
12304,28,0,0,66,66,0,1,0,1,0
10640,28,0,0,70,70,0,1,0,1,0
13307,28,0,0,70,70,0,1,0,1,0
9136,28,0,0,66,66,0,1,0,1,0
14135,28,0,0,67,67,0,1,0,1,0
19018,28,0,0,66,66,0,1,0,1,0
20260,28,0,0,66,66,0,1,0,1,0
14689,28,0,0,68,68,0,1,0,1,0
9691,28,0,0,70,70,0,1,0,1,0
9877,28,0,0,66,66,0,1,0,1,0
10186,28,0,0,66,66,0,1,0,1,0
16486,28,0,0,70,70,0,1,0,1,0
12306,28,0,0,67,67,0,1,0,1,0
17899,28,0,0,70,70,0,1,0,1,0
13818,28,0,0,70,70,0,1,0,1,0
9153,28,0,0,70,70,0,1,0,1,0
21101,28,0,0,66,66,0,1,0,1,0
18056,28,0,0,70,70,0,1,0,1,0
10153,28,0,0,67,67,0,1,0,1,0
9619,28,0,0,70,70,0,1,0,1,0
18802,28,0,0,70,70,0,1,0,1,0
9983,28,0,0,66,66,0,1,0,1,0
9655,28,0,0,70,70,0,1,0,1,0
10106,28,0,0,66,66,0,1,0,1,0
11416,28,0,0,68,68,0,1,0,1,0
11515,28,0,0,70,70,0,1,0,1,0
20274,28,0,0,70,70,0,1,0,1,0
14155,28,0,0,70,70,0,1,0,1,0
9300,28,0,0,70,70,0,1,0,1,0
9696,28,0,0,70,70,0,1,0,1,0
19329,28,0,0,70,70,0,1,0,1,0
14852,28,0,0,70,70,0,1,0,1,0
20191,28,0,0,70,70,0,1,0,1,0
19710,28,0,0,70,70,0,1,0,1,0
21093,28,0,0,70,70,0,1,0,1,0
12530,28,0,0,70,70,0,1,0,1,0
13724,28,0,0,70,70,0,1,0,1,0
15451,28,0,0,70,70,0,1,0,1,0
18226,28,0,0,70,70,0,1,0,1,0
16007,28,0,0,70,70,0,1,0,1,0
19177,28,0,0,70,70,0,1,0,1,0
15594,28,0,0,66,66,0,1,0,1,0
9740,28,0,0,66,66,0,1,0,1,0
19760,28,0,0,66,66,0,1,0,1,0
9552,28,0,0,66,66,0,1,0,1,0
12517,28,0,0,70,70,0,1,0,1,0
21376,28,0,0,69,69,0,1,0,1,0
10162,28,0,0,70,70,0,1,0,1,0
18644,28,0,0,70,70,0,1,0,1,0
16705,28,0,0,70,70,0,1,0,1,0
9722,28,0,0,70,70,0,1,0,1,0
9434,28,0,0,66,66,0,1,0,1,0
19737,28,0,0,68,68,0,1,0,1,0
14670,28,0,0,70,70,0,1,0,1,0
20647,28,0,0,66,66,0,1,0,1,0
14011,28,0,0,67,67,0,1,0,1,0
16847,28,0,0,68,68,0,1,0,1,0
20873,28,0,0,66,66,0,1,0,1,0
15339,28,0,0,66,66,0,1,0,1,0
14528,28,0,0,66,66,0,1,0,1,0
20175,28,0,0,70,70,0,1,0,1,0
18843,28,0,0,70,70,0,1,0,1,0
9195,28,0,0,66,66,0,1,0,1,0
20115,28,0,0,67,67,0,1,0,1,0
14023,28,0,0,70,70,0,1,0,1,0
22529,28,0,0,68,68,0,1,0,1,0
17538,28,0,0,66,66,0,1,0,1,0
12351,28,0,0,70,70,0,1,0,1,0
16024,28,0,0,66,66,0,1,0,1,0
17515,28,0,0,67,67,0,1,0,1,0
13943,28,0,0,70,70,0,1,0,1,0
9356,28,0,0,70,70,0,1,0,1,0
15230,28,0,0,70,70,0,1,0,1,0
10704,28,0,0,70,70,0,1,0,1,0
13580,28,0,0,70,70,0,1,0,1,0
13517,28,0,0,66,66,0,1,0,1,0
15069,28,0,0,70,70,0,1,0,1,0
16881,28,0,0,70,70,0,1,0,1,0
20756,28,0,0,70,70,0,1,0,1,0
21159,28,0,0,70,70,0,1,0,1,0
19004,28,0,0,66,66,0,1,0,1,0
20780,28,0,0,70,70,0,1,0,1,0
13686,28,0,0,70,70,0,1,0,1,0
11052,28,0,0,70,70,0,1,0,1,0
20165,28,0,0,69,69,0,1,0,1,0
17499,28,0,0,66,66,0,1,0,1,0
15383,28,0,0,70,70,0,1,0,1,0
21368,28,0,0,70,70,0,1,0,1,0
11515,28,0,0,67,67,0,1,0,1,0
8493,28,0,0,66,66,0,1,0,1,0
10097,28,0,0,70,70,0,1,0,1,0
13635,28,0,0,69,69,0,1,0,1,0
18830,28,0,0,70,70,0,1,0,1,0
14355,28,0,0,70,70,0,1,0,1,0
16278,28,0,0,68,68,0,1,0,1,0
15182,28,0,0,68,68,0,1,0,1,0
12646,28,0,0,68,68,0,1,0,1,0
14063,28,0,0,70,70,0,1,0,1,0
10000,28,0,0,66,66,0,1,0,1,0
16038,28,0,0,67,67,0,1,0,1,0
21463,28,0,0,70,70,0,1,0,1,0
11509,28,0,0,70,70,0,1,0,1,0
9980,28,0,0,70,70,0,1,0,1,0
9622,28,0,0,70,70,0,1,0,1,0
15814,28,0,0,67,67,0,1,0,1,0
17853,28,0,0,70,70,0,1,0,1,0
17352,28,0,0,66,66,0,1,0,1,0
11453,28,0,0,70,70,0,1,0,1,0
9934,28,0,0,66,66,0,1,0,1,0
16008,28,0,0,70,70,0,1,0,1,0
8717,28,0,0,70,70,0,1,0,1,0
17054,28,0,0,68,68,0,1,0,1,0
16778,28,0,0,70,70,0,1,0,1,0
15443,28,0,0,70,70,0,1,0,1,0
15574,28,0,0,70,70,0,1,0,1,0
16851,28,0,0,70,70,0,1,0,1,0
13972,28,0,0,70,70,0,1,0,1,0
21955,28,0,0,68,68,0,1,0,1,0
16012,28,0,0,67,67,0,1,0,1,0
14456,28,0,0,70,70,0,1,0,1,0
16796,28,0,0,67,67,0,1,0,1,0
11318,28,0,0,66,66,0,1,0,1,0
19750,28,0,0,68,68,0,1,0,1,0
21434,28,0,0,66,66,0,1,0,1,0
22138,28,0,0,70,70,0,1,0,1,0
14862,28,0,0,67,67,0,1,0,1,0
21178,28,0,0,70,70,0,1,0,1,0
13937,28,0,0,66,66,0,1,0,1,0
12723,28,0,0,66,66,0,1,0,1,0
9032,28,0,0,70,70,0,1,0,1,0
10352,28,0,0,68,68,0,1,0,1,0
14057,28,0,0,66,66,0,1,0,1,0
12395,28,0,0,66,66,0,1,0,1,0
10130,28,0,0,70,70,0,1,0,1,0
16311,28,0,0,70,70,0,1,0,1,0
16101,28,0,0,70,70,0,1,0,1,0
10635,28,0,0,70,70,0,1,0,1,0
19475,28,0,0,69,69,0,1,0,1,0
17839,28,0,0,67,67,0,1,0,1,0
9752,28,0,0,66,66,0,1,0,1,0
21612,28,0,0,69,69,0,1,0,1,0
14687,28,0,0,66,66,0,1,0,1,0
11357,28,0,0,66,66,0,1,0,1,0
9796,28,0,0,70,70,0,1,0,1,0
11157,28,0,0,70,70,0,1,0,1,0
18953,28,0,0,70,70,0,1,0,1,0
15589,28,0,0,66,66,0,1,0,1,0
20214,28,0,0,70,70,0,1,0,1,0
21469,28,0,0,70,70,0,1,0,1,0
19611,28,0,0,66,66,0,1,0,1,0
19670,28,0,0,66,66,0,1,0,1,0
12177,28,0,0,70,70,0,1,0,1,0
19983,28,0,0,69,69,0,1,0,1,0
8542,28,0,0,70,70,0,1,0,1,0
18598,28,0,0,66,66,0,1,0,1,0
19337,28,0,0,70,70,0,1,0,1,0
16884,28,0,0,70,70,0,1,0,1,0
11932,28,0,0,70,70,0,1,0,1,0
19660,28,0,0,70,70,0,1,0,1,0
22011,28,0,0,66,66,0,1,0,1,0
21146,28,0,0,66,66,0,1,0,1,0
11452,28,0,0,70,70,0,1,0,1,0
17655,28,0,0,66,66,0,1,0,1,0
15223,28,0,0,66,66,0,1,0,1,0
10987,28,0,0,66,66,0,1,0,1,0
15779,28,0,0,66,66,0,1,0,1,0
20911,28,0,0,67,67,0,1,0,1,0
17640,28,0,0,66,66,0,1,0,1,0
14481,28,0,0,66,66,0,1,0,1,0
8672,28,0,0,66,66,0,1,0,1,0
9292,28,0,0,70,70,0,1,0,1,0
19117,28,0,0,70,70,0,1,0,1,0
15685,28,0,0,70,70,0,1,0,1,0
19181,28,0,0,70,70,0,1,0,1,0
17816,28,0,0,66,66,0,1,0,1,0
20579,28,0,0,70,70,0,1,0,1,0
18652,28,0,0,70,70,0,1,0,1,0
19968,28,0,0,66,66,0,1,0,1,0
11852,28,0,0,66,66,0,1,0,1,0
15473,28,0,0,66,66,0,1,0,1,0
15113,28,0,0,70,70,0,1,0,1,0
20231,28,0,0,68,68,0,1,0,1,0
10120,28,0,0,69,69,0,1,0,1,0
20454,28,0,0,70,70,0,1,0,1,0
21313,28,0,0,66,66,0,1,0,1,0
18184,28,0,0,70,70,0,1,0,1,0
18256,28,0,0,70,70,0,1,0,1,0
13842,28,0,0,70,70,0,1,0,1,0
10415,28,0,0,70,70,0,1,0,1,0
9501,28,0,0,66,66,0,1,0,1,0
15066,28,0,0,70,70,0,1,0,1,0
10150,28,0,0,70,70,0,1,0,1,0
17745,28,0,0,70,70,0,1,0,1,0
14473,28,0,0,69,69,0,1,0,1,0
19254,28,0,0,70,70,0,1,0,1,0
16200,28,0,0,70,70,0,1,0,1,0
10230,28,0,0,66,66,0,1,0,1,0
20749,28,0,0,66,66,0,1,0,1,0
10286,28,0,0,70,70,0,1,0,1,0
9980,28,0,0,70,70,0,1,0,1,0
19539,28,0,0,68,68,0,1,0,1,0
21123,28,0,0,66,66,0,1,0,1,0
11073,28,0,0,70,70,0,1,0,1,0
8689,28,0,0,70,70,0,1,0,1,0
22706,28,0,0,70,70,0,1,0,1,0
10274,28,0,0,70,70,0,1,0,1,0
15112,28,0,0,70,70,0,1,0,1,0
9451,28,0,0,70,70,0,1,0,1,0
18746,28,0,0,70,70,0,1,0,1,0
17084,28,0,0,70,70,0,1,0,1,0
17718,28,0,0,70,70,0,1,0,1,0
21295,28,0,0,66,66,0,1,0,1,0
12950,28,0,0,66,66,0,1,0,1,0
11280,28,0,0,70,70,0,1,0,1,0
14341,28,0,0,68,68,0,1,0,1,0
8611,28,0,0,70,70,0,1,0,1,0
20678,28,0,0,68,68,0,1,0,1,0
13116,28,0,0,68,68,0,1,0,1,0
11707,28,0,0,70,70,0,1,0,1,0
21854,28,0,0,70,70,0,1,0,1,0
21830,28,0,0,66,66,0,1,0,1,0
9938,28,0,0,70,70,0,1,0,1,0
14260,28,0,0,70,70,0,1,0,1,0
13426,28,0,0,69,69,0,1,0,1,0
11070,28,0,0,66,66,0,1,0,1,0
14387,28,0,0,66,66,0,1,0,1,0
17596,28,0,0,66,66,0,1,0,1,0
18701,28,0,0,70,70,0,1,0,1,0
12279,28,0,0,66,66,0,1,0,1,0
13808,28,0,0,66,66,0,1,0,1,0
17660,28,0,0,70,70,0,1,0,1,0
16768,28,0,0,70,70,0,1,0,1,0
22188,28,0,0,70,70,0,1,0,1,0
16039,28,0,0,70,70,0,1,0,1,0
16943,28,0,0,66,66,0,1,0,1,0
22118,28,0,0,70,70,0,1,0,1,0
10594,28,0,0,70,70,0,1,0,1,0
11228,28,0,0,70,70,0,1,0,1,0
20995,28,0,0,70,70,0,1,0,1,0
12242,28,0,0,66,66,0,1,0,1,0
13869,28,0,0,68,68,0,1,0,1,0
13270,28,0,0,70,70,0,1,0,1,0
16346,28,0,0,70,70,0,1,0,1,0
18225,28,0,0,70,70,0,1,0,1,0
12208,28,0,0,70,70,0,1,0,1,0
8575,28,0,0,70,70,0,1,0,1,0
11990,28,0,0,70,70,0,1,0,1,0
19414,28,0,0,66,66,0,1,0,1,0
16877,28,0,0,70,70,0,1,0,1,0
20610,28,0,0,70,70,0,1,0,1,0
21137,28,0,0,70,70,0,1,0,1,0
9318,28,0,0,70,70,0,1,0,1,0
20147,28,0,0,70,70,0,1,0,1,0
15094,28,0,0,66,66,0,1,0,1,0
17558,28,0,0,70,70,0,1,0,1,0
9904,28,0,0,70,70,0,1,0,1,0
16384,28,0,0,66,66,0,1,0,1,0
17807,28,0,0,67,67,0,1,0,1,0
12345,28,0,0,66,66,0,1,0,1,0
14086,28,0,0,69,69,0,1,0,1,0
13828,28,0,0,67,67,0,1,0,1,0
14852,28,0,0,66,66,0,1,0,1,0
17288,28,0,0,66,66,0,1,0,1,0
19959,28,0,0,70,70,0,1,0,1,0
20711,28,0,0,66,66,0,1,0,1,0
18041,28,0,0,67,67,0,1,0,1,0
9626,28,0,0,66,66,0,1,0,1,0
14151,28,0,0,70,70,0,1,0,1,0
19323,28,0,0,70,70,0,1,0,1,0
13312,28,0,0,66,66,0,1,0,1,0
10112,28,0,0,70,70,0,1,0,1,0
22297,28,0,0,70,70,0,1,0,1,0
16634,28,0,0,70,70,0,1,0,1,0
22643,28,0,0,66,66,0,1,0,1,0
19117,28,0,0,70,70,0,1,0,1,0
16558,28,0,0,68,68,0,1,0,1,0
17546,28,0,0,66,66,0,1,0,1,0
19672,28,0,0,66,66,0,1,0,1,0
21185,28,0,0,66,66,0,1,0,1,0
20187,28,0,0,70,70,0,1,0,1,0
13486,28,0,0,70,70,0,1,0,1,0
18100,28,0,0,68,68,0,1,0,1,0
17241,28,0,0,70,70,0,1,0,1,0
15994,28,0,0,66,66,0,1,0,1,0
21591,28,0,0,70,70,0,1,0,1,0
11115,28,0,0,70,70,0,1,0,1,0
10027,28,0,0,69,69,0,1,0,1,0
16693,28,0,0,66,66,0,1,0,1,0
18441,28,0,0,66,66,0,1,0,1,0
17049,28,0,0,68,68,0,1,0,1,0
18673,28,0,0,66,66,0,1,0,1,0
15342,28,0,0,70,70,0,1,0,1,0
18058,28,0,0,70,70,0,1,0,1,0
8359,28,0,0,70,70,0,1,0,1,0
16837,28,0,0,69,69,0,1,0,1,0
17809,28,0,0,70,70,0,1,0,1,0
11977,28,0,0,70,70,0,1,0,1,0
16384,28,0,0,66,66,0,1,0,1,0
17626,28,0,0,68,68,0,1,0,1,0
20905,28,0,0,66,66,0,1,0,1,0
10941,28,0,0,66,66,0,1,0,1,0
19922,28,0,0,70,70,0,1,0,1,0
15717,28,0,0,66,66,0,1,0,1,0
9356,28,0,0,70,70,0,1,0,1,0
17594,28,0,0,66,66,0,1,0,1,0
17630,28,0,0,70,70,0,1,0,1,0
15577,28,0,0,70,70,0,1,0,1,0
9152,28,0,0,66,66,0,1,0,1,0
9270,28,0,0,70,70,0,1,0,1,0
21600,28,0,0,66,66,0,1,0,1,0
15052,28,0,0,66,66,0,1,0,1,0
16996,28,0,0,66,66,0,1,0,1,0
17490,28,0,0,70,70,0,1,0,1,0
10682,28,0,0,69,69,0,1,0,1,0
16030,28,0,0,66,66,0,1,0,1,0
21823,28,0,0,70,70,0,1,0,1,0
9828,28,0,0,70,70,0,1,0,1,0
18145,28,0,0,66,66,0,1,0,1,0
18895,28,0,0,67,67,0,1,0,1,0
12433,28,0,0,70,70,0,1,0,1,0
16926,28,0,0,70,70,0,1,0,1,0
21027,28,0,0,66,66,0,1,0,1,0
18014,28,0,0,70,70,0,1,0,1,0
19246,28,0,0,68,68,0,1,0,1,0
12687,28,0,0,70,70,0,1,0,1,0
9855,28,0,0,70,70,0,1,0,1,0
16838,28,0,0,70,70,0,1,0,1,0
18866,28,0,0,69,69,0,1,0,1,0
21299,28,0,0,69,69,0,1,0,1,0
20383,28,0,0,70,70,0,1,0,1,0
13261,28,0,0,66,66,0,1,0,1,0
14939,28,0,0,70,70,0,1,0,1,0
10534,28,0,0,70,70,0,1,0,1,0
20216,28,0,0,70,70,0,1,0,1,0
10515,28,0,0,70,70,0,1,0,1,0
13967,28,0,0,70,70,0,1,0,1,0
17650,28,0,0,66,66,0,1,0,1,0
17790,28,0,0,70,70,0,1,0,1,0
19774,28,0,0,66,66,0,1,0,1,0
22649,28,0,0,70,70,0,1,0,1,0
21893,28,0,0,68,68,0,1,0,1,0
12644,28,0,0,68,68,0,1,0,1,0
19057,28,0,0,67,67,0,1,0,1,0
12995,28,0,0,70,70,0,1,0,1,0
19666,28,0,0,70,70,0,1,0,1,0
16254,28,0,0,70,70,0,1,0,1,0
16396,28,0,0,70,70,0,1,0,1,0
9323,28,0,0,70,70,0,1,0,1,0
9082,28,0,0,70,70,0,1,0,1,0
18042,28,0,0,69,69,0,1,0,1,0
11486,28,0,0,70,70,0,1,0,1,0
18683,28,0,0,66,66,0,1,0,1,0
11074,28,0,0,69,69,0,1,0,1,0
17520,28,0,0,66,66,0,1,0,1,0
16516,28,0,0,70,70,0,1,0,1,0
17628,28,0,0,70,70,0,1,0,1,0
14528,28,0,0,69,69,0,1,0,1,0
19891,28,0,0,70,70,0,1,0,1,0
17733,28,0,0,66,66,0,1,0,1,0
22705,28,0,0,70,70,0,1,0,1,0
12763,28,0,0,70,70,0,1,0,1,0
19043,28,0,0,70,70,0,1,0,1,0
8746,28,0,0,70,70,0,1,0,1,0
13470,28,0,0,70,70,0,1,0,1,0
21725,28,0,0,70,70,0,1,0,1,0
14619,28,0,0,70,70,0,1,0,1,0
18721,28,0,0,66,66,0,1,0,1,0
9313,28,0,0,66,66,0,1,0,1,0
18420,28,0,0,66,66,0,1,0,1,0
11196,28,0,0,67,67,0,1,0,1,0
16379,28,0,0,70,70,0,1,0,1,0
12525,28,0,0,66,66,0,1,0,1,0
20214,28,0,0,70,70,0,1,0,1,0
19655,28,0,0,66,66,0,1,0,1,0
11881,28,0,0,70,70,0,1,0,1,0
16172,28,0,0,70,70,0,1,0,1,0
12477,28,0,0,70,70,0,1,0,1,0
19180,28,0,0,70,70,0,1,0,1,0
21753,28,0,0,68,68,0,1,0,1,0
18316,28,0,0,70,70,0,1,0,1,0
22400,28,0,0,66,66,0,1,0,1,0
15779,28,0,0,66,66,0,1,0,1,0
9791,28,0,0,70,70,0,1,0,1,0
19807,28,0,0,70,70,0,1,0,1,0
22567,28,0,0,66,66,0,1,0,1,0
14564,28,0,0,70,70,0,1,0,1,0
20435,28,0,0,70,70,0,1,0,1,0
8889,28,0,0,70,70,0,1,0,1,0
10915,28,0,0,70,70,0,1,0,1,0
18928,28,0,0,68,68,0,1,0,1,0
18259,28,0,0,66,66,0,1,0,1,0
14523,28,0,0,70,70,0,1,0,1,0
20218,28,0,0,70,70,0,1,0,1,0
11992,28,0,0,70,70,0,1,0,1,0
15511,28,0,0,70,70,0,1,0,1,0
11464,28,0,0,66,66,0,1,0,1,0
9893,28,0,0,66,66,0,1,0,1,0
17445,28,0,0,70,70,0,1,0,1,0
11213,28,0,0,70,70,0,1,0,1,0
16444,28,0,0,66,66,0,1,0,1,0
22469,28,0,0,66,66,0,1,0,1,0
17627,28,0,0,70,70,0,1,0,1,0
12961,28,0,0,70,70,0,1,0,1,0
22429,28,0,0,70,70,0,1,0,1,0
19673,28,0,0,66,66,0,1,0,1,0
15655,28,0,0,70,70,0,1,0,1,0
11842,28,0,0,66,66,0,1,0,1,0
13609,28,0,0,70,70,0,1,0,1,0
17972,28,0,0,70,70,0,1,0,1,0
8532,28,0,0,70,70,0,1,0,1,0
9498,28,0,0,70,70,0,1,0,1,0
15909,28,0,0,66,66,0,1,0,1,0
13429,28,0,0,66,66,0,1,0,1,0
10027,28,0,0,70,70,0,1,0,1,0
17073,28,0,0,67,67,0,1,0,1,0
8874,28,0,0,70,70,0,1,0,1,0
19160,28,0,0,67,67,0,1,0,1,0
19789,28,0,0,68,68,0,1,0,1,0
9569,28,0,0,66,66,0,1,0,1,0
14420,28,0,0,70,70,0,1,0,1,0
14374,28,0,0,66,66,0,1,0,1,0
20665,28,0,0,70,70,0,1,0,1,0
19047,28,0,0,70,70,0,1,0,1,0
17811,28,0,0,68,68,0,1,0,1,0
10941,28,0,0,67,67,0,1,0,1,0
10991,28,0,0,66,66,0,1,0,1,0
19329,28,0,0,70,70,0,1,0,1,0
16084,28,0,0,66,66,0,1,0,1,0
18169,28,0,0,66,66,0,1,0,1,0
18570,28,0,0,67,67,0,1,0,1,0
10947,28,0,0,69,69,0,1,0,1,0
16873,28,0,0,70,70,0,1,0,1,0
19019,28,0,0,70,70,0,1,0,1,0
9414,28,0,0,68,68,0,1,0,1,0
22175,28,0,0,70,70,0,1,0,1,0
17162,28,0,0,70,70,0,1,0,1,0
10785,28,0,0,70,70,0,1,0,1,0
14869,28,0,0,70,70,0,1,0,1,0
13994,28,0,0,70,70,0,1,0,1,0
17696,28,0,0,70,70,0,1,0,1,0
15348,28,0,0,70,70,0,1,0,1,0
16586,28,0,0,70,70,0,1,0,1,0
12313,28,0,0,70,70,0,1,0,1,0
15480,28,0,0,70,70,0,1,0,1,0
9255,28,0,0,66,66,0,1,0,1,0
18152,28,0,0,69,69,0,1,0,1,0
21236,28,0,0,66,66,0,1,0,1,0
16094,28,0,0,68,68,0,1,0,1,0
19340,28,0,0,67,67,0,1,0,1,0
21176,28,0,0,70,70,0,1,0,1,0
18410,28,0,0,70,70,0,1,0,1,0
13448,28,0,0,70,70,0,1,0,1,0
21832,28,0,0,66,66,0,1,0,1,0
16011,28,0,0,69,69,0,1,0,1,0
20953,28,0,0,70,70,0,1,0,1,0
15727,28,0,0,70,70,0,1,0,1,0
13445,28,0,0,70,70,0,1,0,1,0
16800,28,0,0,70,70,0,1,0,1,0
21034,28,0,0,70,70,0,1,0,1,0
10302,28,0,0,66,66,0,1,0,1,0
17216,28,0,0,66,66,0,1,0,1,0
22097,28,0,0,70,70,0,1,0,1,0
21713,28,0,0,67,67,0,1,0,1,0
17158,28,0,0,70,70,0,1,0,1,0
21095,28,0,0,70,70,0,1,0,1,0
14673,28,0,0,70,70,0,1,0,1,0
18987,28,0,0,70,70,0,1,0,1,0
12000,28,0,0,66,66,0,1,0,1,0
17799,28,0,0,66,66,0,1,0,1,0
16981,28,0,0,70,70,0,1,0,1,0
9903,28,0,0,70,70,0,1,0,1,0
16725,28,0,0,70,70,0,1,0,1,0
9894,28,0,0,70,70,0,1,0,1,0
20910,28,0,0,68,68,0,1,0,1,0
16830,28,0,0,70,70,0,1,0,1,0
19340,28,0,0,68,68,0,1,0,1,0
8997,28,0,0,70,70,0,1,0,1,0
14817,28,0,0,70,70,0,1,0,1,0
13973,28,0,0,70,70,0,1,0,1,0
14968,28,0,0,70,70,0,1,0,1,0
13778,28,0,0,70,70,0,1,0,1,0
10332,28,0,0,70,70,0,1,0,1,0
10167,28,0,0,70,70,0,1,0,1,0
13812,28,0,0,69,69,0,1,0,1,0
9351,28,0,0,70,70,0,1,0,1,0
12992,28,0,0,70,70,0,1,0,1,0
11055,28,0,0,66,66,0,1,0,1,0
18663,28,0,0,70,70,0,1,0,1,0
14521,28,0,0,70,70,0,1,0,1,0
17905,28,0,0,66,66,0,1,0,1,0
12927,28,0,0,70,70,0,1,0,1,0
9319,28,0,0,70,70,0,1,0,1,0
20443,28,0,0,66,66,0,1,0,1,0
22671,28,0,0,70,70,0,1,0,1,0
17240,28,0,0,70,70,0,1,0,1,0
13049,28,0,0,70,70,0,1,0,1,0
18863,28,0,0,70,70,0,1,0,1,0
13988,28,0,0,67,67,0,1,0,1,0
17553,28,0,0,70,70,0,1,0,1,0
9146,28,0,0,70,70,0,1,0,1,0
16433,28,0,0,66,66,0,1,0,1,0
11809,28,0,0,68,68,0,1,0,1,0
21824,28,0,0,70,70,0,1,0,1,0
21366,28,0,0,69,69,0,1,0,1,0
8587,28,0,0,70,70,0,1,0,1,0
19425,28,0,0,66,66,0,1,0,1,0
8873,28,0,0,70,70,0,1,0,1,0
21236,28,0,0,70,70,0,1,0,1,0
10400,28,0,0,70,70,0,1,0,1,0
9748,28,0,0,70,70,0,1,0,1,0
12406,28,0,0,69,69,0,1,0,1,0
19579,28,0,0,70,70,0,1,0,1,0
16036,28,0,0,70,70,0,1,0,1,0
14456,28,0,0,70,70,0,1,0,1,0
20439,28,0,0,69,69,0,1,0,1,0
19716,28,0,0,68,68,0,1,0,1,0
19554,28,0,0,70,70,0,1,0,1,0
20538,28,0,0,70,70,0,1,0,1,0
19975,28,0,0,70,70,0,1,0,1,0
19018,28,0,0,66,66,0,1,0,1,0
10220,28,0,0,70,70,0,1,0,1,0
14147,28,0,0,70,70,0,1,0,1,0
10222,28,0,0,66,66,0,1,0,1,0
11390,28,0,0,70,70,0,1,0,1,0
19077,28,0,0,70,70,0,1,0,1,0
8818,28,0,0,66,66,0,1,0,1,0
14085,28,0,0,70,70,0,1,0,1,0
10160,28,0,0,70,70,0,1,0,1,0
20286,28,0,0,70,70,0,1,0,1,0
14937,28,0,0,69,69,0,1,0,1,0
9411,28,0,0,70,70,0,1,0,1,0
19633,28,0,0,70,70,0,1,0,1,0
22564,28,0,0,66,66,0,1,0,1,0
19970,28,0,0,66,66,0,1,0,1,0
19004,28,0,0,66,66,0,1,0,1,0
22550,28,0,0,70,70,0,1,0,1,0
11797,28,0,0,66,66,0,1,0,1,0
16657,28,0,0,66,66,0,1,0,1,0
13480,28,0,0,70,70,0,1,0,1,0
15685,28,0,0,70,70,0,1,0,1,0
20405,28,0,0,70,70,0,1,0,1,0
14612,28,0,0,69,69,0,1,0,1,0
20768,28,0,0,70,70,0,1,0,1,0
21132,28,0,0,70,70,0,1,0,1,0
19909,28,0,0,70,70,0,1,0,1,0
18412,28,0,0,70,70,0,1,0,1,0
9322,28,0,0,68,68,0,1,0,1,0
11595,28,0,0,70,70,0,1,0,1,0
13318,28,0,0,66,66,0,1,0,1,0
22442,28,0,0,66,66,0,1,0,1,0
17458,28,0,0,70,70,0,1,0,1,0
11629,28,0,0,70,70,0,1,0,1,0
21006,28,0,0,68,68,0,1,0,1,0
20295,28,0,0,66,66,0,1,0,1,0
17491,28,0,0,70,70,0,1,0,1,0
17811,28,0,0,67,67,0,1,0,1,0
13343,28,0,0,70,70,0,1,0,1,0
12998,28,0,0,69,69,0,1,0,1,0
20808,28,0,0,70,70,0,1,0,1,0
17129,28,0,0,69,69,0,1,0,1,0
8394,28,0,0,70,70,0,1,0,1,0
8397,28,0,0,70,70,0,1,0,1,0
9599,28,0,0,70,70,0,1,0,1,0
12643,28,0,0,70,70,0,1,0,1,0
15088,28,0,0,69,69,0,1,0,1,0
9892,28,0,0,66,66,0,1,0,1,0
20524,28,0,0,66,66,0,1,0,1,0
21354,28,0,0,70,70,0,1,0,1,0
22011,28,0,0,66,66,0,1,0,1,0
16808,28,0,0,70,70,0,1,0,1,0
9621,28,0,0,70,70,0,1,0,1,0
21478,28,0,0,66,66,0,1,0,1,0
18088,28,0,0,70,70,0,1,0,1,0
9935,28,0,0,66,66,0,1,0,1,0
18226,28,0,0,70,70,0,1,0,1,0
19048,28,0,0,70,70,0,1,0,1,0
9346,28,0,0,70,70,0,1,0,1,0
19503,28,0,0,70,70,0,1,0,1,0
22012,28,0,0,66,66,0,1,0,1,0
18414,28,0,0,70,70,0,1,0,1,0
20171,28,0,0,66,66,0,1,0,1,0
15788,28,0,0,70,70,0,1,0,1,0
22213,28,0,0,70,70,0,1,0,1,0
14823,28,0,0,70,70,0,1,0,1,0
17594,28,0,0,66,66,0,1,0,1,0
13912,28,0,0,70,70,0,1,0,1,0
21579,28,0,0,70,70,0,1,0,1,0
20042,28,0,0,68,68,0,1,0,1,0
17257,28,0,0,66,66,0,1,0,1,0
15973,28,0,0,66,66,0,1,0,1,0
11974,28,0,0,70,70,0,1,0,1,0
20019,28,0,0,70,70,0,1,0,1,0
22585,28,0,0,66,66,0,1,0,1,0
16137,28,0,0,67,67,0,1,0,1,0
10081,28,0,0,70,70,0,1,0,1,0
11718,28,0,0,70,70,0,1,0,1,0
21186,28,0,0,70,70,0,1,0,1,0
21789,28,0,0,70,70,0,1,0,1,0
13935,28,0,0,66,66,0,1,0,1,0
21705,28,0,0,70,70,0,1,0,1,0
10737,28,0,0,67,67,0,1,0,1,0
15559,28,0,0,70,70,0,1,0,1,0
17992,28,0,0,70,70,0,1,0,1,0
9876,28,0,0,70,70,0,1,0,1,0
12823,28,0,0,70,70,0,1,0,1,0
21136,28,0,0,68,68,0,1,0,1,0
13925,28,0,0,70,70,0,1,0,1,0
13211,28,0,0,70,70,0,1,0,1,0
16453,28,0,0,68,68,0,1,0,1,0
13956,28,0,0,70,70,0,1,0,1,0
10160,28,0,0,70,70,0,1,0,1,0
14068,28,0,0,70,70,0,1,0,1,0
19957,28,0,0,70,70,0,1,0,1,0
14263,28,0,0,67,67,0,1,0,1,0
14724,28,0,0,70,70,0,1,0,1,0
15066,28,0,0,68,68,0,1,0,1,0
13117,28,0,0,70,70,0,1,0,1,0
18987,28,0,0,70,70,0,1,0,1,0
16614,28,0,0,70,70,0,1,0,1,0
20155,28,0,0,66,66,0,1,0,1,0
13401,28,0,0,70,70,0,1,0,1,0
16093,28,0,0,66,66,0,1,0,1,0
21252,28,0,0,69,69,0,1,0,1,0
12175,28,0,0,68,68,0,1,0,1,0
17707,28,0,0,67,67,0,1,0,1,0
13097,28,0,0,70,70,0,1,0,1,0
16551,28,0,0,70,70,0,1,0,1,0
11694,28,0,0,70,70,0,1,0,1,0
21736,28,0,0,70,70,0,1,0,1,0
16286,28,0,0,70,70,0,1,0,1,0
9998,28,0,0,70,70,0,1,0,1,0
19822,28,0,0,70,70,0,1,0,1,0
17160,28,0,0,70,70,0,1,0,1,0
18504,28,0,0,70,70,0,1,0,1,0
16648,28,0,0,69,69,0,1,0,1,0
10255,28,0,0,68,68,0,1,0,1,0
14781,28,0,0,67,67,0,1,0,1,0
12191,28,0,0,70,70,0,1,0,1,0
16472,28,0,0,67,67,0,1,0,1,0
19629,28,0,0,70,70,0,1,0,1,0
15448,28,0,0,70,70,0,1,0,1,0
13907,28,0,0,70,70,0,1,0,1,0
12393,28,0,0,68,68,0,1,0,1,0
18117,28,0,0,70,70,0,1,0,1,0
21974,28,0,0,66,66,0,1,0,1,0
13845,28,0,0,70,70,0,1,0,1,0
13945,28,0,0,70,70,0,1,0,1,0
10511,28,0,0,70,70,0,1,0,1,0
20383,28,0,0,67,67,0,1,0,1,0
15271,28,0,0,70,70,0,1,0,1,0
10441,28,0,0,68,68,0,1,0,1,0
15552,28,0,0,70,70,0,1,0,1,0
19882,28,0,0,70,70,0,1,0,1,0
18507,28,0,0,68,68,0,1,0,1,0
9133,28,0,0,66,66,0,1,0,1,0
18344,28,0,0,70,70,0,1,0,1,0
15255,28,0,0,70,70,0,1,0,1,0
20338,28,0,0,66,66,0,1,0,1,0
18139,28,0,0,70,70,0,1,0,1,0
19961,28,0,0,70,70,0,1,0,1,0
17160,28,0,0,70,70,0,1,0,1,0
14028,28,0,0,70,70,0,1,0,1,0
9791,28,0,0,68,68,0,1,0,1,0
9817,28,0,0,66,66,0,1,0,1,0
10840,28,0,0,70,70,0,1,0,1,0
10499,28,0,0,69,69,0,1,0,1,0
9892,28,0,0,66,66,0,1,0,1,0
15282,28,0,0,66,66,0,1,0,1,0
14136,28,0,0,66,66,0,1,0,1,0
10603,28,0,0,70,70,0,1,0,1,0
14502,28,0,0,70,70,0,1,0,1,0
13623,28,0,0,66,66,0,1,0,1,0
16219,28,0,0,70,70,0,1,0,1,0
11514,28,0,0,70,70,0,1,0,1,0
19098,28,0,0,70,70,0,1,0,1,0
19153,28,0,0,70,70,0,1,0,1,0
13609,28,0,0,70,70,0,1,0,1,0
10185,28,0,0,70,70,0,1,0,1,0
13493,28,0,0,67,67,0,1,0,1,0
20597,28,0,0,70,70,0,1,0,1,0
9272,28,0,0,70,70,0,1,0,1,0
10797,28,0,0,68,68,0,1,0,1,0
21427,28,0,0,69,69,0,1,0,1,0
13441,28,0,0,70,70,0,1,0,1,0
11778,28,0,0,68,68,0,1,0,1,0
15100,28,0,0,66,66,0,1,0,1,0
15392,28,0,0,66,66,0,1,0,1,0
9484,28,0,0,70,70,0,1,0,1,0
18780,28,0,0,66,66,0,1,0,1,0
16177,28,0,0,70,70,0,1,0,1,0
16787,28,0,0,70,70,0,1,0,1,0
20599,28,0,0,66,66,0,1,0,1,0
9628,28,0,0,70,70,0,1,0,1,0
22337,28,0,0,66,66,0,1,0,1,0
8732,28,0,0,70,70,0,1,0,1,0
13359,28,0,0,70,70,0,1,0,1,0
12469,28,0,0,66,66,0,1,0,1,0
22565,28,0,0,70,70,0,1,0,1,0
11777,28,0,0,70,70,0,1,0,1,0
10498,28,0,0,66,66,0,1,0,1,0
21675,28,0,0,70,70,0,1,0,1,0
8948,28,0,0,70,70,0,1,0,1,0
22287,28,0,0,70,70,0,1,0,1,0
11800,28,0,0,70,70,0,1,0,1,0
12863,28,0,0,67,67,0,1,0,1,0
8962,28,0,0,70,70,0,1,0,1,0
14364,28,0,0,66,66,0,1,0,1,0
8932,28,0,0,70,70,0,1,0,1,0
10057,28,0,0,66,66,0,1,0,1,0
17405,28,0,0,70,70,0,1,0,1,0
11366,28,0,0,70,70,0,1,0,1,0
10500,28,0,0,66,66,0,1,0,1,0
22322,28,0,0,66,66,0,1,0,1,0
11532,28,0,0,66,66,0,1,0,1,0
13634,28,0,0,70,70,0,1,0,1,0
16899,28,0,0,66,66,0,1,0,1,0
10752,28,0,0,68,68,0,1,0,1,0
13912,28,0,0,70,70,0,1,0,1,0
10034,28,0,0,70,70,0,1,0,1,0
13296,28,0,0,67,67,0,1,0,1,0
9292,28,0,0,70,70,0,1,0,1,0
9959,28,0,0,66,66,0,1,0,1,0
17675,28,0,0,70,70,0,1,0,1,0
11669,28,0,0,70,70,0,1,0,1,0
21915,28,0,0,70,70,0,1,0,1,0
8333,28,0,0,70,70,0,1,0,1,0
21844,28,0,0,69,69,0,1,0,1,0
10528,28,0,0,69,69,0,1,0,1,0
11430,28,0,0,70,70,0,1,0,1,0
13897,28,0,0,70,70,0,1,0,1,0
21841,28,0,0,66,66,0,1,0,1,0
8689,28,0,0,70,70,0,1,0,1,0
18046,28,0,0,70,70,0,1,0,1,0
13474,28,0,0,70,70,0,1,0,1,0
8515,28,0,0,70,70,0,1,0,1,0
9271,28,0,0,70,70,0,1,0,1,0
16007,28,0,0,70,70,0,1,0,1,0
21953,28,0,0,70,70,0,1,0,1,0
18226,28,0,0,70,70,0,1,0,1,0
15278,28,0,0,70,70,0,1,0,1,0
16442,28,0,0,70,70,0,1,0,1,0
9917,28,0,0,70,70,0,1,0,1,0
20323,28,0,0,69,69,0,1,0,1,0
17499,28,0,0,70,70,0,1,0,1,0
12900,28,0,0,69,69,0,1,0,1,0
21727,28,0,0,67,67,0,1,0,1,0
11686,28,0,0,66,66,0,1,0,1,0
12863,28,0,0,70,70,0,1,0,1,0
17029,28,0,0,66,66,0,1,0,1,0
9187,28,0,0,66,66,0,1,0,1,0
22547,28,0,0,70,70,0,1,0,1,0
16179,28,0,0,70,70,0,1,0,1,0
17341,28,0,0,70,70,0,1,0,1,0
14599,28,0,0,70,70,0,1,0,1,0
13031,28,0,0,70,70,0,1,0,1,0
9863,28,0,0,67,67,0,1,0,1,0
11970,28,0,0,70,70,0,1,0,1,0
13736,28,0,0,70,70,0,1,0,1,0
12585,28,0,0,70,70,0,1,0,1,0
8376,28,0,0,70,70,0,1,0,1,0
10632,28,0,0,70,70,0,1,0,1,0
9757,28,0,0,70,70,0,1,0,1,0
14882,28,0,0,70,70,0,1,0,1,0
19970,28,0,0,67,67,0,1,0,1,0
20218,28,0,0,70,70,0,1,0,1,0
21463,28,0,0,66,66,0,1,0,1,0
13028,28,0,0,70,70,0,1,0,1,0
14306,28,0,0,70,70,0,1,0,1,0
13338,28,0,0,66,66,0,1,0,1,0
19048,28,0,0,70,70,0,1,0,1,0
16929,28,0,0,66,66,0,1,0,1,0
22720,28,0,0,66,66,0,1,0,1,0
17231,28,0,0,70,70,0,1,0,1,0
20645,28,0,0,70,70,0,1,0,1,0
18181,28,0,0,70,70,0,1,0,1,0
16566,28,0,0,66,66,0,1,0,1,0
8640,28,0,0,70,70,0,1,0,1,0
14972,28,0,0,66,66,0,1,0,1,0
19682,28,0,0,70,70,0,1,0,1,0
11934,28,0,0,70,70,0,1,0,1,0
9312,28,0,0,70,70,0,1,0,1,0
17201,28,0,0,70,70,0,1,0,1,0
16834,28,0,0,70,70,0,1,0,1,0
11333,28,0,0,70,70,0,1,0,1,0
10193,28,0,0,70,70,0,1,0,1,0
21488,28,0,0,66,66,0,1,0,1,0
19047,28,0,0,70,70,0,1,0,1,0
17470,28,0,0,66,66,0,1,0,1,0
11364,28,0,0,70,70,0,1,0,1,0
10026,28,0,0,70,70,0,1,0,1,0
9589,28,0,0,70,70,0,1,0,1,0
16511,28,0,0,66,66,0,1,0,1,0
10889,28,0,0,70,70,0,1,0,1,0
22184,28,0,0,70,70,0,1,0,1,0
15358,28,0,0,66,66,0,1,0,1,0
15806,28,0,0,70,70,0,1,0,1,0
18397,28,0,0,70,70,0,1,0,1,0
22427,28,0,0,70,70,0,1,0,1,0
18417,28,0,0,70,70,0,1,0,1,0
14207,28,0,0,70,70,0,1,0,1,0
17123,28,0,0,68,68,0,1,0,1,0
10500,28,0,0,66,66,0,1,0,1,0
21464,28,0,0,70,70,0,1,0,1,0
9102,28,0,0,70,70,0,1,0,1,0
13226,28,0,0,70,70,0,1,0,1,0
18254,28,0,0,70,70,0,1,0,1,0
10126,28,0,0,70,70,0,1,0,1,0
14709,28,0,0,67,67,0,1,0,1,0
12229,28,0,0,68,68,0,1,0,1,0
16065,28,0,0,68,68,0,1,0,1,0
9293,28,0,0,70,70,0,1,0,1,0
13787,28,0,0,70,70,0,1,0,1,0
21356,28,0,0,70,70,0,1,0,1,0
18780,28,0,0,67,67,0,1,0,1,0
22265,28,0,0,70,70,0,1,0,1,0
10127,28,0,0,70,70,0,1,0,1,0
8658,28,0,0,70,70,0,1,0,1,0
10348,28,0,0,66,66,0,1,0,1,0
8356,28,0,0,70,70,0,1,0,1,0
21490,28,0,0,66,66,0,1,0,1,0
9911,28,0,0,70,70,0,1,0,1,0
8969,28,0,0,70,70,0,1,0,1,0
13448,28,0,0,70,70,0,1,0,1,0
20774,28,0,0,69,69,0,1,0,1,0
12479,28,0,0,70,70,0,1,0,1,0
17240,28,0,0,70,70,0,1,0,1,0
15903,28,0,0,70,70,0,1,0,1,0
11671,28,0,0,70,70,0,1,0,1,0
20398,28,0,0,70,70,0,1,0,1,0
14587,28,0,0,70,70,0,1,0,1,0
20504,28,0,0,66,66,0,1,0,1,0
11583,28,0,0,70,70,0,1,0,1,0
22385,28,0,0,70,70,0,1,0,1,0
18258,28,0,0,66,66,0,1,0,1,0
16344,28,0,0,66,66,0,1,0,1,0
19809,28,0,0,70,70,0,1,0,1,0
16803,28,0,0,70,70,0,1,0,1,0
20082,28,0,0,70,70,0,1,0,1,0
19970,28,0,0,66,66,0,1,0,1,0
11052,28,0,0,66,66,0,1,0,1,0
22579,28,0,0,66,66,0,1,0,1,0
20638,28,0,0,70,70,0,1,0,1,0
19999,28,0,0,70,70,0,1,0,1,0
8470,28,0,0,70,70,0,1,0,1,0
15342,28,0,0,70,70,0,1,0,1,0
20381,28,0,0,66,66,0,1,0,1,0
20268,28,0,0,69,69,0,1,0,1,0
20639,28,0,0,70,70,0,1,0,1,0
10149,28,0,0,70,70,0,1,0,1,0
20663,28,0,0,70,70,0,1,0,1,0
11914,28,0,0,66,66,0,1,0,1,0
18489,28,0,0,70,70,0,1,0,1,0
13862,28,0,0,66,66,0,1,0,1,0
13758,28,0,0,70,70,0,1,0,1,0
8699,28,0,0,70,70,0,1,0,1,0
17542,28,0,0,68,68,0,1,0,1,0
19715,28,0,0,70,70,0,1,0,1,0
10432,28,0,0,70,70,0,1,0,1,0
8471,28,0,0,69,69,0,1,0,1,0
10602,28,0,0,70,70,0,1,0,1,0
13325,28,0,0,66,66,0,1,0,1,0
15470,28,0,0,66,66,0,1,0,1,0
17739,28,0,0,70,70,0,1,0,1,0
15692,28,0,0,67,67,0,1,0,1,0
11119,28,0,0,66,66,0,1,0,1,0
16427,28,0,0,70,70,0,1,0,1,0
17685,28,0,0,66,66,0,1,0,1,0
14011,28,0,0,66,66,0,1,0,1,0
11845,28,0,0,70,70,0,1,0,1,0
15288,28,0,0,70,70,0,1,0,1,0
10173,28,0,0,66,66,0,1,0,1,0
16892,28,0,0,70,70,0,1,0,1,0
17700,28,0,0,70,70,0,1,0,1,0
15987,28,0,0,70,70,0,1,0,1,0
10783,28,0,0,70,70,0,1,0,1,0
15659,28,0,0,70,70,0,1,0,1,0
19082,28,0,0,70,70,0,1,0,1,0
17006,28,0,0,70,70,0,1,0,1,0
12545,28,0,0,67,67,0,1,0,1,0
13644,28,0,0,70,70,0,1,0,1,0
13950,28,0,0,67,67,0,1,0,1,0
11482,28,0,0,68,68,0,1,0,1,0
17918,28,0,0,70,70,0,1,0,1,0
21626,28,0,0,70,70,0,1,0,1,0
11169,28,0,0,68,68,0,1,0,1,0
17976,28,0,0,70,70,0,1,0,1,0
22671,28,0,0,70,70,0,1,0,1,0
20932,28,0,0,66,66,0,1,0,1,0
20745,28,0,0,69,69,0,1,0,1,0
8534,28,0,0,68,68,0,1,0,1,0
19580,28,0,0,70,70,0,1,0,1,0
11583,28,0,0,70,70,0,1,0,1,0
12207,28,0,0,70,70,0,1,0,1,0
11581,28,0,0,70,70,0,1,0,1,0
13570,28,0,0,67,67,0,1,0,1,0
13841,28,0,0,70,70,0,1,0,1,0
20067,28,0,0,70,70,0,1,0,1,0
14770,28,0,0,69,69,0,1,0,1,0
12121,28,0,0,70,70,0,1,0,1,0
13624,28,0,0,66,66,0,1,0,1,0
10257,28,0,0,69,69,0,1,0,1,0
12349,28,0,0,70,70,0,1,0,1,0
16648,28,0,0,66,66,0,1,0,1,0
17306,28,0,0,70,70,0,1,0,1,0
12943,28,0,0,70,70,0,1,0,1,0
17839,28,0,0,69,69,0,1,0,1,0
12354,28,0,0,70,70,0,1,0,1,0
17028,28,0,0,67,67,0,1,0,1,0
12008,28,0,0,70,70,0,1,0,1,0
13859,28,0,0,70,70,0,1,0,1,0
9239,28,0,0,66,66,0,1,0,1,0
21423,28,0,0,70,70,0,1,0,1,0
16734,28,0,0,70,70,0,1,0,1,0
15202,28,0,0,69,69,0,1,0,1,0
12522,28,0,0,66,66,0,1,0,1,0
16737,28,0,0,70,70,0,1,0,1,0
22598,28,0,0,66,66,0,1,0,1,0
10603,28,0,0,70,70,0,1,0,1,0
12714,28,0,0,70,70,0,1,0,1,0
12837,28,0,0,70,70,0,1,0,1,0
20985,28,0,0,70,70,0,1,0,1,0
19086,28,0,0,68,68,0,1,0,1,0
15619,28,0,0,66,66,0,1,0,1,0
22550,28,0,0,70,70,0,1,0,1,0
18468,28,0,0,68,68,0,1,0,1,0
17406,28,0,0,70,70,0,1,0,1,0
14402,28,0,0,70,70,0,1,0,1,0
16514,28,0,0,70,70,0,1,0,1,0
11887,28,0,0,66,66,0,1,0,1,0
10499,28,0,0,66,66,0,1,0,1,0
17002,28,0,0,70,70,0,1,0,1,0
15590,28,0,0,66,66,0,1,0,1,0
20657,28,0,0,66,66,0,1,0,1,0
8567,28,0,0,66,66,0,1,0,1,0
11893,28,0,0,70,70,0,1,0,1,0
16429,28,0,0,70,70,0,1,0,1,0
11194,28,0,0,70,70,0,1,0,1,0
19442,28,0,0,70,70,0,1,0,1,0
9951,28,0,0,70,70,0,1,0,1,0
10550,28,0,0,66,66,0,1,0,1,0
13776,28,0,0,70,70,0,1,0,1,0
11460,28,0,0,66,66,0,1,0,1,0
14124,28,0,0,70,70,0,1,0,1,0
15607,28,0,0,70,70,0,1,0,1,0
11825,28,0,0,66,66,0,1,0,1,0
16193,28,0,0,67,67,0,1,0,1,0
19838,28,0,0,70,70,0,1,0,1,0
21576,28,0,0,70,70,0,1,0,1,0
18187,28,0,0,66,66,0,1,0,1,0
18581,28,0,0,67,67,0,1,0,1,0
13739,28,0,0,66,66,0,1,0,1,0
11147,28,0,0,69,69,0,1,0,1,0
20936,28,0,0,66,66,0,1,0,1,0
22029,28,0,0,66,66,0,1,0,1,0
16696,28,0,0,68,68,0,1,0,1,0
16068,28,0,0,69,69,0,1,0,1,0
11892,28,0,0,70,70,0,1,0,1,0
17939,28,0,0,70,70,0,1,0,1,0
10455,28,0,0,70,70,0,1,0,1,0
22103,28,0,0,68,68,0,1,0,1,0
13946,28,0,0,70,70,0,1,0,1,0
20004,28,0,0,70,70,0,1,0,1,0
13046,28,0,0,70,70,0,1,0,1,0
18931,28,0,0,70,70,0,1,0,1,0
10620,28,0,0,70,70,0,1,0,1,0
9264,28,0,0,70,70,0,1,0,1,0
20500,28,0,0,70,70,0,1,0,1,0
18985,28,0,0,68,68,0,1,0,1,0
12787,28,0,0,66,66,0,1,0,1,0
9918,28,0,0,70,70,0,1,0,1,0
15771,28,0,0,70,70,0,1,0,1,0
13399,28,0,0,70,70,0,1,0,1,0
17636,28,0,0,66,66,0,1,0,1,0
14583,28,0,0,70,70,0,1,0,1,0
16646,28,0,0,66,66,0,1,0,1,0
22467,28,0,0,66,66,0,1,0,1,0
17273,28,0,0,70,70,0,1,0,1,0
16387,28,0,0,66,66,0,1,0,1,0
8812,28,0,0,69,69,0,1,0,1,0
19597,28,0,0,66,66,0,1,0,1,0
17330,28,0,0,67,67,0,1,0,1,0
16714,28,0,0,69,69,0,1,0,1,0
19374,28,0,0,70,70,0,1,0,1,0
19728,28,0,0,70,70,0,1,0,1,0
22056,28,0,0,70,70,0,1,0,1,0
12079,28,0,0,66,66,0,1,0,1,0
17407,28,0,0,66,66,0,1,0,1,0
14294,28,0,0,70,70,0,1,0,1,0
14011,28,0,0,69,69,0,1,0,1,0
19699,28,0,0,70,70,0,1,0,1,0
16444,28,0,0,70,70,0,1,0,1,0
10076,28,0,0,70,70,0,1,0,1,0
13480,28,0,0,70,70,0,1,0,1,0
21958,28,0,0,70,70,0,1,0,1,0
10199,28,0,0,66,66,0,1,0,1,0
10988,28,0,0,68,68,0,1,0,1,0
12125,28,0,0,66,66,0,1,0,1,0
13709,28,0,0,70,70,0,1,0,1,0
18724,28,0,0,70,70,0,1,0,1,0
11929,28,0,0,70,70,0,1,0,1,0
12719,28,0,0,66,66,0,1,0,1,0
15685,28,0,0,70,70,0,1,0,1,0
21481,28,0,0,66,66,0,1,0,1,0
16741,28,0,0,66,66,0,1,0,1,0
15273,28,0,0,70,70,0,1,0,1,0
10295,28,0,0,66,66,0,1,0,1,0
20797,28,0,0,70,70,0,1,0,1,0
21886,28,0,0,69,69,0,1,0,1,0
22026,28,0,0,68,68,0,1,0,1,0
19315,28,0,0,70,70,0,1,0,1,0
15983,28,0,0,67,67,0,1,0,1,0
11631,28,0,0,70,70,0,1,0,1,0
17234,28,0,0,68,68,0,1,0,1,0
21345,28,0,0,70,70,0,1,0,1,0
13943,28,0,0,70,70,0,1,0,1,0
13123,28,0,0,70,70,0,1,0,1,0
18625,28,0,0,70,70,0,1,0,1,0
12983,28,0,0,70,70,0,1,0,1,0
19672,28,0,0,70,70,0,1,0,1,0
17776,28,0,0,70,70,0,1,0,1,0
16883,28,0,0,70,70,0,1,0,1,0
20819,28,0,0,70,70,0,1,0,1,0
14025,28,0,0,70,70,0,1,0,1,0
11328,28,0,0,70,70,0,1,0,1,0
15346,28,0,0,70,70,0,1,0,1,0
9369,28,0,0,70,70,0,1,0,1,0
11146,28,0,0,66,66,0,1,0,1,0
17627,28,0,0,70,70,0,1,0,1,0
16595,28,0,0,70,70,0,1,0,1,0
21284,28,0,0,70,70,0,1,0,1,0
21235,28,0,0,66,66,0,1,0,1,0
14583,28,0,0,67,67,0,1,0,1,0
16674,28,0,0,70,70,0,1,0,1,0
16339,28,0,0,66,66,0,1,0,1,0
14125,28,0,0,70,70,0,1,0,1,0
19350,28,0,0,70,70,0,1,0,1,0
13613,28,0,0,66,66,0,1,0,1,0
9420,28,0,0,70,70,0,1,0,1,0
14385,28,0,0,68,68,0,1,0,1,0
18570,28,0,0,66,66,0,1,0,1,0
19140,28,0,0,70,70,0,1,0,1,0
18344,28,0,0,70,70,0,1,0,1,0
11185,28,0,0,66,66,0,1,0,1,0
16103,28,0,0,70,70,0,1,0,1,0
13340,28,0,0,67,67,0,1,0,1,0
22029,28,0,0,66,66,0,1,0,1,0
9865,28,0,0,70,70,0,1,0,1,0
15776,28,0,0,69,69,0,1,0,1,0
16238,28,0,0,66,66,0,1,0,1,0
10495,28,0,0,70,70,0,1,0,1,0
21833,28,0,0,68,68,0,1,0,1,0
12669,28,0,0,70,70,0,1,0,1,0
21709,28,0,0,66,66,0,1,0,1,0
13736,28,0,0,70,70,0,1,0,1,0
17084,28,0,0,70,70,0,1,0,1,0
14373,28,0,0,70,70,0,1,0,1,0
22350,28,0,0,69,69,0,1,0,1,0
14327,28,0,0,70,70,0,1,0,1,0
13294,28,0,0,70,70,0,1,0,1,0
16899,28,0,0,70,70,0,1,0,1,0
17007,28,0,0,69,69,0,1,0,1,0
21739,28,0,0,69,69,0,1,0,1,0
16796,28,0,0,70,70,0,1,0,1,0
20852,28,0,0,70,70,0,1,0,1,0
16784,28,0,0,70,70,0,1,0,1,0
11375,28,0,0,66,66,0,1,0,1,0
20968,28,0,0,70,70,0,1,0,1,0
8452,28,0,0,66,66,0,1,0,1,0
14628,28,0,0,68,68,0,1,0,1,0
12369,28,0,0,70,70,0,1,0,1,0
14669,28,0,0,68,68,0,1,0,1,0
17183,28,0,0,66,66,0,1,0,1,0
13118,28,0,0,70,70,0,1,0,1,0
11803,28,0,0,70,70,0,1,0,1,0
17719,28,0,0,70,70,0,1,0,1,0
14399,28,0,0,69,69,0,1,0,1,0
9073,28,0,0,66,66,0,1,0,1,0
17702,28,0,0,66,66,0,1,0,1,0
8422,28,0,0,68,68,0,1,0,1,0
22161,28,0,0,70,70,0,1,0,1,0
9965,28,0,0,70,70,0,1,0,1,0
19828,28,0,0,66,66,0,1,0,1,0
10835,28,0,0,70,70,0,1,0,1,0
9071,28,0,0,70,70,0,1,0,1,0
17078,28,0,0,70,70,0,1,0,1,0
9610,28,0,0,70,70,0,1,0,1,0
11398,28,0,0,66,66,0,1,0,1,0
10822,28,0,0,70,70,0,1,0,1,0
22358,28,0,0,70,70,0,1,0,1,0
16854,28,0,0,70,70,0,1,0,1,0
10094,28,0,0,66,66,0,1,0,1,0
22482,28,0,0,70,70,0,1,0,1,0
20443,28,0,0,66,66,0,1,0,1,0
11842,28,0,0,70,70,0,1,0,1,0
22199,28,0,0,69,69,0,1,0,1,0
20758,28,0,0,70,70,0,1,0,1,0
13137,28,0,0,66,66,0,1,0,1,0
10138,28,0,0,70,70,0,1,0,1,0
15619,28,0,0,66,66,0,1,0,1,0
20720,28,0,0,70,70,0,1,0,1,0
15154,28,0,0,67,67,0,1,0,1,0
22178,28,0,0,70,70,0,1,0,1,0
12750,28,0,0,70,70,0,1,0,1,0
14370,28,0,0,70,70,0,1,0,1,0
18071,28,0,0,69,69,0,1,0,1,0
16336,28,0,0,66,66,0,1,0,1,0
15951,28,0,0,70,70,0,1,0,1,0
20104,28,0,0,67,67,0,1,0,1,0
9520,28,0,0,69,69,0,1,0,1,0
19442,28,0,0,70,70,0,1,0,1,0
21025,28,0,0,70,70,0,1,0,1,0
21409,28,0,0,70,70,0,1,0,1,0
10996,28,0,0,70,70,0,1,0,1,0
9345,28,0,0,70,70,0,1,0,1,0
17366,28,0,0,70,70,0,1,0,1,0
10361,28,0,0,70,70,0,1,0,1,0
12842,28,0,0,66,66,0,1,0,1,0
17363,28,0,0,66,66,0,1,0,1,0
11648,28,0,0,70,70,0,1,0,1,0
15704,28,0,0,67,67,0,1,0,1,0
21223,28,0,0,70,70,0,1,0,1,0
15531,28,0,0,70,70,0,1,0,1,0
13296,28,0,0,66,66,0,1,0,1,0
19941,28,0,0,70,70,0,1,0,1,0
20476,28,0,0,66,66,0,1,0,1,0
19586,28,0,0,70,70,0,1,0,1,0
12839,28,0,0,66,66,0,1,0,1,0
9705,28,0,0,70,70,0,1,0,1,0
14369,28,0,0,70,70,0,1,0,1,0
10059,28,0,0,66,66,0,1,0,1,0
15723,28,0,0,70,70,0,1,0,1,0
10816,28,0,0,70,70,0,1,0,1,0
13932,28,0,0,66,66,0,1,0,1,0
13896,28,0,0,70,70,0,1,0,1,0
9960,28,0,0,68,68,0,1,0,1,0
17790,28,0,0,70,70,0,1,0,1,0
12479,28,0,0,70,70,0,1,0,1,0
14147,28,0,0,70,70,0,1,0,1,0
21658,28,0,0,70,70,0,1,0,1,0
18666,28,0,0,66,66,0,1,0,1,0
12649,28,0,0,66,66,0,1,0,1,0
15182,28,0,0,68,68,0,1,0,1,0
10869,28,0,0,67,67,0,1,0,1,0
12755,28,0,0,70,70,0,1,0,1,0
9371,28,0,0,70,70,0,1,0,1,0
12907,28,0,0,66,66,0,1,0,1,0
9047,28,0,0,70,70,0,1,0,1,0
22163,28,0,0,70,70,0,1,0,1,0
22268,28,0,0,70,70,0,1,0,1,0
9086,28,0,0,70,70,0,1,0,1,0
15228,28,0,0,70,70,0,1,0,1,0
8975,28,0,0,70,70,0,1,0,1,0
15492,28,0,0,70,70,0,1,0,1,0
13604,28,0,0,70,70,0,1,0,1,0
10753,28,0,0,70,70,0,1,0,1,0
21282,28,0,0,70,70,0,1,0,1,0
20640,28,0,0,70,70,0,1,0,1,0
18255,28,0,0,66,66,0,1,0,1,0
13386,28,0,0,70,70,0,1,0,1,0
9804,28,0,0,70,70,0,1,0,1,0
17760,28,0,0,70,70,0,1,0,1,0
21471,28,0,0,70,70,0,1,0,1,0
16696,28,0,0,70,70,0,1,0,1,0
9278,28,0,0,70,70,0,1,0,1,0
13577,28,0,0,70,70,0,1,0,1,0
9115,28,0,0,70,70,0,1,0,1,0
17085,28,0,0,68,68,0,1,0,1,0
17813,28,0,0,70,70,0,1,0,1,0
11097,28,0,0,70,70,0,1,0,1,0
9638,28,0,0,66,66,0,1,0,1,0
21673,28,0,0,70,70,0,1,0,1,0
17499,28,0,0,69,69,0,1,0,1,0
15297,28,0,0,70,70,0,1,0,1,0
10299,28,0,0,66,66,0,1,0,1,0
13993,28,0,0,70,70,0,1,0,1,0
14454,28,0,0,67,67,0,1,0,1,0
21935,28,0,0,70,70,0,1,0,1,0
8620,28,0,0,70,70,0,1,0,1,0
22303,28,0,0,70,70,0,1,0,1,0
17344,28,0,0,70,70,0,1,0,1,0
11253,28,0,0,70,70,0,1,0,1,0
10412,28,0,0,70,70,0,1,0,1,0
12204,28,0,0,66,66,0,1,0,1,0
15193,28,0,0,70,70,0,1,0,1,0
16423,28,0,0,70,70,0,1,0,1,0
22049,28,0,0,66,66,0,1,0,1,0
16450,28,0,0,70,70,0,1,0,1,0
9170,28,0,0,70,70,0,1,0,1,0
11637,28,0,0,70,70,0,1,0,1,0
11417,28,0,0,70,70,0,1,0,1,0
10706,28,0,0,70,70,0,1,0,1,0
10231,28,0,0,66,66,0,1,0,1,0
21205,28,0,0,70,70,0,1,0,1,0
18078,28,0,0,70,70,0,1,0,1,0
17418,28,0,0,70,70,0,1,0,1,0
21675,28,0,0,70,70,0,1,0,1,0
21591,28,0,0,70,70,0,1,0,1,0
10160,28,0,0,70,70,0,1,0,1,0
11581,28,0,0,70,70,0,1,0,1,0
11694,28,0,0,69,69,0,1,0,1,0
11505,28,0,0,66,66,0,1,0,1,0
14120,28,0,0,70,70,0,1,0,1,0
20614,28,0,0,70,70,0,1,0,1,0
10752,28,0,0,70,70,0,1,0,1,0
21659,28,0,0,70,70,0,1,0,1,0
10097,28,0,0,70,70,0,1,0,1,0
10128,28,0,0,70,70,0,1,0,1,0
14193,28,0,0,70,70,0,1,0,1,0
20983,28,0,0,70,70,0,1,0,1,0
9624,28,0,0,70,70,0,1,0,1,0
17852,28,0,0,70,70,0,1,0,1,0
19721,28,0,0,70,70,0,1,0,1,0
13833,28,0,0,66,66,0,1,0,1,0
9110,28,0,0,70,70,0,1,0,1,0
19333,28,0,0,70,70,0,1,0,1,0
14327,28,0,0,70,70,0,1,0,1,0
15021,28,0,0,70,70,0,1,0,1,0
19551,28,0,0,68,68,0,1,0,1,0
16292,28,0,0,68,68,0,1,0,1,0
13468,28,0,0,70,70,0,1,0,1,0
10529,28,0,0,70,70,0,1,0,1,0
22103,28,0,0,66,66,0,1,0,1,0
17811,28,0,0,66,66,0,1,0,1,0
10061,28,0,0,66,66,0,1,0,1,0
14456,28,0,0,66,66,0,1,0,1,0
15644,28,0,0,66,66,0,1,0,1,0
11195,28,0,0,67,67,0,1,0,1,0
10815,28,0,0,70,70,0,1,0,1,0
17127,28,0,0,67,67,0,1,0,1,0
10231,28,0,0,66,66,0,1,0,1,0
22180,28,0,0,70,70,0,1,0,1,0
16289,28,0,0,67,67,0,1,0,1,0
14898,28,0,0,70,70,0,1,0,1,0
18058,28,0,0,70,70,0,1,0,1,0
20267,28,0,0,70,70,0,1,0,1,0
8881,28,0,0,66,66,0,1,0,1,0
13675,28,0,0,70,70,0,1,0,1,0
11085,28,0,0,70,70,0,1,0,1,0
9715,28,0,0,66,66,0,1,0,1,0
17014,28,0,0,68,68,0,1,0,1,0
12208,28,0,0,70,70,0,1,0,1,0
9853,28,0,0,70,70,0,1,0,1,0
10841,28,0,0,70,70,0,1,0,1,0
10017,28,0,0,66,66,0,1,0,1,0
14363,28,0,0,66,66,0,1,0,1,0
14082,28,0,0,70,70,0,1,0,1,0
16346,28,0,0,70,70,0,1,0,1,0
20997,28,0,0,70,70,0,1,0,1,0
12191,28,0,0,66,66,0,1,0,1,0
18482,28,0,0,70,70,0,1,0,1,0
15656,28,0,0,67,67,0,1,0,1,0
9667,28,0,0,70,70,0,1,0,1,0
16220,28,0,0,70,70,0,1,0,1,0
22384,28,0,0,70,70,0,1,0,1,0
12366,28,0,0,70,70,0,1,0,1,0
20228,28,0,0,70,70,0,1,0,1,0
21702,28,0,0,70,70,0,1,0,1,0
12043,28,0,0,70,70,0,1,0,1,0
9796,28,0,0,66,66,0,1,0,1,0
13439,28,0,0,70,70,0,1,0,1,0
16854,28,0,0,66,66,0,1,0,1,0
15215,28,0,0,70,70,0,1,0,1,0
10031,28,0,0,70,70,0,1,0,1,0
20543,28,0,0,70,70,0,1,0,1,0
10222,28,0,0,66,66,0,1,0,1,0
9950,28,0,0,70,70,0,1,0,1,0
15575,28,0,0,70,70,0,1,0,1,0
11727,28,0,0,66,66,0,1,0,1,0
14043,28,0,0,70,70,0,1,0,1,0
22141,28,0,0,70,70,0,1,0,1,0
9042,28,0,0,70,70,0,1,0,1,0
15929,28,0,0,70,70,0,1,0,1,0
9498,28,0,0,70,70,0,1,0,1,0
17777,28,0,0,70,70,0,1,0,1,0
16512,28,0,0,66,66,0,1,0,1,0
21599,28,0,0,66,66,0,1,0,1,0
12008,28,0,0,70,70,0,1,0,1,0
9967,28,0,0,70,70,0,1,0,1,0
13524,28,0,0,66,66,0,1,0,1,0
21580,28,0,0,70,70,0,1,0,1,0
13942,28,0,0,70,70,0,1,0,1,0
17413,28,0,0,69,69,0,1,0,1,0
9903,28,0,0,70,70,0,1,0,1,0
22386,28,0,0,70,70,0,1,0,1,0
14980,28,0,0,66,66,0,1,0,1,0
13182,28,0,0,68,68,0,1,0,1,0
17775,28,0,0,70,70,0,1,0,1,0
9554,28,0,0,66,66,0,1,0,1,0
16117,28,0,0,69,69,0,1,0,1,0
20027,28,0,0,70,70,0,1,0,1,0
17533,28,0,0,70,70,0,1,0,1,0
14088,28,0,0,70,70,0,1,0,1,0
8488,28,0,0,70,70,0,1,0,1,0
12595,28,0,0,66,66,0,1,0,1,0
18735,28,0,0,67,67,0,1,0,1,0
13741,28,0,0,66,66,0,1,0,1,0
13687,28,0,0,66,66,0,1,0,1,0
21674,28,0,0,70,70,0,1,0,1,0
13257,28,0,0,70,70,0,1,0,1,0
17112,28,0,0,70,70,0,1,0,1,0
9436,28,0,0,66,66,0,1,0,1,0
18307,28,0,0,70,70,0,1,0,1,0
12273,28,0,0,70,70,0,1,0,1,0
10441,28,0,0,70,70,0,1,0,1,0
20849,28,0,0,70,70,0,1,0,1,0
11204,28,0,0,67,67,0,1,0,1,0
10575,28,0,0,67,67,0,1,0,1,0
11685,28,0,0,70,70,0,1,0,1,0
16607,28,0,0,66,66,0,1,0,1,0
21967,28,0,0,70,70,0,1,0,1,0
13934,28,0,0,66,66,0,1,0,1,0
18650,28,0,0,70,70,0,1,0,1,0
8671,28,0,0,70,70,0,1,0,1,0
13978,28,0,0,70,70,0,1,0,1,0
16555,28,0,0,66,66,0,1,0,1,0
11560,28,0,0,66,66,0,1,0,1,0
12004,28,0,0,66,66,0,1,0,1,0
22509,28,0,0,69,69,0,1,0,1,0
17583,28,0,0,69,69,0,1,0,1,0
15878,28,0,0,70,70,0,1,0,1,0
18240,28,0,0,66,66,0,1,0,1,0
13969,28,0,0,70,70,0,1,0,1,0
16457,28,0,0,70,70,0,1,0,1,0
18206,28,0,0,68,68,0,1,0,1,0
13251,28,0,0,70,70,0,1,0,1,0
13097,28,0,0,70,70,0,1,0,1,0
13415,28,0,0,70,70,0,1,0,1,0
12214,28,0,0,70,70,0,1,0,1,0
17537,28,0,0,69,69,0,1,0,1,0
10012,28,0,0,66,66,0,1,0,1,0
12545,28,0,0,70,70,0,1,0,1,0
14755,28,0,0,70,70,0,1,0,1,0
19087,28,0,0,67,67,0,1,0,1,0
22705,28,0,0,70,70,0,1,0,1,0
21267,28,0,0,66,66,0,1,0,1,0
12208,28,0,0,70,70,0,1,0,1,0
10802,28,0,0,66,66,0,1,0,1,0
17547,28,0,0,70,70,0,1,0,1,0
10736,28,0,0,67,67,0,1,0,1,0
20126,28,0,0,70,70,0,1,0,1,0
12460,28,0,0,70,70,0,1,0,1,0
20880,28,0,0,70,70,0,1,0,1,0
11665,28,0,0,66,66,0,1,0,1,0
11391,28,0,0,70,70,0,1,0,1,0
20448,28,0,0,70,70,0,1,0,1,0
16848,28,0,0,67,67,0,1,0,1,0
20208,28,0,0,70,70,0,1,0,1,0
9502,28,0,0,70,70,0,1,0,1,0
22375,28,0,0,69,69,0,1,0,1,0
11437,28,0,0,70,70,0,1,0,1,0
19724,28,0,0,70,70,0,1,0,1,0
20170,28,0,0,70,70,0,1,0,1,0
12331,28,0,0,69,69,0,1,0,1,0
12640,28,0,0,70,70,0,1,0,1,0
10997,28,0,0,70,70,0,1,0,1,0
15086,28,0,0,66,66,0,1,0,1,0
14090,28,0,0,70,70,0,1,0,1,0
17308,28,0,0,70,70,0,1,0,1,0
18253,28,0,0,70,70,0,1,0,1,0
18624,28,0,0,70,70,0,1,0,1,0
12368,28,0,0,70,70,0,1,0,1,0
12004,28,0,0,69,69,0,1,0,1,0
14219,28,0,0,70,70,0,1,0,1,0
20459,28,0,0,70,70,0,1,0,1,0
15181,28,0,0,69,69,0,1,0,1,0
10364,28,0,0,70,70,0,1,0,1,0
15560,28,0,0,70,70,0,1,0,1,0
19111,28,0,0,68,68,0,1,0,1,0
15925,28,0,0,70,70,0,1,0,1,0
11107,28,0,0,70,70,0,1,0,1,0
20460,28,0,0,70,70,0,1,0,1,0
16900,28,0,0,69,69,0,1,0,1,0
17747,28,0,0,66,66,0,1,0,1,0
22551,28,0,0,70,70,0,1,0,1,0
16210,28,0,0,70,70,0,1,0,1,0
19578,28,0,0,70,70,0,1,0,1,0
11669,28,0,0,70,70,0,1,0,1,0
13545,28,0,0,70,70,0,1,0,1,0
9826,28,0,0,70,70,0,1,0,1,0
20969,28,0,0,70,70,0,1,0,1,0
10110,28,0,0,70,70,0,1,0,1,0
20207,28,0,0,70,70,0,1,0,1,0
10993,28,0,0,67,67,0,1,0,1,0
16884,28,0,0,69,69,0,1,0,1,0
9838,28,0,0,67,67,0,1,0,1,0
9642,28,0,0,68,68,0,1,0,1,0
12342,28,0,0,66,66,0,1,0,1,0
17662,28,0,0,70,70,0,1,0,1,0
22604,28,0,0,70,70,0,1,0,1,0
18818,28,0,0,70,70,0,1,0,1,0
11399,28,0,0,70,70,0,1,0,1,0
20497,28,0,0,70,70,0,1,0,1,0
19195,28,0,0,66,66,0,1,0,1,0
20687,28,0,0,66,66,0,1,0,1,0
16687,28,0,0,70,70,0,1,0,1,0
9763,28,0,0,69,69,0,1,0,1,0
18612,28,0,0,70,70,0,1,0,1,0
12866,28,0,0,66,66,0,1,0,1,0
20167,28,0,0,68,68,0,1,0,1,0
17804,28,0,0,70,70,0,1,0,1,0
20573,28,0,0,70,70,0,1,0,1,0
20717,28,0,0,70,70,0,1,0,1,0
9997,28,0,0,66,66,0,1,0,1,0
11003,28,0,0,69,69,0,1,0,1,0
8752,28,0,0,66,66,0,1,0,1,0
22560,28,0,0,70,70,0,1,0,1,0
12983,28,0,0,70,70,0,1,0,1,0
18483,28,0,0,70,70,0,1,0,1,0
17921,28,0,0,70,70,0,1,0,1,0
19141,28,0,0,70,70,0,1,0,1,0
17529,28,0,0,67,67,0,1,0,1,0
12968,28,0,0,67,67,0,1,0,1,0
10993,28,0,0,70,70,0,1,0,1,0
12886,28,0,0,66,66,0,1,0,1,0
9396,28,0,0,66,66,0,1,0,1,0
13953,28,0,0,68,68,0,1,0,1,0
9879,28,0,0,66,66,0,1,0,1,0
10844,28,0,0,70,70,0,1,0,1,0
9501,28,0,0,70,70,0,1,0,1,0
15750,28,0,0,70,70,0,1,0,1,0
14354,28,0,0,70,70,0,1,0,1,0
18226,28,0,0,70,70,0,1,0,1,0
9971,28,0,0,68,68,0,1,0,1,0
9987,28,0,0,70,70,0,1,0,1,0
9168,28,0,0,70,70,0,1,0,1,0
15218,28,0,0,66,66,0,1,0,1,0
16079,28,0,0,69,69,0,1,0,1,0
10058,28,0,0,67,67,0,1,0,1,0
18508,28,0,0,66,66,0,1,0,1,0
9135,28,0,0,70,70,0,1,0,1,0
19122,28,0,0,70,70,0,1,0,1,0
11210,28,0,0,70,70,0,1,0,1,0
17903,28,0,0,70,70,0,1,0,1,0
9736,28,0,0,70,70,0,1,0,1,0
12441,28,0,0,70,70,0,1,0,1,0
12265,28,0,0,70,70,0,1,0,1,0
18945,28,0,0,67,67,0,1,0,1,0
17057,28,0,0,66,66,0,1,0,1,0
11466,28,0,0,70,70,0,1,0,1,0
17822,28,0,0,70,70,0,1,0,1,0
9767,28,0,0,68,68,0,1,0,1,0
12643,28,0,0,70,70,0,1,0,1,0
15676,28,0,0,66,66,0,1,0,1,0
14370,28,0,0,70,70,0,1,0,1,0
14119,28,0,0,69,69,0,1,0,1,0
22286,28,0,0,70,70,0,1,0,1,0
12366,28,0,0,70,70,0,1,0,1,0
16769,28,0,0,70,70,0,1,0,1,0
9629,28,0,0,66,66,0,1,0,1,0
13194,28,0,0,70,70,0,1,0,1,0
12354,28,0,0,68,68,0,1,0,1,0
13480,28,0,0,70,70,0,1,0,1,0
13368,28,0,0,70,70,0,1,0,1,0
22160,28,0,0,70,70,0,1,0,1,0
16711,28,0,0,66,66,0,1,0,1,0
22563,28,0,0,70,70,0,1,0,1,0
9439,28,0,0,70,70,0,1,0,1,0
16541,28,0,0,70,70,0,1,0,1,0
19685,28,0,0,70,70,0,1,0,1,0
12222,28,0,0,66,66,0,1,0,1,0
18861,28,0,0,70,70,0,1,0,1,0
12614,28,0,0,67,67,0,1,0,1,0
9028,28,0,0,70,70,0,1,0,1,0
9689,28,0,0,70,70,0,1,0,1,0
11862,28,0,0,70,70,0,1,0,1,0
21589,28,0,0,70,70,0,1,0,1,0
20638,28,0,0,68,68,0,1,0,1,0
17639,28,0,0,66,66,0,1,0,1,0
20462,28,0,0,69,69,0,1,0,1,0
14627,28,0,0,68,68,0,1,0,1,0
10993,28,0,0,70,70,0,1,0,1,0
17247,28,0,0,70,70,0,1,0,1,0
15281,28,0,0,68,68,0,1,0,1,0
18604,28,0,0,70,70,0,1,0,1,0
19195,28,0,0,70,70,0,1,0,1,0
12122,28,0,0,70,70,0,1,0,1,0
20166,28,0,0,66,66,0,1,0,1,0
16636,28,0,0,70,70,0,1,0,1,0
20101,28,0,0,68,68,0,1,0,1,0
15754,28,0,0,70,70,0,1,0,1,0
11169,28,0,0,67,67,0,1,0,1,0
9268,28,0,0,70,70,0,1,0,1,0
16422,28,0,0,70,70,0,1,0,1,0
17819,28,0,0,70,70,0,1,0,1,0
17626,28,0,0,70,70,0,1,0,1,0
11937,28,0,0,66,66,0,1,0,1,0
18505,28,0,0,70,70,0,1,0,1,0
13850,28,0,0,70,70,0,1,0,1,0
10177,28,0,0,66,66,0,1,0,1,0
8809,28,0,0,69,69,0,1,0,1,0
18089,28,0,0,70,70,0,1,0,1,0
12514,28,0,0,66,66,0,1,0,1,0
18878,28,0,0,66,66,0,1,0,1,0
12011,28,0,0,70,70,0,1,0,1,0
22139,28,0,0,70,70,0,1,0,1,0
19682,28,0,0,70,70,0,1,0,1,0
16292,28,0,0,70,70,0,1,0,1,0
17358,28,0,0,69,69,0,1,0,1,0
16299,28,0,0,70,70,0,1,0,1,0
19250,28,0,0,70,70,0,1,0,1,0
19420,28,0,0,66,66,0,1,0,1,0
20024,28,0,0,66,66,0,1,0,1,0
16675,28,0,0,70,70,0,1,0,1,0
13198,28,0,0,70,70,0,1,0,1,0
16357,28,0,0,70,70,0,1,0,1,0
15647,28,0,0,67,67,0,1,0,1,0
18578,28,0,0,66,66,0,1,0,1,0
8492,28,0,0,69,69,0,1,0,1,0
19004,28,0,0,70,70,0,1,0,1,0
10711,28,0,0,70,70,0,1,0,1,0
21993,28,0,0,70,70,0,1,0,1,0
11540,28,0,0,70,70,0,1,0,1,0
14327,28,0,0,70,70,0,1,0,1,0
12776,28,0,0,66,66,0,1,0,1,0
17827,28,0,0,70,70,0,1,0,1,0
22360,28,0,0,70,70,0,1,0,1,0
13360,28,0,0,68,68,0,1,0,1,0
9252,28,0,0,70,70,0,1,0,1,0
11768,28,0,0,70,70,0,1,0,1,0
8995,28,0,0,70,70,0,1,0,1,0
10195,28,0,0,70,70,0,1,0,1,0
15684,28,0,0,70,70,0,1,0,1,0
13013,28,0,0,67,67,0,1,0,1,0
16757,28,0,0,70,70,0,1,0,1,0
12256,28,0,0,70,70,0,1,0,1,0
14263,28,0,0,68,68,0,1,0,1,0
14899,28,0,0,70,70,0,1,0,1,0
12567,28,0,0,70,70,0,1,0,1,0
10232,28,0,0,67,67,0,1,0,1,0
12435,28,0,0,70,70,0,1,0,1,0
22693,28,0,0,66,66,0,1,0,1,0
17265,28,0,0,70,70,0,1,0,1,0
17693,28,0,0,70,70,0,1,0,1,0
19614,28,0,0,70,70,0,1,0,1,0
8685,28,0,0,67,67,0,1,0,1,0
18717,28,0,0,66,66,0,1,0,1,0
14939,28,0,0,70,70,0,1,0,1,0
11524,28,0,0,68,68,0,1,0,1,0
13148,28,0,0,70,70,0,1,0,1,0
21797,28,0,0,66,66,0,1,0,1,0
11331,28,0,0,70,70,0,1,0,1,0
8425,28,0,0,70,70,0,1,0,1,0
12156,28,0,0,67,67,0,1,0,1,0
14352,28,0,0,70,70,0,1,0,1,0
14646,28,0,0,70,70,0,1,0,1,0
19017,28,0,0,70,70,0,1,0,1,0
10482,28,0,0,70,70,0,1,0,1,0
19567,28,0,0,67,67,0,1,0,1,0
16306,28,0,0,66,66,0,1,0,1,0
19362,28,0,0,70,70,0,1,0,1,0
19667,28,0,0,66,66,0,1,0,1,0
15878,28,0,0,70,70,0,1,0,1,0
21793,28,0,0,70,70,0,1,0,1,0
9923,28,0,0,70,70,0,1,0,1,0
20356,28,0,0,69,69,0,1,0,1,0
12331,28,0,0,66,66,0,1,0,1,0
21845,28,0,0,70,70,0,1,0,1,0
9708,28,0,0,66,66,0,1,0,1,0
20717,28,0,0,70,70,0,1,0,1,0
18659,28,0,0,70,70,0,1,0,1,0
16797,28,0,0,66,66,0,1,0,1,0
14809,28,0,0,70,70,0,1,0,1,0
10890,28,0,0,68,68,0,1,0,1,0
14089,28,0,0,70,70,0,1,0,1,0
18615,28,0,0,70,70,0,1,0,1,0
19783,28,0,0,70,70,0,1,0,1,0
10527,28,0,0,66,66,0,1,0,1,0
9171,28,0,0,70,70,0,1,0,1,0
22430,28,0,0,66,66,0,1,0,1,0
11385,28,0,0,70,70,0,1,0,1,0
20148,28,0,0,70,70,0,1,0,1,0
11724,28,0,0,66,66,0,1,0,1,0
9478,28,0,0,70,70,0,1,0,1,0
19470,28,0,0,70,70,0,1,0,1,0
8785,28,0,0,70,70,0,1,0,1,0
22024,28,0,0,70,70,0,1,0,1,0
19453,28,0,0,70,70,0,1,0,1,0
17454,28,0,0,66,66,0,1,0,1,0
9733,28,0,0,70,70,0,1,0,1,0
16196,28,0,0,70,70,0,1,0,1,0
10105,28,0,0,66,66,0,1,0,1,0
11463,28,0,0,70,70,0,1,0,1,0
18994,28,0,0,66,66,0,1,0,1,0
22274,28,0,0,66,66,0,1,0,1,0
12942,28,0,0,70,70,0,1,0,1,0
17304,28,0,0,70,70,0,1,0,1,0
22299,28,0,0,70,70,0,1,0,1,0
22145,28,0,0,66,66,0,1,0,1,0
21693,28,0,0,70,70,0,1,0,1,0
22501,28,0,0,70,70,0,1,0,1,0
16132,28,0,0,70,70,0,1,0,1,0
18259,28,0,0,66,66,0,1,0,1,0
22177,28,0,0,70,70,0,1,0,1,0
14619,28,0,0,70,70,0,1,0,1,0
19093,28,0,0,70,70,0,1,0,1,0
15347,28,0,0,70,70,0,1,0,1,0
18772,28,0,0,67,67,0,1,0,1,0
17810,28,0,0,70,70,0,1,0,1,0
13780,28,0,0,70,70,0,1,0,1,0
9938,28,0,0,66,66,0,1,0,1,0
17631,28,0,0,70,70,0,1,0,1,0
10184,28,0,0,66,66,0,1,0,1,0
11673,28,0,0,66,66,0,1,0,1,0
21442,28,0,0,70,70,0,1,0,1,0
9983,28,0,0,66,66,0,1,0,1,0
10436,28,0,0,70,70,0,1,0,1,0
11266,28,0,0,70,70,0,1,0,1,0
8871,28,0,0,70,70,0,1,0,1,0
15472,28,0,0,66,66,0,1,0,1,0
22273,28,0,0,66,66,0,1,0,1,0
22183,28,0,0,70,70,0,1,0,1,0
9252,28,0,0,67,67,0,1,0,1,0
14563,28,0,0,66,66,0,1,0,1,0
17411,28,0,0,66,66,0,1,0,1,0
19281,28,0,0,67,67,0,1,0,1,0
17583,28,0,0,70,70,0,1,0,1,0
9940,28,0,0,66,66,0,1,0,1,0
8407,28,0,0,70,70,0,1,0,1,0
9437,28,0,0,70,70,0,1,0,1,0
21533,28,0,0,69,69,0,1,0,1,0
22199,28,0,0,68,68,0,1,0,1,0
18917,28,0,0,70,70,0,1,0,1,0
10794,28,0,0,66,66,0,1,0,1,0
10754,28,0,0,70,70,0,1,0,1,0
17441,28,0,0,66,66,0,1,0,1,0
10040,28,0,0,66,66,0,1,0,1,0
8943,28,0,0,66,66,0,1,0,1,0
11148,28,0,0,70,70,0,1,0,1,0
16398,28,0,0,70,70,0,1,0,1,0
10381,28,0,0,66,66,0,1,0,1,0
9622,28,0,0,70,70,0,1,0,1,0
21636,28,0,0,70,70,0,1,0,1,0
16514,28,0,0,70,70,0,1,0,1,0
17807,28,0,0,66,66,0,1,0,1,0
9676,28,0,0,70,70,0,1,0,1,0
14656,28,0,0,70,70,0,1,0,1,0
9497,28,0,0,66,66,0,1,0,1,0
11466,28,0,0,70,70,0,1,0,1,0
22034,28,0,0,69,69,0,1,0,1,0
11432,28,0,0,70,70,0,1,0,1,0
22676,28,0,0,70,70,0,1,0,1,0
12417,28,0,0,69,69,0,1,0,1,0
17738,28,0,0,70,70,0,1,0,1,0
10105,28,0,0,66,66,0,1,0,1,0
21325,28,0,0,70,70,0,1,0,1,0
15448,28,0,0,70,70,0,1,0,1,0
17365,28,0,0,67,67,0,1,0,1,0
8360,28,0,0,69,69,0,1,0,1,0
11093,28,0,0,70,70,0,1,0,1,0
18837,28,0,0,66,66,0,1,0,1,0
16342,28,0,0,70,70,0,1,0,1,0
16399,28,0,0,70,70,0,1,0,1,0
12766,28,0,0,70,70,0,1,0,1,0
18690,28,0,0,70,70,0,1,0,1,0
9199,28,0,0,66,66,0,1,0,1,0
16209,28,0,0,67,67,0,1,0,1,0
17383,28,0,0,70,70,0,1,0,1,0
21136,28,0,0,69,69,0,1,0,1,0
16354,28,0,0,70,70,0,1,0,1,0
11321,28,0,0,66,66,0,1,0,1,0
12648,28,0,0,66,66,0,1,0,1,0
14123,28,0,0,70,70,0,1,0,1,0
19511,28,0,0,68,68,0,1,0,1,0
10395,28,0,0,66,66,0,1,0,1,0
12051,28,0,0,70,70,0,1,0,1,0
18503,28,0,0,68,68,0,1,0,1,0
9315,28,0,0,69,69,0,1,0,1,0
11723,28,0,0,66,66,0,1,0,1,0
12368,28,0,0,69,69,0,1,0,1,0
10553,28,0,0,70,70,0,1,0,1,0
16385,28,0,0,66,66,0,1,0,1,0
11710,28,0,0,70,70,0,1,0,1,0
14212,28,0,0,70,70,0,1,0,1,0
16587,28,0,0,70,70,0,1,0,1,0
18648,28,0,0,70,70,0,1,0,1,0
12147,28,0,0,67,67,0,1,0,1,0
9056,28,0,0,66,66,0,1,0,1,0
16946,28,0,0,70,70,0,1,0,1,0
13270,28,0,0,70,70,0,1,0,1,0
19713,28,0,0,70,70,0,1,0,1,0
11892,28,0,0,67,67,0,1,0,1,0
16224,28,0,0,70,70,0,1,0,1,0
12652,28,0,0,66,66,0,1,0,1,0
18456,28,0,0,70,70,0,1,0,1,0
8907,28,0,0,66,66,0,1,0,1,0
20900,28,0,0,70,70,0,1,0,1,0
21815,28,0,0,70,70,0,1,0,1,0
20883,28,0,0,69,69,0,1,0,1,0
12763,28,0,0,70,70,0,1,0,1,0
8469,28,0,0,70,70,0,1,0,1,0
17366,28,0,0,68,68,0,1,0,1,0
17385,28,0,0,70,70,0,1,0,1,0
18354,28,0,0,66,66,0,1,0,1,0
11649,28,0,0,70,70,0,1,0,1,0
19069,28,0,0,70,70,0,1,0,1,0
18532,28,0,0,70,70,0,1,0,1,0
12823,28,0,0,70,70,0,1,0,1,0
13908,28,0,0,70,70,0,1,0,1,0
9835,28,0,0,68,68,0,1,0,1,0
19837,28,0,0,69,69,0,1,0,1,0
8423,28,0,0,69,69,0,1,0,1,0
17520,28,0,0,70,70,0,1,0,1,0
18271,28,0,0,70,70,0,1,0,1,0
8925,28,0,0,70,70,0,1,0,1,0
11951,28,0,0,66,66,0,1,0,1,0
13654,28,0,0,70,70,0,1,0,1,0
20432,28,0,0,67,67,0,1,0,1,0
9980,28,0,0,66,66,0,1,0,1,0
12109,28,0,0,70,70,0,1,0,1,0
13874,28,0,0,67,67,0,1,0,1,0
12305,28,0,0,70,70,0,1,0,1,0
8731,28,0,0,70,70,0,1,0,1,0
9368,28,0,0,70,70,0,1,0,1,0
13265,28,0,0,70,70,0,1,0,1,0
14673,28,0,0,70,70,0,1,0,1,0
9375,28,0,0,66,66,0,1,0,1,0
16013,28,0,0,67,67,0,1,0,1,0
18083,28,0,0,68,68,0,1,0,1,0
14871,28,0,0,70,70,0,1,0,1,0
20316,28,0,0,70,70,0,1,0,1,0
16478,28,0,0,70,70,0,1,0,1,0
14044,28,0,0,70,70,0,1,0,1,0
13611,28,0,0,70,70,0,1,0,1,0
11886,28,0,0,66,66,0,1,0,1,0
13980,28,0,0,70,70,0,1,0,1,0
9959,28,0,0,68,68,0,1,0,1,0
17995,28,0,0,70,70,0,1,0,1,0
15973,28,0,0,66,66,0,1,0,1,0
20844,28,0,0,70,70,0,1,0,1,0
15046,28,0,0,70,70,0,1,0,1,0
19506,28,0,0,66,66,0,1,0,1,0
13539,28,0,0,70,70,0,1,0,1,0
17308,28,0,0,66,66,0,1,0,1,0
18804,28,0,0,70,70,0,1,0,1,0
13329,28,0,0,70,70,0,1,0,1,0
20235,28,0,0,70,70,0,1,0,1,0
10516,28,0,0,66,66,0,1,0,1,0
22398,28,0,0,66,66,0,1,0,1,0
11005,28,0,0,66,66,0,1,0,1,0
21315,28,0,0,66,66,0,1,0,1,0
13574,28,0,0,70,70,0,1,0,1,0
16829,28,0,0,70,70,0,1,0,1,0
9856,28,0,0,70,70,0,1,0,1,0
14464,28,0,0,66,66,0,1,0,1,0
13051,28,0,0,70,70,0,1,0,1,0
17357,28,0,0,66,66,0,1,0,1,0
9763,28,0,0,69,69,0,1,0,1,0
17690,28,0,0,70,70,0,1,0,1,0
9776,28,0,0,68,68,0,1,0,1,0
8828,28,0,0,70,70,0,1,0,1,0
14288,28,0,0,68,68,0,1,0,1,0
16909,28,0,0,66,66,0,1,0,1,0
17626,28,0,0,70,70,0,1,0,1,0
12673,28,0,0,70,70,0,1,0,1,0
11105,28,0,0,70,70,0,1,0,1,0
20634,28,0,0,66,66,0,1,0,1,0
10812,28,0,0,69,69,0,1,0,1,0
11665,28,0,0,66,66,0,1,0,1,0
15549,28,0,0,70,70,0,1,0,1,0
14197,28,0,0,70,70,0,1,0,1,0
15056,28,0,0,69,69,0,1,0,1,0
21221,28,0,0,70,70,0,1,0,1,0
12722,28,0,0,66,66,0,1,0,1,0
21322,28,0,0,70,70,0,1,0,1,0
9451,28,0,0,70,70,0,1,0,1,0
13953,28,0,0,68,68,0,1,0,1,0
19579,28,0,0,70,70,0,1,0,1,0
21714,28,0,0,68,68,0,1,0,1,0
19876,28,0,0,66,66,0,1,0,1,0
17198,28,0,0,70,70,0,1,0,1,0
18950,28,0,0,66,66,0,1,0,1,0
19078,28,0,0,69,69,0,1,0,1,0
9224,28,0,0,70,70,0,1,0,1,0
14102,28,0,0,70,70,0,1,0,1,0
8430,28,0,0,66,66,0,1,0,1,0
9431,28,0,0,66,66,0,1,0,1,0
17836,28,0,0,70,70,0,1,0,1,0
14372,28,0,0,70,70,0,1,0,1,0
22159,28,0,0,70,70,0,1,0,1,0
18089,28,0,0,70,70,0,1,0,1,0
15282,28,0,0,66,66,0,1,0,1,0
20219,28,0,0,70,70,0,1,0,1,0
13967,28,0,0,70,70,0,1,0,1,0
22585,28,0,0,66,66,0,1,0,1,0
12643,28,0,0,66,66,0,1,0,1,0
18906,28,0,0,66,66,0,1,0,1,0
9416,28,0,0,68,68,0,1,0,1,0
8686,28,0,0,69,69,0,1,0,1,0
18606,28,0,0,70,70,0,1,0,1,0
17904,28,0,0,70,70,0,1,0,1,0
21681,28,0,0,66,66,0,1,0,1,0
9434,28,0,0,70,70,0,1,0,1,0
9211,28,0,0,70,70,0,1,0,1,0
8420,28,0,0,70,70,0,1,0,1,0
16875,28,0,0,70,70,0,1,0,1,0
20041,28,0,0,70,70,0,1,0,1,0
17595,28,0,0,70,70,0,1,0,1,0
10537,28,0,0,70,70,0,1,0,1,0
11583,28,0,0,69,69,0,1,0,1,0
11194,28,0,0,70,70,0,1,0,1,0
13294,28,0,0,70,70,0,1,0,1,0
20198,28,0,0,70,70,0,1,0,1,0
11684,28,0,0,68,68,0,1,0,1,0
14527,28,0,0,67,67,0,1,0,1,0
16945,28,0,0,70,70,0,1,0,1,0
16102,28,0,0,67,67,0,1,0,1,0
13532,28,0,0,67,67,0,1,0,1,0
13470,28,0,0,70,70,0,1,0,1,0
9559,28,0,0,66,66,0,1,0,1,0
15046,28,0,0,70,70,0,1,0,1,0
13308,28,0,0,70,70,0,1,0,1,0
20904,28,0,0,70,70,0,1,0,1,0
14219,28,0,0,70,70,0,1,0,1,0
15312,28,0,0,66,66,0,1,0,1,0
21052,28,0,0,70,70,0,1,0,1,0
15230,28,0,0,68,68,0,1,0,1,0
11767,28,0,0,70,70,0,1,0,1,0
21161,28,0,0,67,67,0,1,0,1,0
11632,28,0,0,70,70,0,1,0,1,0
15756,28,0,0,70,70,0,1,0,1,0
13932,28,0,0,66,66,0,1,0,1,0
10538,28,0,0,70,70,0,1,0,1,0
14288,28,0,0,66,66,0,1,0,1,0
13376,28,0,0,66,66,0,1,0,1,0
17454,28,0,0,66,66,0,1,0,1,0
18307,28,0,0,67,67,0,1,0,1,0
21833,28,0,0,66,66,0,1,0,1,0
17086,28,0,0,70,70,0,1,0,1,0
11833,28,0,0,66,66,0,1,0,1,0
20897,28,0,0,70,70,0,1,0,1,0
14803,28,0,0,66,66,0,1,0,1,0
8684,28,0,0,70,70,0,1,0,1,0
19299,28,0,0,66,66,0,1,0,1,0
21861,28,0,0,69,69,0,1,0,1,0
10170,28,0,0,66,66,0,1,0,1,0
14779,28,0,0,68,68,0,1,0,1,0
18257,28,0,0,66,66,0,1,0,1,0
16378,28,0,0,70,70,0,1,0,1,0
19959,28,0,0,66,66,0,1,0,1,0
21100,28,0,0,66,66,0,1,0,1,0
10794,28,0,0,68,68,0,1,0,1,0
10392,28,0,0,70,70,0,1,0,1,0
12616,28,0,0,70,70,0,1,0,1,0
19539,28,0,0,66,66,0,1,0,1,0
11554,28,0,0,70,70,0,1,0,1,0
16043,28,0,0,66,66,0,1,0,1,0
16695,28,0,0,66,66,0,1,0,1,0
17309,28,0,0,66,66,0,1,0,1,0
13425,28,0,0,70,70,0,1,0,1,0
22585,28,0,0,66,66,0,1,0,1,0
8492,28,0,0,67,67,0,1,0,1,0
19584,28,0,0,70,70,0,1,0,1,0
17948,28,0,0,66,66,0,1,0,1,0
19247,28,0,0,70,70,0,1,0,1,0
17898,28,0,0,70,70,0,1,0,1,0
16709,28,0,0,66,66,0,1,0,1,0
17402,28,0,0,66,66,0,1,0,1,0
17192,28,0,0,70,70,0,1,0,1,0
19453,28,0,0,70,70,0,1,0,1,0
14987,28,0,0,70,70,0,1,0,1,0
18436,28,0,0,66,66,0,1,0,1,0
15751,28,0,0,69,69,0,1,0,1,0
20647,28,0,0,70,70,0,1,0,1,0
9294,28,0,0,70,70,0,1,0,1,0
14235,28,0,0,70,70,0,1,0,1,0
10622,28,0,0,70,70,0,1,0,1,0
15757,28,0,0,70,70,0,1,0,1,0
14057,28,0,0,70,70,0,1,0,1,0
22212,28,0,0,68,68,0,1,0,1,0
15513,28,0,0,70,70,0,1,0,1,0
11083,28,0,0,70,70,0,1,0,1,0
20675,28,0,0,70,70,0,1,0,1,0
18165,28,0,0,66,66,0,1,0,1,0
9358,28,0,0,67,67,0,1,0,1,0
11508,28,0,0,70,70,0,1,0,1,0
11444,28,0,0,68,68,0,1,0,1,0
12238,28,0,0,66,66,0,1,0,1,0
12038,28,0,0,70,70,0,1,0,1,0
13113,28,0,0,70,70,0,1,0,1,0
21688,28,0,0,66,66,0,1,0,1,0
19005,28,0,0,70,70,0,1,0,1,0
11583,28,0,0,70,70,0,1,0,1,0
19416,28,0,0,70,70,0,1,0,1,0
15201,28,0,0,70,70,0,1,0,1,0
20572,28,0,0,70,70,0,1,0,1,0
9370,28,0,0,70,70,0,1,0,1,0
17775,28,0,0,70,70,0,1,0,1,0
9542,28,0,0,66,66,0,1,0,1,0
8757,28,0,0,67,67,0,1,0,1,0
10392,28,0,0,66,66,0,1,0,1,0
14066,28,0,0,70,70,0,1,0,1,0
21899,28,0,0,70,70,0,1,0,1,0
8617,28,0,0,70,70,0,1,0,1,0
22361,28,0,0,70,70,0,1,0,1,0
10077,28,0,0,66,66,0,1,0,1,0
8685,28,0,0,70,70,0,1,0,1,0
13479,28,0,0,70,70,0,1,0,1,0
12799,28,0,0,70,70,0,1,0,1,0
14455,28,0,0,70,70,0,1,0,1,0
9755,28,0,0,66,66,0,1,0,1,0
15237,28,0,0,70,70,0,1,0,1,0
20194,28,0,0,68,68,0,1,0,1,0
14583,28,0,0,70,70,0,1,0,1,0
8384,28,0,0,70,70,0,1,0,1,0
16412,28,0,0,69,69,0,1,0,1,0
19017,28,0,0,69,69,0,1,0,1,0
15931,28,0,0,70,70,0,1,0,1,0
16609,28,0,0,67,67,0,1,0,1,0
14123,28,0,0,70,70,0,1,0,1,0
16346,28,0,0,68,68,0,1,0,1,0
21237,28,0,0,70,70,0,1,0,1,0
21493,28,0,0,69,69,0,1,0,1,0
10842,28,0,0,67,67,0,1,0,1,0
9527,28,0,0,66,66,0,1,0,1,0
12524,28,0,0,66,66,0,1,0,1,0
14160,28,0,0,70,70,0,1,0,1,0
9572,28,0,0,70,70,0,1,0,1,0
20315,28,0,0,70,70,0,1,0,1,0
17877,28,0,0,70,70,0,1,0,1,0
20657,28,0,0,66,66,0,1,0,1,0
12250,28,0,0,70,70,0,1,0,1,0
18527,28,0,0,66,66,0,1,0,1,0
21414,28,0,0,70,70,0,1,0,1,0
12687,28,0,0,70,70,0,1,0,1,0
15534,28,0,0,70,70,0,1,0,1,0
10134,28,0,0,69,69,0,1,0,1,0
9925,28,0,0,70,70,0,1,0,1,0
11720,28,0,0,66,66,0,1,0,1,0
12910,28,0,0,66,66,0,1,0,1,0
17776,28,0,0,70,70,0,1,0,1,0
10497,28,0,0,67,67,0,1,0,1,0
16627,28,0,0,69,69,0,1,0,1,0
16831,28,0,0,67,67,0,1,0,1,0
21639,28,0,0,70,70,0,1,0,1,0
19028,28,0,0,70,70,0,1,0,1,0
15586,28,0,0,66,66,0,1,0,1,0
8477,28,0,0,69,69,0,1,0,1,0
18860,28,0,0,70,70,0,1,0,1,0
19971,28,0,0,70,70,0,1,0,1,0
20414,28,0,0,70,70,0,1,0,1,0
20042,28,0,0,70,70,0,1,0,1,0
13308,28,0,0,70,70,0,1,0,1,0
19032,28,0,0,70,70,0,1,0,1,0
16468,28,0,0,70,70,0,1,0,1,0
19114,28,0,0,66,66,0,1,0,1,0
20264,28,0,0,68,68,0,1,0,1,0
12079,28,0,0,70,70,0,1,0,1,0
20763,28,0,0,70,70,0,1,0,1,0
18220,28,0,0,67,67,0,1,0,1,0
19019,28,0,0,66,66,0,1,0,1,0
18705,28,0,0,68,68,0,1,0,1,0
9674,28,0,0,70,70,0,1,0,1,0
16624,28,0,0,70,70,0,1,0,1,0
22200,28,0,0,70,70,0,1,0,1,0
10314,28,0,0,67,67,0,1,0,1,0
11668,28,0,0,69,69,0,1,0,1,0
21687,28,0,0,66,66,0,1,0,1,0
10995,28,0,0,70,70,0,1,0,1,0
9529,28,0,0,70,70,0,1,0,1,0
10633,28,0,0,70,70,0,1,0,1,0
19054,28,0,0,66,66,0,1,0,1,0
13126,28,0,0,70,70,0,1,0,1,0
18270,28,0,0,69,69,0,1,0,1,0
13569,28,0,0,66,66,0,1,0,1,0
11249,28,0,0,68,68,0,1,0,1,0
22287,28,0,0,70,70,0,1,0,1,0
16942,28,0,0,70,70,0,1,0,1,0
16651,28,0,0,70,70,0,1,0,1,0
12376,28,0,0,70,70,0,1,0,1,0
18606,28,0,0,70,70,0,1,0,1,0
19956,28,0,0,70,70,0,1,0,1,0
8848,28,0,0,70,70,0,1,0,1,0
9160,28,0,0,70,70,0,1,0,1,0
21724,28,0,0,66,66,0,1,0,1,0
22266,28,0,0,70,70,0,1,0,1,0
10886,28,0,0,66,66,0,1,0,1,0
14435,28,0,0,69,69,0,1,0,1,0
10108,28,0,0,70,70,0,1,0,1,0
16352,28,0,0,70,70,0,1,0,1,0
16899,28,0,0,66,66,0,1,0,1,0
13734,28,0,0,70,70,0,1,0,1,0
18630,28,0,0,66,66,0,1,0,1,0
9785,28,0,0,70,70,0,1,0,1,0
15656,28,0,0,70,70,0,1,0,1,0
20850,28,0,0,70,70,0,1,0,1,0
12113,28,0,0,70,70,0,1,0,1,0
10750,28,0,0,70,70,0,1,0,1,0
19120,28,0,0,70,70,0,1,0,1,0
18823,28,0,0,67,67,0,1,0,1,0
9999,28,0,0,70,70,0,1,0,1,0
16838,28,0,0,70,70,0,1,0,1,0
10312,28,0,0,70,70,0,1,0,1,0
11514,28,0,0,66,66,0,1,0,1,0
19269,28,0,0,70,70,0,1,0,1,0
13762,28,0,0,70,70,0,1,0,1,0
20663,28,0,0,70,70,0,1,0,1,0
14507,28,0,0,70,70,0,1,0,1,0
22298,28,0,0,70,70,0,1,0,1,0
18465,28,0,0,70,70,0,1,0,1,0
8878,28,0,0,66,66,0,1,0,1,0
13500,28,0,0,66,66,0,1,0,1,0
17941,28,0,0,70,70,0,1,0,1,0
19359,28,0,0,69,69,0,1,0,1,0
16558,28,0,0,67,67,0,1,0,1,0
16514,28,0,0,70,70,0,1,0,1,0
8787,28,0,0,67,67,0,1,0,1,0
21544,28,0,0,70,70,0,1,0,1,0
13522,28,0,0,70,70,0,1,0,1,0
14324,28,0,0,70,70,0,1,0,1,0
15540,28,0,0,66,66,0,1,0,1,0
13337,28,0,0,70,70,0,1,0,1,0
9504,28,0,0,70,70,0,1,0,1,0
21824,28,0,0,70,70,0,1,0,1,0
8420,28,0,0,68,68,0,1,0,1,0
14279,28,0,0,70,70,0,1,0,1,0
17720,28,0,0,70,70,0,1,0,1,0
20738,28,0,0,70,70,0,1,0,1,0
15312,28,0,0,67,67,0,1,0,1,0
16603,28,0,0,70,70,0,1,0,1,0
17725,28,0,0,70,70,0,1,0,1,0
10750,28,0,0,66,66,0,1,0,1,0
20151,28,0,0,70,70,0,1,0,1,0
9543,28,0,0,70,70,0,1,0,1,0
20458,28,0,0,70,70,0,1,0,1,0
9213,28,0,0,70,70,0,1,0,1,0
16516,28,0,0,70,70,0,1,0,1,0
12851,28,0,0,70,70,0,1,0,1,0
19453,28,0,0,70,70,0,1,0,1,0
21057,28,0,0,66,66,0,1,0,1,0
16404,28,0,0,70,70,0,1,0,1,0
14135,28,0,0,70,70,0,1,0,1,0
13085,28,0,0,70,70,0,1,0,1,0
12587,28,0,0,70,70,0,1,0,1,0
16173,28,0,0,70,70,0,1,0,1,0
14454,28,0,0,70,70,0,1,0,1,0
21206,28,0,0,66,66,0,1,0,1,0
13765,28,0,0,69,69,0,1,0,1,0
8724,28,0,0,70,70,0,1,0,1,0
20115,28,0,0,66,66,0,1,0,1,0
20053,28,0,0,70,70,0,1,0,1,0
11170,28,0,0,66,66,0,1,0,1,0
13522,28,0,0,66,66,0,1,0,1,0
18372,28,0,0,66,66,0,1,0,1,0
13271,28,0,0,70,70,0,1,0,1,0
20337,28,0,0,69,69,0,1,0,1,0
19176,28,0,0,70,70,0,1,0,1,0
18298,28,0,0,70,70,0,1,0,1,0
16869,28,0,0,70,70,0,1,0,1,0
9981,28,0,0,70,70,0,1,0,1,0
19725,28,0,0,70,70,0,1,0,1,0
12395,28,0,0,66,66,0,1,0,1,0
17940,28,0,0,70,70,0,1,0,1,0
8925,28,0,0,70,70,0,1,0,1,0
21031,28,0,0,66,66,0,1,0,1,0
15782,28,0,0,68,68,0,1,0,1,0
13126,28,0,0,70,70,0,1,0,1,0
16842,28,0,0,66,66,0,1,0,1,0
20228,28,0,0,70,70,0,1,0,1,0
13809,28,0,0,66,66,0,1,0,1,0
9794,28,0,0,70,70,0,1,0,1,0
21356,28,0,0,70,70,0,1,0,1,0
18852,28,0,0,70,70,0,1,0,1,0
13628,28,0,0,70,70,0,1,0,1,0
20213,28,0,0,70,70,0,1,0,1,0
12879,28,0,0,70,70,0,1,0,1,0
12529,28,0,0,70,70,0,1,0,1,0
12005,28,0,0,67,67,0,1,0,1,0
16173,28,0,0,70,70,0,1,0,1,0
14722,28,0,0,70,70,0,1,0,1,0
8587,28,0,0,70,70,0,1,0,1,0
19134,28,0,0,66,66,0,1,0,1,0
21115,28,0,0,69,69,0,1,0,1,0
10360,28,0,0,70,70,0,1,0,1,0
9722,28,0,0,67,67,0,1,0,1,0
9800,28,0,0,70,70,0,1,0,1,0
16714,28,0,0,66,66,0,1,0,1,0
8756,28,0,0,69,69,0,1,0,1,0
14611,28,0,0,66,66,0,1,0,1,0
19157,28,0,0,70,70,0,1,0,1,0
13440,28,0,0,66,66,0,1,0,1,0
11630,28,0,0,70,70,0,1,0,1,0
12273,28,0,0,70,70,0,1,0,1,0
20954,28,0,0,70,70,0,1,0,1,0
10295,28,0,0,66,66,0,1,0,1,0
8958,28,0,0,69,69,0,1,0,1,0
9457,28,0,0,66,66,0,1,0,1,0
8513,28,0,0,69,69,0,1,0,1,0
9437,28,0,0,70,70,0,1,0,1,0
14489,28,0,0,66,66,0,1,0,1,0
11863,28,0,0,70,70,0,1,0,1,0
19422,28,0,0,66,66,0,1,0,1,0
11578,28,0,0,70,70,0,1,0,1,0
20650,28,0,0,66,66,0,1,0,1,0
9086,28,0,0,70,70,0,1,0,1,0
17007,28,0,0,69,69,0,1,0,1,0
8534,28,0,0,68,68,0,1,0,1,0
13976,28,0,0,66,66,0,1,0,1,0
16904,28,0,0,70,70,0,1,0,1,0
15368,28,0,0,70,70,0,1,0,1,0
20403,28,0,0,70,70,0,1,0,1,0
13611,28,0,0,70,70,0,1,0,1,0
12020,28,0,0,70,70,0,1,0,1,0
19626,28,0,0,70,70,0,1,0,1,0
14543,28,0,0,70,70,0,1,0,1,0
11556,28,0,0,70,70,0,1,0,1,0
17790,28,0,0,70,70,0,1,0,1,0
16160,28,0,0,68,68,0,1,0,1,0
15090,28,0,0,66,66,0,1,0,1,0
18189,28,0,0,67,67,0,1,0,1,0
9455,28,0,0,70,70,0,1,0,1,0
13795,28,0,0,70,70,0,1,0,1,0
9171,28,0,0,70,70,0,1,0,1,0
15047,28,0,0,70,70,0,1,0,1,0
9347,28,0,0,70,70,0,1,0,1,0
10076,28,0,0,67,67,0,1,0,1,0
18997,28,0,0,66,66,0,1,0,1,0
8987,28,0,0,68,68,0,1,0,1,0
19529,28,0,0,69,69,0,1,0,1,0
17347,28,0,0,70,70,0,1,0,1,0
13807,28,0,0,70,70,0,1,0,1,0
14954,28,0,0,66,66,0,1,0,1,0
18357,28,0,0,69,69,0,1,0,1,0
8452,28,0,0,67,67,0,1,0,1,0
13858,28,0,0,70,70,0,1,0,1,0
13307,28,0,0,70,70,0,1,0,1,0
17656,28,0,0,67,67,0,1,0,1,0
19017,28,0,0,68,68,0,1,0,1,0
9473,28,0,0,70,70,0,1,0,1,0
15349,28,0,0,70,70,0,1,0,1,0
13997,28,0,0,70,70,0,1,0,1,0
9496,28,0,0,66,66,0,1,0,1,0
20082,28,0,0,70,70,0,1,0,1,0
14604,28,0,0,70,70,0,1,0,1,0
17534,28,0,0,70,70,0,1,0,1,0
10003,28,0,0,70,70,0,1,0,1,0
12104,28,0,0,70,70,0,1,0,1,0
14812,28,0,0,70,70,0,1,0,1,0
12879,28,0,0,70,70,0,1,0,1,0
15537,28,0,0,66,66,0,1,0,1,0
18437,28,0,0,70,70,0,1,0,1,0
19363,28,0,0,70,70,0,1,0,1,0
22634,28,0,0,70,70,0,1,0,1,0
20478,28,0,0,70,70,0,1,0,1,0
9182,28,0,0,70,70,0,1,0,1,0
12458,28,0,0,70,70,0,1,0,1,0
14338,28,0,0,69,69,0,1,0,1,0
13118,28,0,0,70,70,0,1,0,1,0
14238,28,0,0,68,68,0,1,0,1,0
17764,28,0,0,67,67,0,1,0,1,0
17613,28,0,0,67,67,0,1,0,1,0
19187,28,0,0,66,66,0,1,0,1,0
17266,28,0,0,67,67,0,1,0,1,0
19364,28,0,0,70,70,0,1,0,1,0
13857,28,0,0,70,70,0,1,0,1,0
18993,28,0,0,67,67,0,1,0,1,0
20506,28,0,0,70,70,0,1,0,1,0
18933,28,0,0,68,68,0,1,0,1,0
22395,28,0,0,66,66,0,1,0,1,0
19020,28,0,0,70,70,0,1,0,1,0
22651,28,0,0,70,70,0,1,0,1,0
19441,28,0,0,70,70,0,1,0,1,0
17077,28,0,0,68,68,0,1,0,1,0
13640,28,0,0,70,70,0,1,0,1,0
10836,28,0,0,70,70,0,1,0,1,0
16449,28,0,0,66,66,0,1,0,1,0
21756,28,0,0,70,70,0,1,0,1,0
16247,28,0,0,70,70,0,1,0,1,0
8535,28,0,0,70,70,0,1,0,1,0
16195,28,0,0,70,70,0,1,0,1,0
15217,28,0,0,70,70,0,1,0,1,0
10797,28,0,0,68,68,0,1,0,1,0
18945,28,0,0,67,67,0,1,0,1,0
13558,28,0,0,70,70,0,1,0,1,0
19882,28,0,0,70,70,0,1,0,1,0
20562,28,0,0,70,70,0,1,0,1,0
15225,28,0,0,67,67,0,1,0,1,0
17274,28,0,0,70,70,0,1,0,1,0
17553,28,0,0,70,70,0,1,0,1,0
18868,28,0,0,70,70,0,1,0,1,0
20215,28,0,0,70,70,0,1,0,1,0
16942,28,0,0,70,70,0,1,0,1,0
21135,28,0,0,66,66,0,1,0,1,0
9318,28,0,0,70,70,0,1,0,1,0
20581,28,0,0,70,70,0,1,0,1,0
15707,28,0,0,66,66,0,1,0,1,0
21449,28,0,0,70,70,0,1,0,1,0
9923,28,0,0,70,70,0,1,0,1,0
11955,28,0,0,66,66,0,1,0,1,0
21035,28,0,0,70,70,0,1,0,1,0
11461,28,0,0,66,66,0,1,0,1,0
9673,28,0,0,70,70,0,1,0,1,0
19859,28,0,0,66,66,0,1,0,1,0
10552,28,0,0,66,66,0,1,0,1,0
22704,28,0,0,70,70,0,1,0,1,0
20472,28,0,0,66,66,0,1,0,1,0
17596,28,0,0,66,66,0,1,0,1,0
14047,28,0,0,70,70,0,1,0,1,0
12753,28,0,0,70,70,0,1,0,1,0
19226,28,0,0,69,69,0,1,0,1,0
13635,28,0,0,70,70,0,1,0,1,0
12668,28,0,0,70,70,0,1,0,1,0
18973,28,0,0,70,70,0,1,0,1,0
13477,28,0,0,67,67,0,1,0,1,0
19885,28,0,0,70,70,0,1,0,1,0
17811,28,0,0,68,68,0,1,0,1,0
9439,28,0,0,70,70,0,1,0,1,0
22026,28,0,0,69,69,0,1,0,1,0
19170,28,0,0,67,67,0,1,0,1,0
11400,28,0,0,70,70,0,1,0,1,0
15515,28,0,0,70,70,0,1,0,1,0
18606,28,0,0,70,70,0,1,0,1,0
10640,28,0,0,69,69,0,1,0,1,0
12525,28,0,0,66,66,0,1,0,1,0
21284,28,0,0,70,70,0,1,0,1,0
13484,28,0,0,70,70,0,1,0,1,0
21739,28,0,0,66,66,0,1,0,1,0
9898,28,0,0,68,68,0,1,0,1,0
18956,28,0,0,70,70,0,1,0,1,0
14870,28,0,0,70,70,0,1,0,1,0
20140,28,0,0,70,70,0,1,0,1,0
21379,28,0,0,68,68,0,1,0,1,0
16792,28,0,0,70,70,0,1,0,1,0
17578,28,0,0,70,70,0,1,0,1,0
10430,28,0,0,69,69,0,1,0,1,0
12125,28,0,0,66,66,0,1,0,1,0
15708,28,0,0,70,70,0,1,0,1,0
16014,28,0,0,66,66,0,1,0,1,0
20711,28,0,0,66,66,0,1,0,1,0
13761,28,0,0,70,70,0,1,0,1,0
21074,28,0,0,70,70,0,1,0,1,0
13288,28,0,0,70,70,0,1,0,1,0
21911,28,0,0,70,70,0,1,0,1,0
16413,28,0,0,70,70,0,1,0,1,0
11365,28,0,0,70,70,0,1,0,1,0
10160,28,0,0,70,70,0,1,0,1,0
17941,28,0,0,70,70,0,1,0,1,0
22601,28,0,0,69,69,0,1,0,1,0
10435,28,0,0,70,70,0,1,0,1,0
10635,28,0,0,66,66,0,1,0,1,0
11940,28,0,0,70,70,0,1,0,1,0
9102,28,0,0,70,70,0,1,0,1,0
21117,28,0,0,67,67,0,1,0,1,0
12976,28,0,0,66,66,0,1,0,1,0
11093,28,0,0,70,70,0,1,0,1,0
16554,28,0,0,70,70,0,1,0,1,0
13164,28,0,0,70,70,0,1,0,1,0
10048,28,0,0,70,70,0,1,0,1,0
9069,28,0,0,70,70,0,1,0,1,0
14526,28,0,0,70,70,0,1,0,1,0
12846,28,0,0,70,70,0,1,0,1,0
11670,28,0,0,70,70,0,1,0,1,0
10452,28,0,0,70,70,0,1,0,1,0
19815,28,0,0,70,70,0,1,0,1,0
13168,28,0,0,67,67,0,1,0,1,0
8418,28,0,0,66,66,0,1,0,1,0
13690,28,0,0,66,66,0,1,0,1,0
10171,28,0,0,70,70,0,1,0,1,0
19735,28,0,0,70,70,0,1,0,1,0
18964,28,0,0,69,69,0,1,0,1,0
9298,28,0,0,70,70,0,1,0,1,0
10014,28,0,0,66,66,0,1,0,1,0
17113,28,0,0,70,70,0,1,0,1,0
14737,28,0,0,68,68,0,1,0,1,0
20826,28,0,0,68,68,0,1,0,1,0
19474,28,0,0,70,70,0,1,0,1,0
10257,28,0,0,66,66,0,1,0,1,0
19274,28,0,0,70,70,0,1,0,1,0
15946,28,0,0,70,70,0,1,0,1,0
10862,28,0,0,66,66,0,1,0,1,0
14970,28,0,0,66,66,0,1,0,1,0
10658,28,0,0,70,70,0,1,0,1,0
8945,28,0,0,70,70,0,1,0,1,0
22651,28,0,0,70,70,0,1,0,1,0
20228,28,0,0,66,66,0,1,0,1,0
14260,28,0,0,70,70,0,1,0,1,0
11471,28,0,0,70,70,0,1,0,1,0
17292,28,0,0,66,66,0,1,0,1,0
14310,28,0,0,69,69,0,1,0,1,0
20595,28,0,0,66,66,0,1,0,1,0
22175,28,0,0,70,70,0,1,0,1,0
21785,28,0,0,70,70,0,1,0,1,0
18483,28,0,0,70,70,0,1,0,1,0
14580,28,0,0,68,68,0,1,0,1,0
14024,28,0,0,70,70,0,1,0,1,0
18757,28,0,0,70,70,0,1,0,1,0
15795,28,0,0,70,70,0,1,0,1,0
14400,28,0,0,70,70,0,1,0,1,0
19683,28,0,0,70,70,0,1,0,1,0
15721,28,0,0,70,70,0,1,0,1,0
16512,28,0,0,66,66,0,1,0,1,0
10676,28,0,0,66,66,0,1,0,1,0
11639,28,0,0,70,70,0,1,0,1,0
14728,28,0,0,67,67,0,1,0,1,0
17592,28,0,0,70,70,0,1,0,1,0
13857,28,0,0,70,70,0,1,0,1,0
21970,28,0,0,66,66,0,1,0,1,0
10583,28,0,0,70,70,0,1,0,1,0
9910,28,0,0,70,70,0,1,0,1,0
15155,28,0,0,66,66,0,1,0,1,0
10657,28,0,0,70,70,0,1,0,1,0
15813,28,0,0,70,70,0,1,0,1,0
18908,28,0,0,66,66,0,1,0,1,0
12483,28,0,0,70,70,0,1,0,1,0
10080,28,0,0,66,66,0,1,0,1,0
16657,28,0,0,69,69,0,1,0,1,0
9668,28,0,0,70,70,0,1,0,1,0
9679,28,0,0,68,68,0,1,0,1,0
13780,28,0,0,70,70,0,1,0,1,0
10612,28,0,0,66,66,0,1,0,1,0
15644,28,0,0,66,66,0,1,0,1,0
15249,28,0,0,70,70,0,1,0,1,0
16633,28,0,0,70,70,0,1,0,1,0
15906,28,0,0,66,66,0,1,0,1,0
13067,28,0,0,70,70,0,1,0,1,0
14220,28,0,0,70,70,0,1,0,1,0
19854,28,0,0,70,70,0,1,0,1,0
13875,28,0,0,70,70,0,1,0,1,0
19679,28,0,0,66,66,0,1,0,1,0
20118,28,0,0,70,70,0,1,0,1,0
15169,28,0,0,70,70,0,1,0,1,0
9170,28,0,0,70,70,0,1,0,1,0
21407,28,0,0,70,70,0,1,0,1,0
9890,28,0,0,67,67,0,1,0,1,0
11416,28,0,0,70,70,0,1,0,1,0
14326,28,0,0,70,70,0,1,0,1,0
10728,28,0,0,66,66,0,1,0,1,0
19496,28,0,0,70,70,0,1,0,1,0
12757,28,0,0,66,66,0,1,0,1,0
9500,28,0,0,66,66,0,1,0,1,0
20813,28,0,0,70,70,0,1,0,1,0
21719,28,0,0,68,68,0,1,0,1,0
21437,28,0,0,68,68,0,1,0,1,0
9371,28,0,0,66,66,0,1,0,1,0
9776,28,0,0,66,66,0,1,0,1,0
21674,28,0,0,70,70,0,1,0,1,0
22169,28,0,0,69,69,0,1,0,1,0
10001,28,0,0,70,70,0,1,0,1,0
16589,28,0,0,70,70,0,1,0,1,0
14846,28,0,0,66,66,0,1,0,1,0
13272,28,0,0,70,70,0,1,0,1,0
19426,28,0,0,70,70,0,1,0,1,0
20274,28,0,0,70,70,0,1,0,1,0
12175,28,0,0,69,69,0,1,0,1,0
19876,28,0,0,66,66,0,1,0,1,0
12721,28,0,0,66,66,0,1,0,1,0
16760,28,0,0,70,70,0,1,0,1,0
16805,28,0,0,70,70,0,1,0,1,0
9222,28,0,0,70,70,0,1,0,1,0
15089,28,0,0,69,69,0,1,0,1,0
16868,28,0,0,70,70,0,1,0,1,0
20558,28,0,0,69,69,0,1,0,1,0
13962,28,0,0,69,69,0,1,0,1,0
15655,28,0,0,70,70,0,1,0,1,0
12719,28,0,0,66,66,0,1,0,1,0
17754,28,0,0,70,70,0,1,0,1,0
15862,28,0,0,70,70,0,1,0,1,0
13415,28,0,0,68,68,0,1,0,1,0
13517,28,0,0,66,66,0,1,0,1,0
20277,28,0,0,67,67,0,1,0,1,0
8363,28,0,0,67,67,0,1,0,1,0
10610,28,0,0,66,66,0,1,0,1,0
21562,28,0,0,70,70,0,1,0,1,0
12669,28,0,0,69,69,0,1,0,1,0
16442,28,0,0,70,70,0,1,0,1,0
13688,28,0,0,66,66,0,1,0,1,0
20947,28,0,0,70,70,0,1,0,1,0
17852,28,0,0,70,70,0,1,0,1,0
9281,28,0,0,67,67,0,1,0,1,0
21655,28,0,0,70,70,0,1,0,1,0
22500,28,0,0,68,68,0,1,0,1,0
9955,28,0,0,66,66,0,1,0,1,0
16942,28,0,0,68,68,0,1,0,1,0
13225,28,0,0,68,68,0,1,0,1,0
16180,28,0,0,70,70,0,1,0,1,0
10040,28,0,0,70,70,0,1,0,1,0
20311,28,0,0,66,66,0,1,0,1,0
15578,28,0,0,70,70,0,1,0,1,0
13342,28,0,0,66,66,0,1,0,1,0
13989,28,0,0,69,69,0,1,0,1,0
9707,28,0,0,66,66,0,1,0,1,0
15982,28,0,0,69,69,0,1,0,1,0
16741,28,0,0,66,66,0,1,0,1,0
22501,28,0,0,70,70,0,1,0,1,0
14830,28,0,0,68,68,0,1,0,1,0
11748,28,0,0,70,70,0,1,0,1,0
14098,28,0,0,70,70,0,1,0,1,0
9816,28,0,0,66,66,0,1,0,1,0
11071,28,0,0,66,66,0,1,0,1,0
16614,28,0,0,70,70,0,1,0,1,0
8781,28,0,0,70,70,0,1,0,1,0
9480,28,0,0,66,66,0,1,0,1,0
9610,28,0,0,70,70,0,1,0,1,0
14273,28,0,0,70,70,0,1,0,1,0
12888,28,0,0,66,66,0,1,0,1,0
17059,28,0,0,66,66,0,1,0,1,0
9560,28,0,0,70,70,0,1,0,1,0
11168,28,0,0,70,70,0,1,0,1,0
8957,28,0,0,70,70,0,1,0,1,0
19417,28,0,0,70,70,0,1,0,1,0
9933,28,0,0,66,66,0,1,0,1,0
14521,28,0,0,70,70,0,1,0,1,0
20916,28,0,0,70,70,0,1,0,1,0
22703,28,0,0,70,70,0,1,0,1,0
12596,28,0,0,66,66,0,1,0,1,0
13058,28,0,0,66,66,0,1,0,1,0
18116,28,0,0,70,70,0,1,0,1,0
19693,28,0,0,66,66,0,1,0,1,0
9621,28,0,0,66,66,0,1,0,1,0
21834,28,0,0,68,68,0,1,0,1,0
13934,28,0,0,68,68,0,1,0,1,0
11347,28,0,0,70,70,0,1,0,1,0
13242,28,0,0,69,69,0,1,0,1,0
19696,28,0,0,70,70,0,1,0,1,0
18964,28,0,0,67,67,0,1,0,1,0
10932,28,0,0,69,69,0,1,0,1,0
19598,28,0,0,69,69,0,1,0,1,0
12762,28,0,0,70,70,0,1,0,1,0
9125,28,0,0,70,70,0,1,0,1,0
15094,28,0,0,68,68,0,1,0,1,0
19503,28,0,0,70,70,0,1,0,1,0
22226,28,0,0,70,70,0,1,0,1,0
15679,28,0,0,70,70,0,1,0,1,0
8535,28,0,0,69,69,0,1,0,1,0
16274,28,0,0,66,66,0,1,0,1,0
11486,28,0,0,70,70,0,1,0,1,0
14622,28,0,0,67,67,0,1,0,1,0
22486,28,0,0,70,70,0,1,0,1,0
14480,28,0,0,66,66,0,1,0,1,0
20126,28,0,0,70,70,0,1,0,1,0
14262,28,0,0,70,70,0,1,0,1,0
14710,28,0,0,66,66,0,1,0,1,0
17733,28,0,0,66,66,0,1,0,1,0
19100,28,0,0,70,70,0,1,0,1,0
17318,28,0,0,70,70,0,1,0,1,0
13049,28,0,0,69,69,0,1,0,1,0
18089,28,0,0,66,66,0,1,0,1,0
15468,28,0,0,69,69,0,1,0,1,0
20075,28,0,0,70,70,0,1,0,1,0
15779,28,0,0,66,66,0,1,0,1,0
12008,28,0,0,70,70,0,1,0,1,0
10437,28,0,0,66,66,0,1,0,1,0
18272,28,0,0,67,67,0,1,0,1,0
10364,28,0,0,70,70,0,1,0,1,0
9272,28,0,0,70,70,0,1,0,1,0
15883,28,0,0,68,68,0,1,0,1,0
21713,28,0,0,70,70,0,1,0,1,0
13249,28,0,0,70,70,0,1,0,1,0
14410,28,0,0,70,70,0,1,0,1,0
21469,28,0,0,70,70,0,1,0,1,0
14236,28,0,0,66,66,0,1,0,1,0
9434,28,0,0,66,66,0,1,0,1,0
12736,28,0,0,70,70,0,1,0,1,0
17993,28,0,0,70,70,0,1,0,1,0
10841,28,0,0,70,70,0,1,0,1,0
9172,28,0,0,70,70,0,1,0,1,0
18707,28,0,0,70,70,0,1,0,1,0
19406,28,0,0,69,69,0,1,0,1,0
16268,28,0,0,70,70,0,1,0,1,0
10246,28,0,0,70,70,0,1,0,1,0
15419,28,0,0,70,70,0,1,0,1,0
9711,28,0,0,70,70,0,1,0,1,0
21002,28,0,0,68,68,0,1,0,1,0
17902,28,0,0,66,66,0,1,0,1,0
18819,28,0,0,70,70,0,1,0,1,0
15925,28,0,0,67,67,0,1,0,1,0
17401,28,0,0,67,67,0,1,0,1,0
16594,28,0,0,66,66,0,1,0,1,0
21857,28,0,0,69,69,0,1,0,1,0
16093,28,0,0,69,69,0,1,0,1,0
19609,28,0,0,66,66,0,1,0,1,0
9039,28,0,0,70,70,0,1,0,1,0
13713,28,0,0,70,70,0,1,0,1,0
15278,28,0,0,70,70,0,1,0,1,0
18218,28,0,0,66,66,0,1,0,1,0
17600,28,0,0,68,68,0,1,0,1,0
17054,28,0,0,66,66,0,1,0,1,0
14269,28,0,0,70,70,0,1,0,1,0
13736,28,0,0,70,70,0,1,0,1,0
9100,28,0,0,70,70,0,1,0,1,0
18575,28,0,0,70,70,0,1,0,1,0
17592,28,0,0,70,70,0,1,0,1,0
16200,28,0,0,70,70,0,1,0,1,0
15627,28,0,0,70,70,0,1,0,1,0
13436,28,0,0,70,70,0,1,0,1,0
16336,28,0,0,70,70,0,1,0,1,0
16182,28,0,0,68,68,0,1,0,1,0
16373,28,0,0,70,70,0,1,0,1,0
8661,28,0,0,69,69,0,1,0,1,0
20343,28,0,0,67,67,0,1,0,1,0
8476,28,0,0,70,70,0,1,0,1,0
14223,28,0,0,68,68,0,1,0,1,0
8472,28,0,0,69,69,0,1,0,1,0
10094,28,0,0,70,70,0,1,0,1,0
14132,28,0,0,69,69,0,1,0,1,0
14748,28,0,0,68,68,0,1,0,1,0
14769,28,0,0,67,67,0,1,0,1,0
21089,28,0,0,70,70,0,1,0,1,0
20500,28,0,0,70,70,0,1,0,1,0
13477,28,0,0,67,67,0,1,0,1,0
16672,28,0,0,70,70,0,1,0,1,0
9074,28,0,0,66,66,0,1,0,1,0
21545,28,0,0,70,70,0,1,0,1,0
17409,28,0,0,66,66,0,1,0,1,0
9155,28,0,0,70,70,0,1,0,1,0
11404,28,0,0,66,66,0,1,0,1,0
12512,28,0,0,70,70,0,1,0,1,0
11724,28,0,0,66,66,0,1,0,1,0
20914,28,0,0,66,66,0,1,0,1,0
10612,28,0,0,66,66,0,1,0,1,0
8747,28,0,0,70,70,0,1,0,1,0
9849,28,0,0,70,70,0,1,0,1,0
14261,28,0,0,70,70,0,1,0,1,0
18566,28,0,0,66,66,0,1,0,1,0
19970,28,0,0,67,67,0,1,0,1,0
21492,28,0,0,66,66,0,1,0,1,0
21533,28,0,0,66,66,0,1,0,1,0
15907,28,0,0,66,66,0,1,0,1,0
10447,28,0,0,67,67,0,1,0,1,0
14885,28,0,0,68,68,0,1,0,1,0
12619,28,0,0,66,66,0,1,0,1,0
15812,28,0,0,70,70,0,1,0,1,0
18040,28,0,0,66,66,0,1,0,1,0
12765,28,0,0,70,70,0,1,0,1,0
14055,28,0,0,66,66,0,1,0,1,0
8744,28,0,0,70,70,0,1,0,1,0
11231,28,0,0,70,70,0,1,0,1,0
13056,28,0,0,66,66,0,1,0,1,0
12750,28,0,0,69,69,0,1,0,1,0
13217,28,0,0,66,66,0,1,0,1,0
19503,28,0,0,70,70,0,1,0,1,0
16782,28,0,0,70,70,0,1,0,1,0
16723,28,0,0,68,68,0,1,0,1,0
11460,28,0,0,66,66,0,1,0,1,0
12486,28,0,0,70,70,0,1,0,1,0
13999,28,0,0,70,70,0,1,0,1,0
19204,28,0,0,70,70,0,1,0,1,0
17092,28,0,0,66,66,0,1,0,1,0
21653,28,0,0,67,67,0,1,0,1,0
22159,28,0,0,70,70,0,1,0,1,0
21027,28,0,0,66,66,0,1,0,1,0
20970,28,0,0,70,70,0,1,0,1,0
17463,28,0,0,70,70,0,1,0,1,0
14308,28,0,0,70,70,0,1,0,1,0
16652,28,0,0,66,66,0,1,0,1,0
16756,28,0,0,70,70,0,1,0,1,0
10860,28,0,0,66,66,0,1,0,1,0
10478,28,0,0,70,70,0,1,0,1,0
15222,28,0,0,66,66,0,1,0,1,0
14781,28,0,0,70,70,0,1,0,1,0
8879,28,0,0,66,66,0,1,0,1,0
21027,28,0,0,66,66,0,1,0,1,0
9860,28,0,0,66,66,0,1,0,1,0
16520,28,0,0,66,66,0,1,0,1,0
16312,28,0,0,70,70,0,1,0,1,0
12052,28,0,0,70,70,0,1,0,1,0
9428,28,0,0,66,66,0,1,0,1,0
13305,28,0,0,70,70,0,1,0,1,0
12301,28,0,0,70,70,0,1,0,1,0
14236,28,0,0,66,66,0,1,0,1,0
16687,28,0,0,70,70,0,1,0,1,0
14771,28,0,0,70,70,0,1,0,1,0
15969,28,0,0,70,70,0,1,0,1,0
13793,28,0,0,70,70,0,1,0,1,0
12741,28,0,0,68,68,0,1,0,1,0
12133,28,0,0,67,67,0,1,0,1,0
21473,28,0,0,66,66,0,1,0,1,0
8758,28,0,0,68,68,0,1,0,1,0
20891,28,0,0,70,70,0,1,0,1,0
16665,28,0,0,66,66,0,1,0,1,0
22400,28,0,0,68,68,0,1,0,1,0
9466,28,0,0,70,70,0,1,0,1,0
16005,28,0,0,70,70,0,1,0,1,0
18780,28,0,0,66,66,0,1,0,1,0
21138,28,0,0,70,70,0,1,0,1,0
22046,28,0,0,70,70,0,1,0,1,0
18148,28,0,0,68,68,0,1,0,1,0
9708,28,0,0,66,66,0,1,0,1,0
18465,28,0,0,70,70,0,1,0,1,0
12948,28,0,0,70,70,0,1,0,1,0
22319,28,0,0,70,70,0,1,0,1,0
22056,28,0,0,70,70,0,1,0,1,0
11734,28,0,0,66,66,0,1,0,1,0
17072,28,0,0,70,70,0,1,0,1,0
14391,28,0,0,68,68,0,1,0,1,0
19340,28,0,0,68,68,0,1,0,1,0
16444,28,0,0,70,70,0,1,0,1,0
20412,28,0,0,70,70,0,1,0,1,0
11563,28,0,0,68,68,0,1,0,1,0
11743,28,0,0,70,70,0,1,0,1,0
17554,28,0,0,70,70,0,1,0,1,0
18316,28,0,0,70,70,0,1,0,1,0
15553,28,0,0,70,70,0,1,0,1,0
8770,28,0,0,70,70,0,1,0,1,0
19039,28,0,0,66,66,0,1,0,1,0
17179,28,0,0,69,69,0,1,0,1,0
8578,28,0,0,66,66,0,1,0,1,0
20074,28,0,0,70,70,0,1,0,1,0
19101,28,0,0,70,70,0,1,0,1,0
19827,28,0,0,70,70,0,1,0,1,0
14097,28,0,0,70,70,0,1,0,1,0
19083,28,0,0,70,70,0,1,0,1,0
20339,28,0,0,66,66,0,1,0,1,0
22551,28,0,0,67,67,0,1,0,1,0
11451,28,0,0,70,70,0,1,0,1,0
8674,28,0,0,70,70,0,1,0,1,0
14852,28,0,0,68,68,0,1,0,1,0
10703,28,0,0,70,70,0,1,0,1,0
11283,28,0,0,70,70,0,1,0,1,0
18040,28,0,0,66,66,0,1,0,1,0
20997,28,0,0,70,70,0,1,0,1,0
15026,28,0,0,66,66,0,1,0,1,0
17852,28,0,0,70,70,0,1,0,1,0
16080,28,0,0,70,70,0,1,0,1,0
10343,28,0,0,66,66,0,1,0,1,0
19838,28,0,0,70,70,0,1,0,1,0
16200,28,0,0,70,70,0,1,0,1,0
9881,28,0,0,66,66,0,1,0,1,0
22359,28,0,0,70,70,0,1,0,1,0
18152,28,0,0,70,70,0,1,0,1,0
10078,28,0,0,66,66,0,1,0,1,0
21285,28,0,0,70,70,0,1,0,1,0
13973,28,0,0,70,70,0,1,0,1,0
20673,28,0,0,70,70,0,1,0,1,0
15216,28,0,0,66,66,0,1,0,1,0
9273,28,0,0,70,70,0,1,0,1,0
11211,28,0,0,70,70,0,1,0,1,0
11048,28,0,0,70,70,0,1,0,1,0
14499,28,0,0,69,69,0,1,0,1,0
20850,28,0,0,70,70,0,1,0,1,0
14350,28,0,0,70,70,0,1,0,1,0
21535,28,0,0,66,66,0,1,0,1,0
18686,28,0,0,70,70,0,1,0,1,0
19227,28,0,0,67,67,0,1,0,1,0
11333,28,0,0,70,70,0,1,0,1,0
15484,28,0,0,69,69,0,1,0,1,0
12121,28,0,0,70,70,0,1,0,1,0
10277,28,0,0,70,70,0,1,0,1,0
13667,28,0,0,68,68,0,1,0,1,0
13324,28,0,0,66,66,0,1,0,1,0
17844,28,0,0,70,70,0,1,0,1,0
19464,28,0,0,70,70,0,1,0,1,0
20799,28,0,0,68,68,0,1,0,1,0
13524,28,0,0,70,70,0,1,0,1,0
12367,28,0,0,66,66,0,1,0,1,0
18017,28,0,0,70,70,0,1,0,1,0
16943,28,0,0,66,66,0,1,0,1,0
15192,28,0,0,70,70,0,1,0,1,0
14722,28,0,0,66,66,0,1,0,1,0
20133,28,0,0,70,70,0,1,0,1,0
18895,28,0,0,70,70,0,1,0,1,0
15845,28,0,0,70,70,0,1,0,1,0
10863,28,0,0,68,68,0,1,0,1,0
13728,28,0,0,70,70,0,1,0,1,0
13168,28,0,0,70,70,0,1,0,1,0
9995,28,0,0,66,66,0,1,0,1,0
21490,28,0,0,66,66,0,1,0,1,0
15202,28,0,0,69,69,0,1,0,1,0
17817,28,0,0,70,70,0,1,0,1,0
22464,28,0,0,66,66,0,1,0,1,0
16295,28,0,0,67,67,0,1,0,1,0
13376,28,0,0,66,66,0,1,0,1,0
20127,28,0,0,70,70,0,1,0,1,0
17552,28,0,0,67,67,0,1,0,1,0
15889,28,0,0,66,66,0,1,0,1,0
14509,28,0,0,70,70,0,1,0,1,0
9482,28,0,0,66,66,0,1,0,1,0
18086,28,0,0,66,66,0,1,0,1,0
18103,28,0,0,67,67,0,1,0,1,0
14068,28,0,0,70,70,0,1,0,1,0
9879,28,0,0,70,70,0,1,0,1,0
14969,28,0,0,66,66,0,1,0,1,0
18697,28,0,0,70,70,0,1,0,1,0
12150,28,0,0,70,70,0,1,0,1,0
19353,28,0,0,70,70,0,1,0,1,0
20819,28,0,0,70,70,0,1,0,1,0
17807,28,0,0,66,66,0,1,0,1,0
22361,28,0,0,70,70,0,1,0,1,0
22383,28,0,0,70,70,0,1,0,1,0
9103,28,0,0,70,70,0,1,0,1,0
12835,28,0,0,70,70,0,1,0,1,0
22647,28,0,0,70,70,0,1,0,1,0
22180,28,0,0,70,70,0,1,0,1,0
15104,28,0,0,66,66,0,1,0,1,0
13908,28,0,0,70,70,0,1,0,1,0
18904,28,0,0,69,69,0,1,0,1,0
22429,28,0,0,70,70,0,1,0,1,0
16678,28,0,0,66,66,0,1,0,1,0
20847,28,0,0,70,70,0,1,0,1,0
13312,28,0,0,70,70,0,1,0,1,0
18402,28,0,0,70,70,0,1,0,1,0
12950,28,0,0,66,66,0,1,0,1,0
13843,28,0,0,70,70,0,1,0,1,0
12557,28,0,0,70,70,0,1,0,1,0
11118,28,0,0,66,66,0,1,0,1,0
14471,28,0,0,70,70,0,1,0,1,0
22704,28,0,0,67,67,0,1,0,1,0
16852,28,0,0,66,66,0,1,0,1,0
9722,28,0,0,66,66,0,1,0,1,0
15940,28,0,0,70,70,0,1,0,1,0
18473,28,0,0,69,69,0,1,0,1,0
18904,28,0,0,67,67,0,1,0,1,0
17542,28,0,0,68,68,0,1,0,1,0
9414,28,0,0,66,66,0,1,0,1,0
13366,28,0,0,70,70,0,1,0,1,0
10380,28,0,0,70,70,0,1,0,1,0
18784,28,0,0,66,66,0,1,0,1,0
21375,28,0,0,66,66,0,1,0,1,0
10162,28,0,0,70,70,0,1,0,1,0
20713,28,0,0,70,70,0,1,0,1,0
20984,28,0,0,70,70,0,1,0,1,0
8403,28,0,0,70,70,0,1,0,1,0
15291,28,0,0,70,70,0,1,0,1,0
20265,28,0,0,70,70,0,1,0,1,0
16609,28,0,0,68,68,0,1,0,1,0
11965,28,0,0,70,70,0,1,0,1,0
13781,28,0,0,70,70,0,1,0,1,0
9794,28,0,0,70,70,0,1,0,1,0
16497,28,0,0,70,70,0,1,0,1,0
20133,28,0,0,70,70,0,1,0,1,0
13668,28,0,0,66,66,0,1,0,1,0
20572,28,0,0,70,70,0,1,0,1,0
19283,28,0,0,66,66,0,1,0,1,0
15138,28,0,0,66,66,0,1,0,1,0
9632,28,0,0,70,70,0,1,0,1,0
15152,28,0,0,66,66,0,1,0,1,0
15135,28,0,0,68,68,0,1,0,1,0
21212,28,0,0,69,69,0,1,0,1,0
21377,28,0,0,66,66,0,1,0,1,0
14356,28,0,0,70,70,0,1,0,1,0
18716,28,0,0,66,66,0,1,0,1,0
11117,28,0,0,66,66,0,1,0,1,0
21249,28,0,0,66,66,0,1,0,1,0
8895,28,0,0,70,70,0,1,0,1,0
18401,28,0,0,70,70,0,1,0,1,0
8616,28,0,0,70,70,0,1,0,1,0
9503,28,0,0,70,70,0,1,0,1,0
9580,28,0,0,67,67,0,1,0,1,0
9004,28,0,0,66,66,0,1,0,1,0
19235,28,0,0,70,70,0,1,0,1,0
22681,28,0,0,70,70,0,1,0,1,0
9655,28,0,0,70,70,0,1,0,1,0
15391,28,0,0,66,66,0,1,0,1,0
9434,28,0,0,70,70,0,1,0,1,0
9643,28,0,0,70,70,0,1,0,1,0
17287,28,0,0,70,70,0,1,0,1,0
12215,28,0,0,70,70,0,1,0,1,0
17812,28,0,0,70,70,0,1,0,1,0
10355,28,0,0,70,70,0,1,0,1,0
10784,28,0,0,70,70,0,1,0,1,0
8356,28,0,0,70,70,0,1,0,1,0
12823,28,0,0,68,68,0,1,0,1,0
9750,28,0,0,66,66,0,1,0,1,0
21656,28,0,0,70,70,0,1,0,1,0
16670,28,0,0,69,69,0,1,0,1,0
11865,28,0,0,70,70,0,1,0,1,0
14959,28,0,0,66,66,0,1,0,1,0
10117,28,0,0,66,66,0,1,0,1,0
19980,28,0,0,70,70,0,1,0,1,0
9586,28,0,0,70,70,0,1,0,1,0
17824,28,0,0,70,70,0,1,0,1,0
8746,28,0,0,70,70,0,1,0,1,0
20389,28,0,0,70,70,0,1,0,1,0
19077,28,0,0,70,70,0,1,0,1,0
20883,28,0,0,70,70,0,1,0,1,0
17403,28,0,0,70,70,0,1,0,1,0
12066,28,0,0,69,69,0,1,0,1,0
12312,28,0,0,70,70,0,1,0,1,0
20798,28,0,0,70,70,0,1,0,1,0
16657,28,0,0,66,66,0,1,0,1,0
13194,28,0,0,70,70,0,1,0,1,0
9483,28,0,0,70,70,0,1,0,1,0
14506,28,0,0,69,69,0,1,0,1,0
13558,28,0,0,70,70,0,1,0,1,0
16462,28,0,0,70,70,0,1,0,1,0
15458,28,0,0,66,66,0,1,0,1,0
19237,28,0,0,66,66,0,1,0,1,0
17350,28,0,0,66,66,0,1,0,1,0
11506,28,0,0,70,70,0,1,0,1,0
21877,28,0,0,70,70,0,1,0,1,0
19668,28,0,0,70,70,0,1,0,1,0
10407,28,0,0,70,70,0,1,0,1,0
12301,28,0,0,70,70,0,1,0,1,0
8398,28,0,0,70,70,0,1,0,1,0
19697,28,0,0,70,70,0,1,0,1,0
15628,28,0,0,70,70,0,1,0,1,0
11418,28,0,0,70,70,0,1,0,1,0
15027,28,0,0,66,66,0,1,0,1,0
12312,28,0,0,70,70,0,1,0,1,0
11990,28,0,0,70,70,0,1,0,1,0
12515,28,0,0,69,69,0,1,0,1,0
12278,28,0,0,70,70,0,1,0,1,0
21131,28,0,0,68,68,0,1,0,1,0
20490,28,0,0,70,70,0,1,0,1,0
18802,28,0,0,70,70,0,1,0,1,0
15015,28,0,0,68,68,0,1,0,1,0
20308,28,0,0,70,70,0,1,0,1,0
18407,28,0,0,70,70,0,1,0,1,0
11103,28,0,0,70,70,0,1,0,1,0
9690,28,0,0,66,66,0,1,0,1,0
13621,28,0,0,70,70,0,1,0,1,0
22457,28,0,0,66,66,0,1,0,1,0
9299,28,0,0,70,70,0,1,0,1,0
16511,28,0,0,66,66,0,1,0,1,0
13812,28,0,0,70,70,0,1,0,1,0
15625,28,0,0,70,70,0,1,0,1,0
18765,28,0,0,66,66,0,1,0,1,0
18399,28,0,0,67,67,0,1,0,1,0
12750,28,0,0,66,66,0,1,0,1,0
10873,28,0,0,70,70,0,1,0,1,0
20869,28,0,0,66,66,0,1,0,1,0
13756,28,0,0,70,70,0,1,0,1,0
19170,28,0,0,68,68,0,1,0,1,0
20397,28,0,0,70,70,0,1,0,1,0
13379,28,0,0,70,70,0,1,0,1,0
22575,28,0,0,70,70,0,1,0,1,0
9854,28,0,0,70,70,0,1,0,1,0
16340,28,0,0,69,69,0,1,0,1,0
16814,28,0,0,70,70,0,1,0,1,0
18049,28,0,0,66,66,0,1,0,1,0
11665,28,0,0,66,66,0,1,0,1,0
15175,28,0,0,69,69,0,1,0,1,0
16455,28,0,0,66,66,0,1,0,1,0
9367,28,0,0,70,70,0,1,0,1,0
17092,28,0,0,70,70,0,1,0,1,0
22642,28,0,0,66,66,0,1,0,1,0
21586,28,0,0,70,70,0,1,0,1,0
9225,28,0,0,70,70,0,1,0,1,0
8809,28,0,0,70,70,0,1,0,1,0
14570,28,0,0,70,70,0,1,0,1,0
9252,28,0,0,66,66,0,1,0,1,0
22548,28,0,0,70,70,0,1,0,1,0
11513,28,0,0,66,66,0,1,0,1,0
12312,28,0,0,70,70,0,1,0,1,0
18691,28,0,0,70,70,0,1,0,1,0
18424,28,0,0,69,69,0,1,0,1,0
22666,28,0,0,68,68,0,1,0,1,0
20984,28,0,0,66,66,0,1,0,1,0
13051,28,0,0,70,70,0,1,0,1,0
15862,28,0,0,69,69,0,1,0,1,0
13842,28,0,0,70,70,0,1,0,1,0
14001,28,0,0,70,70,0,1,0,1,0
22130,28,0,0,66,66,0,1,0,1,0
19158,28,0,0,68,68,0,1,0,1,0
20678,28,0,0,67,67,0,1,0,1,0
12285,28,0,0,66,66,0,1,0,1,0
14352,28,0,0,66,66,0,1,0,1,0
16082,28,0,0,70,70,0,1,0,1,0
22129,28,0,0,68,68,0,1,0,1,0
13604,28,0,0,70,70,0,1,0,1,0
9068,28,0,0,70,70,0,1,0,1,0
10201,28,0,0,68,68,0,1,0,1,0
12255,28,0,0,66,66,0,1,0,1,0
9627,28,0,0,66,66,0,1,0,1,0
10329,28,0,0,66,66,0,1,0,1,0
16253,28,0,0,70,70,0,1,0,1,0
22374,28,0,0,69,69,0,1,0,1,0
22516,28,0,0,66,66,0,1,0,1,0
9973,28,0,0,67,67,0,1,0,1,0
17379,28,0,0,70,70,0,1,0,1,0
12933,28,0,0,67,67,0,1,0,1,0
18368,28,0,0,66,66,0,1,0,1,0
14324,28,0,0,70,70,0,1,0,1,0
17234,28,0,0,70,70,0,1,0,1,0
20776,28,0,0,70,70,0,1,0,1,0
14499,28,0,0,69,69,0,1,0,1,0
13559,28,0,0,70,70,0,1,0,1,0
10614,28,0,0,66,66,0,1,0,1,0
14113,28,0,0,66,66,0,1,0,1,0
11284,28,0,0,68,68,0,1,0,1,0
9893,28,0,0,70,70,0,1,0,1,0
16025,28,0,0,67,67,0,1,0,1,0
13745,28,0,0,70,70,0,1,0,1,0
22302,28,0,0,70,70,0,1,0,1,0
16789,28,0,0,70,70,0,1,0,1,0
16698,28,0,0,67,67,0,1,0,1,0
21506,28,0,0,70,70,0,1,0,1,0
12778,28,0,0,66,66,0,1,0,1,0
15576,28,0,0,70,70,0,1,0,1,0
16428,28,0,0,70,70,0,1,0,1,0
16404,28,0,0,66,66,0,1,0,1,0
16492,28,0,0,70,70,0,1,0,1,0
13675,28,0,0,70,70,0,1,0,1,0
9543,28,0,0,70,70,0,1,0,1,0
19336,28,0,0,70,70,0,1,0,1,0
14138,28,0,0,70,70,0,1,0,1,0
16160,28,0,0,66,66,0,1,0,1,0
11305,28,0,0,67,67,0,1,0,1,0
11563,28,0,0,66,66,0,1,0,1,0
14177,28,0,0,66,66,0,1,0,1,0
13893,28,0,0,70,70,0,1,0,1,0
13545,28,0,0,70,70,0,1,0,1,0
21212,28,0,0,67,67,0,1,0,1,0
10718,28,0,0,70,70,0,1,0,1,0
13352,28,0,0,70,70,0,1,0,1,0
20192,28,0,0,70,70,0,1,0,1,0
18861,28,0,0,70,70,0,1,0,1,0
18225,28,0,0,70,70,0,1,0,1,0
18904,28,0,0,66,66,0,1,0,1,0
14610,28,0,0,70,70,0,1,0,1,0
20874,28,0,0,70,70,0,1,0,1,0
14061,28,0,0,70,70,0,1,0,1,0
14263,28,0,0,66,66,0,1,0,1,0
12839,28,0,0,70,70,0,1,0,1,0
21845,28,0,0,70,70,0,1,0,1,0
20341,28,0,0,66,66,0,1,0,1,0
8689,28,0,0,70,70,0,1,0,1,0
8551,28,0,0,66,66,0,1,0,1,0
13849,28,0,0,70,70,0,1,0,1,0
9395,28,0,0,68,68,0,1,0,1,0
22072,28,0,0,70,70,0,1,0,1,0
22133,28,0,0,69,69,0,1,0,1,0
18191,28,0,0,70,70,0,1,0,1,0
14371,28,0,0,70,70,0,1,0,1,0
19391,28,0,0,70,70,0,1,0,1,0
14721,28,0,0,66,66,0,1,0,1,0
22192,28,0,0,70,70,0,1,0,1,0
17215,28,0,0,67,67,0,1,0,1,0
16565,28,0,0,66,66,0,1,0,1,0
13416,28,0,0,67,67,0,1,0,1,0
10709,28,0,0,70,70,0,1,0,1,0
11074,28,0,0,70,70,0,1,0,1,0
10719,28,0,0,70,70,0,1,0,1,0
18058,28,0,0,70,70,0,1,0,1,0
21452,28,0,0,70,70,0,1,0,1,0
10668,28,0,0,70,70,0,1,0,1,0
10185,28,0,0,70,70,0,1,0,1,0
13586,28,0,0,70,70,0,1,0,1,0
15599,28,0,0,70,70,0,1,0,1,0
20378,28,0,0,66,66,0,1,0,1,0
9715,28,0,0,70,70,0,1,0,1,0
12597,28,0,0,66,66,0,1,0,1,0
19747,28,0,0,70,70,0,1,0,1,0
9345,28,0,0,70,70,0,1,0,1,0
16369,28,0,0,66,66,0,1,0,1,0
10222,28,0,0,66,66,0,1,0,1,0
16053,28,0,0,70,70,0,1,0,1,0
10597,28,0,0,67,67,0,1,0,1,0
16941,28,0,0,66,66,0,1,0,1,0
18292,28,0,0,70,70,0,1,0,1,0
22072,28,0,0,66,66,0,1,0,1,0
18578,28,0,0,70,70,0,1,0,1,0
13068,28,0,0,70,70,0,1,0,1,0
15167,28,0,0,70,70,0,1,0,1,0
16855,28,0,0,70,70,0,1,0,1,0
20308,28,0,0,70,70,0,1,0,1,0
20998,28,0,0,70,70,0,1,0,1,0
11259,28,0,0,67,67,0,1,0,1,0
20474,28,0,0,66,66,0,1,0,1,0
20078,28,0,0,66,66,0,1,0,1,0
9510,28,0,0,66,66,0,1,0,1,0
20073,28,0,0,70,70,0,1,0,1,0
18850,28,0,0,67,67,0,1,0,1,0
10784,28,0,0,70,70,0,1,0,1,0
19818,28,0,0,66,66,0,1,0,1,0
10459,28,0,0,67,67,0,1,0,1,0
20738,28,0,0,66,66,0,1,0,1,0
17201,28,0,0,70,70,0,1,0,1,0
15477,28,0,0,70,70,0,1,0,1,0
8546,28,0,0,66,66,0,1,0,1,0
21900,28,0,0,70,70,0,1,0,1,0
11504,28,0,0,70,70,0,1,0,1,0
15229,28,0,0,70,70,0,1,0,1,0
21408,28,0,0,70,70,0,1,0,1,0
14041,28,0,0,70,70,0,1,0,1,0
10200,28,0,0,70,70,0,1,0,1,0
16146,28,0,0,70,70,0,1,0,1,0
19606,28,0,0,66,66,0,1,0,1,0
21896,28,0,0,70,70,0,1,0,1,0
16773,28,0,0,70,70,0,1,0,1,0
16233,28,0,0,70,70,0,1,0,1,0
16958,28,0,0,70,70,0,1,0,1,0
17078,28,0,0,69,69,0,1,0,1,0
18754,28,0,0,70,70,0,1,0,1,0
11487,28,0,0,70,70,0,1,0,1,0
9143,28,0,0,66,66,0,1,0,1,0
10231,28,0,0,66,66,0,1,0,1,0
13977,28,0,0,67,67,0,1,0,1,0
22580,28,0,0,68,68,0,1,0,1,0
13977,28,0,0,70,70,0,1,0,1,0
19433,28,0,0,70,70,0,1,0,1,0
14602,28,0,0,68,68,0,1,0,1,0
11765,28,0,0,70,70,0,1,0,1,0
9152,28,0,0,70,70,0,1,0,1,0
20699,28,0,0,67,67,0,1,0,1,0
19736,28,0,0,70,70,0,1,0,1,0
19708,28,0,0,70,70,0,1,0,1,0
16678,28,0,0,66,66,0,1,0,1,0
16570,28,0,0,68,68,0,1,0,1,0
9321,28,0,0,66,66,0,1,0,1,0
14219,28,0,0,70,70,0,1,0,1,0
21611,28,0,0,70,70,0,1,0,1,0
9540,28,0,0,70,70,0,1,0,1,0
14082,28,0,0,70,70,0,1,0,1,0
9482,28,0,0,66,66,0,1,0,1,0
18561,28,0,0,70,70,0,1,0,1,0
13053,28,0,0,70,70,0,1,0,1,0
16594,28,0,0,70,70,0,1,0,1,0
12417,28,0,0,70,70,0,1,0,1,0
10151,28,0,0,70,70,0,1,0,1,0
20156,28,0,0,70,70,0,1,0,1,0
11723,28,0,0,66,66,0,1,0,1,0
22024,28,0,0,70,70,0,1,0,1,0
9938,28,0,0,66,66,0,1,0,1,0
16077,28,0,0,66,66,0,1,0,1,0
8725,28,0,0,70,70,0,1,0,1,0
16400,28,0,0,70,70,0,1,0,1,0
12621,28,0,0,70,70,0,1,0,1,0
20701,28,0,0,70,70,0,1,0,1,0
22123,28,0,0,70,70,0,1,0,1,0
15347,28,0,0,70,70,0,1,0,1,0
22086,28,0,0,69,69,0,1,0,1,0
20355,28,0,0,70,70,0,1,0,1,0
17776,28,0,0,70,70,0,1,0,1,0
21561,28,0,0,70,70,0,1,0,1,0
10626,28,0,0,68,68,0,1,0,1,0
20328,28,0,0,70,70,0,1,0,1,0
13011,28,0,0,70,70,0,1,0,1,0
16205,28,0,0,70,70,0,1,0,1,0
19285,28,0,0,67,67,0,1,0,1,0
9286,28,0,0,70,70,0,1,0,1,0
22613,28,0,0,70,70,0,1,0,1,0
19668,28,0,0,70,70,0,1,0,1,0
8418,28,0,0,69,69,0,1,0,1,0
15473,28,0,0,66,66,0,1,0,1,0
11486,28,0,0,70,70,0,1,0,1,0
20146,28,0,0,70,70,0,1,0,1,0
19588,28,0,0,70,70,0,1,0,1,0
20578,28,0,0,68,68,0,1,0,1,0
21634,28,0,0,70,70,0,1,0,1,0
14720,28,0,0,66,66,0,1,0,1,0
16028,28,0,0,66,66,0,1,0,1,0
14974,28,0,0,70,70,0,1,0,1,0
15397,28,0,0,67,67,0,1,0,1,0
18406,28,0,0,68,68,0,1,0,1,0
14001,28,0,0,70,70,0,1,0,1,0
22447,28,0,0,70,70,0,1,0,1,0
22076,28,0,0,68,68,0,1,0,1,0
9950,28,0,0,70,70,0,1,0,1,0
11329,28,0,0,70,70,0,1,0,1,0
15660,28,0,0,70,70,0,1,0,1,0
15542,28,0,0,66,66,0,1,0,1,0
15322,28,0,0,70,70,0,1,0,1,0
13304,28,0,0,68,68,0,1,0,1,0
22014,28,0,0,68,68,0,1,0,1,0
13778,28,0,0,70,70,0,1,0,1,0
14491,28,0,0,70,70,0,1,0,1,0
13994,28,0,0,70,70,0,1,0,1,0
14223,28,0,0,70,70,0,1,0,1,0
13512,28,0,0,70,70,0,1,0,1,0
19726,28,0,0,70,70,0,1,0,1,0
9607,28,0,0,66,66,0,1,0,1,0
14893,28,0,0,69,69,0,1,0,1,0
15397,28,0,0,68,68,0,1,0,1,0
21847,28,0,0,70,70,0,1,0,1,0
20723,28,0,0,66,66,0,1,0,1,0
13624,28,0,0,70,70,0,1,0,1,0
20842,28,0,0,70,70,0,1,0,1,0
19888,28,0,0,66,66,0,1,0,1,0
10862,28,0,0,66,66,0,1,0,1,0
12701,28,0,0,68,68,0,1,0,1,0
18599,28,0,0,69,69,0,1,0,1,0
12342,28,0,0,70,70,0,1,0,1,0
8808,28,0,0,68,68,0,1,0,1,0
15666,28,0,0,70,70,0,1,0,1,0
20071,28,0,0,70,70,0,1,0,1,0
15623,28,0,0,70,70,0,1,0,1,0
9739,28,0,0,70,70,0,1,0,1,0
12838,28,0,0,70,70,0,1,0,1,0
9467,28,0,0,70,70,0,1,0,1,0
16698,28,0,0,66,66,0,1,0,1,0
12752,28,0,0,70,70,0,1,0,1,0
16044,28,0,0,70,70,0,1,0,1,0
16881,28,0,0,70,70,0,1,0,1,0
21491,28,0,0,66,66,0,1,0,1,0
9474,28,0,0,70,70,0,1,0,1,0
17752,28,0,0,70,70,0,1,0,1,0
11611,28,0,0,68,68,0,1,0,1,0
19751,28,0,0,66,66,0,1,0,1,0
13631,28,0,0,70,70,0,1,0,1,0
18567,28,0,0,70,70,0,1,0,1,0
13941,28,0,0,70,70,0,1,0,1,0
9668,28,0,0,66,66,0,1,0,1,0
8539,28,0,0,70,70,0,1,0,1,0
13498,28,0,0,66,66,0,1,0,1,0
14725,28,0,0,70,70,0,1,0,1,0
18196,28,0,0,66,66,0,1,0,1,0
14355,28,0,0,69,69,0,1,0,1,0
15849,28,0,0,67,67,0,1,0,1,0
13697,28,0,0,70,70,0,1,0,1,0
20647,28,0,0,66,66,0,1,0,1,0
9950,28,0,0,70,70,0,1,0,1,0
22688,28,0,0,66,66,0,1,0,1,0
9907,28,0,0,70,70,0,1,0,1,0
18832,28,0,0,70,70,0,1,0,1,0
8745,28,0,0,70,70,0,1,0,1,0
17351,28,0,0,68,68,0,1,0,1,0
22336,28,0,0,66,66,0,1,0,1,0
15961,28,0,0,70,70,0,1,0,1,0
14405,28,0,0,70,70,0,1,0,1,0
12412,28,0,0,66,66,0,1,0,1,0
18357,28,0,0,70,70,0,1,0,1,0
8989,28,0,0,66,66,0,1,0,1,0
21992,28,0,0,68,68,0,1,0,1,0
8405,28,0,0,70,70,0,1,0,1,0
10969,28,0,0,67,67,0,1,0,1,0
11378,28,0,0,70,70,0,1,0,1,0
15139,28,0,0,66,66,0,1,0,1,0
12981,28,0,0,70,70,0,1,0,1,0
9174,28,0,0,70,70,0,1,0,1,0
15183,28,0,0,68,68,0,1,0,1,0
18761,28,0,0,70,70,0,1,0,1,0
20210,28,0,0,70,70,0,1,0,1,0
19120,28,0,0,70,70,0,1,0,1,0
11601,28,0,0,66,66,0,1,0,1,0
13588,28,0,0,70,70,0,1,0,1,0
14925,28,0,0,68,68,0,1,0,1,0
16265,28,0,0,70,70,0,1,0,1,0
20275,28,0,0,70,70,0,1,0,1,0
17442,28,0,0,66,66,0,1,0,1,0
9776,28,0,0,70,70,0,1,0,1,0
9604,28,0,0,70,70,0,1,0,1,0
18348,28,0,0,70,70,0,1,0,1,0
11041,28,0,0,66,66,0,1,0,1,0
13437,28,0,0,70,70,0,1,0,1,0
10914,28,0,0,70,70,0,1,0,1,0
15329,28,0,0,70,70,0,1,0,1,0
20634,28,0,0,70,70,0,1,0,1,0
15365,28,0,0,66,66,0,1,0,1,0
12954,28,0,0,66,66,0,1,0,1,0
10136,28,0,0,70,70,0,1,0,1,0
22691,28,0,0,69,69,0,1,0,1,0
16944,28,0,0,66,66,0,1,0,1,0
17957,28,0,0,70,70,0,1,0,1,0
19032,28,0,0,70,70,0,1,0,1,0
10720,28,0,0,70,70,0,1,0,1,0
19889,28,0,0,67,67,0,1,0,1,0
15096,28,0,0,66,66,0,1,0,1,0
9204,28,0,0,66,66,0,1,0,1,0
14538,28,0,0,68,68,0,1,0,1,0
13892,28,0,0,70,70,0,1,0,1,0
8806,28,0,0,67,67,0,1,0,1,0
12101,28,0,0,70,70,0,1,0,1,0
19708,28,0,0,70,70,0,1,0,1,0
16789,28,0,0,70,70,0,1,0,1,0
11172,28,0,0,70,70,0,1,0,1,0
11037,28,0,0,69,69,0,1,0,1,0
17404,28,0,0,66,66,0,1,0,1,0
14456,28,0,0,70,70,0,1,0,1,0
11120,28,0,0,70,70,0,1,0,1,0
22581,28,0,0,66,66,0,1,0,1,0
17485,28,0,0,70,70,0,1,0,1,0
22326,28,0,0,66,66,0,1,0,1,0
14254,28,0,0,68,68,0,1,0,1,0
10910,28,0,0,70,70,0,1,0,1,0
15970,28,0,0,70,70,0,1,0,1,0
10395,28,0,0,66,66,0,1,0,1,0
20565,28,0,0,70,70,0,1,0,1,0
15697,28,0,0,70,70,0,1,0,1,0
20249,28,0,0,67,67,0,1,0,1,0
11583,28,0,0,70,70,0,1,0,1,0
15585,28,0,0,66,66,0,1,0,1,0
19674,28,0,0,70,70,0,1,0,1,0
11466,28,0,0,70,70,0,1,0,1,0
9496,28,0,0,66,66,0,1,0,1,0
12947,28,0,0,70,70,0,1,0,1,0
11149,28,0,0,69,69,0,1,0,1,0
15066,28,0,0,70,70,0,1,0,1,0
9938,28,0,0,66,66,0,1,0,1,0
18840,28,0,0,70,70,0,1,0,1,0
9254,28,0,0,66,66,0,1,0,1,0
19719,28,0,0,70,70,0,1,0,1,0
19673,28,0,0,70,70,0,1,0,1,0
11000,28,0,0,70,70,0,1,0,1,0
19183,28,0,0,70,70,0,1,0,1,0
20841,28,0,0,70,70,0,1,0,1,0
21774,28,0,0,70,70,0,1,0,1,0
20846,28,0,0,70,70,0,1,0,1,0
12643,28,0,0,66,66,0,1,0,1,0
12944,28,0,0,70,70,0,1,0,1,0
22515,28,0,0,66,66,0,1,0,1,0
21049,28,0,0,68,68,0,1,0,1,0
13520,28,0,0,68,68,0,1,0,1,0
21086,28,0,0,70,70,0,1,0,1,0
10530,28,0,0,70,70,0,1,0,1,0
9206,28,0,0,70,70,0,1,0,1,0
9878,28,0,0,66,66,0,1,0,1,0
13723,28,0,0,70,70,0,1,0,1,0
16616,28,0,0,70,70,0,1,0,1,0
15098,28,0,0,66,66,0,1,0,1,0
12823,28,0,0,70,70,0,1,0,1,0
11762,28,0,0,70,70,0,1,0,1,0
15181,28,0,0,68,68,0,1,0,1,0
8489,28,0,0,70,70,0,1,0,1,0
21786,28,0,0,70,70,0,1,0,1,0
22192,28,0,0,70,70,0,1,0,1,0
13163,28,0,0,70,70,0,1,0,1,0
16993,28,0,0,66,66,0,1,0,1,0
14244,28,0,0,68,68,0,1,0,1,0
20400,28,0,0,67,67,0,1,0,1,0
17647,28,0,0,67,67,0,1,0,1,0
22273,28,0,0,66,66,0,1,0,1,0
18690,28,0,0,70,70,0,1,0,1,0
21052,28,0,0,70,70,0,1,0,1,0
20295,28,0,0,70,70,0,1,0,1,0
15362,28,0,0,66,66,0,1,0,1,0
20258,28,0,0,66,66,0,1,0,1,0
13005,28,0,0,70,70,0,1,0,1,0
18113,28,0,0,70,70,0,1,0,1,0
8867,28,0,0,70,70,0,1,0,1,0
11524,28,0,0,68,68,0,1,0,1,0
15143,28,0,0,70,70,0,1,0,1,0
12731,28,0,0,70,70,0,1,0,1,0
20823,28,0,0,70,70,0,1,0,1,0
15795,28,0,0,70,70,0,1,0,1,0
20680,28,0,0,66,66,0,1,0,1,0
14504,28,0,0,70,70,0,1,0,1,0
21809,28,0,0,66,66,0,1,0,1,0
18058,28,0,0,70,70,0,1,0,1,0
9841,28,0,0,68,68,0,1,0,1,0
19162,28,0,0,66,66,0,1,0,1,0
14607,28,0,0,70,70,0,1,0,1,0
9690,28,0,0,66,66,0,1,0,1,0
21160,28,0,0,70,70,0,1,0,1,0
19864,28,0,0,66,66,0,1,0,1,0
15873,28,0,0,70,70,0,1,0,1,0
11491,28,0,0,69,69,0,1,0,1,0
19380,28,0,0,70,70,0,1,0,1,0
10216,28,0,0,70,70,0,1,0,1,0
9714,28,0,0,70,70,0,1,0,1,0
11784,28,0,0,70,70,0,1,0,1,0
13702,28,0,0,70,70,0,1,0,1,0
9251,28,0,0,70,70,0,1,0,1,0
11799,28,0,0,70,70,0,1,0,1,0
20255,28,0,0,70,70,0,1,0,1,0
8946,28,0,0,70,70,0,1,0,1,0
21671,28,0,0,69,69,0,1,0,1,0
15366,28,0,0,70,70,0,1,0,1,0
9201,28,0,0,68,68,0,1,0,1,0
18705,28,0,0,69,69,0,1,0,1,0
9490,28,0,0,66,66,0,1,0,1,0
14431,28,0,0,66,66,0,1,0,1,0
18573,28,0,0,70,70,0,1,0,1,0
10374,28,0,0,70,70,0,1,0,1,0
11449,28,0,0,70,70,0,1,0,1,0
18531,28,0,0,69,69,0,1,0,1,0
9627,28,0,0,70,70,0,1,0,1,0
10287,28,0,0,70,70,0,1,0,1,0
18317,28,0,0,66,66,0,1,0,1,0
13141,28,0,0,70,70,0,1,0,1,0
15587,28,0,0,66,66,0,1,0,1,0
8867,28,0,0,70,70,0,1,0,1,0
22441,28,0,0,66,66,0,1,0,1,0
16675,28,0,0,70,70,0,1,0,1,0
21342,28,0,0,68,68,0,1,0,1,0
19787,28,0,0,70,70,0,1,0,1,0
9470,28,0,0,66,66,0,1,0,1,0
13757,28,0,0,68,68,0,1,0,1,0
10449,28,0,0,70,70,0,1,0,1,0
14052,28,0,0,66,66,0,1,0,1,0
18655,28,0,0,70,70,0,1,0,1,0
9926,28,0,0,66,66,0,1,0,1,0
21374,28,0,0,70,70,0,1,0,1,0
16238,28,0,0,66,66,0,1,0,1,0
17729,28,0,0,66,66,0,1,0,1,0
10605,28,0,0,70,70,0,1,0,1,0
20647,28,0,0,66,66,0,1,0,1,0
15669,28,0,0,70,70,0,1,0,1,0
14687,28,0,0,70,70,0,1,0,1,0
12839,28,0,0,70,70,0,1,0,1,0
19197,28,0,0,66,66,0,1,0,1,0
14472,28,0,0,70,70,0,1,0,1,0
15446,28,0,0,70,70,0,1,0,1,0
22666,28,0,0,66,66,0,1,0,1,0
21312,28,0,0,66,66,0,1,0,1,0
10363,28,0,0,70,70,0,1,0,1,0
17661,28,0,0,70,70,0,1,0,1,0
18317,28,0,0,70,70,0,1,0,1,0
9394,28,0,0,66,66,0,1,0,1,0
9980,28,0,0,66,66,0,1,0,1,0
14286,28,0,0,70,70,0,1,0,1,0
16090,28,0,0,66,66,0,1,0,1,0
14746,28,0,0,66,66,0,1,0,1,0
12179,28,0,0,66,66,0,1,0,1,0
14746,28,0,0,66,66,0,1,0,1,0
8491,28,0,0,70,70,0,1,0,1,0
22700,28,0,0,70,70,0,1,0,1,0
15464,28,0,0,70,70,0,1,0,1,0
10433,28,0,0,66,66,0,1,0,1,0
11469,28,0,0,70,70,0,1,0,1,0
17678,28,0,0,70,70,0,1,0,1,0
19735,28,0,0,66,66,0,1,0,1,0
19483,28,0,0,70,70,0,1,0,1,0
12136,28,0,0,70,70,0,1,0,1,0
20720,28,0,0,70,70,0,1,0,1,0
19501,28,0,0,70,70,0,1,0,1,0
9922,28,0,0,70,70,0,1,0,1,0
13609,28,0,0,70,70,0,1,0,1,0
15365,28,0,0,67,67,0,1,0,1,0
13168,28,0,0,66,66,0,1,0,1,0
22028,28,0,0,66,66,0,1,0,1,0
20431,28,0,0,69,69,0,1,0,1,0
18155,28,0,0,70,70,0,1,0,1,0
15412,28,0,0,66,66,0,1,0,1,0
17684,28,0,0,66,66,0,1,0,1,0
14933,28,0,0,66,66,0,1,0,1,0
20065,28,0,0,66,66,0,1,0,1,0
10542,28,0,0,68,68,0,1,0,1,0
20738,28,0,0,66,66,0,1,0,1,0
21182,28,0,0,66,66,0,1,0,1,0
8867,28,0,0,70,70,0,1,0,1,0
19737,28,0,0,66,66,0,1,0,1,0
16461,28,0,0,70,70,0,1,0,1,0
13025,28,0,0,69,69,0,1,0,1,0
13517,28,0,0,66,66,0,1,0,1,0
13873,28,0,0,70,70,0,1,0,1,0
14449,28,0,0,70,70,0,1,0,1,0
17446,28,0,0,66,66,0,1,0,1,0
10160,28,0,0,70,70,0,1,0,1,0
8577,28,0,0,67,67,0,1,0,1,0
13148,28,0,0,70,70,0,1,0,1,0
19182,28,0,0,70,70,0,1,0,1,0
18712,28,0,0,70,70,0,1,0,1,0
20185,28,0,0,69,69,0,1,0,1,0
11536,28,0,0,70,70,0,1,0,1,0
20933,28,0,0,70,70,0,1,0,1,0
11081,28,0,0,70,70,0,1,0,1,0
14903,28,0,0,69,69,0,1,0,1,0
18355,28,0,0,70,70,0,1,0,1,0
11363,28,0,0,66,66,0,1,0,1,0
14257,28,0,0,70,70,0,1,0,1,0
22374,28,0,0,69,69,0,1,0,1,0
10744,28,0,0,70,70,0,1,0,1,0
20394,28,0,0,67,67,0,1,0,1,0
12840,28,0,0,66,66,0,1,0,1,0
20339,28,0,0,66,66,0,1,0,1,0
19181,28,0,0,70,70,0,1,0,1,0
15213,28,0,0,70,70,0,1,0,1,0
20245,28,0,0,70,70,0,1,0,1,0
19274,28,0,0,70,70,0,1,0,1,0
10907,28,0,0,70,70,0,1,0,1,0
9207,28,0,0,66,66,0,1,0,1,0
17848,28,0,0,70,70,0,1,0,1,0
16676,28,0,0,70,70,0,1,0,1,0
19171,28,0,0,68,68,0,1,0,1,0
15407,28,0,0,70,70,0,1,0,1,0
18676,28,0,0,69,69,0,1,0,1,0
12373,28,0,0,70,70,0,1,0,1,0
14319,28,0,0,70,70,0,1,0,1,0
21373,28,0,0,70,70,0,1,0,1,0
8654,28,0,0,66,66,0,1,0,1,0
17816,28,0,0,66,66,0,1,0,1,0
11767,28,0,0,70,70,0,1,0,1,0
13080,28,0,0,69,69,0,1,0,1,0
9170,28,0,0,70,70,0,1,0,1,0
20855,28,0,0,70,70,0,1,0,1,0
17843,28,0,0,66,66,0,1,0,1,0
10459,28,0,0,66,66,0,1,0,1,0
15780,28,0,0,66,66,0,1,0,1,0
16655,28,0,0,70,70,0,1,0,1,0
20580,28,0,0,70,70,0,1,0,1,0
17563,28,0,0,70,70,0,1,0,1,0
16993,28,0,0,66,66,0,1,0,1,0
18256,28,0,0,66,66,0,1,0,1,0
15919,28,0,0,68,68,0,1,0,1,0
10392,28,0,0,70,70,0,1,0,1,0
13621,28,0,0,66,66,0,1,0,1,0
19880,28,0,0,70,70,0,1,0,1,0
8869,28,0,0,70,70,0,1,0,1,0
22585,28,0,0,67,67,0,1,0,1,0
17518,28,0,0,66,66,0,1,0,1,0
19219,28,0,0,70,70,0,1,0,1,0
14273,28,0,0,70,70,0,1,0,1,0
16180,28,0,0,70,70,0,1,0,1,0
19889,28,0,0,68,68,0,1,0,1,0
16236,28,0,0,66,66,0,1,0,1,0
9744,28,0,0,66,66,0,1,0,1,0
13908,28,0,0,70,70,0,1,0,1,0
20610,28,0,0,66,66,0,1,0,1,0
16811,28,0,0,70,70,0,1,0,1,0
17599,28,0,0,67,67,0,1,0,1,0
17464,28,0,0,70,70,0,1,0,1,0
21033,28,0,0,70,70,0,1,0,1,0
21643,28,0,0,70,70,0,1,0,1,0
20040,28,0,0,70,70,0,1,0,1,0
13795,28,0,0,70,70,0,1,0,1,0
14544,28,0,0,70,70,0,1,0,1,0
22640,28,0,0,66,66,0,1,0,1,0
13862,28,0,0,70,70,0,1,0,1,0
20361,28,0,0,67,67,0,1,0,1,0
9415,28,0,0,66,66,0,1,0,1,0
18112,28,0,0,70,70,0,1,0,1,0
21701,28,0,0,70,70,0,1,0,1,0
11720,28,0,0,70,70,0,1,0,1,0
8790,28,0,0,70,70,0,1,0,1,0
13632,28,0,0,70,70,0,1,0,1,0
15565,28,0,0,68,68,0,1,0,1,0
22125,28,0,0,66,66,0,1,0,1,0
14724,28,0,0,70,70,0,1,0,1,0
13299,28,0,0,69,69,0,1,0,1,0
11039,28,0,0,70,70,0,1,0,1,0
22476,28,0,0,67,67,0,1,0,1,0
12216,28,0,0,70,70,0,1,0,1,0
12981,28,0,0,70,70,0,1,0,1,0
22297,28,0,0,70,70,0,1,0,1,0
14659,28,0,0,70,70,0,1,0,1,0
10154,28,0,0,70,70,0,1,0,1,0
22035,28,0,0,70,70,0,1,0,1,0
15589,28,0,0,66,66,0,1,0,1,0
12335,28,0,0,70,70,0,1,0,1,0
9883,28,0,0,66,66,0,1,0,1,0
8399,28,0,0,70,70,0,1,0,1,0
9998,28,0,0,70,70,0,1,0,1,0
22645,28,0,0,70,70,0,1,0,1,0
17394,28,0,0,66,66,0,1,0,1,0
17733,28,0,0,66,66,0,1,0,1,0
21694,28,0,0,70,70,0,1,0,1,0
17054,28,0,0,69,69,0,1,0,1,0
19839,28,0,0,69,69,0,1,0,1,0
9600,28,0,0,70,70,0,1,0,1,0
11444,28,0,0,66,66,0,1,0,1,0
22408,28,0,0,70,70,0,1,0,1,0
16487,28,0,0,70,70,0,1,0,1,0
20071,28,0,0,70,70,0,1,0,1,0
8793,28,0,0,70,70,0,1,0,1,0
21108,28,0,0,70,70,0,1,0,1,0
21716,28,0,0,70,70,0,1,0,1,0
8588,28,0,0,70,70,0,1,0,1,0
18091,28,0,0,70,70,0,1,0,1,0
13370,28,0,0,70,70,0,1,0,1,0
9346,28,0,0,70,70,0,1,0,1,0
12983,28,0,0,70,70,0,1,0,1,0
14147,28,0,0,70,70,0,1,0,1,0
8963,28,0,0,70,70,0,1,0,1,0
22274,28,0,0,66,66,0,1,0,1,0
14268,28,0,0,70,70,0,1,0,1,0
21660,28,0,0,70,70,0,1,0,1,0
20278,28,0,0,70,70,0,1,0,1,0
13489,28,0,0,68,68,0,1,0,1,0
21608,28,0,0,66,66,0,1,0,1,0
20031,28,0,0,70,70,0,1,0,1,0
11601,28,0,0,66,66,0,1,0,1,0
15782,28,0,0,68,68,0,1,0,1,0
9139,28,0,0,70,70,0,1,0,1,0
14844,28,0,0,67,67,0,1,0,1,0
16931,28,0,0,69,69,0,1,0,1,0
22528,28,0,0,68,68,0,1,0,1,0
10912,28,0,0,70,70,0,1,0,1,0
10278,28,0,0,70,70,0,1,0,1,0
18803,28,0,0,70,70,0,1,0,1,0
17058,28,0,0,66,66,0,1,0,1,0
10162,28,0,0,70,70,0,1,0,1,0
12846,28,0,0,66,66,0,1,0,1,0
21187,28,0,0,66,66,0,1,0,1,0
16505,28,0,0,70,70,0,1,0,1,0
21186,28,0,0,70,70,0,1,0,1,0
15669,28,0,0,70,70,0,1,0,1,0
18872,28,0,0,70,70,0,1,0,1,0
19784,28,0,0,70,70,0,1,0,1,0
16495,28,0,0,66,66,0,1,0,1,0
10431,28,0,0,68,68,0,1,0,1,0
14461,28,0,0,70,70,0,1,0,1,0
15207,28,0,0,66,66,0,1,0,1,0
17937,28,0,0,70,70,0,1,0,1,0
20724,28,0,0,66,66,0,1,0,1,0
11857,28,0,0,70,70,0,1,0,1,0
19655,28,0,0,66,66,0,1,0,1,0
12848,28,0,0,70,70,0,1,0,1,0
10572,28,0,0,66,66,0,1,0,1,0
11228,28,0,0,68,68,0,1,0,1,0
22084,28,0,0,70,70,0,1,0,1,0
20026,28,0,0,66,66,0,1,0,1,0
16084,28,0,0,68,68,0,1,0,1,0
17316,28,0,0,70,70,0,1,0,1,0
21069,28,0,0,70,70,0,1,0,1,0
13440,28,0,0,70,70,0,1,0,1,0
19838,28,0,0,70,70,0,1,0,1,0
10201,28,0,0,70,70,0,1,0,1,0
14232,28,0,0,69,69,0,1,0,1,0
14502,28,0,0,69,69,0,1,0,1,0
20436,28,0,0,70,70,0,1,0,1,0
8641,28,0,0,70,70,0,1,0,1,0
18662,28,0,0,70,70,0,1,0,1,0
14875,28,0,0,70,70,0,1,0,1,0
15027,28,0,0,66,66,0,1,0,1,0
10630,28,0,0,70,70,0,1,0,1,0
19566,28,0,0,69,69,0,1,0,1,0
9495,28,0,0,66,66,0,1,0,1,0
9434,28,0,0,70,70,0,1,0,1,0
17940,28,0,0,70,70,0,1,0,1,0
16616,28,0,0,67,67,0,1,0,1,0
16993,28,0,0,66,66,0,1,0,1,0
17697,28,0,0,70,70,0,1,0,1,0
8915,28,0,0,70,70,0,1,0,1,0
17998,28,0,0,70,70,0,1,0,1,0
19735,28,0,0,70,70,0,1,0,1,0
10662,28,0,0,70,70,0,1,0,1,0
18239,28,0,0,69,69,0,1,0,1,0
22519,28,0,0,67,67,0,1,0,1,0
19195,28,0,0,70,70,0,1,0,1,0
15909,28,0,0,66,66,0,1,0,1,0
13118,28,0,0,70,70,0,1,0,1,0
22648,28,0,0,70,70,0,1,0,1,0
10541,28,0,0,66,66,0,1,0,1,0
22585,28,0,0,66,66,0,1,0,1,0
20936,28,0,0,66,66,0,1,0,1,0
15722,28,0,0,70,70,0,1,0,1,0
14056,28,0,0,66,66,0,1,0,1,0
19376,28,0,0,70,70,0,1,0,1,0
9966,28,0,0,70,70,0,1,0,1,0
13701,28,0,0,70,70,0,1,0,1,0
14086,28,0,0,70,70,0,1,0,1,0
11589,28,0,0,70,70,0,1,0,1,0
10975,28,0,0,70,70,0,1,0,1,0
13120,28,0,0,70,70,0,1,0,1,0
18569,28,0,0,69,69,0,1,0,1,0
11685,28,0,0,70,70,0,1,0,1,0
10512,28,0,0,70,70,0,1,0,1,0
14809,28,0,0,69,69,0,1,0,1,0
20391,28,0,0,70,70,0,1,0,1,0
15338,28,0,0,68,68,0,1,0,1,0
22399,28,0,0,66,66,0,1,0,1,0
15290,28,0,0,70,70,0,1,0,1,0
10173,28,0,0,70,70,0,1,0,1,0
22508,28,0,0,70,70,0,1,0,1,0
13828,28,0,0,69,69,0,1,0,1,0
17598,28,0,0,66,66,0,1,0,1,0
8664,28,0,0,70,70,0,1,0,1,0
9891,28,0,0,68,68,0,1,0,1,0
13475,28,0,0,66,66,0,1,0,1,0
13426,28,0,0,70,70,0,1,0,1,0
9749,28,0,0,66,66,0,1,0,1,0
18304,28,0,0,70,70,0,1,0,1,0
10593,28,0,0,70,70,0,1,0,1,0
17406,28,0,0,70,70,0,1,0,1,0
8925,28,0,0,70,70,0,1,0,1,0
11331,28,0,0,70,70,0,1,0,1,0
16917,28,0,0,70,70,0,1,0,1,0
16142,28,0,0,69,69,0,1,0,1,0
21736,28,0,0,70,70,0,1,0,1,0
15249,28,0,0,70,70,0,1,0,1,0
16775,28,0,0,68,68,0,1,0,1,0
17570,28,0,0,70,70,0,1,0,1,0
13543,28,0,0,70,70,0,1,0,1,0
12774,28,0,0,66,66,0,1,0,1,0
17205,28,0,0,70,70,0,1,0,1,0
10159,28,0,0,70,70,0,1,0,1,0
10136,28,0,0,70,70,0,1,0,1,0
10821,28,0,0,70,70,0,1,0,1,0
18862,28,0,0,67,67,0,1,0,1,0
16464,28,0,0,69,69,0,1,0,1,0
10057,28,0,0,68,68,0,1,0,1,0
9271,28,0,0,70,70,0,1,0,1,0
9129,28,0,0,70,70,0,1,0,1,0
9267,28,0,0,70,70,0,1,0,1,0
16066,28,0,0,67,67,0,1,0,1,0
11532,28,0,0,67,67,0,1,0,1,0
17557,28,0,0,70,70,0,1,0,1,0
9058,28,0,0,67,67,0,1,0,1,0
19838,28,0,0,70,70,0,1,0,1,0
18678,28,0,0,66,66,0,1,0,1,0
22689,28,0,0,70,70,0,1,0,1,0
21917,28,0,0,66,66,0,1,0,1,0
17363,28,0,0,66,66,0,1,0,1,0
16777,28,0,0,66,66,0,1,0,1,0
21714,28,0,0,70,70,0,1,0,1,0
15667,28,0,0,70,70,0,1,0,1,0
8807,28,0,0,67,67,0,1,0,1,0
10519,28,0,0,70,70,0,1,0,1,0
16903,28,0,0,66,66,0,1,0,1,0
13785,28,0,0,70,70,0,1,0,1,0
20041,28,0,0,70,70,0,1,0,1,0
13821,28,0,0,70,70,0,1,0,1,0
11284,28,0,0,68,68,0,1,0,1,0
12771,28,0,0,66,66,0,1,0,1,0
17380,28,0,0,70,70,0,1,0,1,0
10987,28,0,0,66,66,0,1,0,1,0
9269,28,0,0,70,70,0,1,0,1,0
15363,28,0,0,66,66,0,1,0,1,0
14459,28,0,0,70,70,0,1,0,1,0
21594,28,0,0,66,66,0,1,0,1,0
14310,28,0,0,69,69,0,1,0,1,0
15756,28,0,0,70,70,0,1,0,1,0
10160,28,0,0,70,70,0,1,0,1,0
18507,28,0,0,66,66,0,1,0,1,0
15162,28,0,0,70,70,0,1,0,1,0
20703,28,0,0,66,66,0,1,0,1,0
13860,28,0,0,70,70,0,1,0,1,0
14306,28,0,0,70,70,0,1,0,1,0
20923,28,0,0,70,70,0,1,0,1,0
21860,28,0,0,66,66,0,1,0,1,0
11512,28,0,0,70,70,0,1,0,1,0
13126,28,0,0,70,70,0,1,0,1,0
11970,28,0,0,70,70,0,1,0,1,0
9495,28,0,0,66,66,0,1,0,1,0
16140,28,0,0,70,70,0,1,0,1,0
10733,28,0,0,66,66,0,1,0,1,0
9943,28,0,0,70,70,0,1,0,1,0
11384,28,0,0,70,70,0,1,0,1,0
21049,28,0,0,67,67,0,1,0,1,0
10000,28,0,0,70,70,0,1,0,1,0
14246,28,0,0,70,70,0,1,0,1,0
10239,28,0,0,66,66,0,1,0,1,0
17737,28,0,0,70,70,0,1,0,1,0
20894,28,0,0,70,70,0,1,0,1,0
17515,28,0,0,70,70,0,1,0,1,0
13538,28,0,0,69,69,0,1,0,1,0
9572,28,0,0,70,70,0,1,0,1,0
21112,28,0,0,70,70,0,1,0,1,0
17491,28,0,0,66,66,0,1,0,1,0
13836,28,0,0,69,69,0,1,0,1,0
16789,28,0,0,70,70,0,1,0,1,0
9992,28,0,0,66,66,0,1,0,1,0
18951,28,0,0,68,68,0,1,0,1,0
10227,28,0,0,67,67,0,1,0,1,0
14409,28,0,0,70,70,0,1,0,1,0
21981,28,0,0,66,66,0,1,0,1,0
19370,28,0,0,70,70,0,1,0,1,0
22435,28,0,0,70,70,0,1,0,1,0
8430,28,0,0,70,70,0,1,0,1,0
13526,28,0,0,70,70,0,1,0,1,0
8716,28,0,0,70,70,0,1,0,1,0
9072,28,0,0,66,66,0,1,0,1,0
11631,28,0,0,70,70,0,1,0,1,0
12474,28,0,0,70,70,0,1,0,1,0
15947,28,0,0,70,70,0,1,0,1,0
18000,28,0,0,70,70,0,1,0,1,0
11768,28,0,0,70,70,0,1,0,1,0
13641,28,0,0,67,67,0,1,0,1,0
16399,28,0,0,70,70,0,1,0,1,0
17777,28,0,0,70,70,0,1,0,1,0
13793,28,0,0,69,69,0,1,0,1,0
17728,28,0,0,66,66,0,1,0,1,0
16849,28,0,0,68,68,0,1,0,1,0
10831,28,0,0,70,70,0,1,0,1,0
19733,28,0,0,68,68,0,1,0,1,0
9816,28,0,0,66,66,0,1,0,1,0
19067,28,0,0,69,69,0,1,0,1,0
9710,28,0,0,70,70,0,1,0,1,0
10783,28,0,0,70,70,0,1,0,1,0
17309,28,0,0,70,70,0,1,0,1,0
15974,28,0,0,66,66,0,1,0,1,0
11196,28,0,0,67,67,0,1,0,1,0
9910,28,0,0,70,70,0,1,0,1,0
9461,28,0,0,70,70,0,1,0,1,0
12341,28,0,0,66,66,0,1,0,1,0
14605,28,0,0,66,66,0,1,0,1,0
19600,28,0,0,70,70,0,1,0,1,0
9559,28,0,0,67,67,0,1,0,1,0
10667,28,0,0,66,66,0,1,0,1,0
21727,28,0,0,66,66,0,1,0,1,0
12114,28,0,0,68,68,0,1,0,1,0
21780,28,0,0,66,66,0,1,0,1,0
21034,28,0,0,70,70,0,1,0,1,0
15214,28,0,0,70,70,0,1,0,1,0
20398,28,0,0,70,70,0,1,0,1,0
19852,28,0,0,70,70,0,1,0,1,0
12030,28,0,0,66,66,0,1,0,1,0
12599,28,0,0,70,70,0,1,0,1,0
12139,28,0,0,70,70,0,1,0,1,0
12617,28,0,0,67,67,0,1,0,1,0
20525,28,0,0,67,67,0,1,0,1,0
11350,28,0,0,70,70,0,1,0,1,0
12501,28,0,0,68,68,0,1,0,1,0
12982,28,0,0,70,70,0,1,0,1,0
21637,28,0,0,70,70,0,1,0,1,0
19348,28,0,0,70,70,0,1,0,1,0
11567,28,0,0,70,70,0,1,0,1,0
17696,28,0,0,68,68,0,1,0,1,0
15657,28,0,0,68,68,0,1,0,1,0
14970,28,0,0,68,68,0,1,0,1,0
15361,28,0,0,67,67,0,1,0,1,0
14649,28,0,0,70,70,0,1,0,1,0
19298,28,0,0,66,66,0,1,0,1,0
18319,28,0,0,70,70,0,1,0,1,0
8496,28,0,0,67,67,0,1,0,1,0
11119,28,0,0,70,70,0,1,0,1,0
18625,28,0,0,70,70,0,1,0,1,0
10539,28,0,0,70,70,0,1,0,1,0
21593,28,0,0,70,70,0,1,0,1,0
22123,28,0,0,67,67,0,1,0,1,0
8495,28,0,0,68,68,0,1,0,1,0
12008,28,0,0,70,70,0,1,0,1,0
20167,28,0,0,66,66,0,1,0,1,0
22400,28,0,0,66,66,0,1,0,1,0
10680,28,0,0,69,69,0,1,0,1,0
11490,28,0,0,66,66,0,1,0,1,0
17425,28,0,0,66,66,0,1,0,1,0
13229,28,0,0,70,70,0,1,0,1,0
9899,28,0,0,66,66,0,1,0,1,0
12852,28,0,0,70,70,0,1,0,1,0
15181,28,0,0,69,69,0,1,0,1,0
22513,28,0,0,66,66,0,1,0,1,0
16905,28,0,0,70,70,0,1,0,1,0
20110,28,0,0,70,70,0,1,0,1,0
17115,28,0,0,70,70,0,1,0,1,0
18964,28,0,0,68,68,0,1,0,1,0
19172,28,0,0,70,70,0,1,0,1,0
10342,28,0,0,66,66,0,1,0,1,0
14723,28,0,0,66,66,0,1,0,1,0
17356,28,0,0,66,66,0,1,0,1,0
19194,28,0,0,66,66,0,1,0,1,0
9283,28,0,0,69,69,0,1,0,1,0
20023,28,0,0,66,66,0,1,0,1,0
11859,28,0,0,70,70,0,1,0,1,0
18666,28,0,0,68,68,0,1,0,1,0
12767,28,0,0,66,66,0,1,0,1,0
19758,28,0,0,67,67,0,1,0,1,0
9559,28,0,0,66,66,0,1,0,1,0
19601,28,0,0,68,68,0,1,0,1,0
15465,28,0,0,70,70,0,1,0,1,0
12366,28,0,0,66,66,0,1,0,1,0
15051,28,0,0,70,70,0,1,0,1,0
18066,28,0,0,70,70,0,1,0,1,0
11536,28,0,0,70,70,0,1,0,1,0
22140,28,0,0,70,70,0,1,0,1,0
21675,28,0,0,70,70,0,1,0,1,0
19902,28,0,0,68,68,0,1,0,1,0
15324,28,0,0,70,70,0,1,0,1,0
21619,28,0,0,66,66,0,1,0,1,0
16359,28,0,0,70,70,0,1,0,1,0
9607,28,0,0,66,66,0,1,0,1,0
15445,28,0,0,70,70,0,1,0,1,0
17689,28,0,0,69,69,0,1,0,1,0
13746,28,0,0,66,66,0,1,0,1,0
19887,28,0,0,69,69,0,1,0,1,0
11504,28,0,0,70,70,0,1,0,1,0
15205,28,0,0,66,66,0,1,0,1,0
10303,28,0,0,67,67,0,1,0,1,0
21642,28,0,0,68,68,0,1,0,1,0
10907,28,0,0,70,70,0,1,0,1,0
16095,28,0,0,70,70,0,1,0,1,0
10636,28,0,0,70,70,0,1,0,1,0
9750,28,0,0,66,66,0,1,0,1,0
16471,28,0,0,70,70,0,1,0,1,0
11399,28,0,0,70,70,0,1,0,1,0
13383,28,0,0,70,70,0,1,0,1,0
21281,28,0,0,70,70,0,1,0,1,0
17132,28,0,0,67,67,0,1,0,1,0
19734,28,0,0,70,70,0,1,0,1,0
11032,28,0,0,70,70,0,1,0,1,0
11748,28,0,0,70,70,0,1,0,1,0
16154,28,0,0,70,70,0,1,0,1,0
16807,28,0,0,66,66,0,1,0,1,0
17899,28,0,0,70,70,0,1,0,1,0
21809,28,0,0,68,68,0,1,0,1,0
17792,28,0,0,70,70,0,1,0,1,0
19282,28,0,0,66,66,0,1,0,1,0
19426,28,0,0,66,66,0,1,0,1,0
8882,28,0,0,66,66,0,1,0,1,0
9937,28,0,0,66,66,0,1,0,1,0
22654,28,0,0,68,68,0,1,0,1,0
21351,28,0,0,70,70,0,1,0,1,0
11808,28,0,0,66,66,0,1,0,1,0
21200,28,0,0,66,66,0,1,0,1,0
14176,28,0,0,66,66,0,1,0,1,0
22274,28,0,0,66,66,0,1,0,1,0
9602,28,0,0,70,70,0,1,0,1,0
17652,28,0,0,66,66,0,1,0,1,0
13265,28,0,0,70,70,0,1,0,1,0
18534,28,0,0,70,70,0,1,0,1,0
14715,28,0,0,66,66,0,1,0,1,0
19361,28,0,0,70,70,0,1,0,1,0
19653,28,0,0,69,69,0,1,0,1,0
14483,28,0,0,66,66,0,1,0,1,0
11710,28,0,0,66,66,0,1,0,1,0
14763,28,0,0,68,68,0,1,0,1,0
13227,28,0,0,70,70,0,1,0,1,0
20821,28,0,0,70,70,0,1,0,1,0
13725,28,0,0,70,70,0,1,0,1,0
21539,28,0,0,70,70,0,1,0,1,0
9711,28,0,0,70,70,0,1,0,1,0
12476,28,0,0,70,70,0,1,0,1,0
15361,28,0,0,70,70,0,1,0,1,0
19991,28,0,0,70,70,0,1,0,1,0
11563,28,0,0,67,67,0,1,0,1,0
16346,28,0,0,70,70,0,1,0,1,0
12787,28,0,0,69,69,0,1,0,1,0
16235,28,0,0,66,66,0,1,0,1,0
9983,28,0,0,66,66,0,1,0,1,0
17389,28,0,0,70,70,0,1,0,1,0
14823,28,0,0,70,70,0,1,0,1,0
8780,28,0,0,68,68,0,1,0,1,0
12838,28,0,0,66,66,0,1,0,1,0
18462,28,0,0,70,70,0,1,0,1,0
14788,28,0,0,68,68,0,1,0,1,0
17121,28,0,0,70,70,0,1,0,1,0
16994,28,0,0,66,66,0,1,0,1,0
12698,28,0,0,70,70,0,1,0,1,0
10739,28,0,0,70,70,0,1,0,1,0
9667,28,0,0,70,70,0,1,0,1,0
11356,28,0,0,69,69,0,1,0,1,0
14587,28,0,0,70,70,0,1,0,1,0
19470,28,0,0,70,70,0,1,0,1,0
12831,28,0,0,70,70,0,1,0,1,0
11764,28,0,0,70,70,0,1,0,1,0
15274,28,0,0,70,70,0,1,0,1,0
9909,28,0,0,70,70,0,1,0,1,0
9158,28,0,0,70,70,0,1,0,1,0
10294,28,0,0,66,66,0,1,0,1,0
21450,28,0,0,68,68,0,1,0,1,0
16194,28,0,0,66,66,0,1,0,1,0
20637,28,0,0,70,70,0,1,0,1,0
17135,28,0,0,66,66,0,1,0,1,0
14100,28,0,0,70,70,0,1,0,1,0
16718,28,0,0,70,70,0,1,0,1,0
13787,28,0,0,70,70,0,1,0,1,0
13046,28,0,0,68,68,0,1,0,1,0
15773,28,0,0,67,67,0,1,0,1,0
13175,28,0,0,66,66,0,1,0,1,0
9957,28,0,0,70,70,0,1,0,1,0
22526,28,0,0,70,70,0,1,0,1,0
13806,28,0,0,70,70,0,1,0,1,0
17673,28,0,0,70,70,0,1,0,1,0
20797,28,0,0,66,66,0,1,0,1,0
19904,28,0,0,66,66,0,1,0,1,0
16876,28,0,0,70,70,0,1,0,1,0
9250,28,0,0,70,70,0,1,0,1,0
18803,28,0,0,70,70,0,1,0,1,0
17625,28,0,0,70,70,0,1,0,1,0
21379,28,0,0,68,68,0,1,0,1,0
20776,28,0,0,70,70,0,1,0,1,0
11719,28,0,0,70,70,0,1,0,1,0
14811,28,0,0,69,69,0,1,0,1,0
20019,28,0,0,70,70,0,1,0,1,0
20954,28,0,0,70,70,0,1,0,1,0
9328,28,0,0,70,70,0,1,0,1,0
9201,28,0,0,66,66,0,1,0,1,0
17182,28,0,0,66,66,0,1,0,1,0
13430,28,0,0,70,70,0,1,0,1,0
20903,28,0,0,70,70,0,1,0,1,0
20457,28,0,0,69,69,0,1,0,1,0
20596,28,0,0,66,66,0,1,0,1,0
14817,28,0,0,66,66,0,1,0,1,0
11839,28,0,0,70,70,0,1,0,1,0
12848,28,0,0,70,70,0,1,0,1,0
21012,28,0,0,66,66,0,1,0,1,0
11463,28,0,0,66,66,0,1,0,1,0
9777,28,0,0,70,70,0,1,0,1,0
9603,28,0,0,70,70,0,1,0,1,0
22282,28,0,0,70,70,0,1,0,1,0
14758,28,0,0,70,70,0,1,0,1,0
13851,28,0,0,70,70,0,1,0,1,0
22393,28,0,0,69,69,0,1,0,1,0
11245,28,0,0,66,66,0,1,0,1,0
20970,28,0,0,70,70,0,1,0,1,0
12588,28,0,0,70,70,0,1,0,1,0
19389,28,0,0,70,70,0,1,0,1,0
9686,28,0,0,66,66,0,1,0,1,0
18613,28,0,0,70,70,0,1,0,1,0
11870,28,0,0,67,67,0,1,0,1,0
11916,28,0,0,67,67,0,1,0,1,0
10589,28,0,0,70,70,0,1,0,1,0
9810,28,0,0,66,66,0,1,0,1,0
19780,28,0,0,70,70,0,1,0,1,0
10996,28,0,0,70,70,0,1,0,1,0
9293,28,0,0,70,70,0,1,0,1,0
16032,28,0,0,70,70,0,1,0,1,0
11766,28,0,0,70,70,0,1,0,1,0
9187,28,0,0,70,70,0,1,0,1,0
19958,28,0,0,67,67,0,1,0,1,0
16071,28,0,0,67,67,0,1,0,1,0
20764,28,0,0,70,70,0,1,0,1,0
13027,28,0,0,70,70,0,1,0,1,0
9798,28,0,0,66,66,0,1,0,1,0
9890,28,0,0,67,67,0,1,0,1,0
20162,28,0,0,70,70,0,1,0,1,0
22641,28,0,0,66,66,0,1,0,1,0
19102,28,0,0,70,70,0,1,0,1,0
17562,28,0,0,70,70,0,1,0,1,0
15409,28,0,0,70,70,0,1,0,1,0
18864,28,0,0,70,70,0,1,0,1,0
10500,28,0,0,66,66,0,1,0,1,0
8592,28,0,0,70,70,0,1,0,1,0
18841,28,0,0,70,70,0,1,0,1,0
13845,28,0,0,70,70,0,1,0,1,0
17391,28,0,0,66,66,0,1,0,1,0
11113,28,0,0,67,67,0,1,0,1,0
17905,28,0,0,66,66,0,1,0,1,0
14968,28,0,0,70,70,0,1,0,1,0
14618,28,0,0,70,70,0,1,0,1,0
10380,28,0,0,70,70,0,1,0,1,0
20339,28,0,0,66,66,0,1,0,1,0
21785,28,0,0,70,70,0,1,0,1,0
22533,28,0,0,66,66,0,1,0,1,0
19068,28,0,0,68,68,0,1,0,1,0
16362,28,0,0,68,68,0,1,0,1,0
20931,28,0,0,67,67,0,1,0,1,0
11804,28,0,0,70,70,0,1,0,1,0
15814,28,0,0,70,70,0,1,0,1,0
21262,28,0,0,70,70,0,1,0,1,0
15659,28,0,0,70,70,0,1,0,1,0
16075,28,0,0,68,68,0,1,0,1,0
9948,28,0,0,70,70,0,1,0,1,0
12879,28,0,0,70,70,0,1,0,1,0
15948,28,0,0,69,69,0,1,0,1,0
19190,28,0,0,67,67,0,1,0,1,0
9015,28,0,0,70,70,0,1,0,1,0
22112,28,0,0,70,70,0,1,0,1,0
9547,28,0,0,70,70,0,1,0,1,0
11639,28,0,0,70,70,0,1,0,1,0
9562,28,0,0,66,66,0,1,0,1,0
15840,28,0,0,70,70,0,1,0,1,0
14584,28,0,0,68,68,0,1,0,1,0
12852,28,0,0,70,70,0,1,0,1,0
17489,28,0,0,70,70,0,1,0,1,0
20228,28,0,0,69,69,0,1,0,1,0
22275,28,0,0,67,67,0,1,0,1,0
21599,28,0,0,70,70,0,1,0,1,0
21513,28,0,0,70,70,0,1,0,1,0
17356,28,0,0,70,70,0,1,0,1,0
15828,28,0,0,66,66,0,1,0,1,0
17273,28,0,0,70,70,0,1,0,1,0
10162,28,0,0,70,70,0,1,0,1,0
19464,28,0,0,70,70,0,1,0,1,0
15168,28,0,0,70,70,0,1,0,1,0
14369,28,0,0,70,70,0,1,0,1,0
21281,28,0,0,70,70,0,1,0,1,0
12422,28,0,0,66,66,0,1,0,1,0
10150,28,0,0,70,70,0,1,0,1,0
10869,28,0,0,70,70,0,1,0,1,0
21628,28,0,0,70,70,0,1,0,1,0
12944,28,0,0,70,70,0,1,0,1,0
21966,28,0,0,66,66,0,1,0,1,0
22586,28,0,0,66,66,0,1,0,1,0
16147,28,0,0,70,70,0,1,0,1,0
11583,28,0,0,70,70,0,1,0,1,0
14848,28,0,0,66,66,0,1,0,1,0
19981,28,0,0,70,70,0,1,0,1,0
22210,28,0,0,67,67,0,1,0,1,0
9152,28,0,0,70,70,0,1,0,1,0
22420,28,0,0,66,66,0,1,0,1,0
21942,28,0,0,67,67,0,1,0,1,0
14645,28,0,0,70,70,0,1,0,1,0
9256,28,0,0,66,66,0,1,0,1,0
16171,28,0,0,70,70,0,1,0,1,0
10744,28,0,0,70,70,0,1,0,1,0
20850,28,0,0,70,70,0,1,0,1,0
14106,28,0,0,66,66,0,1,0,1,0
10001,28,0,0,66,66,0,1,0,1,0
12567,28,0,0,70,70,0,1,0,1,0
13441,28,0,0,66,66,0,1,0,1,0
12669,28,0,0,66,66,0,1,0,1,0
15096,28,0,0,68,68,0,1,0,1,0
17551,28,0,0,66,66,0,1,0,1,0
16094,28,0,0,66,66,0,1,0,1,0
10995,28,0,0,70,70,0,1,0,1,0
10873,28,0,0,70,70,0,1,0,1,0
17217,28,0,0,70,70,0,1,0,1,0
9559,28,0,0,70,70,0,1,0,1,0
18202,28,0,0,70,70,0,1,0,1,0
20447,28,0,0,70,70,0,1,0,1,0
17445,28,0,0,66,66,0,1,0,1,0
21383,28,0,0,70,70,0,1,0,1,0
12131,28,0,0,67,67,0,1,0,1,0
8677,28,0,0,67,67,0,1,0,1,0
21104,28,0,0,70,70,0,1,0,1,0
13746,28,0,0,68,68,0,1,0,1,0
10481,28,0,0,68,68,0,1,0,1,0
15352,28,0,0,66,66,0,1,0,1,0
20677,28,0,0,70,70,0,1,0,1,0
17470,28,0,0,69,69,0,1,0,1,0
18405,28,0,0,70,70,0,1,0,1,0
14938,28,0,0,70,70,0,1,0,1,0
10136,28,0,0,70,70,0,1,0,1,0
9852,28,0,0,70,70,0,1,0,1,0
19811,28,0,0,70,70,0,1,0,1,0
12121,28,0,0,70,70,0,1,0,1,0
18697,28,0,0,70,70,0,1,0,1,0
9144,28,0,0,70,70,0,1,0,1,0
22520,28,0,0,70,70,0,1,0,1,0
14684,28,0,0,66,66,0,1,0,1,0
21966,28,0,0,70,70,0,1,0,1,0
12942,28,0,0,70,70,0,1,0,1,0
10587,28,0,0,70,70,0,1,0,1,0
18083,28,0,0,70,70,0,1,0,1,0
15432,28,0,0,70,70,0,1,0,1,0
9090,28,0,0,66,66,0,1,0,1,0
19943,28,0,0,69,69,0,1,0,1,0
20722,28,0,0,70,70,0,1,0,1,0
10541,28,0,0,70,70,0,1,0,1,0
9688,28,0,0,66,66,0,1,0,1,0
22520,28,0,0,67,67,0,1,0,1,0
19974,28,0,0,70,70,0,1,0,1,0
21134,28,0,0,66,66,0,1,0,1,0
22518,28,0,0,68,68,0,1,0,1,0
17878,28,0,0,67,67,0,1,0,1,0
13122,28,0,0,70,70,0,1,0,1,0
16163,28,0,0,68,68,0,1,0,1,0
14186,28,0,0,70,70,0,1,0,1,0
9989,28,0,0,66,66,0,1,0,1,0
14246,28,0,0,70,70,0,1,0,1,0
13762,28,0,0,70,70,0,1,0,1,0
14496,28,0,0,66,66,0,1,0,1,0
13805,28,0,0,66,66,0,1,0,1,0
17327,28,0,0,70,70,0,1,0,1,0
11147,28,0,0,70,70,0,1,0,1,0
10989,28,0,0,67,67,0,1,0,1,0
10709,28,0,0,70,70,0,1,0,1,0
16513,28,0,0,70,70,0,1,0,1,0
20226,28,0,0,70,70,0,1,0,1,0
15216,28,0,0,67,67,0,1,0,1,0
16654,28,0,0,66,66,0,1,0,1,0
14303,28,0,0,70,70,0,1,0,1,0
10163,28,0,0,66,66,0,1,0,1,0
15024,28,0,0,70,70,0,1,0,1,0
15760,28,0,0,68,68,0,1,0,1,0
22396,28,0,0,66,66,0,1,0,1,0
20496,28,0,0,70,70,0,1,0,1,0
20082,28,0,0,70,70,0,1,0,1,0
18695,28,0,0,70,70,0,1,0,1,0
17336,28,0,0,70,70,0,1,0,1,0
19667,28,0,0,66,66,0,1,0,1,0
10608,28,0,0,68,68,0,1,0,1,0
14312,28,0,0,70,70,0,1,0,1,0
8742,28,0,0,70,70,0,1,0,1,0
21071,28,0,0,66,66,0,1,0,1,0
12817,28,0,0,70,70,0,1,0,1,0
9801,28,0,0,70,70,0,1,0,1,0
20696,28,0,0,70,70,0,1,0,1,0
9074,28,0,0,67,67,0,1,0,1,0
20825,28,0,0,66,66,0,1,0,1,0
15922,28,0,0,70,70,0,1,0,1,0
22466,28,0,0,67,67,0,1,0,1,0
17880,28,0,0,70,70,0,1,0,1,0
14406,28,0,0,70,70,0,1,0,1,0
16029,28,0,0,66,66,0,1,0,1,0
9239,28,0,0,66,66,0,1,0,1,0
13979,28,0,0,70,70,0,1,0,1,0
13620,28,0,0,66,66,0,1,0,1,0
18647,28,0,0,70,70,0,1,0,1,0
17385,28,0,0,70,70,0,1,0,1,0
19426,28,0,0,66,66,0,1,0,1,0
13057,28,0,0,66,66,0,1,0,1,0
13062,28,0,0,66,66,0,1,0,1,0
20178,28,0,0,70,70,0,1,0,1,0
12342,28,0,0,66,66,0,1,0,1,0
18592,28,0,0,69,69,0,1,0,1,0
21482,28,0,0,70,70,0,1,0,1,0
12545,28,0,0,69,69,0,1,0,1,0
17551,28,0,0,70,70,0,1,0,1,0
15947,28,0,0,70,70,0,1,0,1,0
12997,28,0,0,70,70,0,1,0,1,0
17599,28,0,0,70,70,0,1,0,1,0
22336,28,0,0,68,68,0,1,0,1,0
22303,28,0,0,70,70,0,1,0,1,0
21264,28,0,0,70,70,0,1,0,1,0
15531,28,0,0,70,70,0,1,0,1,0
21677,28,0,0,70,70,0,1,0,1,0
15837,28,0,0,66,66,0,1,0,1,0
18437,28,0,0,70,70,0,1,0,1,0
20095,28,0,0,70,70,0,1,0,1,0
17240,28,0,0,70,70,0,1,0,1,0
13903,28,0,0,70,70,0,1,0,1,0
19710,28,0,0,66,66,0,1,0,1,0
18826,28,0,0,70,70,0,1,0,1,0
14365,28,0,0,66,66,0,1,0,1,0
20597,28,0,0,70,70,0,1,0,1,0
18226,28,0,0,70,70,0,1,0,1,0
13162,28,0,0,69,69,0,1,0,1,0
9722,28,0,0,68,68,0,1,0,1,0
19675,28,0,0,70,70,0,1,0,1,0
21782,28,0,0,66,66,0,1,0,1,0
12303,28,0,0,70,70,0,1,0,1,0
20620,28,0,0,66,66,0,1,0,1,0
13714,28,0,0,66,66,0,1,0,1,0
19637,28,0,0,66,66,0,1,0,1,0
10791,28,0,0,66,66,0,1,0,1,0
19763,28,0,0,68,68,0,1,0,1,0
10704,28,0,0,70,70,0,1,0,1,0
20885,28,0,0,70,70,0,1,0,1,0
12170,28,0,0,70,70,0,1,0,1,0
20067,28,0,0,66,66,0,1,0,1,0
15244,28,0,0,66,66,0,1,0,1,0
17190,28,0,0,66,66,0,1,0,1,0
11815,28,0,0,66,66,0,1,0,1,0
20701,28,0,0,70,70,0,1,0,1,0
11462,28,0,0,66,66,0,1,0,1,0
19255,28,0,0,70,70,0,1,0,1,0
14470,28,0,0,70,70,0,1,0,1,0
16393,28,0,0,66,66,0,1,0,1,0
12885,28,0,0,66,66,0,1,0,1,0
12991,28,0,0,70,70,0,1,0,1,0
15474,28,0,0,67,67,0,1,0,1,0
18777,28,0,0,66,66,0,1,0,1,0
14023,28,0,0,70,70,0,1,0,1,0
20335,28,0,0,70,70,0,1,0,1,0
9567,28,0,0,70,70,0,1,0,1,0
9960,28,0,0,70,70,0,1,0,1,0
13871,28,0,0,70,70,0,1,0,1,0
12789,28,0,0,66,66,0,1,0,1,0
15100,28,0,0,66,66,0,1,0,1,0
9128,28,0,0,70,70,0,1,0,1,0
11221,28,0,0,70,70,0,1,0,1,0
8489,28,0,0,70,70,0,1,0,1,0
20834,28,0,0,68,68,0,1,0,1,0
15843,28,0,0,66,66,0,1,0,1,0
21134,28,0,0,66,66,0,1,0,1,0
19453,28,0,0,66,66,0,1,0,1,0
9071,28,0,0,70,70,0,1,0,1,0
13140,28,0,0,70,70,0,1,0,1,0
14160,28,0,0,68,68,0,1,0,1,0
22721,28,0,0,66,66,0,1,0,1,0
15658,28,0,0,70,70,0,1,0,1,0
16815,28,0,0,70,70,0,1,0,1,0
18777,28,0,0,70,70,0,1,0,1,0
14150,28,0,0,70,70,0,1,0,1,0
16159,28,0,0,67,67,0,1,0,1,0
9775,28,0,0,69,69,0,1,0,1,0
19359,28,0,0,67,67,0,1,0,1,0
9181,28,0,0,70,70,0,1,0,1,0
11452,28,0,0,70,70,0,1,0,1,0
18006,28,0,0,66,66,0,1,0,1,0
14012,28,0,0,70,70,0,1,0,1,0
9756,28,0,0,70,70,0,1,0,1,0
12673,28,0,0,67,67,0,1,0,1,0
20742,28,0,0,66,66,0,1,0,1,0
19735,28,0,0,70,70,0,1,0,1,0
9939,28,0,0,68,68,0,1,0,1,0
10035,28,0,0,70,70,0,1,0,1,0
11641,28,0,0,70,70,0,1,0,1,0
18034,28,0,0,70,70,0,1,0,1,0
13617,28,0,0,66,66,0,1,0,1,0
17822,28,0,0,70,70,0,1,0,1,0
15230,28,0,0,67,67,0,1,0,1,0
16851,28,0,0,70,70,0,1,0,1,0
11884,28,0,0,67,67,0,1,0,1,0
9303,28,0,0,70,70,0,1,0,1,0
22586,28,0,0,68,68,0,1,0,1,0
11118,28,0,0,70,70,0,1,0,1,0
9247,28,0,0,70,70,0,1,0,1,0
18842,28,0,0,70,70,0,1,0,1,0
15185,28,0,0,70,70,0,1,0,1,0
19602,28,0,0,70,70,0,1,0,1,0
9467,28,0,0,70,70,0,1,0,1,0
17528,28,0,0,66,66,0,1,0,1,0
10139,28,0,0,66,66,0,1,0,1,0
9312,28,0,0,66,66,0,1,0,1,0
21307,28,0,0,70,70,0,1,0,1,0
19578,28,0,0,68,68,0,1,0,1,0
8659,28,0,0,70,70,0,1,0,1,0
16979,28,0,0,70,70,0,1,0,1,0
15756,28,0,0,70,70,0,1,0,1,0
11616,28,0,0,66,66,0,1,0,1,0
16768,28,0,0,70,70,0,1,0,1,0
12736,28,0,0,68,68,0,1,0,1,0
19923,28,0,0,70,70,0,1,0,1,0
14661,28,0,0,66,66,0,1,0,1,0
10135,28,0,0,70,70,0,1,0,1,0
12722,28,0,0,66,66,0,1,0,1,0
20809,28,0,0,70,70,0,1,0,1,0
14288,28,0,0,68,68,0,1,0,1,0
10403,28,0,0,70,70,0,1,0,1,0
9761,28,0,0,70,70,0,1,0,1,0
9043,28,0,0,70,70,0,1,0,1,0
11304,28,0,0,68,68,0,1,0,1,0
18697,28,0,0,70,70,0,1,0,1,0
16007,28,0,0,70,70,0,1,0,1,0
16044,28,0,0,67,67,0,1,0,1,0
16711,28,0,0,70,70,0,1,0,1,0
16681,28,0,0,67,67,0,1,0,1,0
18806,28,0,0,70,70,0,1,0,1,0
16226,28,0,0,70,70,0,1,0,1,0
9509,28,0,0,70,70,0,1,0,1,0
14668,28,0,0,68,68,0,1,0,1,0
16887,28,0,0,70,70,0,1,0,1,0
17387,28,0,0,70,70,0,1,0,1,0
9972,28,0,0,70,70,0,1,0,1,0
9542,28,0,0,70,70,0,1,0,1,0
15339,28,0,0,66,66,0,1,0,1,0
19943,28,0,0,70,70,0,1,0,1,0
16179,28,0,0,67,67,0,1,0,1,0
8920,28,0,0,70,70,0,1,0,1,0
16721,28,0,0,68,68,0,1,0,1,0
16859,28,0,0,66,66,0,1,0,1,0
22686,28,0,0,70,70,0,1,0,1,0
9673,28,0,0,70,70,0,1,0,1,0
10449,28,0,0,66,66,0,1,0,1,0
19434,28,0,0,70,70,0,1,0,1,0
19751,28,0,0,68,68,0,1,0,1,0
9300,28,0,0,70,70,0,1,0,1,0
10346,28,0,0,66,66,0,1,0,1,0
19464,28,0,0,70,70,0,1,0,1,0
14578,28,0,0,70,70,0,1,0,1,0
19826,28,0,0,70,70,0,1,0,1,0
15151,28,0,0,70,70,0,1,0,1,0
15018,28,0,0,70,70,0,1,0,1,0
9926,28,0,0,66,66,0,1,0,1,0
9291,28,0,0,70,70,0,1,0,1,0
10578,28,0,0,70,70,0,1,0,1,0
16537,28,0,0,70,70,0,1,0,1,0
21722,28,0,0,66,66,0,1,0,1,0
22057,28,0,0,70,70,0,1,0,1,0
17773,28,0,0,70,70,0,1,0,1,0
20365,28,0,0,70,70,0,1,0,1,0
10538,28,0,0,70,70,0,1,0,1,0
14098,28,0,0,70,70,0,1,0,1,0
20921,28,0,0,66,66,0,1,0,1,0
16334,28,0,0,70,70,0,1,0,1,0
12640,28,0,0,70,70,0,1,0,1,0
15338,28,0,0,70,70,0,1,0,1,0
14563,28,0,0,66,66,0,1,0,1,0
9081,28,0,0,70,70,0,1,0,1,0
20321,28,0,0,70,70,0,1,0,1,0
17942,28,0,0,70,70,0,1,0,1,0
14759,28,0,0,70,70,0,1,0,1,0
19781,28,0,0,67,67,0,1,0,1,0
17196,28,0,0,67,67,0,1,0,1,0
11170,28,0,0,70,70,0,1,0,1,0
19394,28,0,0,70,70,0,1,0,1,0
22649,28,0,0,70,70,0,1,0,1,0
14897,28,0,0,70,70,0,1,0,1,0
13666,28,0,0,70,70,0,1,0,1,0
8617,28,0,0,70,70,0,1,0,1,0
18415,28,0,0,70,70,0,1,0,1,0
15022,28,0,0,70,70,0,1,0,1,0
11230,28,0,0,66,66,0,1,0,1,0
19598,28,0,0,66,66,0,1,0,1,0
19900,28,0,0,70,70,0,1,0,1,0
13080,28,0,0,66,66,0,1,0,1,0
20529,28,0,0,66,66,0,1,0,1,0
12982,28,0,0,70,70,0,1,0,1,0
19801,28,0,0,70,70,0,1,0,1,0
18507,28,0,0,70,70,0,1,0,1,0
20260,28,0,0,66,66,0,1,0,1,0
17365,28,0,0,67,67,0,1,0,1,0
13536,28,0,0,70,70,0,1,0,1,0
16666,28,0,0,66,66,0,1,0,1,0
14343,28,0,0,70,70,0,1,0,1,0
10579,28,0,0,70,70,0,1,0,1,0
17073,28,0,0,70,70,0,1,0,1,0
10759,28,0,0,66,66,0,1,0,1,0
10396,28,0,0,66,66,0,1,0,1,0
16080,28,0,0,70,70,0,1,0,1,0
22362,28,0,0,70,70,0,1,0,1,0
15985,28,0,0,70,70,0,1,0,1,0
9509,28,0,0,70,70,0,1,0,1,0
19526,28,0,0,70,70,0,1,0,1,0
10691,28,0,0,70,70,0,1,0,1,0
22040,28,0,0,70,70,0,1,0,1,0
12063,28,0,0,66,66,0,1,0,1,0
21393,28,0,0,67,67,0,1,0,1,0
19556,28,0,0,67,67,0,1,0,1,0
20050,28,0,0,70,70,0,1,0,1,0
17839,28,0,0,67,67,0,1,0,1,0
9622,28,0,0,70,70,0,1,0,1,0
10910,28,0,0,70,70,0,1,0,1,0
11984,28,0,0,66,66,0,1,0,1,0
15511,28,0,0,70,70,0,1,0,1,0
22288,28,0,0,70,70,0,1,0,1,0
16425,28,0,0,70,70,0,1,0,1,0
14287,28,0,0,70,70,0,1,0,1,0
9556,28,0,0,66,66,0,1,0,1,0
13819,28,0,0,70,70,0,1,0,1,0
14315,28,0,0,70,70,0,1,0,1,0
12693,28,0,0,70,70,0,1,0,1,0
14001,28,0,0,70,70,0,1,0,1,0
12815,28,0,0,70,70,0,1,0,1,0
14079,28,0,0,70,70,0,1,0,1,0
10990,28,0,0,66,66,0,1,0,1,0
9974,28,0,0,70,70,0,1,0,1,0
13013,28,0,0,67,67,0,1,0,1,0
14725,28,0,0,70,70,0,1,0,1,0
20461,28,0,0,70,70,0,1,0,1,0
9431,28,0,0,70,70,0,1,0,1,0
21308,28,0,0,68,68,0,1,0,1,0
19498,28,0,0,66,66,0,1,0,1,0
17810,28,0,0,68,68,0,1,0,1,0
10518,28,0,0,70,70,0,1,0,1,0
14787,28,0,0,68,68,0,1,0,1,0
18257,28,0,0,66,66,0,1,0,1,0
9279,28,0,0,70,70,0,1,0,1,0
17186,28,0,0,70,70,0,1,0,1,0
16026,28,0,0,66,66,0,1,0,1,0
18230,28,0,0,70,70,0,1,0,1,0
18950,28,0,0,66,66,0,1,0,1,0
9548,28,0,0,70,70,0,1,0,1,0
11119,28,0,0,66,66,0,1,0,1,0
12649,28,0,0,66,66,0,1,0,1,0
18760,28,0,0,66,66,0,1,0,1,0
11472,28,0,0,70,70,0,1,0,1,0
9688,28,0,0,70,70,0,1,0,1,0
14421,28,0,0,70,70,0,1,0,1,0
10552,28,0,0,66,66,0,1,0,1,0
18607,28,0,0,69,69,0,1,0,1,0
16083,28,0,0,67,67,0,1,0,1,0
12189,28,0,0,70,70,0,1,0,1,0
14285,28,0,0,70,70,0,1,0,1,0
20463,28,0,0,70,70,0,1,0,1,0
13778,28,0,0,70,70,0,1,0,1,0
12707,28,0,0,68,68,0,1,0,1,0
9467,28,0,0,70,70,0,1,0,1,0
21522,28,0,0,70,70,0,1,0,1,0
13435,28,0,0,66,66,0,1,0,1,0
11993,28,0,0,70,70,0,1,0,1,0
9997,28,0,0,66,66,0,1,0,1,0
18348,28,0,0,70,70,0,1,0,1,0
14723,28,0,0,70,70,0,1,0,1,0
16750,28,0,0,70,70,0,1,0,1,0
16768,28,0,0,70,70,0,1,0,1,0
19710,28,0,0,70,70,0,1,0,1,0
11113,28,0,0,69,69,0,1,0,1,0
20739,28,0,0,66,66,0,1,0,1,0
15309,28,0,0,70,70,0,1,0,1,0
20336,28,0,0,70,70,0,1,0,1,0
17322,28,0,0,70,70,0,1,0,1,0
22674,28,0,0,70,70,0,1,0,1,0
9396,28,0,0,70,70,0,1,0,1,0
9507,28,0,0,70,70,0,1,0,1,0
15679,28,0,0,68,68,0,1,0,1,0
8538,28,0,0,70,70,0,1,0,1,0
22586,28,0,0,70,70,0,1,0,1,0
19126,28,0,0,70,70,0,1,0,1,0
21869,28,0,0,70,70,0,1,0,1,0
16443,28,0,0,66,66,0,1,0,1,0
13838,28,0,0,66,66,0,1,0,1,0
22276,28,0,0,70,70,0,1,0,1,0
12321,28,0,0,70,70,0,1,0,1,0
21457,28,0,0,68,68,0,1,0,1,0
12632,28,0,0,68,68,0,1,0,1,0
10158,28,0,0,66,66,0,1,0,1,0
14287,28,0,0,70,70,0,1,0,1,0
9420,28,0,0,70,70,0,1,0,1,0
21312,28,0,0,66,66,0,1,0,1,0
13033,28,0,0,70,70,0,1,0,1,0
13611,28,0,0,68,68,0,1,0,1,0
19740,28,0,0,66,66,0,1,0,1,0
15284,28,0,0,66,66,0,1,0,1,0
9750,28,0,0,70,70,0,1,0,1,0
8733,28,0,0,66,66,0,1,0,1,0
10965,28,0,0,70,70,0,1,0,1,0
15567,28,0,0,68,68,0,1,0,1,0
18308,28,0,0,66,66,0,1,0,1,0
9999,28,0,0,66,66,0,1,0,1,0
14175,28,0,0,70,70,0,1,0,1,0
19118,28,0,0,70,70,0,1,0,1,0
18697,28,0,0,70,70,0,1,0,1,0
19335,28,0,0,70,70,0,1,0,1,0
12882,28,0,0,70,70,0,1,0,1,0
22163,28,0,0,70,70,0,1,0,1,0
16510,28,0,0,66,66,0,1,0,1,0
15657,28,0,0,70,70,0,1,0,1,0
15531,28,0,0,70,70,0,1,0,1,0
21934,28,0,0,66,66,0,1,0,1,0
9195,28,0,0,70,70,0,1,0,1,0
14277,28,0,0,70,70,0,1,0,1,0
14116,28,0,0,66,66,0,1,0,1,0
18019,28,0,0,66,66,0,1,0,1,0
20038,28,0,0,70,70,0,1,0,1,0
18761,28,0,0,70,70,0,1,0,1,0
9751,28,0,0,70,70,0,1,0,1,0
21049,28,0,0,68,68,0,1,0,1,0
22026,28,0,0,70,70,0,1,0,1,0
11565,28,0,0,66,66,0,1,0,1,0
14273,28,0,0,70,70,0,1,0,1,0
16857,28,0,0,70,70,0,1,0,1,0
13566,28,0,0,66,66,0,1,0,1,0
20500,28,0,0,69,69,0,1,0,1,0
19876,28,0,0,66,66,0,1,0,1,0
8558,28,0,0,66,66,0,1,0,1,0
12054,28,0,0,70,70,0,1,0,1,0
17764,28,0,0,66,66,0,1,0,1,0
9749,28,0,0,66,66,0,1,0,1,0
19862,28,0,0,68,68,0,1,0,1,0
10702,28,0,0,70,70,0,1,0,1,0
9071,28,0,0,70,70,0,1,0,1,0
11649,28,0,0,67,67,0,1,0,1,0
15930,28,0,0,70,70,0,1,0,1,0
17776,28,0,0,70,70,0,1,0,1,0
22233,28,0,0,67,67,0,1,0,1,0
11617,28,0,0,69,69,0,1,0,1,0
14219,28,0,0,70,70,0,1,0,1,0
19047,28,0,0,70,70,0,1,0,1,0
20848,28,0,0,70,70,0,1,0,1,0
14647,28,0,0,66,66,0,1,0,1,0
17545,28,0,0,66,66,0,1,0,1,0
8374,28,0,0,70,70,0,1,0,1,0
17098,28,0,0,70,70,0,1,0,1,0
17469,28,0,0,70,70,0,1,0,1,0
20081,28,0,0,70,70,0,1,0,1,0
12287,28,0,0,70,70,0,1,0,1,0
9416,28,0,0,70,70,0,1,0,1,0
12704,28,0,0,70,70,0,1,0,1,0
22587,28,0,0,69,69,0,1,0,1,0
19442,28,0,0,70,70,0,1,0,1,0
12555,28,0,0,70,70,0,1,0,1,0
20856,28,0,0,70,70,0,1,0,1,0
12215,28,0,0,70,70,0,1,0,1,0
19709,28,0,0,70,70,0,1,0,1,0
11485,28,0,0,70,70,0,1,0,1,0
18680,28,0,0,69,69,0,1,0,1,0
18605,28,0,0,70,70,0,1,0,1,0
10744,28,0,0,68,68,0,1,0,1,0
14280,28,0,0,70,70,0,1,0,1,0
21642,28,0,0,67,67,0,1,0,1,0
13084,28,0,0,70,70,0,1,0,1,0
10140,28,0,0,69,69,0,1,0,1,0
17390,28,0,0,68,68,0,1,0,1,0
8850,28,0,0,68,68,0,1,0,1,0
15075,28,0,0,67,67,0,1,0,1,0
12312,28,0,0,70,70,0,1,0,1,0
9484,28,0,0,66,66,0,1,0,1,0
9668,28,0,0,70,70,0,1,0,1,0
17628,28,0,0,70,70,0,1,0,1,0
20998,28,0,0,70,70,0,1,0,1,0
17521,28,0,0,70,70,0,1,0,1,0
10061,28,0,0,66,66,0,1,0,1,0
11069,28,0,0,66,66,0,1,0,1,0
14178,28,0,0,66,66,0,1,0,1,0
19224,28,0,0,68,68,0,1,0,1,0
13478,28,0,0,70,70,0,1,0,1,0
15517,28,0,0,70,70,0,1,0,1,0
9997,28,0,0,66,66,0,1,0,1,0
9321,28,0,0,70,70,0,1,0,1,0
16942,28,0,0,66,66,0,1,0,1,0
11120,28,0,0,66,66,0,1,0,1,0
17158,28,0,0,70,70,0,1,0,1,0
22666,28,0,0,69,69,0,1,0,1,0
12643,28,0,0,66,66,0,1,0,1,0
17583,28,0,0,66,66,0,1,0,1,0
11601,28,0,0,70,70,0,1,0,1,0
10498,28,0,0,66,66,0,1,0,1,0
21825,28,0,0,70,70,0,1,0,1,0
16100,28,0,0,70,70,0,1,0,1,0
9357,28,0,0,67,67,0,1,0,1,0
21206,28,0,0,70,70,0,1,0,1,0
20125,28,0,0,70,70,0,1,0,1,0
9774,28,0,0,66,66,0,1,0,1,0
21434,28,0,0,66,66,0,1,0,1,0
12066,28,0,0,66,66,0,1,0,1,0
16313,28,0,0,70,70,0,1,0,1,0
13814,28,0,0,70,70,0,1,0,1,0
22116,28,0,0,70,70,0,1,0,1,0
20823,28,0,0,70,70,0,1,0,1,0
9522,28,0,0,70,70,0,1,0,1,0
11248,28,0,0,66,66,0,1,0,1,0
12513,28,0,0,70,70,0,1,0,1,0
19059,28,0,0,70,70,0,1,0,1,0
9006,28,0,0,66,66,0,1,0,1,0
10864,28,0,0,67,67,0,1,0,1,0
14549,28,0,0,66,66,0,1,0,1,0
17858,28,0,0,70,70,0,1,0,1,0
21201,28,0,0,67,67,0,1,0,1,0
17358,28,0,0,66,66,0,1,0,1,0
17189,28,0,0,70,70,0,1,0,1,0
17672,28,0,0,70,70,0,1,0,1,0
16647,28,0,0,70,70,0,1,0,1,0
14723,28,0,0,66,66,0,1,0,1,0
10329,28,0,0,70,70,0,1,0,1,0
15390,28,0,0,69,69,0,1,0,1,0
14711,28,0,0,66,66,0,1,0,1,0
20524,28,0,0,67,67,0,1,0,1,0
14220,28,0,0,70,70,0,1,0,1,0
13943,28,0,0,70,70,0,1,0,1,0
12497,28,0,0,70,70,0,1,0,1,0
12390,28,0,0,67,67,0,1,0,1,0
20173,28,0,0,70,70,0,1,0,1,0
17677,28,0,0,70,70,0,1,0,1,0
21071,28,0,0,68,68,0,1,0,1,0
9085,28,0,0,70,70,0,1,0,1,0
16973,28,0,0,70,70,0,1,0,1,0
9482,28,0,0,66,66,0,1,0,1,0
20472,28,0,0,66,66,0,1,0,1,0
14563,28,0,0,70,70,0,1,0,1,0
10670,28,0,0,69,69,0,1,0,1,0
16269,28,0,0,70,70,0,1,0,1,0
19551,28,0,0,68,68,0,1,0,1,0
18884,28,0,0,70,70,0,1,0,1,0
13251,28,0,0,70,70,0,1,0,1,0
12396,28,0,0,66,66,0,1,0,1,0
10574,28,0,0,67,67,0,1,0,1,0
11994,28,0,0,70,70,0,1,0,1,0
21497,28,0,0,68,68,0,1,0,1,0
9449,28,0,0,70,70,0,1,0,1,0
13420,28,0,0,70,70,0,1,0,1,0
17460,28,0,0,70,70,0,1,0,1,0
21189,28,0,0,66,66,0,1,0,1,0
8662,28,0,0,70,70,0,1,0,1,0
14237,28,0,0,66,66,0,1,0,1,0
12904,28,0,0,66,66,0,1,0,1,0
10602,28,0,0,70,70,0,1,0,1,0
19826,28,0,0,68,68,0,1,0,1,0
16757,28,0,0,70,70,0,1,0,1,0
20128,28,0,0,70,70,0,1,0,1,0
16753,28,0,0,66,66,0,1,0,1,0
13314,28,0,0,70,70,0,1,0,1,0
11983,28,0,0,67,67,0,1,0,1,0
10540,28,0,0,70,70,0,1,0,1,0
20997,28,0,0,70,70,0,1,0,1,0
16083,28,0,0,68,68,0,1,0,1,0
12285,28,0,0,70,70,0,1,0,1,0
15805,28,0,0,68,68,0,1,0,1,0
14676,28,0,0,70,70,0,1,0,1,0
20654,28,0,0,66,66,0,1,0,1,0
19478,28,0,0,69,69,0,1,0,1,0
14371,28,0,0,66,66,0,1,0,1,0
15370,28,0,0,68,68,0,1,0,1,0
9410,28,0,0,70,70,0,1,0,1,0
18378,28,0,0,70,70,0,1,0,1,0
10623,28,0,0,70,70,0,1,0,1,0
10452,28,0,0,70,70,0,1,0,1,0
20950,28,0,0,70,70,0,1,0,1,0
14337,28,0,0,70,70,0,1,0,1,0
21557,28,0,0,70,70,0,1,0,1,0
22702,28,0,0,70,70,0,1,0,1,0
11173,28,0,0,70,70,0,1,0,1,0
8927,28,0,0,66,66,0,1,0,1,0
20557,28,0,0,68,68,0,1,0,1,0
17920,28,0,0,70,70,0,1,0,1,0
19335,28,0,0,70,70,0,1,0,1,0
21433,28,0,0,66,66,0,1,0,1,0
19242,28,0,0,66,66,0,1,0,1,0
16792,28,0,0,70,70,0,1,0,1,0
12793,28,0,0,68,68,0,1,0,1,0
8621,28,0,0,66,66,0,1,0,1,0
21490,28,0,0,70,70,0,1,0,1,0
20328,28,0,0,70,70,0,1,0,1,0
21975,28,0,0,66,66,0,1,0,1,0
12659,28,0,0,70,70,0,1,0,1,0
13167,28,0,0,70,70,0,1,0,1,0
12199,28,0,0,66,66,0,1,0,1,0
12777,28,0,0,66,66,0,1,0,1,0
20135,28,0,0,70,70,0,1,0,1,0
12209,28,0,0,70,70,0,1,0,1,0
12370,28,0,0,70,70,0,1,0,1,0
16667,28,0,0,70,70,0,1,0,1,0
9508,28,0,0,66,66,0,1,0,1,0
19340,28,0,0,68,68,0,1,0,1,0
20653,28,0,0,70,70,0,1,0,1,0
9344,28,0,0,70,70,0,1,0,1,0
20413,28,0,0,70,70,0,1,0,1,0
16811,28,0,0,66,66,0,1,0,1,0
18317,28,0,0,70,70,0,1,0,1,0
18841,28,0,0,70,70,0,1,0,1,0
17229,28,0,0,70,70,0,1,0,1,0
21121,28,0,0,66,66,0,1,0,1,0
9982,28,0,0,70,70,0,1,0,1,0
19482,28,0,0,66,66,0,1,0,1,0
18617,28,0,0,69,69,0,1,0,1,0
12708,28,0,0,70,70,0,1,0,1,0
16758,28,0,0,69,69,0,1,0,1,0
20450,28,0,0,70,70,0,1,0,1,0
15131,28,0,0,70,70,0,1,0,1,0
21245,28,0,0,67,67,0,1,0,1,0
14248,28,0,0,70,70,0,1,0,1,0
19569,28,0,0,68,68,0,1,0,1,0
17407,28,0,0,70,70,0,1,0,1,0
10735,28,0,0,66,66,0,1,0,1,0
18888,28,0,0,70,70,0,1,0,1,0
9186,28,0,0,70,70,0,1,0,1,0
16012,28,0,0,67,67,0,1,0,1,0
20635,28,0,0,66,66,0,1,0,1,0
17709,28,0,0,66,66,0,1,0,1,0
12598,28,0,0,70,70,0,1,0,1,0
9567,28,0,0,70,70,0,1,0,1,0
11546,28,0,0,69,69,0,1,0,1,0
16356,28,0,0,70,70,0,1,0,1,0
12057,28,0,0,66,66,0,1,0,1,0
17429,28,0,0,68,68,0,1,0,1,0
11430,28,0,0,67,67,0,1,0,1,0
19459,28,0,0,66,66,0,1,0,1,0
16426,28,0,0,70,70,0,1,0,1,0
21786,28,0,0,70,70,0,1,0,1,0
14404,28,0,0,70,70,0,1,0,1,0
17458,28,0,0,66,66,0,1,0,1,0
11390,28,0,0,70,70,0,1,0,1,0
11406,28,0,0,66,66,0,1,0,1,0
21935,28,0,0,70,70,0,1,0,1,0
20255,28,0,0,67,67,0,1,0,1,0
16902,28,0,0,66,66,0,1,0,1,0
12456,28,0,0,70,70,0,1,0,1,0
12987,28,0,0,70,70,0,1,0,1,0
8729,28,0,0,70,70,0,1,0,1,0
20301,28,0,0,70,70,0,1,0,1,0
16090,28,0,0,66,66,0,1,0,1,0
8470,28,0,0,70,70,0,1,0,1,0
20956,28,0,0,67,67,0,1,0,1,0
18254,28,0,0,68,68,0,1,0,1,0
9266,28,0,0,70,70,0,1,0,1,0
11699,28,0,0,70,70,0,1,0,1,0
16802,28,0,0,70,70,0,1,0,1,0
10072,28,0,0,70,70,0,1,0,1,0
19143,28,0,0,70,70,0,1,0,1,0
20146,28,0,0,70,70,0,1,0,1,0
14078,28,0,0,70,70,0,1,0,1,0
10989,28,0,0,69,69,0,1,0,1,0
11793,28,0,0,70,70,0,1,0,1,0
13140,28,0,0,70,70,0,1,0,1,0
18172,28,0,0,70,70,0,1,0,1,0
21146,28,0,0,66,66,0,1,0,1,0
16512,28,0,0,66,66,0,1,0,1,0
13255,28,0,0,70,70,0,1,0,1,0
19833,28,0,0,66,66,0,1,0,1,0
10212,28,0,0,69,69,0,1,0,1,0
19310,28,0,0,66,66,0,1,0,1,0
9420,28,0,0,70,70,0,1,0,1,0
17084,28,0,0,70,70,0,1,0,1,0
11211,28,0,0,70,70,0,1,0,1,0
14232,28,0,0,66,66,0,1,0,1,0
9668,28,0,0,70,70,0,1,0,1,0
9650,28,0,0,68,68,0,1,0,1,0
18742,28,0,0,70,70,0,1,0,1,0
10459,28,0,0,69,69,0,1,0,1,0
14092,28,0,0,70,70,0,1,0,1,0
8472,28,0,0,70,70,0,1,0,1,0
20383,28,0,0,70,70,0,1,0,1,0
8924,28,0,0,70,70,0,1,0,1,0
8674,28,0,0,66,66,0,1,0,1,0
16890,28,0,0,70,70,0,1,0,1,0
14403,28,0,0,70,70,0,1,0,1,0
12645,28,0,0,66,66,0,1,0,1,0
12001,28,0,0,66,66,0,1,0,1,0
21447,28,0,0,70,70,0,1,0,1,0
18525,28,0,0,66,66,0,1,0,1,0
16931,28,0,0,66,66,0,1,0,1,0
11039,28,0,0,70,70,0,1,0,1,0
21737,28,0,0,69,69,0,1,0,1,0
20760,28,0,0,70,70,0,1,0,1,0
18800,28,0,0,70,70,0,1,0,1,0
11389,28,0,0,70,70,0,1,0,1,0
18571,28,0,0,68,68,0,1,0,1,0
19724,28,0,0,66,66,0,1,0,1,0
14628,28,0,0,69,69,0,1,0,1,0
20318,28,0,0,70,70,0,1,0,1,0
21553,28,0,0,66,66,0,1,0,1,0
11335,28,0,0,70,70,0,1,0,1,0
22717,28,0,0,70,70,0,1,0,1,0
20116,28,0,0,66,66,0,1,0,1,0
9897,28,0,0,70,70,0,1,0,1,0
9247,28,0,0,70,70,0,1,0,1,0
9501,28,0,0,70,70,0,1,0,1,0
17405,28,0,0,70,70,0,1,0,1,0
22039,28,0,0,70,70,0,1,0,1,0
10856,28,0,0,66,66,0,1,0,1,0
18470,28,0,0,67,67,0,1,0,1,0
19375,28,0,0,70,70,0,1,0,1,0
12706,28,0,0,67,67,0,1,0,1,0
17972,28,0,0,68,68,0,1,0,1,0
21021,28,0,0,66,66,0,1,0,1,0
13137,28,0,0,70,70,0,1,0,1,0
14846,28,0,0,66,66,0,1,0,1,0
9653,28,0,0,69,69,0,1,0,1,0
12130,28,0,0,66,66,0,1,0,1,0
17251,28,0,0,66,66,0,1,0,1,0
11650,28,0,0,70,70,0,1,0,1,0
21738,28,0,0,69,69,0,1,0,1,0
14268,28,0,0,70,70,0,1,0,1,0
18666,28,0,0,66,66,0,1,0,1,0
18485,28,0,0,70,70,0,1,0,1,0
8548,28,0,0,66,66,0,1,0,1,0
19975,28,0,0,70,70,0,1,0,1,0
14199,28,0,0,70,70,0,1,0,1,0
13535,28,0,0,66,66,0,1,0,1,0
19180,28,0,0,70,70,0,1,0,1,0
22100,28,0,0,66,66,0,1,0,1,0
21936,28,0,0,70,70,0,1,0,1,0
19276,28,0,0,70,70,0,1,0,1,0
20496,28,0,0,70,70,0,1,0,1,0
8975,28,0,0,70,70,0,1,0,1,0
16855,28,0,0,70,70,0,1,0,1,0
14371,28,0,0,66,66,0,1,0,1,0
11395,28,0,0,66,66,0,1,0,1,0
18058,28,0,0,69,69,0,1,0,1,0
15538,28,0,0,70,70,0,1,0,1,0
12079,28,0,0,70,70,0,1,0,1,0
17727,28,0,0,66,66,0,1,0,1,0
14065,28,0,0,70,70,0,1,0,1,0
20845,28,0,0,67,67,0,1,0,1,0
21097,28,0,0,68,68,0,1,0,1,0
21375,28,0,0,70,70,0,1,0,1,0
18191,28,0,0,69,69,0,1,0,1,0
9905,28,0,0,70,70,0,1,0,1,0
17563,28,0,0,68,68,0,1,0,1,0
12894,28,0,0,66,66,0,1,0,1,0
10217,28,0,0,70,70,0,1,0,1,0
14429,28,0,0,69,69,0,1,0,1,0
18252,28,0,0,70,70,0,1,0,1,0
17921,28,0,0,70,70,0,1,0,1,0
19178,28,0,0,67,67,0,1,0,1,0
12329,28,0,0,66,66,0,1,0,1,0
16594,28,0,0,68,68,0,1,0,1,0
18438,28,0,0,70,70,0,1,0,1,0
13175,28,0,0,69,69,0,1,0,1,0
22427,28,0,0,70,70,0,1,0,1,0
18883,28,0,0,70,70,0,1,0,1,0
18604,28,0,0,69,69,0,1,0,1,0
17729,28,0,0,66,66,0,1,0,1,0
15814,28,0,0,67,67,0,1,0,1,0
8566,28,0,0,67,67,0,1,0,1,0
19883,28,0,0,70,70,0,1,0,1,0
18409,28,0,0,70,70,0,1,0,1,0
10575,28,0,0,70,70,0,1,0,1,0
12942,28,0,0,70,70,0,1,0,1,0
10314,28,0,0,68,68,0,1,0,1,0
18347,28,0,0,70,70,0,1,0,1,0
10593,28,0,0,70,70,0,1,0,1,0
9509,28,0,0,66,66,0,1,0,1,0
8809,28,0,0,70,70,0,1,0,1,0
8612,28,0,0,70,70,0,1,0,1,0
10765,28,0,0,70,70,0,1,0,1,0
10139,28,0,0,70,70,0,1,0,1,0
16335,28,0,0,70,70,0,1,0,1,0
22012,28,0,0,66,66,0,1,0,1,0
22075,28,0,0,67,67,0,1,0,1,0
8586,28,0,0,70,70,0,1,0,1,0
13638,28,0,0,66,66,0,1,0,1,0
8758,28,0,0,68,68,0,1,0,1,0
13376,28,0,0,66,66,0,1,0,1,0
13542,28,0,0,70,70,0,1,0,1,0
15272,28,0,0,70,70,0,1,0,1,0
19298,28,0,0,70,70,0,1,0,1,0
16258,28,0,0,70,70,0,1,0,1,0
8998,28,0,0,70,70,0,1,0,1,0
9317,28,0,0,70,70,0,1,0,1,0
15718,28,0,0,70,70,0,1,0,1,0
16806,28,0,0,66,66,0,1,0,1,0
20675,28,0,0,70,70,0,1,0,1,0
17721,28,0,0,70,70,0,1,0,1,0
20888,28,0,0,70,70,0,1,0,1,0
19052,28,0,0,66,66,0,1,0,1,0
14043,28,0,0,70,70,0,1,0,1,0
22704,28,0,0,70,70,0,1,0,1,0
9619,28,0,0,70,70,0,1,0,1,0
18193,28,0,0,70,70,0,1,0,1,0
17672,28,0,0,70,70,0,1,0,1,0
12242,28,0,0,66,66,0,1,0,1,0
19164,28,0,0,70,70,0,1,0,1,0
13137,28,0,0,70,70,0,1,0,1,0
8468,28,0,0,70,70,0,1,0,1,0
18712,28,0,0,70,70,0,1,0,1,0
15278,28,0,0,70,70,0,1,0,1,0
21549,28,0,0,66,66,0,1,0,1,0
10223,28,0,0,66,66,0,1,0,1,0
20571,28,0,0,70,70,0,1,0,1,0
16815,28,0,0,70,70,0,1,0,1,0
18318,28,0,0,68,68,0,1,0,1,0
13058,28,0,0,66,66,0,1,0,1,0
17725,28,0,0,70,70,0,1,0,1,0
9170,28,0,0,70,70,0,1,0,1,0
14167,28,0,0,70,70,0,1,0,1,0
15985,28,0,0,68,68,0,1,0,1,0
19871,28,0,0,70,70,0,1,0,1,0
12845,28,0,0,66,66,0,1,0,1,0
10394,28,0,0,66,66,0,1,0,1,0
12482,28,0,0,66,66,0,1,0,1,0
9279,28,0,0,70,70,0,1,0,1,0
14479,28,0,0,66,66,0,1,0,1,0
17889,28,0,0,66,66,0,1,0,1,0
22268,28,0,0,70,70,0,1,0,1,0
14311,28,0,0,70,70,0,1,0,1,0
21638,28,0,0,70,70,0,1,0,1,0
12269,28,0,0,70,70,0,1,0,1,0
14922,28,0,0,70,70,0,1,0,1,0
17826,28,0,0,70,70,0,1,0,1,0
13857,28,0,0,66,66,0,1,0,1,0
10184,28,0,0,69,69,0,1,0,1,0
12726,28,0,0,70,70,0,1,0,1,0
22223,28,0,0,68,68,0,1,0,1,0
9438,28,0,0,70,70,0,1,0,1,0
17454,28,0,0,66,66,0,1,0,1,0
19239,28,0,0,66,66,0,1,0,1,0
16404,28,0,0,66,66,0,1,0,1,0
10666,28,0,0,68,68,0,1,0,1,0
17648,28,0,0,66,66,0,1,0,1,0
19986,28,0,0,70,70,0,1,0,1,0
22034,28,0,0,68,68,0,1,0,1,0
17247,28,0,0,69,69,0,1,0,1,0
17514,28,0,0,70,70,0,1,0,1,0
20161,28,0,0,70,70,0,1,0,1,0
16901,28,0,0,69,69,0,1,0,1,0
19681,28,0,0,70,70,0,1,0,1,0
20243,28,0,0,70,70,0,1,0,1,0
9171,28,0,0,70,70,0,1,0,1,0
9912,28,0,0,70,70,0,1,0,1,0
12695,28,0,0,70,70,0,1,0,1,0
20955,28,0,0,70,70,0,1,0,1,0
9687,28,0,0,66,66,0,1,0,1,0
11768,28,0,0,70,70,0,1,0,1,0
9567,28,0,0,70,70,0,1,0,1,0
13869,28,0,0,70,70,0,1,0,1,0
11881,28,0,0,70,70,0,1,0,1,0
22287,28,0,0,70,70,0,1,0,1,0
16424,28,0,0,70,70,0,1,0,1,0
19178,28,0,0,67,67,0,1,0,1,0
19838,28,0,0,66,66,0,1,0,1,0
17940,28,0,0,70,70,0,1,0,1,0
13328,28,0,0,66,66,0,1,0,1,0
9612,28,0,0,66,66,0,1,0,1,0
21188,28,0,0,66,66,0,1,0,1,0
15152,28,0,0,66,66,0,1,0,1,0
14023,28,0,0,70,70,0,1,0,1,0
17214,28,0,0,70,70,0,1,0,1,0
12741,28,0,0,70,70,0,1,0,1,0
11970,28,0,0,70,70,0,1,0,1,0
13879,28,0,0,70,70,0,1,0,1,0
18645,28,0,0,70,70,0,1,0,1,0
16202,28,0,0,70,70,0,1,0,1,0
10173,28,0,0,66,66,0,1,0,1,0
13793,28,0,0,70,70,0,1,0,1,0
11325,28,0,0,70,70,0,1,0,1,0
20163,28,0,0,70,70,0,1,0,1,0
19708,28,0,0,66,66,0,1,0,1,0
8433,28,0,0,69,69,0,1,0,1,0
16756,28,0,0,67,67,0,1,0,1,0
20832,28,0,0,69,69,0,1,0,1,0
13972,28,0,0,70,70,0,1,0,1,0
15088,28,0,0,67,67,0,1,0,1,0
17765,28,0,0,67,67,0,1,0,1,0
18378,28,0,0,70,70,0,1,0,1,0
14123,28,0,0,70,70,0,1,0,1,0
9465,28,0,0,70,70,0,1,0,1,0
19130,28,0,0,70,70,0,1,0,1,0
14039,28,0,0,70,70,0,1,0,1,0
14279,28,0,0,70,70,0,1,0,1,0
21785,28,0,0,70,70,0,1,0,1,0
15229,28,0,0,70,70,0,1,0,1,0
11014,28,0,0,70,70,0,1,0,1,0
18117,28,0,0,70,70,0,1,0,1,0
13178,28,0,0,70,70,0,1,0,1,0
12219,28,0,0,70,70,0,1,0,1,0
17328,28,0,0,68,68,0,1,0,1,0
21506,28,0,0,68,68,0,1,0,1,0
18843,28,0,0,70,70,0,1,0,1,0
9569,28,0,0,70,70,0,1,0,1,0
15823,28,0,0,66,66,0,1,0,1,0
8944,28,0,0,66,66,0,1,0,1,0
15464,28,0,0,69,69,0,1,0,1,0
18636,28,0,0,70,70,0,1,0,1,0
11581,28,0,0,70,70,0,1,0,1,0
13025,28,0,0,69,69,0,1,0,1,0
13804,28,0,0,70,70,0,1,0,1,0
11572,28,0,0,70,70,0,1,0,1,0
16402,28,0,0,66,66,0,1,0,1,0
19021,28,0,0,70,70,0,1,0,1,0
19662,28,0,0,70,70,0,1,0,1,0
11145,28,0,0,70,70,0,1,0,1,0
14325,28,0,0,70,70,0,1,0,1,0
11826,28,0,0,66,66,0,1,0,1,0
16836,28,0,0,70,70,0,1,0,1,0
9686,28,0,0,66,66,0,1,0,1,0
9033,28,0,0,70,70,0,1,0,1,0
21719,28,0,0,69,69,0,1,0,1,0
9601,28,0,0,70,70,0,1,0,1,0
17309,28,0,0,66,66,0,1,0,1,0
19006,28,0,0,70,70,0,1,0,1,0
21498,28,0,0,67,67,0,1,0,1,0
9992,28,0,0,70,70,0,1,0,1,0
21953,28,0,0,66,66,0,1,0,1,0
22444,28,0,0,69,69,0,1,0,1,0
9044,28,0,0,70,70,0,1,0,1,0
15902,28,0,0,67,67,0,1,0,1,0
19891,28,0,0,70,70,0,1,0,1,0
12721,28,0,0,66,66,0,1,0,1,0
16395,28,0,0,67,67,0,1,0,1,0
18196,28,0,0,66,66,0,1,0,1,0
10199,28,0,0,66,66,0,1,0,1,0
13877,28,0,0,70,70,0,1,0,1,0
14458,28,0,0,70,70,0,1,0,1,0
19555,28,0,0,70,70,0,1,0,1,0
11390,28,0,0,70,70,0,1,0,1,0
16030,28,0,0,66,66,0,1,0,1,0
9687,28,0,0,66,66,0,1,0,1,0
9292,28,0,0,70,70,0,1,0,1,0
18145,28,0,0,66,66,0,1,0,1,0
17223,28,0,0,70,70,0,1,0,1,0
16322,28,0,0,70,70,0,1,0,1,0
21489,28,0,0,66,66,0,1,0,1,0
13713,28,0,0,70,70,0,1,0,1,0
14212,28,0,0,70,70,0,1,0,1,0
18409,28,0,0,70,70,0,1,0,1,0
8616,28,0,0,70,70,0,1,0,1,0
19736,28,0,0,70,70,0,1,0,1,0
19791,28,0,0,66,66,0,1,0,1,0
21441,28,0,0,70,70,0,1,0,1,0
20900,28,0,0,70,70,0,1,0,1,0
14627,28,0,0,70,70,0,1,0,1,0
20997,28,0,0,70,70,0,1,0,1,0
14001,28,0,0,70,70,0,1,0,1,0
9623,28,0,0,70,70,0,1,0,1,0
19909,28,0,0,70,70,0,1,0,1,0
10077,28,0,0,66,66,0,1,0,1,0
13006,28,0,0,70,70,0,1,0,1,0
18401,28,0,0,70,70,0,1,0,1,0
15182,28,0,0,67,67,0,1,0,1,0
17343,28,0,0,70,70,0,1,0,1,0
8683,28,0,0,70,70,0,1,0,1,0
20676,28,0,0,70,70,0,1,0,1,0
17439,28,0,0,69,69,0,1,0,1,0
22275,28,0,0,69,69,0,1,0,1,0
15535,28,0,0,66,66,0,1,0,1,0
19697,28,0,0,70,70,0,1,0,1,0
20241,28,0,0,70,70,0,1,0,1,0
16039,28,0,0,70,70,0,1,0,1,0
12768,28,0,0,70,70,0,1,0,1,0
12656,28,0,0,66,66,0,1,0,1,0
20367,28,0,0,66,66,0,1,0,1,0
17880,28,0,0,70,70,0,1,0,1,0
21594,28,0,0,66,66,0,1,0,1,0
10602,28,0,0,70,70,0,1,0,1,0
9444,28,0,0,70,70,0,1,0,1,0
22063,28,0,0,67,67,0,1,0,1,0
14908,28,0,0,70,70,0,1,0,1,0
9543,28,0,0,70,70,0,1,0,1,0
13691,28,0,0,66,66,0,1,0,1,0
18704,28,0,0,66,66,0,1,0,1,0
21599,28,0,0,66,66,0,1,0,1,0
15056,28,0,0,67,67,0,1,0,1,0
13558,28,0,0,68,68,0,1,0,1,0
16513,28,0,0,66,66,0,1,0,1,0
9100,28,0,0,70,70,0,1,0,1,0
20541,28,0,0,69,69,0,1,0,1,0
9041,28,0,0,70,70,0,1,0,1,0
21549,28,0,0,66,66,0,1,0,1,0
9371,28,0,0,66,66,0,1,0,1,0
15659,28,0,0,68,68,0,1,0,1,0
10028,28,0,0,70,70,0,1,0,1,0
16611,28,0,0,70,70,0,1,0,1,0
16083,28,0,0,68,68,0,1,0,1,0
16017,28,0,0,69,69,0,1,0,1,0
9571,28,0,0,70,70,0,1,0,1,0
15290,28,0,0,70,70,0,1,0,1,0
10977,28,0,0,70,70,0,1,0,1,0
10603,28,0,0,70,70,0,1,0,1,0
20807,28,0,0,70,70,0,1,0,1,0
16444,28,0,0,66,66,0,1,0,1,0
10589,28,0,0,70,70,0,1,0,1,0
18500,28,0,0,66,66,0,1,0,1,0
10276,28,0,0,69,69,0,1,0,1,0
8655,28,0,0,68,68,0,1,0,1,0
17046,28,0,0,69,69,0,1,0,1,0
20108,28,0,0,70,70,0,1,0,1,0
11429,28,0,0,70,70,0,1,0,1,0
20338,28,0,0,70,70,0,1,0,1,0
11420,28,0,0,68,68,0,1,0,1,0
16910,28,0,0,66,66,0,1,0,1,0
17566,28,0,0,70,70,0,1,0,1,0
19481,28,0,0,70,70,0,1,0,1,0
12234,28,0,0,70,70,0,1,0,1,0
11719,28,0,0,66,66,0,1,0,1,0
16309,28,0,0,70,70,0,1,0,1,0
14222,28,0,0,67,67,0,1,0,1,0
13533,28,0,0,66,66,0,1,0,1,0
9651,28,0,0,70,70,0,1,0,1,0
14266,28,0,0,70,70,0,1,0,1,0
20254,28,0,0,70,70,0,1,0,1,0
14252,28,0,0,66,66,0,1,0,1,0
13284,28,0,0,70,70,0,1,0,1,0
20207,28,0,0,66,66,0,1,0,1,0
10406,28,0,0,70,70,0,1,0,1,0
12404,28,0,0,69,69,0,1,0,1,0
14666,28,0,0,66,66,0,1,0,1,0
20853,28,0,0,70,70,0,1,0,1,0
11317,28,0,0,66,66,0,1,0,1,0
18278,28,0,0,68,68,0,1,0,1,0
20214,28,0,0,70,70,0,1,0,1,0
9827,28,0,0,70,70,0,1,0,1,0
16840,28,0,0,68,68,0,1,0,1,0
9982,28,0,0,66,66,0,1,0,1,0
13835,28,0,0,68,68,0,1,0,1,0
19814,28,0,0,70,70,0,1,0,1,0
19340,28,0,0,66,66,0,1,0,1,0
9114,28,0,0,68,68,0,1,0,1,0
18548,28,0,0,66,66,0,1,0,1,0
19951,28,0,0,70,70,0,1,0,1,0
13430,28,0,0,70,70,0,1,0,1,0
10356,28,0,0,67,67,0,1,0,1,0
9855,28,0,0,70,70,0,1,0,1,0
12637,28,0,0,70,70,0,1,0,1,0
12557,28,0,0,70,70,0,1,0,1,0
9202,28,0,0,70,70,0,1,0,1,0
11407,28,0,0,70,70,0,1,0,1,0
12884,28,0,0,70,70,0,1,0,1,0
18404,28,0,0,70,70,0,1,0,1,0
18820,28,0,0,69,69,0,1,0,1,0
11471,28,0,0,70,70,0,1,0,1,0
22529,28,0,0,70,70,0,1,0,1,0
22683,28,0,0,70,70,0,1,0,1,0
20669,28,0,0,67,67,0,1,0,1,0
9776,28,0,0,70,70,0,1,0,1,0
9959,28,0,0,70,70,0,1,0,1,0
21137,28,0,0,66,66,0,1,0,1,0
14368,28,0,0,70,70,0,1,0,1,0
16059,28,0,0,70,70,0,1,0,1,0
18515,28,0,0,69,69,0,1,0,1,0
19055,28,0,0,66,66,0,1,0,1,0
13971,28,0,0,70,70,0,1,0,1,0
14186,28,0,0,70,70,0,1,0,1,0
11911,28,0,0,66,66,0,1,0,1,0
20900,28,0,0,70,70,0,1,0,1,0
9501,28,0,0,70,70,0,1,0,1,0
13878,28,0,0,70,70,0,1,0,1,0
18807,28,0,0,70,70,0,1,0,1,0
11590,28,0,0,70,70,0,1,0,1,0
16324,28,0,0,67,67,0,1,0,1,0
10222,28,0,0,66,66,0,1,0,1,0
13326,28,0,0,69,69,0,1,0,1,0
19458,28,0,0,66,66,0,1,0,1,0
21169,28,0,0,66,66,0,1,0,1,0
16079,28,0,0,66,66,0,1,0,1,0
9667,28,0,0,66,66,0,1,0,1,0
20366,28,0,0,70,70,0,1,0,1,0
20576,28,0,0,70,70,0,1,0,1,0
13474,28,0,0,70,70,0,1,0,1,0
18438,28,0,0,70,70,0,1,0,1,0
11854,28,0,0,70,70,0,1,0,1,0
20068,28,0,0,67,67,0,1,0,1,0
13504,28,0,0,70,70,0,1,0,1,0
20068,28,0,0,66,66,0,1,0,1,0
13693,28,0,0,70,70,0,1,0,1,0
17189,28,0,0,70,70,0,1,0,1,0
9580,28,0,0,67,67,0,1,0,1,0
19416,28,0,0,66,66,0,1,0,1,0
16754,28,0,0,66,66,0,1,0,1,0
13971,28,0,0,70,70,0,1,0,1,0
22298,28,0,0,70,70,0,1,0,1,0
9483,28,0,0,66,66,0,1,0,1,0
18712,28,0,0,70,70,0,1,0,1,0
22213,28,0,0,70,70,0,1,0,1,0
18748,28,0,0,69,69,0,1,0,1,0
8637,28,0,0,67,67,0,1,0,1,0
9495,28,0,0,66,66,0,1,0,1,0
19907,28,0,0,70,70,0,1,0,1,0
8578,28,0,0,67,67,0,1,0,1,0
15884,28,0,0,70,70,0,1,0,1,0
9452,28,0,0,66,66,0,1,0,1,0
19706,28,0,0,69,69,0,1,0,1,0
16708,28,0,0,70,70,0,1,0,1,0
10095,28,0,0,68,68,0,1,0,1,0
21099,28,0,0,67,67,0,1,0,1,0
20965,28,0,0,70,70,0,1,0,1,0
12306,28,0,0,67,67,0,1,0,1,0
18492,28,0,0,70,70,0,1,0,1,0
15620,28,0,0,70,70,0,1,0,1,0
16445,28,0,0,69,69,0,1,0,1,0
10957,28,0,0,70,70,0,1,0,1,0
11460,28,0,0,66,66,0,1,0,1,0
13858,28,0,0,70,70,0,1,0,1,0
21227,28,0,0,70,70,0,1,0,1,0
19734,28,0,0,70,70,0,1,0,1,0
8356,28,0,0,70,70,0,1,0,1,0
14481,28,0,0,66,66,0,1,0,1,0
17574,28,0,0,70,70,0,1,0,1,0
18480,28,0,0,66,66,0,1,0,1,0
18832,28,0,0,70,70,0,1,0,1,0
9833,28,0,0,70,70,0,1,0,1,0
10276,28,0,0,70,70,0,1,0,1,0
13534,28,0,0,69,69,0,1,0,1,0
17470,28,0,0,69,69,0,1,0,1,0
16211,28,0,0,69,69,0,1,0,1,0
8502,28,0,0,70,70,0,1,0,1,0
22699,28,0,0,70,70,0,1,0,1,0
10106,28,0,0,66,66,0,1,0,1,0
19920,28,0,0,66,66,0,1,0,1,0
16634,28,0,0,70,70,0,1,0,1,0
20017,28,0,0,66,66,0,1,0,1,0
11015,28,0,0,70,70,0,1,0,1,0
14427,28,0,0,70,70,0,1,0,1,0
14347,28,0,0,70,70,0,1,0,1,0
20595,28,0,0,70,70,0,1,0,1,0
13807,28,0,0,70,70,0,1,0,1,0
8921,28,0,0,70,70,0,1,0,1,0
17751,28,0,0,66,66,0,1,0,1,0
9567,28,0,0,70,70,0,1,0,1,0
9313,28,0,0,70,70,0,1,0,1,0
10961,28,0,0,70,70,0,1,0,1,0
15577,28,0,0,70,70,0,1,0,1,0
21725,28,0,0,70,70,0,1,0,1,0
11373,28,0,0,66,66,0,1,0,1,0
10077,28,0,0,70,70,0,1,0,1,0
10080,28,0,0,70,70,0,1,0,1,0
21772,28,0,0,70,70,0,1,0,1,0
13664,28,0,0,70,70,0,1,0,1,0
20953,28,0,0,70,70,0,1,0,1,0
15986,28,0,0,70,70,0,1,0,1,0
9827,28,0,0,70,70,0,1,0,1,0
16281,28,0,0,70,70,0,1,0,1,0
18648,28,0,0,70,70,0,1,0,1,0
12302,28,0,0,69,69,0,1,0,1,0
9394,28,0,0,70,70,0,1,0,1,0
13690,28,0,0,66,66,0,1,0,1,0
15095,28,0,0,68,68,0,1,0,1,0
14124,28,0,0,70,70,0,1,0,1,0
8360,28,0,0,70,70,0,1,0,1,0
11868,28,0,0,70,70,0,1,0,1,0
18518,28,0,0,69,69,0,1,0,1,0
20118,28,0,0,66,66,0,1,0,1,0
13594,28,0,0,70,70,0,1,0,1,0
20167,28,0,0,66,66,0,1,0,1,0
9879,28,0,0,66,66,0,1,0,1,0
14583,28,0,0,70,70,0,1,0,1,0
14337,28,0,0,70,70,0,1,0,1,0
12953,28,0,0,66,66,0,1,0,1,0
10291,28,0,0,66,66,0,1,0,1,0
14315,28,0,0,70,70,0,1,0,1,0
15789,28,0,0,70,70,0,1,0,1,0
19580,28,0,0,69,69,0,1,0,1,0
9672,28,0,0,70,70,0,1,0,1,0
13578,28,0,0,70,70,0,1,0,1,0
19849,28,0,0,70,70,0,1,0,1,0
16608,28,0,0,66,66,0,1,0,1,0
14094,28,0,0,70,70,0,1,0,1,0
18696,28,0,0,68,68,0,1,0,1,0
17595,28,0,0,66,66,0,1,0,1,0
12259,28,0,0,70,70,0,1,0,1,0
12656,28,0,0,66,66,0,1,0,1,0
13630,28,0,0,70,70,0,1,0,1,0
14619,28,0,0,66,66,0,1,0,1,0
19054,28,0,0,66,66,0,1,0,1,0
15849,28,0,0,70,70,0,1,0,1,0
22024,28,0,0,70,70,0,1,0,1,0
17374,28,0,0,69,69,0,1,0,1,0
21594,28,0,0,66,66,0,1,0,1,0
20042,28,0,0,70,70,0,1,0,1,0
16786,28,0,0,70,70,0,1,0,1,0
12769,28,0,0,66,66,0,1,0,1,0
21080,28,0,0,70,70,0,1,0,1,0
19474,28,0,0,70,70,0,1,0,1,0
9740,28,0,0,69,69,0,1,0,1,0
20241,28,0,0,70,70,0,1,0,1,0
14625,28,0,0,66,66,0,1,0,1,0
13389,28,0,0,70,70,0,1,0,1,0
18676,28,0,0,70,70,0,1,0,1,0
17267,28,0,0,70,70,0,1,0,1,0
20647,28,0,0,70,70,0,1,0,1,0
11503,28,0,0,66,66,0,1,0,1,0
9785,28,0,0,70,70,0,1,0,1,0
22647,28,0,0,70,70,0,1,0,1,0
22360,28,0,0,70,70,0,1,0,1,0
12536,28,0,0,66,66,0,1,0,1,0
18948,28,0,0,66,66,0,1,0,1,0
20001,28,0,0,70,70,0,1,0,1,0
16336,28,0,0,66,66,0,1,0,1,0
19687,28,0,0,69,69,0,1,0,1,0
17452,28,0,0,70,70,0,1,0,1,0
10624,28,0,0,66,66,0,1,0,1,0
15340,28,0,0,66,66,0,1,0,1,0
16602,28,0,0,69,69,0,1,0,1,0
16472,28,0,0,70,70,0,1,0,1,0
19209,28,0,0,66,66,0,1,0,1,0
13890,28,0,0,70,70,0,1,0,1,0
13675,28,0,0,70,70,0,1,0,1,0
20715,28,0,0,66,66,0,1,0,1,0
21754,28,0,0,70,70,0,1,0,1,0
8556,28,0,0,70,70,0,1,0,1,0
19359,28,0,0,66,66,0,1,0,1,0
20716,28,0,0,70,70,0,1,0,1,0
15419,28,0,0,70,70,0,1,0,1,0
16759,28,0,0,70,70,0,1,0,1,0
16729,28,0,0,70,70,0,1,0,1,0
11627,28,0,0,69,69,0,1,0,1,0
15656,28,0,0,66,66,0,1,0,1,0
8656,28,0,0,66,66,0,1,0,1,0
19582,28,0,0,70,70,0,1,0,1,0
19555,28,0,0,70,70,0,1,0,1,0
15391,28,0,0,66,66,0,1,0,1,0
9190,28,0,0,70,70,0,1,0,1,0
10835,28,0,0,70,70,0,1,0,1,0
17515,28,0,0,70,70,0,1,0,1,0
11364,28,0,0,70,70,0,1,0,1,0
21473,28,0,0,66,66,0,1,0,1,0
17540,28,0,0,66,66,0,1,0,1,0
22123,28,0,0,67,67,0,1,0,1,0
17852,28,0,0,70,70,0,1,0,1,0
13168,28,0,0,66,66,0,1,0,1,0
18528,28,0,0,68,68,0,1,0,1,0
9661,28,0,0,66,66,0,1,0,1,0
13922,28,0,0,70,70,0,1,0,1,0
11042,28,0,0,70,70,0,1,0,1,0
12191,28,0,0,66,66,0,1,0,1,0
14470,28,0,0,70,70,0,1,0,1,0
20277,28,0,0,66,66,0,1,0,1,0
13685,28,0,0,70,70,0,1,0,1,0
19954,28,0,0,70,70,0,1,0,1,0
20241,28,0,0,66,66,0,1,0,1,0
13662,28,0,0,70,70,0,1,0,1,0
10626,28,0,0,70,70,0,1,0,1,0
14490,28,0,0,70,70,0,1,0,1,0
22274,28,0,0,66,66,0,1,0,1,0
14144,28,0,0,70,70,0,1,0,1,0
14570,28,0,0,70,70,0,1,0,1,0
14738,28,0,0,70,70,0,1,0,1,0
14982,28,0,0,70,70,0,1,0,1,0
21595,28,0,0,66,66,0,1,0,1,0
14022,28,0,0,70,70,0,1,0,1,0
16200,28,0,0,70,70,0,1,0,1,0
9208,28,0,0,70,70,0,1,0,1,0
18771,28,0,0,68,68,0,1,0,1,0
15573,28,0,0,70,70,0,1,0,1,0
9814,28,0,0,66,66,0,1,0,1,0
9585,28,0,0,67,67,0,1,0,1,0
15955,28,0,0,68,68,0,1,0,1,0
17153,28,0,0,70,70,0,1,0,1,0
9138,28,0,0,70,70,0,1,0,1,0
16944,28,0,0,66,66,0,1,0,1,0
12365,28,0,0,68,68,0,1,0,1,0
20505,28,0,0,67,67,0,1,0,1,0
19615,28,0,0,70,70,0,1,0,1,0
16346,28,0,0,66,66,0,1,0,1,0
19737,28,0,0,69,69,0,1,0,1,0
19608,28,0,0,66,66,0,1,0,1,0
12566,28,0,0,70,70,0,1,0,1,0
21049,28,0,0,67,67,0,1,0,1,0
9449,28,0,0,70,70,0,1,0,1,0
12300,28,0,0,70,70,0,1,0,1,0
13247,28,0,0,70,70,0,1,0,1,0
11503,28,0,0,66,66,0,1,0,1,0
9973,28,0,0,66,66,0,1,0,1,0
12374,28,0,0,70,70,0,1,0,1,0
11893,28,0,0,70,70,0,1,0,1,0
10413,28,0,0,70,70,0,1,0,1,0
9644,28,0,0,70,70,0,1,0,1,0
18474,28,0,0,70,70,0,1,0,1,0
13712,28,0,0,70,70,0,1,0,1,0
11968,28,0,0,70,70,0,1,0,1,0
20793,28,0,0,69,69,0,1,0,1,0
11633,28,0,0,70,70,0,1,0,1,0
16878,28,0,0,70,70,0,1,0,1,0
21917,28,0,0,70,70,0,1,0,1,0
10528,28,0,0,70,70,0,1,0,1,0
14962,28,0,0,66,66,0,1,0,1,0
16849,28,0,0,66,66,0,1,0,1,0
16687,28,0,0,70,70,0,1,0,1,0
14961,28,0,0,68,68,0,1,0,1,0
11645,28,0,0,70,70,0,1,0,1,0
21132,28,0,0,70,70,0,1,0,1,0
19055,28,0,0,66,66,0,1,0,1,0
18305,28,0,0,70,70,0,1,0,1,0
12929,28,0,0,70,70,0,1,0,1,0
9005,28,0,0,70,70,0,1,0,1,0
10816,28,0,0,70,70,0,1,0,1,0
21942,28,0,0,66,66,0,1,0,1,0
16615,28,0,0,70,70,0,1,0,1,0
8434,28,0,0,70,70,0,1,0,1,0
11586,28,0,0,70,70,0,1,0,1,0
14224,28,0,0,70,70,0,1,0,1,0
12174,28,0,0,70,70,0,1,0,1,0
20240,28,0,0,66,66,0,1,0,1,0
18578,28,0,0,69,69,0,1,0,1,0
12277,28,0,0,66,66,0,1,0,1,0
20006,28,0,0,68,68,0,1,0,1,0
9677,28,0,0,68,68,0,1,0,1,0
11711,28,0,0,67,67,0,1,0,1,0
9444,28,0,0,70,70,0,1,0,1,0
20185,28,0,0,69,69,0,1,0,1,0
14090,28,0,0,70,70,0,1,0,1,0
19449,28,0,0,70,70,0,1,0,1,0
9415,28,0,0,70,70,0,1,0,1,0
13367,28,0,0,70,70,0,1,0,1,0
21826,28,0,0,70,70,0,1,0,1,0
15067,28,0,0,70,70,0,1,0,1,0
8660,28,0,0,70,70,0,1,0,1,0
16955,28,0,0,70,70,0,1,0,1,0
9467,28,0,0,70,70,0,1,0,1,0
10222,28,0,0,66,66,0,1,0,1,0
15064,28,0,0,68,68,0,1,0,1,0
15108,28,0,0,70,70,0,1,0,1,0
11977,28,0,0,70,70,0,1,0,1,0
10781,28,0,0,70,70,0,1,0,1,0
16764,28,0,0,70,70,0,1,0,1,0
16853,28,0,0,70,70,0,1,0,1,0
19623,28,0,0,70,70,0,1,0,1,0
16570,28,0,0,70,70,0,1,0,1,0
10625,28,0,0,69,69,0,1,0,1,0
18437,28,0,0,70,70,0,1,0,1,0
12546,28,0,0,67,67,0,1,0,1,0
13239,28,0,0,66,66,0,1,0,1,0
9688,28,0,0,66,66,0,1,0,1,0
13838,28,0,0,68,68,0,1,0,1,0
12402,28,0,0,66,66,0,1,0,1,0
17851,28,0,0,70,70,0,1,0,1,0
21491,28,0,0,68,68,0,1,0,1,0
20126,28,0,0,70,70,0,1,0,1,0
14262,28,0,0,69,69,0,1,0,1,0
17853,28,0,0,70,70,0,1,0,1,0
11670,28,0,0,70,70,0,1,0,1,0
13958,28,0,0,70,70,0,1,0,1,0
20499,28,0,0,70,70,0,1,0,1,0
14829,28,0,0,70,70,0,1,0,1,0
17876,28,0,0,70,70,0,1,0,1,0
15575,28,0,0,70,70,0,1,0,1,0
21250,28,0,0,66,66,0,1,0,1,0
12851,28,0,0,70,70,0,1,0,1,0
16882,28,0,0,70,70,0,1,0,1,0
21864,28,0,0,70,70,0,1,0,1,0
8695,28,0,0,66,66,0,1,0,1,0
19972,28,0,0,70,70,0,1,0,1,0
22398,28,0,0,66,66,0,1,0,1,0
13429,28,0,0,70,70,0,1,0,1,0
9293,28,0,0,70,70,0,1,0,1,0
21398,28,0,0,70,70,0,1,0,1,0
11567,28,0,0,70,70,0,1,0,1,0
14825,28,0,0,70,70,0,1,0,1,0
20855,28,0,0,70,70,0,1,0,1,0
9280,28,0,0,70,70,0,1,0,1,0
11708,28,0,0,70,70,0,1,0,1,0
15426,28,0,0,70,70,0,1,0,1,0
15718,28,0,0,70,70,0,1,0,1,0
21976,28,0,0,68,68,0,1,0,1,0
15005,28,0,0,70,70,0,1,0,1,0
12112,28,0,0,69,69,0,1,0,1,0
15121,28,0,0,70,70,0,1,0,1,0
20506,28,0,0,70,70,0,1,0,1,0
15974,28,0,0,67,67,0,1,0,1,0
21007,28,0,0,66,66,0,1,0,1,0
16045,28,0,0,66,66,0,1,0,1,0
9040,28,0,0,67,67,0,1,0,1,0
10081,28,0,0,66,66,0,1,0,1,0
19151,28,0,0,66,66,0,1,0,1,0
13616,28,0,0,66,66,0,1,0,1,0
12698,28,0,0,70,70,0,1,0,1,0
20497,28,0,0,70,70,0,1,0,1,0
21599,28,0,0,70,70,0,1,0,1,0
13966,28,0,0,66,66,0,1,0,1,0
19455,28,0,0,70,70,0,1,0,1,0
21943,28,0,0,70,70,0,1,0,1,0
19374,28,0,0,70,70,0,1,0,1,0
13058,28,0,0,70,70,0,1,0,1,0
13512,28,0,0,66,66,0,1,0,1,0
18950,28,0,0,66,66,0,1,0,1,0
17811,28,0,0,70,70,0,1,0,1,0
12946,28,0,0,70,70,0,1,0,1,0
9012,28,0,0,70,70,0,1,0,1,0
8399,28,0,0,70,70,0,1,0,1,0
15350,28,0,0,70,70,0,1,0,1,0
18501,28,0,0,66,66,0,1,0,1,0
12525,28,0,0,69,69,0,1,0,1,0
16543,28,0,0,67,67,0,1,0,1,0
9838,28,0,0,70,70,0,1,0,1,0
14906,28,0,0,66,66,0,1,0,1,0
18015,28,0,0,70,70,0,1,0,1,0
10293,28,0,0,66,66,0,1,0,1,0
16429,28,0,0,70,70,0,1,0,1,0
14039,28,0,0,70,70,0,1,0,1,0
17291,28,0,0,66,66,0,1,0,1,0
9777,28,0,0,70,70,0,1,0,1,0
12801,28,0,0,70,70,0,1,0,1,0
13935,28,0,0,66,66,0,1,0,1,0
15599,28,0,0,66,66,0,1,0,1,0
10519,28,0,0,70,70,0,1,0,1,0
11688,28,0,0,70,70,0,1,0,1,0
14447,28,0,0,70,70,0,1,0,1,0
15312,28,0,0,70,70,0,1,0,1,0
16027,28,0,0,66,66,0,1,0,1,0
19323,28,0,0,70,70,0,1,0,1,0
17834,28,0,0,70,70,0,1,0,1,0
9551,28,0,0,70,70,0,1,0,1,0
15342,28,0,0,70,70,0,1,0,1,0
13510,28,0,0,66,66,0,1,0,1,0
16234,28,0,0,66,66,0,1,0,1,0
8470,28,0,0,70,70,0,1,0,1,0
13436,28,0,0,70,70,0,1,0,1,0
10062,28,0,0,67,67,0,1,0,1,0
8606,28,0,0,66,66,0,1,0,1,0
8990,28,0,0,66,66,0,1,0,1,0
18517,28,0,0,70,70,0,1,0,1,0
19195,28,0,0,67,67,0,1,0,1,0
17658,28,0,0,70,70,0,1,0,1,0
17877,28,0,0,70,70,0,1,0,1,0
11792,28,0,0,66,66,0,1,0,1,0
9737,28,0,0,66,66,0,1,0,1,0
16171,28,0,0,70,70,0,1,0,1,0
20877,28,0,0,68,68,0,1,0,1,0
21577,28,0,0,68,68,0,1,0,1,0
10182,28,0,0,66,66,0,1,0,1,0
16730,28,0,0,70,70,0,1,0,1,0
18399,28,0,0,69,69,0,1,0,1,0
21076,28,0,0,66,66,0,1,0,1,0
13812,28,0,0,70,70,0,1,0,1,0
11054,28,0,0,67,67,0,1,0,1,0
10174,28,0,0,66,66,0,1,0,1,0
14725,28,0,0,69,69,0,1,0,1,0
12058,28,0,0,70,70,0,1,0,1,0
17240,28,0,0,70,70,0,1,0,1,0
8988,28,0,0,68,68,0,1,0,1,0
16093,28,0,0,70,70,0,1,0,1,0
17660,28,0,0,70,70,0,1,0,1,0
9288,28,0,0,70,70,0,1,0,1,0
8973,28,0,0,70,70,0,1,0,1,0
10989,28,0,0,68,68,0,1,0,1,0
12562,28,0,0,70,70,0,1,0,1,0
12704,28,0,0,67,67,0,1,0,1,0
20459,28,0,0,70,70,0,1,0,1,0
17442,28,0,0,66,66,0,1,0,1,0
12269,28,0,0,70,70,0,1,0,1,0
17255,28,0,0,68,68,0,1,0,1,0
19071,28,0,0,70,70,0,1,0,1,0
19386,28,0,0,69,69,0,1,0,1,0
9997,28,0,0,66,66,0,1,0,1,0
20356,28,0,0,70,70,0,1,0,1,0
13661,28,0,0,70,70,0,1,0,1,0
17292,28,0,0,66,66,0,1,0,1,0
20234,28,0,0,70,70,0,1,0,1,0
20825,28,0,0,66,66,0,1,0,1,0
12346,28,0,0,70,70,0,1,0,1,0
12583,28,0,0,70,70,0,1,0,1,0
21546,28,0,0,68,68,0,1,0,1,0
12049,28,0,0,70,70,0,1,0,1,0
9756,28,0,0,70,70,0,1,0,1,0
15295,28,0,0,70,70,0,1,0,1,0
21660,28,0,0,70,70,0,1,0,1,0
18396,28,0,0,70,70,0,1,0,1,0
17640,28,0,0,68,68,0,1,0,1,0
12376,28,0,0,70,70,0,1,0,1,0
9444,28,0,0,70,70,0,1,0,1,0
16714,28,0,0,70,70,0,1,0,1,0
22495,28,0,0,67,67,0,1,0,1,0
13745,28,0,0,66,66,0,1,0,1,0
13296,28,0,0,68,68,0,1,0,1,0
17470,28,0,0,67,67,0,1,0,1,0
14338,28,0,0,69,69,0,1,0,1,0
14724,28,0,0,70,70,0,1,0,1,0
18083,28,0,0,70,70,0,1,0,1,0
13558,28,0,0,70,70,0,1,0,1,0
18819,28,0,0,70,70,0,1,0,1,0
14857,28,0,0,70,70,0,1,0,1,0
19461,28,0,0,70,70,0,1,0,1,0
15612,28,0,0,70,70,0,1,0,1,0
19296,28,0,0,70,70,0,1,0,1,0
10294,28,0,0,66,66,0,1,0,1,0
14306,28,0,0,69,69,0,1,0,1,0
9614,28,0,0,66,66,0,1,0,1,0
12981,28,0,0,70,70,0,1,0,1,0
8744,28,0,0,70,70,0,1,0,1,0
8383,28,0,0,70,70,0,1,0,1,0
14527,28,0,0,70,70,0,1,0,1,0
14024,28,0,0,70,70,0,1,0,1,0
14134,28,0,0,70,70,0,1,0,1,0
22361,28,0,0,70,70,0,1,0,1,0
18500,28,0,0,66,66,0,1,0,1,0
11046,28,0,0,66,66,0,1,0,1,0
19584,28,0,0,70,70,0,1,0,1,0
18485,28,0,0,70,70,0,1,0,1,0
19293,28,0,0,66,66,0,1,0,1,0
19802,28,0,0,70,70,0,1,0,1,0
17388,28,0,0,68,68,0,1,0,1,0
8503,28,0,0,70,70,0,1,0,1,0
9100,28,0,0,70,70,0,1,0,1,0
11721,28,0,0,70,70,0,1,0,1,0
19945,28,0,0,66,66,0,1,0,1,0
21235,28,0,0,67,67,0,1,0,1,0
13118,28,0,0,70,70,0,1,0,1,0
19836,28,0,0,70,70,0,1,0,1,0
14345,28,0,0,70,70,0,1,0,1,0
19815,28,0,0,70,70,0,1,0,1,0
16900,28,0,0,66,66,0,1,0,1,0
18904,28,0,0,68,68,0,1,0,1,0
9863,28,0,0,70,70,0,1,0,1,0
15731,28,0,0,70,70,0,1,0,1,0
16714,28,0,0,70,70,0,1,0,1,0
17500,28,0,0,69,69,0,1,0,1,0
18498,28,0,0,66,66,0,1,0,1,0
12597,28,0,0,70,70,0,1,0,1,0
9322,28,0,0,70,70,0,1,0,1,0
8931,28,0,0,66,66,0,1,0,1,0
10702,28,0,0,70,70,0,1,0,1,0
18954,28,0,0,70,70,0,1,0,1,0
14709,28,0,0,70,70,0,1,0,1,0
21236,28,0,0,66,66,0,1,0,1,0
17955,28,0,0,70,70,0,1,0,1,0
15775,28,0,0,66,66,0,1,0,1,0
12656,28,0,0,66,66,0,1,0,1,0
19621,28,0,0,70,70,0,1,0,1,0
20336,28,0,0,70,70,0,1,0,1,0
20135,28,0,0,70,70,0,1,0,1,0
14089,28,0,0,70,70,0,1,0,1,0
13057,28,0,0,66,66,0,1,0,1,0
15984,28,0,0,66,66,0,1,0,1,0
12121,28,0,0,70,70,0,1,0,1,0
19148,28,0,0,70,70,0,1,0,1,0
19071,28,0,0,70,70,0,1,0,1,0
9957,28,0,0,70,70,0,1,0,1,0
9973,28,0,0,70,70,0,1,0,1,0
20598,28,0,0,66,66,0,1,0,1,0
14404,28,0,0,70,70,0,1,0,1,0
18679,28,0,0,67,67,0,1,0,1,0
13943,28,0,0,70,70,0,1,0,1,0
13431,28,0,0,66,66,0,1,0,1,0
10214,28,0,0,70,70,0,1,0,1,0
15668,28,0,0,70,70,0,1,0,1,0
14724,28,0,0,70,70,0,1,0,1,0
15922,28,0,0,70,70,0,1,0,1,0
12368,28,0,0,68,68,0,1,0,1,0
14582,28,0,0,70,70,0,1,0,1,0
19751,28,0,0,67,67,0,1,0,1,0
12056,28,0,0,67,67,0,1,0,1,0
22669,28,0,0,68,68,0,1,0,1,0
19113,28,0,0,70,70,0,1,0,1,0
15113,28,0,0,70,70,0,1,0,1,0
11882,28,0,0,70,70,0,1,0,1,0
10376,28,0,0,70,70,0,1,0,1,0
18022,28,0,0,66,66,0,1,0,1,0
22031,28,0,0,66,66,0,1,0,1,0
21450,28,0,0,67,67,0,1,0,1,0
17563,28,0,0,67,67,0,1,0,1,0
20800,28,0,0,70,70,0,1,0,1,0
18923,28,0,0,70,70,0,1,0,1,0
22090,28,0,0,69,69,0,1,0,1,0
9958,28,0,0,70,70,0,1,0,1,0
20499,28,0,0,70,70,0,1,0,1,0
12591,28,0,0,66,66,0,1,0,1,0
15645,28,0,0,66,66,0,1,0,1,0
18745,28,0,0,67,67,0,1,0,1,0
17212,28,0,0,67,67,0,1,0,1,0
9342,28,0,0,70,70,0,1,0,1,0
17956,28,0,0,70,70,0,1,0,1,0
18185,28,0,0,70,70,0,1,0,1,0
12739,28,0,0,70,70,0,1,0,1,0
15163,28,0,0,70,70,0,1,0,1,0
9852,28,0,0,70,70,0,1,0,1,0
10270,28,0,0,70,70,0,1,0,1,0
14052,28,0,0,70,70,0,1,0,1,0
19286,28,0,0,68,68,0,1,0,1,0
19540,28,0,0,66,66,0,1,0,1,0
18344,28,0,0,70,70,0,1,0,1,0
10874,28,0,0,70,70,0,1,0,1,0
12315,28,0,0,70,70,0,1,0,1,0
18438,28,0,0,70,70,0,1,0,1,0
19148,28,0,0,66,66,0,1,0,1,0
16513,28,0,0,70,70,0,1,0,1,0
20759,28,0,0,70,70,0,1,0,1,0
14910,28,0,0,68,68,0,1,0,1,0
14699,28,0,0,70,70,0,1,0,1,0
12167,28,0,0,67,67,0,1,0,1,0
20870,28,0,0,66,66,0,1,0,1,0
13757,28,0,0,69,69,0,1,0,1,0
19276,28,0,0,70,70,0,1,0,1,0
16371,28,0,0,69,69,0,1,0,1,0
17292,28,0,0,66,66,0,1,0,1,0
21938,28,0,0,69,69,0,1,0,1,0
16993,28,0,0,66,66,0,1,0,1,0
8550,28,0,0,66,66,0,1,0,1,0
12883,28,0,0,70,70,0,1,0,1,0
13271,28,0,0,70,70,0,1,0,1,0
21252,28,0,0,66,66,0,1,0,1,0
8586,28,0,0,70,70,0,1,0,1,0
13247,28,0,0,70,70,0,1,0,1,0
10792,28,0,0,66,66,0,1,0,1,0
17493,28,0,0,66,66,0,1,0,1,0
20475,28,0,0,70,70,0,1,0,1,0
14152,28,0,0,70,70,0,1,0,1,0
16871,28,0,0,70,70,0,1,0,1,0
19204,28,0,0,66,66,0,1,0,1,0
12445,28,0,0,70,70,0,1,0,1,0
20339,28,0,0,66,66,0,1,0,1,0
13412,28,0,0,70,70,0,1,0,1,0
13339,28,0,0,66,66,0,1,0,1,0
9071,28,0,0,70,70,0,1,0,1,0
19735,28,0,0,70,70,0,1,0,1,0
8659,28,0,0,70,70,0,1,0,1,0
20434,28,0,0,70,70,0,1,0,1,0
15409,28,0,0,66,66,0,1,0,1,0
16782,28,0,0,70,70,0,1,0,1,0
19087,28,0,0,69,69,0,1,0,1,0
20262,28,0,0,66,66,0,1,0,1,0
21544,28,0,0,70,70,0,1,0,1,0
11365,28,0,0,70,70,0,1,0,1,0
20652,28,0,0,70,70,0,1,0,1,0
19910,28,0,0,70,70,0,1,0,1,0
14147,28,0,0,70,70,0,1,0,1,0
10354,28,0,0,70,70,0,1,0,1,0
9541,28,0,0,66,66,0,1,0,1,0
14195,28,0,0,70,70,0,1,0,1,0
10294,28,0,0,66,66,0,1,0,1,0
11941,28,0,0,70,70,0,1,0,1,0
21719,28,0,0,68,68,0,1,0,1,0
10605,28,0,0,70,70,0,1,0,1,0
16495,28,0,0,70,70,0,1,0,1,0
14306,28,0,0,66,66,0,1,0,1,0
8721,28,0,0,70,70,0,1,0,1,0
9878,28,0,0,70,70,0,1,0,1,0
19194,28,0,0,70,70,0,1,0,1,0
9562,28,0,0,66,66,0,1,0,1,0
21801,28,0,0,70,70,0,1,0,1,0
8375,28,0,0,70,70,0,1,0,1,0
16400,28,0,0,70,70,0,1,0,1,0
8495,28,0,0,69,69,0,1,0,1,0
18100,28,0,0,66,66,0,1,0,1,0
16537,28,0,0,70,70,0,1,0,1,0
16656,28,0,0,66,66,0,1,0,1,0
18563,28,0,0,67,67,0,1,0,1,0
17142,28,0,0,70,70,0,1,0,1,0
11105,28,0,0,70,70,0,1,0,1,0
14800,28,0,0,70,70,0,1,0,1,0
18334,28,0,0,66,66,0,1,0,1,0
20074,28,0,0,70,70,0,1,0,1,0
20082,28,0,0,70,70,0,1,0,1,0
21730,28,0,0,66,66,0,1,0,1,0
20197,28,0,0,69,69,0,1,0,1,0
16427,28,0,0,70,70,0,1,0,1,0
13431,28,0,0,67,67,0,1,0,1,0
13593,28,0,0,70,70,0,1,0,1,0
10589,28,0,0,70,70,0,1,0,1,0
21450,28,0,0,69,69,0,1,0,1,0
22579,28,0,0,68,68,0,1,0,1,0
16694,28,0,0,67,67,0,1,0,1,0
8949,28,0,0,70,70,0,1,0,1,0
21462,28,0,0,66,66,0,1,0,1,0
16705,28,0,0,69,69,0,1,0,1,0
13168,28,0,0,68,68,0,1,0,1,0
16585,28,0,0,70,70,0,1,0,1,0
10440,28,0,0,67,67,0,1,0,1,0
9816,28,0,0,66,66,0,1,0,1,0
8728,28,0,0,70,70,0,1,0,1,0
8767,28,0,0,70,70,0,1,0,1,0
19735,28,0,0,66,66,0,1,0,1,0
8503,28,0,0,70,70,0,1,0,1,0
16855,28,0,0,70,70,0,1,0,1,0
9197,28,0,0,70,70,0,1,0,1,0
9693,28,0,0,70,70,0,1,0,1,0
9629,28,0,0,70,70,0,1,0,1,0
13752,28,0,0,66,66,0,1,0,1,0
17347,28,0,0,70,70,0,1,0,1,0
10528,28,0,0,69,69,0,1,0,1,0
16896,28,0,0,70,70,0,1,0,1,0
10476,28,0,0,70,70,0,1,0,1,0
20478,28,0,0,66,66,0,1,0,1,0
19359,28,0,0,66,66,0,1,0,1,0
13672,28,0,0,68,68,0,1,0,1,0
16537,28,0,0,70,70,0,1,0,1,0
10598,28,0,0,66,66,0,1,0,1,0
18584,28,0,0,70,70,0,1,0,1,0
16593,28,0,0,66,66,0,1,0,1,0
11492,28,0,0,70,70,0,1,0,1,0
20886,28,0,0,70,70,0,1,0,1,0
10235,28,0,0,66,66,0,1,0,1,0
18736,28,0,0,70,70,0,1,0,1,0
17631,28,0,0,70,70,0,1,0,1,0
11561,28,0,0,66,66,0,1,0,1,0
18630,28,0,0,70,70,0,1,0,1,0
22336,28,0,0,69,69,0,1,0,1,0
18565,28,0,0,66,66,0,1,0,1,0
18437,28,0,0,70,70,0,1,0,1,0
16714,28,0,0,66,66,0,1,0,1,0
11927,28,0,0,70,70,0,1,0,1,0
14119,28,0,0,66,66,0,1,0,1,0
14828,28,0,0,70,70,0,1,0,1,0
12688,28,0,0,70,70,0,1,0,1,0
16036,28,0,0,70,70,0,1,0,1,0
10167,28,0,0,70,70,0,1,0,1,0
9950,28,0,0,70,70,0,1,0,1,0
20713,28,0,0,70,70,0,1,0,1,0
19780,28,0,0,70,70,0,1,0,1,0
10856,28,0,0,69,69,0,1,0,1,0
21465,28,0,0,70,70,0,1,0,1,0
13697,28,0,0,70,70,0,1,0,1,0
15229,28,0,0,70,70,0,1,0,1,0
12715,28,0,0,70,70,0,1,0,1,0
9375,28,0,0,70,70,0,1,0,1,0
17458,28,0,0,70,70,0,1,0,1,0
17382,28,0,0,70,70,0,1,0,1,0
13972,28,0,0,70,70,0,1,0,1,0
19449,28,0,0,70,70,0,1,0,1,0
16389,28,0,0,70,70,0,1,0,1,0
14862,28,0,0,68,68,0,1,0,1,0
19310,28,0,0,70,70,0,1,0,1,0
20309,28,0,0,69,69,0,1,0,1,0
9336,28,0,0,70,70,0,1,0,1,0
11649,28,0,0,69,69,0,1,0,1,0
17630,28,0,0,70,70,0,1,0,1,0
16264,28,0,0,70,70,0,1,0,1,0
15428,28,0,0,70,70,0,1,0,1,0
12763,28,0,0,70,70,0,1,0,1,0
18090,28,0,0,67,67,0,1,0,1,0
12780,28,0,0,66,66,0,1,0,1,0
16151,28,0,0,70,70,0,1,0,1,0
18308,28,0,0,70,70,0,1,0,1,0
12003,28,0,0,66,66,0,1,0,1,0
8589,28,0,0,70,70,0,1,0,1,0
18286,28,0,0,70,70,0,1,0,1,0
20337,28,0,0,69,69,0,1,0,1,0
21050,28,0,0,70,70,0,1,0,1,0
20119,28,0,0,70,70,0,1,0,1,0
18952,28,0,0,70,70,0,1,0,1,0
14180,28,0,0,70,70,0,1,0,1,0
8549,28,0,0,66,66,0,1,0,1,0
18207,28,0,0,70,70,0,1,0,1,0
9707,28,0,0,66,66,0,1,0,1,0
10191,28,0,0,70,70,0,1,0,1,0
9809,28,0,0,66,66,0,1,0,1,0
16043,28,0,0,66,66,0,1,0,1,0
17560,28,0,0,70,70,0,1,0,1,0
17549,28,0,0,66,66,0,1,0,1,0
9055,28,0,0,66,66,0,1,0,1,0
22451,28,0,0,70,70,0,1,0,1,0
10424,28,0,0,70,70,0,1,0,1,0
20592,28,0,0,70,70,0,1,0,1,0
9830,28,0,0,70,70,0,1,0,1,0
21569,28,0,0,69,69,0,1,0,1,0
10943,28,0,0,69,69,0,1,0,1,0
21406,28,0,0,70,70,0,1,0,1,0
13665,28,0,0,70,70,0,1,0,1,0
14056,28,0,0,66,66,0,1,0,1,0
16904,28,0,0,70,70,0,1,0,1,0
20780,28,0,0,66,66,0,1,0,1,0
14043,28,0,0,70,70,0,1,0,1,0
14367,28,0,0,66,66,0,1,0,1,0
9315,28,0,0,70,70,0,1,0,1,0
14544,28,0,0,68,68,0,1,0,1,0
10344,28,0,0,66,66,0,1,0,1,0
14037,28,0,0,66,66,0,1,0,1,0
13657,28,0,0,70,70,0,1,0,1,0
14987,28,0,0,70,70,0,1,0,1,0
8534,28,0,0,70,70,0,1,0,1,0
19069,28,0,0,70,70,0,1,0,1,0
8324,28,0,0,67,67,0,1,0,1,0
13221,28,0,0,66,66,0,1,0,1,0
10336,28,0,0,69,69,0,1,0,1,0
12750,28,0,0,66,66,0,1,0,1,0
13937,28,0,0,66,66,0,1,0,1,0
17192,28,0,0,68,68,0,1,0,1,0
13943,28,0,0,70,70,0,1,0,1,0
17600,28,0,0,68,68,0,1,0,1,0
20815,28,0,0,66,66,0,1,0,1,0
15859,28,0,0,66,66,0,1,0,1,0
10041,28,0,0,70,70,0,1,0,1,0
11826,28,0,0,66,66,0,1,0,1,0
9973,28,0,0,70,70,0,1,0,1,0
11841,28,0,0,70,70,0,1,0,1,0
21672,28,0,0,70,70,0,1,0,1,0
19579,28,0,0,70,70,0,1,0,1,0
19112,28,0,0,67,67,0,1,0,1,0
12595,28,0,0,66,66,0,1,0,1,0
20982,28,0,0,70,70,0,1,0,1,0
13225,28,0,0,68,68,0,1,0,1,0
20396,28,0,0,67,67,0,1,0,1,0
13374,28,0,0,70,70,0,1,0,1,0
10857,28,0,0,66,66,0,1,0,1,0
21223,28,0,0,70,70,0,1,0,1,0
20597,28,0,0,66,66,0,1,0,1,0
18331,28,0,0,69,69,0,1,0,1,0
9344,28,0,0,70,70,0,1,0,1,0
19621,28,0,0,70,70,0,1,0,1,0
16232,28,0,0,70,70,0,1,0,1,0
21693,28,0,0,70,70,0,1,0,1,0
15683,28,0,0,70,70,0,1,0,1,0
15055,28,0,0,70,70,0,1,0,1,0
12341,28,0,0,66,66,0,1,0,1,0
9541,28,0,0,70,70,0,1,0,1,0
9104,28,0,0,70,70,0,1,0,1,0
14899,28,0,0,70,70,0,1,0,1,0
15410,28,0,0,70,70,0,1,0,1,0
15772,28,0,0,70,70,0,1,0,1,0
17201,28,0,0,70,70,0,1,0,1,0
20592,28,0,0,66,66,0,1,0,1,0
9251,28,0,0,70,70,0,1,0,1,0
21283,28,0,0,70,70,0,1,0,1,0
8544,28,0,0,69,69,0,1,0,1,0
20483,28,0,0,70,70,0,1,0,1,0
18676,28,0,0,66,66,0,1,0,1,0
9224,28,0,0,70,70,0,1,0,1,0
17976,28,0,0,70,70,0,1,0,1,0
21031,28,0,0,66,66,0,1,0,1,0
22245,28,0,0,67,67,0,1,0,1,0
17274,28,0,0,70,70,0,1,0,1,0
14001,28,0,0,70,70,0,1,0,1,0
11485,28,0,0,70,70,0,1,0,1,0
15718,28,0,0,70,70,0,1,0,1,0
10082,28,0,0,70,70,0,1,0,1,0
12759,28,0,0,70,70,0,1,0,1,0
8354,28,0,0,67,67,0,1,0,1,0
21365,28,0,0,68,68,0,1,0,1,0
9946,28,0,0,66,66,0,1,0,1,0
16236,28,0,0,66,66,0,1,0,1,0
17078,28,0,0,70,70,0,1,0,1,0
21245,28,0,0,67,67,0,1,0,1,0
17730,28,0,0,66,66,0,1,0,1,0
20572,28,0,0,70,70,0,1,0,1,0
10812,28,0,0,70,70,0,1,0,1,0
9225,28,0,0,70,70,0,1,0,1,0
12343,28,0,0,66,66,0,1,0,1,0
9161,28,0,0,67,67,0,1,0,1,0
18108,28,0,0,70,70,0,1,0,1,0
10583,28,0,0,70,70,0,1,0,1,0
10423,28,0,0,66,66,0,1,0,1,0
19881,28,0,0,70,70,0,1,0,1,0
21598,28,0,0,70,70,0,1,0,1,0
12218,28,0,0,70,70,0,1,0,1,0
13757,28,0,0,66,66,0,1,0,1,0
17189,28,0,0,66,66,0,1,0,1,0
17540,28,0,0,70,70,0,1,0,1,0
19872,28,0,0,70,70,0,1,0,1,0
15792,28,0,0,70,70,0,1,0,1,0
10414,28,0,0,70,70,0,1,0,1,0
10423,28,0,0,70,70,0,1,0,1,0
18205,28,0,0,66,66,0,1,0,1,0
10273,28,0,0,70,70,0,1,0,1,0
18403,28,0,0,70,70,0,1,0,1,0
20525,28,0,0,66,66,0,1,0,1,0
15347,28,0,0,70,70,0,1,0,1,0
15205,28,0,0,66,66,0,1,0,1,0
12355,28,0,0,70,70,0,1,0,1,0
15838,28,0,0,70,70,0,1,0,1,0
11639,28,0,0,70,70,0,1,0,1,0
18895,28,0,0,66,66,0,1,0,1,0
20022,28,0,0,66,66,0,1,0,1,0
20226,28,0,0,66,66,0,1,0,1,0
10151,28,0,0,70,70,0,1,0,1,0
17014,28,0,0,67,67,0,1,0,1,0
16945,28,0,0,70,70,0,1,0,1,0
21434,28,0,0,66,66,0,1,0,1,0
20514,28,0,0,68,68,0,1,0,1,0
21659,28,0,0,70,70,0,1,0,1,0
12885,28,0,0,66,66,0,1,0,1,0
9918,28,0,0,70,70,0,1,0,1,0
15026,28,0,0,67,67,0,1,0,1,0
15088,28,0,0,70,70,0,1,0,1,0
9939,28,0,0,70,70,0,1,0,1,0
16443,28,0,0,70,70,0,1,0,1,0
17268,28,0,0,70,70,0,1,0,1,0
13251,28,0,0,70,70,0,1,0,1,0
21138,28,0,0,70,70,0,1,0,1,0
16654,28,0,0,68,68,0,1,0,1,0
21391,28,0,0,70,70,0,1,0,1,0
15251,28,0,0,70,70,0,1,0,1,0
15690,28,0,0,70,70,0,1,0,1,0
14437,28,0,0,70,70,0,1,0,1,0
21170,28,0,0,70,70,0,1,0,1,0
17470,28,0,0,68,68,0,1,0,1,0
11595,28,0,0,70,70,0,1,0,1,0
19044,28,0,0,70,70,0,1,0,1,0
16839,28,0,0,70,70,0,1,0,1,0
15427,28,0,0,70,70,0,1,0,1,0
14622,28,0,0,70,70,0,1,0,1,0
9444,28,0,0,70,70,0,1,0,1,0
14503,28,0,0,66,66,0,1,0,1,0
22281,28,0,0,70,70,0,1,0,1,0
13924,28,0,0,70,70,0,1,0,1,0
12642,28,0,0,70,70,0,1,0,1,0
21295,28,0,0,66,66,0,1,0,1,0
14982,28,0,0,68,68,0,1,0,1,0
22550,28,0,0,70,70,0,1,0,1,0
13544,28,0,0,70,70,0,1,0,1,0
10176,28,0,0,66,66,0,1,0,1,0
22148,28,0,0,66,66,0,1,0,1,0
14056,28,0,0,66,66,0,1,0,1,0
22608,28,0,0,68,68,0,1,0,1,0
17835,28,0,0,70,70,0,1,0,1,0
13723,28,0,0,70,70,0,1,0,1,0
11359,28,0,0,66,66,0,1,0,1,0
12899,28,0,0,70,70,0,1,0,1,0
18741,28,0,0,70,70,0,1,0,1,0
20005,28,0,0,70,70,0,1,0,1,0
11646,28,0,0,70,70,0,1,0,1,0
16351,28,0,0,70,70,0,1,0,1,0
14689,28,0,0,70,70,0,1,0,1,0
17241,28,0,0,66,66,0,1,0,1,0
15394,28,0,0,66,66,0,1,0,1,0
16253,28,0,0,70,70,0,1,0,1,0
21095,28,0,0,68,68,0,1,0,1,0
17693,28,0,0,69,69,0,1,0,1,0
22271,28,0,0,66,66,0,1,0,1,0
21488,28,0,0,70,70,0,1,0,1,0
21706,28,0,0,66,66,0,1,0,1,0
16450,28,0,0,67,67,0,1,0,1,0
10253,28,0,0,70,70,0,1,0,1,0
11665,28,0,0,66,66,0,1,0,1,0
14135,28,0,0,68,68,0,1,0,1,0
12239,28,0,0,66,66,0,1,0,1,0
16793,28,0,0,66,66,0,1,0,1,0
22276,28,0,0,70,70,0,1,0,1,0
21855,28,0,0,70,70,0,1,0,1,0
18821,28,0,0,66,66,0,1,0,1,0
13687,28,0,0,66,66,0,1,0,1,0
12415,28,0,0,70,70,0,1,0,1,0
9981,28,0,0,70,70,0,1,0,1,0
11911,28,0,0,69,69,0,1,0,1,0
21736,28,0,0,70,70,0,1,0,1,0
20891,28,0,0,70,70,0,1,0,1,0
11323,28,0,0,70,70,0,1,0,1,0
14430,28,0,0,66,66,0,1,0,1,0
16540,28,0,0,70,70,0,1,0,1,0
18519,28,0,0,70,70,0,1,0,1,0
10681,28,0,0,70,70,0,1,0,1,0
10282,28,0,0,70,70,0,1,0,1,0
17973,28,0,0,70,70,0,1,0,1,0
18620,28,0,0,66,66,0,1,0,1,0
17216,28,0,0,66,66,0,1,0,1,0
21478,28,0,0,70,70,0,1,0,1,0
12497,28,0,0,70,70,0,1,0,1,0
12950,28,0,0,69,69,0,1,0,1,0
16353,28,0,0,66,66,0,1,0,1,0
9038,28,0,0,70,70,0,1,0,1,0
10246,28,0,0,69,69,0,1,0,1,0
19441,28,0,0,70,70,0,1,0,1,0
15406,28,0,0,70,70,0,1,0,1,0
19019,28,0,0,66,66,0,1,0,1,0
16293,28,0,0,66,66,0,1,0,1,0
17405,28,0,0,70,70,0,1,0,1,0
15375,28,0,0,70,70,0,1,0,1,0
15206,28,0,0,66,66,0,1,0,1,0
20815,28,0,0,70,70,0,1,0,1,0
21532,28,0,0,70,70,0,1,0,1,0
20831,28,0,0,66,66,0,1,0,1,0
19653,28,0,0,66,66,0,1,0,1,0
22043,28,0,0,70,70,0,1,0,1,0
9343,28,0,0,70,70,0,1,0,1,0
14923,28,0,0,70,70,0,1,0,1,0
21148,28,0,0,70,70,0,1,0,1,0
15913,28,0,0,70,70,0,1,0,1,0
15802,28,0,0,70,70,0,1,0,1,0
11472,28,0,0,70,70,0,1,0,1,0
22484,28,0,0,70,70,0,1,0,1,0
19371,28,0,0,70,70,0,1,0,1,0
22075,28,0,0,66,66,0,1,0,1,0
11542,28,0,0,70,70,0,1,0,1,0
20118,28,0,0,67,67,0,1,0,1,0
14283,28,0,0,70,70,0,1,0,1,0
17733,28,0,0,67,67,0,1,0,1,0
9408,28,0,0,70,70,0,1,0,1,0
8946,28,0,0,70,70,0,1,0,1,0
19926,28,0,0,67,67,0,1,0,1,0
18932,28,0,0,67,67,0,1,0,1,0
15703,28,0,0,70,70,0,1,0,1,0
17596,28,0,0,66,66,0,1,0,1,0
18896,28,0,0,69,69,0,1,0,1,0
17255,28,0,0,70,70,0,1,0,1,0
18834,28,0,0,66,66,0,1,0,1,0
13150,28,0,0,70,70,0,1,0,1,0
13252,28,0,0,70,70,0,1,0,1,0
21585,28,0,0,70,70,0,1,0,1,0
19370,28,0,0,70,70,0,1,0,1,0
21184,28,0,0,66,66,0,1,0,1,0
17412,28,0,0,66,66,0,1,0,1,0
18305,28,0,0,70,70,0,1,0,1,0
21045,28,0,0,70,70,0,1,0,1,0
13474,28,0,0,67,67,0,1,0,1,0
11143,28,0,0,66,66,0,1,0,1,0
13356,28,0,0,70,70,0,1,0,1,0
14435,28,0,0,68,68,0,1,0,1,0
16650,28,0,0,66,66,0,1,0,1,0
20242,28,0,0,70,70,0,1,0,1,0
9280,28,0,0,70,70,0,1,0,1,0
9617,28,0,0,66,66,0,1,0,1,0
11943,28,0,0,70,70,0,1,0,1,0
21922,28,0,0,70,70,0,1,0,1,0
19196,28,0,0,66,66,0,1,0,1,0
9863,28,0,0,66,66,0,1,0,1,0
19653,28,0,0,66,66,0,1,0,1,0
9134,28,0,0,66,66,0,1,0,1,0
22436,28,0,0,70,70,0,1,0,1,0
13692,28,0,0,70,70,0,1,0,1,0
8548,28,0,0,66,66,0,1,0,1,0
15886,28,0,0,69,69,0,1,0,1,0
16664,28,0,0,67,67,0,1,0,1,0
19182,28,0,0,70,70,0,1,0,1,0
16431,28,0,0,68,68,0,1,0,1,0
13247,28,0,0,70,70,0,1,0,1,0
9955,28,0,0,66,66,0,1,0,1,0
10492,28,0,0,70,70,0,1,0,1,0
14285,28,0,0,70,70,0,1,0,1,0
15129,28,0,0,70,70,0,1,0,1,0
22517,28,0,0,69,69,0,1,0,1,0
11118,28,0,0,70,70,0,1,0,1,0
17906,28,0,0,70,70,0,1,0,1,0
12061,28,0,0,66,66,0,1,0,1,0
10436,28,0,0,70,70,0,1,0,1,0
13566,28,0,0,66,66,0,1,0,1,0
10310,28,0,0,70,70,0,1,0,1,0
16161,28,0,0,70,70,0,1,0,1,0
20085,28,0,0,70,70,0,1,0,1,0
20477,28,0,0,66,66,0,1,0,1,0
10474,28,0,0,70,70,0,1,0,1,0
19783,28,0,0,70,70,0,1,0,1,0
17358,28,0,0,66,66,0,1,0,1,0
11209,28,0,0,70,70,0,1,0,1,0
22472,28,0,0,67,67,0,1,0,1,0
11346,28,0,0,70,70,0,1,0,1,0
22570,28,0,0,70,70,0,1,0,1,0
19878,28,0,0,70,70,0,1,0,1,0
17921,28,0,0,70,70,0,1,0,1,0
14673,28,0,0,70,70,0,1,0,1,0
17696,28,0,0,70,70,0,1,0,1,0
8432,28,0,0,68,68,0,1,0,1,0
11841,28,0,0,66,66,0,1,0,1,0
21872,28,0,0,70,70,0,1,0,1,0
10361,28,0,0,70,70,0,1,0,1,0
21326,28,0,0,70,70,0,1,0,1,0
19298,28,0,0,70,70,0,1,0,1,0
16839,28,0,0,70,70,0,1,0,1,0
15280,28,0,0,69,69,0,1,0,1,0
9654,28,0,0,70,70,0,1,0,1,0
22132,28,0,0,66,66,0,1,0,1,0
12169,28,0,0,70,70,0,1,0,1,0
15592,28,0,0,66,66,0,1,0,1,0
12951,28,0,0,66,66,0,1,0,1,0
16740,28,0,0,66,66,0,1,0,1,0
13811,28,0,0,66,66,0,1,0,1,0
10576,28,0,0,67,67,0,1,0,1,0
20254,28,0,0,70,70,0,1,0,1,0
14340,28,0,0,70,70,0,1,0,1,0
17193,28,0,0,68,68,0,1,0,1,0
10783,28,0,0,70,70,0,1,0,1,0
18591,28,0,0,70,70,0,1,0,1,0
17307,28,0,0,70,70,0,1,0,1,0
22337,28,0,0,66,66,0,1,0,1,0
19544,28,0,0,70,70,0,1,0,1,0
13200,28,0,0,70,70,0,1,0,1,0
19874,28,0,0,70,70,0,1,0,1,0
13777,28,0,0,70,70,0,1,0,1,0
21331,28,0,0,70,70,0,1,0,1,0
17943,28,0,0,70,70,0,1,0,1,0
17521,28,0,0,66,66,0,1,0,1,0
12062,28,0,0,66,66,0,1,0,1,0
13269,28,0,0,70,70,0,1,0,1,0
21626,28,0,0,69,69,0,1,0,1,0
10030,28,0,0,70,70,0,1,0,1,0
10530,28,0,0,70,70,0,1,0,1,0
13878,28,0,0,70,70,0,1,0,1,0
12238,28,0,0,66,66,0,1,0,1,0
10148,28,0,0,70,70,0,1,0,1,0
15123,28,0,0,70,70,0,1,0,1,0
10029,28,0,0,70,70,0,1,0,1,0
20956,28,0,0,68,68,0,1,0,1,0
10450,28,0,0,70,70,0,1,0,1,0
20171,28,0,0,70,70,0,1,0,1,0
11772,28,0,0,66,66,0,1,0,1,0
10794,28,0,0,67,67,0,1,0,1,0
9372,28,0,0,70,70,0,1,0,1,0
8941,28,0,0,66,66,0,1,0,1,0
18197,28,0,0,66,66,0,1,0,1,0
20698,28,0,0,70,70,0,1,0,1,0
12982,28,0,0,69,69,0,1,0,1,0
20273,28,0,0,67,67,0,1,0,1,0
20447,28,0,0,70,70,0,1,0,1,0
9203,28,0,0,70,70,0,1,0,1,0
17158,28,0,0,66,66,0,1,0,1,0
14134,28,0,0,66,66,0,1,0,1,0
9716,28,0,0,70,70,0,1,0,1,0
21802,28,0,0,70,70,0,1,0,1,0
15029,28,0,0,66,66,0,1,0,1,0
14683,28,0,0,66,66,0,1,0,1,0
20784,28,0,0,66,66,0,1,0,1,0
15033,28,0,0,69,69,0,1,0,1,0
13511,28,0,0,70,70,0,1,0,1,0
19404,28,0,0,66,66,0,1,0,1,0
13969,28,0,0,70,70,0,1,0,1,0
11515,28,0,0,66,66,0,1,0,1,0
11958,28,0,0,70,70,0,1,0,1,0
14664,28,0,0,66,66,0,1,0,1,0
11317,28,0,0,67,67,0,1,0,1,0
8575,28,0,0,70,70,0,1,0,1,0
9578,28,0,0,66,66,0,1,0,1,0
9704,28,0,0,70,70,0,1,0,1,0
10184,28,0,0,69,69,0,1,0,1,0
11432,28,0,0,70,70,0,1,0,1,0
18852,28,0,0,70,70,0,1,0,1,0
17824,28,0,0,70,70,0,1,0,1,0
22384,28,0,0,70,70,0,1,0,1,0
13308,28,0,0,70,70,0,1,0,1,0
19527,28,0,0,70,70,0,1,0,1,0
9506,28,0,0,70,70,0,1,0,1,0
22500,28,0,0,67,67,0,1,0,1,0
9343,28,0,0,70,70,0,1,0,1,0
8990,28,0,0,66,66,0,1,0,1,0
19942,28,0,0,66,66,0,1,0,1,0
12776,28,0,0,66,66,0,1,0,1,0
16555,28,0,0,68,68,0,1,0,1,0
13236,28,0,0,66,66,0,1,0,1,0
15089,28,0,0,66,66,0,1,0,1,0
10715,28,0,0,66,66,0,1,0,1,0
10378,28,0,0,70,70,0,1,0,1,0
16634,28,0,0,70,70,0,1,0,1,0
14458,28,0,0,70,70,0,1,0,1,0
20852,28,0,0,70,70,0,1,0,1,0
12585,28,0,0,70,70,0,1,0,1,0
19116,28,0,0,70,70,0,1,0,1,0
12817,28,0,0,70,70,0,1,0,1,0
11562,28,0,0,66,66,0,1,0,1,0
10890,28,0,0,70,70,0,1,0,1,0
15727,28,0,0,70,70,0,1,0,1,0
10911,28,0,0,66,66,0,1,0,1,0
17445,28,0,0,67,67,0,1,0,1,0
15164,28,0,0,70,70,0,1,0,1,0
9042,28,0,0,68,68,0,1,0,1,0
9600,28,0,0,70,70,0,1,0,1,0
18438,28,0,0,70,70,0,1,0,1,0
17519,28,0,0,67,67,0,1,0,1,0
9466,28,0,0,70,70,0,1,0,1,0
16556,28,0,0,69,69,0,1,0,1,0
19372,28,0,0,70,70,0,1,0,1,0
22068,28,0,0,70,70,0,1,0,1,0
13685,28,0,0,70,70,0,1,0,1,0
10738,28,0,0,70,70,0,1,0,1,0
14583,28,0,0,70,70,0,1,0,1,0
19581,28,0,0,66,66,0,1,0,1,0
12642,28,0,0,70,70,0,1,0,1,0
16785,28,0,0,70,70,0,1,0,1,0
12621,28,0,0,70,70,0,1,0,1,0
22705,28,0,0,70,70,0,1,0,1,0
17743,28,0,0,66,66,0,1,0,1,0
14725,28,0,0,70,70,0,1,0,1,0
14335,28,0,0,68,68,0,1,0,1,0
9064,28,0,0,70,70,0,1,0,1,0
19210,28,0,0,66,66,0,1,0,1,0
16828,28,0,0,70,70,0,1,0,1,0
18115,28,0,0,70,70,0,1,0,1,0
9303,28,0,0,66,66,0,1,0,1,0
17822,28,0,0,70,70,0,1,0,1,0
9014,28,0,0,70,70,0,1,0,1,0
16712,28,0,0,70,70,0,1,0,1,0
20597,28,0,0,69,69,0,1,0,1,0
17674,28,0,0,68,68,0,1,0,1,0
12345,28,0,0,66,66,0,1,0,1,0
10622,28,0,0,70,70,0,1,0,1,0
20036,28,0,0,70,70,0,1,0,1,0
15512,28,0,0,70,70,0,1,0,1,0
16943,28,0,0,66,66,0,1,0,1,0
14371,28,0,0,70,70,0,1,0,1,0
22259,28,0,0,66,66,0,1,0,1,0
16233,28,0,0,70,70,0,1,0,1,0
19182,28,0,0,70,70,0,1,0,1,0
12346,28,0,0,66,66,0,1,0,1,0
19187,28,0,0,66,66,0,1,0,1,0
16886,28,0,0,70,70,0,1,0,1,0
14303,28,0,0,70,70,0,1,0,1,0
13905,28,0,0,70,70,0,1,0,1,0
10782,28,0,0,70,70,0,1,0,1,0
21085,28,0,0,70,70,0,1,0,1,0
22513,28,0,0,66,66,0,1,0,1,0
14025,28,0,0,70,70,0,1,0,1,0
19210,28,0,0,66,66,0,1,0,1,0
14765,28,0,0,67,67,0,1,0,1,0
15789,28,0,0,70,70,0,1,0,1,0
13943,28,0,0,70,70,0,1,0,1,0
20580,28,0,0,70,70,0,1,0,1,0
22427,28,0,0,70,70,0,1,0,1,0
21655,28,0,0,69,69,0,1,0,1,0
17953,28,0,0,70,70,0,1,0,1,0
18074,28,0,0,66,66,0,1,0,1,0
8943,28,0,0,66,66,0,1,0,1,0
10060,28,0,0,66,66,0,1,0,1,0
13375,28,0,0,66,66,0,1,0,1,0
19910,28,0,0,70,70,0,1,0,1,0
9938,28,0,0,66,66,0,1,0,1,0
21205,28,0,0,70,70,0,1,0,1,0
11119,28,0,0,70,70,0,1,0,1,0
19457,28,0,0,69,69,0,1,0,1,0
11666,28,0,0,70,70,0,1,0,1,0
11941,28,0,0,70,70,0,1,0,1,0
19193,28,0,0,66,66,0,1,0,1,0
15528,28,0,0,70,70,0,1,0,1,0
19942,28,0,0,70,70,0,1,0,1,0
11104,28,0,0,70,70,0,1,0,1,0
19607,28,0,0,66,66,0,1,0,1,0
20527,28,0,0,69,69,0,1,0,1,0
18091,28,0,0,66,66,0,1,0,1,0
20971,28,0,0,66,66,0,1,0,1,0
17700,28,0,0,66,66,0,1,0,1,0
20572,28,0,0,70,70,0,1,0,1,0
13469,28,0,0,66,66,0,1,0,1,0
19318,28,0,0,70,70,0,1,0,1,0
11675,28,0,0,70,70,0,1,0,1,0
20341,28,0,0,66,66,0,1,0,1,0
13270,28,0,0,68,68,0,1,0,1,0
20429,28,0,0,70,70,0,1,0,1,0
9509,28,0,0,68,68,0,1,0,1,0
11022,28,0,0,66,66,0,1,0,1,0
14307,28,0,0,66,66,0,1,0,1,0
22058,28,0,0,70,70,0,1,0,1,0
10783,28,0,0,70,70,0,1,0,1,0
17563,28,0,0,67,67,0,1,0,1,0
20459,28,0,0,70,70,0,1,0,1,0
12827,28,0,0,70,70,0,1,0,1,0
18441,28,0,0,67,67,0,1,0,1,0
19951,28,0,0,70,70,0,1,0,1,0
9418,28,0,0,70,70,0,1,0,1,0
9006,28,0,0,66,66,0,1,0,1,0
12525,28,0,0,70,70,0,1,0,1,0
14564,28,0,0,70,70,0,1,0,1,0
22629,28,0,0,70,70,0,1,0,1,0
15555,28,0,0,67,67,0,1,0,1,0
21032,28,0,0,69,69,0,1,0,1,0
10450,28,0,0,68,68,0,1,0,1,0
15064,28,0,0,70,70,0,1,0,1,0
15343,28,0,0,70,70,0,1,0,1,0
9758,28,0,0,70,70,0,1,0,1,0
12375,28,0,0,70,70,0,1,0,1,0
17409,28,0,0,66,66,0,1,0,1,0
12250,28,0,0,70,70,0,1,0,1,0
20391,28,0,0,70,70,0,1,0,1,0
16277,28,0,0,66,66,0,1,0,1,0
12928,28,0,0,70,70,0,1,0,1,0
10180,28,0,0,66,66,0,1,0,1,0
16396,28,0,0,66,66,0,1,0,1,0
9855,28,0,0,70,70,0,1,0,1,0
14194,28,0,0,70,70,0,1,0,1,0
20591,28,0,0,66,66,0,1,0,1,0
9071,28,0,0,70,70,0,1,0,1,0
15577,28,0,0,70,70,0,1,0,1,0
11868,28,0,0,68,68,0,1,0,1,0
11940,28,0,0,66,66,0,1,0,1,0
9435,28,0,0,66,66,0,1,0,1,0
22357,28,0,0,70,70,0,1,0,1,0
11686,28,0,0,70,70,0,1,0,1,0
14585,28,0,0,70,70,0,1,0,1,0
12114,28,0,0,69,69,0,1,0,1,0
20543,28,0,0,66,66,0,1,0,1,0
15290,28,0,0,70,70,0,1,0,1,0
16796,28,0,0,69,69,0,1,0,1,0
21626,28,0,0,69,69,0,1,0,1,0
16730,28,0,0,70,70,0,1,0,1,0
15471,28,0,0,70,70,0,1,0,1,0
12368,28,0,0,70,70,0,1,0,1,0
20186,28,0,0,67,67,0,1,0,1,0
8493,28,0,0,70,70,0,1,0,1,0
21705,28,0,0,70,70,0,1,0,1,0
16596,28,0,0,66,66,0,1,0,1,0
8394,28,0,0,70,70,0,1,0,1,0
14473,28,0,0,66,66,0,1,0,1,0
11195,28,0,0,67,67,0,1,0,1,0
20240,28,0,0,70,70,0,1,0,1,0
15348,28,0,0,68,68,0,1,0,1,0
10164,28,0,0,70,70,0,1,0,1,0
16304,28,0,0,69,69,0,1,0,1,0
16634,28,0,0,70,70,0,1,0,1,0
12993,28,0,0,66,66,0,1,0,1,0
8397,28,0,0,70,70,0,1,0,1,0
8674,28,0,0,69,69,0,1,0,1,0
16856,28,0,0,70,70,0,1,0,1,0
9227,28,0,0,70,70,0,1,0,1,0
12878,28,0,0,70,70,0,1,0,1,0
22443,28,0,0,70,70,0,1,0,1,0
9133,28,0,0,66,66,0,1,0,1,0
17390,28,0,0,69,69,0,1,0,1,0
19703,28,0,0,68,68,0,1,0,1,0
16015,28,0,0,66,66,0,1,0,1,0
15512,28,0,0,70,70,0,1,0,1,0
14868,28,0,0,70,70,0,1,0,1,0
14944,28,0,0,70,70,0,1,0,1,0
16071,28,0,0,66,66,0,1,0,1,0
12770,28,0,0,67,67,0,1,0,1,0
21099,28,0,0,67,67,0,1,0,1,0
20808,28,0,0,70,70,0,1,0,1,0
18751,28,0,0,70,70,0,1,0,1,0
20224,28,0,0,67,67,0,1,0,1,0
14398,28,0,0,68,68,0,1,0,1,0
15588,28,0,0,66,66,0,1,0,1,0
11334,28,0,0,70,70,0,1,0,1,0
18182,28,0,0,66,66,0,1,0,1,0
13144,28,0,0,70,70,0,1,0,1,0
14657,28,0,0,70,70,0,1,0,1,0
21019,28,0,0,66,66,0,1,0,1,0
9880,28,0,0,70,70,0,1,0,1,0
9776,28,0,0,69,69,0,1,0,1,0
12560,28,0,0,70,70,0,1,0,1,0
19774,28,0,0,66,66,0,1,0,1,0
10017,28,0,0,66,66,0,1,0,1,0
18051,28,0,0,67,67,0,1,0,1,0
15510,28,0,0,70,70,0,1,0,1,0
9188,28,0,0,70,70,0,1,0,1,0
9580,28,0,0,69,69,0,1,0,1,0
14249,28,0,0,70,70,0,1,0,1,0
14241,28,0,0,66,66,0,1,0,1,0
16357,28,0,0,70,70,0,1,0,1,0
17672,28,0,0,69,69,0,1,0,1,0
11296,28,0,0,69,69,0,1,0,1,0
15577,28,0,0,70,70,0,1,0,1,0
20748,28,0,0,66,66,0,1,0,1,0
20636,28,0,0,67,67,0,1,0,1,0
15219,28,0,0,66,66,0,1,0,1,0
19063,28,0,0,66,66,0,1,0,1,0
8998,28,0,0,70,70,0,1,0,1,0
18500,28,0,0,66,66,0,1,0,1,0
15887,28,0,0,66,66,0,1,0,1,0
12376,28,0,0,70,70,0,1,0,1,0
22142,28,0,0,70,70,0,1,0,1,0
8368,28,0,0,66,66,0,1,0,1,0
18540,28,0,0,68,68,0,1,0,1,0
11603,28,0,0,70,70,0,1,0,1,0
11547,28,0,0,70,70,0,1,0,1,0
18626,28,0,0,70,70,0,1,0,1,0
20022,28,0,0,66,66,0,1,0,1,0
15347,28,0,0,70,70,0,1,0,1,0
10384,28,0,0,70,70,0,1,0,1,0
21662,28,0,0,70,70,0,1,0,1,0
16556,28,0,0,69,69,0,1,0,1,0
9269,28,0,0,70,70,0,1,0,1,0
15775,28,0,0,70,70,0,1,0,1,0
12722,28,0,0,66,66,0,1,0,1,0
12179,28,0,0,66,66,0,1,0,1,0
14267,28,0,0,70,70,0,1,0,1,0
19749,28,0,0,70,70,0,1,0,1,0
11185,28,0,0,66,66,0,1,0,1,0
19120,28,0,0,70,70,0,1,0,1,0
16796,28,0,0,70,70,0,1,0,1,0
17663,28,0,0,70,70,0,1,0,1,0
19616,28,0,0,70,70,0,1,0,1,0
20694,28,0,0,67,67,0,1,0,1,0
9171,28,0,0,70,70,0,1,0,1,0
10624,28,0,0,70,70,0,1,0,1,0
16805,28,0,0,70,70,0,1,0,1,0
13644,28,0,0,70,70,0,1,0,1,0
14049,28,0,0,70,70,0,1,0,1,0
9184,28,0,0,66,66,0,1,0,1,0
8750,28,0,0,66,66,0,1,0,1,0
16956,28,0,0,70,70,0,1,0,1,0
16347,28,0,0,70,70,0,1,0,1,0
9817,28,0,0,66,66,0,1,0,1,0
14943,28,0,0,70,70,0,1,0,1,0
11566,28,0,0,68,68,0,1,0,1,0
12716,28,0,0,70,70,0,1,0,1,0
15547,28,0,0,70,70,0,1,0,1,0
9836,28,0,0,70,70,0,1,0,1,0
14862,28,0,0,66,66,0,1,0,1,0
20313,28,0,0,70,70,0,1,0,1,0
8454,28,0,0,68,68,0,1,0,1,0
15409,28,0,0,70,70,0,1,0,1,0
12511,28,0,0,70,70,0,1,0,1,0
21832,28,0,0,70,70,0,1,0,1,0
17432,28,0,0,67,67,0,1,0,1,0
11122,28,0,0,67,67,0,1,0,1,0
16425,28,0,0,70,70,0,1,0,1,0
11718,28,0,0,70,70,0,1,0,1,0
9794,28,0,0,70,70,0,1,0,1,0
20381,28,0,0,66,66,0,1,0,1,0
16655,28,0,0,66,66,0,1,0,1,0
12372,28,0,0,70,70,0,1,0,1,0
11439,28,0,0,69,69,0,1,0,1,0
16776,28,0,0,70,70,0,1,0,1,0
12948,28,0,0,70,70,0,1,0,1,0
12510,28,0,0,70,70,0,1,0,1,0
10162,28,0,0,70,70,0,1,0,1,0
9763,28,0,0,70,70,0,1,0,1,0
19501,28,0,0,70,70,0,1,0,1,0
17639,28,0,0,66,66,0,1,0,1,0
9546,28,0,0,66,66,0,1,0,1,0
12837,28,0,0,70,70,0,1,0,1,0
12111,28,0,0,66,66,0,1,0,1,0
17699,28,0,0,66,66,0,1,0,1,0
18414,28,0,0,70,70,0,1,0,1,0
11657,28,0,0,70,70,0,1,0,1,0
21722,28,0,0,66,66,0,1,0,1,0
18819,28,0,0,69,69,0,1,0,1,0
8873,28,0,0,70,70,0,1,0,1,0
9700,28,0,0,70,70,0,1,0,1,0
22693,28,0,0,70,70,0,1,0,1,0
15291,28,0,0,70,70,0,1,0,1,0
17045,28,0,0,69,69,0,1,0,1,0
15719,28,0,0,68,68,0,1,0,1,0
9192,28,0,0,70,70,0,1,0,1,0
13906,28,0,0,70,70,0,1,0,1,0
17886,28,0,0,70,70,0,1,0,1,0
13739,28,0,0,70,70,0,1,0,1,0
9938,28,0,0,66,66,0,1,0,1,0
9869,28,0,0,68,68,0,1,0,1,0
11704,28,0,0,68,68,0,1,0,1,0
10452,28,0,0,66,66,0,1,0,1,0
13237,28,0,0,69,69,0,1,0,1,0
16193,28,0,0,70,70,0,1,0,1,0
18557,28,0,0,68,68,0,1,0,1,0
17086,28,0,0,68,68,0,1,0,1,0
16214,28,0,0,70,70,0,1,0,1,0
8539,28,0,0,70,70,0,1,0,1,0
19697,28,0,0,70,70,0,1,0,1,0
10380,28,0,0,70,70,0,1,0,1,0
9694,28,0,0,70,70,0,1,0,1,0
16194,28,0,0,66,66,0,1,0,1,0
9692,28,0,0,70,70,0,1,0,1,0
14964,28,0,0,70,70,0,1,0,1,0
9730,28,0,0,70,70,0,1,0,1,0
18683,28,0,0,66,66,0,1,0,1,0
17562,28,0,0,70,70,0,1,0,1,0
13917,28,0,0,66,66,0,1,0,1,0
18649,28,0,0,70,70,0,1,0,1,0
21952,28,0,0,70,70,0,1,0,1,0
18645,28,0,0,70,70,0,1,0,1,0
13270,28,0,0,66,66,0,1,0,1,0
16510,28,0,0,66,66,0,1,0,1,0
10489,28,0,0,70,70,0,1,0,1,0
19940,28,0,0,70,70,0,1,0,1,0
14025,28,0,0,70,70,0,1,0,1,0
20962,28,0,0,70,70,0,1,0,1,0
13357,28,0,0,69,69,0,1,0,1,0
18241,28,0,0,66,66,0,1,0,1,0
13861,28,0,0,66,66,0,1,0,1,0
20139,28,0,0,70,70,0,1,0,1,0
18346,28,0,0,70,70,0,1,0,1,0
14814,28,0,0,66,66,0,1,0,1,0
14824,28,0,0,70,70,0,1,0,1,0
13791,28,0,0,70,70,0,1,0,1,0
17306,28,0,0,70,70,0,1,0,1,0
14055,28,0,0,70,70,0,1,0,1,0
14496,28,0,0,66,66,0,1,0,1,0
20900,28,0,0,70,70,0,1,0,1,0
11407,28,0,0,66,66,0,1,0,1,0
12885,28,0,0,68,68,0,1,0,1,0
17674,28,0,0,70,70,0,1,0,1,0
16877,28,0,0,70,70,0,1,0,1,0
12125,28,0,0,66,66,0,1,0,1,0
10039,28,0,0,70,70,0,1,0,1,0
21075,28,0,0,66,66,0,1,0,1,0
18818,28,0,0,70,70,0,1,0,1,0
16897,28,0,0,70,70,0,1,0,1,0
20805,28,0,0,70,70,0,1,0,1,0
14120,28,0,0,70,70,0,1,0,1,0
20374,28,0,0,68,68,0,1,0,1,0
14682,28,0,0,66,66,0,1,0,1,0
9882,28,0,0,68,68,0,1,0,1,0
14446,28,0,0,70,70,0,1,0,1,0
22436,28,0,0,70,70,0,1,0,1,0
10095,28,0,0,67,67,0,1,0,1,0
17539,28,0,0,66,66,0,1,0,1,0
22419,28,0,0,70,70,0,1,0,1,0
12545,28,0,0,67,67,0,1,0,1,0
19695,28,0,0,66,66,0,1,0,1,0
13128,28,0,0,70,70,0,1,0,1,0
9397,28,0,0,70,70,0,1,0,1,0
15204,28,0,0,67,67,0,1,0,1,0
11383,28,0,0,70,70,0,1,0,1,0
18901,28,0,0,66,66,0,1,0,1,0
8712,28,0,0,68,68,0,1,0,1,0
15249,28,0,0,70,70,0,1,0,1,0
19712,28,0,0,70,70,0,1,0,1,0
14762,28,0,0,69,69,0,1,0,1,0
12004,28,0,0,69,69,0,1,0,1,0
14935,28,0,0,66,66,0,1,0,1,0
18986,28,0,0,68,68,0,1,0,1,0
9549,28,0,0,70,70,0,1,0,1,0
11402,28,0,0,66,66,0,1,0,1,0
18507,28,0,0,70,70,0,1,0,1,0
12088,28,0,0,70,70,0,1,0,1,0
21393,28,0,0,67,67,0,1,0,1,0
19980,28,0,0,70,70,0,1,0,1,0
9170,28,0,0,70,70,0,1,0,1,0
19327,28,0,0,70,70,0,1,0,1,0
13403,28,0,0,70,70,0,1,0,1,0
16037,28,0,0,70,70,0,1,0,1,0
17427,28,0,0,69,69,0,1,0,1,0
19675,28,0,0,70,70,0,1,0,1,0
18255,28,0,0,67,67,0,1,0,1,0
10575,28,0,0,69,69,0,1,0,1,0
15307,28,0,0,70,70,0,1,0,1,0
12116,28,0,0,70,70,0,1,0,1,0
16768,28,0,0,70,70,0,1,0,1,0
16793,28,0,0,66,66,0,1,0,1,0
14823,28,0,0,70,70,0,1,0,1,0
13933,28,0,0,66,66,0,1,0,1,0
11345,28,0,0,69,69,0,1,0,1,0
10121,28,0,0,70,70,0,1,0,1,0
21456,28,0,0,67,67,0,1,0,1,0
17833,28,0,0,70,70,0,1,0,1,0
17445,28,0,0,66,66,0,1,0,1,0
22400,28,0,0,68,68,0,1,0,1,0
13430,28,0,0,70,70,0,1,0,1,0
18954,28,0,0,70,70,0,1,0,1,0
12455,28,0,0,70,70,0,1,0,1,0
13243,28,0,0,70,70,0,1,0,1,0
17599,28,0,0,66,66,0,1,0,1,0
11173,28,0,0,70,70,0,1,0,1,0
11098,28,0,0,68,68,0,1,0,1,0
22634,28,0,0,70,70,0,1,0,1,0
10061,28,0,0,66,66,0,1,0,1,0
21284,28,0,0,70,70,0,1,0,1,0
9572,28,0,0,70,70,0,1,0,1,0
16042,28,0,0,70,70,0,1,0,1,0
10892,28,0,0,70,70,0,1,0,1,0
20322,28,0,0,70,70,0,1,0,1,0
10383,28,0,0,66,66,0,1,0,1,0
16995,28,0,0,69,69,0,1,0,1,0
20433,28,0,0,70,70,0,1,0,1,0
18448,28,0,0,68,68,0,1,0,1,0
10409,28,0,0,70,70,0,1,0,1,0
15963,28,0,0,70,70,0,1,0,1,0
12951,28,0,0,66,66,0,1,0,1,0
11888,28,0,0,66,66,0,1,0,1,0
16945,28,0,0,70,70,0,1,0,1,0
11666,28,0,0,70,70,0,1,0,1,0
18283,28,0,0,68,68,0,1,0,1,0
19783,28,0,0,68,68,0,1,0,1,0
10498,28,0,0,66,66,0,1,0,1,0
12801,28,0,0,66,66,0,1,0,1,0
12721,28,0,0,66,66,0,1,0,1,0
14067,28,0,0,70,70,0,1,0,1,0
14809,28,0,0,69,69,0,1,0,1,0
17855,28,0,0,70,70,0,1,0,1,0
21389,28,0,0,67,67,0,1,0,1,0
9543,28,0,0,70,70,0,1,0,1,0
19762,28,0,0,68,68,0,1,0,1,0
12787,28,0,0,66,66,0,1,0,1,0
16644,28,0,0,66,66,0,1,0,1,0
9485,28,0,0,70,70,0,1,0,1,0
16279,28,0,0,66,66,0,1,0,1,0
16400,28,0,0,70,70,0,1,0,1,0
11580,28,0,0,70,70,0,1,0,1,0
22712,28,0,0,70,70,0,1,0,1,0
8843,28,0,0,70,70,0,1,0,1,0
9762,28,0,0,70,70,0,1,0,1,0
8659,28,0,0,70,70,0,1,0,1,0
14943,28,0,0,70,70,0,1,0,1,0
13784,28,0,0,70,70,0,1,0,1,0
18358,28,0,0,70,70,0,1,0,1,0
12752,28,0,0,70,70,0,1,0,1,0
9346,28,0,0,70,70,0,1,0,1,0
14781,28,0,0,66,66,0,1,0,1,0
14304,28,0,0,68,68,0,1,0,1,0
20383,28,0,0,66,66,0,1,0,1,0
10526,28,0,0,67,67,0,1,0,1,0
10515,28,0,0,70,70,0,1,0,1,0
13905,28,0,0,70,70,0,1,0,1,0
15900,28,0,0,70,70,0,1,0,1,0
13171,28,0,0,66,66,0,1,0,1,0
9319,28,0,0,70,70,0,1,0,1,0
10565,28,0,0,67,67,0,1,0,1,0
9706,28,0,0,66,66,0,1,0,1,0
10397,28,0,0,66,66,0,1,0,1,0
9746,28,0,0,66,66,0,1,0,1,0
16795,28,0,0,66,66,0,1,0,1,0
16755,28,0,0,66,66,0,1,0,1,0
18226,28,0,0,70,70,0,1,0,1,0
13687,28,0,0,66,66,0,1,0,1,0
20068,28,0,0,66,66,0,1,0,1,0
18518,28,0,0,66,66,0,1,0,1,0
20118,28,0,0,70,70,0,1,0,1,0
11994,28,0,0,70,70,0,1,0,1,0
18563,28,0,0,70,70,0,1,0,1,0
11283,28,0,0,68,68,0,1,0,1,0
16852,28,0,0,66,66,0,1,0,1,0
17164,28,0,0,70,70,0,1,0,1,0
9776,28,0,0,70,70,0,1,0,1,0
18771,28,0,0,69,69,0,1,0,1,0
10596,28,0,0,70,70,0,1,0,1,0
18694,28,0,0,70,70,0,1,0,1,0
11669,28,0,0,70,70,0,1,0,1,0
21834,28,0,0,69,69,0,1,0,1,0
19244,28,0,0,70,70,0,1,0,1,0
13977,28,0,0,68,68,0,1,0,1,0
8915,28,0,0,66,66,0,1,0,1,0
20490,28,0,0,68,68,0,1,0,1,0
21405,28,0,0,70,70,0,1,0,1,0
9632,28,0,0,70,70,0,1,0,1,0
20049,28,0,0,70,70,0,1,0,1,0
12690,28,0,0,70,70,0,1,0,1,0
21085,28,0,0,68,68,0,1,0,1,0
19227,28,0,0,67,67,0,1,0,1,0
21861,28,0,0,70,70,0,1,0,1,0
20719,28,0,0,70,70,0,1,0,1,0
13774,28,0,0,70,70,0,1,0,1,0
18837,28,0,0,66,66,0,1,0,1,0
16085,28,0,0,66,66,0,1,0,1,0
21460,28,0,0,70,70,0,1,0,1,0
14981,28,0,0,70,70,0,1,0,1,0
19467,28,0,0,70,70,0,1,0,1,0
16807,28,0,0,70,70,0,1,0,1,0
19203,28,0,0,69,69,0,1,0,1,0
9195,28,0,0,70,70,0,1,0,1,0
13724,28,0,0,70,70,0,1,0,1,0
15322,28,0,0,70,70,0,1,0,1,0
14198,28,0,0,70,70,0,1,0,1,0
18918,28,0,0,70,70,0,1,0,1,0
19654,28,0,0,66,66,0,1,0,1,0
9940,28,0,0,70,70,0,1,0,1,0
11402,28,0,0,66,66,0,1,0,1,0
9571,28,0,0,68,68,0,1,0,1,0
10707,28,0,0,70,70,0,1,0,1,0
18859,28,0,0,70,70,0,1,0,1,0
22223,28,0,0,70,70,0,1,0,1,0
10741,28,0,0,70,70,0,1,0,1,0
12241,28,0,0,66,66,0,1,0,1,0
21595,28,0,0,69,69,0,1,0,1,0
20792,28,0,0,66,66,0,1,0,1,0
9747,28,0,0,70,70,0,1,0,1,0
9729,28,0,0,70,70,0,1,0,1,0
8872,28,0,0,70,70,0,1,0,1,0
8469,28,0,0,70,70,0,1,0,1,0
19912,28,0,0,70,70,0,1,0,1,0
11937,28,0,0,66,66,0,1,0,1,0
8912,28,0,0,66,66,0,1,0,1,0
16998,28,0,0,70,70,0,1,0,1,0
11545,28,0,0,70,70,0,1,0,1,0
20723,28,0,0,66,66,0,1,0,1,0
16848,28,0,0,68,68,0,1,0,1,0
16509,28,0,0,67,67,0,1,0,1,0
14966,28,0,0,70,70,0,1,0,1,0
9158,28,0,0,70,70,0,1,0,1,0
21143,28,0,0,68,68,0,1,0,1,0
21434,28,0,0,66,66,0,1,0,1,0
19443,28,0,0,66,66,0,1,0,1,0
20086,28,0,0,70,70,0,1,0,1,0
17237,28,0,0,66,66,0,1,0,1,0
11579,28,0,0,70,70,0,1,0,1,0
9749,28,0,0,70,70,0,1,0,1,0
20998,28,0,0,70,70,0,1,0,1,0
19891,28,0,0,70,70,0,1,0,1,0
9259,28,0,0,70,70,0,1,0,1,0
15102,28,0,0,66,66,0,1,0,1,0
21011,28,0,0,69,69,0,1,0,1,0
20575,28,0,0,70,70,0,1,0,1,0
12236,28,0,0,70,70,0,1,0,1,0
12714,28,0,0,70,70,0,1,0,1,0
16856,28,0,0,66,66,0,1,0,1,0
14211,28,0,0,70,70,0,1,0,1,0
12725,28,0,0,68,68,0,1,0,1,0
10309,28,0,0,70,70,0,1,0,1,0
16537,28,0,0,70,70,0,1,0,1,0
12009,28,0,0,70,70,0,1,0,1,0
21565,28,0,0,70,70,0,1,0,1,0
10336,28,0,0,67,67,0,1,0,1,0
10104,28,0,0,66,66,0,1,0,1,0
21187,28,0,0,66,66,0,1,0,1,0
8490,28,0,0,70,70,0,1,0,1,0
17830,28,0,0,70,70,0,1,0,1,0
12751,28,0,0,70,70,0,1,0,1,0
18069,28,0,0,66,66,0,1,0,1,0
13426,28,0,0,66,66,0,1,0,1,0
10801,28,0,0,66,66,0,1,0,1,0
19884,28,0,0,66,66,0,1,0,1,0
9577,28,0,0,70,70,0,1,0,1,0
16413,28,0,0,69,69,0,1,0,1,0
9169,28,0,0,70,70,0,1,0,1,0
9738,28,0,0,66,66,0,1,0,1,0
10915,28,0,0,70,70,0,1,0,1,0
12948,28,0,0,70,70,0,1,0,1,0
11308,28,0,0,66,66,0,1,0,1,0
17249,28,0,0,66,66,0,1,0,1,0
16136,28,0,0,70,70,0,1,0,1,0
20023,28,0,0,66,66,0,1,0,1,0
18765,28,0,0,67,67,0,1,0,1,0
11430,28,0,0,66,66,0,1,0,1,0
21094,28,0,0,70,70,0,1,0,1,0
22175,28,0,0,69,69,0,1,0,1,0
10380,28,0,0,70,70,0,1,0,1,0
10186,28,0,0,70,70,0,1,0,1,0
21343,28,0,0,68,68,0,1,0,1,0
14209,28,0,0,70,70,0,1,0,1,0
13224,28,0,0,69,69,0,1,0,1,0
17918,28,0,0,68,68,0,1,0,1,0
16444,28,0,0,66,66,0,1,0,1,0
13933,28,0,0,70,70,0,1,0,1,0
16712,28,0,0,70,70,0,1,0,1,0
12956,28,0,0,67,67,0,1,0,1,0
17901,28,0,0,70,70,0,1,0,1,0
11982,28,0,0,69,69,0,1,0,1,0
20278,28,0,0,69,69,0,1,0,1,0
22717,28,0,0,69,69,0,1,0,1,0
10037,28,0,0,70,70,0,1,0,1,0
10377,28,0,0,70,70,0,1,0,1,0
8447,28,0,0,70,70,0,1,0,1,0
9997,28,0,0,66,66,0,1,0,1,0
9443,28,0,0,70,70,0,1,0,1,0
12512,28,0,0,68,68,0,1,0,1,0
18650,28,0,0,70,70,0,1,0,1,0
16614,28,0,0,70,70,0,1,0,1,0
19227,28,0,0,66,66,0,1,0,1,0
17548,28,0,0,66,66,0,1,0,1,0
16078,28,0,0,70,70,0,1,0,1,0
12189,28,0,0,69,69,0,1,0,1,0
14421,28,0,0,70,70,0,1,0,1,0
8469,28,0,0,70,70,0,1,0,1,0
8703,28,0,0,70,70,0,1,0,1,0
9135,28,0,0,66,66,0,1,0,1,0
10528,28,0,0,66,66,0,1,0,1,0
21072,28,0,0,66,66,0,1,0,1,0
21876,28,0,0,70,70,0,1,0,1,0
19733,28,0,0,70,70,0,1,0,1,0
19709,28,0,0,70,70,0,1,0,1,0
19563,28,0,0,67,67,0,1,0,1,0
18872,28,0,0,70,70,0,1,0,1,0
17880,28,0,0,70,70,0,1,0,1,0
13699,28,0,0,70,70,0,1,0,1,0
14058,28,0,0,70,70,0,1,0,1,0
14135,28,0,0,70,70,0,1,0,1,0
20701,28,0,0,70,70,0,1,0,1,0
15983,28,0,0,68,68,0,1,0,1,0
20873,28,0,0,70,70,0,1,0,1,0
10720,28,0,0,70,70,0,1,0,1,0
12802,28,0,0,68,68,0,1,0,1,0
11884,28,0,0,66,66,0,1,0,1,0
12193,28,0,0,66,66,0,1,0,1,0
19507,28,0,0,70,70,0,1,0,1,0
10157,28,0,0,69,69,0,1,0,1,0
18750,28,0,0,70,70,0,1,0,1,0
11333,28,0,0,70,70,0,1,0,1,0
12994,28,0,0,70,70,0,1,0,1,0
16881,28,0,0,69,69,0,1,0,1,0
20457,28,0,0,66,66,0,1,0,1,0
9630,28,0,0,70,70,0,1,0,1,0
14842,28,0,0,67,67,0,1,0,1,0
21427,28,0,0,70,70,0,1,0,1,0
22392,28,0,0,70,70,0,1,0,1,0
17660,28,0,0,70,70,0,1,0,1,0
20265,28,0,0,70,70,0,1,0,1,0
17223,28,0,0,70,70,0,1,0,1,0
22266,28,0,0,70,70,0,1,0,1,0
14558,28,0,0,70,70,0,1,0,1,0
8791,28,0,0,70,70,0,1,0,1,0
17657,28,0,0,68,68,0,1,0,1,0
20620,28,0,0,66,66,0,1,0,1,0
21626,28,0,0,70,70,0,1,0,1,0
12598,28,0,0,70,70,0,1,0,1,0
20312,28,0,0,70,70,0,1,0,1,0
14372,28,0,0,70,70,0,1,0,1,0
14446,28,0,0,70,70,0,1,0,1,0
18165,28,0,0,69,69,0,1,0,1,0
19977,28,0,0,70,70,0,1,0,1,0
15917,28,0,0,66,66,0,1,0,1,0
11322,28,0,0,66,66,0,1,0,1,0
11791,28,0,0,67,67,0,1,0,1,0
16715,28,0,0,69,69,0,1,0,1,0
20990,28,0,0,66,66,0,1,0,1,0
13105,28,0,0,66,66,0,1,0,1,0
14263,28,0,0,67,67,0,1,0,1,0
9153,28,0,0,66,66,0,1,0,1,0
12588,28,0,0,70,70,0,1,0,1,0
15424,28,0,0,70,70,0,1,0,1,0
10012,28,0,0,70,70,0,1,0,1,0
10150,28,0,0,70,70,0,1,0,1,0
10655,28,0,0,66,66,0,1,0,1,0
18252,28,0,0,70,70,0,1,0,1,0
22445,28,0,0,70,70,0,1,0,1,0
17140,28,0,0,68,68,0,1,0,1,0
13684,28,0,0,70,70,0,1,0,1,0
18840,28,0,0,67,67,0,1,0,1,0
8731,28,0,0,70,70,0,1,0,1,0
19327,28,0,0,70,70,0,1,0,1,0
14906,28,0,0,70,70,0,1,0,1,0
9746,28,0,0,66,66,0,1,0,1,0
13849,28,0,0,70,70,0,1,0,1,0
22477,28,0,0,66,66,0,1,0,1,0
12007,28,0,0,70,70,0,1,0,1,0
19269,28,0,0,66,66,0,1,0,1,0
16454,28,0,0,70,70,0,1,0,1,0
15247,28,0,0,70,70,0,1,0,1,0
20154,28,0,0,70,70,0,1,0,1,0
11239,28,0,0,69,69,0,1,0,1,0
11117,28,0,0,66,66,0,1,0,1,0
18664,28,0,0,70,70,0,1,0,1,0
20442,28,0,0,66,66,0,1,0,1,0
11606,28,0,0,66,66,0,1,0,1,0
22501,28,0,0,69,69,0,1,0,1,0
9343,28,0,0,70,70,0,1,0,1,0
22419,28,0,0,70,70,0,1,0,1,0
14484,28,0,0,66,66,0,1,0,1,0
17906,28,0,0,70,70,0,1,0,1,0
18563,28,0,0,70,70,0,1,0,1,0
18915,28,0,0,70,70,0,1,0,1,0
10677,28,0,0,66,66,0,1,0,1,0
11490,28,0,0,66,66,0,1,0,1,0
10376,28,0,0,70,70,0,1,0,1,0
11235,28,0,0,70,70,0,1,0,1,0
11583,28,0,0,70,70,0,1,0,1,0
13773,28,0,0,67,67,0,1,0,1,0
21169,28,0,0,66,66,0,1,0,1,0
13828,28,0,0,67,67,0,1,0,1,0
16888,28,0,0,70,70,0,1,0,1,0
20591,28,0,0,66,66,0,1,0,1,0
17563,28,0,0,68,68,0,1,0,1,0
20574,28,0,0,70,70,0,1,0,1,0
10282,28,0,0,70,70,0,1,0,1,0
18649,28,0,0,70,70,0,1,0,1,0
11078,28,0,0,70,70,0,1,0,1,0
9550,28,0,0,66,66,0,1,0,1,0
9926,28,0,0,66,66,0,1,0,1,0
15058,28,0,0,67,67,0,1,0,1,0
20121,28,0,0,66,66,0,1,0,1,0
12371,28,0,0,67,67,0,1,0,1,0
22140,28,0,0,70,70,0,1,0,1,0
9796,28,0,0,68,68,0,1,0,1,0
16739,28,0,0,69,69,0,1,0,1,0
16960,28,0,0,67,67,0,1,0,1,0
12557,28,0,0,70,70,0,1,0,1,0
15360,28,0,0,70,70,0,1,0,1,0
20694,28,0,0,70,70,0,1,0,1,0
15839,28,0,0,68,68,0,1,0,1,0
12991,28,0,0,70,70,0,1,0,1,0
16236,28,0,0,66,66,0,1,0,1,0
19181,28,0,0,70,70,0,1,0,1,0
16220,28,0,0,70,70,0,1,0,1,0
21666,28,0,0,66,66,0,1,0,1,0
16551,28,0,0,67,67,0,1,0,1,0
21325,28,0,0,70,70,0,1,0,1,0
15540,28,0,0,66,66,0,1,0,1,0
16304,28,0,0,70,70,0,1,0,1,0
11770,28,0,0,66,66,0,1,0,1,0
18375,28,0,0,69,69,0,1,0,1,0
9755,28,0,0,70,70,0,1,0,1,0
9625,28,0,0,70,70,0,1,0,1,0
16105,28,0,0,70,70,0,1,0,1,0
17972,28,0,0,68,68,0,1,0,1,0
21910,28,0,0,68,68,0,1,0,1,0
11749,28,0,0,70,70,0,1,0,1,0
16426,28,0,0,70,70,0,1,0,1,0
16837,28,0,0,70,70,0,1,0,1,0
22438,28,0,0,69,69,0,1,0,1,0
19564,28,0,0,66,66,0,1,0,1,0
12442,28,0,0,70,70,0,1,0,1,0
18717,28,0,0,66,66,0,1,0,1,0
18463,28,0,0,70,70,0,1,0,1,0
9957,28,0,0,66,66,0,1,0,1,0
13779,28,0,0,70,70,0,1,0,1,0
11245,28,0,0,66,66,0,1,0,1,0
14136,28,0,0,66,66,0,1,0,1,0
18989,28,0,0,70,70,0,1,0,1,0
17075,28,0,0,70,70,0,1,0,1,0
14953,28,0,0,66,66,0,1,0,1,0
19782,28,0,0,70,70,0,1,0,1,0
16291,28,0,0,69,69,0,1,0,1,0
14604,28,0,0,69,69,0,1,0,1,0
14385,28,0,0,70,70,0,1,0,1,0
17057,28,0,0,67,67,0,1,0,1,0
15322,28,0,0,70,70,0,1,0,1,0
12567,28,0,0,70,70,0,1,0,1,0
11722,28,0,0,70,70,0,1,0,1,0
13647,28,0,0,70,70,0,1,0,1,0
8421,28,0,0,66,66,0,1,0,1,0
14125,28,0,0,70,70,0,1,0,1,0
17233,28,0,0,70,70,0,1,0,1,0
19855,28,0,0,70,70,0,1,0,1,0
14159,28,0,0,66,66,0,1,0,1,0
11113,28,0,0,70,70,0,1,0,1,0
9004,28,0,0,70,70,0,1,0,1,0
9703,28,0,0,70,70,0,1,0,1,0
16947,28,0,0,70,70,0,1,0,1,0
15183,28,0,0,67,67,0,1,0,1,0
12866,28,0,0,67,67,0,1,0,1,0
18964,28,0,0,69,69,0,1,0,1,0
9213,28,0,0,70,70,0,1,0,1,0
20668,28,0,0,70,70,0,1,0,1,0
8518,28,0,0,66,66,0,1,0,1,0
21267,28,0,0,66,66,0,1,0,1,0
11209,28,0,0,70,70,0,1,0,1,0
20237,28,0,0,70,70,0,1,0,1,0
16538,28,0,0,70,70,0,1,0,1,0
11197,28,0,0,66,66,0,1,0,1,0
14456,28,0,0,70,70,0,1,0,1,0
21111,28,0,0,70,70,0,1,0,1,0
16167,28,0,0,70,70,0,1,0,1,0
18762,28,0,0,66,66,0,1,0,1,0
12741,28,0,0,68,68,0,1,0,1,0
21378,28,0,0,66,66,0,1,0,1,0
20967,28,0,0,68,68,0,1,0,1,0
19174,28,0,0,70,70,0,1,0,1,0
9986,28,0,0,70,70,0,1,0,1,0
20400,28,0,0,70,70,0,1,0,1,0
20219,28,0,0,70,70,0,1,0,1,0
10221,28,0,0,70,70,0,1,0,1,0
21721,28,0,0,66,66,0,1,0,1,0
21680,28,0,0,70,70,0,1,0,1,0
12345,28,0,0,66,66,0,1,0,1,0
14650,28,0,0,70,70,0,1,0,1,0
18540,28,0,0,70,70,0,1,0,1,0
12588,28,0,0,68,68,0,1,0,1,0
21521,28,0,0,70,70,0,1,0,1,0
21436,28,0,0,66,66,0,1,0,1,0
15880,28,0,0,70,70,0,1,0,1,0
17312,28,0,0,70,70,0,1,0,1,0
19500,28,0,0,67,67,0,1,0,1,0
11624,28,0,0,66,66,0,1,0,1,0
12876,28,0,0,70,70,0,1,0,1,0
21711,28,0,0,68,68,0,1,0,1,0
20290,28,0,0,66,66,0,1,0,1,0
13805,28,0,0,70,70,0,1,0,1,0
12809,28,0,0,70,70,0,1,0,1,0
21959,28,0,0,70,70,0,1,0,1,0
16332,28,0,0,70,70,0,1,0,1,0
18087,28,0,0,66,66,0,1,0,1,0
12895,28,0,0,70,70,0,1,0,1,0
20824,28,0,0,70,70,0,1,0,1,0
21069,28,0,0,70,70,0,1,0,1,0
20068,28,0,0,69,69,0,1,0,1,0
20523,28,0,0,68,68,0,1,0,1,0
9320,28,0,0,70,70,0,1,0,1,0
20173,28,0,0,70,70,0,1,0,1,0
17005,28,0,0,70,70,0,1,0,1,0
10105,28,0,0,66,66,0,1,0,1,0
10231,28,0,0,68,68,0,1,0,1,0
19854,28,0,0,70,70,0,1,0,1,0
19339,28,0,0,66,66,0,1,0,1,0
10238,28,0,0,66,66,0,1,0,1,0
18504,28,0,0,70,70,0,1,0,1,0
9944,28,0,0,66,66,0,1,0,1,0
21205,28,0,0,70,70,0,1,0,1,0
9099,28,0,0,70,70,0,1,0,1,0
11451,28,0,0,70,70,0,1,0,1,0
10229,28,0,0,66,66,0,1,0,1,0
20185,28,0,0,66,66,0,1,0,1,0
14965,28,0,0,70,70,0,1,0,1,0
12265,28,0,0,70,70,0,1,0,1,0
14024,28,0,0,70,70,0,1,0,1,0
11419,28,0,0,70,70,0,1,0,1,0
14258,28,0,0,70,70,0,1,0,1,0
15917,28,0,0,66,66,0,1,0,1,0
11379,28,0,0,68,68,0,1,0,1,0
16363,28,0,0,70,70,0,1,0,1,0
13765,28,0,0,66,66,0,1,0,1,0
14473,28,0,0,66,66,0,1,0,1,0
20118,28,0,0,70,70,0,1,0,1,0
16137,28,0,0,70,70,0,1,0,1,0
18254,28,0,0,69,69,0,1,0,1,0
16983,28,0,0,70,70,0,1,0,1,0
14523,28,0,0,70,70,0,1,0,1,0
20627,28,0,0,70,70,0,1,0,1,0
13560,28,0,0,70,70,0,1,0,1,0
15653,28,0,0,70,70,0,1,0,1,0
18799,28,0,0,69,69,0,1,0,1,0
11723,28,0,0,66,66,0,1,0,1,0
19982,28,0,0,66,66,0,1,0,1,0
19650,28,0,0,70,70,0,1,0,1,0
9292,28,0,0,70,70,0,1,0,1,0
11735,28,0,0,66,66,0,1,0,1,0
20322,28,0,0,70,70,0,1,0,1,0
14676,28,0,0,70,70,0,1,0,1,0
15412,28,0,0,66,66,0,1,0,1,0
13526,28,0,0,66,66,0,1,0,1,0
9454,28,0,0,67,67,0,1,0,1,0
15862,28,0,0,69,69,0,1,0,1,0
12526,28,0,0,66,66,0,1,0,1,0
18420,28,0,0,68,68,0,1,0,1,0
10688,28,0,0,68,68,0,1,0,1,0
16045,28,0,0,70,70,0,1,0,1,0
16956,28,0,0,70,70,0,1,0,1,0
20221,28,0,0,70,70,0,1,0,1,0
8409,28,0,0,70,70,0,1,0,1,0
19774,28,0,0,67,67,0,1,0,1,0
20027,28,0,0,66,66,0,1,0,1,0
11316,28,0,0,66,66,0,1,0,1,0
18675,28,0,0,66,66,0,1,0,1,0
19771,28,0,0,70,70,0,1,0,1,0
14314,28,0,0,70,70,0,1,0,1,0
12886,28,0,0,66,66,0,1,0,1,0
22147,28,0,0,66,66,0,1,0,1,0
14955,28,0,0,66,66,0,1,0,1,0
10012,28,0,0,70,70,0,1,0,1,0
20074,28,0,0,69,69,0,1,0,1,0
8844,28,0,0,70,70,0,1,0,1,0
14288,28,0,0,70,70,0,1,0,1,0
14260,28,0,0,70,70,0,1,0,1,0
14569,28,0,0,70,70,0,1,0,1,0
19144,28,0,0,70,70,0,1,0,1,0
18116,28,0,0,70,70,0,1,0,1,0
15281,28,0,0,66,66,0,1,0,1,0
14106,28,0,0,66,66,0,1,0,1,0
22579,28,0,0,67,67,0,1,0,1,0
20106,28,0,0,68,68,0,1,0,1,0
19837,28,0,0,66,66,0,1,0,1,0
13083,28,0,0,68,68,0,1,0,1,0
10159,28,0,0,66,66,0,1,0,1,0
11606,28,0,0,66,66,0,1,0,1,0
13535,28,0,0,66,66,0,1,0,1,0
17574,28,0,0,70,70,0,1,0,1,0
14013,28,0,0,68,68,0,1,0,1,0
17244,28,0,0,70,70,0,1,0,1,0
13269,28,0,0,70,70,0,1,0,1,0
17246,28,0,0,67,67,0,1,0,1,0
12769,28,0,0,66,66,0,1,0,1,0
19199,28,0,0,66,66,0,1,0,1,0
14187,28,0,0,70,70,0,1,0,1,0
20401,28,0,0,68,68,0,1,0,1,0
17814,28,0,0,70,70,0,1,0,1,0
20082,28,0,0,70,70,0,1,0,1,0
9239,28,0,0,66,66,0,1,0,1,0
18628,28,0,0,69,69,0,1,0,1,0
13859,28,0,0,70,70,0,1,0,1,0
11944,28,0,0,70,70,0,1,0,1,0
18209,28,0,0,67,67,0,1,0,1,0
12705,28,0,0,68,68,0,1,0,1,0
13126,28,0,0,66,66,0,1,0,1,0
18016,28,0,0,70,70,0,1,0,1,0
8674,28,0,0,66,66,0,1,0,1,0
18787,28,0,0,67,67,0,1,0,1,0
13666,28,0,0,69,69,0,1,0,1,0
8611,28,0,0,70,70,0,1,0,1,0
16610,28,0,0,67,67,0,1,0,1,0
8407,28,0,0,70,70,0,1,0,1,0
12093,28,0,0,70,70,0,1,0,1,0
17957,28,0,0,70,70,0,1,0,1,0
12154,28,0,0,67,67,0,1,0,1,0
16570,28,0,0,68,68,0,1,0,1,0
10224,28,0,0,66,66,0,1,0,1,0
10682,28,0,0,69,69,0,1,0,1,0
10970,28,0,0,70,70,0,1,0,1,0
13081,28,0,0,66,66,0,1,0,1,0
10840,28,0,0,70,70,0,1,0,1,0
13644,28,0,0,70,70,0,1,0,1,0
13736,28,0,0,67,67,0,1,0,1,0
20238,28,0,0,66,66,0,1,0,1,0
13488,28,0,0,66,66,0,1,0,1,0
18623,28,0,0,70,70,0,1,0,1,0
9657,28,0,0,70,70,0,1,0,1,0
21185,28,0,0,70,70,0,1,0,1,0
18357,28,0,0,69,69,0,1,0,1,0
9816,28,0,0,70,70,0,1,0,1,0
17769,28,0,0,70,70,0,1,0,1,0
12054,28,0,0,70,70,0,1,0,1,0
18176,28,0,0,70,70,0,1,0,1,0
18467,28,0,0,70,70,0,1,0,1,0
10690,28,0,0,70,70,0,1,0,1,0
17749,28,0,0,69,69,0,1,0,1,0
19662,28,0,0,70,70,0,1,0,1,0
15621,28,0,0,70,70,0,1,0,1,0
11460,28,0,0,66,66,0,1,0,1,0
18150,28,0,0,69,69,0,1,0,1,0
17817,28,0,0,67,67,0,1,0,1,0
20868,28,0,0,68,68,0,1,0,1,0
19834,28,0,0,66,66,0,1,0,1,0
17628,28,0,0,69,69,0,1,0,1,0
20969,28,0,0,70,70,0,1,0,1,0
17721,28,0,0,70,70,0,1,0,1,0
9559,28,0,0,70,70,0,1,0,1,0
14364,28,0,0,66,66,0,1,0,1,0
20578,28,0,0,70,70,0,1,0,1,0
19875,28,0,0,66,66,0,1,0,1,0
15923,28,0,0,69,69,0,1,0,1,0
17956,28,0,0,70,70,0,1,0,1,0
21022,28,0,0,70,70,0,1,0,1,0
13317,28,0,0,66,66,0,1,0,1,0
18878,28,0,0,66,66,0,1,0,1,0
12322,28,0,0,70,70,0,1,0,1,0
10238,28,0,0,66,66,0,1,0,1,0
9608,28,0,0,70,70,0,1,0,1,0
16182,28,0,0,70,70,0,1,0,1,0
14718,28,0,0,66,66,0,1,0,1,0
22595,28,0,0,70,70,0,1,0,1,0
19456,28,0,0,66,66,0,1,0,1,0
10690,28,0,0,70,70,0,1,0,1,0
15185,28,0,0,70,70,0,1,0,1,0
19961,28,0,0,70,70,0,1,0,1,0
18394,28,0,0,67,67,0,1,0,1,0
17374,28,0,0,70,70,0,1,0,1,0
20120,28,0,0,66,66,0,1,0,1,0
12728,28,0,0,70,70,0,1,0,1,0
18771,28,0,0,69,69,0,1,0,1,0
10203,28,0,0,68,68,0,1,0,1,0
14570,28,0,0,70,70,0,1,0,1,0
16727,28,0,0,70,70,0,1,0,1,0
19058,28,0,0,70,70,0,1,0,1,0
20738,28,0,0,66,66,0,1,0,1,0
17515,28,0,0,70,70,0,1,0,1,0
12883,28,0,0,70,70,0,1,0,1,0
8807,28,0,0,70,70,0,1,0,1,0
15834,28,0,0,68,68,0,1,0,1,0
19453,28,0,0,66,66,0,1,0,1,0
16624,28,0,0,67,67,0,1,0,1,0
18323,28,0,0,67,67,0,1,0,1,0
19017,28,0,0,69,69,0,1,0,1,0
9826,28,0,0,70,70,0,1,0,1,0
20316,28,0,0,70,70,0,1,0,1,0
15363,28,0,0,66,66,0,1,0,1,0
19186,28,0,0,67,67,0,1,0,1,0
9344,28,0,0,70,70,0,1,0,1,0
22319,28,0,0,68,68,0,1,0,1,0
19133,28,0,0,66,66,0,1,0,1,0
22196,28,0,0,66,66,0,1,0,1,0
12293,28,0,0,70,70,0,1,0,1,0
16806,28,0,0,70,70,0,1,0,1,0
12546,28,0,0,66,66,0,1,0,1,0
16832,28,0,0,66,66,0,1,0,1,0
16687,28,0,0,70,70,0,1,0,1,0
14764,28,0,0,68,68,0,1,0,1,0
10598,28,0,0,66,66,0,1,0,1,0
8786,28,0,0,70,70,0,1,0,1,0
11710,28,0,0,69,69,0,1,0,1,0
9416,28,0,0,70,70,0,1,0,1,0
11301,28,0,0,66,66,0,1,0,1,0
10027,28,0,0,70,70,0,1,0,1,0
9536,28,0,0,67,67,0,1,0,1,0
17957,28,0,0,70,70,0,1,0,1,0
18674,28,0,0,70,70,0,1,0,1,0
14187,28,0,0,70,70,0,1,0,1,0
13616,28,0,0,66,66,0,1,0,1,0
16487,28,0,0,70,70,0,1,0,1,0
19792,28,0,0,66,66,0,1,0,1,0
13071,28,0,0,66,66,0,1,0,1,0
16247,28,0,0,70,70,0,1,0,1,0
17810,28,0,0,66,66,0,1,0,1,0
15109,28,0,0,70,70,0,1,0,1,0
20781,28,0,0,66,66,0,1,0,1,0
18697,28,0,0,70,70,0,1,0,1,0
17189,28,0,0,66,66,0,1,0,1,0
10455,28,0,0,70,70,0,1,0,1,0
13827,28,0,0,67,67,0,1,0,1,0
20895,28,0,0,66,66,0,1,0,1,0
11117,28,0,0,66,66,0,1,0,1,0
12108,28,0,0,70,70,0,1,0,1,0
16644,28,0,0,66,66,0,1,0,1,0
14278,28,0,0,70,70,0,1,0,1,0
16515,28,0,0,70,70,0,1,0,1,0
21970,28,0,0,66,66,0,1,0,1,0
21507,28,0,0,70,70,0,1,0,1,0
14794,28,0,0,70,70,0,1,0,1,0
10499,28,0,0,66,66,0,1,0,1,0
10747,28,0,0,69,69,0,1,0,1,0
13041,28,0,0,70,70,0,1,0,1,0
10007,28,0,0,70,70,0,1,0,1,0
19687,28,0,0,66,66,0,1,0,1,0
13415,28,0,0,69,69,0,1,0,1,0
16076,28,0,0,66,66,0,1,0,1,0
9701,28,0,0,70,70,0,1,0,1,0
11654,28,0,0,70,70,0,1,0,1,0
9918,28,0,0,70,70,0,1,0,1,0
16196,28,0,0,70,70,0,1,0,1,0
16591,28,0,0,66,66,0,1,0,1,0
12707,28,0,0,70,70,0,1,0,1,0
15098,28,0,0,67,67,0,1,0,1,0
19318,28,0,0,68,68,0,1,0,1,0
20736,28,0,0,70,70,0,1,0,1,0
21135,28,0,0,66,66,0,1,0,1,0
17683,28,0,0,70,70,0,1,0,1,0
9801,28,0,0,66,66,0,1,0,1,0
8657,28,0,0,70,70,0,1,0,1,0
9608,28,0,0,66,66,0,1,0,1,0
9541,28,0,0,70,70,0,1,0,1,0
21236,28,0,0,66,66,0,1,0,1,0
19239,28,0,0,66,66,0,1,0,1,0
17788,28,0,0,70,70,0,1,0,1,0
20862,28,0,0,66,66,0,1,0,1,0
17132,28,0,0,69,69,0,1,0,1,0
22715,28,0,0,70,70,0,1,0,1,0
10381,28,0,0,70,70,0,1,0,1,0
15409,28,0,0,70,70,0,1,0,1,0
18064,28,0,0,70,70,0,1,0,1,0
17315,28,0,0,67,67,0,1,0,1,0
22190,28,0,0,70,70,0,1,0,1,0
8999,28,0,0,70,70,0,1,0,1,0
14624,28,0,0,67,67,0,1,0,1,0
10968,28,0,0,70,70,0,1,0,1,0
15617,28,0,0,66,66,0,1,0,1,0
11840,28,0,0,70,70,0,1,0,1,0
18913,28,0,0,70,70,0,1,0,1,0
22585,28,0,0,66,66,0,1,0,1,0
11827,28,0,0,70,70,0,1,0,1,0
9875,28,0,0,70,70,0,1,0,1,0
22133,28,0,0,68,68,0,1,0,1,0
10792,28,0,0,67,67,0,1,0,1,0
19273,28,0,0,70,70,0,1,0,1,0
21355,28,0,0,70,70,0,1,0,1,0
18763,28,0,0,66,66,0,1,0,1,0
18919,28,0,0,70,70,0,1,0,1,0
13828,28,0,0,68,68,0,1,0,1,0
10097,28,0,0,70,70,0,1,0,1,0
10263,28,0,0,70,70,0,1,0,1,0
19585,28,0,0,70,70,0,1,0,1,0
20886,28,0,0,70,70,0,1,0,1,0
14052,28,0,0,70,70,0,1,0,1,0
9110,28,0,0,70,70,0,1,0,1,0
10537,28,0,0,70,70,0,1,0,1,0
19140,28,0,0,70,70,0,1,0,1,0
8663,28,0,0,70,70,0,1,0,1,0
12424,28,0,0,66,66,0,1,0,1,0
9525,28,0,0,70,70,0,1,0,1,0
15577,28,0,0,70,70,0,1,0,1,0
19156,28,0,0,70,70,0,1,0,1,0
16855,28,0,0,70,70,0,1,0,1,0
14216,28,0,0,70,70,0,1,0,1,0
17470,28,0,0,68,68,0,1,0,1,0
15156,28,0,0,67,67,0,1,0,1,0
16854,28,0,0,66,66,0,1,0,1,0
12639,28,0,0,70,70,0,1,0,1,0
19325,28,0,0,70,70,0,1,0,1,0
21752,28,0,0,70,70,0,1,0,1,0
16882,28,0,0,70,70,0,1,0,1,0
19087,28,0,0,66,66,0,1,0,1,0
20152,28,0,0,70,70,0,1,0,1,0
17546,28,0,0,66,66,0,1,0,1,0
12484,28,0,0,70,70,0,1,0,1,0
17995,28,0,0,70,70,0,1,0,1,0
20754,28,0,0,70,70,0,1,0,1,0
10689,28,0,0,69,69,0,1,0,1,0
20658,28,0,0,70,70,0,1,0,1,0
16235,28,0,0,67,67,0,1,0,1,0
13781,28,0,0,70,70,0,1,0,1,0
21844,28,0,0,70,70,0,1,0,1,0
9051,28,0,0,70,70,0,1,0,1,0
9501,28,0,0,66,66,0,1,0,1,0
10441,28,0,0,70,70,0,1,0,1,0
10990,28,0,0,67,67,0,1,0,1,0
9800,28,0,0,66,66,0,1,0,1,0
18647,28,0,0,70,70,0,1,0,1,0
17256,28,0,0,70,70,0,1,0,1,0
12418,28,0,0,68,68,0,1,0,1,0
12079,28,0,0,70,70,0,1,0,1,0
8467,28,0,0,68,68,0,1,0,1,0
17992,28,0,0,70,70,0,1,0,1,0
19481,28,0,0,70,70,0,1,0,1,0
9687,28,0,0,66,66,0,1,0,1,0
15349,28,0,0,70,70,0,1,0,1,0
11720,28,0,0,66,66,0,1,0,1,0
20147,28,0,0,70,70,0,1,0,1,0
13344,28,0,0,69,69,0,1,0,1,0
12092,28,0,0,70,70,0,1,0,1,0
15128,28,0,0,70,70,0,1,0,1,0
20276,28,0,0,70,70,0,1,0,1,0
9219,28,0,0,70,70,0,1,0,1,0
14292,28,0,0,69,69,0,1,0,1,0
20300,28,0,0,70,70,0,1,0,1,0
16015,28,0,0,66,66,0,1,0,1,0
15261,28,0,0,70,70,0,1,0,1,0
11706,28,0,0,66,66,0,1,0,1,0
11186,28,0,0,66,66,0,1,0,1,0
13248,28,0,0,70,70,0,1,0,1,0
21284,28,0,0,70,70,0,1,0,1,0
9883,28,0,0,66,66,0,1,0,1,0
19182,28,0,0,70,70,0,1,0,1,0
9705,28,0,0,68,68,0,1,0,1,0
16356,28,0,0,70,70,0,1,0,1,0
16426,28,0,0,70,70,0,1,0,1,0
13344,28,0,0,68,68,0,1,0,1,0
15725,28,0,0,70,70,0,1,0,1,0
21284,28,0,0,66,66,0,1,0,1,0
19299,28,0,0,70,70,0,1,0,1,0
10070,28,0,0,66,66,0,1,0,1,0
20677,28,0,0,70,70,0,1,0,1,0
13990,28,0,0,66,66,0,1,0,1,0
13396,28,0,0,66,66,0,1,0,1,0
20510,28,0,0,66,66,0,1,0,1,0
21546,28,0,0,70,70,0,1,0,1,0
12969,28,0,0,70,70,0,1,0,1,0
16277,28,0,0,66,66,0,1,0,1,0
19859,28,0,0,66,66,0,1,0,1,0
19769,28,0,0,70,70,0,1,0,1,0
20612,28,0,0,70,70,0,1,0,1,0
9973,28,0,0,70,70,0,1,0,1,0
20430,28,0,0,70,70,0,1,0,1,0
15346,28,0,0,70,70,0,1,0,1,0
10060,28,0,0,66,66,0,1,0,1,0
17184,28,0,0,70,70,0,1,0,1,0
22260,28,0,0,70,70,0,1,0,1,0
8565,28,0,0,66,66,0,1,0,1,0
20063,28,0,0,70,70,0,1,0,1,0
19100,28,0,0,70,70,0,1,0,1,0
20180,28,0,0,70,70,0,1,0,1,0
14426,28,0,0,68,68,0,1,0,1,0
20686,28,0,0,70,70,0,1,0,1,0
22055,28,0,0,70,70,0,1,0,1,0
18436,28,0,0,68,68,0,1,0,1,0
9412,28,0,0,70,70,0,1,0,1,0
22339,28,0,0,66,66,0,1,0,1,0
10498,28,0,0,67,67,0,1,0,1,0
9462,28,0,0,70,70,0,1,0,1,0
9628,28,0,0,70,70,0,1,0,1,0
21559,28,0,0,66,66,0,1,0,1,0
11614,28,0,0,66,66,0,1,0,1,0
19717,28,0,0,67,67,0,1,0,1,0
22470,28,0,0,68,68,0,1,0,1,0
8742,28,0,0,70,70,0,1,0,1,0
17353,28,0,0,66,66,0,1,0,1,0
19298,28,0,0,70,70,0,1,0,1,0
10347,28,0,0,66,66,0,1,0,1,0
20211,28,0,0,70,70,0,1,0,1,0
21695,28,0,0,70,70,0,1,0,1,0
17009,28,0,0,67,67,0,1,0,1,0
20542,28,0,0,70,70,0,1,0,1,0
16589,28,0,0,70,70,0,1,0,1,0
13173,28,0,0,66,66,0,1,0,1,0
15195,28,0,0,70,70,0,1,0,1,0
17204,28,0,0,70,70,0,1,0,1,0
19293,28,0,0,66,66,0,1,0,1,0
15055,28,0,0,70,70,0,1,0,1,0
13880,28,0,0,70,70,0,1,0,1,0
14619,28,0,0,70,70,0,1,0,1,0
14137,28,0,0,70,70,0,1,0,1,0
19405,28,0,0,66,66,0,1,0,1,0
17237,28,0,0,66,66,0,1,0,1,0
18780,28,0,0,69,69,0,1,0,1,0
19480,28,0,0,70,70,0,1,0,1,0
17776,28,0,0,70,70,0,1,0,1,0
8365,28,0,0,66,66,0,1,0,1,0
19313,28,0,0,66,66,0,1,0,1,0
8868,28,0,0,70,70,0,1,0,1,0
9227,28,0,0,70,70,0,1,0,1,0
13997,28,0,0,70,70,0,1,0,1,0
13835,28,0,0,68,68,0,1,0,1,0
14329,28,0,0,70,70,0,1,0,1,0
13978,28,0,0,70,70,0,1,0,1,0
8782,28,0,0,67,67,0,1,0,1,0
19526,28,0,0,70,70,0,1,0,1,0
10191,28,0,0,66,66,0,1,0,1,0
19040,28,0,0,70,70,0,1,0,1,0
11585,28,0,0,70,70,0,1,0,1,0
20592,28,0,0,66,66,0,1,0,1,0
14318,28,0,0,70,70,0,1,0,1,0
14101,28,0,0,68,68,0,1,0,1,0
17113,28,0,0,69,69,0,1,0,1,0
19802,28,0,0,66,66,0,1,0,1,0
11721,28,0,0,70,70,0,1,0,1,0
16057,28,0,0,70,70,0,1,0,1,0
17955,28,0,0,70,70,0,1,0,1,0
17353,28,0,0,70,70,0,1,0,1,0
9777,28,0,0,70,70,0,1,0,1,0
20366,28,0,0,66,66,0,1,0,1,0
14759,28,0,0,70,70,0,1,0,1,0
13171,28,0,0,70,70,0,1,0,1,0
17459,28,0,0,70,70,0,1,0,1,0
16901,28,0,0,66,66,0,1,0,1,0
21266,28,0,0,70,70,0,1,0,1,0
16870,28,0,0,68,68,0,1,0,1,0
10379,28,0,0,70,70,0,1,0,1,0
11070,28,0,0,66,66,0,1,0,1,0
20874,28,0,0,70,70,0,1,0,1,0
14401,28,0,0,70,70,0,1,0,1,0
8353,28,0,0,67,67,0,1,0,1,0
12654,28,0,0,66,66,0,1,0,1,0
13432,28,0,0,70,70,0,1,0,1,0
9826,28,0,0,70,70,0,1,0,1,0
20036,28,0,0,70,70,0,1,0,1,0
13780,28,0,0,70,70,0,1,0,1,0
17335,28,0,0,70,70,0,1,0,1,0
18957,28,0,0,70,70,0,1,0,1,0
13909,28,0,0,70,70,0,1,0,1,0
14405,28,0,0,70,70,0,1,0,1,0
19852,28,0,0,70,70,0,1,0,1,0
17731,28,0,0,66,66,0,1,0,1,0
20719,28,0,0,70,70,0,1,0,1,0
16427,28,0,0,70,70,0,1,0,1,0
9923,28,0,0,70,70,0,1,0,1,0
11941,28,0,0,70,70,0,1,0,1,0
13780,28,0,0,70,70,0,1,0,1,0
17056,28,0,0,66,66,0,1,0,1,0
12510,28,0,0,70,70,0,1,0,1,0
14923,28,0,0,67,67,0,1,0,1,0
12994,28,0,0,66,66,0,1,0,1,0
10285,28,0,0,70,70,0,1,0,1,0
21036,28,0,0,70,70,0,1,0,1,0
13689,28,0,0,66,66,0,1,0,1,0
11710,28,0,0,66,66,0,1,0,1,0
18654,28,0,0,70,70,0,1,0,1,0
16407,28,0,0,70,70,0,1,0,1,0
10973,28,0,0,69,69,0,1,0,1,0
19558,28,0,0,70,70,0,1,0,1,0
17816,28,0,0,70,70,0,1,0,1,0
13180,28,0,0,68,68,0,1,0,1,0
19726,28,0,0,66,66,0,1,0,1,0
15366,28,0,0,68,68,0,1,0,1,0
12498,28,0,0,69,69,0,1,0,1,0
19237,28,0,0,70,70,0,1,0,1,0
18184,28,0,0,70,70,0,1,0,1,0
11880,28,0,0,70,70,0,1,0,1,0
11031,28,0,0,70,70,0,1,0,1,0
18673,28,0,0,67,67,0,1,0,1,0
22076,28,0,0,70,70,0,1,0,1,0
11211,28,0,0,70,70,0,1,0,1,0
19911,28,0,0,66,66,0,1,0,1,0
10302,28,0,0,67,67,0,1,0,1,0
20754,28,0,0,70,70,0,1,0,1,0
17194,28,0,0,70,70,0,1,0,1,0
11973,28,0,0,70,70,0,1,0,1,0
18641,28,0,0,70,70,0,1,0,1,0
16811,28,0,0,66,66,0,1,0,1,0
15751,28,0,0,70,70,0,1,0,1,0
22165,28,0,0,68,68,0,1,0,1,0
13735,28,0,0,70,70,0,1,0,1,0
11554,28,0,0,70,70,0,1,0,1,0
17730,28,0,0,70,70,0,1,0,1,0
13782,28,0,0,70,70,0,1,0,1,0
12085,28,0,0,66,66,0,1,0,1,0
20678,28,0,0,68,68,0,1,0,1,0
12818,28,0,0,70,70,0,1,0,1,0
9747,28,0,0,70,70,0,1,0,1,0
12719,28,0,0,66,66,0,1,0,1,0
14115,28,0,0,67,67,0,1,0,1,0
22344,28,0,0,67,67,0,1,0,1,0
17799,28,0,0,68,68,0,1,0,1,0
21582,28,0,0,70,70,0,1,0,1,0
15046,28,0,0,70,70,0,1,0,1,0
11092,28,0,0,70,70,0,1,0,1,0
12877,28,0,0,70,70,0,1,0,1,0
16283,28,0,0,70,70,0,1,0,1,0
9623,28,0,0,66,66,0,1,0,1,0
9707,28,0,0,66,66,0,1,0,1,0
19325,28,0,0,70,70,0,1,0,1,0
19769,28,0,0,70,70,0,1,0,1,0
20747,28,0,0,69,69,0,1,0,1,0
10127,28,0,0,70,70,0,1,0,1,0
11418,28,0,0,67,67,0,1,0,1,0
9867,28,0,0,70,70,0,1,0,1,0
8364,28,0,0,66,66,0,1,0,1,0
14323,28,0,0,70,70,0,1,0,1,0
9930,28,0,0,70,70,0,1,0,1,0
17738,28,0,0,70,70,0,1,0,1,0
15883,28,0,0,69,69,0,1,0,1,0
8386,28,0,0,67,67,0,1,0,1,0
13346,28,0,0,68,68,0,1,0,1,0
15470,28,0,0,70,70,0,1,0,1,0
20781,28,0,0,70,70,0,1,0,1,0
20213,28,0,0,70,70,0,1,0,1,0
22086,28,0,0,70,70,0,1,0,1,0
8960,28,0,0,70,70,0,1,0,1,0
20398,28,0,0,70,70,0,1,0,1,0
11606,28,0,0,66,66,0,1,0,1,0
21857,28,0,0,66,66,0,1,0,1,0
13485,28,0,0,70,70,0,1,0,1,0
21680,28,0,0,70,70,0,1,0,1,0
9546,28,0,0,70,70,0,1,0,1,0
17233,28,0,0,70,70,0,1,0,1,0
17591,28,0,0,70,70,0,1,0,1,0
10667,28,0,0,66,66,0,1,0,1,0
9413,28,0,0,70,70,0,1,0,1,0
17095,28,0,0,70,70,0,1,0,1,0
13857,28,0,0,70,70,0,1,0,1,0
10136,28,0,0,70,70,0,1,0,1,0
22562,28,0,0,66,66,0,1,0,1,0
20412,28,0,0,70,70,0,1,0,1,0
18056,28,0,0,66,66,0,1,0,1,0
12525,28,0,0,70,70,0,1,0,1,0
15907,28,0,0,66,66,0,1,0,1,0
14653,28,0,0,70,70,0,1,0,1,0
11097,28,0,0,70,70,0,1,0,1,0
9616,28,0,0,66,66,0,1,0,1,0
10190,28,0,0,70,70,0,1,0,1,0
22666,28,0,0,69,69,0,1,0,1,0
16698,28,0,0,67,67,0,1,0,1,0
12082,28,0,0,70,70,0,1,0,1,0
9304,28,0,0,70,70,0,1,0,1,0
19909,28,0,0,70,70,0,1,0,1,0
15264,28,0,0,67,67,0,1,0,1,0
17408,28,0,0,66,66,0,1,0,1,0
14340,28,0,0,70,70,0,1,0,1,0
12567,28,0,0,70,70,0,1,0,1,0
12992,28,0,0,70,70,0,1,0,1,0
17811,28,0,0,66,66,0,1,0,1,0
11406,28,0,0,70,70,0,1,0,1,0
10634,28,0,0,70,70,0,1,0,1,0
22336,28,0,0,68,68,0,1,0,1,0
13778,28,0,0,70,70,0,1,0,1,0
16136,28,0,0,70,70,0,1,0,1,0
16586,28,0,0,70,70,0,1,0,1,0
13485,28,0,0,67,67,0,1,0,1,0
21936,28,0,0,70,70,0,1,0,1,0
9298,28,0,0,70,70,0,1,0,1,0
12915,28,0,0,66,66,0,1,0,1,0
18593,28,0,0,70,70,0,1,0,1,0
14959,28,0,0,68,68,0,1,0,1,0
17852,28,0,0,70,70,0,1,0,1,0
13646,28,0,0,68,68,0,1,0,1,0
19426,28,0,0,66,66,0,1,0,1,0
21318,28,0,0,70,70,0,1,0,1,0
16450,28,0,0,66,66,0,1,0,1,0
21652,28,0,0,66,66,0,1,0,1,0
8587,28,0,0,70,70,0,1,0,1,0
9685,28,0,0,66,66,0,1,0,1,0
17356,28,0,0,70,70,0,1,0,1,0
10081,28,0,0,70,70,0,1,0,1,0
18113,28,0,0,70,70,0,1,0,1,0
20865,28,0,0,66,66,0,1,0,1,0
14543,28,0,0,70,70,0,1,0,1,0
17349,28,0,0,70,70,0,1,0,1,0
13778,28,0,0,70,70,0,1,0,1,0
11546,28,0,0,66,66,0,1,0,1,0
19817,28,0,0,67,67,0,1,0,1,0
18442,28,0,0,66,66,0,1,0,1,0
12242,28,0,0,66,66,0,1,0,1,0
15365,28,0,0,66,66,0,1,0,1,0
15533,28,0,0,70,70,0,1,0,1,0
21225,28,0,0,70,70,0,1,0,1,0
21122,28,0,0,66,66,0,1,0,1,0
20778,28,0,0,66,66,0,1,0,1,0
8827,28,0,0,70,70,0,1,0,1,0
19936,28,0,0,70,70,0,1,0,1,0
15168,28,0,0,70,70,0,1,0,1,0
8611,28,0,0,70,70,0,1,0,1,0
11329,28,0,0,70,70,0,1,0,1,0
12949,28,0,0,67,67,0,1,0,1,0
17259,28,0,0,70,70,0,1,0,1,0
13727,28,0,0,70,70,0,1,0,1,0
21548,28,0,0,66,66,0,1,0,1,0
19625,28,0,0,70,70,0,1,0,1,0
16978,28,0,0,70,70,0,1,0,1,0
14368,28,0,0,66,66,0,1,0,1,0
19978,28,0,0,66,66,0,1,0,1,0
15127,28,0,0,70,70,0,1,0,1,0
19661,28,0,0,70,70,0,1,0,1,0
13274,28,0,0,70,70,0,1,0,1,0
13665,28,0,0,70,70,0,1,0,1,0
15229,28,0,0,69,69,0,1,0,1,0
14064,28,0,0,70,70,0,1,0,1,0
20809,28,0,0,70,70,0,1,0,1,0
18437,28,0,0,70,70,0,1,0,1,0
10326,28,0,0,66,66,0,1,0,1,0
9942,28,0,0,70,70,0,1,0,1,0
9238,28,0,0,69,69,0,1,0,1,0
21818,28,0,0,70,70,0,1,0,1,0
16688,28,0,0,70,70,0,1,0,1,0
13309,28,0,0,70,70,0,1,0,1,0
11297,28,0,0,66,66,0,1,0,1,0
13499,28,0,0,70,70,0,1,0,1,0
12123,28,0,0,70,70,0,1,0,1,0
20882,28,0,0,70,70,0,1,0,1,0
10785,28,0,0,70,70,0,1,0,1,0
16442,28,0,0,70,70,0,1,0,1,0
18663,28,0,0,70,70,0,1,0,1,0
21481,28,0,0,70,70,0,1,0,1,0
8811,28,0,0,70,70,0,1,0,1,0
13781,28,0,0,70,70,0,1,0,1,0
8424,28,0,0,70,70,0,1,0,1,0
13363,28,0,0,70,70,0,1,0,1,0
9069,28,0,0,70,70,0,1,0,1,0
12786,28,0,0,66,66,0,1,0,1,0
12197,28,0,0,66,66,0,1,0,1,0
11040,28,0,0,70,70,0,1,0,1,0
11977,28,0,0,70,70,0,1,0,1,0
11139,28,0,0,66,66,0,1,0,1,0
20177,28,0,0,66,66,0,1,0,1,0
20067,28,0,0,66,66,0,1,0,1,0
17598,28,0,0,66,66,0,1,0,1,0
14334,28,0,0,70,70,0,1,0,1,0
14562,28,0,0,68,68,0,1,0,1,0
11429,28,0,0,69,69,0,1,0,1,0
13935,28,0,0,66,66,0,1,0,1,0
19457,28,0,0,69,69,0,1,0,1,0
13063,28,0,0,66,66,0,1,0,1,0
21265,28,0,0,70,70,0,1,0,1,0
12727,28,0,0,70,70,0,1,0,1,0
19737,28,0,0,67,67,0,1,0,1,0
14094,28,0,0,70,70,0,1,0,1,0
13425,28,0,0,66,66,0,1,0,1,0
13026,28,0,0,70,70,0,1,0,1,0
15775,28,0,0,67,67,0,1,0,1,0
10172,28,0,0,66,66,0,1,0,1,0
17561,28,0,0,68,68,0,1,0,1,0
14262,28,0,0,70,70,0,1,0,1,0
13539,28,0,0,70,70,0,1,0,1,0
21481,28,0,0,67,67,0,1,0,1,0
16429,28,0,0,70,70,0,1,0,1,0
19454,28,0,0,70,70,0,1,0,1,0
19038,28,0,0,66,66,0,1,0,1,0
10160,28,0,0,70,70,0,1,0,1,0
19534,28,0,0,70,70,0,1,0,1,0
19005,28,0,0,70,70,0,1,0,1,0
16081,28,0,0,70,70,0,1,0,1,0
9939,28,0,0,66,66,0,1,0,1,0
8977,28,0,0,70,70,0,1,0,1,0
19910,28,0,0,70,70,0,1,0,1,0
14137,28,0,0,70,70,0,1,0,1,0
13366,28,0,0,70,70,0,1,0,1,0
13100,28,0,0,66,66,0,1,0,1,0
19719,28,0,0,70,70,0,1,0,1,0
13342,28,0,0,68,68,0,1,0,1,0
15255,28,0,0,70,70,0,1,0,1,0
21793,28,0,0,70,70,0,1,0,1,0
9891,28,0,0,66,66,0,1,0,1,0
10137,28,0,0,70,70,0,1,0,1,0
13347,28,0,0,70,70,0,1,0,1,0
22259,28,0,0,66,66,0,1,0,1,0
20886,28,0,0,69,69,0,1,0,1,0
17223,28,0,0,67,67,0,1,0,1,0
9047,28,0,0,70,70,0,1,0,1,0
18370,28,0,0,66,66,0,1,0,1,0
20737,28,0,0,66,66,0,1,0,1,0
13736,28,0,0,70,70,0,1,0,1,0
21736,28,0,0,70,70,0,1,0,1,0
21488,28,0,0,66,66,0,1,0,1,0
15723,28,0,0,70,70,0,1,0,1,0
20750,28,0,0,68,68,0,1,0,1,0
20973,28,0,0,70,70,0,1,0,1,0
18483,28,0,0,67,67,0,1,0,1,0
17727,28,0,0,70,70,0,1,0,1,0
18272,28,0,0,67,67,0,1,0,1,0
8952,28,0,0,70,70,0,1,0,1,0
9789,28,0,0,70,70,0,1,0,1,0
20258,28,0,0,66,66,0,1,0,1,0
15775,28,0,0,66,66,0,1,0,1,0
9110,28,0,0,70,70,0,1,0,1,0
22360,28,0,0,70,70,0,1,0,1,0
18954,28,0,0,70,70,0,1,0,1,0
21861,28,0,0,67,67,0,1,0,1,0
17450,28,0,0,70,70,0,1,0,1,0
19162,28,0,0,66,66,0,1,0,1,0
9920,28,0,0,67,67,0,1,0,1,0
9608,28,0,0,70,70,0,1,0,1,0
9158,28,0,0,70,70,0,1,0,1,0
16541,28,0,0,69,69,0,1,0,1,0
15241,28,0,0,70,70,0,1,0,1,0
9788,28,0,0,70,70,0,1,0,1,0
13250,28,0,0,70,70,0,1,0,1,0
17451,28,0,0,70,70,0,1,0,1,0
9450,28,0,0,70,70,0,1,0,1,0
8974,28,0,0,70,70,0,1,0,1,0
9972,28,0,0,70,70,0,1,0,1,0
16071,28,0,0,66,66,0,1,0,1,0
20312,28,0,0,66,66,0,1,0,1,0
13969,28,0,0,70,70,0,1,0,1,0
8853,28,0,0,69,69,0,1,0,1,0
19371,28,0,0,70,70,0,1,0,1,0
8724,28,0,0,70,70,0,1,0,1,0
11281,28,0,0,70,70,0,1,0,1,0
15168,28,0,0,70,70,0,1,0,1,0
20720,28,0,0,70,70,0,1,0,1,0
21004,28,0,0,66,66,0,1,0,1,0
21833,28,0,0,66,66,0,1,0,1,0
14994,28,0,0,70,70,0,1,0,1,0
15800,28,0,0,70,70,0,1,0,1,0
14287,28,0,0,70,70,0,1,0,1,0
20005,28,0,0,69,69,0,1,0,1,0
8488,28,0,0,70,70,0,1,0,1,0
13058,28,0,0,68,68,0,1,0,1,0
9686,28,0,0,66,66,0,1,0,1,0
20397,28,0,0,70,70,0,1,0,1,0
11011,28,0,0,70,70,0,1,0,1,0
12782,28,0,0,69,69,0,1,0,1,0
9487,28,0,0,69,69,0,1,0,1,0
17971,28,0,0,66,66,0,1,0,1,0
14053,28,0,0,66,66,0,1,0,1,0
19714,28,0,0,70,70,0,1,0,1,0
17057,28,0,0,68,68,0,1,0,1,0
18056,28,0,0,69,69,0,1,0,1,0
13434,28,0,0,69,69,0,1,0,1,0
14278,28,0,0,70,70,0,1,0,1,0
9125,28,0,0,70,70,0,1,0,1,0
19268,28,0,0,67,67,0,1,0,1,0
20367,28,0,0,66,66,0,1,0,1,0
10668,28,0,0,67,67,0,1,0,1,0
9408,28,0,0,70,70,0,1,0,1,0
9849,28,0,0,70,70,0,1,0,1,0
10194,28,0,0,70,70,0,1,0,1,0
8806,28,0,0,68,68,0,1,0,1,0
14344,28,0,0,70,70,0,1,0,1,0
12170,28,0,0,70,70,0,1,0,1,0
9754,28,0,0,70,70,0,1,0,1,0
8657,28,0,0,70,70,0,1,0,1,0
21680,28,0,0,69,69,0,1,0,1,0
9785,28,0,0,70,70,0,1,0,1,0
10154,28,0,0,66,66,0,1,0,1,0
14245,28,0,0,70,70,0,1,0,1,0
22450,28,0,0,70,70,0,1,0,1,0
12741,28,0,0,70,70,0,1,0,1,0
15200,28,0,0,70,70,0,1,0,1,0
9576,28,0,0,67,67,0,1,0,1,0
15258,28,0,0,70,70,0,1,0,1,0
12545,28,0,0,70,70,0,1,0,1,0
10136,28,0,0,70,70,0,1,0,1,0
12001,28,0,0,66,66,0,1,0,1,0
17530,28,0,0,68,68,0,1,0,1,0
19488,28,0,0,70,70,0,1,0,1,0
21841,28,0,0,70,70,0,1,0,1,0
19626,28,0,0,70,70,0,1,0,1,0
10189,28,0,0,70,70,0,1,0,1,0
19552,28,0,0,70,70,0,1,0,1,0
17486,28,0,0,70,70,0,1,0,1,0
12377,28,0,0,70,70,0,1,0,1,0
13360,28,0,0,68,68,0,1,0,1,0
10040,28,0,0,70,70,0,1,0,1,0
20724,28,0,0,66,66,0,1,0,1,0
14690,28,0,0,66,66,0,1,0,1,0
17346,28,0,0,70,70,0,1,0,1,0
14430,28,0,0,66,66,0,1,0,1,0
21766,28,0,0,67,67,0,1,0,1,0
10282,28,0,0,70,70,0,1,0,1,0
13577,28,0,0,70,70,0,1,0,1,0
10413,28,0,0,70,70,0,1,0,1,0
20017,28,0,0,70,70,0,1,0,1,0
9340,28,0,0,70,70,0,1,0,1,0
9627,28,0,0,70,70,0,1,0,1,0
10391,28,0,0,70,70,0,1,0,1,0
11720,28,0,0,66,66,0,1,0,1,0
21319,28,0,0,70,70,0,1,0,1,0
16574,28,0,0,70,70,0,1,0,1,0
14538,28,0,0,69,69,0,1,0,1,0
21916,28,0,0,70,70,0,1,0,1,0
11583,28,0,0,67,67,0,1,0,1,0
19639,28,0,0,66,66,0,1,0,1,0
19150,28,0,0,66,66,0,1,0,1,0
9256,28,0,0,66,66,0,1,0,1,0
11829,28,0,0,66,66,0,1,0,1,0
9228,28,0,0,70,70,0,1,0,1,0
8432,28,0,0,70,70,0,1,0,1,0
16387,28,0,0,66,66,0,1,0,1,0
19327,28,0,0,70,70,0,1,0,1,0
16044,28,0,0,69,69,0,1,0,1,0
19374,28,0,0,70,70,0,1,0,1,0
22011,28,0,0,66,66,0,1,0,1,0
19833,28,0,0,66,66,0,1,0,1,0
19193,28,0,0,66,66,0,1,0,1,0
9473,28,0,0,70,70,0,1,0,1,0
19373,28,0,0,70,70,0,1,0,1,0
13205,28,0,0,70,70,0,1,0,1,0
16108,28,0,0,70,70,0,1,0,1,0
18704,28,0,0,70,70,0,1,0,1,0
10976,28,0,0,70,70,0,1,0,1,0
11562,28,0,0,66,66,0,1,0,1,0
10081,28,0,0,67,67,0,1,0,1,0
22273,28,0,0,66,66,0,1,0,1,0
17775,28,0,0,70,70,0,1,0,1,0
21792,28,0,0,70,70,0,1,0,1,0
9653,28,0,0,70,70,0,1,0,1,0
9801,28,0,0,66,66,0,1,0,1,0
16082,28,0,0,66,66,0,1,0,1,0
17733,28,0,0,66,66,0,1,0,1,0
17291,28,0,0,66,66,0,1,0,1,0
9973,28,0,0,67,67,0,1,0,1,0
11364,28,0,0,70,70,0,1,0,1,0
9070,28,0,0,70,70,0,1,0,1,0
15756,28,0,0,70,70,0,1,0,1,0
20046,28,0,0,70,70,0,1,0,1,0
17726,28,0,0,70,70,0,1,0,1,0
16597,28,0,0,69,69,0,1,0,1,0
9059,28,0,0,68,68,0,1,0,1,0
15411,28,0,0,70,70,0,1,0,1,0
10526,28,0,0,70,70,0,1,0,1,0
19723,28,0,0,70,70,0,1,0,1,0
17037,28,0,0,66,66,0,1,0,1,0
13593,28,0,0,70,70,0,1,0,1,0
19869,28,0,0,70,70,0,1,0,1,0
22700,28,0,0,70,70,0,1,0,1,0
22546,28,0,0,66,66,0,1,0,1,0
16472,28,0,0,70,70,0,1,0,1,0
9170,28,0,0,70,70,0,1,0,1,0
14354,28,0,0,69,69,0,1,0,1,0
16993,28,0,0,69,69,0,1,0,1,0
14088,28,0,0,70,70,0,1,0,1,0
19667,28,0,0,69,69,0,1,0,1,0
16470,28,0,0,70,70,0,1,0,1,0
13579,28,0,0,70,70,0,1,0,1,0
17218,28,0,0,70,70,0,1,0,1,0
10538,28,0,0,70,70,0,1,0,1,0
20765,28,0,0,70,70,0,1,0,1,0
9050,28,0,0,70,70,0,1,0,1,0
22551,28,0,0,67,67,0,1,0,1,0
11171,28,0,0,70,70,0,1,0,1,0
14426,28,0,0,70,70,0,1,0,1,0
15801,28,0,0,70,70,0,1,0,1,0
9503,28,0,0,70,70,0,1,0,1,0
16735,28,0,0,70,70,0,1,0,1,0
20966,28,0,0,70,70,0,1,0,1,0
11249,28,0,0,66,66,0,1,0,1,0
14289,28,0,0,70,70,0,1,0,1,0
20296,28,0,0,70,70,0,1,0,1,0
9997,28,0,0,66,66,0,1,0,1,0
17786,28,0,0,68,68,0,1,0,1,0
16874,28,0,0,70,70,0,1,0,1,0
14787,28,0,0,69,69,0,1,0,1,0
18711,28,0,0,70,70,0,1,0,1,0
9706,28,0,0,66,66,0,1,0,1,0
14311,28,0,0,70,70,0,1,0,1,0
11993,28,0,0,70,70,0,1,0,1,0
13097,28,0,0,70,70,0,1,0,1,0
19454,28,0,0,66,66,0,1,0,1,0
21312,28,0,0,67,67,0,1,0,1,0
12903,28,0,0,67,67,0,1,0,1,0
11385,28,0,0,70,70,0,1,0,1,0
10027,28,0,0,70,70,0,1,0,1,0
18240,28,0,0,67,67,0,1,0,1,0
12839,28,0,0,68,68,0,1,0,1,0
9585,28,0,0,67,67,0,1,0,1,0
11770,28,0,0,67,67,0,1,0,1,0
21025,28,0,0,70,70,0,1,0,1,0
15363,28,0,0,66,66,0,1,0,1,0
9274,28,0,0,70,70,0,1,0,1,0
16512,28,0,0,66,66,0,1,0,1,0
15156,28,0,0,68,68,0,1,0,1,0
13309,28,0,0,70,70,0,1,0,1,0
20105,28,0,0,70,70,0,1,0,1,0
9608,28,0,0,70,70,0,1,0,1,0
19661,28,0,0,70,70,0,1,0,1,0
20074,28,0,0,66,66,0,1,0,1,0
17812,28,0,0,70,70,0,1,0,1,0
16721,28,0,0,70,70,0,1,0,1,0
11827,28,0,0,69,69,0,1,0,1,0
17040,28,0,0,70,70,0,1,0,1,0
9863,28,0,0,66,66,0,1,0,1,0
17645,28,0,0,68,68,0,1,0,1,0
21721,28,0,0,70,70,0,1,0,1,0
10537,28,0,0,70,70,0,1,0,1,0
20904,28,0,0,70,70,0,1,0,1,0
17520,28,0,0,68,68,0,1,0,1,0
13049,28,0,0,70,70,0,1,0,1,0
18201,28,0,0,70,70,0,1,0,1,0
10094,28,0,0,70,70,0,1,0,1,0
12923,28,0,0,70,70,0,1,0,1,0
8975,28,0,0,70,70,0,1,0,1,0
13459,28,0,0,67,67,0,1,0,1,0
9494,28,0,0,70,70,0,1,0,1,0
11722,28,0,0,70,70,0,1,0,1,0
10344,28,0,0,66,66,0,1,0,1,0
9781,28,0,0,70,70,0,1,0,1,0
17426,28,0,0,66,66,0,1,0,1,0
14925,28,0,0,70,70,0,1,0,1,0
11332,28,0,0,70,70,0,1,0,1,0
16103,28,0,0,70,70,0,1,0,1,0
9117,28,0,0,69,69,0,1,0,1,0
9323,28,0,0,70,70,0,1,0,1,0
18342,28,0,0,70,70,0,1,0,1,0
20329,28,0,0,70,70,0,1,0,1,0
20909,28,0,0,66,66,0,1,0,1,0
20980,28,0,0,70,70,0,1,0,1,0
19838,28,0,0,70,70,0,1,0,1,0
10658,28,0,0,69,69,0,1,0,1,0
20510,28,0,0,66,66,0,1,0,1,0
14173,28,0,0,66,66,0,1,0,1,0
20074,28,0,0,66,66,0,1,0,1,0
16233,28,0,0,70,70,0,1,0,1,0
9632,28,0,0,70,70,0,1,0,1,0
14784,28,0,0,66,66,0,1,0,1,0
8492,28,0,0,70,70,0,1,0,1,0
9412,28,0,0,70,70,0,1,0,1,0
22268,28,0,0,70,70,0,1,0,1,0
18406,28,0,0,70,70,0,1,0,1,0
18965,28,0,0,70,70,0,1,0,1,0
10061,28,0,0,66,66,0,1,0,1,0
20197,28,0,0,69,69,0,1,0,1,0
21731,28,0,0,67,67,0,1,0,1,0
22386,28,0,0,70,70,0,1,0,1,0
20656,28,0,0,68,68,0,1,0,1,0
8566,28,0,0,70,70,0,1,0,1,0
13094,28,0,0,70,70,0,1,0,1,0
15774,28,0,0,70,70,0,1,0,1,0
17595,28,0,0,70,70,0,1,0,1,0
8940,28,0,0,68,68,0,1,0,1,0
15465,28,0,0,66,66,0,1,0,1,0
11436,28,0,0,70,70,0,1,0,1,0
13313,28,0,0,67,67,0,1,0,1,0
17126,28,0,0,67,67,0,1,0,1,0
18023,28,0,0,66,66,0,1,0,1,0
10107,28,0,0,66,66,0,1,0,1,0
21183,28,0,0,70,70,0,1,0,1,0
13263,28,0,0,70,70,0,1,0,1,0
22597,28,0,0,66,66,0,1,0,1,0
15313,28,0,0,70,70,0,1,0,1,0
19034,28,0,0,70,70,0,1,0,1,0
12157,28,0,0,66,66,0,1,0,1,0
17266,28,0,0,70,70,0,1,0,1,0
18210,28,0,0,70,70,0,1,0,1,0
19993,28,0,0,70,70,0,1,0,1,0
8672,28,0,0,66,66,0,1,0,1,0
11562,28,0,0,66,66,0,1,0,1,0
9759,28,0,0,70,70,0,1,0,1,0
13268,28,0,0,68,68,0,1,0,1,0
10139,28,0,0,67,67,0,1,0,1,0
12714,28,0,0,70,70,0,1,0,1,0
19887,28,0,0,67,67,0,1,0,1,0
18047,28,0,0,70,70,0,1,0,1,0
15711,28,0,0,66,66,0,1,0,1,0
14880,28,0,0,70,70,0,1,0,1,0
10161,28,0,0,70,70,0,1,0,1,0
17827,28,0,0,70,70,0,1,0,1,0
9612,28,0,0,66,66,0,1,0,1,0
9916,28,0,0,70,70,0,1,0,1,0
17748,28,0,0,70,70,0,1,0,1,0
15341,28,0,0,70,70,0,1,0,1,0
15898,28,0,0,70,70,0,1,0,1,0
17489,28,0,0,70,70,0,1,0,1,0
20564,28,0,0,70,70,0,1,0,1,0
22435,28,0,0,70,70,0,1,0,1,0
21525,28,0,0,70,70,0,1,0,1,0
8947,28,0,0,70,70,0,1,0,1,0
18653,28,0,0,70,70,0,1,0,1,0
12346,28,0,0,70,70,0,1,0,1,0
17648,28,0,0,66,66,0,1,0,1,0
18904,28,0,0,66,66,0,1,0,1,0
16224,28,0,0,69,69,0,1,0,1,0
13474,28,0,0,66,66,0,1,0,1,0
19862,28,0,0,68,68,0,1,0,1,0
9692,28,0,0,70,70,0,1,0,1,0
14303,28,0,0,70,70,0,1,0,1,0
16195,28,0,0,70,70,0,1,0,1,0
22032,28,0,0,66,66,0,1,0,1,0
12404,28,0,0,67,67,0,1,0,1,0
20444,28,0,0,70,70,0,1,0,1,0
20219,28,0,0,68,68,0,1,0,1,0
21222,28,0,0,69,69,0,1,0,1,0
14858,28,0,0,70,70,0,1,0,1,0
13589,28,0,0,70,70,0,1,0,1,0
13641,28,0,0,66,66,0,1,0,1,0
10384,28,0,0,70,70,0,1,0,1,0
16893,28,0,0,70,70,0,1,0,1,0
22528,28,0,0,69,69,0,1,0,1,0
21353,28,0,0,70,70,0,1,0,1,0
12720,28,0,0,66,66,0,1,0,1,0
22226,28,0,0,70,70,0,1,0,1,0
16513,28,0,0,66,66,0,1,0,1,0
10933,28,0,0,70,70,0,1,0,1,0
21031,28,0,0,66,66,0,1,0,1,0
13727,28,0,0,70,70,0,1,0,1,0
20889,28,0,0,70,70,0,1,0,1,0
20495,28,0,0,70,70,0,1,0,1,0
10120,28,0,0,70,70,0,1,0,1,0
9904,28,0,0,66,66,0,1,0,1,0
19434,28,0,0,68,68,0,1,0,1,0
17306,28,0,0,66,66,0,1,0,1,0
15235,28,0,0,67,67,0,1,0,1,0
10372,28,0,0,70,70,0,1,0,1,0
19677,28,0,0,70,70,0,1,0,1,0
16083,28,0,0,66,66,0,1,0,1,0
22200,28,0,0,66,66,0,1,0,1,0
13950,28,0,0,67,67,0,1,0,1,0
18319,28,0,0,66,66,0,1,0,1,0
11805,28,0,0,68,68,0,1,0,1,0
16754,28,0,0,70,70,0,1,0,1,0
8934,28,0,0,69,69,0,1,0,1,0
14732,28,0,0,67,67,0,1,0,1,0
13652,28,0,0,70,70,0,1,0,1,0
17999,28,0,0,70,70,0,1,0,1,0
20184,28,0,0,70,70,0,1,0,1,0
22102,28,0,0,66,66,0,1,0,1,0
11565,28,0,0,70,70,0,1,0,1,0
14544,28,0,0,70,70,0,1,0,1,0
16446,28,0,0,70,70,0,1,0,1,0
20018,28,0,0,66,66,0,1,0,1,0
16066,28,0,0,66,66,0,1,0,1,0
13779,28,0,0,70,70,0,1,0,1,0
12320,28,0,0,70,70,0,1,0,1,0
20197,28,0,0,66,66,0,1,0,1,0
20512,28,0,0,70,70,0,1,0,1,0
10114,28,0,0,66,66,0,1,0,1,0
16672,28,0,0,70,70,0,1,0,1,0
10722,28,0,0,70,70,0,1,0,1,0
12947,28,0,0,70,70,0,1,0,1,0
20744,28,0,0,70,70,0,1,0,1,0
14287,28,0,0,70,70,0,1,0,1,0
16993,28,0,0,68,68,0,1,0,1,0
16422,28,0,0,70,70,0,1,0,1,0
19350,28,0,0,70,70,0,1,0,1,0
14726,28,0,0,70,70,0,1,0,1,0
15814,28,0,0,66,66,0,1,0,1,0
11304,28,0,0,69,69,0,1,0,1,0
18769,28,0,0,66,66,0,1,0,1,0
19926,28,0,0,70,70,0,1,0,1,0
16210,28,0,0,70,70,0,1,0,1,0
9219,28,0,0,70,70,0,1,0,1,0
17878,28,0,0,70,70,0,1,0,1,0
20231,28,0,0,69,69,0,1,0,1,0
20558,28,0,0,70,70,0,1,0,1,0
12276,28,0,0,66,66,0,1,0,1,0
16957,28,0,0,70,70,0,1,0,1,0
21158,28,0,0,70,70,0,1,0,1,0
16767,28,0,0,70,70,0,1,0,1,0
16203,28,0,0,66,66,0,1,0,1,0
19017,28,0,0,70,70,0,1,0,1,0
19880,28,0,0,70,70,0,1,0,1,0
15947,28,0,0,70,70,0,1,0,1,0
20687,28,0,0,69,69,0,1,0,1,0
20121,28,0,0,66,66,0,1,0,1,0
22704,28,0,0,68,68,0,1,0,1,0
19246,28,0,0,69,69,0,1,0,1,0
16516,28,0,0,70,70,0,1,0,1,0
17656,28,0,0,66,66,0,1,0,1,0
19883,28,0,0,69,69,0,1,0,1,0
10756,28,0,0,70,70,0,1,0,1,0
12811,28,0,0,70,70,0,1,0,1,0
19425,28,0,0,67,67,0,1,0,1,0
10082,28,0,0,69,69,0,1,0,1,0
12260,28,0,0,66,66,0,1,0,1,0
22090,28,0,0,70,70,0,1,0,1,0
10552,28,0,0,66,66,0,1,0,1,0
10973,28,0,0,69,69,0,1,0,1,0
18818,28,0,0,70,70,0,1,0,1,0
10008,28,0,0,70,70,0,1,0,1,0
14454,28,0,0,66,66,0,1,0,1,0
15390,28,0,0,68,68,0,1,0,1,0
12148,28,0,0,67,67,0,1,0,1,0
15125,28,0,0,70,70,0,1,0,1,0
19600,28,0,0,66,66,0,1,0,1,0
22087,28,0,0,67,67,0,1,0,1,0
18254,28,0,0,70,70,0,1,0,1,0
9951,28,0,0,70,70,0,1,0,1,0
11580,28,0,0,70,70,0,1,0,1,0
12770,28,0,0,66,66,0,1,0,1,0
8664,28,0,0,70,70,0,1,0,1,0
15889,28,0,0,66,66,0,1,0,1,0
17489,28,0,0,68,68,0,1,0,1,0
19417,28,0,0,70,70,0,1,0,1,0
12864,28,0,0,70,70,0,1,0,1,0
13416,28,0,0,70,70,0,1,0,1,0
9101,28,0,0,70,70,0,1,0,1,0
18683,28,0,0,68,68,0,1,0,1,0
11709,28,0,0,69,69,0,1,0,1,0
19098,28,0,0,70,70,0,1,0,1,0
13849,28,0,0,70,70,0,1,0,1,0
22402,28,0,0,69,69,0,1,0,1,0
12247,28,0,0,70,70,0,1,0,1,0
15465,28,0,0,70,70,0,1,0,1,0
15802,28,0,0,70,70,0,1,0,1,0
16351,28,0,0,70,70,0,1,0,1,0
17120,28,0,0,70,70,0,1,0,1,0
21425,28,0,0,70,70,0,1,0,1,0
19035,28,0,0,70,70,0,1,0,1,0
17488,28,0,0,70,70,0,1,0,1,0
16351,28,0,0,70,70,0,1,0,1,0
22266,28,0,0,70,70,0,1,0,1,0
13881,28,0,0,70,70,0,1,0,1,0
20590,28,0,0,70,70,0,1,0,1,0
21399,28,0,0,70,70,0,1,0,1,0
20876,28,0,0,66,66,0,1,0,1,0
22280,28,0,0,70,70,0,1,0,1,0
9584,28,0,0,66,66,0,1,0,1,0
19778,28,0,0,67,67,0,1,0,1,0
21324,28,0,0,70,70,0,1,0,1,0
13505,28,0,0,70,70,0,1,0,1,0
17196,28,0,0,66,66,0,1,0,1,0
10272,28,0,0,70,70,0,1,0,1,0
13897,28,0,0,70,70,0,1,0,1,0
17521,28,0,0,66,66,0,1,0,1,0
9951,28,0,0,70,70,0,1,0,1,0
11708,28,0,0,68,68,0,1,0,1,0
13388,28,0,0,70,70,0,1,0,1,0
21245,28,0,0,68,68,0,1,0,1,0
14885,28,0,0,69,69,0,1,0,1,0
13798,28,0,0,70,70,0,1,0,1,0
11075,28,0,0,70,70,0,1,0,1,0
20891,28,0,0,66,66,0,1,0,1,0
14486,28,0,0,66,66,0,1,0,1,0
13637,28,0,0,70,70,0,1,0,1,0
12928,28,0,0,70,70,0,1,0,1,0
11233,28,0,0,70,70,0,1,0,1,0
13692,28,0,0,68,68,0,1,0,1,0
19920,28,0,0,68,68,0,1,0,1,0
19725,28,0,0,66,66,0,1,0,1,0
9715,28,0,0,68,68,0,1,0,1,0
9104,28,0,0,66,66,0,1,0,1,0
21370,28,0,0,70,70,0,1,0,1,0
13656,28,0,0,70,70,0,1,0,1,0
15271,28,0,0,70,70,0,1,0,1,0
13384,28,0,0,70,70,0,1,0,1,0
22381,28,0,0,68,68,0,1,0,1,0
18367,28,0,0,66,66,0,1,0,1,0
18482,28,0,0,67,67,0,1,0,1,0
12289,28,0,0,69,69,0,1,0,1,0
16025,28,0,0,66,66,0,1,0,1,0
12295,28,0,0,70,70,0,1,0,1,0
18044,28,0,0,70,70,0,1,0,1,0
14967,28,0,0,70,70,0,1,0,1,0
16249,28,0,0,70,70,0,1,0,1,0
17841,28,0,0,70,70,0,1,0,1,0
22634,28,0,0,70,70,0,1,0,1,0
13806,28,0,0,70,70,0,1,0,1,0
10703,28,0,0,70,70,0,1,0,1,0
8588,28,0,0,70,70,0,1,0,1,0
19687,28,0,0,66,66,0,1,0,1,0
8471,28,0,0,70,70,0,1,0,1,0
13081,28,0,0,70,70,0,1,0,1,0
9488,28,0,0,70,70,0,1,0,1,0
17243,28,0,0,67,67,0,1,0,1,0
11946,28,0,0,70,70,0,1,0,1,0
21224,28,0,0,70,70,0,1,0,1,0
22298,28,0,0,70,70,0,1,0,1,0
13309,28,0,0,70,70,0,1,0,1,0
11387,28,0,0,70,70,0,1,0,1,0
17846,28,0,0,70,70,0,1,0,1,0
11515,28,0,0,70,70,0,1,0,1,0
11514,28,0,0,70,70,0,1,0,1,0
22716,28,0,0,70,70,0,1,0,1,0
16942,28,0,0,66,66,0,1,0,1,0
9258,28,0,0,66,66,0,1,0,1,0
18416,28,0,0,70,70,0,1,0,1,0
14931,28,0,0,67,67,0,1,0,1,0
20816,28,0,0,66,66,0,1,0,1,0
15513,28,0,0,70,70,0,1,0,1,0
12818,28,0,0,70,70,0,1,0,1,0
14220,28,0,0,70,70,0,1,0,1,0
22325,28,0,0,66,66,0,1,0,1,0
20524,28,0,0,66,66,0,1,0,1,0
12561,28,0,0,70,70,0,1,0,1,0
14882,28,0,0,70,70,0,1,0,1,0
9837,28,0,0,70,70,0,1,0,1,0
12919,28,0,0,70,70,0,1,0,1,0
20339,28,0,0,66,66,0,1,0,1,0
20457,28,0,0,70,70,0,1,0,1,0
17837,28,0,0,66,66,0,1,0,1,0
21170,28,0,0,66,66,0,1,0,1,0
14237,28,0,0,66,66,0,1,0,1,0
18577,28,0,0,70,70,0,1,0,1,0
16855,28,0,0,70,70,0,1,0,1,0
14350,28,0,0,70,70,0,1,0,1,0
14355,28,0,0,67,67,0,1,0,1,0
14350,28,0,0,70,70,0,1,0,1,0
12596,28,0,0,66,66,0,1,0,1,0
13558,28,0,0,69,69,0,1,0,1,0
16531,28,0,0,67,67,0,1,0,1,0
17906,28,0,0,70,70,0,1,0,1,0
22529,28,0,0,68,68,0,1,0,1,0
10388,28,0,0,70,70,0,1,0,1,0
15089,28,0,0,66,66,0,1,0,1,0
20138,28,0,0,70,70,0,1,0,1,0
22287,28,0,0,70,70,0,1,0,1,0
22048,28,0,0,66,66,0,1,0,1,0
22258,28,0,0,66,66,0,1,0,1,0
18557,28,0,0,70,70,0,1,0,1,0
9942,28,0,0,70,70,0,1,0,1,0
19566,28,0,0,70,70,0,1,0,1,0
18918,28,0,0,70,70,0,1,0,1,0
14237,28,0,0,66,66,0,1,0,1,0
12721,28,0,0,66,66,0,1,0,1,0
18406,28,0,0,69,69,0,1,0,1,0
9726,28,0,0,70,70,0,1,0,1,0
9738,28,0,0,70,70,0,1,0,1,0
16449,28,0,0,66,66,0,1,0,1,0
15873,28,0,0,70,70,0,1,0,1,0
21794,28,0,0,70,70,0,1,0,1,0
22083,28,0,0,70,70,0,1,0,1,0
13796,28,0,0,68,68,0,1,0,1,0
21841,28,0,0,66,66,0,1,0,1,0
14982,28,0,0,70,70,0,1,0,1,0
18437,28,0,0,70,70,0,1,0,1,0
14582,28,0,0,66,66,0,1,0,1,0
13184,28,0,0,69,69,0,1,0,1,0
19064,28,0,0,66,66,0,1,0,1,0
20826,28,0,0,66,66,0,1,0,1,0
16653,28,0,0,66,66,0,1,0,1,0
8503,28,0,0,70,70,0,1,0,1,0
15554,28,0,0,68,68,0,1,0,1,0
20447,28,0,0,69,69,0,1,0,1,0
16947,28,0,0,70,70,0,1,0,1,0
13543,28,0,0,70,70,0,1,0,1,0
13862,28,0,0,70,70,0,1,0,1,0
19821,28,0,0,70,70,0,1,0,1,0
11380,28,0,0,70,70,0,1,0,1,0
13923,28,0,0,70,70,0,1,0,1,0
17876,28,0,0,69,69,0,1,0,1,0
18042,28,0,0,68,68,0,1,0,1,0
9430,28,0,0,66,66,0,1,0,1,0
15262,28,0,0,68,68,0,1,0,1,0
15247,28,0,0,70,70,0,1,0,1,0
9257,28,0,0,70,70,0,1,0,1,0
13202,28,0,0,70,70,0,1,0,1,0
18132,28,0,0,69,69,0,1,0,1,0
9750,28,0,0,66,66,0,1,0,1,0
19025,28,0,0,70,70,0,1,0,1,0
19776,28,0,0,66,66,0,1,0,1,0
16556,28,0,0,70,70,0,1,0,1,0
20959,28,0,0,66,66,0,1,0,1,0
16275,28,0,0,66,66,0,1,0,1,0
20028,28,0,0,69,69,0,1,0,1,0
9291,28,0,0,70,70,0,1,0,1,0
20541,28,0,0,70,70,0,1,0,1,0
21659,28,0,0,70,70,0,1,0,1,0
12514,28,0,0,66,66,0,1,0,1,0
8917,28,0,0,67,67,0,1,0,1,0
12013,28,0,0,66,66,0,1,0,1,0
13270,28,0,0,70,70,0,1,0,1,0
20022,28,0,0,66,66,0,1,0,1,0
18520,28,0,0,70,70,0,1,0,1,0
17628,28,0,0,70,70,0,1,0,1,0
13760,28,0,0,69,69,0,1,0,1,0
19998,28,0,0,70,70,0,1,0,1,0
14367,28,0,0,66,66,0,1,0,1,0
20400,28,0,0,67,67,0,1,0,1,0
9973,28,0,0,70,70,0,1,0,1,0
22565,28,0,0,69,69,0,1,0,1,0
19697,28,0,0,70,70,0,1,0,1,0
11121,28,0,0,66,66,0,1,0,1,0
15028,28,0,0,66,66,0,1,0,1,0
8733,28,0,0,66,66,0,1,0,1,0
8359,28,0,0,70,70,0,1,0,1,0
17183,28,0,0,66,66,0,1,0,1,0
15660,28,0,0,70,70,0,1,0,1,0
16716,28,0,0,70,70,0,1,0,1,0
8795,28,0,0,70,70,0,1,0,1,0
9267,28,0,0,70,70,0,1,0,1,0
19308,28,0,0,66,66,0,1,0,1,0
9688,28,0,0,66,66,0,1,0,1,0
13081,28,0,0,67,67,0,1,0,1,0
13499,28,0,0,70,70,0,1,0,1,0
17588,28,0,0,68,68,0,1,0,1,0
22686,28,0,0,70,70,0,1,0,1,0
19070,28,0,0,67,67,0,1,0,1,0
11081,28,0,0,70,70,0,1,0,1,0
19647,28,0,0,70,70,0,1,0,1,0
17840,28,0,0,70,70,0,1,0,1,0
14473,28,0,0,70,70,0,1,0,1,0
13310,28,0,0,70,70,0,1,0,1,0
8367,28,0,0,66,66,0,1,0,1,0
17393,28,0,0,66,66,0,1,0,1,0
15578,28,0,0,70,70,0,1,0,1,0
18854,28,0,0,70,70,0,1,0,1,0
14323,28,0,0,70,70,0,1,0,1,0
11827,28,0,0,69,69,0,1,0,1,0
22689,28,0,0,70,70,0,1,0,1,0
14527,28,0,0,67,67,0,1,0,1,0
14094,28,0,0,70,70,0,1,0,1,0
9946,28,0,0,66,66,0,1,0,1,0
11172,28,0,0,70,70,0,1,0,1,0
15606,28,0,0,70,70,0,1,0,1,0
19877,28,0,0,66,66,0,1,0,1,0
16113,28,0,0,70,70,0,1,0,1,0
19242,28,0,0,67,67,0,1,0,1,0
8468,28,0,0,70,70,0,1,0,1,0
16169,28,0,0,70,70,0,1,0,1,0
21871,28,0,0,70,70,0,1,0,1,0
20748,28,0,0,66,66,0,1,0,1,0
10190,28,0,0,70,70,0,1,0,1,0
16032,28,0,0,70,70,0,1,0,1,0
15607,28,0,0,67,67,0,1,0,1,0
15756,28,0,0,70,70,0,1,0,1,0
19473,28,0,0,70,70,0,1,0,1,0
15875,28,0,0,70,70,0,1,0,1,0
14137,28,0,0,70,70,0,1,0,1,0
10602,28,0,0,70,70,0,1,0,1,0
10959,28,0,0,70,70,0,1,0,1,0
13743,28,0,0,66,66,0,1,0,1,0
14942,28,0,0,70,70,0,1,0,1,0
16805,28,0,0,66,66,0,1,0,1,0
15092,28,0,0,70,70,0,1,0,1,0
14624,28,0,0,66,66,0,1,0,1,0
11303,28,0,0,66,66,0,1,0,1,0
9318,28,0,0,70,70,0,1,0,1,0
20739,28,0,0,70,70,0,1,0,1,0
11087,28,0,0,70,70,0,1,0,1,0
16812,28,0,0,70,70,0,1,0,1,0
12985,28,0,0,70,70,0,1,0,1,0
22306,28,0,0,68,68,0,1,0,1,0
14160,28,0,0,70,70,0,1,0,1,0
10027,28,0,0,69,69,0,1,0,1,0
18991,28,0,0,70,70,0,1,0,1,0
19888,28,0,0,67,67,0,1,0,1,0
8927,28,0,0,70,70,0,1,0,1,0
10433,28,0,0,70,70,0,1,0,1,0
19556,28,0,0,70,70,0,1,0,1,0
11992,28,0,0,70,70,0,1,0,1,0
16190,28,0,0,66,66,0,1,0,1,0
20230,28,0,0,70,70,0,1,0,1,0
14223,28,0,0,70,70,0,1,0,1,0
16496,28,0,0,66,66,0,1,0,1,0
14029,28,0,0,70,70,0,1,0,1,0
20138,28,0,0,70,70,0,1,0,1,0
18899,28,0,0,66,66,0,1,0,1,0
10811,28,0,0,69,69,0,1,0,1,0
11984,28,0,0,66,66,0,1,0,1,0
19016,28,0,0,70,70,0,1,0,1,0
9678,28,0,0,66,66,0,1,0,1,0
18692,28,0,0,70,70,0,1,0,1,0
20615,28,0,0,70,70,0,1,0,1,0
10668,28,0,0,66,66,0,1,0,1,0
8831,28,0,0,67,67,0,1,0,1,0
12421,28,0,0,66,66,0,1,0,1,0
13878,28,0,0,70,70,0,1,0,1,0
16634,28,0,0,70,70,0,1,0,1,0
11408,28,0,0,69,69,0,1,0,1,0
20146,28,0,0,70,70,0,1,0,1,0
16430,28,0,0,70,70,0,1,0,1,0
16273,28,0,0,66,66,0,1,0,1,0
10603,28,0,0,70,70,0,1,0,1,0
11268,28,0,0,70,70,0,1,0,1,0
16633,28,0,0,70,70,0,1,0,1,0
19158,28,0,0,68,68,0,1,0,1,0
14970,28,0,0,69,69,0,1,0,1,0
16071,28,0,0,70,70,0,1,0,1,0
16353,28,0,0,70,70,0,1,0,1,0
16900,28,0,0,66,66,0,1,0,1,0
11715,28,0,0,70,70,0,1,0,1,0
12996,28,0,0,70,70,0,1,0,1,0
9004,28,0,0,70,70,0,1,0,1,0
13544,28,0,0,70,70,0,1,0,1,0
13550,28,0,0,70,70,0,1,0,1,0
17561,28,0,0,70,70,0,1,0,1,0
11224,28,0,0,70,70,0,1,0,1,0
10544,28,0,0,67,67,0,1,0,1,0
17290,28,0,0,69,69,0,1,0,1,0
9229,28,0,0,70,70,0,1,0,1,0
11027,28,0,0,66,66,0,1,0,1,0
19132,28,0,0,69,69,0,1,0,1,0
13604,28,0,0,70,70,0,1,0,1,0
12656,28,0,0,70,70,0,1,0,1,0
16884,28,0,0,68,68,0,1,0,1,0
11143,28,0,0,66,66,0,1,0,1,0
21976,28,0,0,70,70,0,1,0,1,0
16851,28,0,0,66,66,0,1,0,1,0
11285,28,0,0,66,66,0,1,0,1,0
16226,28,0,0,70,70,0,1,0,1,0
15156,28,0,0,68,68,0,1,0,1,0
8881,28,0,0,66,66,0,1,0,1,0
10415,28,0,0,70,70,0,1,0,1,0
10363,28,0,0,70,70,0,1,0,1,0
13304,28,0,0,70,70,0,1,0,1,0
13932,28,0,0,68,68,0,1,0,1,0
22579,28,0,0,66,66,0,1,0,1,0
19752,28,0,0,70,70,0,1,0,1,0
9411,28,0,0,70,70,0,1,0,1,0
9827,28,0,0,70,70,0,1,0,1,0
19751,28,0,0,70,70,0,1,0,1,0
20375,28,0,0,66,66,0,1,0,1,0
17374,28,0,0,69,69,0,1,0,1,0
20830,28,0,0,66,66,0,1,0,1,0
16509,28,0,0,66,66,0,1,0,1,0
15419,28,0,0,70,70,0,1,0,1,0
19116,28,0,0,66,66,0,1,0,1,0
16904,28,0,0,70,70,0,1,0,1,0
11719,28,0,0,66,66,0,1,0,1,0
18172,28,0,0,70,70,0,1,0,1,0
21615,28,0,0,66,66,0,1,0,1,0
15971,28,0,0,70,70,0,1,0,1,0
22629,28,0,0,70,70,0,1,0,1,0
22175,28,0,0,70,70,0,1,0,1,0
14815,28,0,0,70,70,0,1,0,1,0
13148,28,0,0,70,70,0,1,0,1,0
14960,28,0,0,66,66,0,1,0,1,0
19833,28,0,0,66,66,0,1,0,1,0
17822,28,0,0,70,70,0,1,0,1,0
15940,28,0,0,69,69,0,1,0,1,0
14308,28,0,0,70,70,0,1,0,1,0
12015,28,0,0,70,70,0,1,0,1,0
9882,28,0,0,66,66,0,1,0,1,0
13282,28,0,0,69,69,0,1,0,1,0
12219,28,0,0,70,70,0,1,0,1,0
21293,28,0,0,69,69,0,1,0,1,0
19449,28,0,0,70,70,0,1,0,1,0
21545,28,0,0,67,67,0,1,0,1,0
15686,28,0,0,68,68,0,1,0,1,0
8591,28,0,0,70,70,0,1,0,1,0
8998,28,0,0,70,70,0,1,0,1,0
9975,28,0,0,70,70,0,1,0,1,0
21128,28,0,0,70,70,0,1,0,1,0
19033,28,0,0,70,70,0,1,0,1,0
19760,28,0,0,68,68,0,1,0,1,0
17164,28,0,0,70,70,0,1,0,1,0
9802,28,0,0,69,69,0,1,0,1,0
8867,28,0,0,70,70,0,1,0,1,0
11486,28,0,0,70,70,0,1,0,1,0
16740,28,0,0,68,68,0,1,0,1,0
11570,28,0,0,70,70,0,1,0,1,0
17232,28,0,0,70,70,0,1,0,1,0
11695,28,0,0,70,70,0,1,0,1,0
19328,28,0,0,70,70,0,1,0,1,0
16931,28,0,0,70,70,0,1,0,1,0
18359,28,0,0,70,70,0,1,0,1,0
12847,28,0,0,70,70,0,1,0,1,0
18376,28,0,0,70,70,0,1,0,1,0
11927,28,0,0,70,70,0,1,0,1,0
20239,28,0,0,70,70,0,1,0,1,0
20813,28,0,0,66,66,0,1,0,1,0
20937,28,0,0,70,70,0,1,0,1,0
13180,28,0,0,70,70,0,1,0,1,0
21747,28,0,0,70,70,0,1,0,1,0
18695,28,0,0,70,70,0,1,0,1,0
11892,28,0,0,66,66,0,1,0,1,0
20980,28,0,0,66,66,0,1,0,1,0
20475,28,0,0,66,66,0,1,0,1,0
17158,28,0,0,68,68,0,1,0,1,0
10500,28,0,0,66,66,0,1,0,1,0
8615,28,0,0,70,70,0,1,0,1,0
17615,28,0,0,70,70,0,1,0,1,0
14965,28,0,0,70,70,0,1,0,1,0
11865,28,0,0,70,70,0,1,0,1,0
9430,28,0,0,66,66,0,1,0,1,0
20182,28,0,0,70,70,0,1,0,1,0
12641,28,0,0,70,70,0,1,0,1,0
12441,28,0,0,70,70,0,1,0,1,0
13359,28,0,0,66,66,0,1,0,1,0
12535,28,0,0,66,66,0,1,0,1,0
12845,28,0,0,66,66,0,1,0,1,0
20625,28,0,0,69,69,0,1,0,1,0
14886,28,0,0,68,68,0,1,0,1,0
21599,28,0,0,70,70,0,1,0,1,0
22482,28,0,0,70,70,0,1,0,1,0
12511,28,0,0,70,70,0,1,0,1,0
20308,28,0,0,66,66,0,1,0,1,0
21406,28,0,0,70,70,0,1,0,1,0
20311,28,0,0,70,70,0,1,0,1,0
14303,28,0,0,66,66,0,1,0,1,0
13151,28,0,0,70,70,0,1,0,1,0
16540,28,0,0,69,69,0,1,0,1,0
17531,28,0,0,68,68,0,1,0,1,0
14822,28,0,0,69,69,0,1,0,1,0
14052,28,0,0,66,66,0,1,0,1,0
18411,28,0,0,70,70,0,1,0,1,0
21668,28,0,0,66,66,0,1,0,1,0
10058,28,0,0,66,66,0,1,0,1,0
9006,28,0,0,70,70,0,1,0,1,0
8660,28,0,0,68,68,0,1,0,1,0
17810,28,0,0,70,70,0,1,0,1,0
14476,28,0,0,66,66,0,1,0,1,0
11191,28,0,0,68,68,0,1,0,1,0
13905,28,0,0,70,70,0,1,0,1,0
16095,28,0,0,70,70,0,1,0,1,0
14964,28,0,0,66,66,0,1,0,1,0
17267,28,0,0,70,70,0,1,0,1,0
19059,28,0,0,70,70,0,1,0,1,0
17364,28,0,0,66,66,0,1,0,1,0
9401,28,0,0,70,70,0,1,0,1,0
17458,28,0,0,66,66,0,1,0,1,0
14604,28,0,0,70,70,0,1,0,1,0
16979,28,0,0,70,70,0,1,0,1,0
10385,28,0,0,70,70,0,1,0,1,0
14894,28,0,0,70,70,0,1,0,1,0
18667,28,0,0,66,66,0,1,0,1,0
9297,28,0,0,70,70,0,1,0,1,0
16944,28,0,0,66,66,0,1,0,1,0
10029,28,0,0,70,70,0,1,0,1,0
9418,28,0,0,70,70,0,1,0,1,0
12592,28,0,0,66,66,0,1,0,1,0
14827,28,0,0,70,70,0,1,0,1,0
17401,28,0,0,70,70,0,1,0,1,0
20366,28,0,0,69,69,0,1,0,1,0
19537,28,0,0,70,70,0,1,0,1,0
21901,28,0,0,70,70,0,1,0,1,0
8530,28,0,0,70,70,0,1,0,1,0
22257,28,0,0,66,66,0,1,0,1,0
17461,28,0,0,70,70,0,1,0,1,0
20100,28,0,0,70,70,0,1,0,1,0
19501,28,0,0,70,70,0,1,0,1,0
13026,28,0,0,70,70,0,1,0,1,0
16225,28,0,0,66,66,0,1,0,1,0
20276,28,0,0,70,70,0,1,0,1,0
17585,28,0,0,70,70,0,1,0,1,0
11247,28,0,0,66,66,0,1,0,1,0
9067,28,0,0,70,70,0,1,0,1,0
13330,28,0,0,66,66,0,1,0,1,0
15988,28,0,0,66,66,0,1,0,1,0
14133,28,0,0,66,66,0,1,0,1,0
19452,28,0,0,70,70,0,1,0,1,0
11819,28,0,0,66,66,0,1,0,1,0
13593,28,0,0,70,70,0,1,0,1,0
20657,28,0,0,70,70,0,1,0,1,0
12273,28,0,0,70,70,0,1,0,1,0
17855,28,0,0,70,70,0,1,0,1,0
10380,28,0,0,70,70,0,1,0,1,0
20905,28,0,0,69,69,0,1,0,1,0
9212,28,0,0,70,70,0,1,0,1,0
19296,28,0,0,66,66,0,1,0,1,0
17452,28,0,0,70,70,0,1,0,1,0
20253,28,0,0,67,67,0,1,0,1,0
22325,28,0,0,66,66,0,1,0,1,0
13374,28,0,0,66,66,0,1,0,1,0
20781,28,0,0,70,70,0,1,0,1,0
15661,28,0,0,66,66,0,1,0,1,0
10586,28,0,0,70,70,0,1,0,1,0
11122,28,0,0,70,70,0,1,0,1,0
12869,28,0,0,66,66,0,1,0,1,0
20376,28,0,0,66,66,0,1,0,1,0
17009,28,0,0,66,66,0,1,0,1,0
13325,28,0,0,66,66,0,1,0,1,0
14027,28,0,0,70,70,0,1,0,1,0
18318,28,0,0,70,70,0,1,0,1,0
16236,28,0,0,66,66,0,1,0,1,0
8450,28,0,0,67,67,0,1,0,1,0
21701,28,0,0,70,70,0,1,0,1,0
16509,28,0,0,70,70,0,1,0,1,0
14473,28,0,0,66,66,0,1,0,1,0
10144,28,0,0,66,66,0,1,0,1,0
10119,28,0,0,70,70,0,1,0,1,0
13179,28,0,0,70,70,0,1,0,1,0
13771,28,0,0,70,70,0,1,0,1,0
17418,28,0,0,70,70,0,1,0,1,0
19018,28,0,0,66,66,0,1,0,1,0
8576,28,0,0,66,66,0,1,0,1,0
11396,28,0,0,67,67,0,1,0,1,0
17490,28,0,0,66,66,0,1,0,1,0
18872,28,0,0,70,70,0,1,0,1,0
11469,28,0,0,70,70,0,1,0,1,0
20928,28,0,0,70,70,0,1,0,1,0
15473,28,0,0,66,66,0,1,0,1,0
15927,28,0,0,70,70,0,1,0,1,0
22396,28,0,0,66,66,0,1,0,1,0
14448,28,0,0,70,70,0,1,0,1,0
9724,28,0,0,67,67,0,1,0,1,0
19946,28,0,0,70,70,0,1,0,1,0
21157,28,0,0,70,70,0,1,0,1,0
22286,28,0,0,70,70,0,1,0,1,0
13685,28,0,0,70,70,0,1,0,1,0
17488,28,0,0,69,69,0,1,0,1,0
9478,28,0,0,66,66,0,1,0,1,0
22236,28,0,0,70,70,0,1,0,1,0
22506,28,0,0,70,70,0,1,0,1,0
9670,28,0,0,70,70,0,1,0,1,0
21481,28,0,0,68,68,0,1,0,1,0
20245,28,0,0,70,70,0,1,0,1,0
9987,28,0,0,70,70,0,1,0,1,0
12565,28,0,0,70,70,0,1,0,1,0
13701,28,0,0,70,70,0,1,0,1,0
17906,28,0,0,70,70,0,1,0,1,0
18670,28,0,0,66,66,0,1,0,1,0
15359,28,0,0,70,70,0,1,0,1,0
14388,28,0,0,70,70,0,1,0,1,0
18086,28,0,0,66,66,0,1,0,1,0
21392,28,0,0,70,70,0,1,0,1,0
19982,28,0,0,70,70,0,1,0,1,0
17582,28,0,0,69,69,0,1,0,1,0
9444,28,0,0,70,70,0,1,0,1,0
12838,28,0,0,67,67,0,1,0,1,0
22649,28,0,0,70,70,0,1,0,1,0
9880,28,0,0,70,70,0,1,0,1,0
13756,28,0,0,67,67,0,1,0,1,0
10236,28,0,0,68,68,0,1,0,1,0
11608,28,0,0,70,70,0,1,0,1,0
9514,28,0,0,66,66,0,1,0,1,0
9826,28,0,0,70,70,0,1,0,1,0
21170,28,0,0,66,66,0,1,0,1,0
8924,28,0,0,70,70,0,1,0,1,0
19145,28,0,0,70,70,0,1,0,1,0
15944,28,0,0,70,70,0,1,0,1,0
12240,28,0,0,66,66,0,1,0,1,0
13742,28,0,0,67,67,0,1,0,1,0
10596,28,0,0,70,70,0,1,0,1,0
11366,28,0,0,70,70,0,1,0,1,0
9561,28,0,0,66,66,0,1,0,1,0
9038,28,0,0,70,70,0,1,0,1,0
10832,28,0,0,70,70,0,1,0,1,0
10007,28,0,0,70,70,0,1,0,1,0
16220,28,0,0,70,70,0,1,0,1,0
9868,28,0,0,66,66,0,1,0,1,0
18022,28,0,0,66,66,0,1,0,1,0
8793,28,0,0,70,70,0,1,0,1,0
11076,28,0,0,70,70,0,1,0,1,0
16080,28,0,0,66,66,0,1,0,1,0
10606,28,0,0,70,70,0,1,0,1,0
13624,28,0,0,70,70,0,1,0,1,0
12645,28,0,0,70,70,0,1,0,1,0
9802,28,0,0,66,66,0,1,0,1,0
16310,28,0,0,68,68,0,1,0,1,0
14103,28,0,0,66,66,0,1,0,1,0
22086,28,0,0,70,70,0,1,0,1,0
14485,28,0,0,69,69,0,1,0,1,0
20196,28,0,0,66,66,0,1,0,1,0
13111,28,0,0,66,66,0,1,0,1,0
18133,28,0,0,70,70,0,1,0,1,0
18257,28,0,0,66,66,0,1,0,1,0
21735,28,0,0,70,70,0,1,0,1,0
19608,28,0,0,66,66,0,1,0,1,0
20262,28,0,0,67,67,0,1,0,1,0
19538,28,0,0,70,70,0,1,0,1,0
21888,28,0,0,66,66,0,1,0,1,0
10161,28,0,0,70,70,0,1,0,1,0
11604,28,0,0,69,69,0,1,0,1,0
14698,28,0,0,70,70,0,1,0,1,0
12544,28,0,0,67,67,0,1,0,1,0
12118,28,0,0,70,70,0,1,0,1,0
14621,28,0,0,66,66,0,1,0,1,0
19938,28,0,0,70,70,0,1,0,1,0
11273,28,0,0,70,70,0,1,0,1,0
14797,28,0,0,70,70,0,1,0,1,0
20936,28,0,0,66,66,0,1,0,1,0
12505,28,0,0,70,70,0,1,0,1,0
19607,28,0,0,66,66,0,1,0,1,0
18949,28,0,0,66,66,0,1,0,1,0
18864,28,0,0,66,66,0,1,0,1,0
14856,28,0,0,70,70,0,1,0,1,0
22517,28,0,0,66,66,0,1,0,1,0
16076,28,0,0,66,66,0,1,0,1,0
8403,28,0,0,70,70,0,1,0,1,0
18964,28,0,0,66,66,0,1,0,1,0
20883,28,0,0,70,70,0,1,0,1,0
22584,28,0,0,66,66,0,1,0,1,0
14361,28,0,0,67,67,0,1,0,1,0
21689,28,0,0,66,66,0,1,0,1,0
12282,28,0,0,66,66,0,1,0,1,0
20625,28,0,0,70,70,0,1,0,1,0
21830,28,0,0,66,66,0,1,0,1,0
11855,28,0,0,70,70,0,1,0,1,0
19338,28,0,0,69,69,0,1,0,1,0
9921,28,0,0,70,70,0,1,0,1,0
14095,28,0,0,70,70,0,1,0,1,0
20048,28,0,0,70,70,0,1,0,1,0
15719,28,0,0,70,70,0,1,0,1,0
9722,28,0,0,66,66,0,1,0,1,0
16236,28,0,0,69,69,0,1,0,1,0
22075,28,0,0,69,69,0,1,0,1,0
14752,28,0,0,70,70,0,1,0,1,0
19876,28,0,0,70,70,0,1,0,1,0
17448,28,0,0,70,70,0,1,0,1,0
18356,28,0,0,70,70,0,1,0,1,0
8790,28,0,0,70,70,0,1,0,1,0
8557,28,0,0,66,66,0,1,0,1,0
19276,28,0,0,70,70,0,1,0,1,0
14688,28,0,0,68,68,0,1,0,1,0
19955,28,0,0,70,70,0,1,0,1,0
17619,28,0,0,70,70,0,1,0,1,0
8436,28,0,0,68,68,0,1,0,1,0
20885,28,0,0,66,66,0,1,0,1,0
10295,28,0,0,66,66,0,1,0,1,0
14024,28,0,0,70,70,0,1,0,1,0
11932,28,0,0,70,70,0,1,0,1,0
15571,28,0,0,70,70,0,1,0,1,0
9702,28,0,0,70,70,0,1,0,1,0
19399,28,0,0,70,70,0,1,0,1,0
12888,28,0,0,67,67,0,1,0,1,0
14922,28,0,0,68,68,0,1,0,1,0
21955,28,0,0,68,68,0,1,0,1,0
14808,28,0,0,70,70,0,1,0,1,0
19774,28,0,0,66,66,0,1,0,1,0
16281,28,0,0,70,70,0,1,0,1,0
15627,28,0,0,69,69,0,1,0,1,0
17898,28,0,0,70,70,0,1,0,1,0
19803,28,0,0,69,69,0,1,0,1,0
11197,28,0,0,66,66,0,1,0,1,0
18809,28,0,0,70,70,0,1,0,1,0
20949,28,0,0,70,70,0,1,0,1,0
13056,28,0,0,66,66,0,1,0,1,0
19411,28,0,0,70,70,0,1,0,1,0
10895,28,0,0,70,70,0,1,0,1,0
15797,28,0,0,70,70,0,1,0,1,0
18369,28,0,0,66,66,0,1,0,1,0
13538,28,0,0,68,68,0,1,0,1,0
17271,28,0,0,70,70,0,1,0,1,0
20620,28,0,0,66,66,0,1,0,1,0
19557,28,0,0,70,70,0,1,0,1,0
13083,28,0,0,67,67,0,1,0,1,0
21823,28,0,0,70,70,0,1,0,1,0
13225,28,0,0,69,69,0,1,0,1,0
11069,28,0,0,70,70,0,1,0,1,0
18664,28,0,0,66,66,0,1,0,1,0
12049,28,0,0,70,70,0,1,0,1,0
20341,28,0,0,66,66,0,1,0,1,0
18605,28,0,0,67,67,0,1,0,1,0
16604,28,0,0,70,70,0,1,0,1,0
9752,28,0,0,66,66,0,1,0,1,0
14147,28,0,0,70,70,0,1,0,1,0
11532,28,0,0,70,70,0,1,0,1,0
11505,28,0,0,70,70,0,1,0,1,0
14295,28,0,0,70,70,0,1,0,1,0
20938,28,0,0,68,68,0,1,0,1,0
21854,28,0,0,67,67,0,1,0,1,0
9626,28,0,0,66,66,0,1,0,1,0
12320,28,0,0,70,70,0,1,0,1,0
9819,28,0,0,70,70,0,1,0,1,0
21613,28,0,0,69,69,0,1,0,1,0
13106,28,0,0,66,66,0,1,0,1,0
10129,28,0,0,70,70,0,1,0,1,0
21094,28,0,0,68,68,0,1,0,1,0
22239,28,0,0,70,70,0,1,0,1,0
16345,28,0,0,70,70,0,1,0,1,0
20508,28,0,0,68,68,0,1,0,1,0
20994,28,0,0,70,70,0,1,0,1,0
12540,28,0,0,68,68,0,1,0,1,0
22199,28,0,0,66,66,0,1,0,1,0
13696,28,0,0,70,70,0,1,0,1,0
14106,28,0,0,70,70,0,1,0,1,0
16136,28,0,0,70,70,0,1,0,1,0
19276,28,0,0,70,70,0,1,0,1,0
18851,28,0,0,70,70,0,1,0,1,0
11462,28,0,0,66,66,0,1,0,1,0
9777,28,0,0,70,70,0,1,0,1,0
19877,28,0,0,70,70,0,1,0,1,0
10516,28,0,0,70,70,0,1,0,1,0
16655,28,0,0,66,66,0,1,0,1,0
22517,28,0,0,69,69,0,1,0,1,0
18436,28,0,0,70,70,0,1,0,1,0
12470,28,0,0,66,66,0,1,0,1,0
9322,28,0,0,67,67,0,1,0,1,0
21162,28,0,0,66,66,0,1,0,1,0
18400,28,0,0,70,70,0,1,0,1,0
8447,28,0,0,70,70,0,1,0,1,0
9337,28,0,0,70,70,0,1,0,1,0
20338,28,0,0,67,67,0,1,0,1,0
12643,28,0,0,67,67,0,1,0,1,0
20919,28,0,0,66,66,0,1,0,1,0
11241,28,0,0,67,67,0,1,0,1,0
12341,28,0,0,66,66,0,1,0,1,0
10327,28,0,0,67,67,0,1,0,1,0
15600,28,0,0,69,69,0,1,0,1,0
13556,28,0,0,66,66,0,1,0,1,0
11649,28,0,0,70,70,0,1,0,1,0
11186,28,0,0,66,66,0,1,0,1,0
19003,28,0,0,70,70,0,1,0,1,0
16211,28,0,0,70,70,0,1,0,1,0
14386,28,0,0,70,70,0,1,0,1,0
20761,28,0,0,70,70,0,1,0,1,0
16013,28,0,0,67,67,0,1,0,1,0
13828,28,0,0,68,68,0,1,0,1,0
12107,28,0,0,70,70,0,1,0,1,0
12598,28,0,0,70,70,0,1,0,1,0
14153,28,0,0,70,70,0,1,0,1,0
18183,28,0,0,68,68,0,1,0,1,0
14721,28,0,0,66,66,0,1,0,1,0
21095,28,0,0,70,70,0,1,0,1,0
14202,28,0,0,68,68,0,1,0,1,0
15554,28,0,0,70,70,0,1,0,1,0
11485,28,0,0,70,70,0,1,0,1,0
22468,28,0,0,66,66,0,1,0,1,0
14254,28,0,0,66,66,0,1,0,1,0
11604,28,0,0,70,70,0,1,0,1,0
19823,28,0,0,70,70,0,1,0,1,0
17125,28,0,0,66,66,0,1,0,1,0
21690,28,0,0,67,67,0,1,0,1,0
18259,28,0,0,67,67,0,1,0,1,0
15972,28,0,0,70,70,0,1,0,1,0
18664,28,0,0,66,66,0,1,0,1,0
19288,28,0,0,70,70,0,1,0,1,0
11613,28,0,0,66,66,0,1,0,1,0
11876,28,0,0,68,68,0,1,0,1,0
12030,28,0,0,67,67,0,1,0,1,0
17796,28,0,0,66,66,0,1,0,1,0
19984,28,0,0,70,70,0,1,0,1,0
15122,28,0,0,70,70,0,1,0,1,0
17339,28,0,0,70,70,0,1,0,1,0
10701,28,0,0,70,70,0,1,0,1,0
16900,28,0,0,66,66,0,1,0,1,0
17316,28,0,0,70,70,0,1,0,1,0
9757,28,0,0,70,70,0,1,0,1,0
14678,28,0,0,68,68,0,1,0,1,0
20157,28,0,0,66,66,0,1,0,1,0
20436,28,0,0,68,68,0,1,0,1,0
15234,28,0,0,66,66,0,1,0,1,0
18142,28,0,0,66,66,0,1,0,1,0
15821,28,0,0,70,70,0,1,0,1,0
15160,28,0,0,70,70,0,1,0,1,0
20208,28,0,0,66,66,0,1,0,1,0
13811,28,0,0,70,70,0,1,0,1,0
20243,28,0,0,70,70,0,1,0,1,0
20999,28,0,0,70,70,0,1,0,1,0
14094,28,0,0,70,70,0,1,0,1,0
18538,28,0,0,70,70,0,1,0,1,0
20440,28,0,0,66,66,0,1,0,1,0
21726,28,0,0,66,66,0,1,0,1,0
18517,28,0,0,67,67,0,1,0,1,0
13006,28,0,0,70,70,0,1,0,1,0
18805,28,0,0,70,70,0,1,0,1,0
19226,28,0,0,70,70,0,1,0,1,0
9644,28,0,0,68,68,0,1,0,1,0
12708,28,0,0,69,69,0,1,0,1,0
22348,28,0,0,70,70,0,1,0,1,0
12881,28,0,0,70,70,0,1,0,1,0
18058,28,0,0,70,70,0,1,0,1,0
22101,28,0,0,68,68,0,1,0,1,0
21160,28,0,0,70,70,0,1,0,1,0
18261,28,0,0,69,69,0,1,0,1,0
20490,28,0,0,66,66,0,1,0,1,0
10943,28,0,0,66,66,0,1,0,1,0
20886,28,0,0,70,70,0,1,0,1,0
16906,28,0,0,70,70,0,1,0,1,0
17784,28,0,0,67,67,0,1,0,1,0
20263,28,0,0,67,67,0,1,0,1,0
16539,28,0,0,70,70,0,1,0,1,0
11959,28,0,0,68,68,0,1,0,1,0
10361,28,0,0,70,70,0,1,0,1,0
22082,28,0,0,70,70,0,1,0,1,0
9766,28,0,0,66,66,0,1,0,1,0
15216,28,0,0,66,66,0,1,0,1,0
17409,28,0,0,70,70,0,1,0,1,0
9292,28,0,0,70,70,0,1,0,1,0
16337,28,0,0,69,69,0,1,0,1,0
16629,28,0,0,70,70,0,1,0,1,0
20374,28,0,0,70,70,0,1,0,1,0
22175,28,0,0,66,66,0,1,0,1,0
21694,28,0,0,70,70,0,1,0,1,0
19355,28,0,0,67,67,0,1,0,1,0
19593,28,0,0,70,70,0,1,0,1,0
20153,28,0,0,66,66,0,1,0,1,0
21265,28,0,0,70,70,0,1,0,1,0
17574,28,0,0,66,66,0,1,0,1,0
9055,28,0,0,66,66,0,1,0,1,0
10059,28,0,0,66,66,0,1,0,1,0
19735,28,0,0,70,70,0,1,0,1,0
21955,28,0,0,67,67,0,1,0,1,0
21036,28,0,0,70,70,0,1,0,1,0
17086,28,0,0,68,68,0,1,0,1,0
14759,28,0,0,70,70,0,1,0,1,0
20998,28,0,0,70,70,0,1,0,1,0
11429,28,0,0,68,68,0,1,0,1,0
9801,28,0,0,66,66,0,1,0,1,0
10374,28,0,0,70,70,0,1,0,1,0
10080,28,0,0,70,70,0,1,0,1,0
16052,28,0,0,66,66,0,1,0,1,0
8979,28,0,0,70,70,0,1,0,1,0
18541,28,0,0,70,70,0,1,0,1,0
13476,28,0,0,67,67,0,1,0,1,0
14967,28,0,0,70,70,0,1,0,1,0
8821,28,0,0,70,70,0,1,0,1,0
9344,28,0,0,70,70,0,1,0,1,0
12103,28,0,0,70,70,0,1,0,1,0
20334,28,0,0,70,70,0,1,0,1,0
18773,28,0,0,66,66,0,1,0,1,0
14896,28,0,0,70,70,0,1,0,1,0
21411,28,0,0,69,69,0,1,0,1,0
9948,28,0,0,70,70,0,1,0,1,0
14482,28,0,0,66,66,0,1,0,1,0
9821,28,0,0,70,70,0,1,0,1,0
15291,28,0,0,70,70,0,1,0,1,0
10286,28,0,0,70,70,0,1,0,1,0
9567,28,0,0,66,66,0,1,0,1,0
14071,28,0,0,70,70,0,1,0,1,0
22411,28,0,0,66,66,0,1,0,1,0
12249,28,0,0,66,66,0,1,0,1,0
11452,28,0,0,70,70,0,1,0,1,0
22302,28,0,0,67,67,0,1,0,1,0
16073,28,0,0,70,70,0,1,0,1,0
15086,28,0,0,70,70,0,1,0,1,0
16570,28,0,0,67,67,0,1,0,1,0
16805,28,0,0,70,70,0,1,0,1,0
12729,28,0,0,70,70,0,1,0,1,0
18290,28,0,0,70,70,0,1,0,1,0
15157,28,0,0,70,70,0,1,0,1,0
19480,28,0,0,70,70,0,1,0,1,0
18747,28,0,0,70,70,0,1,0,1,0
9500,28,0,0,66,66,0,1,0,1,0
10835,28,0,0,70,70,0,1,0,1,0
11451,28,0,0,70,70,0,1,0,1,0
18034,28,0,0,70,70,0,1,0,1,0
9342,28,0,0,70,70,0,1,0,1,0
21593,28,0,0,70,70,0,1,0,1,0
22318,28,0,0,70,70,0,1,0,1,0
11262,28,0,0,66,66,0,1,0,1,0
13267,28,0,0,70,70,0,1,0,1,0
19681,28,0,0,70,70,0,1,0,1,0
10608,28,0,0,70,70,0,1,0,1,0
10961,28,0,0,70,70,0,1,0,1,0
15340,28,0,0,66,66,0,1,0,1,0
12330,28,0,0,68,68,0,1,0,1,0
21753,28,0,0,67,67,0,1,0,1,0
11641,28,0,0,70,70,0,1,0,1,0
17290,28,0,0,66,66,0,1,0,1,0
21140,28,0,0,69,69,0,1,0,1,0
11045,28,0,0,70,70,0,1,0,1,0
10587,28,0,0,70,70,0,1,0,1,0
15958,28,0,0,66,66,0,1,0,1,0
19129,28,0,0,70,70,0,1,0,1,0
16955,28,0,0,70,70,0,1,0,1,0
20779,28,0,0,66,66,0,1,0,1,0
21268,28,0,0,68,68,0,1,0,1,0
17514,28,0,0,70,70,0,1,0,1,0
14496,28,0,0,70,70,0,1,0,1,0
19910,28,0,0,70,70,0,1,0,1,0
21829,28,0,0,70,70,0,1,0,1,0
21711,28,0,0,66,66,0,1,0,1,0
11976,28,0,0,70,70,0,1,0,1,0
11115,28,0,0,66,66,0,1,0,1,0
9586,28,0,0,68,68,0,1,0,1,0
19226,28,0,0,68,68,0,1,0,1,0
14119,28,0,0,70,70,0,1,0,1,0
13907,28,0,0,70,70,0,1,0,1,0
9940,28,0,0,66,66,0,1,0,1,0
12850,28,0,0,70,70,0,1,0,1,0
10186,28,0,0,70,70,0,1,0,1,0
20557,28,0,0,66,66,0,1,0,1,0
16477,28,0,0,70,70,0,1,0,1,0
19200,28,0,0,66,66,0,1,0,1,0
22567,28,0,0,66,66,0,1,0,1,0
19580,28,0,0,70,70,0,1,0,1,0
13857,28,0,0,70,70,0,1,0,1,0
13175,28,0,0,66,66,0,1,0,1,0
10275,28,0,0,70,70,0,1,0,1,0
19390,28,0,0,66,66,0,1,0,1,0
18500,28,0,0,66,66,0,1,0,1,0
14502,28,0,0,66,66,0,1,0,1,0
19682,28,0,0,70,70,0,1,0,1,0
19605,28,0,0,66,66,0,1,0,1,0
11317,28,0,0,66,66,0,1,0,1,0
10384,28,0,0,70,70,0,1,0,1,0
8819,28,0,0,70,70,0,1,0,1,0
13184,28,0,0,70,70,0,1,0,1,0
14901,28,0,0,70,70,0,1,0,1,0
11936,28,0,0,66,66,0,1,0,1,0
15395,28,0,0,66,66,0,1,0,1,0
19454,28,0,0,70,70,0,1,0,1,0
12127,28,0,0,66,66,0,1,0,1,0
17061,28,0,0,66,66,0,1,0,1,0
20117,28,0,0,66,66,0,1,0,1,0
19969,28,0,0,70,70,0,1,0,1,0
12656,28,0,0,68,68,0,1,0,1,0
13667,28,0,0,68,68,0,1,0,1,0
8577,28,0,0,70,70,0,1,0,1,0
18485,28,0,0,70,70,0,1,0,1,0
8732,28,0,0,67,67,0,1,0,1,0
21640,28,0,0,70,70,0,1,0,1,0
9499,28,0,0,66,66,0,1,0,1,0
13978,28,0,0,70,70,0,1,0,1,0
9183,28,0,0,67,67,0,1,0,1,0
12216,28,0,0,70,70,0,1,0,1,0
17011,28,0,0,67,67,0,1,0,1,0
15610,28,0,0,70,70,0,1,0,1,0
13222,28,0,0,69,69,0,1,0,1,0
15162,28,0,0,70,70,0,1,0,1,0
10028,28,0,0,70,70,0,1,0,1,0
17448,28,0,0,70,70,0,1,0,1,0
9158,28,0,0,70,70,0,1,0,1,0
21650,28,0,0,66,66,0,1,0,1,0
14872,28,0,0,70,70,0,1,0,1,0
9433,28,0,0,66,66,0,1,0,1,0
17903,28,0,0,70,70,0,1,0,1,0
17908,28,0,0,69,69,0,1,0,1,0
13725,28,0,0,70,70,0,1,0,1,0
11927,28,0,0,70,70,0,1,0,1,0
10294,28,0,0,66,66,0,1,0,1,0
10731,28,0,0,66,66,0,1,0,1,0
11849,28,0,0,69,69,0,1,0,1,0
12391,28,0,0,70,70,0,1,0,1,0
18757,28,0,0,70,70,0,1,0,1,0
17306,28,0,0,66,66,0,1,0,1,0
9957,28,0,0,66,66,0,1,0,1,0
10161,28,0,0,66,66,0,1,0,1,0
16460,28,0,0,70,70,0,1,0,1,0
19874,28,0,0,70,70,0,1,0,1,0
17186,28,0,0,66,66,0,1,0,1,0
18241,28,0,0,66,66,0,1,0,1,0
14725,28,0,0,66,66,0,1,0,1,0
11362,28,0,0,66,66,0,1,0,1,0
14544,28,0,0,68,68,0,1,0,1,0
11118,28,0,0,70,70,0,1,0,1,0
22350,28,0,0,68,68,0,1,0,1,0
9131,28,0,0,70,70,0,1,0,1,0
12392,28,0,0,67,67,0,1,0,1,0
19787,28,0,0,70,70,0,1,0,1,0
15311,28,0,0,70,70,0,1,0,1,0
895,183,3580,121,293,223,70,4,1,3,1
1459,183,5116,121,293,223,70,4,1,3,1
1312,183,4388,121,293,223,70,4,1,3,1
1958,840,0,0,62,62,0,1,0,1,0
2278,1694,0,0,62,62,0,1,0,1,0
204,2349,0,0,145,145,0,1,0,1,0
2899,1694,0,0,62,62,0,1,0,1,0
10361,1543,0,0,72,72,0,1,0,1,0
4148,403,0,0,146,146,0,1,0,1,0
1652,529,0,0,148,148,0,1,0,1,0
4504,183,15928,121,293,223,70,4,1,3,1
3044,1694,0,0,62,62,0,1,0,1,0
8327,1543,0,0,146,146,0,1,0,1,0
5694,249,0,0,146,146,0,1,0,1,0
8327,1694,0,0,146,146,0,1,0,1,0
2514,1,0,0,62,62,0,1,0,1,0
7274,3049,0,0,62,62,0,1,0,1,0
2916,1176,0,0,148,148,0,1,0,1,0
5035,183,16587,121,293,223,70,4,1,3,1
18,1003,0,0,157,157,0,1,0,1,0
10809,1543,0,0,62,62,0,1,0,1,0
8243,1176,0,0,157,157,0,1,0,1,0
1915,183,7339,121,293,223,70,4,0,3,1
2258,183,9267,121,293,223,70,4,0,3,1
1431,1176,0,0,139,139,0,1,0,1,0
21701,1543,0,0,62,62,0,1,0,1,0
1339,3095,0,0,143,143,0,1,0,1,0
366,1176,0,0,143,143,0,1,0,1,0
768,1176,0,0,157,157,0,1,0,1,0
11546,1694,0,0,62,62,0,1,0,1,0
2245,3095,0,0,159,159,0,1,0,1,0
21292,183,28462,121,293,223,70,4,0,3,1
1432,3095,0,0,139,139,0,1,0,1,0
18482,3095,0,0,145,145,0,1,0,1,0
14306,249,0,0,145,145,0,1,0,1,0
707,3095,0,0,139,139,0,1,0,1,0
2058,183,8110,121,293,223,70,4,0,3,1
1933,1176,0,0,143,143,0,1,0,1,0
518,2816,0,0,141,141,0,1,0,1,0
9413,1627,0,0,109,109,0,1,0,1,0
11276,1638,0,0,62,62,0,1,0,1,0
1288,183,4343,121,293,223,70,4,1,3,1
2203,3095,0,0,158,158,0,1,0,1,0
1455,3095,0,0,139,139,0,1,0,1,0
7427,2830,0,0,74,74,0,1,0,1,0
1545,559,0,0,148,148,0,1,0,1,0
2108,1590,0,0,77,77,0,1,0,1,0
1149,183,4271,121,293,223,70,4,1,3,1
2190,183,8887,121,293,223,70,4,0,3,1
2612,1422,0,0,107,107,0,1,0,1,0
1848,183,7094,121,293,223,70,4,0,3,1
10768,1594,0,0,68,68,0,1,0,1,0
595,1534,0,0,153,153,0,1,0,1,0
1452,3095,0,0,148,148,0,1,0,1,0
2858,1007,0,0,135,135,0,1,0,1,0
10813,1543,0,0,62,62,0,1,0,1,0
2214,183,9044,121,293,223,70,4,0,3,1
14219,281,0,0,142,142,0,1,0,1,0
1794,183,7333,121,293,223,70,4,0,3,1
1456,183,5095,121,293,223,70,4,0,3,1
485,1176,0,0,147,147,0,1,0,1,0
2084,183,8367,121,293,223,70,4,0,3,1
2158,183,8691,121,293,223,70,4,0,3,1
2901,1629,0,0,72,72,0,1,0,1,0
854,3095,0,0,139,139,0,1,0,1,0
2997,1504,0,0,93,93,0,1,0,1,0
9043,1543,0,0,119,119,0,1,0,1,0
1666,561,0,0,147,147,0,1,0,1,0
2786,1591,0,0,62,62,0,1,0,1,0
4127,183,14193,121,293,223,70,4,0,3,1
14679,1543,0,0,68,68,0,1,0,1,0
2106,183,8392,121,293,223,70,4,0,3,1
8276,1322,0,0,152,152,0,1,0,1,0
1734,183,6548,121,293,223,70,4,0,3,1
1116,183,4009,121,293,223,70,4,1,3,1
1616,183,5883,121,293,223,70,4,0,3,1
2056,1558,0,0,82,82,0,1,0,1,0
1774,2444,0,0,105,105,0,1,0,1,0
8158,1783,0,0,132,132,0,1,0,1,0
10086,1676,0,0,71,71,0,1,0,1,0
8969,1543,0,0,122,122,0,1,0,1,0
1941,1065,0,0,116,116,0,1,0,1,0
3018,1694,0,0,62,62,0,1,0,1,0
1637,3095,0,0,148,148,0,1,0,1,0
8437,1548,0,0,143,143,0,1,0,1,0
15208,1543,0,0,62,62,0,1,0,1,0
20976,1892,0,0,80,80,0,1,0,1,0
1784,3095,0,0,147,147,0,1,0,1,0
1625,183,5950,121,293,223,70,4,0,3,1
1446,183,5056,121,293,223,70,4,0,3,1
1828,3095,0,0,148,148,0,1,0,1,0
14375,183,21487,121,293,223,70,4,0,3,1
2508,4,0,0,62,62,0,1,0,1,0
1097,3095,0,0,141,141,0,1,0,1,0
2010,858,0,0,66,66,0,1,0,1,0
2573,1453,0,0,101,101,0,1,0,1,0
2932,1694,0,0,62,62,0,1,0,1,0
206,2352,0,0,144,144,0,1,0,1,0
10589,1543,0,0,66,66,0,1,0,1,0
993,1122,0,0,144,144,0,1,0,1,0
2896,1694,0,0,62,62,0,1,0,1,0
292,1710,0,0,143,143,0,1,0,1,0
8245,1660,0,0,139,139,0,1,0,1,0
1422,295,2962,81,245,198,47,3,0,2,0
2201,183,8948,121,293,223,70,4,0,3,1
9130,1634,0,0,116,116,0,1,0,1,0
1855,183,7097,121,293,223,70,4,0,3,1
166,2079,0,0,147,147,0,1,0,1,0
301,1640,0,0,143,143,0,1,0,1,0
385,1176,0,0,143,143,0,1,0,1,0
1442,183,5058,121,293,223,70,4,0,3,1
3964,518,0,0,146,146,0,1,0,1,0
10936,1616,0,0,67,67,0,1,0,1,0
1935,1140,0,0,134,134,0,1,0,1,0
1677,183,6175,121,293,223,70,4,0,3,1
1646,1038,0,0,107,107,0,1,0,1,0
50,1019,0,0,155,155,0,1,0,1,0
1848,183,7012,121,293,223,70,4,0,3,1
898,183,3586,121,293,223,70,4,1,3,1
955,3095,0,0,140,140,0,1,0,1,0
849,1176,0,0,154,154,0,1,0,1,0
1918,1176,0,0,142,142,0,1,0,1,0
424,2675,0,0,142,142,0,1,0,1,0
10732,1543,0,0,63,63,0,1,0,1,0
1435,3095,0,0,139,139,0,1,0,1,0
2364,92,0,0,76,76,0,1,0,1,0
8173,1891,0,0,133,133,0,1,0,1,0
986,1016,0,0,154,154,0,1,0,1,0
2548,100,0,0,69,69,0,1,0,1,0
4949,183,16480,121,293,223,70,4,1,3,1
3772,183,13329,121,293,223,70,4,1,3,1
3415,183,12061,121,293,223,70,4,1,3,1
3539,183,12328,121,293,223,70,4,0,3,1
59,1008,0,0,156,156,0,1,0,1,0
1448,183,5061,121,293,223,70,4,1,3,1
7618,1194,0,0,146,146,0,1,0,1,0
8251,1211,0,0,155,155,0,1,0,1,0
8964,1655,0,0,124,124,0,1,0,1,0
2912,1293,0,0,128,128,0,1,0,1,0
1982,577,0,0,99,99,0,1,0,1,0
10101,1441,0,0,88,88,0,1,0,1,0
1315,183,5217,121,293,223,70,4,0,3,1
716,2810,0,0,141,141,0,1,0,1,0
11465,1677,0,0,62,62,0,1,0,1,0
2446,1694,0,0,62,62,0,1,0,1,0
9178,1309,0,0,122,122,0,1,0,1,0
1484,2877,0,0,130,130,0,1,0,1,0
4450,183,14924,121,293,223,70,4,0,3,1
16624,1618,0,0,62,62,0,1,0,1,0
9102,1298,0,0,125,125,0,1,0,1,0
2904,1527,0,0,89,89,0,1,0,1,0
463,1105,0,0,157,157,0,1,0,1,0
2222,183,9061,121,293,223,70,4,0,3,1
1864,183,7626,121,293,223,70,4,0,3,1
1315,183,4406,121,293,223,70,4,1,3,1
1126,3095,0,0,144,144,0,1,0,1,0
1896,3095,0,0,150,150,0,1,0,1,0
1537,183,5496,121,293,223,70,4,0,3,1
1347,183,4562,121,293,223,70,4,1,3,1
479,1775,0,0,150,150,0,1,0,1,0
532,2564,0,0,144,144,0,1,0,1,0
6937,931,0,0,146,146,0,1,0,1,0
2058,183,8231,121,293,223,70,4,0,3,1
2330,2910,0,0,146,146,0,1,0,1,0
1887,3095,0,0,150,150,0,1,0,1,0
429,1097,0,0,157,157,0,1,0,1,0
21144,183,28351,121,293,223,70,4,0,3,1
1284,183,4335,121,293,223,70,4,1,3,1
1316,774,0,0,151,151,0,1,0,1,0
2219,181,0,0,91,91,0,1,0,1,0
710,3095,0,0,139,139,0,1,0,1,0
13369,451,0,0,145,145,0,1,0,1,0
21402,549,20785,88,230,179,51,3,0,2,0
900,1176,0,0,155,155,0,1,0,1,0
1449,2930,0,0,133,133,0,1,0,1,0
195,2290,0,0,145,145,0,1,0,1,0
2384,1227,0,0,62,62,0,1,0,1,0
1197,183,4842,121,293,223,70,4,0,3,1
1449,1120,0,0,139,139,0,1,0,1,0
2151,183,8666,121,293,223,70,4,0,3,1
21315,1728,0,0,71,71,0,1,0,1,0
2249,2920,0,0,146,146,0,1,0,1,0
9272,1323,0,0,118,118,0,1,0,1,0
10249,1633,0,0,95,95,0,1,0,1,0
10345,1550,0,0,71,71,0,1,0,1,0
1274,3095,0,0,146,146,0,1,0,1,0
10806,1599,0,0,68,68,0,1,0,1,0
2595,1418,0,0,62,62,0,1,0,1,0
1637,1044,0,0,108,108,0,1,0,1,0
21190,1788,0,0,75,75,0,1,0,1,0
1500,183,5310,121,293,223,70,4,0,3,1
2593,1438,0,0,104,104,0,1,0,1,0
14829,1543,0,0,62,62,0,1,0,1,0
6253,524,0,0,146,146,0,1,0,1,0
1128,2956,0,0,143,143,0,1,0,1,0
10728,1543,0,0,63,63,0,1,0,1,0
1740,733,0,0,146,146,0,1,0,1,0
8269,1337,0,0,153,153,0,1,0,1,0
4843,183,15971,121,293,223,70,4,1,3,1
1490,1176,0,0,139,139,0,1,0,1,0
183,1085,0,0,150,150,0,1,0,1,0
8281,1411,0,0,151,151,0,1,0,1,0
937,3095,0,0,139,139,0,1,0,1,0
8193,1271,0,0,152,152,0,1,0,1,0
604,1056,0,0,143,143,0,1,0,1,0
7931,2109,0,0,114,114,0,1,0,1,0
11130,1694,0,0,72,72,0,1,0,1,0
8916,1694,0,0,130,130,0,1,0,1,0
10445,1565,0,0,74,74,0,1,0,1,0
1067,183,3914,121,293,223,70,4,1,3,1
1868,183,7113,121,293,223,70,4,0,3,1
2910,1694,0,0,62,62,0,1,0,1,0
1701,1003,0,0,99,99,0,1,0,1,0
9565,1365,0,0,108,108,0,1,0,1,0
1578,744,0,0,145,145,0,1,0,1,0
10390,1543,0,0,71,71,0,1,0,1,0
1759,638,0,0,117,117,0,1,0,1,0
6222,508,0,0,146,146,0,1,0,1,0
1368,399,1340,45,202,176,26,2,0,1,0
17067,1611,0,0,62,62,0,1,0,1,0
8327,1676,0,0,146,146,0,1,0,1,0
11370,1335,0,0,75,75,0,1,0,1,0
1384,3095,0,0,141,141,0,1,0,1,0
2014,755,0,0,62,62,0,1,0,1,0
1997,1273,0,0,127,127,0,1,0,1,0
2985,1459,0,0,100,100,0,1,0,1,0
1204,324,2118,71,233,192,41,2,0,2,0
230,2159,0,0,144,144,0,1,0,1,0
1234,1151,0,0,141,141,0,1,0,1,0
2014,183,7892,121,293,223,70,4,0,3,1
1985,912,0,0,62,62,0,1,0,1,0
10154,1507,0,0,80,80,0,1,0,1,0
2732,1111,0,0,131,131,0,1,0,1,0
1570,588,0,0,148,148,0,1,0,1,0
9779,1395,0,0,100,100,0,1,0,1,0
715,3095,0,0,139,139,0,1,0,1,0
801,913,945,31,192,174,18,1,0,1,0
597,741,1567,52,208,178,30,2,0,1,0
7958,2069,0,0,116,116,0,1,0,1,0
851,525,2345,79,246,200,45,2,0,2,0
1036,183,3855,121,293,223,70,4,1,3,1
4681,183,16148,121,293,223,70,4,1,3,1
2083,3095,0,0,156,156,0,1,0,1,0
710,1162,0,0,157,157,0,1,0,1,0
1922,803,0,0,72,72,0,1,0,1,0
4318,386,0,0,146,146,0,1,0,1,0
726,3095,0,0,139,139,0,1,0,1,0
790,996,648,21,181,168,12,1,0,1,0
10129,1543,0,0,80,80,0,1,0,1,0
8985,1282,0,0,129,129,0,1,0,1,0
1080,183,4303,121,293,223,70,4,0,3,1
1947,183,6851,121,293,223,70,4,1,3,1
2907,1422,0,0,107,107,0,1,0,1,0
1952,1494,0,0,91,91,0,1,0,1,0
8557,1221,0,0,145,145,0,1,0,1,0
1470,183,5172,121,293,223,70,4,0,3,1
1885,183,7247,121,293,223,70,4,0,3,1
11183,1647,0,0,65,65,0,1,0,1,0
10483,1543,0,0,69,69,0,1,0,1,0
2706,1590,0,0,78,78,0,1,0,1,0
4002,494,0,0,146,146,0,1,0,1,0
2217,600,0,0,103,103,0,1,0,1,0
2245,3072,0,0,157,157,0,1,0,1,0
2966,1380,0,0,114,114,0,1,0,1,0
1748,3095,0,0,152,152,0,1,0,1,0
1513,1123,0,0,126,126,0,1,0,1,0
2405,2751,0,0,135,135,0,1,0,1,0
1774,1176,0,0,141,141,0,1,0,1,0
2186,183,8896,121,293,223,70,4,0,3,1
671,3042,0,0,139,139,0,1,0,1,0
2819,1142,0,0,139,139,0,1,0,1,0
1916,1137,0,0,143,143,0,1,0,1,0
8276,1320,0,0,152,152,0,1,0,1,0
1552,602,0,0,149,149,0,1,0,1,0
10634,1543,0,0,65,65,0,1,0,1,0
1917,647,0,0,104,104,0,1,0,1,0
2331,1176,0,0,145,145,0,1,0,1,0
3036,1694,0,0,62,62,0,1,0,1,0
737,1168,0,0,157,157,0,1,0,1,0
2109,1440,0,0,101,101,0,1,0,1,0
4410,183,14736,121,293,223,70,4,0,3,1
1506,954,0,0,142,142,0,1,0,1,0
6306,584,0,0,146,146,0,1,0,1,0
8296,1506,0,0,149,149,0,1,0,1,0
1722,990,0,0,96,96,0,1,0,1,0
2794,1498,0,0,62,62,0,1,0,1,0
339,1365,0,0,143,143,0,1,0,1,0
8262,1262,0,0,154,154,0,1,0,1,0
9325,1543,0,0,112,112,0,1,0,1,0
428,1053,0,0,151,151,0,1,0,1,0
2140,183,8584,121,293,223,70,4,0,3,1
8327,1693,0,0,146,146,0,1,0,1,0
2230,1314,0,0,121,121,0,1,0,1,0
301,1642,0,0,143,143,0,1,0,1,0
1819,928,0,0,82,82,0,1,0,1,0
1332,183,4490,121,293,223,70,4,1,3,1
1511,938,0,0,142,142,0,1,0,1,0
1373,183,4691,121,293,223,70,4,1,3,1
2127,183,8722,121,293,223,70,4,0,3,1
2508,1444,0,0,101,101,0,1,0,1,0
2250,2877,0,0,143,143,0,1,0,1,0
1446,679,0,0,150,150,0,1,0,1,0
3002,1694,0,0,62,62,0,1,0,1,0
1204,3095,0,0,139,139,0,1,0,1,0
1436,1176,0,0,139,139,0,1,0,1,0
1793,183,6745,121,293,223,70,4,0,3,1
4321,183,15387,121,293,223,70,4,0,3,1
898,183,3586,121,293,223,70,4,1,3,1
1964,857,0,0,62,62,0,1,0,1,0
1325,183,5255,121,293,223,70,4,0,3,1
2126,3095,0,0,156,156,0,1,0,1,0
2820,183,10342,121,293,223,70,4,0,3,1
11045,1591,0,0,62,62,0,1,0,1,0
19627,1180,0,0,85,85,0,1,0,1,0
10520,1560,0,0,71,71,0,1,0,1,0
879,306,3134,105,276,214,61,3,0,2,0
2542,1694,0,0,62,62,0,1,0,1,0
1563,183,5620,121,293,223,70,4,0,3,1
46,1017,0,0,155,155,0,1,0,1,0
1559,596,0,0,148,148,0,1,0,1,0
1941,1056,0,0,114,114,0,1,0,1,0
11305,1663,0,0,64,64,0,1,0,1,0
1386,183,4756,121,293,223,70,4,1,3,1
1016,3095,0,0,140,140,0,1,0,1,0
9272,1354,0,0,115,115,0,1,0,1,0
521,1176,0,0,148,148,0,1,0,1,0
3222,183,11215,121,293,223,70,4,0,3,1
1383,606,0,0,149,149,0,1,0,1,0
2060,183,8122,121,293,223,70,4,0,3,1
1949,831,0,0,64,64,0,1,0,1,0
1413,183,4992,121,293,223,70,4,1,3,1
2029,183,7956,121,293,223,70,4,0,3,1
191,2260,0,0,145,145,0,1,0,1,0
7596,2588,0,0,87,87,0,1,0,1,0
2611,1423,0,0,106,106,0,1,0,1,0
2913,1255,0,0,134,134,0,1,0,1,0
2699,1586,0,0,78,78,0,1,0,1,0
8994,1543,0,0,123,123,0,1,0,1,0
4649,183,16108,121,293,223,70,4,1,3,1
2872,1694,0,0,62,62,0,1,0,1,0
224,2199,0,0,144,144,0,1,0,1,0
2241,167,0,0,89,89,0,1,0,1,0
1685,508,0,0,144,144,0,1,0,1,0
9149,1632,0,0,116,116,0,1,0,1,0
19895,183,27419,121,293,223,70,4,0,3,1
11174,1617,0,0,62,62,0,1,0,1,0
10977,1577,0,0,62,62,0,1,0,1,0
1461,3095,0,0,139,139,0,1,0,1,0
2056,1102,0,0,62,62,0,1,0,1,0
2227,1558,0,0,62,62,0,1,0,1,0
17874,1543,0,0,62,62,0,1,0,1,0
1494,1176,0,0,139,139,0,1,0,1,0
1949,950,0,0,88,88,0,1,0,1,0
817,2752,0,0,143,143,0,1,0,1,0
10426,1488,0,0,76,76,0,1,0,1,0
1589,711,0,0,145,145,0,1,0,1,0
1389,3095,0,0,140,140,0,1,0,1,0
315,1540,0,0,143,143,0,1,0,1,0
2246,1176,0,0,144,144,0,1,0,1,0
5725,304,0,0,144,144,0,1,0,1,0
1321,183,4433,121,293,223,70,4,1,3,1
1341,183,4532,121,293,223,70,4,0,3,1
1637,570,0,0,147,147,0,1,0,1,0
1474,1047,0,0,140,140,0,1,0,1,0
16997,2795,0,0,127,127,0,1,0,1,0
13530,655,0,0,121,121,0,1,0,1,0
1535,3095,0,0,146,146,0,1,0,1,0
15520,2529,0,0,118,118,0,1,0,1,0
1231,183,4231,121,293,223,70,4,1,3,1
2031,1323,0,0,119,119,0,1,0,1,0
8856,1543,0,0,126,126,0,1,0,1,0
8281,1411,0,0,152,152,0,1,0,1,0
9029,1543,0,0,122,122,0,1,0,1,0
1816,907,0,0,145,145,0,1,0,1,0
8327,1689,0,0,146,146,0,1,0,1,0
2048,1349,0,0,115,115,0,1,0,1,0
1713,183,6353,121,293,223,70,4,0,3,1
18404,3042,0,0,145,145,0,1,0,1,0
2423,137,0,0,62,62,0,1,0,1,0
3469,183,12860,121,293,223,70,4,0,3,1
11111,1605,0,0,62,62,0,1,0,1,0
2804,1643,0,0,69,69,0,1,0,1,0
8973,1654,0,0,124,124,0,1,0,1,0
2028,183,7961,121,293,223,70,4,0,3,1
1444,183,5047,121,293,223,70,4,0,3,1
2742,1694,0,0,62,62,0,1,0,1,0
2928,1694,0,0,62,62,0,1,0,1,0
6196,1139,0,0,119,119,0,1,0,1,0
11142,1611,0,0,62,62,0,1,0,1,0
1486,183,5759,121,293,223,70,4,0,3,1
1652,529,0,0,147,147,0,1,0,1,0
9835,1451,0,0,93,93,0,1,0,1,0
9653,1613,0,0,101,101,0,1,0,1,0
8268,1335,0,0,153,153,0,1,0,1,0
13993,412,0,0,135,135,0,1,0,1,0
1900,183,7324,121,293,223,70,4,0,3,1
20766,183,28078,121,293,223,70,4,0,3,1
9274,2073,0,0,68,68,0,1,0,1,0
16452,2684,0,0,123,123,0,1,0,1,0
3907,183,13244,121,293,223,70,4,0,3,1
546,1176,0,0,149,149,0,1,0,1,0
1596,1070,0,0,114,114,0,1,0,1,0
2136,183,8562,121,293,223,70,4,0,3,1
2143,183,8623,121,293,223,70,4,0,3,1
11067,1595,0,0,62,62,0,1,0,1,0
2247,183,9207,121,293,223,70,4,0,3,1
4812,183,16310,121,293,223,70,4,1,3,1
8925,1543,0,0,124,124,0,1,0,1,0
2078,267,0,0,105,105,0,1,0,1,0
18994,2848,0,0,131,131,0,1,0,1,0
2958,1653,0,0,68,68,0,1,0,1,0
1580,1080,0,0,117,117,0,1,0,1,0
930,3095,0,0,141,141,0,1,0,1,0
332,1416,0,0,143,143,0,1,0,1,0
4728,183,16206,121,293,223,70,4,1,3,1
3954,603,0,0,132,132,0,1,0,1,0
722,1176,0,0,141,141,0,1,0,1,0
1777,451,0,0,135,135,0,1,0,1,0
1312,183,4391,121,293,223,70,4,1,3,1
295,2484,0,0,143,143,0,1,0,1,0
2713,1434,0,0,62,62,0,1,0,1,0
1977,855,0,0,62,62,0,1,0,1,0
6416,511,0,0,149,149,0,1,0,1,0
11306,1644,0,0,62,62,0,1,0,1,0
10908,1664,0,0,78,78,0,1,0,1,0
1489,183,5270,121,293,223,70,4,0,3,1
2076,183,8249,121,293,223,70,4,0,3,1
1255,819,0,0,152,152,0,1,0,1,0
7416,2865,0,0,73,73,0,1,0,1,0
19720,183,27288,121,293,223,70,4,0,3,1
2238,183,9152,121,293,223,70,4,0,3,1
3021,1602,0,0,77,77,0,1,0,1,0
2922,1204,0,0,143,143,0,1,0,1,0
2019,1001,0,0,130,130,0,1,0,1,0
1716,1176,0,0,141,141,0,1,0,1,0
6807,860,0,0,146,146,0,1,0,1,0
8304,1445,0,0,148,148,0,1,0,1,0
1031,3095,0,0,141,141,0,1,0,1,0
11769,1576,0,0,68,68,0,1,0,1,0
18404,3079,0,0,144,144,0,1,0,1,0
2264,1656,0,0,62,62,0,1,0,1,0
1953,1206,0,0,138,138,0,1,0,1,0
11021,1627,0,0,66,66,0,1,0,1,0
9837,1404,0,0,97,97,0,1,0,1,0
1138,3095,0,0,139,139,0,1,0,1,0
8322,1666,0,0,146,146,0,1,0,1,0
11768,1738,0,0,64,64,0,1,0,1,0
1009,2838,0,0,141,141,0,1,0,1,0
1476,183,5201,121,293,223,70,4,0,3,1
1143,183,4255,121,293,223,70,4,1,3,1
10664,1652,0,0,85,85,0,1,0,1,0
1752,760,0,0,146,146,0,1,0,1,0
10796,1598,0,0,68,68,0,1,0,1,0
9091,1637,0,0,118,118,0,1,0,1,0
1010,1176,0,0,150,150,0,1,0,1,0
11449,183,21272,121,293,223,70,4,0,3,1
4459,183,15795,121,293,223,70,4,0,3,1
1660,2716,0,0,118,118,0,1,0,1,0
2975,1416,0,0,108,108,0,1,0,1,0
972,3095,0,0,139,139,0,1,0,1,0
755,980,0,0,144,144,0,1,0,1,0
349,1297,0,0,143,143,0,1,0,1,0
1707,656,0,0,147,147,0,1,0,1,0
8080,1490,0,0,141,141,0,1,0,1,0
407,1176,0,0,144,144,0,1,0,1,0
1492,183,5288,121,293,223,70,4,0,3,1
796,1176,0,0,156,156,0,1,0,1,0
837,628,1972,66,231,193,38,2,0,2,0
1390,3095,0,0,140,140,0,1,0,1,0
1037,2855,0,0,140,140,0,1,0,1,0
12293,1302,0,0,84,84,0,1,0,1,0
2891,1694,0,0,62,62,0,1,0,1,0
1735,183,6678,121,293,223,70,4,0,3,1
7496,2618,0,0,83,83,0,1,0,1,0
7999,1646,0,0,133,133,0,1,0,1,0
1863,1176,0,0,142,142,0,1,0,1,0
359,1081,0,0,157,157,0,1,0,1,0
7884,2176,0,0,110,110,0,1,0,1,0
14215,278,0,0,143,143,0,1,0,1,0
1457,1159,0,0,135,135,0,1,0,1,0
2777,1628,0,0,72,72,0,1,0,1,0
20785,1984,0,0,85,85,0,1,0,1,0
10916,1565,0,0,62,62,0,1,0,1,0
11441,1672,0,0,62,62,0,1,0,1,0
4538,183,15278,121,293,223,70,4,0,3,1
4751,183,16234,121,293,223,70,4,1,3,1
9312,1620,0,0,110,110,0,1,0,1,0
173,2126,0,0,146,146,0,1,0,1,0
2985,1694,0,0,62,62,0,1,0,1,0
2253,1657,0,0,67,67,0,1,0,1,0
1358,394,1387,46,204,177,27,2,0,1,0
458,1176,0,0,146,146,0,1,0,1,0
2202,192,0,0,93,93,0,1,0,1,0
2906,183,10257,121,293,223,70,4,1,3,1
3021,1603,0,0,77,77,0,1,0,1,0
1372,401,1320,44,201,175,25,2,0,1,0
2911,1323,0,0,123,123,0,1,0,1,0
4804,183,16301,121,293,223,70,4,1,3,1
625,2626,0,0,144,144,0,1,0,1,0
8532,1226,0,0,145,145,0,1,0,1,0
83,1011,0,0,156,156,0,1,0,1,0
1717,2621,0,0,112,112,0,1,0,1,0
74,1410,0,0,153,153,0,1,0,1,0
8900,2255,0,0,67,67,0,1,0,1,0
3862,183,13800,121,293,223,70,4,0,3,1
5780,291,0,0,146,146,0,1,0,1,0
7595,2635,0,0,87,87,0,1,0,1,0
2266,2179,0,0,95,95,0,1,0,1,0
2985,183,11075,121,293,223,70,4,0,3,1
6119,482,0,0,146,146,0,1,0,1,0
2639,183,10397,121,293,223,70,4,0,3,1
1538,183,5512,121,293,223,70,4,0,3,1
2370,217,0,0,62,62,0,1,0,1,0
2870,1694,0,0,62,62,0,1,0,1,0
8266,1278,0,0,153,153,0,1,0,1,0
2029,183,7982,121,293,223,70,4,0,3,1
1807,1176,0,0,144,144,0,1,0,1,0
893,193,3541,119,291,222,69,3,0,2,0
7649,2512,0,0,91,91,0,1,0,1,0
8309,1465,0,0,148,148,0,1,0,1,0
826,1133,0,0,156,156,0,1,0,1,0
1642,183,6091,121,293,223,70,4,0,3,1
4261,183,15153,121,293,223,70,4,0,3,1
11243,1655,0,0,64,64,0,1,0,1,0
14497,379,0,0,145,145,0,1,0,1,0
1885,386,0,0,124,124,0,1,0,1,0
2871,183,10513,121,293,223,70,4,0,3,1
739,793,0,0,153,153,0,1,0,1,0
10790,1543,0,0,62,62,0,1,0,1,0
1897,183,7252,121,293,223,70,4,0,3,1
1921,803,0,0,72,72,0,1,0,1,0
2073,1148,0,0,62,62,0,1,0,1,0
8327,1655,0,0,146,146,0,1,0,1,0
10472,1694,0,0,90,90,0,1,0,1,0
1293,3095,0,0,142,142,0,1,0,1,0
1661,183,6102,121,293,223,70,4,0,3,1
21597,1197,7232,30,120,102,17,1,0,1,0
1441,183,5029,121,293,223,70,4,1,3,1
2161,1519,0,0,89,89,0,1,0,1,0
6597,744,0,0,146,146,0,1,0,1,0
8327,1677,0,0,146,146,0,1,0,1,0
1667,544,0,0,143,143,0,1,0,1,0
1616,3095,0,0,143,143,0,1,0,1,0
3664,183,12524,121,293,223,70,4,0,3,1
9902,1598,0,0,92,92,0,1,0,1,0
2987,1694,0,0,62,62,0,1,0,1,0
632,2630,0,0,144,144,0,1,0,1,0
2219,3095,0,0,158,158,0,1,0,1,0
1376,183,4706,121,293,223,70,4,1,3,1
934,1176,0,0,152,152,0,1,0,1,0
1772,3095,0,0,152,152,0,1,0,1,0
15601,475,0,0,130,130,0,1,0,1,0
10651,1543,0,0,67,67,0,1,0,1,0
258,1122,0,0,147,147,0,1,0,1,0
1040,183,4146,121,293,223,70,4,0,3,1
2729,1694,0,0,62,62,0,1,0,1,0
9693,1427,0,0,98,98,0,1,0,1,0
9815,1809,0,0,70,70,0,1,0,1,0
319,1511,0,0,143,143,0,1,0,1,0
150,1959,0,0,148,148,0,1,0,1,0
1412,183,4884,121,293,223,70,4,1,3,1
3238,1343,0,0,84,84,0,1,0,1,0
2963,1694,0,0,62,62,0,1,0,1,0
3076,1510,0,0,73,73,0,1,0,1,0
1587,183,5734,121,293,223,70,4,0,3,1
1339,183,5218,121,293,223,70,4,0,3,1
1795,674,0,0,107,107,0,1,0,1,0
13890,183,23055,121,293,223,70,4,0,3,1
1812,183,6372,121,293,223,70,4,1,3,1
1477,1040,0,0,140,140,0,1,0,1,0
8327,1637,0,0,146,146,0,1,0,1,0
1052,1176,0,0,149,149,0,1,0,1,0
1367,3095,0,0,141,141,0,1,0,1,0
17857,2975,0,0,139,139,0,1,0,1,0
1231,3095,0,0,142,142,0,1,0,1,0
1860,183,7217,121,293,223,70,4,0,3,1
18954,2867,0,0,132,132,0,1,0,1,0
4739,183,16220,121,293,223,70,4,1,3,1
2161,217,0,0,97,97,0,1,0,1,0
1059,3095,0,0,139,139,0,1,0,1,0
12484,1881,0,0,80,80,0,1,0,1,0
8327,1639,0,0,146,146,0,1,0,1,0
1558,183,5596,121,293,223,70,4,0,3,1
8386,1543,0,0,144,144,0,1,0,1,0
10123,1543,0,0,85,85,0,1,0,1,0
11642,1543,0,0,62,62,0,1,0,1,0
404,2480,0,0,144,144,0,1,0,1,0
2016,183,7885,121,293,223,70,4,0,3,1
2530,1496,0,0,92,92,0,1,0,1,0
1432,183,4986,121,293,223,70,4,1,3,1
16032,1425,0,0,145,145,0,1,0,1,0
2806,1644,0,0,69,69,0,1,0,1,0
2038,1334,0,0,118,118,0,1,0,1,0
10493,1543,0,0,69,69,0,1,0,1,0
1066,1176,0,0,140,140,0,1,0,1,0
4761,183,16247,121,293,223,70,4,1,3,1
2911,1327,0,0,122,122,0,1,0,1,0
2505,183,8832,121,293,223,70,4,1,3,1
9128,1329,0,0,121,121,0,1,0,1,0
12108,1807,0,0,68,68,0,1,0,1,0
18171,183,25160,121,293,223,70,4,0,3,1
15305,929,0,0,145,145,0,1,0,1,0
8739,1262,0,0,137,137,0,1,0,1,0
6478,1639,0,0,104,104,0,1,0,1,0
125,1027,0,0,157,157,0,1,0,1,0
1934,1155,0,0,138,138,0,1,0,1,0
2404,1591,0,0,79,79,0,1,0,1,0
18577,3048,0,0,142,142,0,1,0,1,0
13816,505,0,0,130,130,0,1,0,1,0
2026,299,0,0,110,110,0,1,0,1,0
1795,183,6802,121,293,223,70,4,0,3,1
1137,3095,0,0,139,139,0,1,0,1,0
1870,183,7175,121,293,223,70,4,0,3,1
2092,1414,0,0,105,105,0,1,0,1,0
10679,1543,0,0,64,64,0,1,0,1,0
20720,1543,0,0,62,62,0,1,0,1,0
8532,1226,0,0,145,145,0,1,0,1,0
11139,1543,0,0,71,71,0,1,0,1,0
1915,1135,0,0,143,143,0,1,0,1,0
1952,915,0,0,80,80,0,1,0,1,0
539,2846,0,0,140,140,0,1,0,1,0
10034,1543,0,0,83,83,0,1,0,1,0
1417,1176,0,0,149,149,0,1,0,1,0
1131,183,4038,121,293,223,70,4,1,3,1
2142,183,8670,121,293,223,70,4,0,3,1
4108,777,0,0,147,147,0,1,0,1,0
2447,1694,0,0,62,62,0,1,0,1,0
1159,183,4092,121,293,223,70,4,1,3,1
19180,183,26885,121,293,223,70,4,0,3,1
3682,183,13023,121,293,223,70,4,0,3,1
2277,1693,0,0,62,62,0,1,0,1,0
2766,183,10164,121,293,223,70,4,0,3,1
1954,891,0,0,74,74,0,1,0,1,0
759,1434,0,0,154,154,0,1,0,1,0
574,1131,0,0,157,157,0,1,0,1,0
8223,1213,0,0,155,155,0,1,0,1,0
1193,183,4158,121,293,223,70,4,1,3,1
2631,183,10374,121,293,223,70,4,0,3,1
1619,538,0,0,148,148,0,1,0,1,0
1886,885,0,0,72,72,0,1,0,1,0
1170,668,0,0,150,150,0,1,0,1,0
2915,1196,0,0,144,144,0,1,0,1,0
4890,183,16407,121,293,223,70,4,1,3,1
18063,3010,0,0,139,139,0,1,0,1,0
4039,529,0,0,137,137,0,1,0,1,0
1426,693,0,0,150,150,0,1,0,1,0
8297,1414,0,0,149,149,0,1,0,1,0
170,1078,0,0,150,150,0,1,0,1,0
1480,3095,0,0,140,140,0,1,0,1,0
5010,183,16556,121,293,223,70,4,1,3,1
2144,1338,0,0,62,62,0,1,0,1,0
338,2547,0,0,143,143,0,1,0,1,0
11308,183,21169,121,293,223,70,4,0,3,1
1904,3095,0,0,150,150,0,1,0,1,0
3193,183,11740,121,293,223,70,4,0,3,1
1642,557,0,0,147,147,0,1,0,1,0
621,1176,0,0,151,151,0,1,0,1,0
355,1248,0,0,143,143,0,1,0,1,0
2907,1432,0,0,105,105,0,1,0,1,0
2396,1237,0,0,62,62,0,1,0,1,0
9729,1433,0,0,97,97,0,1,0,1,0
1936,183,7452,121,293,223,70,4,0,3,1
13438,2074,0,0,90,90,0,1,0,1,0
17562,1604,0,0,62,62,0,1,0,1,0
11941,760,0,0,145,145,0,1,0,1,0
589,1176,0,0,150,150,0,1,0,1,0
1954,183,7591,121,293,223,70,4,0,3,1
264,2438,0,0,144,144,0,1,0,1,0
8327,1636,0,0,146,146,0,1,0,1,0
1693,183,6255,121,293,223,70,4,0,3,1
6537,1744,0,0,101,101,0,1,0,1,0
1627,3095,0,0,143,143,0,1,0,1,0
6738,628,0,0,150,150,0,1,0,1,0
1971,819,0,0,62,62,0,1,0,1,0
2242,183,9175,121,293,223,70,4,0,3,1
7089,934,0,0,146,146,0,1,0,1,0
10776,1595,0,0,68,68,0,1,0,1,0
803,3095,0,0,139,139,0,1,0,1,0
8848,183,19372,121,293,223,70,4,0,3,1
3990,817,0,0,147,147,0,1,0,1,0
1392,659,0,0,146,146,0,1,0,1,0
1525,1115,0,0,125,125,0,1,0,1,0
3100,1060,0,0,147,147,0,1,0,1,0
1462,1176,0,0,139,139,0,1,0,1,0
1408,3095,0,0,140,140,0,1,0,1,0
148,1949,0,0,148,148,0,1,0,1,0
2979,1694,0,0,62,62,0,1,0,1,0
10764,1543,0,0,62,62,0,1,0,1,0
2129,183,8599,121,293,223,70,4,0,3,1
851,2774,0,0,143,143,0,1,0,1,0
133,1029,0,0,157,157,0,1,0,1,0
8083,2007,0,0,126,126,0,1,0,1,0
8547,1677,0,0,137,137,0,1,0,1,0
9762,1393,0,0,100,100,0,1,0,1,0
987,2824,0,0,141,141,0,1,0,1,0
20609,183,27963,121,293,223,70,4,0,3,1
2952,1694,0,0,62,62,0,1,0,1,0
1360,1176,0,0,140,140,0,1,0,1,0
725,3095,0,0,139,139,0,1,0,1,0
1803,682,0,0,105,105,0,1,0,1,0
2006,766,0,0,62,62,0,1,0,1,0
2735,1322,0,0,123,123,0,1,0,1,0
1913,795,0,0,74,74,0,1,0,1,0
8552,1677,0,0,137,137,0,1,0,1,0
404,1176,0,0,144,144,0,1,0,1,0
347,1309,0,0,143,143,0,1,0,1,0
7784,2061,0,0,112,112,0,1,0,1,0
353,2570,0,0,143,143,0,1,0,1,0
365,1179,0,0,143,143,0,1,0,1,0
72,1398,0,0,153,153,0,1,0,1,0
1117,183,4010,121,293,223,70,4,1,3,1
4850,332,0,0,146,146,0,1,0,1,0
13799,1660,0,0,62,62,0,1,0,1,0
7482,183,18374,121,293,223,70,4,0,3,1
294,1696,0,0,143,143,0,1,0,1,0
1788,183,6845,121,293,223,70,4,0,3,1
1495,183,5286,121,293,223,70,4,0,3,1
991,3095,0,0,139,139,0,1,0,1,0
847,1176,0,0,154,154,0,1,0,1,0
1620,1055,0,0,111,111,0,1,0,1,0
20982,1417,0,0,70,70,0,1,0,1,0
10243,1577,0,0,81,81,0,1,0,1,0
2026,183,7939,121,293,223,70,4,0,3,1
2010,183,7855,121,293,223,70,4,0,3,1
19937,183,27450,121,293,223,70,4,0,3,1
17394,2353,0,0,145,145,0,1,0,1,0
1880,2287,0,0,96,96,0,1,0,1,0
1037,1176,0,0,153,153,0,1,0,1,0
2957,1342,0,0,120,120,0,1,0,1,0
3578,183,12643,121,293,223,70,4,1,3,1
5023,183,16572,121,293,223,70,4,1,3,1
17663,2929,0,0,135,135,0,1,0,1,0
21367,1484,0,0,65,65,0,1,0,1,0
1576,749,0,0,144,144,0,1,0,1,0
2107,957,0,0,62,62,0,1,0,1,0
2918,1694,0,0,62,62,0,1,0,1,0
2239,1670,0,0,65,65,0,1,0,1,0
20291,2222,0,0,98,98,0,1,0,1,0
465,1106,0,0,157,157,0,1,0,1,0
2334,1363,0,0,113,113,0,1,0,1,0
2523,1494,0,0,95,95,0,1,0,1,0
564,1128,0,0,157,157,0,1,0,1,0
4584,359,0,0,146,146,0,1,0,1,0
21189,1543,0,0,62,62,0,1,0,1,0
7558,1272,0,0,146,146,0,1,0,1,0
9114,1646,0,0,119,119,0,1,0,1,0
9841,1796,0,0,70,70,0,1,0,1,0
480,2530,0,0,144,144,0,1,0,1,0
986,183,3756,121,293,223,70,4,1,3,1
2950,1317,0,0,124,124,0,1,0,1,0
381,1176,0,0,142,142,0,1,0,1,0
2126,183,8718,121,293,223,70,4,0,3,1
682,1156,0,0,157,157,0,1,0,1,0
2007,183,7964,121,293,223,70,4,0,3,1
1337,385,1486,50,208,179,29,2,0,1,0
10210,1457,0,0,84,84,0,1,0,1,0
1654,183,6062,121,293,223,70,4,0,3,1
2119,183,8545,121,293,223,70,4,0,3,1
1407,183,4853,121,293,223,70,4,0,3,1
14201,283,0,0,143,143,0,1,0,1,0
11248,1633,0,0,62,62,0,1,0,1,0
2915,1196,0,0,144,144,0,1,0,1,0
2948,183,10403,121,293,223,70,4,1,3,1
1697,183,6376,121,293,223,70,4,0,3,1
3760,183,13551,121,293,223,70,4,0,3,1
2906,1694,0,0,62,62,0,1,0,1,0
2947,1648,0,0,69,69,0,1,0,1,0
2462,1459,0,0,98,98,0,1,0,1,0
2266,1676,0,0,64,64,0,1,0,1,0
1945,1194,0,0,140,140,0,1,0,1,0
9194,2112,0,0,68,68,0,1,0,1,0
2852,183,11029,121,293,223,70,4,0,3,1
11230,1653,0,0,64,64,0,1,0,1,0
10742,1591,0,0,68,68,0,1,0,1,0
886,3095,0,0,139,139,0,1,0,1,0
1873,393,0,0,125,125,0,1,0,1,0
1227,3095,0,0,145,145,0,1,0,1,0
374,1176,0,0,143,143,0,1,0,1,0
18619,1543,0,0,64,64,0,1,0,1,0
8073,1905,0,0,125,125,0,1,0,1,0
1657,1031,0,0,105,105,0,1,0,1,0
1627,599,0,0,147,147,0,1,0,1,0
4699,580,0,0,146,146,0,1,0,1,0
632,1176,0,0,152,152,0,1,0,1,0
572,1130,0,0,157,157,0,1,0,1,0
10506,1561,0,0,70,70,0,1,0,1,0
1930,811,0,0,69,69,0,1,0,1,0
2359,1176,0,0,145,145,0,1,0,1,0
2502,24,0,0,63,63,0,1,0,1,0
2276,183,8806,121,293,223,70,4,0,3,1
10396,183,20327,121,293,223,70,4,0,3,1
1854,183,7114,121,293,223,70,4,0,3,1
1145,183,4261,121,293,223,70,4,1,3,1
1686,183,6252,121,293,223,70,4,0,3,1
2230,183,9110,121,293,223,70,4,0,3,1
1732,183,6486,121,293,223,70,4,0,3,1
12231,1335,0,0,82,82,0,1,0,1,0
6402,638,0,0,146,146,0,1,0,1,0
2086,3095,0,0,155,155,0,1,0,1,0
10965,1620,0,0,66,66,0,1,0,1,0
9218,1315,0,0,120,120,0,1,0,1,0
892,3095,0,0,140,140,0,1,0,1,0
2432,166,0,0,73,73,0,1,0,1,0
2904,1515,0,0,91,91,0,1,0,1,0
2775,765,0,0,117,117,0,1,0,1,0
984,1121,0,0,144,144,0,1,0,1,0
1964,1502,0,0,90,90,0,1,0,1,0
10363,1543,0,0,71,71,0,1,0,1,0
205,2351,0,0,144,144,0,1,0,1,0
79,1447,0,0,153,153,0,1,0,1,0
2316,121,0,0,81,81,0,1,0,1,0
893,3095,0,0,141,141,0,1,0,1,0
1250,183,4269,121,293,223,70,4,1,3,1
1520,1119,0,0,125,125,0,1,0,1,0
2189,1561,0,0,82,82,0,1,0,1,0
2177,183,8850,121,293,223,70,4,0,3,1
2497,1515,0,0,91,91,0,1,0,1,0
10426,1543,0,0,70,70,0,1,0,1,0
2140,183,8662,121,293,223,70,4,0,3,1
1751,759,0,0,146,146,0,1,0,1,0
6692,739,0,0,146,146,0,1,0,1,0
1709,3095,0,0,149,149,0,1,0,1,0
17575,2911,0,0,135,135,0,1,0,1,0
1856,736,0,0,90,90,0,1,0,1,0
2033,183,7987,121,293,223,70,4,0,3,1
8127,1399,0,0,145,145,0,1,0,1,0
333,1408,0,0,143,143,0,1,0,1,0
9916,1543,0,0,92,92,0,1,0,1,0
14668,2366,0,0,110,110,0,1,0,1,0
636,2990,0,0,139,139,0,1,0,1,0
13542,531,0,0,126,126,0,1,0,1,0
20352,183,27514,121,293,223,70,4,0,3,1
1024,3095,0,0,141,141,0,1,0,1,0
1446,183,5059,121,293,223,70,4,0,3,1
1427,1176,0,0,139,139,0,1,0,1,0
4326,385,0,0,146,146,0,1,0,1,0
1848,909,0,0,78,78,0,1,0,1,0
1245,1176,0,0,144,144,0,1,0,1,0
8320,1653,0,0,146,146,0,1,0,1,0
2910,1174,0,0,147,147,0,1,0,1,0
443,1176,0,0,145,145,0,1,0,1,0
1961,183,7589,121,293,223,70,4,0,3,1
2904,1539,0,0,87,87,0,1,0,1,0
2699,183,9522,121,293,223,70,4,1,3,1
902,746,0,0,152,152,0,1,0,1,0
773,2723,0,0,143,143,0,1,0,1,0
2903,1566,0,0,83,83,0,1,0,1,0
1420,183,4926,121,293,223,70,4,0,3,1
195,951,0,0,156,156,0,1,0,1,0
7754,2361,0,0,100,100,0,1,0,1,0
17216,2232,0,0,145,145,0,1,0,1,0
7856,1923,0,0,119,119,0,1,0,1,0
2117,1452,0,0,99,99,0,1,0,1,0
936,2830,0,0,143,143,0,1,0,1,0
2992,1694,0,0,62,62,0,1,0,1,0
18213,3040,0,0,141,141,0,1,0,1,0
2243,183,9182,121,293,223,70,4,0,3,1
2047,1348,0,0,116,116,0,1,0,1,0
2247,3089,0,0,158,158,0,1,0,1,0
5151,303,0,0,146,146,0,1,0,1,0
956,3095,0,0,142,142,0,1,0,1,0
5357,282,0,0,146,146,0,1,0,1,0
455,2722,0,0,141,141,0,1,0,1,0
3964,357,0,0,136,136,0,1,0,1,0
979,3095,0,0,140,140,0,1,0,1,0
4264,183,14393,121,293,223,70,4,0,3,1
2335,269,0,0,62,62,0,1,0,1,0
10051,1434,0,0,90,90,0,1,0,1,0
9910,1597,0,0,92,92,0,1,0,1,0
663,3029,0,0,139,139,0,1,0,1,0
10442,1565,0,0,74,74,0,1,0,1,0
190,2253,0,0,145,145,0,1,0,1,0
10359,1103,0,0,145,145,0,1,0,1,0
2172,1411,0,0,62,62,0,1,0,1,0
370,2450,0,0,144,144,0,1,0,1,0
207,1097,0,0,149,149,0,1,0,1,0
14510,1543,0,0,68,68,0,1,0,1,0
2229,183,9103,121,293,223,70,4,0,3,1
1596,183,5784,121,293,223,70,4,0,3,1
1548,183,6126,121,293,223,70,4,0,3,1
10623,1576,0,0,69,69,0,1,0,1,0
8292,1481,0,0,150,150,0,1,0,1,0
1488,454,771,26,179,164,15,1,0,1,0
3639,183,12908,121,293,223,70,4,0,3,1
1514,183,5404,121,293,223,70,4,0,3,1
10329,1545,0,0,73,73,0,1,0,1,0
1075,1176,0,0,148,148,0,1,0,1,0
2074,1997,0,0,79,79,0,1,0,1,0
1879,183,7163,121,293,223,70,4,0,3,1
2866,1158,0,0,143,143,0,1,0,1,0
2058,1559,0,0,81,81,0,1,0,1,0
10960,1619,0,0,66,66,0,1,0,1,0
1512,937,0,0,142,142,0,1,0,1,0
12054,736,0,0,145,145,0,1,0,1,0
2056,1361,0,0,114,114,0,1,0,1,0
2244,1643,0,0,69,69,0,1,0,1,0
3023,1694,0,0,62,62,0,1,0,1,0
311,2414,0,0,144,144,0,1,0,1,0
2217,1531,0,0,62,62,0,1,0,1,0
3623,945,0,0,110,110,0,1,0,1,0
1790,183,6733,121,293,223,70,4,0,3,1
10279,1528,0,0,75,75,0,1,0,1,0
1804,435,0,0,132,132,0,1,0,1,0
10444,1543,0,0,70,70,0,1,0,1,0
478,1109,0,0,157,157,0,1,0,1,0
1880,3095,0,0,152,152,0,1,0,1,0
2942,1694,0,0,62,62,0,1,0,1,0
10274,1543,0,0,80,80,0,1,0,1,0
3061,183,11318,121,293,223,70,4,0,3,1
1850,183,7150,121,293,223,70,4,0,3,1
8251,1226,0,0,155,155,0,1,0,1,0
739,1169,0,0,157,157,0,1,0,1,0
8280,1404,0,0,152,152,0,1,0,1,0
2890,1196,0,0,144,144,0,1,0,1,0
3506,1066,0,0,102,102,0,1,0,1,0
10087,1439,0,0,88,88,0,1,0,1,0
2916,1694,0,0,62,62,0,1,0,1,0
8697,2354,0,0,66,66,0,1,0,1,0
1396,183,4945,121,293,223,70,4,1,3,1
4143,401,0,0,145,145,0,1,0,1,0
527,872,1092,36,188,167,21,1,0,1,0
1795,860,0,0,145,145,0,1,0,1,0
18397,3078,0,0,144,144,0,1,0,1,0
2791,69,0,0,76,76,0,1,0,1,0
3170,183,11060,121,293,223,70,4,0,3,1
1445,1166,0,0,136,136,0,1,0,1,0
15566,1108,0,0,145,145,0,1,0,1,0
8622,1676,0,0,135,135,0,1,0,1,0
2327,282,0,0,62,62,0,1,0,1,0
7833,1300,0,0,146,146,0,1,0,1,0
227,2364,0,0,144,144,0,1,0,1,0
2390,187,0,0,62,62,0,1,0,1,0
1529,590,0,0,147,147,0,1,0,1,0
1731,1176,0,0,141,141,0,1,0,1,0
1666,2606,0,0,114,114,0,1,0,1,0
11141,1611,0,0,62,62,0,1,0,1,0
10628,1455,0,0,76,76,0,1,0,1,0
1573,183,5690,121,293,223,70,4,0,3,1
242,2069,0,0,144,144,0,1,0,1,0
531,1176,0,0,142,142,0,1,0,1,0
1821,1176,0,0,142,142,0,1,0,1,0
2974,1411,0,0,108,108,0,1,0,1,0
1447,1128,0,0,139,139,0,1,0,1,0
1942,1044,0,0,111,111,0,1,0,1,0
9152,183,19398,121,293,223,70,4,0,3,1
7525,2688,0,0,82,82,0,1,0,1,0
6127,486,0,0,146,146,0,1,0,1,0
1884,3095,0,0,150,150,0,1,0,1,0
1266,183,4949,121,293,223,70,4,0,3,1
885,3095,0,0,139,139,0,1,0,1,0
6136,410,0,0,147,147,0,1,0,1,0
1514,2959,0,0,131,131,0,1,0,1,0
3021,1603,0,0,77,77,0,1,0,1,0
538,1653,0,0,152,152,0,1,0,1,0
10155,1147,0,0,145,145,0,1,0,1,0
51,1243,0,0,154,154,0,1,0,1,0
7793,2044,0,0,112,112,0,1,0,1,0
483,1176,0,0,147,147,0,1,0,1,0
60,1313,0,0,154,154,0,1,0,1,0
8259,1275,0,0,154,154,0,1,0,1,0
190,2252,0,0,145,145,0,1,0,1,0
1010,3095,0,0,140,140,0,1,0,1,0
10734,1543,0,0,63,63,0,1,0,1,0
2304,1694,0,0,62,62,0,1,0,1,0
2134,574,0,0,62,62,0,1,0,1,0
2166,183,8740,121,293,223,70,4,0,3,1
1941,1067,0,0,116,116,0,1,0,1,0
3340,909,0,0,147,147,0,1,0,1,0
8097,1870,0,0,127,127,0,1,0,1,0
2918,1673,0,0,63,63,0,1,0,1,0
4734,344,0,0,146,146,0,1,0,1,0
1454,1176,0,0,139,139,0,1,0,1,0
1976,183,7668,121,293,223,70,4,0,3,1
412,1051,0,0,151,151,0,1,0,1,0
458,1176,0,0,146,146,0,1,0,1,0
1347,3095,0,0,142,142,0,1,0,1,0
709,531,2322,78,240,194,45,2,0,2,0
1834,183,7083,121,293,223,70,4,0,3,1
7818,2270,0,0,105,105,0,1,0,1,0
3678,888,0,0,114,114,0,1,0,1,0
10091,1440,0,0,88,88,0,1,0,1,0
1065,2915,0,0,143,143,0,1,0,1,0
229,2165,0,0,144,144,0,1,0,1,0
6391,591,0,0,146,146,0,1,0,1,0
2772,1694,0,0,62,62,0,1,0,1,0
16546,1543,0,0,62,62,0,1,0,1,0
429,1176,0,0,145,145,0,1,0,1,0
2235,1176,0,0,144,144,0,1,0,1,0
6360,183,17555,121,293,223,70,4,0,3,1
264,1125,0,0,147,147,0,1,0,1,0
17150,2825,0,0,130,130,0,1,0,1,0
881,1176,0,0,155,155,0,1,0,1,0
4294,183,14211,121,293,223,70,4,1,3,1
1654,532,0,0,147,147,0,1,0,1,0
2388,1388,0,0,109,109,0,1,0,1,0
14685,507,0,0,145,145,0,1,0,1,0
1917,366,0,0,121,121,0,1,0,1,0
4874,183,16387,121,293,223,70,4,1,3,1
1018,3095,0,0,139,139,0,1,0,1,0
10558,1507,0,0,71,71,0,1,0,1,0
3488,816,0,0,147,147,0,1,0,1,0
1762,3095,0,0,150,150,0,1,0,1,0
630,2608,0,0,142,142,0,1,0,1,0
1356,3095,0,0,142,142,0,1,0,1,0
127,1028,0,0,157,157,0,1,0,1,0
1322,1176,0,0,150,150,0,1,0,1,0
3049,1538,0,0,72,72,0,1,0,1,0
2719,1335,0,0,121,121,0,1,0,1,0
2158,1621,0,0,72,72,0,1,0,1,0
1670,1176,0,0,146,146,0,1,0,1,0
2316,122,0,0,81,81,0,1,0,1,0
2733,1694,0,0,62,62,0,1,0,1,0
458,1176,0,0,146,146,0,1,0,1,0
1050,3095,0,0,141,141,0,1,0,1,0
906,903,0,0,145,145,0,1,0,1,0
409,1176,0,0,144,144,0,1,0,1,0
2448,1011,0,0,106,106,0,1,0,1,0
2490,35,0,0,62,62,0,1,0,1,0
9141,1543,0,0,118,118,0,1,0,1,0
1913,3095,0,0,154,154,0,1,0,1,0
1830,183,6973,121,293,223,70,4,0,3,1
1492,183,5270,121,293,223,70,4,0,3,1
260,1058,0,0,157,157,0,1,0,1,0
2122,1460,0,0,98,98,0,1,0,1,0
2292,1682,0,0,63,63,0,1,0,1,0
3718,846,0,0,117,117,0,1,0,1,0
1105,183,3988,121,293,223,70,4,1,3,1
1241,3095,0,0,145,145,0,1,0,1,0
14188,310,0,0,141,141,0,1,0,1,0
1386,3095,0,0,140,140,0,1,0,1,0
5046,313,0,0,146,146,0,1,0,1,0
9374,1592,0,0,118,118,0,1,0,1,0
8268,1288,0,0,153,153,0,1,0,1,0
2962,1364,0,0,116,116,0,1,0,1,0
2859,1658,0,0,62,62,0,1,0,1,0
9373,1543,0,0,107,107,0,1,0,1,0
1435,183,5022,121,293,223,70,4,0,3,1
8693,1666,0,0,132,132,0,1,0,1,0
9927,1575,0,0,87,87,0,1,0,1,0
16645,1843,0,0,145,145,0,1,0,1,0
1956,838,0,0,62,62,0,1,0,1,0
7683,2463,0,0,94,94,0,1,0,1,0
2807,1137,0,0,138,138,0,1,0,1,0
2467,1462,0,0,98,98,0,1,0,1,0
9306,1694,0,0,120,120,0,1,0,1,0
16949,2802,0,0,131,131,0,1,0,1,0
9190,1340,0,0,118,118,0,1,0,1,0
4882,329,0,0,146,146,0,1,0,1,0
13254,799,0,0,113,113,0,1,0,1,0
2145,183,8618,121,293,223,70,4,0,3,1
1374,183,4692,121,293,223,70,4,0,3,1
587,2917,0,0,140,140,0,1,0,1,0
2998,1507,0,0,92,92,0,1,0,1,0
7402,2884,0,0,72,72,0,1,0,1,0
17208,2226,0,0,145,145,0,1,0,1,0
318,2519,0,0,143,143,0,1,0,1,0
2735,1176,0,0,147,147,0,1,0,1,0
1552,821,0,0,143,143,0,1,0,1,0
4287,183,15284,121,293,223,70,4,0,3,1
17465,801,0,0,109,109,0,1,0,1,0
1551,822,0,0,143,143,0,1,0,1,0
720,1164,0,0,157,157,0,1,0,1,0
2067,1248,0,0,131,131,0,1,0,1,0
5563,292,0,0,146,146,0,1,0,1,0
1001,1176,0,0,140,140,0,1,0,1,0
2123,1924,0,0,75,75,0,1,0,1,0
3214,1494,0,0,74,74,0,1,0,1,0
11105,1433,0,0,69,69,0,1,0,1,0
8511,1680,0,0,139,139,0,1,0,1,0
1428,183,4965,121,293,223,70,4,1,3,1
373,1176,0,0,143,143,0,1,0,1,0
1555,1176,0,0,147,147,0,1,0,1,0
1386,1176,0,0,139,139,0,1,0,1,0
1048,3095,0,0,139,139,0,1,0,1,0
8941,1694,0,0,129,129,0,1,0,1,0
976,183,3737,121,293,223,70,4,1,3,1
20478,1543,0,0,62,62,0,1,0,1,0
2597,1176,0,0,146,146,0,1,0,1,0
1386,662,0,0,146,146,0,1,0,1,0
2672,1694,0,0,62,62,0,1,0,1,0
7395,2892,0,0,71,71,0,1,0,1,0
1914,2235,0,0,93,93,0,1,0,1,0
17079,1611,0,0,62,62,0,1,0,1,0
2116,805,0,0,117,117,0,1,0,1,0
17791,1543,0,0,65,65,0,1,0,1,0
2953,1694,0,0,62,62,0,1,0,1,0
1441,183,5068,121,293,223,70,4,1,3,1
1892,381,0,0,124,124,0,1,0,1,0
4265,183,14559,121,293,223,70,4,0,3,1
8010,2101,0,0,120,120,0,1,0,1,0
1549,604,0,0,149,149,0,1,0,1,0
1982,326,0,0,115,115,0,1,0,1,0
2487,17,0,0,64,64,0,1,0,1,0
4317,183,14542,121,293,223,70,4,0,3,1
1934,2206,0,0,91,91,0,1,0,1,0
8586,1674,0,0,136,136,0,1,0,1,0
2179,1432,0,0,62,62,0,1,0,1,0
4748,183,16231,121,293,223,70,4,1,3,1
1963,183,7602,121,293,223,70,4,0,3,1
220,2231,0,0,144,144,0,1,0,1,0
2022,183,7917,121,293,223,70,4,0,3,1
480,1176,0,0,146,146,0,1,0,1,0
18729,1543,0,0,62,62,0,1,0,1,0
1246,183,5047,121,293,223,70,4,0,3,1
2142,1490,0,0,93,93,0,1,0,1,0
2230,183,9109,121,293,223,70,4,0,3,1
974,3095,0,0,140,140,0,1,0,1,0
1511,941,0,0,142,142,0,1,0,1,0
114,1050,0,0,153,153,0,1,0,1,0
7587,2600,0,0,87,87,0,1,0,1,0
3780,183,12869,121,293,223,70,4,0,3,1
10587,1543,0,0,66,66,0,1,0,1,0
1039,3095,0,0,143,143,0,1,0,1,0
1644,551,0,0,147,147,0,1,0,1,0
10566,1543,0,0,67,67,0,1,0,1,0
354,1261,0,0,143,143,0,1,0,1,0
2763,1571,0,0,62,62,0,1,0,1,0
11540,1693,0,0,62,62,0,1,0,1,0
4724,183,15703,121,293,223,70,4,0,3,1
8579,1234,0,0,143,143,0,1,0,1,0
3433,1238,0,0,91,91,0,1,0,1,0
10003,1592,0,0,89,89,0,1,0,1,0
21480,1649,0,0,67,67,0,1,0,1,0
675,1020,0,0,144,144,0,1,0,1,0
2241,1597,0,0,62,62,0,1,0,1,0
13680,480,0,0,130,130,0,1,0,1,0
8495,1219,0,0,146,146,0,1,0,1,0
8264,1271,0,0,154,154,0,1,0,1,0
8327,1675,0,0,146,146,0,1,0,1,0
2133,183,7279,121,293,223,70,4,1,3,1
1808,889,0,0,145,145,0,1,0,1,0
435,2693,0,0,142,142,0,1,0,1,0
8467,1208,0,0,148,148,0,1,0,1,0
2963,1694,0,0,62,62,0,1,0,1,0
999,3095,0,0,139,139,0,1,0,1,0
2080,1573,0,0,79,79,0,1,0,1,0
2915,1173,0,0,147,147,0,1,0,1,0
8799,1440,0,0,145,145,0,1,0,1,0
2558,2423,0,0,112,112,0,1,0,1,0
2246,3042,0,0,155,155,0,1,0,1,0
1425,2966,0,0,135,135,0,1,0,1,0
7803,1285,0,0,146,146,0,1,0,1,0
15878,183,23003,121,293,223,70,4,0,3,1
1013,1124,0,0,144,144,0,1,0,1,0
1474,1048,0,0,140,140,0,1,0,1,0
3035,1694,0,0,62,62,0,1,0,1,0
1347,3095,0,0,142,142,0,1,0,1,0
8769,1543,0,0,129,129,0,1,0,1,0
9917,1466,0,0,89,89,0,1,0,1,0
3900,558,0,0,146,146,0,1,0,1,0
10262,1633,0,0,95,95,0,1,0,1,0
1372,733,0,0,150,150,0,1,0,1,0
17389,2886,0,0,135,135,0,1,0,1,0
15695,183,24283,121,293,223,70,4,0,3,1
1439,1167,0,0,138,138,0,1,0,1,0
1954,836,0,0,63,63,0,1,0,1,0
9223,1348,0,0,145,145,0,1,0,1,0
1783,183,6821,121,293,223,70,4,0,3,1
2240,1670,0,0,65,65,0,1,0,1,0
2012,545,0,0,97,97,0,1,0,1,0
5034,183,16586,121,293,223,70,4,1,3,1
11809,1172,0,0,85,85,0,1,0,1,0
16510,1620,0,0,62,62,0,1,0,1,0
422,1893,0,0,149,149,0,1,0,1,0
7458,2784,0,0,76,76,0,1,0,1,0
1052,2906,0,0,143,143,0,1,0,1,0
1089,3095,0,0,143,143,0,1,0,1,0
802,2712,0,0,142,142,0,1,0,1,0
8327,1676,0,0,146,146,0,1,0,1,0
13024,919,0,0,106,106,0,1,0,1,0
12616,803,0,0,113,113,0,1,0,1,0
10055,1565,0,0,83,83,0,1,0,1,0
1157,183,4087,121,293,223,70,4,1,3,1
1382,3095,0,0,141,141,0,1,0,1,0
2263,2321,0,0,105,105,0,1,0,1,0
625,1472,0,0,153,153,0,1,0,1,0
11195,1622,0,0,62,62,0,1,0,1,0
4185,183,14347,121,293,223,70,4,0,3,1
2232,570,0,0,101,101,0,1,0,1,0
7990,2024,0,0,119,119,0,1,0,1,0
13703,564,0,0,126,126,0,1,0,1,0
8282,1346,0,0,151,151,0,1,0,1,0
2878,1065,0,0,139,139,0,1,0,1,0
15290,1638,0,0,62,62,0,1,0,1,0
8741,1562,0,0,135,135,0,1,0,1,0
3744,303,0,0,125,125,0,1,0,1,0
865,3095,0,0,139,139,0,1,0,1,0
4542,363,0,0,146,146,0,1,0,1,0
2247,164,0,0,88,88,0,1,0,1,0
9021,1651,0,0,122,122,0,1,0,1,0
2089,461,0,0,92,92,0,1,0,1,0
14620,183,21734,121,293,223,70,4,0,3,1
2061,3095,0,0,155,155,0,1,0,1,0
7991,1378,0,0,146,146,0,1,0,1,0
2331,183,8214,121,293,223,70,4,1,3,1
8322,1669,0,0,146,146,0,1,0,1,0
2216,183,9031,121,293,223,70,4,0,3,1
8327,1560,0,0,146,146,0,1,0,1,0
342,2554,0,0,143,143,0,1,0,1,0
8624,1675,0,0,135,135,0,1,0,1,0
2852,1694,0,0,62,62,0,1,0,1,0
9722,1543,0,0,95,95,0,1,0,1,0
8880,1652,0,0,125,125,0,1,0,1,0
1585,3095,0,0,142,142,0,1,0,1,0
1414,183,4897,121,293,223,70,4,1,3,1
2960,1694,0,0,62,62,0,1,0,1,0
1387,3095,0,0,140,140,0,1,0,1,0
1379,183,4724,121,293,223,70,4,0,3,1
2121,1458,0,0,98,98,0,1,0,1,0
287,1065,0,0,157,157,0,1,0,1,0
2794,70,0,0,76,76,0,1,0,1,0
262,1124,0,0,147,147,0,1,0,1,0
16827,1967,0,0,145,145,0,1,0,1,0
9043,183,19514,121,293,223,70,4,0,3,1
1832,1176,0,0,142,142,0,1,0,1,0
2947,1694,0,0,62,62,0,1,0,1,0
2010,979,0,0,62,62,0,1,0,1,0
9164,1643,0,0,117,117,0,1,0,1,0
101,1044,0,0,153,153,0,1,0,1,0
8327,1571,0,0,146,146,0,1,0,1,0
4088,472,0,0,141,141,0,1,0,1,0
1570,768,0,0,144,144,0,1,0,1,0
1807,183,6857,121,293,223,70,4,0,3,1
3406,1169,0,0,96,96,0,1,0,1,0
1945,183,7505,121,293,223,70,4,0,3,1
2426,2705,0,0,132,132,0,1,0,1,0
2762,1176,0,0,147,147,0,1,0,1,0
1261,1176,0,0,139,139,0,1,0,1,0
19895,1543,0,0,62,62,0,1,0,1,0
8637,1244,0,0,141,141,0,1,0,1,0
2235,1057,0,0,62,62,0,1,0,1,0
801,3095,0,0,139,139,0,1,0,1,0
1420,698,0,0,150,150,0,1,0,1,0
8327,1672,0,0,146,146,0,1,0,1,0
10685,1543,0,0,64,64,0,1,0,1,0
8320,1656,0,0,146,146,0,1,0,1,0
2422,138,0,0,62,62,0,1,0,1,0
1499,975,0,0,141,141,0,1,0,1,0
1951,922,0,0,82,82,0,1,0,1,0
9460,1609,0,0,104,104,0,1,0,1,0
1396,183,4804,121,293,223,70,4,1,3,1
10825,183,20648,121,293,223,70,4,0,3,1
8834,1566,0,0,132,132,0,1,0,1,0
695,1176,0,0,154,154,0,1,0,1,0
13560,1543,0,0,69,69,0,1,0,1,0
975,3095,0,0,139,139,0,1,0,1,0
2261,2412,0,0,111,111,0,1,0,1,0
1548,183,5565,121,293,223,70,4,0,3,1
3457,183,12583,121,293,223,70,4,0,3,1
1072,3095,0,0,141,141,0,1,0,1,0
1463,183,5128,121,293,223,70,4,0,3,1
2048,183,8062,121,293,223,70,4,0,3,1
1601,1280,0,0,123,123,0,1,0,1,0
1716,2623,0,0,113,113,0,1,0,1,0
21428,637,18957,80,215,169,46,2,0,2,0
10762,1594,0,0,68,68,0,1,0,1,0
526,1677,0,0,151,151,0,1,0,1,0
284,1765,0,0,144,144,0,1,0,1,0
1759,819,0,0,115,115,0,1,0,1,0
8248,1199,0,0,156,156,0,1,0,1,0
1657,541,0,0,147,147,0,1,0,1,0
1981,1176,0,0,143,143,0,1,0,1,0
1872,894,0,0,74,74,0,1,0,1,0
8094,1122,0,0,156,156,0,1,0,1,0
1632,1176,0,0,140,140,0,1,0,1,0
9385,1339,0,0,114,114,0,1,0,1,0
4953,183,16485,121,293,223,70,4,1,3,1
16903,183,24035,121,293,223,70,4,0,3,1
8582,1543,0,0,136,136,0,1,0,1,0
1177,3095,0,0,145,145,0,1,0,1,0
1510,1224,0,0,131,131,0,1,0,1,0
1480,183,5222,121,293,223,70,4,0,3,1
5033,183,16585,121,293,223,70,4,1,3,1
1843,723,0,0,94,94,0,1,0,1,0
20039,2344,0,0,104,104,0,1,0,1,0
849,536,2304,77,244,199,45,2,0,2,0
4151,402,0,0,146,146,0,1,0,1,0
964,183,3714,121,293,223,70,4,1,3,1
2133,183,8618,121,293,223,70,4,0,3,1
1854,183,7044,121,293,223,70,4,0,3,1
3419,1254,0,0,90,90,0,1,0,1,0
17574,1543,0,0,62,62,0,1,0,1,0
2960,1694,0,0,62,62,0,1,0,1,0
7016,898,0,0,146,146,0,1,0,1,0
2156,1176,0,0,144,144,0,1,0,1,0
1894,1086,0,0,143,143,0,1,0,1,0
693,3075,0,0,139,139,0,1,0,1,0
2336,183,9500,121,293,223,70,4,0,3,1
2048,183,8059,121,293,223,70,4,0,3,1
16872,1543,0,0,62,62,0,1,0,1,0
4096,183,14482,121,293,223,70,4,1,3,1
16663,1855,0,0,145,145,0,1,0,1,0
19074,1582,0,0,62,62,0,1,0,1,0
2609,1352,0,0,62,62,0,1,0,1,0
8545,2428,0,0,66,66,0,1,0,1,0
7804,2365,0,0,104,104,0,1,0,1,0
1654,183,6537,121,293,223,70,4,0,3,1
17433,2380,0,0,145,145,0,1,0,1,0
1338,385,1484,50,208,179,29,2,0,1,0
9896,1598,0,0,92,92,0,1,0,1,0
2857,1607,0,0,75,75,0,1,0,1,0
6247,1229,0,0,116,116,0,1,0,1,0
9061,1543,0,0,119,119,0,1,0,1,0
264,1912,0,0,144,144,0,1,0,1,0
8327,1669,0,0,146,146,0,1,0,1,0
398,2637,0,0,142,142,0,1,0,1,0
2779,1486,0,0,62,62,0,1,0,1,0
11941,1486,0,0,73,73,0,1,0,1,0
1326,1176,0,0,141,141,0,1,0,1,0
1336,207,4077,112,282,217,65,3,0,2,0
20884,183,28030,121,293,223,70,4,0,3,1
18794,2944,0,0,136,136,0,1,0,1,0
11126,1608,0,0,62,62,0,1,0,1,0
2076,183,7876,121,293,223,70,4,0,3,1
1723,989,0,0,96,96,0,1,0,1,0
10497,1694,0,0,89,89,0,1,0,1,0
7622,2551,0,0,89,89,0,1,0,1,0
2733,641,0,0,108,108,0,1,0,1,0
728,3095,0,0,139,139,0,1,0,1,0
882,3095,0,0,139,139,0,1,0,1,0
17043,2114,0,0,145,145,0,1,0,1,0
4068,496,0,0,139,139,0,1,0,1,0
2466,183,9272,121,293,223,70,4,0,3,1
2060,183,8241,121,293,223,70,4,0,3,1
10921,1694,0,0,78,78,0,1,0,1,0
1408,3095,0,0,148,148,0,1,0,1,0
11403,1694,0,0,65,65,0,1,0,1,0
9219,1639,0,0,115,115,0,1,0,1,0
947,1176,0,0,152,152,0,1,0,1,0
1469,1062,0,0,140,140,0,1,0,1,0
1462,183,5132,121,293,223,70,4,0,3,1
1507,381,1866,51,209,179,29,2,0,1,0
2911,1300,0,0,127,127,0,1,0,1,0
1676,3095,0,0,145,145,0,1,0,1,0
9915,1415,0,0,95,95,0,1,0,1,0
2114,1257,0,0,62,62,0,1,0,1,0
1154,183,4287,121,293,223,70,4,1,3,1
2023,301,0,0,110,110,0,1,0,1,0
18812,2935,0,0,136,136,0,1,0,1,0
3027,1694,0,0,62,62,0,1,0,1,0
251,2249,0,0,146,146,0,1,0,1,0
4664,183,16127,121,293,223,70,4,1,3,1
7515,2582,0,0,85,85,0,1,0,1,0
2803,1607,0,0,62,62,0,1,0,1,0
19945,2389,0,0,107,107,0,1,0,1,0
3081,183,10796,121,293,223,70,4,0,3,1
1623,183,5917,121,293,223,70,4,0,3,1
1369,3095,0,0,141,141,0,1,0,1,0
11163,1645,0,0,65,65,0,1,0,1,0
9622,1543,0,0,98,98,0,1,0,1,0
10169,1509,0,0,79,79,0,1,0,1,0
384,1087,0,0,157,157,0,1,0,1,0
2197,478,0,0,62,62,0,1,0,1,0
172,2122,0,0,147,147,0,1,0,1,0
10753,1543,0,0,63,63,0,1,0,1,0
6306,550,0,0,146,146,0,1,0,1,0
323,2525,0,0,143,143,0,1,0,1,0
8327,1623,0,0,146,146,0,1,0,1,0
1239,1176,0,0,144,144,0,1,0,1,0
1941,1055,0,0,113,113,0,1,0,1,0
1497,1133,0,0,129,129,0,1,0,1,0
7831,1971,0,0,116,116,0,1,0,1,0
2531,52,0,0,65,65,0,1,0,1,0
8255,1250,0,0,155,155,0,1,0,1,0
14509,2335,0,0,109,109,0,1,0,1,0
10545,1543,0,0,67,67,0,1,0,1,0
1847,910,0,0,78,78,0,1,0,1,0
8657,1543,0,0,133,133,0,1,0,1,0
2022,183,7694,121,293,223,70,4,0,3,1
1272,3095,0,0,139,139,0,1,0,1,0
1259,816,0,0,151,151,0,1,0,1,0
8739,2334,0,0,66,66,0,1,0,1,0
930,183,3676,121,293,223,70,4,1,3,1
7804,1407,0,0,146,146,0,1,0,1,0
9043,2185,0,0,67,67,0,1,0,1,0
10280,1529,0,0,75,75,0,1,0,1,0
598,1176,0,0,151,151,0,1,0,1,0
2101,1223,0,0,62,62,0,1,0,1,0
10690,1543,0,0,64,64,0,1,0,1,0
12496,1196,0,0,90,90,0,1,0,1,0
1735,1176,0,0,141,141,0,1,0,1,0
11284,1640,0,0,62,62,0,1,0,1,0
1913,183,7387,121,293,223,70,4,0,3,1
1445,318,2670,73,236,193,42,2,0,2,0
642,2615,0,0,142,142,0,1,0,1,0
1784,1176,0,0,141,141,0,1,0,1,0
14769,330,0,0,139,139,0,1,0,1,0
2009,183,7851,121,293,223,70,4,0,3,1
2449,70,0,0,66,66,0,1,0,1,0
18514,1543,0,0,64,64,0,1,0,1,0
13702,183,22918,121,293,223,70,4,0,3,1
9112,1579,0,0,125,125,0,1,0,1,0
720,1176,0,0,155,155,0,1,0,1,0
1774,810,0,0,145,145,0,1,0,1,0
1420,183,5515,121,293,223,70,4,0,3,1
7859,1437,0,0,146,146,0,1,0,1,0
7956,1729,0,0,128,128,0,1,0,1,0
2042,183,8053,121,293,223,70,4,0,3,1
2086,3095,0,0,156,156,0,1,0,1,0
10708,1587,0,0,69,69,0,1,0,1,0
767,3095,0,0,139,139,0,1,0,1,0
4032,374,0,0,140,140,0,1,0,1,0
1698,576,0,0,134,134,0,1,0,1,0
1615,1176,0,0,140,140,0,1,0,1,0
1858,183,7061,121,293,223,70,4,0,3,1
127,1057,0,0,152,152,0,1,0,1,0
10476,1565,0,0,73,73,0,1,0,1,0
1965,336,0,0,116,116,0,1,0,1,0
1126,1176,0,0,152,152,0,1,0,1,0
4943,183,16473,121,293,223,70,4,1,3,1
1485,359,2149,59,219,184,34,2,0,1,0
2146,3095,0,0,156,156,0,1,0,1,0
46,1017,0,0,155,155,0,1,0,1,0
2823,906,0,0,128,128,0,1,0,1,0
2169,3095,0,0,157,157,0,1,0,1,0
2437,1694,0,0,62,62,0,1,0,1,0
721,2653,0,0,143,143,0,1,0,1,0
11250,1656,0,0,64,64,0,1,0,1,0
1798,3095,0,0,151,151,0,1,0,1,0
1277,1176,0,0,139,139,0,1,0,1,0
4799,338,0,0,146,146,0,1,0,1,0
830,1176,0,0,156,156,0,1,0,1,0
2304,1375,0,0,111,111,0,1,0,1,0
1985,3095,0,0,155,155,0,1,0,1,0
1642,183,6009,121,293,223,70,4,0,3,1
8159,1337,0,0,148,148,0,1,0,1,0
2953,1694,0,0,62,62,0,1,0,1,0
2172,1851,0,0,71,71,0,1,0,1,0
1706,653,0,0,147,147,0,1,0,1,0
1862,3095,0,0,149,149,0,1,0,1,0
818,784,1410,47,210,183,27,2,0,1,0
9931,1543,0,0,91,91,0,1,0,1,0
1958,2170,0,0,89,89,0,1,0,1,0
9498,1355,0,0,110,110,0,1,0,1,0
1668,546,0,0,143,143,0,1,0,1,0
8413,1543,0,0,142,142,0,1,0,1,0
930,2790,0,0,141,141,0,1,0,1,0
1585,183,5727,121,293,223,70,4,0,3,1
1289,183,4344,121,293,223,70,4,1,3,1
1781,2515,0,0,107,107,0,1,0,1,0
11492,1694,0,0,63,63,0,1,0,1,0
9599,1543,0,0,102,102,0,1,0,1,0
8435,1543,0,0,142,142,0,1,0,1,0
10002,1427,0,0,91,91,0,1,0,1,0
2483,33,0,0,64,64,0,1,0,1,0
1985,183,7849,121,293,223,70,4,0,3,1
8327,1678,0,0,146,146,0,1,0,1,0
1093,183,4354,121,293,223,70,4,0,3,1
12575,623,0,0,145,145,0,1,0,1,0
8172,1609,0,0,146,146,0,1,0,1,0
1926,3095,0,0,153,153,0,1,0,1,0
142,1904,0,0,148,148,0,1,0,1,0
8323,2536,0,0,65,65,0,1,0,1,0
20631,2058,0,0,89,89,0,1,0,1,0
2160,1176,0,0,144,144,0,1,0,1,0
2074,183,8235,121,293,223,70,4,0,3,1
1465,1153,0,0,133,133,0,1,0,1,0
10556,1694,0,0,87,87,0,1,0,1,0
1598,2819,0,0,123,123,0,1,0,1,0
9142,1644,0,0,118,118,0,1,0,1,0
14621,1543,0,0,68,68,0,1,0,1,0
1315,1176,0,0,142,142,0,1,0,1,0
2805,1694,0,0,62,62,0,1,0,1,0
4744,183,16226,121,293,223,70,4,1,3,1
317,1529,0,0,143,143,0,1,0,1,0
1366,3095,0,0,141,141,0,1,0,1,0
2166,704,0,0,110,110,0,1,0,1,0
2089,183,8294,121,293,223,70,4,0,3,1
11343,1652,0,0,62,62,0,1,0,1,0
1011,1176,0,0,150,150,0,1,0,1,0
8990,1282,0,0,129,129,0,1,0,1,0
5667,251,0,0,146,146,0,1,0,1,0
1369,183,4685,121,293,223,70,4,0,3,1
1684,183,6874,121,293,223,70,4,0,3,1
1382,3095,0,0,141,141,0,1,0,1,0
1568,1176,0,0,140,140,0,1,0,1,0
2025,183,8060,121,293,223,70,4,0,3,1
4586,618,0,0,146,146,0,1,0,1,0
16012,183,23137,121,293,223,70,4,0,3,1
7684,2520,0,0,94,94,0,1,0,1,0
2573,1453,0,0,101,101,0,1,0,1,0
1828,2438,0,0,102,102,0,1,0,1,0
290,2476,0,0,143,143,0,1,0,1,0
1383,183,4739,121,293,223,70,4,0,3,1
2332,275,0,0,62,62,0,1,0,1,0
10532,1543,0,0,68,68,0,1,0,1,0
2097,842,0,0,120,120,0,1,0,1,0
1415,3095,0,0,139,139,0,1,0,1,0
7635,2583,0,0,90,90,0,1,0,1,0
1254,3039,0,0,143,143,0,1,0,1,0
6088,442,0,0,146,146,0,1,0,1,0
22,1034,0,0,156,156,0,1,0,1,0
8409,1688,0,0,143,143,0,1,0,1,0
1457,183,5107,121,293,223,70,4,1,3,1
8811,1543,0,0,128,128,0,1,0,1,0
8223,1214,0,0,155,155,0,1,0,1,0
6086,441,0,0,146,146,0,1,0,1,0
2952,1324,0,0,123,123,0,1,0,1,0
1600,183,5619,121,293,223,70,4,1,3,1
2148,553,0,0,62,62,0,1,0,1,0
9054,1639,0,0,119,119,0,1,0,1,0
1353,183,4592,121,293,223,70,4,1,3,1
13766,531,0,0,128,128,0,1,0,1,0
16447,1708,0,0,145,145,0,1,0,1,0
1986,183,7726,121,293,223,70,4,0,3,1
1595,183,5781,121,293,223,70,4,0,3,1
10380,183,17458,121,293,223,70,4,0,3,1
1041,2899,0,0,143,143,0,1,0,1,0
17911,879,0,0,104,104,0,1,0,1,0
8267,1284,0,0,153,153,0,1,0,1,0
4688,183,16156,121,293,223,70,4,1,3,1
4079,183,14668,121,293,223,70,4,0,3,1
20546,183,27673,121,293,223,70,4,0,3,1
1638,1043,0,0,108,108,0,1,0,1,0
68,1027,0,0,154,154,0,1,0,1,0
2428,1005,0,0,104,104,0,1,0,1,0
861,926,0,0,144,144,0,1,0,1,0
2350,183,8281,121,293,223,70,4,1,3,1
2685,183,10392,121,293,223,70,4,0,3,1
1541,416,1420,39,194,172,22,1,0,1,0
1340,3095,0,0,142,142,0,1,0,1,0
2894,1694,0,0,62,62,0,1,0,1,0
4614,183,16065,121,293,223,70,4,1,3,1
2788,1493,0,0,62,62,0,1,0,1,0
27,1007,0,0,156,156,0,1,0,1,0
754,3095,0,0,139,139,0,1,0,1,0
2201,183,8949,121,293,223,70,4,0,3,1
3587,754,0,0,146,146,0,1,0,1,0
1174,183,4121,121,293,223,70,4,1,3,1
7584,2448,0,0,92,92,0,1,0,1,0
5133,304,0,0,146,146,0,1,0,1,0
1516,183,6001,121,293,223,70,4,0,3,1
8327,1620,0,0,146,146,0,1,0,1,0
2179,3095,0,0,157,157,0,1,0,1,0
950,3095,0,0,139,139,0,1,0,1,0
574,2898,0,0,140,140,0,1,0,1,0
14690,2329,0,0,99,99,0,1,0,1,0
8279,1667,0,0,146,146,0,1,0,1,0
4334,183,15386,121,293,223,70,4,0,3,1
715,2812,0,0,141,141,0,1,0,1,0
8033,2072,0,0,122,122,0,1,0,1,0
966,1176,0,0,140,140,0,1,0,1,0
1611,183,5932,121,293,223,70,4,0,3,1
1936,183,7460,121,293,223,70,4,0,3,1
10380,1545,0,0,71,71,0,1,0,1,0
1312,777,0,0,151,151,0,1,0,1,0
1682,183,6201,121,293,223,70,4,0,3,1
10470,1556,0,0,71,71,0,1,0,1,0
1711,183,6376,121,293,223,70,4,0,3,1
1255,3039,0,0,143,143,0,1,0,1,0
8310,1534,0,0,146,146,0,1,0,1,0
2017,183,7890,121,293,223,70,4,0,3,1
8326,1543,0,0,145,145,0,1,0,1,0
1558,556,0,0,148,148,0,1,0,1,0
1393,3095,0,0,140,140,0,1,0,1,0
3270,953,0,0,147,147,0,1,0,1,0
538,851,1168,39,191,169,22,1,0,1,0
18982,183,26737,121,293,223,70,4,0,3,1
1902,1464,0,0,96,96,0,1,0,1,0
8912,2249,0,0,67,67,0,1,0,1,0
1802,3095,0,0,148,148,0,1,0,1,0
2181,1437,0,0,62,62,0,1,0,1,0
2340,183,7943,121,293,223,70,4,1,3,1
3050,1091,0,0,147,147,0,1,0,1,0
1947,1197,0,0,139,139,0,1,0,1,0
8262,1295,0,0,154,154,0,1,0,1,0
2905,1687,0,0,62,62,0,1,0,1,0
1385,257,3443,94,261,206,54,3,0,2,0
2248,2952,0,0,149,149,0,1,0,1,0
1767,961,0,0,89,89,0,1,0,1,0
4070,183,11094,121,293,223,70,4,0,3,1
5713,284,0,0,144,144,0,1,0,1,0
507,910,956,32,183,164,18,1,0,1,0
1877,2356,0,0,98,98,0,1,0,1,0
2976,183,11398,121,293,223,70,4,0,3,1
2837,1694,0,0,62,62,0,1,0,1,0
3974,605,0,0,132,132,0,1,0,1,0
2924,1694,0,0,62,62,0,1,0,1,0
2162,531,0,0,62,62,0,1,0,1,0
24,1050,0,0,156,156,0,1,0,1,0
1272,1176,0,0,143,143,0,1,0,1,0
1876,183,7150,121,293,223,70,4,0,3,1
1423,183,4940,121,293,223,70,4,1,3,1
1795,183,6757,121,293,223,70,4,0,3,1
8675,1467,0,0,145,145,0,1,0,1,0
2208,1589,0,0,78,78,0,1,0,1,0
18506,3083,0,0,144,144,0,1,0,1,0
10918,1614,0,0,67,67,0,1,0,1,0
14961,1643,0,0,62,62,0,1,0,1,0
215,1048,0,0,157,157,0,1,0,1,0
3189,1524,0,0,73,73,0,1,0,1,0
7689,2514,0,0,95,95,0,1,0,1,0
4689,349,0,0,146,146,0,1,0,1,0
10597,1694,0,0,86,86,0,1,0,1,0
793,978,710,24,184,170,13,1,0,1,0
1433,1168,0,0,139,139,0,1,0,1,0
8298,1517,0,0,149,149,0,1,0,1,0
2257,183,9264,121,293,223,70,4,0,3,1
19438,1543,0,0,62,62,0,1,0,1,0
1449,1176,0,0,148,148,0,1,0,1,0
472,1176,0,0,142,142,0,1,0,1,0
2113,183,8517,121,293,223,70,4,0,3,1
12024,997,0,0,102,102,0,1,0,1,0
8895,1289,0,0,130,130,0,1,0,1,0
9336,1332,0,0,116,116,0,1,0,1,0
1662,1176,0,0,140,140,0,1,0,1,0
21049,183,28217,121,293,223,70,4,0,3,1
2150,3095,0,0,157,157,0,1,0,1,0
584,2599,0,0,144,144,0,1,0,1,0
8065,183,14466,121,293,223,70,4,0,3,1
1856,3095,0,0,149,149,0,1,0,1,0
14025,396,0,0,136,136,0,1,0,1,0
4322,183,15349,121,293,223,70,4,0,3,1
16155,1509,0,0,145,145,0,1,0,1,0
2293,183,9372,121,293,223,70,4,0,3,1
1706,183,6421,121,293,223,70,4,0,3,1
7565,929,0,0,154,154,0,1,0,1,0
2219,596,0,0,103,103,0,1,0,1,0
2207,1650,0,0,68,68,0,1,0,1,0
11328,1666,0,0,63,63,0,1,0,1,0
2980,1438,0,0,104,104,0,1,0,1,0
1970,3095,0,0,152,152,0,1,0,1,0
2147,183,8643,121,293,223,70,4,0,3,1
10210,1543,0,0,77,77,0,1,0,1,0
1882,1059,0,0,143,143,0,1,0,1,0
38,1012,0,0,156,156,0,1,0,1,0
21579,1601,0,0,65,65,0,1,0,1,0
1939,1179,0,0,142,142,0,1,0,1,0
13864,480,0,0,131,131,0,1,0,1,0
1366,3095,0,0,147,147,0,1,0,1,0
2310,1667,0,0,66,66,0,1,0,1,0
951,3095,0,0,140,140,0,1,0,1,0
11365,1694,0,0,66,66,0,1,0,1,0
2909,1371,0,0,115,115,0,1,0,1,0
791,988,675,22,182,169,13,1,0,1,0
1524,183,5445,121,293,223,70,4,0,3,1
1523,906,0,0,142,142,0,1,0,1,0
2931,1694,0,0,62,62,0,1,0,1,0
1522,183,5424,121,293,223,70,4,0,3,1
4554,183,15990,121,293,223,70,4,1,3,1
1632,183,6019,121,293,223,70,4,0,3,1
7610,2399,0,0,94,94,0,1,0,1,0
1632,2762,0,0,120,120,0,1,0,1,0
624,1142,0,0,157,157,0,1,0,1,0
1884,183,6479,121,293,223,70,4,1,3,1
324,1155,0,0,144,144,0,1,0,1,0
1808,183,6862,121,293,223,70,4,0,3,1
18481,3094,0,0,145,145,0,1,0,1,0
2399,1240,0,0,62,62,0,1,0,1,0
9283,1356,0,0,115,115,0,1,0,1,0
1235,1176,0,0,144,144,0,1,0,1,0
1352,3095,0,0,143,143,0,1,0,1,0
2998,1694,0,0,62,62,0,1,0,1,0
1373,3095,0,0,141,141,0,1,0,1,0
1899,1099,0,0,143,143,0,1,0,1,0
15648,1543,0,0,62,62,0,1,0,1,0
8272,1357,0,0,153,153,0,1,0,1,0
2575,1176,0,0,146,146,0,1,0,1,0
2046,183,8075,121,293,223,70,4,0,3,1
1817,910,0,0,145,145,0,1,0,1,0
20698,1557,0,0,62,62,0,1,0,1,0
6097,447,0,0,146,146,0,1,0,1,0
14071,299,0,0,145,145,0,1,0,1,0
1467,183,5157,121,293,223,70,4,0,3,1
2646,1394,0,0,111,111,0,1,0,1,0
2192,1465,0,0,62,62,0,1,0,1,0
10586,1543,0,0,66,66,0,1,0,1,0
7407,2858,0,0,72,72,0,1,0,1,0
261,1929,0,0,144,144,0,1,0,1,0
19858,183,27016,121,293,223,70,4,0,3,1
8295,1407,0,0,150,150,0,1,0,1,0
247,1055,0,0,157,157,0,1,0,1,0
48,1009,0,0,157,157,0,1,0,1,0
1484,358,2165,59,219,185,34,2,0,1,0
244,1115,0,0,147,147,0,1,0,1,0
197,2303,0,0,145,145,0,1,0,1,0
17521,183,25708,121,293,223,70,4,0,3,1
835,939,0,0,144,144,0,1,0,1,0
2906,1460,0,0,100,100,0,1,0,1,0
4620,183,16072,121,293,223,70,4,1,3,1
2253,1657,0,0,67,67,0,1,0,1,0
1940,1071,0,0,117,117,0,1,0,1,0
15896,1333,0,0,145,145,0,1,0,1,0
9266,1636,0,0,114,114,0,1,0,1,0
8358,1543,0,0,144,144,0,1,0,1,0
949,183,3685,121,293,223,70,4,1,3,1
2481,1529,0,0,89,89,0,1,0,1,0
2196,3095,0,0,158,158,0,1,0,1,0
2852,1651,0,0,62,62,0,1,0,1,0
1072,3095,0,0,143,143,0,1,0,1,0
1437,1176,0,0,139,139,0,1,0,1,0
1872,3095,0,0,152,152,0,1,0,1,0
7838,2773,0,0,63,63,0,1,0,1,0
1165,3095,0,0,139,139,0,1,0,1,0
773,2723,0,0,143,143,0,1,0,1,0
7148,2827,0,0,68,68,0,1,0,1,0
1051,183,4006,121,293,223,70,4,1,3,1
715,3095,0,0,139,139,0,1,0,1,0
8245,1194,0,0,156,156,0,1,0,1,0
1937,1121,0,0,129,129,0,1,0,1,0
991,3095,0,0,140,140,0,1,0,1,0
2002,2149,0,0,87,87,0,1,0,1,0
1598,183,5810,121,293,223,70,4,0,3,1
1946,183,7551,121,293,223,70,4,0,3,1
165,2070,0,0,147,147,0,1,0,1,0
7675,2474,0,0,94,94,0,1,0,1,0
1584,3095,0,0,142,142,0,1,0,1,0
1207,183,4431,121,293,223,70,4,1,3,1
1188,1176,0,0,151,151,0,1,0,1,0
730,1252,0,0,156,156,0,1,0,1,0
4538,183,15971,121,293,223,70,4,1,3,1
2880,1694,0,0,62,62,0,1,0,1,0
2350,2868,0,0,143,143,0,1,0,1,0
13226,814,0,0,112,112,0,1,0,1,0
11208,1651,0,0,64,64,0,1,0,1,0
1159,183,4299,121,293,223,70,4,1,3,1
5655,261,0,0,146,146,0,1,0,1,0
1689,183,5854,121,293,223,70,4,1,3,1
2977,1694,0,0,62,62,0,1,0,1,0
16528,1619,0,0,62,62,0,1,0,1,0
2269,2041,0,0,86,86,0,1,0,1,0
1532,183,5472,121,293,223,70,4,0,3,1
8927,1294,0,0,129,129,0,1,0,1,0
2754,183,10125,121,293,223,70,4,0,3,1
2257,388,0,0,62,62,0,1,0,1,0
1494,369,2028,55,215,182,32,2,0,1,0
10346,1544,0,0,72,72,0,1,0,1,0
3224,1482,0,0,75,75,0,1,0,1,0
2428,53,0,0,70,70,0,1,0,1,0
2970,1659,0,0,67,67,0,1,0,1,0
1276,183,4619,121,293,223,70,4,1,3,1
889,226,3424,115,287,220,66,3,0,2,0
10305,1543,0,0,74,74,0,1,0,1,0
1918,183,7359,121,293,223,70,4,0,3,1
2019,183,7924,121,293,223,70,4,0,3,1
2346,253,0,0,62,62,0,1,0,1,0
577,1176,0,0,150,150,0,1,0,1,0
843,280,3228,109,278,215,63,3,0,2,0
8558,1230,0,0,144,144,0,1,0,1,0
725,501,2431,82,244,197,47,3,0,2,0
3100,183,10944,121,293,223,70,4,1,3,1
15175,841,0,0,145,145,0,1,0,1,0
10214,1631,0,0,96,96,0,1,0,1,0
1497,3095,0,0,140,140,0,1,0,1,0
1883,183,7334,121,293,223,70,4,0,3,1
3487,183,12181,121,293,223,70,4,0,3,1
4424,375,0,0,146,146,0,1,0,1,0
7285,3033,0,0,62,62,0,1,0,1,0
1650,528,5,0,148,148,0,1,0,1,0
8065,1916,0,0,125,125,0,1,0,1,0
252,1119,0,0,147,147,0,1,0,1,0
773,1095,0,0,147,147,0,1,0,1,0
597,740,1568,53,208,178,30,2,0,1,0
1936,1133,0,0,132,132,0,1,0,1,0
1590,710,0,0,145,145,0,1,0,1,0
1508,949,0,0,142,142,0,1,0,1,0
98,1021,0,0,157,157,0,1,0,1,0
9049,1576,0,0,127,127,0,1,0,1,0
262,1124,0,0,147,147,0,1,0,1,0
2178,183,8808,121,293,223,70,4,0,3,1
298,2489,0,0,143,143,0,1,0,1,0
4459,183,15787,121,293,223,70,4,0,3,1
8309,1468,0,0,148,148,0,1,0,1,0
1611,183,5931,121,293,223,70,4,0,3,1
8492,1211,0,0,147,147,0,1,0,1,0
20568,183,27921,121,293,223,70,4,0,3,1
2789,1493,0,0,62,62,0,1,0,1,0
20097,2316,0,0,103,103,0,1,0,1,0
17520,183,25646,121,293,223,70,4,0,3,1
2964,1694,0,0,62,62,0,1,0,1,0
2037,1547,0,0,83,83,0,1,0,1,0
10491,1543,0,0,69,69,0,1,0,1,0
2711,1432,0,0,62,62,0,1,0,1,0
2966,1378,0,0,114,114,0,1,0,1,0
2342,346,0,0,85,85,0,1,0,1,0
2221,1778,0,0,66,66,0,1,0,1,0
1060,183,3900,121,293,223,70,4,1,3,1
8952,1543,0,0,123,123,0,1,0,1,0
1572,183,5668,121,293,223,70,4,0,3,1
2245,1607,0,0,62,62,0,1,0,1,0
1207,183,4430,121,293,223,70,4,1,3,1
2070,183,8181,121,293,223,70,4,0,3,1
1398,183,4817,121,293,223,70,4,1,3,1
9000,1574,0,0,128,128,0,1,0,1,0
380,2610,0,0,142,142,0,1,0,1,0
1504,183,5350,121,293,223,70,4,0,3,1
1390,183,4777,121,293,223,70,4,1,3,1
21338,338,25209,107,266,204,62,3,0,2,0
8302,1725,0,0,144,144,0,1,0,1,0
1031,183,4149,121,293,223,70,4,0,3,1
18186,183,25330,121,293,223,70,4,0,3,1
20049,2339,0,0,104,104,0,1,0,1,0
1300,3095,0,0,142,142,0,1,0,1,0
802,1176,0,0,156,156,0,1,0,1,0
327,2531,0,0,143,143,0,1,0,1,0
1405,183,4846,121,293,223,70,4,0,3,1
2784,183,10828,121,293,223,70,4,0,3,1
1375,183,4704,121,293,223,70,4,1,3,1
9989,1724,0,0,70,70,0,1,0,1,0
1947,979,0,0,95,95,0,1,0,1,0
7651,2562,0,0,92,92,0,1,0,1,0
4309,183,14437,121,293,223,70,4,0,3,1
1990,183,7744,121,293,223,70,4,0,3,1
7788,1278,0,0,146,146,0,1,0,1,0
96,1568,0,0,151,151,0,1,0,1,0
10667,1652,0,0,84,84,0,1,0,1,0
11247,1632,0,0,62,62,0,1,0,1,0
5314,183,11555,121,293,223,70,4,0,3,1
535,1176,0,0,148,148,0,1,0,1,0
7550,2515,0,0,89,89,0,1,0,1,0
1664,2609,0,0,114,114,0,1,0,1,0
4725,345,0,0,146,146,0,1,0,1,0
2848,979,0,0,133,133,0,1,0,1,0
1727,183,6460,121,293,223,70,4,0,3,1
1210,852,0,0,152,152,0,1,0,1,0
11353,1694,0,0,67,67,0,1,0,1,0
16606,1543,0,0,66,66,0,1,0,1,0
629,2979,0,0,139,139,0,1,0,1,0
10012,1568,0,0,84,84,0,1,0,1,0
1762,2547,0,0,108,108,0,1,0,1,0
723,3095,0,0,139,139,0,1,0,1,0
3955,183,13512,121,293,223,70,4,0,3,1
918,1066,0,0,155,155,0,1,0,1,0
2071,183,8218,121,293,223,70,4,0,3,1
9595,1694,0,0,112,112,0,1,0,1,0
1923,183,7389,121,293,223,70,4,0,3,1
823,3095,0,0,139,139,0,1,0,1,0
13886,2216,0,0,103,103,0,1,0,1,0
33,1006,0,0,157,157,0,1,0,1,0
2654,1388,0,0,112,112,0,1,0,1,0
1014,3095,0,0,140,140,0,1,0,1,0
1791,3095,0,0,147,147,0,1,0,1,0
2023,740,0,0,62,62,0,1,0,1,0
6452,665,0,0,146,146,0,1,0,1,0
1059,3095,0,0,141,141,0,1,0,1,0
10905,1612,0,0,67,67,0,1,0,1,0
1790,2501,0,0,106,106,0,1,0,1,0
95,1041,0,0,153,153,0,1,0,1,0
3705,859,0,0,116,116,0,1,0,1,0
1914,183,7482,121,293,223,70,4,0,3,1
1722,3095,0,0,149,149,0,1,0,1,0
2913,1240,0,0,137,137,0,1,0,1,0
255,934,0,0,155,155,0,1,0,1,0
2931,1238,0,0,137,137,0,1,0,1,0
2592,1694,0,0,62,62,0,1,0,1,0
1882,183,7699,121,293,223,70,4,0,3,1
2036,1331,0,0,118,118,0,1,0,1,0
8201,1721,0,0,136,136,0,1,0,1,0
1365,3095,0,0,141,141,0,1,0,1,0
1422,3095,0,0,148,148,0,1,0,1,0
7517,2701,0,0,81,81,0,1,0,1,0
2167,183,8758,121,293,223,70,4,0,3,1
4591,183,16036,121,293,223,70,4,1,3,1
1951,3095,0,0,151,151,0,1,0,1,0
2320,1694,0,0,62,62,0,1,0,1,0
2041,183,8020,121,293,223,70,4,0,3,1
20703,1368,0,0,73,73,0,1,0,1,0
2413,62,0,0,71,71,0,1,0,1,0
13291,780,0,0,114,114,0,1,0,1,0
3151,183,11606,121,293,223,70,4,0,3,1
5398,278,0,0,146,146,0,1,0,1,0
11063,1632,0,0,66,66,0,1,0,1,0
122,1027,0,0,157,157,0,1,0,1,0
2031,729,0,0,62,62,0,1,0,1,0
4655,183,15507,121,293,223,70,4,0,3,1
8254,1227,0,0,155,155,0,1,0,1,0
6222,508,0,0,146,146,0,1,0,1,0
2143,183,8602,121,293,223,70,4,0,3,1
1898,1096,0,0,143,143,0,1,0,1,0
718,2725,0,0,142,142,0,1,0,1,0
1084,3095,0,0,139,139,0,1,0,1,0
7970,2152,0,0,117,117,0,1,0,1,0
8523,1543,0,0,138,138,0,1,0,1,0
1689,614,0,0,147,147,0,1,0,1,0
2817,1588,0,0,78,78,0,1,0,1,0
1504,3095,0,0,145,145,0,1,0,1,0
1410,1176,0,0,139,139,0,1,0,1,0
9668,1880,0,0,69,69,0,1,0,1,0
1608,1062,0,0,113,113,0,1,0,1,0
638,1176,0,0,152,152,0,1,0,1,0
10161,1450,0,0,85,85,0,1,0,1,0
17503,2897,0,0,133,133,0,1,0,1,0
10114,1663,0,0,71,71,0,1,0,1,0
13174,667,0,0,118,118,0,1,0,1,0
15810,2555,0,0,113,113,0,1,0,1,0
1324,183,4748,121,293,223,70,4,1,3,1
4902,183,16422,121,293,223,70,4,1,3,1
960,1176,0,0,151,151,0,1,0,1,0
10526,1564,0,0,70,70,0,1,0,1,0
1496,183,5303,121,293,223,70,4,0,3,1
238,2101,0,0,144,144,0,1,0,1,0
6447,1584,0,0,105,105,0,1,0,1,0
1516,183,5401,121,293,223,70,4,0,3,1
1497,183,5240,121,293,223,70,4,1,3,1
7941,1758,0,0,127,127,0,1,0,1,0
2280,1691,0,0,62,62,0,1,0,1,0
11759,1737,0,0,64,64,0,1,0,1,0
2009,183,7867,121,293,223,70,4,0,3,1
1969,183,7633,121,293,223,70,4,0,3,1
1439,3095,0,0,139,139,0,1,0,1,0
467,872,0,0,154,154,0,1,0,1,0
121,1054,0,0,152,152,0,1,0,1,0
8301,1432,0,0,149,149,0,1,0,1,0
1294,1176,0,0,150,150,0,1,0,1,0
856,1176,0,0,154,154,0,1,0,1,0
1576,1083,0,0,117,117,0,1,0,1,0
362,1082,0,0,157,157,0,1,0,1,0
16457,1715,0,0,145,145,0,1,0,1,0
2526,1494,0,0,93,93,0,1,0,1,0
1971,183,7641,121,293,223,70,4,0,3,1
4664,183,16126,121,293,223,70,4,1,3,1
1428,3095,0,0,139,139,0,1,0,1,0
11454,1675,0,0,62,62,0,1,0,1,0
11433,1670,0,0,62,62,0,1,0,1,0
3024,1694,0,0,62,62,0,1,0,1,0
2764,1298,0,0,127,127,0,1,0,1,0
1116,183,4009,121,293,223,70,4,1,3,1
17854,2968,0,0,137,137,0,1,0,1,0
12513,1187,0,0,91,91,0,1,0,1,0
2225,1614,0,0,74,74,0,1,0,1,0
11331,1666,0,0,63,63,0,1,0,1,0
8260,1284,0,0,154,154,0,1,0,1,0
161,2043,0,0,147,147,0,1,0,1,0
1390,183,4929,121,293,223,70,4,1,3,1
1537,183,5491,121,293,223,70,4,0,3,1
1827,707,0,0,98,98,0,1,0,1,0
1478,1204,0,0,134,134,0,1,0,1,0
19594,183,27222,121,293,223,70,4,0,3,1
1987,183,7872,121,293,223,70,4,0,3,1
834,1127,0,0,156,156,0,1,0,1,0
10546,1543,0,0,67,67,0,1,0,1,0
537,1176,0,0,142,142,0,1,0,1,0
3021,1683,0,0,63,63,0,1,0,1,0
1965,859,0,0,62,62,0,1,0,1,0
11141,1611,0,0,62,62,0,1,0,1,0
1987,863,0,0,62,62,0,1,0,1,0
1294,1176,0,0,142,142,0,1,0,1,0
8681,1559,0,0,136,136,0,1,0,1,0
7591,2595,0,0,87,87,0,1,0,1,0
993,1011,0,0,154,154,0,1,0,1,0
1413,3095,0,0,144,144,0,1,0,1,0
3525,183,12288,121,293,223,70,4,0,3,1
2912,1277,0,0,131,131,0,1,0,1,0
2750,1463,0,0,62,62,0,1,0,1,0
11232,1629,0,0,62,62,0,1,0,1,0
575,783,1415,47,202,174,27,2,0,1,0
1336,3095,0,0,139,139,0,1,0,1,0
1355,183,4605,121,293,223,70,4,1,3,1
8262,1297,0,0,154,154,0,1,0,1,0
1401,3095,0,0,140,140,0,1,0,1,0
1784,664,0,0,110,110,0,1,0,1,0
10378,1543,0,0,71,71,0,1,0,1,0
2088,183,8289,121,293,223,70,4,0,3,1
18473,3089,0,0,145,145,0,1,0,1,0
2120,183,8694,121,293,223,70,4,0,3,1
6604,1862,0,0,97,97,0,1,0,1,0
11373,1672,0,0,63,63,0,1,0,1,0
3874,183,13147,121,293,223,70,4,0,3,1
1457,671,0,0,149,149,0,1,0,1,0
1408,3095,0,0,140,140,0,1,0,1,0
10706,1654,0,0,83,83,0,1,0,1,0
1791,443,0,0,134,134,0,1,0,1,0
1934,183,7442,121,293,223,70,4,0,3,1
1938,1176,0,0,143,143,0,1,0,1,0
13018,922,0,0,106,106,0,1,0,1,0
779,1087,320,10,169,162,6,1,0,1,0
1916,3095,0,0,154,154,0,1,0,1,0
10795,1543,0,0,62,62,0,1,0,1,0
20648,1543,0,0,62,62,0,1,0,1,0
1798,866,0,0,145,145,0,1,0,1,0
2509,1444,0,0,100,100,0,1,0,1,0
1294,183,4354,121,293,223,70,4,1,3,1
7591,2594,0,0,87,87,0,1,0,1,0
570,1176,0,0,150,150,0,1,0,1,0
3064,1126,0,0,147,147,0,1,0,1,0
15619,1144,0,0,145,145,0,1,0,1,0
1425,183,4949,121,293,223,70,4,1,3,1
9938,1543,0,0,91,91,0,1,0,1,0
2720,1334,0,0,121,121,0,1,0,1,0
1689,615,0,0,147,147,0,1,0,1,0
13193,183,22546,121,293,223,70,4,0,3,1
2268,2088,0,0,89,89,0,1,0,1,0
4778,183,15765,121,293,223,70,4,1,3,1
3008,1694,0,0,62,62,0,1,0,1,0
11001,1581,0,0,64,64,0,1,0,1,0
1990,183,7773,121,293,223,70,4,0,3,1
1515,389,1767,48,206,178,28,2,0,1,0
7534,2676,0,0,82,82,0,1,0,1,0
1610,650,0,0,146,146,0,1,0,1,0
1943,183,7632,121,293,223,70,4,0,3,1
2184,183,8853,121,293,223,70,4,0,3,1
6732,2089,0,0,90,90,0,1,0,1,0
1343,183,4545,121,293,223,70,4,1,3,1
1521,1118,0,0,125,125,0,1,0,1,0
2034,909,0,0,62,62,0,1,0,1,0
13584,183,22707,121,293,223,70,4,0,3,1
1482,356,2185,60,220,185,34,2,0,1,0
1802,436,0,0,132,132,0,1,0,1,0
750,1715,0,0,151,151,0,1,0,1,0
1512,183,5394,121,293,223,70,4,0,3,1
2093,634,0,0,62,62,0,1,0,1,0
1385,183,4751,121,293,223,70,4,1,3,1
2462,1544,0,0,86,86,0,1,0,1,0
7786,2388,0,0,102,102,0,1,0,1,0
1584,183,5747,121,293,223,70,4,0,3,1
2125,3095,0,0,156,156,0,1,0,1,0
1524,183,5433,121,293,223,70,4,0,3,1
2570,1517,0,0,89,89,0,1,0,1,0
2833,1835,0,0,71,71,0,1,0,1,0
1854,3095,0,0,153,153,0,1,0,1,0
10591,1543,0,0,66,66,0,1,0,1,0
5023,183,16573,121,293,223,70,4,1,3,1
1908,1468,0,0,95,95,0,1,0,1,0
10499,1694,0,0,89,89,0,1,0,1,0
1885,183,7245,121,293,223,70,4,0,3,1
1333,383,1506,50,209,179,29,2,0,1,0
2913,1262,0,0,133,133,0,1,0,1,0
2921,1671,0,0,63,63,0,1,0,1,0
5861,331,0,0,146,146,0,1,0,1,0
14561,1649,0,0,62,62,0,1,0,1,0
2085,1180,0,0,62,62,0,1,0,1,0
1747,3095,0,0,146,146,0,1,0,1,0
1012,183,3899,121,293,223,70,4,1,3,1
1756,635,0,0,118,118,0,1,0,1,0
1476,183,5235,121,293,223,70,4,0,3,1
7896,1846,0,0,122,122,0,1,0,1,0
10956,1347,0,0,83,83,0,1,0,1,0
4644,183,15558,121,293,223,70,4,0,3,1
1946,990,0,0,98,98,0,1,0,1,0
1295,1176,0,0,142,142,0,1,0,1,0
627,826,0,0,153,153,0,1,0,1,0
3869,183,12849,121,293,223,70,4,1,3,1
8327,1693,0,0,146,146,0,1,0,1,0
8490,1543,0,0,140,140,0,1,0,1,0
8284,1432,0,0,151,151,0,1,0,1,0
1937,1117,0,0,128,128,0,1,0,1,0
17634,2923,0,0,134,134,0,1,0,1,0
448,1102,0,0,157,157,0,1,0,1,0
2007,551,0,0,98,98,0,1,0,1,0
750,1731,0,0,151,151,0,1,0,1,0
8866,1543,0,0,127,127,0,1,0,1,0
1096,1176,0,0,153,153,0,1,0,1,0
1452,629,0,0,147,147,0,1,0,1,0
1247,3095,0,0,142,142,0,1,0,1,0
1321,1176,0,0,141,141,0,1,0,1,0
3640,183,12861,121,293,223,70,4,1,3,1
3760,855,0,0,116,116,0,1,0,1,0
1831,711,0,0,97,97,0,1,0,1,0
1953,904,0,0,77,77,0,1,0,1,0
5074,310,0,0,146,146,0,1,0,1,0
4811,543,0,0,146,146,0,1,0,1,0
9140,1633,0,0,116,116,0,1,0,1,0
2276,358,0,0,62,62,0,1,0,1,0
1917,183,7350,121,293,223,70,4,0,3,1
8278,1330,0,0,152,152,0,1,0,1,0
288,1737,0,0,143,143,0,1,0,1,0
2876,1061,0,0,139,139,0,1,0,1,0
2111,1176,0,0,143,143,0,1,0,1,0
12879,717,0,0,118,118,0,1,0,1,0
1743,739,0,0,146,146,0,1,0,1,0
171,2116,0,0,147,147,0,1,0,1,0
11143,1642,0,0,65,65,0,1,0,1,0
1930,183,7424,121,293,223,70,4,0,3,1
1352,1176,0,0,141,141,0,1,0,1,0
740,793,0,0,153,153,0,1,0,1,0
1808,433,0,0,132,132,0,1,0,1,0
10799,1598,0,0,68,68,0,1,0,1,0
17849,2967,0,0,137,137,0,1,0,1,0
2284,1694,0,0,62,62,0,1,0,1,0
4282,183,14603,121,293,223,70,4,0,3,1
3061,1673,0,0,63,63,0,1,0,1,0
2255,1633,0,0,62,62,0,1,0,1,0
1034,981,0,0,154,154,0,1,0,1,0
8851,1543,0,0,128,128,0,1,0,1,0
343,1338,0,0,143,143,0,1,0,1,0
5739,273,0,0,146,146,0,1,0,1,0
817,785,1407,47,210,182,27,2,0,1,0
12389,1252,0,0,87,87,0,1,0,1,0
1278,183,4322,121,293,223,70,4,1,3,1
2443,183,9343,121,293,223,70,4,0,3,1
4664,183,16048,121,293,223,70,4,0,3,1
974,3095,0,0,140,140,0,1,0,1,0
865,413,2749,92,261,207,53,3,0,2,0
2194,3095,0,0,157,157,0,1,0,1,0
775,3095,0,0,139,139,0,1,0,1,0
1018,992,0,0,154,154,0,1,0,1,0
1858,903,0,0,76,76,0,1,0,1,0
3593,183,13018,121,293,223,70,4,0,3,1
2048,3095,0,0,156,156,0,1,0,1,0
15007,183,23769,121,293,223,70,4,0,3,1
3119,183,11822,121,293,223,70,4,0,3,1
1444,1136,0,0,139,139,0,1,0,1,0
2987,1694,0,0,62,62,0,1,0,1,0
5435,274,0,0,146,146,0,1,0,1,0
2542,1176,0,0,146,146,0,1,0,1,0
4719,183,16194,121,293,223,70,4,1,3,1
1399,183,4822,121,293,223,70,4,1,3,1
1718,183,6412,121,293,223,70,4,0,3,1
9485,1607,0,0,103,103,0,1,0,1,0
2540,79,0,0,67,67,0,1,0,1,0
60,1312,0,0,154,154,0,1,0,1,0
7734,2456,0,0,98,98,0,1,0,1,0
12731,589,0,0,145,145,0,1,0,1,0
1110,281,2558,86,251,201,50,3,0,2,0
2565,152,0,0,73,73,0,1,0,1,0
8327,1642,0,0,146,146,0,1,0,1,0
3007,1694,0,0,62,62,0,1,0,1,0
4106,451,0,0,142,142,0,1,0,1,0
11663,183,21428,121,293,223,70,4,0,3,1
1952,907,0,0,78,78,0,1,0,1,0
10369,1543,0,0,76,76,0,1,0,1,0
1073,3095,0,0,139,139,0,1,0,1,0
3837,183,13798,121,293,223,70,4,0,3,1
2680,41,0,0,70,70,0,1,0,1,0
11669,1543,0,0,62,62,0,1,0,1,0
230,2154,0,0,144,144,0,1,0,1,0
1922,3095,0,0,153,153,0,1,0,1,0
1595,183,5779,121,293,223,70,4,0,3,1
2274,1685,0,0,62,62,0,1,0,1,0
3013,1114,0,0,147,147,0,1,0,1,0
1810,1176,0,0,142,142,0,1,0,1,0
1930,3095,0,0,151,151,0,1,0,1,0
1898,1097,0,0,143,143,0,1,0,1,0
1573,3095,0,0,142,142,0,1,0,1,0
7462,2806,0,0,77,77,0,1,0,1,0
1935,1144,0,0,135,135,0,1,0,1,0
4120,183,14700,121,293,223,70,4,0,3,1
10348,1543,0,0,77,77,0,1,0,1,0
1795,183,6798,121,293,223,70,4,0,3,1
4386,379,0,0,146,146,0,1,0,1,0
8630,1243,0,0,141,141,0,1,0,1,0
808,3095,0,0,139,139,0,1,0,1,0
775,1120,198,6,164,160,3,1,0,1,0
2364,92,0,0,76,76,0,1,0,1,0
701,1176,0,0,154,154,0,1,0,1,0
1464,1176,0,0,148,148,0,1,0,1,0
3442,1228,0,0,92,92,0,1,0,1,0
2661,1176,0,0,146,146,0,1,0,1,0
944,2798,0,0,141,141,0,1,0,1,0
2344,183,8762,121,293,223,70,4,0,3,1
2537,1043,0,0,114,114,0,1,0,1,0
8380,1543,0,0,144,144,0,1,0,1,0
10739,1543,0,0,63,63,0,1,0,1,0
8552,1543,0,0,137,137,0,1,0,1,0
1810,2391,0,0,102,102,0,1,0,1,0
1554,183,5599,121,293,223,70,4,0,3,1
1299,183,4363,121,293,223,70,4,1,3,1
1357,183,4611,121,293,223,70,4,1,3,1
1830,183,7029,121,293,223,70,4,0,3,1
8532,1543,0,0,139,139,0,1,0,1,0
130,1813,0,0,149,149,0,1,0,1,0
2220,1077,0,0,62,62,0,1,0,1,0
7103,1022,0,0,146,146,0,1,0,1,0
14545,412,0,0,145,145,0,1,0,1,0
1934,1156,0,0,138,138,0,1,0,1,0
6453,525,0,0,149,149,0,1,0,1,0
4747,343,0,0,146,146,0,1,0,1,0
1086,1176,0,0,140,140,0,1,0,1,0
1936,1127,0,0,131,131,0,1,0,1,0
13394,726,0,0,117,117,0,1,0,1,0
1104,183,4396,121,293,223,70,4,0,3,1
2843,1643,0,0,62,62,0,1,0,1,0
15141,2420,0,0,105,105,0,1,0,1,0
20242,1564,0,0,62,62,0,1,0,1,0
15979,1389,0,0,145,145,0,1,0,1,0
2021,3095,0,0,156,156,0,1,0,1,0
3902,557,0,0,146,146,0,1,0,1,0
10461,1564,0,0,73,73,0,1,0,1,0
1862,1176,0,0,142,142,0,1,0,1,0
305,1611,0,0,143,143,0,1,0,1,0
2904,1536,0,0,88,88,0,1,0,1,0
531,1176,0,0,148,148,0,1,0,1,0
8955,1647,0,0,123,123,0,1,0,1,0
10177,1694,0,0,97,97,0,1,0,1,0
2724,616,0,0,107,107,0,1,0,1,0
21443,686,17921,76,207,163,44,2,0,2,0
965,183,3771,121,293,223,70,4,1,3,1
2268,1355,0,0,114,114,0,1,0,1,0
8314,1487,0,0,147,147,0,1,0,1,0
2113,183,8452,121,293,223,70,4,0,3,1
1744,183,6601,121,293,223,70,4,0,3,1
1724,1176,0,0,145,145,0,1,0,1,0
1932,183,7437,121,293,223,70,4,0,3,1
1724,183,6444,121,293,223,70,4,0,3,1
9179,1309,0,0,122,122,0,1,0,1,0
1796,860,0,0,145,145,0,1,0,1,0
298,1664,0,0,143,143,0,1,0,1,0
8000,1644,0,0,133,133,0,1,0,1,0
8445,1204,0,0,149,149,0,1,0,1,0
1438,183,5005,121,293,223,70,4,0,3,1
363,2453,0,0,144,144,0,1,0,1,0
1581,183,5705,121,293,223,70,4,0,3,1
8716,1694,0,0,135,135,0,1,0,1,0
2759,1567,0,0,62,62,0,1,0,1,0
1859,183,7069,121,293,223,70,4,0,3,1
12312,1292,0,0,85,85,0,1,0,1,0
1562,574,0,0,147,147,0,1,0,1,0
1165,2933,0,0,140,140,0,1,0,1,0
1457,1097,0,0,140,140,0,1,0,1,0
733,1176,0,0,155,155,0,1,0,1,0
11105,1637,0,0,65,65,0,1,0,1,0
1959,183,7580,121,293,223,70,4,0,3,1
8298,1520,0,0,149,149,0,1,0,1,0
1941,3095,0,0,153,153,0,1,0,1,0
2641,1460,0,0,62,62,0,1,0,1,0
10951,1543,0,0,71,71,0,1,0,1,0
4000,495,0,0,146,146,0,1,0,1,0
1981,1198,0,0,139,139,0,1,0,1,0
7855,2301,0,0,108,108,0,1,0,1,0
9947,1419,0,0,93,93,0,1,0,1,0
8286,1445,0,0,151,151,0,1,0,1,0
2266,2165,0,0,94,94,0,1,0,1,0
1707,656,0,0,147,147,0,1,0,1,0
8952,1543,0,0,123,123,0,1,0,1,0
3025,1621,0,0,74,74,0,1,0,1,0
1800,3095,0,0,148,148,0,1,0,1,0
11869,776,0,0,145,145,0,1,0,1,0
9167,1694,0,0,124,124,0,1,0,1,0
10244,1632,0,0,95,95,0,1,0,1,0
8384,2507,0,0,65,65,0,1,0,1,0
2949,1694,0,0,62,62,0,1,0,1,0
1960,183,7729,121,293,223,70,4,0,3,1
7710,2205,0,0,104,104,0,1,0,1,0
2630,1694,0,0,62,62,0,1,0,1,0
2088,261,0,0,104,104,0,1,0,1,0
50,1019,0,0,155,155,0,1,0,1,0
7860,1914,0,0,119,119,0,1,0,1,0
9980,1593,0,0,90,90,0,1,0,1,0
609,2615,0,0,144,144,0,1,0,1,0
1171,1176,0,0,152,152,0,1,0,1,0
18189,1543,0,0,65,65,0,1,0,1,0
1363,3095,0,0,141,141,0,1,0,1,0
1457,183,5108,121,293,223,70,4,1,3,1
815,801,1351,45,208,181,26,2,0,1,0
2765,1176,0,0,147,147,0,1,0,1,0
7434,2842,0,0,74,74,0,1,0,1,0
1144,296,2401,81,245,198,46,3,0,2,0
8327,1606,0,0,146,146,0,1,0,1,0
884,1176,0,0,153,153,0,1,0,1,0
8871,1265,0,0,133,133,0,1,0,1,0
2119,183,8487,121,293,223,70,4,0,3,1
2133,233,0,0,99,99,0,1,0,1,0
1518,627,0,0,149,149,0,1,0,1,0
1863,1015,0,0,144,144,0,1,0,1,0
2046,183,8052,121,293,223,70,4,0,3,1
2762,727,0,0,115,115,0,1,0,1,0
6374,622,0,0,146,146,0,1,0,1,0
1439,3095,0,0,148,148,0,1,0,1,0
2452,1694,0,0,62,62,0,1,0,1,0
279,1805,0,0,144,144,0,1,0,1,0
12269,1315,0,0,83,83,0,1,0,1,0
10031,1543,0,0,88,88,0,1,0,1,0
4536,183,15968,121,293,223,70,4,1,3,1
1268,1176,0,0,150,150,0,1,0,1,0
9614,1694,0,0,112,112,0,1,0,1,0
995,183,3973,121,293,223,70,4,0,3,1
8327,1599,0,0,146,146,0,1,0,1,0
1112,3095,0,0,141,141,0,1,0,1,0
2147,183,8645,121,293,223,70,4,0,3,1
853,505,2417,81,248,201,47,3,0,2,0
809,853,1163,39,201,178,22,1,0,1,0
839,2735,0,0,141,141,0,1,0,1,0
1209,183,4890,121,293,223,70,4,0,3,1
3224,183,12134,121,293,223,70,4,0,3,1
31,1100,0,0,156,156,0,1,0,1,0
17238,1543,0,0,65,65,0,1,0,1,0
2174,1539,0,0,86,86,0,1,0,1,0
1927,1162,0,0,143,143,0,1,0,1,0
2833,1242,0,0,136,136,0,1,0,1,0
1528,619,0,0,149,149,0,1,0,1,0
7967,1708,0,0,129,129,0,1,0,1,0
10197,183,17273,121,293,223,70,4,0,3,1
1537,1108,0,0,123,123,0,1,0,1,0
2439,1176,0,0,145,145,0,1,0,1,0
722,2608,0,0,143,143,0,1,0,1,0
1981,3095,0,0,154,154,0,1,0,1,0
10893,1560,0,0,62,62,0,1,0,1,0
9485,1623,0,0,106,106,0,1,0,1,0
10940,1616,0,0,67,67,0,1,0,1,0
1953,899,0,0,76,76,0,1,0,1,0
4973,320,0,0,146,146,0,1,0,1,0
10863,1378,0,0,81,81,0,1,0,1,0
7395,2813,0,0,73,73,0,1,0,1,0
1943,849,0,0,64,64,0,1,0,1,0
1375,183,4888,121,293,223,70,4,1,3,1
8544,1680,0,0,138,138,0,1,0,1,0
1402,3095,0,0,140,140,0,1,0,1,0
224,2306,0,0,145,145,0,1,0,1,0
2558,1466,0,0,99,99,0,1,0,1,0
8406,1543,0,0,143,143,0,1,0,1,0
2458,1547,0,0,86,86,0,1,0,1,0
1487,3095,0,0,140,140,0,1,0,1,0
8738,1543,0,0,132,132,0,1,0,1,0
2961,183,10451,121,293,223,70,4,1,3,1
603,1519,0,0,153,153,0,1,0,1,0
14049,344,0,0,138,138,0,1,0,1,0
238,1053,0,0,157,157,0,1,0,1,0
470,979,709,23,172,158,13,1,0,1,0
767,1176,0,0,156,156,0,1,0,1,0
2245,3054,0,0,156,156,0,1,0,1,0
1015,994,0,0,154,154,0,1,0,1,0
8327,1590,0,0,146,146,0,1,0,1,0
7514,2584,0,0,85,85,0,1,0,1,0
2312,1161,0,0,62,62,0,1,0,1,0
9760,1438,0,0,96,96,0,1,0,1,0
12414,948,0,0,100,100,0,1,0,1,0
17824,1543,0,0,65,65,0,1,0,1,0
310,1579,0,0,143,143,0,1,0,1,0
2742,1176,0,0,147,147,0,1,0,1,0
1657,2619,0,0,115,115,0,1,0,1,0
1690,183,6239,121,293,223,70,4,0,3,1
1495,183,5286,121,293,223,70,4,0,3,1
517,1099,0,0,143,143,0,1,0,1,0
2675,1694,0,0,62,62,0,1,0,1,0
888,235,3391,114,285,219,66,3,0,2,0
2118,183,8541,121,293,223,70,4,0,3,1
6650,183,17530,121,293,223,70,4,0,3,1
10565,1557,0,0,70,70,0,1,0,1,0
9063,1649,0,0,121,121,0,1,0,1,0
47,1017,0,0,155,155,0,1,0,1,0
2049,3095,0,0,154,154,0,1,0,1,0
2682,493,0,0,98,98,0,1,0,1,0
9178,1642,0,0,117,117,0,1,0,1,0
2294,957,0,0,92,92,0,1,0,1,0
1412,183,4886,121,293,223,70,4,1,3,1
1626,183,5958,121,293,223,70,4,0,3,1
733,2248,0,0,146,146,0,1,0,1,0
1323,183,4445,121,293,223,70,4,1,3,1
5831,316,0,0,146,146,0,1,0,1,0
9731,1388,0,0,101,101,0,1,0,1,0
154,1070,0,0,151,151,0,1,0,1,0
3027,1694,0,0,62,62,0,1,0,1,0
2403,1694,0,0,62,62,0,1,0,1,0
7952,2078,0,0,116,116,0,1,0,1,0
8321,1658,0,0,146,146,0,1,0,1,0
2507,1176,0,0,145,145,0,1,0,1,0
10765,1543,0,0,62,62,0,1,0,1,0
1340,3095,0,0,142,142,0,1,0,1,0
2714,1176,0,0,146,146,0,1,0,1,0
2555,1382,0,0,62,62,0,1,0,1,0
864,419,2726,92,260,207,53,3,0,2,0
7901,2151,0,0,112,112,0,1,0,1,0
63,1025,0,0,155,155,0,1,0,1,0
8453,1686,0,0,141,141,0,1,0,1,0
1042,1176,0,0,149,149,0,1,0,1,0
1948,1198,0,0,139,139,0,1,0,1,0
1452,183,5082,121,293,223,70,4,1,3,1
21671,1444,2063,8,78,73,5,1,0,1,0
2027,1318,0,0,120,120,0,1,0,1,0
3921,183,14067,121,293,223,70,4,0,3,1
1679,2685,0,0,116,116,0,1,0,1,0
2870,183,9884,121,293,223,70,4,0,3,1
7465,2678,0,0,80,80,0,1,0,1,0
8878,1694,0,0,131,131,0,1,0,1,0
1790,848,0,0,145,145,0,1,0,1,0
1708,659,0,0,146,146,0,1,0,1,0
548,2860,0,0,140,140,0,1,0,1,0
1600,476,666,18,170,159,10,1,0,1,0
2567,183,10186,121,293,223,70,4,0,3,1
1360,3095,0,0,142,142,0,1,0,1,0
2077,474,0,0,93,93,0,1,0,1,0
1955,878,0,0,71,71,0,1,0,1,0
7122,768,0,0,152,152,0,1,0,1,0
11165,1645,0,0,65,65,0,1,0,1,0
1514,183,5387,121,293,223,70,4,0,3,1
18465,183,26351,121,293,223,70,4,0,3,1
2108,183,8404,121,293,223,70,4,0,3,1
1162,183,4623,121,293,223,70,4,0,3,1
482,1176,0,0,147,147,0,1,0,1,0
3454,183,12445,121,293,223,70,4,0,3,1
2325,183,8555,121,293,223,70,4,0,3,1
2034,183,7992,121,293,223,70,4,0,3,1
17138,2179,0,0,145,145,0,1,0,1,0
486,950,812,27,177,161,15,1,0,1,0
4012,183,14471,121,293,223,70,4,0,3,1
1953,183,7552,121,293,223,70,4,0,3,1
8943,1656,0,0,125,125,0,1,0,1,0
2985,1456,0,0,101,101,0,1,0,1,0
10364,1543,0,0,71,71,0,1,0,1,0
11456,1682,0,0,62,62,0,1,0,1,0
1602,478,636,17,169,158,10,1,0,1,0
12634,1123,0,0,94,94,0,1,0,1,0
8027,1592,0,0,135,135,0,1,0,1,0
2201,1578,0,0,80,80,0,1,0,1,0
8280,1340,0,0,152,152,0,1,0,1,0
9432,1543,0,0,105,105,0,1,0,1,0
1082,183,4089,121,293,223,70,4,1,3,1
12318,1289,0,0,85,85,0,1,0,1,0
577,1176,0,0,150,150,0,1,0,1,0
9543,1543,0,0,104,104,0,1,0,1,0
1757,183,6570,121,293,223,70,4,0,3,1
1786,1176,0,0,141,141,0,1,0,1,0
860,451,2612,88,256,205,51,3,0,2,0
10904,1612,0,0,67,67,0,1,0,1,0
9700,1610,0,0,99,99,0,1,0,1,0
2414,1400,0,0,107,107,0,1,0,1,0
1472,183,5186,121,293,223,70,4,0,3,1
1388,3095,0,0,140,140,0,1,0,1,0
330,1075,0,0,157,157,0,1,0,1,0
9123,1543,0,0,117,117,0,1,0,1,0
5856,183,17187,121,293,223,70,4,0,3,1
8472,1543,0,0,141,141,0,1,0,1,0
1554,183,5639,121,293,223,70,4,0,3,1
2752,1694,0,0,62,62,0,1,0,1,0
4278,390,0,0,146,146,0,1,0,1,0
1719,183,6419,121,293,223,70,4,0,3,1
20966,1414,0,0,70,70,0,1,0,1,0
11431,1670,0,0,62,62,0,1,0,1,0
2935,1253,0,0,135,135,0,1,0,1,0
21596,1593,0,0,64,64,0,1,0,1,0
8805,1658,0,0,128,128,0,1,0,1,0
555,2562,0,0,143,143,0,1,0,1,0
2235,183,9140,121,293,223,70,4,0,3,1
2911,1312,0,0,125,125,0,1,0,1,0
3631,727,0,0,146,146,0,1,0,1,0
2109,183,8409,121,293,223,70,4,0,3,1
4738,183,15804,121,293,223,70,4,0,3,1
10779,1543,0,0,62,62,0,1,0,1,0
535,2840,0,0,141,141,0,1,0,1,0
13182,492,0,0,145,145,0,1,0,1,0
2468,93,0,0,68,68,0,1,0,1,0
1614,637,0,0,146,146,0,1,0,1,0
1190,183,4152,121,293,223,70,4,1,3,1
2536,1694,0,0,62,62,0,1,0,1,0
1577,183,5711,121,293,223,70,4,0,3,1
1068,3095,0,0,139,139,0,1,0,1,0
1878,690,0,0,107,107,0,1,0,1,0
4628,183,15281,121,293,223,70,4,1,3,1
815,332,3042,102,270,210,59,3,0,2,0
4493,183,15896,121,293,223,70,4,0,3,1
8341,1543,0,0,145,145,0,1,0,1,0
1420,2974,0,0,136,136,0,1,0,1,0
873,350,2976,100,270,211,58,3,0,2,0
2251,1623,0,0,62,62,0,1,0,1,0
859,249,3338,112,282,217,65,3,0,2,0
1570,446,1049,28,182,165,16,1,0,1,0
8612,1481,0,0,145,145,0,1,0,1,0
20835,1960,0,0,84,84,0,1,0,1,0
788,2733,0,0,143,143,0,1,0,1,0
3828,324,0,0,129,129,0,1,0,1,0
8282,1521,0,0,146,146,0,1,0,1,0
2878,1694,0,0,62,62,0,1,0,1,0
12680,1099,0,0,96,96,0,1,0,1,0
2977,1694,0,0,62,62,0,1,0,1,0
434,1046,466,15,162,153,9,1,0,1,0
2045,183,8072,121,293,223,70,4,0,3,1
12922,973,0,0,103,103,0,1,0,1,0
1424,183,5021,121,293,223,70,4,1,3,1
1328,1176,0,0,141,141,0,1,0,1,0
3013,1694,0,0,62,62,0,1,0,1,0
9670,1606,0,0,110,110,0,1,0,1,0
321,2522,0,0,143,143,0,1,0,1,0
1802,183,6901,121,293,223,70,4,0,3,1
1982,2183,0,0,88,88,0,1,0,1,0
17131,183,25355,121,293,223,70,4,0,3,1
1574,3095,0,0,147,147,0,1,0,1,0
1653,530,0,0,147,147,0,1,0,1,0
5803,302,0,0,146,146,0,1,0,1,0
74,1413,0,0,153,153,0,1,0,1,0
490,1176,0,0,147,147,0,1,0,1,0
8290,1385,0,0,150,150,0,1,0,1,0
2910,183,10834,121,293,223,70,4,0,3,1
988,1121,0,0,144,144,0,1,0,1,0
122,1054,0,0,152,152,0,1,0,1,0
1046,3095,0,0,141,141,0,1,0,1,0
10360,1543,0,0,72,72,0,1,0,1,0
1339,183,4523,121,293,223,70,4,1,3,1
11001,1582,0,0,62,62,0,1,0,1,0
10362,1543,0,0,71,71,0,1,0,1,0
1157,1176,0,0,146,146,0,1,0,1,0
2725,1694,0,0,62,62,0,1,0,1,0
10637,1543,0,0,67,67,0,1,0,1,0
1569,1087,0,0,118,118,0,1,0,1,0
20960,1900,0,0,81,81,0,1,0,1,0
1948,968,0,0,92,92,0,1,0,1,0
7457,1216,0,0,146,146,0,1,0,1,0
2121,1277,0,0,127,127,0,1,0,1,0
8802,1658,0,0,128,128,0,1,0,1,0
7557,2683,0,0,84,84,0,1,0,1,0
1316,183,4410,121,293,223,70,4,0,3,1
459,1057,0,0,151,151,0,1,0,1,0
10498,1644,0,0,89,89,0,1,0,1,0
7638,2580,0,0,91,91,0,1,0,1,0
1268,183,5138,121,293,223,70,4,0,3,1
11440,183,18526,121,293,223,70,4,0,3,1
3698,868,0,0,115,115,0,1,0,1,0
543,850,0,0,154,154,0,1,0,1,0
3287,1292,0,0,88,88,0,1,0,1,0
15874,2596,0,0,121,121,0,1,0,1,0
218,1102,0,0,148,148,0,1,0,1,0
8319,1511,0,0,146,146,0,1,0,1,0
17449,799,0,0,109,109,0,1,0,1,0
10437,1565,0,0,74,74,0,1,0,1,0
1339,3095,0,0,142,142,0,1,0,1,0
2962,1363,0,0,116,116,0,1,0,1,0
2907,1424,0,0,106,106,0,1,0,1,0
2907,1438,0,0,104,104,0,1,0,1,0
11278,1659,0,0,64,64,0,1,0,1,0
1682,1176,0,0,141,141,0,1,0,1,0
2366,1694,0,0,62,62,0,1,0,1,0
1134,907,0,0,153,153,0,1,0,1,0
2010,183,7870,121,293,223,70,4,0,3,1
2259,2461,0,0,115,115,0,1,0,1,0
10725,1543,0,0,63,63,0,1,0,1,0
1959,1122,0,0,139,139,0,1,0,1,0
1435,183,4997,121,293,223,70,4,1,3,1
2271,1677,0,0,62,62,0,1,0,1,0
14574,1543,0,0,62,62,0,1,0,1,0
1345,217,3950,108,278,215,63,3,0,2,0
809,952,0,0,144,144,0,1,0,1,0
6774,641,0,0,150,150,0,1,0,1,0
2121,3095,0,0,155,155,0,1,0,1,0
8140,1591,0,0,146,146,0,1,0,1,0
1860,1008,0,0,144,144,0,1,0,1,0
71,1393,0,0,153,153,0,1,0,1,0
1835,918,0,0,79,79,0,1,0,1,0
1428,3095,0,0,139,139,0,1,0,1,0
447,1176,0,0,145,145,0,1,0,1,0
594,1073,0,0,149,149,0,1,0,1,0
1396,716,0,0,150,150,0,1,0,1,0
967,183,3719,121,293,223,70,4,1,3,1
2151,183,8653,121,293,223,70,4,0,3,1
11090,1635,0,0,65,65,0,1,0,1,0
11131,1423,0,0,69,69,0,1,0,1,0
3906,653,0,0,129,129,0,1,0,1,0
1470,183,5170,121,293,223,70,4,0,3,1
6189,429,0,0,148,148,0,1,0,1,0
454,1176,0,0,142,142,0,1,0,1,0
1178,1176,0,0,139,139,0,1,0,1,0
8296,1507,0,0,149,149,0,1,0,1,0
722,2619,0,0,143,143,0,1,0,1,0
2183,1044,0,0,62,62,0,1,0,1,0
11409,1687,0,0,65,65,0,1,0,1,0
7804,2023,0,0,114,114,0,1,0,1,0
940,1176,0,0,154,154,0,1,0,1,0
8327,1620,0,0,146,146,0,1,0,1,0
241,1054,0,0,157,157,0,1,0,1,0
1380,3095,0,0,141,141,0,1,0,1,0
1276,3000,0,0,139,139,0,1,0,1,0
2632,1176,0,0,146,146,0,1,0,1,0
8651,1694,0,0,137,137,0,1,0,1,0
8296,1504,0,0,150,150,0,1,0,1,0
2400,1176,0,0,145,145,0,1,0,1,0
1275,3095,0,0,139,139,0,1,0,1,0
961,3095,0,0,139,139,0,1,0,1,0
1117,183,4186,121,293,223,70,4,1,3,1
992,227,3117,105,274,213,60,3,0,2,0
8211,1708,0,0,136,136,0,1,0,1,0
560,1176,0,0,142,142,0,1,0,1,0
1086,3095,0,0,141,141,0,1,0,1,0
8284,1355,0,0,151,151,0,1,0,1,0
2496,1694,0,0,62,62,0,1,0,1,0
10808,183,17889,121,293,223,70,4,0,3,1
1539,858,0,0,143,143,0,1,0,1,0
507,910,956,32,183,164,18,1,0,1,0
20748,1543,0,0,62,62,0,1,0,1,0
1579,1014,0,0,128,128,0,1,0,1,0
9151,1643,0,0,118,118,0,1,0,1,0
7186,2893,0,0,66,66,0,1,0,1,0
3933,537,0,0,146,146,0,1,0,1,0
8398,1202,0,0,150,150,0,1,0,1,0
2902,1594,0,0,78,78,0,1,0,1,0
10655,1543,0,0,67,67,0,1,0,1,0
287,1136,0,0,146,146,0,1,0,1,0
1585,2840,0,0,125,125,0,1,0,1,0
3334,1244,0,0,91,91,0,1,0,1,0
1651,183,6083,121,293,223,70,4,0,3,1
388,1088,0,0,157,157,0,1,0,1,0
1416,3095,0,0,139,139,0,1,0,1,0
9293,1635,0,0,113,113,0,1,0,1,0
3113,1613,0,0,67,67,0,1,0,1,0
4068,496,0,0,139,139,0,1,0,1,0
950,183,3732,121,293,223,70,4,1,3,1
11430,1688,0,0,65,65,0,1,0,1,0
1165,2932,0,0,140,140,0,1,0,1,0
2116,3095,0,0,155,155,0,1,0,1,0
1181,183,4359,121,293,223,70,4,1,3,1
228,2365,0,0,144,144,0,1,0,1,0
330,1041,0,0,153,153,0,1,0,1,0
8831,1277,0,0,133,133,0,1,0,1,0
3671,183,13267,121,293,223,70,4,0,3,1
343,1340,0,0,143,143,0,1,0,1,0
1391,183,5515,121,293,223,70,4,0,3,1
11525,1277,0,0,79,79,0,1,0,1,0
794,3095,0,0,139,139,0,1,0,1,0
2173,183,8780,121,293,223,70,4,0,3,1
2569,2399,0,0,110,110,0,1,0,1,0
8077,2015,0,0,126,126,0,1,0,1,0
2128,183,8515,121,293,223,70,4,0,3,1
1265,1176,0,0,139,139,0,1,0,1,0
720,2667,0,0,143,143,0,1,0,1,0
8271,1299,0,0,153,153,0,1,0,1,0
1750,754,0,0,146,146,0,1,0,1,0
15239,885,0,0,145,145,0,1,0,1,0
1779,2518,0,0,107,107,0,1,0,1,0
1837,183,7083,121,293,223,70,4,0,3,1
10477,1557,0,0,71,71,0,1,0,1,0
840,3095,0,0,139,139,0,1,0,1,0
19841,1543,0,0,62,62,0,1,0,1,0
2975,1418,0,0,107,107,0,1,0,1,0
447,1135,0,0,143,143,0,1,0,1,0
4754,183,16238,121,293,223,70,4,1,3,1
10883,1609,0,0,67,67,0,1,0,1,0
3847,183,13597,121,293,223,70,4,1,3,1
5505,267,0,0,146,146,0,1,0,1,0
8655,1471,0,0,145,145,0,1,0,1,0
5817,309,0,0,146,146,0,1,0,1,0
906,3095,0,0,141,141,0,1,0,1,0
2048,702,0,0,62,62,0,1,0,1,0
10595,1555,0,0,69,69,0,1,0,1,0
10769,1595,0,0,68,68,0,1,0,1,0
12135,1385,0,0,79,79,0,1,0,1,0
2533,1694,0,0,62,62,0,1,0,1,0
2112,3095,0,0,155,155,0,1,0,1,0
1658,535,0,0,146,146,0,1,0,1,0
8013,1388,0,0,146,146,0,1,0,1,0
3657,710,0,0,146,146,0,1,0,1,0
2940,1273,0,0,131,131,0,1,0,1,0
10307,1546,0,0,73,73,0,1,0,1,0
992,183,3957,121,293,223,70,4,0,3,1
1518,183,5396,121,293,223,70,4,0,3,1
932,1055,0,0,155,155,0,1,0,1,0
10385,1543,0,0,71,71,0,1,0,1,0
2160,1621,0,0,72,72,0,1,0,1,0
2305,1694,0,0,62,62,0,1,0,1,0
21561,1079,9708,41,140,116,23,2,0,1,0
1355,3071,0,0,141,141,0,1,0,1,0
1249,1176,0,0,143,143,0,1,0,1,0
649,644,1916,64,223,185,37,2,0,2,0
2904,1514,0,0,91,91,0,1,0,1,0
16461,1620,0,0,62,62,0,1,0,1,0
10276,1543,0,0,80,80,0,1,0,1,0
40,1014,0,0,156,156,0,1,0,1,0
2302,2972,0,0,150,150,0,1,0,1,0
9202,1543,0,0,114,114,0,1,0,1,0
8314,1487,0,0,147,147,0,1,0,1,0
2232,183,9121,121,293,223,70,4,0,3,1
1901,1104,0,0,143,143,0,1,0,1,0
4366,183,14442,121,293,223,70,4,1,3,1
2199,3095,0,0,157,157,0,1,0,1,0
9637,1596,0,0,98,98,0,1,0,1,0
4142,183,14045,121,293,223,70,4,0,3,1
1488,1210,0,0,133,133,0,1,0,1,0
1665,183,6122,121,293,223,70,4,0,3,1
2509,1176,0,0,145,145,0,1,0,1,0
1611,183,6369,121,293,223,70,4,0,3,1
4349,183,14779,121,293,223,70,4,0,3,1
20395,2172,0,0,95,95,0,1,0,1,0
18933,1543,0,0,62,62,0,1,0,1,0
2227,183,9108,121,293,223,70,4,0,3,1
788,3095,0,0,139,139,0,1,0,1,0
1154,183,4083,121,293,223,70,4,1,3,1
1392,410,1225,41,197,173,23,2,0,1,0
2047,3095,0,0,154,154,0,1,0,1,0
730,3095,0,0,139,139,0,1,0,1,0
615,1176,0,0,151,151,0,1,0,1,0
2118,183,8480,121,293,223,70,4,0,3,1
2186,183,8867,121,293,223,70,4,0,3,1
992,183,3768,121,293,223,70,4,1,3,1
15159,830,0,0,145,145,0,1,0,1,0
712,2927,0,0,140,140,0,1,0,1,0
1856,183,7125,121,293,223,70,4,0,3,1
1762,183,6633,121,293,223,70,4,0,3,1
1372,3095,0,0,141,141,0,1,0,1,0
17580,2480,0,0,145,145,0,1,0,1,0
2142,183,8598,121,293,223,70,4,0,3,1
1586,721,0,0,145,145,0,1,0,1,0
15525,2497,0,0,113,113,0,1,0,1,0
7678,1337,0,0,146,146,0,1,0,1,0
2904,1538,0,0,87,87,0,1,0,1,0
7691,975,0,0,154,154,0,1,0,1,0
8260,1254,0,0,154,154,0,1,0,1,0
1114,3095,0,0,141,141,0,1,0,1,0
7391,866,0,0,153,153,0,1,0,1,0
4982,183,16436,121,293,223,70,4,0,3,1
17565,819,0,0,108,108,0,1,0,1,0
11028,1588,0,0,62,62,0,1,0,1,0
55,1021,0,0,155,155,0,1,0,1,0
4150,183,14756,121,293,223,70,4,0,3,1
8263,1305,0,0,154,154,0,1,0,1,0
4125,183,13998,121,293,223,70,4,0,3,1
1070,183,4058,121,293,223,70,4,1,3,1
319,1153,0,0,144,144,0,1,0,1,0
10788,1624,0,0,75,75,0,1,0,1,0
6203,528,0,0,146,146,0,1,0,1,0
1105,183,4356,121,293,223,70,4,0,3,1
19486,2610,0,0,119,119,0,1,0,1,0
1141,183,4487,121,293,223,70,4,0,3,1
736,1176,0,0,155,155,0,1,0,1,0
1638,1176,0,0,140,140,0,1,0,1,0
7484,2747,0,0,78,78,0,1,0,1,0
1656,539,0,0,147,147,0,1,0,1,0
17231,2242,0,0,145,145,0,1,0,1,0
3998,496,0,0,146,146,0,1,0,1,0
17760,2602,0,0,145,145,0,1,0,1,0
3596,183,11972,121,293,223,70,4,1,3,1
2046,183,8080,121,293,223,70,4,0,3,1
1345,1176,0,0,141,141,0,1,0,1,0
6777,2169,0,0,88,88,0,1,0,1,0
1033,1176,0,0,149,149,0,1,0,1,0
880,1093,0,0,155,155,0,1,0,1,0
14623,1543,0,0,68,68,0,1,0,1,0
7738,2385,0,0,99,99,0,1,0,1,0
7764,2346,0,0,101,101,0,1,0,1,0
2090,183,7141,121,293,223,70,4,1,3,1
1805,881,0,0,145,145,0,1,0,1,0
1087,942,0,0,153,153,0,1,0,1,0
17322,776,0,0,111,111,0,1,0,1,0
1901,183,7501,121,293,223,70,4,0,3,1
361,2581,0,0,143,143,0,1,0,1,0
339,2438,0,0,144,144,0,1,0,1,0
2026,3095,0,0,153,153,0,1,0,1,0
2041,183,8021,121,293,223,70,4,0,3,1
120,1053,0,0,152,152,0,1,0,1,0
3038,1694,0,0,62,62,0,1,0,1,0
9990,1570,0,0,85,85,0,1,0,1,0
1612,2686,0,0,119,119,0,1,0,1,0
1534,871,0,0,143,143,0,1,0,1,0
3031,183,11043,121,293,223,70,4,0,3,1
2881,1694,0,0,62,62,0,1,0,1,0
18310,3060,0,0,143,143,0,1,0,1,0
7507,2598,0,0,84,84,0,1,0,1,0
8316,1538,0,0,146,146,0,1,0,1,0
14056,183,21164,121,293,223,70,4,0,3,1
1814,2385,0,0,101,101,0,1,0,1,0
2589,183,9808,121,293,223,70,4,0,3,1
1738,3095,0,0,146,146,0,1,0,1,0
2072,183,8225,121,293,223,70,4,0,3,1
1425,3095,0,0,139,139,0,1,0,1,0
7576,1282,0,0,146,146,0,1,0,1,0
2068,1239,0,0,133,133,0,1,0,1,0
16550,1543,0,0,62,62,0,1,0,1,0
798,933,872,29,190,173,17,1,0,1,0
1677,555,0,0,140,140,0,1,0,1,0
1442,3095,0,0,148,148,0,1,0,1,0
193,2273,0,0,145,145,0,1,0,1,0
18946,2871,0,0,133,133,0,1,0,1,0
1628,183,5942,121,293,223,70,4,0,3,1
1864,183,7224,121,293,223,70,4,0,3,1
1844,3095,0,0,153,153,0,1,0,1,0
1754,183,6555,121,293,223,70,4,0,3,1
1328,183,4468,121,293,223,70,4,0,3,1
8254,1244,0,0,155,155,0,1,0,1,0
9494,1543,0,0,103,103,0,1,0,1,0
1891,1176,0,0,143,143,0,1,0,1,0
1500,3095,0,0,145,145,0,1,0,1,0
2261,2402,0,0,111,111,0,1,0,1,0
1946,183,7518,121,293,223,70,4,0,3,1
10470,1643,0,0,90,90,0,1,0,1,0
4644,353,0,0,146,146,0,1,0,1,0
8798,1694,0,0,133,133,0,1,0,1,0
814,810,1319,44,207,181,25,2,0,1,0
4016,538,0,0,137,137,0,1,0,1,0
1702,183,6555,121,293,223,70,4,0,3,1
1647,3095,0,0,151,151,0,1,0,1,0
4100,780,0,0,147,147,0,1,0,1,0
21452,1543,0,0,62,62,0,1,0,1,0
1655,183,6099,121,293,223,70,4,0,3,1
1215,3095,0,0,139,139,0,1,0,1,0
1233,1176,0,0,144,144,0,1,0,1,0
1562,183,5616,121,293,223,70,4,0,3,1
8090,1881,0,0,127,127,0,1,0,1,0
16291,2652,0,0,118,118,0,1,0,1,0
1144,3095,0,0,141,141,0,1,0,1,0
1624,183,5923,121,293,223,70,4,0,3,1
2068,673,0,0,62,62,0,1,0,1,0
1473,1052,0,0,140,140,0,1,0,1,0
20647,2050,0,0,89,89,0,1,0,1,0
8145,2623,0,0,64,64,0,1,0,1,0
2032,183,7686,121,293,223,70,4,0,3,1
2180,1634,0,0,70,70,0,1,0,1,0
9637,1895,0,0,69,69,0,1,0,1,0
2078,183,8335,121,293,223,70,4,0,3,1
1834,183,6994,121,293,223,70,4,0,3,1
1357,183,4838,121,293,223,70,4,1,3,1
1150,183,4276,121,293,223,70,4,1,3,1
2191,183,8893,121,293,223,70,4,0,3,1
8161,1334,0,0,148,148,0,1,0,1,0
1087,941,0,0,153,153,0,1,0,1,0
1957,845,0,0,63,63,0,1,0,1,0
10165,1509,0,0,79,79,0,1,0,1,0
1351,3095,0,0,142,142,0,1,0,1,0
1657,183,6114,121,293,223,70,4,0,3,1
531,865,1120,37,189,168,21,1,0,1,0
10953,1572,0,0,62,62,0,1,0,1,0
1971,2201,0,0,89,89,0,1,0,1,0
124,1770,0,0,150,150,0,1,0,1,0
2970,1694,0,0,62,62,0,1,0,1,0
8327,1634,0,0,146,146,0,1,0,1,0
1978,183,7693,121,293,223,70,4,0,3,1
12124,964,0,0,104,104,0,1,0,1,0
18493,1543,0,0,64,64,0,1,0,1,0
1418,646,0,0,147,147,0,1,0,1,0
1728,853,0,0,117,117,0,1,0,1,0
15754,2544,0,0,112,112,0,1,0,1,0
1597,687,0,0,145,145,0,1,0,1,0
10192,1513,0,0,78,78,0,1,0,1,0
2355,239,0,0,62,62,0,1,0,1,0
844,3095,0,0,139,139,0,1,0,1,0
974,183,3733,121,293,223,70,4,1,3,1
56,1283,0,0,154,154,0,1,0,1,0
255,2241,0,0,146,146,0,1,0,1,0
941,3095,0,0,142,142,0,1,0,1,0
1804,1176,0,0,141,141,0,1,0,1,0
1943,1031,0,0,108,108,0,1,0,1,0
1269,3095,0,0,139,139,0,1,0,1,0
11498,1687,0,0,62,62,0,1,0,1,0
1397,3095,0,0,144,144,0,1,0,1,0
9979,1543,0,0,85,85,0,1,0,1,0
1089,183,4110,121,293,223,70,4,1,3,1
1770,183,6733,121,293,223,70,4,0,3,1
14598,2309,0,0,102,102,0,1,0,1,0
1372,183,4682,121,293,223,70,4,0,3,1
2959,1351,0,0,118,118,0,1,0,1,0
4611,183,16060,121,293,223,70,4,1,3,1
2127,1266,0,0,128,128,0,1,0,1,0
826,312,3114,105,273,212,60,3,0,2,0
17285,1543,0,0,62,62,0,1,0,1,0
1493,993,0,0,141,141,0,1,0,1,0
4163,183,14106,121,293,223,70,4,0,3,1
609,2615,0,0,144,144,0,1,0,1,0
1819,183,6919,121,293,223,70,4,0,3,1
1100,3095,0,0,139,139,0,1,0,1,0
2515,183,9331,121,293,223,70,4,0,3,1
2754,1694,0,0,62,62,0,1,0,1,0
262,1925,0,0,144,144,0,1,0,1,0
9212,1694,0,0,122,122,0,1,0,1,0
13587,484,0,0,131,131,0,1,0,1,0
844,1176,0,0,154,154,0,1,0,1,0
8169,1897,0,0,133,133,0,1,0,1,0
2041,714,0,0,62,62,0,1,0,1,0
1677,183,6180,121,293,223,70,4,0,3,1
2220,183,9048,121,293,223,70,4,0,3,1
1343,3041,0,0,139,139,0,1,0,1,0
2917,183,10663,121,293,223,70,4,0,3,1
10295,1543,0,0,79,79,0,1,0,1,0
1627,600,0,0,147,147,0,1,0,1,0
4735,183,16215,121,293,223,70,4,1,3,1
2677,1523,0,0,88,88,0,1,0,1,0
548,2860,0,0,140,140,0,1,0,1,0
8327,1613,0,0,146,146,0,1,0,1,0
418,2666,0,0,142,142,0,1,0,1,0
988,2825,0,0,141,141,0,1,0,1,0
13007,928,0,0,105,105,0,1,0,1,0
2137,1903,0,0,74,74,0,1,0,1,0
2352,99,0,0,78,78,0,1,0,1,0
558,2874,0,0,140,140,0,1,0,1,0
576,1131,0,0,157,157,0,1,0,1,0
620,828,0,0,153,153,0,1,0,1,0
4054,499,0,0,139,139,0,1,0,1,0
1319,183,4424,121,293,223,70,4,1,3,1
2170,1406,0,0,62,62,0,1,0,1,0
1656,539,0,0,147,147,0,1,0,1,0
2910,1350,0,0,119,119,0,1,0,1,0
8656,1673,0,0,134,134,0,1,0,1,0
4455,183,15756,121,293,223,70,4,1,3,1
10956,1573,0,0,62,62,0,1,0,1,0
2956,1341,0,0,120,120,0,1,0,1,0
333,1407,0,0,143,143,0,1,0,1,0
4100,183,14731,121,293,223,70,4,0,3,1
1879,389,0,0,125,125,0,1,0,1,0
1228,183,4225,121,293,223,70,4,1,3,1
8304,1555,0,0,148,148,0,1,0,1,0
2712,1593,0,0,77,77,0,1,0,1,0
1632,183,5957,121,293,223,70,4,0,3,1
662,3029,0,0,139,139,0,1,0,1,0
10130,1584,0,0,84,84,0,1,0,1,0
1284,183,4335,121,293,223,70,4,1,3,1
8287,1599,0,0,142,142,0,1,0,1,0
8327,1604,0,0,146,146,0,1,0,1,0
1546,1176,0,0,139,139,0,1,0,1,0
11967,1114,0,0,89,89,0,1,0,1,0
2911,1323,0,0,123,123,0,1,0,1,0
2034,1176,0,0,143,143,0,1,0,1,0
1971,183,7642,121,293,223,70,4,0,3,1
10703,1543,0,0,64,64,0,1,0,1,0
1573,183,5673,121,293,223,70,4,0,3,1
1735,183,6552,121,293,223,70,4,0,3,1
1434,3095,0,0,148,148,0,1,0,1,0
10382,183,17460,121,293,223,70,4,0,3,1
1391,3095,0,0,140,140,0,1,0,1,0
1487,183,5246,121,293,223,70,4,0,3,1
2428,1266,0,0,62,62,0,1,0,1,0
3674,183,13467,121,293,223,70,4,0,3,1
890,218,3451,116,288,220,67,3,0,2,0
659,2648,0,0,144,144,0,1,0,1,0
2029,2104,0,0,84,84,0,1,0,1,0
1205,3095,0,0,142,142,0,1,0,1,0
1440,1148,0,0,139,139,0,1,0,1,0
1240,2978,0,0,139,139,0,1,0,1,0
1619,183,5916,121,293,223,70,4,0,3,1
17112,183,25408,121,293,223,70,4,0,3,1
308,2417,0,0,144,144,0,1,0,1,0
4306,387,0,0,146,146,0,1,0,1,0
7514,2705,0,0,81,81,0,1,0,1,0
1348,183,4567,121,293,223,70,4,1,3,1
1248,183,4881,121,293,223,70,4,0,3,1
2932,1694,0,0,62,62,0,1,0,1,0
2091,183,8301,121,293,223,70,4,0,3,1
12600,808,0,0,113,113,0,1,0,1,0
1037,183,3968,121,293,223,70,4,1,3,1
817,1139,0,0,156,156,0,1,0,1,0
343,1339,0,0,143,143,0,1,0,1,0
1993,183,7890,121,293,223,70,4,0,3,1
2618,305,0,0,84,84,0,1,0,1,0
976,183,3738,121,293,223,70,4,1,3,1
7701,2222,0,0,103,103,0,1,0,1,0
2724,1694,0,0,62,62,0,1,0,1,0
8314,1618,0,0,147,147,0,1,0,1,0
3741,303,0,0,125,125,0,1,0,1,0
1005,3095,0,0,140,140,0,1,0,1,0
1697,3095,0,0,145,145,0,1,0,1,0
2865,1217,0,0,141,141,0,1,0,1,0
1403,183,4843,121,293,223,70,4,1,3,1
1795,858,0,0,145,145,0,1,0,1,0
80,1455,0,0,152,152,0,1,0,1,0
18052,1543,0,0,62,62,0,1,0,1,0
11529,1691,0,0,62,62,0,1,0,1,0
16264,1583,0,0,145,145,0,1,0,1,0
2723,612,0,0,106,106,0,1,0,1,0
9415,1543,0,0,106,106,0,1,0,1,0
1934,1156,0,0,138,138,0,1,0,1,0
9912,1414,0,0,95,95,0,1,0,1,0
1029,2850,0,0,140,140,0,1,0,1,0
20029,2348,0,0,105,105,0,1,0,1,0
676,1176,0,0,153,153,0,1,0,1,0
2548,1047,0,0,115,115,0,1,0,1,0
517,1176,0,0,148,148,0,1,0,1,0
2119,183,8486,121,293,223,70,4,0,3,1
1613,183,5894,121,293,223,70,4,0,3,1
2656,2213,0,0,97,97,0,1,0,1,0
1913,183,7389,121,293,223,70,4,0,3,1
1575,183,5678,121,293,223,70,4,0,3,1
2251,1106,0,0,62,62,0,1,0,1,0
2355,98,0,0,77,77,0,1,0,1,0
2994,1694,0,0,62,62,0,1,0,1,0
1277,183,5070,121,293,223,70,4,0,3,1
8265,1315,0,0,154,154,0,1,0,1,0
1501,1131,0,0,128,128,0,1,0,1,0
1889,183,7214,121,293,223,70,4,0,3,1
391,1089,0,0,157,157,0,1,0,1,0
1043,974,0,0,154,154,0,1,0,1,0
2074,1387,0,0,109,109,0,1,0,1,0
3123,1600,0,0,68,68,0,1,0,1,0
1398,3095,0,0,140,140,0,1,0,1,0
14338,271,0,0,145,145,0,1,0,1,0
14302,250,0,0,144,144,0,1,0,1,0
4613,183,15475,121,293,223,70,4,0,3,1
1644,183,6019,121,293,223,70,4,0,3,1
3106,1621,0,0,66,66,0,1,0,1,0
2210,183,8999,121,293,223,70,4,0,3,1
11393,1674,0,0,63,63,0,1,0,1,0
1374,3095,0,0,141,141,0,1,0,1,0
8276,1384,0,0,152,152,0,1,0,1,0
212,2289,0,0,144,144,0,1,0,1,0
1883,183,7428,121,293,223,70,4,0,3,1
807,3095,0,0,139,139,0,1,0,1,0
1820,2452,0,0,103,103,0,1,0,1,0
1703,646,0,0,147,147,0,1,0,1,0
14113,349,0,0,139,139,0,1,0,1,0
1865,183,7361,121,293,223,70,4,0,3,1
2885,1694,0,0,62,62,0,1,0,1,0
3422,1251,0,0,90,90,0,1,0,1,0
1021,3095,0,0,143,143,0,1,0,1,0
8612,1481,0,0,145,145,0,1,0,1,0
11165,928,0,0,145,145,0,1,0,1,0
1956,857,0,0,66,66,0,1,0,1,0
1370,1176,0,0,139,139,0,1,0,1,0
10237,1543,0,0,76,76,0,1,0,1,0
2054,183,8210,121,293,223,70,4,0,3,1
1523,183,5421,121,293,223,70,4,0,3,1
571,1176,0,0,150,150,0,1,0,1,0
8904,1658,0,0,126,126,0,1,0,1,0
1535,183,5482,121,293,223,70,4,0,3,1
15457,1033,0,0,145,145,0,1,0,1,0
1097,183,3972,121,293,223,70,4,1,3,1
8246,1798,0,0,139,139,0,1,0,1,0
4518,183,15946,121,293,223,70,4,1,3,1
17775,2952,0,0,136,136,0,1,0,1,0
16574,2709,0,0,124,124,0,1,0,1,0
1680,183,6191,121,293,223,70,4,0,3,1
2769,183,10173,121,293,223,70,4,0,3,1
6509,696,0,0,146,146,0,1,0,1,0
1364,3095,0,0,141,141,0,1,0,1,0
10431,1543,0,0,70,70,0,1,0,1,0
1180,183,4133,121,293,223,70,4,1,3,1
1141,3095,0,0,141,141,0,1,0,1,0
4729,345,0,0,146,146,0,1,0,1,0
1473,1176,0,0,139,139,0,1,0,1,0
1855,183,7098,121,293,223,70,4,0,3,1
9560,1618,0,0,104,104,0,1,0,1,0
2093,183,8314,121,293,223,70,4,0,3,1
2276,1754,0,0,66,66,0,1,0,1,0
20164,1565,0,0,62,62,0,1,0,1,0
1590,1176,0,0,140,140,0,1,0,1,0
1970,2152,0,0,88,88,0,1,0,1,0
2050,3095,0,0,154,154,0,1,0,1,0
7890,1328,0,0,146,146,0,1,0,1,0
2674,1694,0,0,62,62,0,1,0,1,0
1395,3095,0,0,139,139,0,1,0,1,0
1919,183,7416,121,293,223,70,4,0,3,1
1836,183,6954,121,293,223,70,4,0,3,1
17833,183,25936,121,293,223,70,4,0,3,1
1329,183,4476,121,293,223,70,4,1,3,1
1021,1176,0,0,150,150,0,1,0,1,0
157,1072,0,0,151,151,0,1,0,1,0
1617,183,5887,121,293,223,70,4,0,3,1
21683,1484,1215,5,71,68,2,1,0,1,0
1502,1130,0,0,128,128,0,1,0,1,0
1962,1219,0,0,136,136,0,1,0,1,0
4091,438,0,0,146,146,0,1,0,1,0
1476,1147,0,0,132,132,0,1,0,1,0
10669,1694,0,0,84,84,0,1,0,1,0
21136,183,28305,121,293,223,70,4,0,3,1
3120,1604,0,0,67,67,0,1,0,1,0
9301,1634,0,0,113,113,0,1,0,1,0
17684,1602,0,0,62,62,0,1,0,1,0
2369,89,0,0,76,76,0,1,0,1,0
838,1124,0,0,156,156,0,1,0,1,0
1515,927,0,0,142,142,0,1,0,1,0
106,1640,0,0,151,151,0,1,0,1,0
9430,1543,0,0,105,105,0,1,0,1,0
651,1080,0,0,148,148,0,1,0,1,0
8715,1257,0,0,138,138,0,1,0,1,0
2299,132,0,0,83,83,0,1,0,1,0
1795,858,0,0,145,145,0,1,0,1,0
499,1735,0,0,151,151,0,1,0,1,0
3496,183,11653,121,293,223,70,4,1,3,1
2971,1694,0,0,62,62,0,1,0,1,0
4863,331,0,0,146,146,0,1,0,1,0
2110,183,8440,121,293,223,70,4,0,3,1
1583,183,5788,121,293,223,70,4,0,3,1
1775,183,6699,121,293,223,70,4,0,3,1
8296,1408,0,0,150,150,0,1,0,1,0
3012,1694,0,0,62,62,0,1,0,1,0
943,1176,0,0,152,152,0,1,0,1,0
1639,1043,0,0,108,108,0,1,0,1,0
2019,304,0,0,111,111,0,1,0,1,0
2946,1694,0,0,62,62,0,1,0,1,0
6352,183,17307,121,293,223,70,4,0,3,1
4723,183,16200,121,293,223,70,4,1,3,1
7484,2747,0,0,78,78,0,1,0,1,0
900,183,3603,121,293,223,70,4,0,3,1
2981,1694,0,0,62,62,0,1,0,1,0
552,2578,0,0,144,144,0,1,0,1,0
1303,183,4371,121,293,223,70,4,1,3,1
1890,183,7275,121,293,223,70,4,0,3,1
7478,2756,0,0,78,78,0,1,0,1,0
12421,946,0,0,100,100,0,1,0,1,0
7809,2013,0,0,114,114,0,1,0,1,0
3038,1694,0,0,62,62,0,1,0,1,0
1215,183,4452,121,293,223,70,4,1,3,1
8322,1521,0,0,146,146,0,1,0,1,0
1825,2444,0,0,103,103,0,1,0,1,0
2210,1324,0,0,119,119,0,1,0,1,0
1972,3095,0,0,152,152,0,1,0,1,0
7756,2359,0,0,100,100,0,1,0,1,0
8251,1212,0,0,155,155,0,1,0,1,0
8449,1684,0,0,141,141,0,1,0,1,0
1386,407,1257,42,198,174,24,2,0,1,0
8276,1381,0,0,152,152,0,1,0,1,0
1934,1152,0,0,137,137,0,1,0,1,0
648,1176,0,0,152,152,0,1,0,1,0
1869,750,0,0,86,86,0,1,0,1,0
2385,261,0,0,79,79,0,1,0,1,0
2373,284,0,0,81,81,0,1,0,1,0
1650,532,0,0,147,147,0,1,0,1,0
16137,1543,0,0,62,62,0,1,0,1,0
977,3095,0,0,140,140,0,1,0,1,0
2579,1694,0,0,62,62,0,1,0,1,0
11324,1665,0,0,63,63,0,1,0,1,0
1728,183,6463,121,293,223,70,4,0,3,1
9320,1620,0,0,109,109,0,1,0,1,0
3355,1329,0,0,85,85,0,1,0,1,0
8871,1694,0,0,131,131,0,1,0,1,0
1994,936,0,0,62,62,0,1,0,1,0
2050,183,8102,121,293,223,70,4,0,3,1
2173,3095,0,0,158,158,0,1,0,1,0
14160,325,0,0,140,140,0,1,0,1,0
2680,1367,0,0,116,116,0,1,0,1,0
1524,902,0,0,142,142,0,1,0,1,0
4484,183,15136,121,293,223,70,4,0,3,1
1834,183,6944,121,293,223,70,4,0,3,1
1626,604,0,0,146,146,0,1,0,1,0
17029,1612,0,0,62,62,0,1,0,1,0
1491,1137,0,0,130,130,0,1,0,1,0
8983,1645,0,0,122,122,0,1,0,1,0
9139,1543,0,0,118,118,0,1,0,1,0
1173,3095,0,0,139,139,0,1,0,1,0
10059,1588,0,0,87,87,0,1,0,1,0
550,1068,0,0,150,150,0,1,0,1,0
514,2553,0,0,144,144,0,1,0,1,0
2636,1694,0,0,62,62,0,1,0,1,0
2125,238,0,0,100,100,0,1,0,1,0
1534,871,0,0,143,143,0,1,0,1,0
2026,1021,0,0,62,62,0,1,0,1,0
350,1290,0,0,143,143,0,1,0,1,0
2491,14,0,0,64,64,0,1,0,1,0
1954,882,0,0,72,72,0,1,0,1,0
8108,1855,0,0,128,128,0,1,0,1,0
8313,1482,0,0,147,147,0,1,0,1,0
765,2718,0,0,144,144,0,1,0,1,0
1152,1176,0,0,146,146,0,1,0,1,0
2243,183,7902,121,293,223,70,4,1,3,1
1108,183,4160,121,293,223,70,4,1,3,1
4414,183,15630,121,293,223,70,4,0,3,1
2531,1694,0,0,62,62,0,1,0,1,0
1768,961,0,0,89,89,0,1,0,1,0
2794,1133,0,0,137,137,0,1,0,1,0
1165,183,4317,121,293,223,70,4,1,3,1
2622,1545,0,0,85,85,0,1,0,1,0
1467,341,2374,65,226,188,37,2,0,2,0
2460,58,0,0,65,65,0,1,0,1,0
184,2210,0,0,146,146,0,1,0,1,0
1555,1176,0,0,139,139,0,1,0,1,0
1941,3095,0,0,155,155,0,1,0,1,0
11212,1624,0,0,66,66,0,1,0,1,0
2826,913,0,0,128,128,0,1,0,1,0
1405,3095,0,0,140,140,0,1,0,1,0
2544,1176,0,0,146,146,0,1,0,1,0
2641,1079,0,0,123,123,0,1,0,1,0
17659,2534,0,0,145,145,0,1,0,1,0
757,1501,0,0,153,153,0,1,0,1,0
18899,2893,0,0,134,134,0,1,0,1,0
2739,659,0,0,110,110,0,1,0,1,0
79,1010,0,0,156,156,0,1,0,1,0
1612,1287,0,0,122,122,0,1,0,1,0
3488,1174,0,0,95,95,0,1,0,1,0
2039,183,8018,121,293,223,70,4,0,3,1
1521,396,1683,46,203,176,26,2,0,1,0
1335,183,4508,121,293,223,70,4,0,3,1
1929,183,7571,121,293,223,70,4,0,3,1
823,743,1559,52,216,185,30,2,0,1,0
486,1060,0,0,151,151,0,1,0,1,0
325,2529,0,0,143,143,0,1,0,1,0
1271,183,4308,121,293,223,70,4,1,3,1
1323,183,4446,121,293,223,70,4,1,3,1
1248,3095,0,0,139,139,0,1,0,1,0
1405,183,4843,121,293,223,70,4,0,3,1
9042,1388,0,0,145,145,0,1,0,1,0
8579,1234,0,0,143,143,0,1,0,1,0
429,1097,0,0,157,157,0,1,0,1,0
8042,2674,0,0,64,64,0,1,0,1,0
1368,1176,0,0,140,140,0,1,0,1,0
2212,929,0,0,84,84,0,1,0,1,0
11153,1613,0,0,62,62,0,1,0,1,0
3377,183,12218,121,293,223,70,4,0,3,1
3215,183,11405,121,293,223,70,4,0,3,1
2482,20,0,0,65,65,0,1,0,1,0
1350,3095,0,0,142,142,0,1,0,1,0
10365,1541,0,0,72,72,0,1,0,1,0
2795,1176,0,0,147,147,0,1,0,1,0
303,1068,0,0,157,157,0,1,0,1,0
9402,1543,0,0,109,109,0,1,0,1,0
1548,1101,0,0,121,121,0,1,0,1,0
1949,955,0,0,89,89,0,1,0,1,0
1498,183,5323,121,293,223,70,4,0,3,1
2150,183,8643,121,293,223,70,4,0,3,1
7907,2143,0,0,112,112,0,1,0,1,0
1981,901,0,0,62,62,0,1,0,1,0
99,1012,0,0,155,155,0,1,0,1,0
2050,1176,0,0,143,143,0,1,0,1,0
989,183,3976,121,293,223,70,4,0,3,1
1396,183,4804,121,293,223,70,4,1,3,1
545,1067,0,0,150,150,0,1,0,1,0
790,2734,0,0,143,143,0,1,0,1,0
1454,438,933,31,185,167,18,1,0,1,0
3038,1694,0,0,62,62,0,1,0,1,0
1071,3095,0,0,141,141,0,1,0,1,0
12482,1203,0,0,90,90,0,1,0,1,0
2922,1694,0,0,62,62,0,1,0,1,0
842,1103,0,0,146,146,0,1,0,1,0
7841,2318,0,0,107,107,0,1,0,1,0
1080,1176,0,0,148,148,0,1,0,1,0
8696,1671,0,0,133,133,0,1,0,1,0
1723,601,0,0,127,127,0,1,0,1,0
8631,1675,0,0,135,135,0,1,0,1,0
5882,317,0,0,146,146,0,1,0,1,0
1081,1176,0,0,148,148,0,1,0,1,0
2493,32,0,0,62,62,0,1,0,1,0
146,1932,0,0,148,148,0,1,0,1,0
170,2104,0,0,147,147,0,1,0,1,0
8327,1682,0,0,146,146,0,1,0,1,0
2964,1370,0,0,115,115,0,1,0,1,0
2978,1694,0,0,62,62,0,1,0,1,0
8029,2680,0,0,64,64,0,1,0,1,0
2237,1585,0,0,62,62,0,1,0,1,0
2082,2017,0,0,79,79,0,1,0,1,0
1042,2858,0,0,140,140,0,1,0,1,0
218,2369,0,0,144,144,0,1,0,1,0
2553,1694,0,0,62,62,0,1,0,1,0
8050,1548,0,0,138,138,0,1,0,1,0
2602,1424,0,0,62,62,0,1,0,1,0
2133,183,8569,121,293,223,70,4,0,3,1
1814,760,0,0,111,111,0,1,0,1,0
7908,2140,0,0,112,112,0,1,0,1,0
10776,1543,0,0,62,62,0,1,0,1,0
1382,183,4734,121,293,223,70,4,0,3,1
16509,1750,0,0,145,145,0,1,0,1,0
7490,2769,0,0,79,79,0,1,0,1,0
2915,1182,0,0,146,146,0,1,0,1,0
10930,183,20725,121,293,223,70,4,0,3,1
58,1299,0,0,154,154,0,1,0,1,0
1738,979,0,0,94,94,0,1,0,1,0
2028,183,7963,121,293,223,70,4,0,3,1
9667,1612,0,0,100,100,0,1,0,1,0
2289,1694,0,0,62,62,0,1,0,1,0
1951,920,0,0,81,81,0,1,0,1,0
8083,1890,0,0,126,126,0,1,0,1,0
2001,855,0,0,65,65,0,1,0,1,0
10416,1550,0,0,71,71,0,1,0,1,0
14150,183,23245,121,293,223,70,4,0,3,1
2073,183,8232,121,293,223,70,4,0,3,1
2474,1694,0,0,62,62,0,1,0,1,0
1517,3095,0,0,149,149,0,1,0,1,0
4965,183,16500,121,293,223,70,4,1,3,1
2070,670,0,0,62,62,0,1,0,1,0
2138,3095,0,0,156,156,0,1,0,1,0
1877,183,7158,121,293,223,70,4,0,3,1
8300,1530,0,0,149,149,0,1,0,1,0
7792,1012,0,0,155,155,0,1,0,1,0
1441,183,5031,121,293,223,70,4,0,3,1
1511,183,5381,121,293,223,70,4,0,3,1
4895,183,16220,121,293,223,70,4,0,3,1
8327,1621,0,0,146,146,0,1,0,1,0
3772,638,0,0,146,146,0,1,0,1,0
2347,1369,0,0,112,112,0,1,0,1,0
2274,1849,0,0,72,72,0,1,0,1,0
1844,972,0,0,144,144,0,1,0,1,0
5070,457,0,0,146,146,0,1,0,1,0
821,3095,0,0,139,139,0,1,0,1,0
1378,183,4897,121,293,223,70,4,1,3,1
914,183,3617,121,293,223,70,4,1,3,1
2675,1371,0,0,115,115,0,1,0,1,0
21420,611,19490,82,220,172,47,3,0,2,0
432,1176,0,0,142,142,0,1,0,1,0
7615,2561,0,0,89,89,0,1,0,1,0
1962,2217,0,0,90,90,0,1,0,1,0
10561,1543,0,0,70,70,0,1,0,1,0
1937,1116,0,0,128,128,0,1,0,1,0
1410,3095,0,0,139,139,0,1,0,1,0
8683,1694,0,0,136,136,0,1,0,1,0
2193,1566,0,0,81,81,0,1,0,1,0
1223,1176,0,0,139,139,0,1,0,1,0
86,1499,0,0,152,152,0,1,0,1,0
253,1987,0,0,144,144,0,1,0,1,0
9218,1543,0,0,115,115,0,1,0,1,0
2405,183,9222,121,293,223,70,4,0,3,1
21477,801,15521,65,187,149,38,2,0,2,0
1337,183,4515,121,293,223,70,4,1,3,1
8855,183,19377,121,293,223,70,4,0,3,1
230,2388,0,0,144,144,0,1,0,1,0
4995,183,16537,121,293,223,70,4,1,3,1
2276,1692,0,0,62,62,0,1,0,1,0
1926,1159,0,0,143,143,0,1,0,1,0
1554,3095,0,0,142,142,0,1,0,1,0
1381,183,4732,121,293,223,70,4,1,3,1
1191,865,0,0,152,152,0,1,0,1,0
2153,183,8660,121,293,223,70,4,0,3,1
1519,183,5417,121,293,223,70,4,0,3,1
10432,1565,0,0,74,74,0,1,0,1,0
8327,1682,0,0,146,146,0,1,0,1,0
1827,2365,0,0,100,100,0,1,0,1,0
3423,183,12342,121,293,223,70,4,0,3,1
2148,989,0,0,62,62,0,1,0,1,0
1233,183,4501,121,293,223,70,4,1,3,1
11442,1680,0,0,62,62,0,1,0,1,0
1998,183,7814,121,293,223,70,4,0,3,1
9310,1589,0,0,120,120,0,1,0,1,0
1041,975,0,0,154,154,0,1,0,1,0
2995,119,0,0,86,86,0,1,0,1,0
2146,1275,0,0,127,127,0,1,0,1,0
16898,2774,0,0,127,127,0,1,0,1,0
6960,871,0,0,146,146,0,1,0,1,0
10515,1560,0,0,71,71,0,1,0,1,0
2935,1694,0,0,62,62,0,1,0,1,0
15392,989,0,0,145,145,0,1,0,1,0
217,1102,0,0,148,148,0,1,0,1,0
1918,183,7411,121,293,223,70,4,0,3,1
703,1309,0,0,155,155,0,1,0,1,0
13467,687,0,0,119,119,0,1,0,1,0
1408,183,4860,121,293,223,70,4,0,3,1
8322,1666,0,0,146,146,0,1,0,1,0
2378,183,9583,121,293,223,70,4,0,3,1
9402,1543,0,0,106,106,0,1,0,1,0
70,1384,0,0,153,153,0,1,0,1,0
683,1176,0,0,154,154,0,1,0,1,0
8873,1543,0,0,126,126,0,1,0,1,0
8327,1659,0,0,146,146,0,1,0,1,0
1512,183,5983,121,293,223,70,4,0,3,1
1091,183,4344,121,293,223,70,4,0,3,1
2310,411,0,0,90,90,0,1,0,1,0
14481,368,0,0,145,145,0,1,0,1,0
2225,1552,0,0,62,62,0,1,0,1,0
12170,1366,0,0,80,80,0,1,0,1,0
1836,2425,0,0,102,102,0,1,0,1,0
2246,183,7911,121,293,223,70,4,1,3,1
1124,183,4023,121,293,223,70,4,1,3,1
1342,183,4547,121,293,223,70,4,0,3,1
4396,681,0,0,146,146,0,1,0,1,0
1466,664,0,0,149,149,0,1,0,1,0
2941,1277,0,0,131,131,0,1,0,1,0
3924,348,0,0,134,134,0,1,0,1,0
2911,1319,0,0,124,124,0,1,0,1,0
247,2033,0,0,144,144,0,1,0,1,0
4015,183,14365,121,293,223,70,4,0,3,1
1609,183,5846,121,293,223,70,4,0,3,1
6527,1725,0,0,101,101,0,1,0,1,0
1754,969,0,0,91,91,0,1,0,1,0
10003,1543,0,0,84,84,0,1,0,1,0
3449,841,0,0,147,147,0,1,0,1,0
2366,91,0,0,76,76,0,1,0,1,0
14876,638,0,0,145,145,0,1,0,1,0
4227,395,0,0,146,146,0,1,0,1,0
4449,183,14919,121,293,223,70,4,0,3,1
9064,1318,0,0,124,124,0,1,0,1,0
11202,1650,0,0,64,64,0,1,0,1,0
1661,3095,0,0,148,148,0,1,0,1,0
11240,1655,0,0,64,64,0,1,0,1,0
9983,1184,0,0,145,145,0,1,0,1,0
1518,183,5404,121,293,223,70,4,0,3,1
338,1376,0,0,143,143,0,1,0,1,0
14496,379,0,0,145,145,0,1,0,1,0
9534,1399,0,0,105,105,0,1,0,1,0
2239,183,9160,121,293,223,70,4,0,3,1
2009,183,7868,121,293,223,70,4,0,3,1
2305,421,0,0,91,91,0,1,0,1,0
16917,2778,0,0,128,128,0,1,0,1,0
17714,2948,0,0,138,138,0,1,0,1,0
2517,1694,0,0,62,62,0,1,0,1,0
4872,183,16065,121,293,223,70,4,1,3,1
2605,1427,0,0,106,106,0,1,0,1,0
11159,1614,0,0,62,62,0,1,0,1,0
17118,2166,0,0,145,145,0,1,0,1,0
2553,183,8625,121,293,223,70,4,1,3,1
1732,183,6537,121,293,223,70,4,0,3,1
1377,3095,0,0,141,141,0,1,0,1,0
2215,183,9022,121,293,223,70,4,0,3,1
4811,183,16309,121,293,223,70,4,1,3,1
11278,1659,0,0,64,64,0,1,0,1,0
4660,183,16122,121,293,223,70,4,1,3,1
1988,3095,0,0,152,152,0,1,0,1,0
1773,3095,0,0,147,147,0,1,0,1,0
1968,183,7628,121,293,223,70,4,0,3,1
2003,183,7897,121,293,223,70,4,0,3,1
1539,3095,0,0,146,146,0,1,0,1,0
2070,928,0,0,62,62,0,1,0,1,0
1737,616,0,0,123,123,0,1,0,1,0
2043,1176,0,0,143,143,0,1,0,1,0
5603,183,17002,121,293,223,70,4,0,3,1
2253,183,9241,121,293,223,70,4,0,3,1
8327,1626,0,0,146,146,0,1,0,1,0
2620,311,0,0,84,84,0,1,0,1,0
2802,1136,0,0,137,137,0,1,0,1,0
10422,1487,0,0,76,76,0,1,0,1,0
2322,118,0,0,81,81,0,1,0,1,0
2991,1482,0,0,97,97,0,1,0,1,0
1403,183,5453,121,293,223,70,4,0,3,1
2089,261,0,0,104,104,0,1,0,1,0
10511,1543,0,0,68,68,0,1,0,1,0
2163,1388,0,0,62,62,0,1,0,1,0
15802,2552,0,0,116,116,0,1,0,1,0
1884,3095,0,0,154,154,0,1,0,1,0
32,1006,0,0,157,157,0,1,0,1,0
1408,3095,0,0,140,140,0,1,0,1,0
7420,2838,0,0,73,73,0,1,0,1,0
2122,183,8483,121,293,223,70,4,0,3,1
765,3095,0,0,139,139,0,1,0,1,0
106,1046,0,0,153,153,0,1,0,1,0
720,510,2400,81,243,196,46,3,0,2,0
1915,796,0,0,73,73,0,1,0,1,0
10634,1453,0,0,77,77,0,1,0,1,0
2060,933,0,0,62,62,0,1,0,1,0
2025,183,8057,121,293,223,70,4,0,3,1
2769,1971,0,0,81,81,0,1,0,1,0
10722,1530,0,0,65,65,0,1,0,1,0
8013,1991,0,0,120,120,0,1,0,1,0
2902,1602,0,0,77,77,0,1,0,1,0
3386,183,12221,121,293,223,70,4,0,3,1
1801,3095,0,0,153,153,0,1,0,1,0
452,1176,0,0,146,146,0,1,0,1,0
5299,288,0,0,146,146,0,1,0,1,0
679,2638,0,0,142,142,0,1,0,1,0
5681,250,0,0,146,146,0,1,0,1,0
2866,1694,0,0,62,62,0,1,0,1,0
1855,183,7046,121,293,223,70,4,0,3,1
2565,1694,0,0,62,62,0,1,0,1,0
21673,1452,1902,8,77,72,4,1,0,1,0
1524,183,5449,121,293,223,70,4,0,3,1
11621,1654,0,0,64,64,0,1,0,1,0
3524,1047,0,0,104,104,0,1,0,1,0
2939,183,11288,121,293,223,70,4,0,3,1
10849,1661,0,0,80,80,0,1,0,1,0
2848,1540,0,0,62,62,0,1,0,1,0
2045,183,8049,121,293,223,70,4,0,3,1
1892,1083,0,0,143,143,0,1,0,1,0
19588,183,26658,121,293,223,70,4,0,3,1
4068,183,14382,121,293,223,70,4,1,3,1
4247,731,0,0,147,147,0,1,0,1,0
1039,3095,0,0,139,139,0,1,0,1,0
2099,1989,0,0,78,78,0,1,0,1,0
340,1163,0,0,144,144,0,1,0,1,0
2165,1392,0,0,62,62,0,1,0,1,0
9171,1543,0,0,115,115,0,1,0,1,0
2914,1694,0,0,62,62,0,1,0,1,0
2410,183,8982,121,293,223,70,4,0,3,1
17465,2402,0,0,145,145,0,1,0,1,0
1514,932,0,0,142,142,0,1,0,1,0
1905,786,0,0,76,76,0,1,0,1,0
1280,3056,0,0,143,143,0,1,0,1,0
2150,395,0,0,87,87,0,1,0,1,0
4221,183,14443,121,293,223,70,4,0,3,1
2993,1694,0,0,62,62,0,1,0,1,0
1858,183,7063,121,293,223,70,4,0,3,1
1893,881,0,0,71,71,0,1,0,1,0
2087,1408,0,0,106,106,0,1,0,1,0
1444,1176,0,0,139,139,0,1,0,1,0
903,183,3596,121,293,223,70,4,1,3,1
1414,597,0,0,149,149,0,1,0,1,0
3024,1684,0,0,63,63,0,1,0,1,0
2134,1478,0,0,95,95,0,1,0,1,0
714,2846,0,0,141,141,0,1,0,1,0
9721,1432,0,0,97,97,0,1,0,1,0
11244,1632,0,0,62,62,0,1,0,1,0
383,896,0,0,154,154,0,1,0,1,0
1321,3095,0,0,142,142,0,1,0,1,0
2020,1006,0,0,62,62,0,1,0,1,0
10312,1543,0,0,73,73,0,1,0,1,0
3021,1603,0,0,76,76,0,1,0,1,0
8631,1543,0,0,134,134,0,1,0,1,0
20214,2259,0,0,100,100,0,1,0,1,0
2244,1321,0,0,120,120,0,1,0,1,0
7717,183,14098,121,293,223,70,4,0,3,1
2786,183,10834,121,293,223,70,4,0,3,1
2018,887,0,0,62,62,0,1,0,1,0
2738,1453,0,0,62,62,0,1,0,1,0
2810,1261,0,0,133,133,0,1,0,1,0
2307,1669,0,0,66,66,0,1,0,1,0
2101,183,8359,121,293,223,70,4,0,3,1
1340,3095,0,0,143,143,0,1,0,1,0
2921,1198,0,0,144,144,0,1,0,1,0
9067,1293,0,0,126,126,0,1,0,1,0
7913,2134,0,0,113,113,0,1,0,1,0
10277,1528,0,0,75,75,0,1,0,1,0
19047,2822,0,0,130,130,0,1,0,1,0
1315,183,4403,121,293,223,70,4,1,3,1
1138,1176,0,0,140,140,0,1,0,1,0
2237,1093,0,0,62,62,0,1,0,1,0
1535,183,5489,121,293,223,70,4,0,3,1
995,1009,0,0,154,154,0,1,0,1,0
1868,749,0,0,87,87,0,1,0,1,0
2119,183,8688,121,293,223,70,4,0,3,1
1398,1176,0,0,149,149,0,1,0,1,0
1151,3095,0,0,141,141,0,1,0,1,0
3657,909,0,0,113,113,0,1,0,1,0
8017,1523,0,0,146,146,0,1,0,1,0
4558,362,0,0,146,146,0,1,0,1,0
3468,991,0,0,147,147,0,1,0,1,0
7580,2610,0,0,86,86,0,1,0,1,0
9098,1543,0,0,117,117,0,1,0,1,0
10655,1543,0,0,65,65,0,1,0,1,0
1315,3079,0,0,143,143,0,1,0,1,0
4347,183,15409,121,293,223,70,4,0,3,1
11370,1657,0,0,62,62,0,1,0,1,0
2924,1211,0,0,142,142,0,1,0,1,0
1094,1176,0,0,148,148,0,1,0,1,0
7509,2745,0,0,80,80,0,1,0,1,0
2047,183,8056,121,293,223,70,4,0,3,1
11310,1694,0,0,68,68,0,1,0,1,0
14349,278,0,0,145,145,0,1,0,1,0
324,1155,0,0,144,144,0,1,0,1,0
12477,1880,0,0,80,80,0,1,0,1,0
1707,585,0,0,132,132,0,1,0,1,0
10684,1543,0,0,66,66,0,1,0,1,0
597,2607,0,0,144,144,0,1,0,1,0
2180,1547,0,0,84,84,0,1,0,1,0
2570,1456,0,0,101,101,0,1,0,1,0
9437,1993,0,0,69,69,0,1,0,1,0
2655,1176,0,0,146,146,0,1,0,1,0
16830,1969,0,0,145,145,0,1,0,1,0
1679,591,0,0,147,147,0,1,0,1,0
11098,1673,0,0,73,73,0,1,0,1,0
8296,1408,0,0,150,150,0,1,0,1,0
1927,3095,0,0,153,153,0,1,0,1,0
1947,183,7512,121,293,223,70,4,0,3,1
570,2589,0,0,144,144,0,1,0,1,0
2748,1176,0,0,147,147,0,1,0,1,0
2217,3095,0,0,158,158,0,1,0,1,0
1278,3095,0,0,142,142,0,1,0,1,0
7703,2217,0,0,104,104,0,1,0,1,0
1443,183,5040,121,293,223,70,4,1,3,1
130,1814,0,0,149,149,0,1,0,1,0
9921,1466,0,0,89,89,0,1,0,1,0
1891,3095,0,0,152,152,0,1,0,1,0
3215,183,11809,121,293,223,70,4,0,3,1
2474,60,0,0,62,62,0,1,0,1,0
3616,1024,0,0,105,105,0,1,0,1,0
9807,1543,0,0,92,92,0,1,0,1,0
2290,452,0,0,93,93,0,1,0,1,0
2226,183,9088,121,293,223,70,4,0,3,1
1956,857,0,0,66,66,0,1,0,1,0
128,1803,0,0,149,149,0,1,0,1,0
10394,1543,0,0,71,71,0,1,0,1,0
958,3095,0,0,139,139,0,1,0,1,0
9890,1543,0,0,89,89,0,1,0,1,0
3284,183,12312,121,293,223,70,4,0,3,1
9632,1597,0,0,98,98,0,1,0,1,0
2464,183,8684,121,293,223,70,4,1,3,1
17475,2409,0,0,145,145,0,1,0,1,0
2011,1217,0,0,136,136,0,1,0,1,0
1789,183,6768,121,293,223,70,4,0,3,1
12927,547,0,0,145,145,0,1,0,1,0
2850,1694,0,0,62,62,0,1,0,1,0
13297,622,0,0,121,121,0,1,0,1,0
2590,1694,0,0,62,62,0,1,0,1,0
8294,1401,0,0,150,150,0,1,0,1,0
8257,1239,0,0,155,155,0,1,0,1,0
1939,1087,0,0,121,121,0,1,0,1,0
8064,1521,0,0,139,139,0,1,0,1,0
9646,1257,0,0,145,145,0,1,0,1,0
2428,1267,0,0,62,62,0,1,0,1,0
6646,771,0,0,146,146,0,1,0,1,0
2975,1415,0,0,108,108,0,1,0,1,0
1597,1176,0,0,140,140,0,1,0,1,0
2807,1694,0,0,62,62,0,1,0,1,0
1233,183,4235,121,293,223,70,4,1,3,1
2246,3033,0,0,154,154,0,1,0,1,0
13158,2077,0,0,97,97,0,1,0,1,0
43,1184,0,0,155,155,0,1,0,1,0
2116,1263,0,0,62,62,0,1,0,1,0
2672,1488,0,0,62,62,0,1,0,1,0
4869,183,16151,121,293,223,70,4,0,3,1
11054,1631,0,0,66,66,0,1,0,1,0
1919,2287,0,0,94,94,0,1,0,1,0
13452,695,0,0,119,119,0,1,0,1,0
8327,1693,0,0,146,146,0,1,0,1,0
1886,885,0,0,72,72,0,1,0,1,0
648,1148,0,0,157,157,0,1,0,1,0
8811,1543,0,0,129,129,0,1,0,1,0
1349,3095,0,0,142,142,0,1,0,1,0
2064,1125,0,0,62,62,0,1,0,1,0
10754,1546,0,0,63,63,0,1,0,1,0
278,1132,0,0,146,146,0,1,0,1,0
10394,1543,0,0,71,71,0,1,0,1,0
2047,183,8050,121,293,223,70,4,0,3,1
9967,1594,0,0,90,90,0,1,0,1,0
449,1176,0,0,145,145,0,1,0,1,0
8307,1455,0,0,148,148,0,1,0,1,0
2995,183,10045,121,293,223,70,4,1,3,1
21185,1791,0,0,75,75,0,1,0,1,0
2126,1466,0,0,97,97,0,1,0,1,0
1462,1155,0,0,134,134,0,1,0,1,0
349,2046,0,0,148,148,0,1,0,1,0
8227,1639,0,0,146,146,0,1,0,1,0
2273,1868,0,0,74,74,0,1,0,1,0
388,1176,0,0,143,143,0,1,0,1,0
8705,1256,0,0,138,138,0,1,0,1,0
9790,1444,0,0,94,94,0,1,0,1,0
8327,1689,0,0,146,146,0,1,0,1,0
8290,1383,0,0,150,150,0,1,0,1,0
8327,1552,0,0,146,146,0,1,0,1,0
2578,1176,0,0,146,146,0,1,0,1,0
1753,632,0,0,119,119,0,1,0,1,0
1531,882,0,0,143,143,0,1,0,1,0
1529,183,5469,121,293,223,70,4,0,3,1
2473,1694,0,0,62,62,0,1,0,1,0
165,2069,0,0,147,147,0,1,0,1,0
1895,183,7296,121,293,223,70,4,0,3,1
7635,183,14689,121,293,223,70,4,0,3,1
11163,183,20899,121,293,223,70,4,0,3,1
1039,183,3860,121,293,223,70,4,1,3,1
1570,183,5677,121,293,223,70,4,0,3,1
9400,1543,0,0,106,106,0,1,0,1,0
448,1176,0,0,142,142,0,1,0,1,0
2046,945,0,0,127,127,0,1,0,1,0
2391,185,0,0,62,62,0,1,0,1,0
10380,1543,0,0,76,76,0,1,0,1,0
10619,1575,0,0,69,69,0,1,0,1,0
16196,1543,0,0,66,66,0,1,0,1,0
7149,2828,0,0,68,68,0,1,0,1,0
8931,1295,0,0,129,129,0,1,0,1,0
1411,183,4886,121,293,223,70,4,0,3,1
2063,1562,0,0,81,81,0,1,0,1,0
700,1316,0,0,155,155,0,1,0,1,0
1956,3095,0,0,151,151,0,1,0,1,0
1602,674,0,0,145,145,0,1,0,1,0
3310,183,11690,121,293,223,70,4,1,3,1
2931,1239,0,0,137,137,0,1,0,1,0
1438,183,5013,121,293,223,70,4,1,3,1
2595,2344,0,0,107,107,0,1,0,1,0
2994,1694,0,0,62,62,0,1,0,1,0
2975,183,10482,121,293,223,70,4,0,3,1
2912,1176,0,0,147,147,0,1,0,1,0
1961,183,7598,121,293,223,70,4,0,3,1
316,1537,0,0,143,143,0,1,0,1,0
3281,183,11588,121,293,223,70,4,1,3,1
1147,183,4267,121,293,223,70,4,1,3,1
2302,2971,0,0,150,150,0,1,0,1,0
2346,183,8265,121,293,223,70,4,1,3,1
1563,1176,0,0,140,140,0,1,0,1,0
9560,1543,0,0,101,101,0,1,0,1,0
8327,1665,0,0,146,146,0,1,0,1,0
1018,183,3915,121,293,223,70,4,1,3,1
2115,183,8524,121,293,223,70,4,0,3,1
9521,1358,0,0,109,109,0,1,0,1,0
1872,1035,0,0,144,144,0,1,0,1,0
881,1176,0,0,141,141,0,1,0,1,0
13232,646,0,0,119,119,0,1,0,1,0
1951,929,0,0,83,83,0,1,0,1,0
1110,183,4166,121,293,223,70,4,1,3,1
299,2490,0,0,143,143,0,1,0,1,0
5682,252,0,0,146,146,0,1,0,1,0
2258,1176,0,0,144,144,0,1,0,1,0
1939,1084,0,0,121,121,0,1,0,1,0
10363,1543,0,0,71,71,0,1,0,1,0
1346,183,4558,121,293,223,70,4,0,3,1
17465,2401,0,0,145,145,0,1,0,1,0
1950,940,0,0,86,86,0,1,0,1,0
1947,183,7969,121,293,223,70,4,0,3,1
2903,1546,0,0,86,86,0,1,0,1,0
8505,1221,0,0,146,146,0,1,0,1,0
1641,534,0,0,147,147,0,1,0,1,0
15701,493,0,0,129,129,0,1,0,1,0
3361,896,0,0,147,147,0,1,0,1,0
8386,1543,0,0,143,143,0,1,0,1,0
650,642,1922,64,223,185,37,2,0,2,0
1367,183,4663,121,293,223,70,4,1,3,1
4738,183,16219,121,293,223,70,4,1,3,1
8299,1522,0,0,149,149,0,1,0,1,0
1399,183,4953,121,293,223,70,4,1,3,1
1546,1102,0,0,122,122,0,1,0,1,0
1851,1176,0,0,142,142,0,1,0,1,0
1526,183,5451,121,293,223,70,4,0,3,1
1303,183,4372,121,293,223,70,4,1,3,1
1494,183,5291,121,293,223,70,4,0,3,1
4051,463,0,0,146,146,0,1,0,1,0
1072,1176,0,0,140,140,0,1,0,1,0
885,201,3514,118,290,221,68,3,0,2,0
9933,1417,0,0,94,94,0,1,0,1,0
2901,1608,0,0,76,76,0,1,0,1,0
2881,1694,0,0,62,62,0,1,0,1,0
1451,183,5076,121,293,223,70,4,1,3,1
96,1012,0,0,155,155,0,1,0,1,0
1758,774,0,0,146,146,0,1,0,1,0
8716,1670,0,0,132,132,0,1,0,1,0
1525,3095,0,0,141,141,0,1,0,1,0
8048,2052,0,0,123,123,0,1,0,1,0
2250,162,0,0,88,88,0,1,0,1,0
8902,1659,0,0,126,126,0,1,0,1,0
11144,1642,0,0,65,65,0,1,0,1,0
17677,2546,0,0,145,145,0,1,0,1,0
691,1176,0,0,154,154,0,1,0,1,0
811,1100,0,0,146,146,0,1,0,1,0
127,1057,0,0,152,152,0,1,0,1,0
2776,769,0,0,118,118,0,1,0,1,0
2174,1305,0,0,122,122,0,1,0,1,0
4521,183,15949,121,293,223,70,4,1,3,1
2914,1694,0,0,62,62,0,1,0,1,0
2500,1694,0,0,62,62,0,1,0,1,0
984,3095,0,0,140,140,0,1,0,1,0
11948,1483,0,0,74,74,0,1,0,1,0
468,982,696,23,172,158,13,1,0,1,0
7675,2532,0,0,94,94,0,1,0,1,0
1434,183,5831,121,293,223,70,4,0,3,1
1053,3095,0,0,139,139,0,1,0,1,0
1899,1099,0,0,143,143,0,1,0,1,0
12655,1981,0,0,92,92,0,1,0,1,0
5408,277,0,0,146,146,0,1,0,1,0
1417,1176,0,0,139,139,0,1,0,1,0
75,1417,0,0,153,153,0,1,0,1,0
2955,1694,0,0,62,62,0,1,0,1,0
1771,1176,0,0,141,141,0,1,0,1,0
2904,1532,0,0,88,88,0,1,0,1,0
1993,183,7786,121,293,223,70,4,0,3,1
1751,183,6655,121,293,223,70,4,0,3,1
1944,183,7497,121,293,223,70,4,0,3,1
2982,1446,0,0,103,103,0,1,0,1,0
1575,1176,0,0,140,140,0,1,0,1,0
5260,393,0,0,146,146,0,1,0,1,0
8249,1202,0,0,156,156,0,1,0,1,0
1482,183,5229,121,293,223,70,4,0,3,1
1998,3095,0,0,152,152,0,1,0,1,0
743,1944,0,0,149,149,0,1,0,1,0
1477,1038,0,0,140,140,0,1,0,1,0
2550,1472,0,0,98,98,0,1,0,1,0
7364,2874,0,0,70,70,0,1,0,1,0
2228,431,0,0,62,62,0,1,0,1,0
342,1077,0,0,157,157,0,1,0,1,0
1252,730,0,0,146,146,0,1,0,1,0
1585,183,5522,121,293,223,70,4,1,3,1
21657,1399,3001,12,86,78,7,1,0,1,0
1615,547,0,0,147,147,0,1,0,1,0
19627,1543,0,0,62,62,0,1,0,1,0
9116,1543,0,0,119,119,0,1,0,1,0
2093,183,8313,121,293,223,70,4,0,3,1
2145,3095,0,0,156,156,0,1,0,1,0
2771,1176,0,0,147,147,0,1,0,1,0
1106,3095,0,0,141,141,0,1,0,1,0
8327,1641,0,0,146,146,0,1,0,1,0
2185,665,0,0,107,107,0,1,0,1,0
7224,1001,0,0,146,146,0,1,0,1,0
1382,1176,0,0,139,139,0,1,0,1,0
1935,355,0,0,119,119,0,1,0,1,0
1006,3095,0,0,139,139,0,1,0,1,0
2904,183,10520,121,293,223,70,4,0,3,1
1231,183,4889,121,293,223,70,4,0,3,1
7285,3034,0,0,62,62,0,1,0,1,0
2391,1601,0,0,77,77,0,1,0,1,0
7173,2870,0,0,67,67,0,1,0,1,0
45,1009,0,0,157,157,0,1,0,1,0
1137,1176,0,0,146,146,0,1,0,1,0
7376,2916,0,0,70,70,0,1,0,1,0
1668,183,6431,121,293,223,70,4,0,3,1
2979,1431,0,0,105,105,0,1,0,1,0
521,1688,0,0,151,151,0,1,0,1,0
2256,2617,0,0,125,125,0,1,0,1,0
859,1109,0,0,156,156,0,1,0,1,0
116,1025,0,0,157,157,0,1,0,1,0
1962,183,7595,121,293,223,70,4,0,3,1
1735,183,6464,121,293,223,70,4,0,3,1
2027,1219,0,0,136,136,0,1,0,1,0
947,183,3772,121,293,223,70,4,0,3,1
1298,3013,0,0,139,139,0,1,0,1,0
8266,1278,0,0,153,153,0,1,0,1,0
17334,2313,0,0,145,145,0,1,0,1,0
13469,686,0,0,119,119,0,1,0,1,0
2393,1694,0,0,62,62,0,1,0,1,0
618,1176,0,0,151,151,0,1,0,1,0
1319,183,4425,121,293,223,70,4,1,3,1
1468,1151,0,0,133,133,0,1,0,1,0
1953,1207,0,0,138,138,0,1,0,1,0
8312,1602,0,0,147,147,0,1,0,1,0
20425,2158,0,0,94,94,0,1,0,1,0
10712,1427,0,0,78,78,0,1,0,1,0
829,3095,0,0,139,139,0,1,0,1,0
1346,183,4560,121,293,223,70,4,1,3,1
1705,183,6315,121,293,223,70,4,0,3,1
799,931,880,29,190,173,17,1,0,1,0
347,1312,0,0,143,143,0,1,0,1,0
2097,1422,0,0,104,104,0,1,0,1,0
1914,795,0,0,74,74,0,1,0,1,0
2479,1530,0,0,89,89,0,1,0,1,0
20630,2059,0,0,89,89,0,1,0,1,0
909,183,3619,121,293,223,70,4,1,3,1
566,2587,0,0,144,144,0,1,0,1,0
1376,183,4701,121,293,223,70,4,0,3,1
1797,1176,0,0,144,144,0,1,0,1,0
2166,1527,0,0,88,88,0,1,0,1,0
2029,183,7997,121,293,223,70,4,0,3,1
1855,1176,0,0,142,142,0,1,0,1,0
2821,1694,0,0,62,62,0,1,0,1,0
1850,730,0,0,92,92,0,1,0,1,0
8563,1679,0,0,137,137,0,1,0,1,0
2177,1860,0,0,71,71,0,1,0,1,0
2883,183,11121,121,293,223,70,4,0,3,1
1211,183,4193,121,293,223,70,4,1,3,1
1766,1176,0,0,145,145,0,1,0,1,0
429,1176,0,0,142,142,0,1,0,1,0
8619,1543,0,0,136,136,0,1,0,1,0
1692,622,0,0,147,147,0,1,0,1,0
1942,1047,0,0,112,112,0,1,0,1,0
3901,690,0,0,127,127,0,1,0,1,0
2910,1332,0,0,122,122,0,1,0,1,0
2963,1694,0,0,62,62,0,1,0,1,0
15252,1543,0,0,67,67,0,1,0,1,0
4453,183,15749,121,293,223,70,4,1,3,1
2005,1285,0,0,125,125,0,1,0,1,0
1189,317,2185,73,236,193,42,2,0,2,0
703,1176,0,0,154,154,0,1,0,1,0
11173,1617,0,0,62,62,0,1,0,1,0
3484,183,12172,121,293,223,70,4,0,3,1
7740,2448,0,0,99,99,0,1,0,1,0
2662,2199,0,0,97,97,0,1,0,1,0
2346,340,0,0,85,85,0,1,0,1,0
1489,1176,0,0,139,139,0,1,0,1,0
599,1176,0,0,151,151,0,1,0,1,0
2249,1617,0,0,62,62,0,1,0,1,0
18028,2785,0,0,145,145,0,1,0,1,0
9259,1352,0,0,116,116,0,1,0,1,0
5687,249,0,0,146,146,0,1,0,1,0
3508,183,11689,121,293,223,70,4,1,3,1
1879,1053,0,0,143,143,0,1,0,1,0
2925,1694,0,0,62,62,0,1,0,1,0
3277,188,0,0,101,101,0,1,0,1,0
2925,1213,0,0,141,141,0,1,0,1,0
10508,1500,0,0,73,73,0,1,0,1,0
1851,183,7156,121,293,223,70,4,0,3,1
2025,183,8056,121,293,223,70,4,0,3,1
1668,183,6138,121,293,223,70,4,0,3,1
2184,202,0,0,94,94,0,1,0,1,0
17840,2965,0,0,137,137,0,1,0,1,0
2929,1694,0,0,62,62,0,1,0,1,0
1948,967,0,0,92,92,0,1,0,1,0
1200,3095,0,0,139,139,0,1,0,1,0
4106,183,14608,121,293,223,70,4,0,3,1
261,2228,0,0,146,146,0,1,0,1,0
2020,1007,0,0,62,62,0,1,0,1,0
9428,1612,0,0,105,105,0,1,0,1,0
1460,3095,0,0,148,148,0,1,0,1,0
2608,1351,0,0,62,62,0,1,0,1,0
1406,183,4857,121,293,223,70,4,1,3,1
31,1009,0,0,156,156,0,1,0,1,0
2060,183,8126,121,293,223,70,4,0,3,1
12878,996,0,0,102,102,0,1,0,1,0
8728,1669,0,0,132,132,0,1,0,1,0
1917,183,7354,121,293,223,70,4,0,3,1
16146,183,23273,121,293,223,70,4,0,3,1
18263,1594,0,0,62,62,0,1,0,1,0
15991,1627,0,0,62,62,0,1,0,1,0
2794,1918,0,0,77,77,0,1,0,1,0
903,183,3602,121,293,223,70,4,1,3,1
7519,2698,0,0,81,81,0,1,0,1,0
5582,286,0,0,146,146,0,1,0,1,0
811,838,1216,41,203,179,23,2,0,1,0
1382,3095,0,0,141,141,0,1,0,1,0
2111,3095,0,0,155,155,0,1,0,1,0
1710,588,0,0,131,131,0,1,0,1,0
10248,1462,0,0,82,82,0,1,0,1,0
1742,977,0,0,93,93,0,1,0,1,0
10972,1576,0,0,62,62,0,1,0,1,0
20832,1390,0,0,71,71,0,1,0,1,0
11094,183,18178,121,293,223,70,4,0,3,1
6288,575,0,0,146,146,0,1,0,1,0
1598,183,5815,121,293,223,70,4,0,3,1
247,2412,0,0,144,144,0,1,0,1,0
1428,183,4986,121,293,223,70,4,0,3,1
18516,3078,0,0,144,144,0,1,0,1,0
8436,1543,0,0,142,142,0,1,0,1,0
3746,183,13682,121,293,223,70,4,0,3,1
381,2611,0,0,142,142,0,1,0,1,0
2243,183,9183,121,293,223,70,4,0,3,1
1757,183,6607,121,293,223,70,4,0,3,1
6731,183,17826,121,293,223,70,4,0,3,1
1943,825,0,0,66,66,0,1,0,1,0
1664,1176,0,0,140,140,0,1,0,1,0
686,2642,0,0,142,142,0,1,0,1,0
1117,183,4011,121,293,223,70,4,1,3,1
2906,1461,0,0,100,100,0,1,0,1,0
8327,1557,0,0,146,146,0,1,0,1,0
2295,183,9364,121,293,223,70,4,0,3,1
8281,1413,0,0,151,151,0,1,0,1,0
8309,1588,0,0,148,148,0,1,0,1,0
1745,744,0,0,146,146,0,1,0,1,0
8331,1543,0,0,145,145,0,1,0,1,0
8825,1543,0,0,127,127,0,1,0,1,0
1850,1176,0,0,142,142,0,1,0,1,0
7646,2515,0,0,91,91,0,1,0,1,0
2075,1390,0,0,109,109,0,1,0,1,0
11497,1684,0,0,62,62,0,1,0,1,0
10367,1543,0,0,71,71,0,1,0,1,0
2434,1176,0,0,145,145,0,1,0,1,0
13546,413,0,0,145,145,0,1,0,1,0
1719,685,0,0,146,146,0,1,0,1,0
2310,308,0,0,62,62,0,1,0,1,0
2218,3095,0,0,158,158,0,1,0,1,0
18831,1543,0,0,62,62,0,1,0,1,0
2255,1727,0,0,63,63,0,1,0,1,0
2769,1694,0,0,62,62,0,1,0,1,0
2005,768,0,0,62,62,0,1,0,1,0
19337,2682,0,0,122,122,0,1,0,1,0
1064,2871,0,0,140,140,0,1,0,1,0
2234,183,9129,121,293,223,70,4,0,3,1
8327,1554,0,0,146,146,0,1,0,1,0
1729,708,0,0,146,146,0,1,0,1,0
1702,1176,0,0,141,141,0,1,0,1,0
8088,2000,0,0,126,126,0,1,0,1,0
562,845,0,0,154,154,0,1,0,1,0
635,2989,0,0,139,139,0,1,0,1,0
722,3095,0,0,139,139,0,1,0,1,0
1778,1176,0,0,141,141,0,1,0,1,0
2165,183,8731,121,293,223,70,4,0,3,1
21464,757,16446,69,195,155,40,2,0,2,0
82,1035,0,0,154,154,0,1,0,1,0
1569,3095,0,0,147,147,0,1,0,1,0
4868,183,16379,121,293,223,70,4,1,3,1
759,1437,0,0,154,154,0,1,0,1,0
2082,1400,0,0,107,107,0,1,0,1,0
2095,183,8350,121,293,223,70,4,0,3,1
1649,3095,0,0,148,148,0,1,0,1,0
234,2126,0,0,144,144,0,1,0,1,0
9679,1381,0,0,103,103,0,1,0,1,0
781,1165,0,0,156,156,0,1,0,1,0
8583,1224,0,0,144,144,0,1,0,1,0
44,1196,0,0,155,155,0,1,0,1,0
1946,183,7509,121,293,223,70,4,0,3,1
8255,1232,0,0,155,155,0,1,0,1,0
1735,1176,0,0,141,141,0,1,0,1,0
2717,51,0,0,72,72,0,1,0,1,0
4564,183,16002,121,293,223,70,4,1,3,1
4733,183,16213,121,293,223,70,4,1,3,1
1843,723,0,0,94,94,0,1,0,1,0
10132,1559,0,0,80,80,0,1,0,1,0
1287,183,4339,121,293,223,70,4,1,3,1
1171,3095,0,0,141,141,0,1,0,1,0
3558,1092,0,0,101,101,0,1,0,1,0
1621,183,5904,121,293,223,70,4,0,3,1
1821,1176,0,0,142,142,0,1,0,1,0
1909,790,0,0,75,75,0,1,0,1,0
5497,268,0,0,146,146,0,1,0,1,0
9551,1363,0,0,108,108,0,1,0,1,0
3154,158,0,0,94,94,0,1,0,1,0
1542,609,0,0,149,149,0,1,0,1,0
8322,1669,0,0,146,146,0,1,0,1,0
1006,183,3884,121,293,223,70,4,1,3,1
2044,183,8158,121,293,223,70,4,0,3,1
8352,1194,0,0,152,152,0,1,0,1,0
13031,1992,0,0,86,86,0,1,0,1,0
8313,1609,0,0,147,147,0,1,0,1,0
21493,852,14451,61,179,143,35,2,0,2,0
288,2173,0,0,146,146,0,1,0,1,0
3543,1027,0,0,105,105,0,1,0,1,0
2220,183,9049,121,293,223,70,4,0,3,1
1866,183,7103,121,293,223,70,4,0,3,1
2452,93,0,0,62,62,0,1,0,1,0
1740,183,6487,121,293,223,70,4,0,3,1
2908,1630,0,0,71,71,0,1,0,1,0
2096,183,8429,121,293,223,70,4,0,3,1
2259,2465,0,0,115,115,0,1,0,1,0
253,2246,0,0,146,146,0,1,0,1,0
2004,963,0,0,62,62,0,1,0,1,0
10696,1543,0,0,64,64,0,1,0,1,0
2301,1176,0,0,144,144,0,1,0,1,0
2245,3059,0,0,156,156,0,1,0,1,0
1100,183,3978,121,293,223,70,4,1,3,1
1489,3095,0,0,145,145,0,1,0,1,0
7483,2644,0,0,82,82,0,1,0,1,0
2307,183,8819,121,293,223,70,4,0,3,1
2988,1694,0,0,62,62,0,1,0,1,0
2251,2804,0,0,138,138,0,1,0,1,0
8189,1475,0,0,146,146,0,1,0,1,0
1523,183,6200,121,293,223,70,4,0,3,1
1715,593,0,0,130,130,0,1,0,1,0
2062,1562,0,0,81,81,0,1,0,1,0
8110,1432,0,0,144,144,0,1,0,1,0
2905,1481,0,0,97,97,0,1,0,1,0
19894,1569,0,0,62,62,0,1,0,1,0
4788,183,16281,121,293,223,70,4,1,3,1
8808,1543,0,0,128,128,0,1,0,1,0
20515,2114,0,0,92,92,0,1,0,1,0
11171,1617,0,0,62,62,0,1,0,1,0
1684,183,6209,121,293,223,70,4,0,3,1
3705,183,13559,121,293,223,70,4,0,3,1
906,745,0,0,152,152,0,1,0,1,0
588,1549,0,0,153,153,0,1,0,1,0
1280,3095,0,0,139,139,0,1,0,1,0
1175,3095,0,0,145,145,0,1,0,1,0
2149,183,8639,121,293,223,70,4,0,3,1
739,2069,0,0,148,148,0,1,0,1,0
1516,390,1751,48,205,177,27,2,0,1,0
1460,1090,0,0,140,140,0,1,0,1,0
10921,1566,0,0,62,62,0,1,0,1,0
1747,748,0,0,146,146,0,1,0,1,0
1009,1124,0,0,144,144,0,1,0,1,0
327,2532,0,0,143,143,0,1,0,1,0
2650,2226,0,0,98,98,0,1,0,1,0
7512,910,0,0,153,153,0,1,0,1,0
6764,638,0,0,150,150,0,1,0,1,0
2227,183,9097,121,293,223,70,4,0,3,1
1804,880,0,0,145,145,0,1,0,1,0
16056,2604,0,0,118,118,0,1,0,1,0
9946,1419,0,0,93,93,0,1,0,1,0
1748,750,0,0,146,146,0,1,0,1,0
736,1168,0,0,157,157,0,1,0,1,0
10007,1591,0,0,89,89,0,1,0,1,0
1167,183,4323,121,293,223,70,4,1,3,1
17414,2367,0,0,145,145,0,1,0,1,0
1372,183,4686,121,293,223,70,4,1,3,1
194,1043,0,0,157,157,0,1,0,1,0
13783,362,0,0,145,145,0,1,0,1,0
743,1948,0,0,149,149,0,1,0,1,0
1508,183,5347,121,293,223,70,4,0,3,1
948,3095,0,0,140,140,0,1,0,1,0
986,183,3757,121,293,223,70,4,1,3,1
8291,1472,0,0,150,150,0,1,0,1,0
8088,2000,0,0,126,126,0,1,0,1,0
7766,2097,0,0,110,110,0,1,0,1,0
7836,2245,0,0,106,106,0,1,0,1,0
839,3095,0,0,139,139,0,1,0,1,0
8298,1519,0,0,149,149,0,1,0,1,0
1926,859,0,0,66,66,0,1,0,1,0
5838,319,0,0,146,146,0,1,0,1,0
647,648,1901,64,222,185,37,2,0,2,0
21362,1706,0,0,70,70,0,1,0,1,0
7770,2409,0,0,101,101,0,1,0,1,0
106,1023,0,0,157,157,0,1,0,1,0
2095,1966,0,0,77,77,0,1,0,1,0
1393,183,4789,121,293,223,70,4,1,3,1
1323,3084,0,0,143,143,0,1,0,1,0
2948,1306,0,0,126,126,0,1,0,1,0
4472,183,15834,121,293,223,70,4,0,3,1
1627,183,6279,121,293,223,70,4,0,3,1
10750,1543,0,0,63,63,0,1,0,1,0
4613,183,16064,121,293,223,70,4,1,3,1
17570,2474,0,0,145,145,0,1,0,1,0
1985,1069,0,0,135,135,0,1,0,1,0
1973,183,7654,121,293,223,70,4,0,3,1
2222,1610,0,0,75,75,0,1,0,1,0
266,1897,0,0,144,144,0,1,0,1,0
20022,183,27118,121,293,223,70,4,0,3,1
1943,1032,0,0,108,108,0,1,0,1,0
12073,981,0,0,103,103,0,1,0,1,0
10641,1543,0,0,65,65,0,1,0,1,0
8600,1673,0,0,136,136,0,1,0,1,0
17888,183,25029,121,293,223,70,4,0,3,1
2866,1664,0,0,62,62,0,1,0,1,0
16595,1543,0,0,66,66,0,1,0,1,0
2385,1606,0,0,76,76,0,1,0,1,0
3299,183,11018,121,293,223,70,4,1,3,1
1441,3078,0,0,138,138,0,1,0,1,0
5416,276,0,0,146,146,0,1,0,1,0
1283,183,4333,121,293,223,70,4,1,3,1
2844,1694,0,0,62,62,0,1,0,1,0
2978,1429,0,0,105,105,0,1,0,1,0
289,1138,0,0,146,146,0,1,0,1,0
3514,183,11708,121,293,223,70,4,1,3,1
2058,688,0,0,62,62,0,1,0,1,0
15139,2419,0,0,105,105,0,1,0,1,0
268,1879,0,0,144,144,0,1,0,1,0
2993,1694,0,0,62,62,0,1,0,1,0
2471,1243,0,0,62,62,0,1,0,1,0
2491,46,0,0,65,65,0,1,0,1,0
2328,1694,0,0,62,62,0,1,0,1,0
1775,3095,0,0,147,147,0,1,0,1,0
8327,1543,0,0,146,146,0,1,0,1,0
745,1888,0,0,150,150,0,1,0,1,0
1557,183,5588,121,293,223,70,4,0,3,1
15381,982,0,0,145,145,0,1,0,1,0
2374,282,0,0,81,81,0,1,0,1,0
7879,2182,0,0,110,110,0,1,0,1,0
17636,2924,0,0,134,134,0,1,0,1,0
1186,183,4373,121,293,223,70,4,1,3,1
2808,1176,0,0,147,147,0,1,0,1,0
2771,1694,0,0,62,62,0,1,0,1,0
535,1176,0,0,148,148,0,1,0,1,0
620,2967,0,0,140,140,0,1,0,1,0
2153,1294,0,0,124,124,0,1,0,1,0
1543,183,5521,121,293,223,70,4,0,3,1
2100,3095,0,0,157,157,0,1,0,1,0
2979,1434,0,0,105,105,0,1,0,1,0
6267,563,0,0,146,146,0,1,0,1,0
438,1176,0,0,145,145,0,1,0,1,0
5630,270,0,0,146,146,0,1,0,1,0
2575,181,0,0,75,75,0,1,0,1,0
2070,183,8182,121,293,223,70,4,0,3,1
2766,183,10126,121,293,223,70,4,0,3,1
2155,183,8732,121,293,223,70,4,0,3,1
1751,183,6541,121,293,223,70,4,0,3,1
863,241,3369,113,284,218,65,3,0,2,0
337,2436,0,0,144,144,0,1,0,1,0
2094,183,8417,121,293,223,70,4,0,3,1
4026,183,14342,121,293,223,70,4,0,3,1
1950,939,0,0,85,85,0,1,0,1,0
2675,473,0,0,96,96,0,1,0,1,0
2385,1387,0,0,110,110,0,1,0,1,0
4083,183,14583,121,293,223,70,4,0,3,1
17934,183,25075,121,293,223,70,4,0,3,1
9762,1439,0,0,96,96,0,1,0,1,0
2005,183,7956,121,293,223,70,4,0,3,1
11361,1670,0,0,63,63,0,1,0,1,0
19546,1575,0,0,62,62,0,1,0,1,0
9544,1401,0,0,104,104,0,1,0,1,0
1343,3095,0,0,142,142,0,1,0,1,0
1095,2934,0,0,143,143,0,1,0,1,0
1708,183,6750,121,293,223,70,4,0,3,1
677,590,2109,71,231,190,41,2,0,2,0
1659,1030,0,0,105,105,0,1,0,1,0
1386,723,0,0,150,150,0,1,0,1,0
10440,1085,0,0,145,145,0,1,0,1,0
3672,183,12996,121,293,223,70,4,0,3,1
2787,68,0,0,76,76,0,1,0,1,0
2751,1694,0,0,62,62,0,1,0,1,0
1224,3095,0,0,139,139,0,1,0,1,0
9807,1612,0,0,107,107,0,1,0,1,0
1499,183,5935,121,293,223,70,4,0,3,1
21573,1119,8869,37,133,112,21,1,0,1,0
348,2436,0,0,144,144,0,1,0,1,0
16777,183,23909,121,293,223,70,4,0,3,1
1939,1084,0,0,120,120,0,1,0,1,0
10993,1580,0,0,62,62,0,1,0,1,0
3725,840,0,0,117,117,0,1,0,1,0
9070,1577,0,0,126,126,0,1,0,1,0
10272,183,17348,121,293,223,70,4,0,3,1
7484,2748,0,0,78,78,0,1,0,1,0
16245,2667,0,0,124,124,0,1,0,1,0
2068,183,8281,121,293,223,70,4,0,3,1
10120,1501,0,0,81,81,0,1,0,1,0
139,1880,0,0,149,149,0,1,0,1,0
1590,709,0,0,145,145,0,1,0,1,0
4151,763,0,0,147,147,0,1,0,1,0
7548,2519,0,0,88,88,0,1,0,1,0
4756,342,0,0,146,146,0,1,0,1,0
2934,1694,0,0,62,62,0,1,0,1,0
7333,1054,0,0,146,146,0,1,0,1,0
1899,3095,0,0,150,150,0,1,0,1,0
1526,3095,0,0,141,141,0,1,0,1,0
3814,183,13882,121,293,223,70,4,0,3,1
4940,183,16470,121,293,223,70,4,1,3,1
8158,1784,0,0,132,132,0,1,0,1,0
4892,183,16409,121,293,223,70,4,1,3,1
1041,1176,0,0,149,149,0,1,0,1,0
700,3085,0,0,139,139,0,1,0,1,0
1429,183,4969,121,293,223,70,4,1,3,1
10553,1543,0,0,67,67,0,1,0,1,0
2946,1297,0,0,127,127,0,1,0,1,0
3250,182,0,0,99,99,0,1,0,1,0
7330,2940,0,0,67,67,0,1,0,1,0
897,183,3584,121,293,223,70,4,1,3,1
1278,1176,0,0,143,143,0,1,0,1,0
8254,1249,0,0,155,155,0,1,0,1,0
11423,1678,0,0,63,63,0,1,0,1,0
8196,1730,0,0,135,135,0,1,0,1,0
2211,185,0,0,92,92,0,1,0,1,0
1934,1160,0,0,139,139,0,1,0,1,0
1933,356,0,0,119,119,0,1,0,1,0
4465,658,0,0,146,146,0,1,0,1,0
2065,183,8155,121,293,223,70,4,0,3,1
244,1055,0,0,157,157,0,1,0,1,0
3024,1613,0,0,75,75,0,1,0,1,0
478,1176,0,0,146,146,0,1,0,1,0
21459,739,16823,71,198,157,41,2,0,2,0
2725,1176,0,0,147,147,0,1,0,1,0
1555,183,6153,121,293,223,70,4,0,3,1
2173,183,8789,121,293,223,70,4,0,3,1
11329,1649,0,0,62,62,0,1,0,1,0
9330,1331,0,0,116,116,0,1,0,1,0
967,873,0,0,145,145,0,1,0,1,0
1370,610,0,0,149,149,0,1,0,1,0
10112,1561,0,0,81,81,0,1,0,1,0
1317,3095,0,0,142,142,0,1,0,1,0
2513,1,0,0,62,62,0,1,0,1,0
4722,573,0,0,146,146,0,1,0,1,0
8260,1250,0,0,154,154,0,1,0,1,0
13676,481,0,0,130,130,0,1,0,1,0
7812,2355,0,0,104,104,0,1,0,1,0
2417,1176,0,0,145,145,0,1,0,1,0
1921,1150,0,0,143,143,0,1,0,1,0
7296,3038,0,0,62,62,0,1,0,1,0
1949,956,0,0,89,89,0,1,0,1,0
610,1503,0,0,153,153,0,1,0,1,0
5822,183,12093,121,293,223,70,4,0,3,1
13431,572,0,0,124,124,0,1,0,1,0
18495,1590,0,0,62,62,0,1,0,1,0
742,1984,0,0,149,149,0,1,0,1,0
2913,1251,0,0,135,135,0,1,0,1,0
1550,3095,0,0,141,141,0,1,0,1,0
2126,3095,0,0,156,156,0,1,0,1,0
6261,528,0,0,146,146,0,1,0,1,0
2232,1625,0,0,72,72,0,1,0,1,0
1064,824,0,0,145,145,0,1,0,1,0
12002,1455,0,0,75,75,0,1,0,1,0
643,1147,0,0,157,157,0,1,0,1,0
3838,183,13565,121,293,223,70,4,1,3,1
1148,183,4270,121,293,223,70,4,1,3,1
12507,638,0,0,145,145,0,1,0,1,0
2902,1580,0,0,80,80,0,1,0,1,0
570,2891,0,0,140,140,0,1,0,1,0
9797,1584,0,0,92,92,0,1,0,1,0
1409,183,4869,121,293,223,70,4,1,3,1
4369,690,0,0,146,146,0,1,0,1,0
129,1058,0,0,152,152,0,1,0,1,0
16948,1543,0,0,66,66,0,1,0,1,0
8247,1196,0,0,156,156,0,1,0,1,0
9788,1694,0,0,107,107,0,1,0,1,0
1780,183,7029,121,293,223,70,4,0,3,1
2392,183,9178,121,293,223,70,4,0,3,1
2113,183,8518,121,293,223,70,4,0,3,1
21344,356,24822,105,263,202,61,3,0,2,0
1967,825,0,0,62,62,0,1,0,1,0
9783,1396,0,0,99,99,0,1,0,1,0
874,3095,0,0,139,139,0,1,0,1,0
264,1911,0,0,144,144,0,1,0,1,0
1852,1176,0,0,143,143,0,1,0,1,0
214,2275,0,0,144,144,0,1,0,1,0
1870,1031,0,0,144,144,0,1,0,1,0
1365,183,4648,121,293,223,70,4,0,3,1
4898,183,16417,121,293,223,70,4,1,3,1
2098,1424,0,0,104,104,0,1,0,1,0
8875,1285,0,0,131,131,0,1,0,1,0
1704,183,6310,121,293,223,70,4,0,3,1
1525,183,5453,121,293,223,70,4,0,3,1
121,1054,0,0,152,152,0,1,0,1,0
11497,1684,0,0,62,62,0,1,0,1,0
7420,2840,0,0,73,73,0,1,0,1,0
2075,183,8239,121,293,223,70,4,0,3,1
487,2769,0,0,141,141,0,1,0,1,0
10815,1600,0,0,68,68,0,1,0,1,0
2088,942,0,0,62,62,0,1,0,1,0
21653,1386,3273,13,88,80,8,1,0,1,0
3005,1694,0,0,62,62,0,1,0,1,0
1338,183,5307,121,293,223,70,4,0,3,1
2980,1438,0,0,104,104,0,1,0,1,0
2750,1463,0,0,62,62,0,1,0,1,0
4137,183,14712,121,293,223,70,4,0,3,1
1655,183,6073,121,293,223,70,4,0,3,1
10806,1543,0,0,62,62,0,1,0,1,0
1964,2162,0,0,89,89,0,1,0,1,0
3806,755,0,0,123,123,0,1,0,1,0
8185,1155,0,0,156,156,0,1,0,1,0
6321,477,0,0,148,148,0,1,0,1,0
2098,3095,0,0,155,155,0,1,0,1,0
1774,653,0,0,113,113,0,1,0,1,0
1223,333,2024,68,230,190,39,2,0,2,0
1525,2939,0,0,130,130,0,1,0,1,0
2554,2431,0,0,113,113,0,1,0,1,0
1397,183,5678,121,293,223,70,4,0,3,1
8067,1914,0,0,125,125,0,1,0,1,0
1816,908,0,0,145,145,0,1,0,1,0
1638,183,6013,121,293,223,70,4,0,3,1
2395,1694,0,0,62,62,0,1,0,1,0
4713,183,16187,121,293,223,70,4,1,3,1
917,1176,0,0,155,155,0,1,0,1,0
785,1176,0,0,141,141,0,1,0,1,0
10723,1612,0,0,75,75,0,1,0,1,0
11695,1615,0,0,66,66,0,1,0,1,0
1992,933,0,0,62,62,0,1,0,1,0
1141,183,4250,121,293,223,70,4,1,3,1
8813,1257,0,0,135,135,0,1,0,1,0
19150,2772,0,0,127,127,0,1,0,1,0
1783,662,0,0,111,111,0,1,0,1,0
8701,183,19265,121,293,223,70,4,0,3,1
811,1176,0,0,155,155,0,1,0,1,0
14388,263,0,0,144,144,0,1,0,1,0
2174,1417,0,0,62,62,0,1,0,1,0
2306,1176,0,0,144,144,0,1,0,1,0
2573,1694,0,0,62,62,0,1,0,1,0
472,2746,0,0,141,141,0,1,0,1,0
2914,1212,0,0,141,141,0,1,0,1,0
8313,1608,0,0,147,147,0,1,0,1,0
2071,183,8185,121,293,223,70,4,0,3,1
1454,183,5094,121,293,223,70,4,1,3,1
11982,1108,0,0,89,89,0,1,0,1,0
250,2009,0,0,144,144,0,1,0,1,0
8211,1237,0,0,153,153,0,1,0,1,0
1934,183,7584,121,293,223,70,4,0,3,1
17368,1543,0,0,65,65,0,1,0,1,0
8238,1808,0,0,138,138,0,1,0,1,0
176,1039,0,0,157,157,0,1,0,1,0
2688,1360,0,0,117,117,0,1,0,1,0
2289,183,9348,121,293,223,70,4,0,3,1
9689,1543,0,0,99,99,0,1,0,1,0
4299,387,0,0,146,146,0,1,0,1,0
2133,183,8548,121,293,223,70,4,0,3,1
1367,183,4867,121,293,223,70,4,1,3,1
2498,1694,0,0,62,62,0,1,0,1,0
342,1164,0,0,143,143,0,1,0,1,0
10936,1694,0,0,77,77,0,1,0,1,0
2109,1440,0,0,101,101,0,1,0,1,0
1875,892,0,0,74,74,0,1,0,1,0
2245,3083,0,0,158,158,0,1,0,1,0
959,3095,0,0,139,139,0,1,0,1,0
709,3095,0,0,139,139,0,1,0,1,0
1965,845,0,0,62,62,0,1,0,1,0
1829,183,6920,121,293,223,70,4,0,3,1
1432,1176,0,0,138,138,0,1,0,1,0
2095,3095,0,0,155,155,0,1,0,1,0
1044,1176,0,0,140,140,0,1,0,1,0
10134,1503,0,0,81,81,0,1,0,1,0
1520,625,0,0,149,149,0,1,0,1,0
3557,773,0,0,146,146,0,1,0,1,0
4591,183,15324,121,293,223,70,4,0,3,1
139,1879,0,0,149,149,0,1,0,1,0
4789,183,15940,121,293,223,70,4,0,3,1
2019,1003,0,0,62,62,0,1,0,1,0
2137,1483,0,0,94,94,0,1,0,1,0
3570,1077,0,0,102,102,0,1,0,1,0
2270,150,0,0,86,86,0,1,0,1,0
1000,183,3866,121,293,223,70,4,1,3,1
2209,183,8986,121,293,223,70,4,0,3,1
904,745,0,0,152,152,0,1,0,1,0
1974,183,7694,121,293,223,70,4,0,3,1
1729,707,0,0,146,146,0,1,0,1,0
2732,1694,0,0,62,62,0,1,0,1,0
1934,855,0,0,65,65,0,1,0,1,0
97,1021,0,0,157,157,0,1,0,1,0
4820,183,16022,121,293,223,70,4,0,3,1
11234,1630,0,0,62,62,0,1,0,1,0
1274,183,4612,121,293,223,70,4,1,3,1
2408,2743,0,0,134,134,0,1,0,1,0
2870,1159,0,0,143,143,0,1,0,1,0
15417,183,24075,121,293,223,70,4,0,3,1
4577,183,15284,121,293,223,70,4,0,3,1
1003,183,3791,121,293,223,70,4,1,3,1
6249,521,0,0,146,146,0,1,0,1,0
1436,3095,0,0,144,144,0,1,0,1,0
1256,183,4280,121,293,223,70,4,1,3,1
15560,2536,0,0,118,118,0,1,0,1,0
10170,1543,0,0,78,78,0,1,0,1,0
1712,183,6350,121,293,223,70,4,0,3,1
2926,1217,0,0,141,141,0,1,0,1,0
1508,383,1849,51,209,179,29,2,0,1,0
4051,183,13433,121,293,223,70,4,1,3,1
2166,1396,0,0,62,62,0,1,0,1,0
8710,1242,0,0,139,139,0,1,0,1,0
4541,183,15974,121,293,223,70,4,1,3,1
2045,1551,0,0,83,83,0,1,0,1,0
1909,656,0,0,104,104,0,1,0,1,0
3246,1334,0,0,85,85,0,1,0,1,0
12639,1121,0,0,94,94,0,1,0,1,0
11141,1611,0,0,62,62,0,1,0,1,0
2068,183,8290,121,293,223,70,4,0,3,1
1586,1076,0,0,116,116,0,1,0,1,0
8503,1213,0,0,147,147,0,1,0,1,0
1879,183,7221,121,293,223,70,4,0,3,1
7861,2293,0,0,108,108,0,1,0,1,0
6097,395,0,0,147,147,0,1,0,1,0
2021,535,0,0,97,97,0,1,0,1,0
11378,1659,0,0,62,62,0,1,0,1,0
8481,1684,0,0,140,140,0,1,0,1,0
3119,149,0,0,93,93,0,1,0,1,0
9327,1543,0,0,109,109,0,1,0,1,0
1763,183,6639,121,293,223,70,4,0,3,1
2225,183,9078,121,293,223,70,4,0,3,1
1563,183,5642,121,293,223,70,4,0,3,1
2067,1248,0,0,131,131,0,1,0,1,0
293,923,0,0,155,155,0,1,0,1,0
221,2375,0,0,144,144,0,1,0,1,0
730,1176,0,0,141,141,0,1,0,1,0
10760,1543,0,0,63,63,0,1,0,1,0
1225,743,0,0,146,146,0,1,0,1,0
517,1697,0,0,151,151,0,1,0,1,0
1296,788,0,0,151,151,0,1,0,1,0
1842,183,7533,121,293,223,70,4,0,3,1
988,183,3760,121,293,223,70,4,1,3,1
3136,1585,0,0,69,69,0,1,0,1,0
2213,1522,0,0,62,62,0,1,0,1,0
2342,347,0,0,85,85,0,1,0,1,0
8278,1330,0,0,152,152,0,1,0,1,0
1479,450,813,27,180,165,15,1,0,1,0
11802,1559,0,0,69,69,0,1,0,1,0
3269,183,12266,121,293,223,70,4,0,3,1
8264,1270,0,0,154,154,0,1,0,1,0
2031,183,7966,121,293,223,70,4,0,3,1
21643,1353,3972,16,94,84,9,1,0,1,0
4879,183,16144,121,293,223,70,4,0,3,1
432,1176,0,0,145,145,0,1,0,1,0
8836,1663,0,0,128,128,0,1,0,1,0
1186,183,4372,121,293,223,70,4,1,3,1
2914,1212,0,0,141,141,0,1,0,1,0
2018,183,7915,121,293,223,70,4,0,3,1
641,2998,0,0,139,139,0,1,0,1,0
1991,790,0,0,62,62,0,1,0,1,0
1341,3095,0,0,142,142,0,1,0,1,0
7294,3022,0,0,63,63,0,1,0,1,0
1034,1176,0,0,153,153,0,1,0,1,0
9167,1694,0,0,124,124,0,1,0,1,0
2667,2190,0,0,96,96,0,1,0,1,0
10091,1694,0,0,99,99,0,1,0,1,0
1297,183,5257,121,293,223,70,4,0,3,1
2032,1324,0,0,119,119,0,1,0,1,0
1841,2417,0,0,101,101,0,1,0,1,0
4246,183,14340,121,293,223,70,4,0,3,1
1471,345,2330,64,224,187,37,2,0,2,0
1772,651,0,0,114,114,0,1,0,1,0
1736,183,6470,121,293,223,70,4,0,3,1
8580,1224,0,0,144,144,0,1,0,1,0
21396,1689,0,0,69,69,0,1,0,1,0
4077,183,14412,121,293,223,70,4,1,3,1
2603,1425,0,0,62,62,0,1,0,1,0
2166,1176,0,0,144,144,0,1,0,1,0
8978,1543,0,0,122,122,0,1,0,1,0
11414,1318,0,0,76,76,0,1,0,1,0
17042,183,25357,121,293,223,70,4,0,3,1
13657,488,0,0,129,129,0,1,0,1,0
7949,1744,0,0,128,128,0,1,0,1,0
1951,183,7536,121,293,223,70,4,0,3,1
8199,1858,0,0,135,135,0,1,0,1,0
9383,1543,0,0,110,110,0,1,0,1,0
8327,1609,0,0,146,146,0,1,0,1,0
2328,1176,0,0,145,145,0,1,0,1,0
988,1014,0,0,154,154,0,1,0,1,0
2013,989,0,0,62,62,0,1,0,1,0
2112,247,0,0,102,102,0,1,0,1,0
1301,3095,0,0,142,142,0,1,0,1,0
5973,744,0,0,131,131,0,1,0,1,0
21489,838,14736,62,181,145,36,2,0,2,0
2087,3095,0,0,156,156,0,1,0,1,0
2236,1668,0,0,65,65,0,1,0,1,0
9792,1543,0,0,92,92,0,1,0,1,0
2781,1694,0,0,62,62,0,1,0,1,0
555,847,0,0,154,154,0,1,0,1,0
756,1176,0,0,156,156,0,1,0,1,0
5342,283,0,0,146,146,0,1,0,1,0
1743,2578,0,0,110,110,0,1,0,1,0
586,1134,0,0,157,157,0,1,0,1,0
508,1176,0,0,147,147,0,1,0,1,0
2477,183,9451,121,293,223,70,4,0,3,1
10449,1543,0,0,70,70,0,1,0,1,0
12133,1053,0,0,93,93,0,1,0,1,0
2128,183,8518,121,293,223,70,4,0,3,1
9209,1543,0,0,116,116,0,1,0,1,0
1856,737,0,0,90,90,0,1,0,1,0
2856,1694,0,0,62,62,0,1,0,1,0
657,1176,0,0,153,153,0,1,0,1,0
1984,909,0,0,62,62,0,1,0,1,0
2263,1176,0,0,144,144,0,1,0,1,0
266,1126,0,0,146,146,0,1,0,1,0
1094,183,4358,121,293,223,70,4,0,3,1
1392,183,4787,121,293,223,70,4,1,3,1
13039,912,0,0,106,106,0,1,0,1,0
2817,1255,0,0,134,134,0,1,0,1,0
11204,1650,0,0,64,64,0,1,0,1,0
1065,2915,0,0,143,143,0,1,0,1,0
9516,1543,0,0,102,102,0,1,0,1,0
1719,183,6491,121,293,223,70,4,0,3,1
4642,353,0,0,146,146,0,1,0,1,0
13043,1543,0,0,69,69,0,1,0,1,0
6160,478,0,0,146,146,0,1,0,1,0
245,2051,0,0,144,144,0,1,0,1,0
14098,357,0,0,138,138,0,1,0,1,0
1715,994,0,0,97,97,0,1,0,1,0
1768,3095,0,0,147,147,0,1,0,1,0
7781,1008,0,0,155,155,0,1,0,1,0
8111,1436,0,0,146,146,0,1,0,1,0
2247,183,9223,121,293,223,70,4,0,3,1
4719,183,16194,121,293,223,70,4,1,3,1
10450,1543,0,0,69,69,0,1,0,1,0
2238,183,9154,121,293,223,70,4,0,3,1
11126,1291,0,0,86,86,0,1,0,1,0
1394,3095,0,0,140,140,0,1,0,1,0
2431,1569,0,0,82,82,0,1,0,1,0
7009,970,0,0,146,146,0,1,0,1,0
1384,3095,0,0,141,141,0,1,0,1,0
1709,1176,0,0,141,141,0,1,0,1,0
1979,183,7829,121,293,223,70,4,0,3,1
1507,1176,0,0,139,139,0,1,0,1,0
16091,1466,0,0,145,145,0,1,0,1,0
2968,1694,0,0,62,62,0,1,0,1,0
793,2707,0,0,142,142,0,1,0,1,0
2070,1176,0,0,143,143,0,1,0,1,0
293,2482,0,0,143,143,0,1,0,1,0
1406,183,4854,121,293,223,70,4,1,3,1
925,183,3664,121,293,223,70,4,1,3,1
1942,1044,0,0,111,111,0,1,0,1,0
14885,183,21683,121,293,223,70,4,0,3,1
10948,1571,0,0,62,62,0,1,0,1,0
12537,1958,0,0,91,91,0,1,0,1,0
8922,1570,0,0,130,130,0,1,0,1,0
7960,1073,0,0,155,155,0,1,0,1,0
1773,957,0,0,88,88,0,1,0,1,0
1016,1176,0,0,140,140,0,1,0,1,0
7754,2430,0,0,100,100,0,1,0,1,0
2243,183,9181,121,293,223,70,4,0,3,1
1786,183,6712,121,293,223,70,4,0,3,1
2200,183,8936,121,293,223,70,4,0,3,1
3023,1609,0,0,76,76,0,1,0,1,0
1998,3095,0,0,152,152,0,1,0,1,0
2962,1365,0,0,116,116,0,1,0,1,0
2713,183,9706,121,293,223,70,4,0,3,1
1467,1070,0,0,140,140,0,1,0,1,0
1820,1176,0,0,142,142,0,1,0,1,0
8069,1416,0,0,146,146,0,1,0,1,0
21663,1416,2641,11,83,76,6,1,0,1,0
1982,3095,0,0,152,152,0,1,0,1,0
12829,795,0,0,109,109,0,1,0,1,0
3926,661,0,0,129,129,0,1,0,1,0
2822,1519,0,0,62,62,0,1,0,1,0
2090,1412,0,0,106,106,0,1,0,1,0
2413,153,0,0,62,62,0,1,0,1,0
1906,183,7350,121,293,223,70,4,0,3,1
1351,748,0,0,151,151,0,1,0,1,0
8945,1276,0,0,131,131,0,1,0,1,0
967,183,3845,121,293,223,70,4,0,3,1
2859,1694,0,0,62,62,0,1,0,1,0
9080,1543,0,0,120,120,0,1,0,1,0
768,1176,0,0,156,156,0,1,0,1,0
1523,183,6026,121,293,223,70,4,0,3,1
48,1225,0,0,155,155,0,1,0,1,0
9482,1353,0,0,111,111,0,1,0,1,0
8247,1196,0,0,156,156,0,1,0,1,0
13558,640,0,0,122,122,0,1,0,1,0
489,2536,0,0,144,144,0,1,0,1,0
11630,1649,0,0,64,64,0,1,0,1,0
2255,1680,0,0,64,64,0,1,0,1,0
10074,1437,0,0,89,89,0,1,0,1,0
1972,1096,0,0,137,137,0,1,0,1,0
5120,306,0,0,146,146,0,1,0,1,0
1776,3095,0,0,150,150,0,1,0,1,0
8262,1297,0,0,154,154,0,1,0,1,0
2827,1176,0,0,147,147,0,1,0,1,0
1005,1176,0,0,140,140,0,1,0,1,0
8986,1694,0,0,128,128,0,1,0,1,0
4898,183,16417,121,293,223,70,4,1,3,1
8322,1665,0,0,146,146,0,1,0,1,0
1737,183,6472,121,293,223,70,4,0,3,1
8313,1483,0,0,147,147,0,1,0,1,0
1747,3095,0,0,152,152,0,1,0,1,0
4239,734,0,0,147,147,0,1,0,1,0
1996,183,7794,121,293,223,70,4,0,3,1
1708,3095,0,0,145,145,0,1,0,1,0
1537,1108,0,0,123,123,0,1,0,1,0
5178,420,0,0,146,146,0,1,0,1,0
1406,183,4850,121,293,223,70,4,0,3,1
4684,183,16152,121,293,223,70,4,1,3,1
1082,183,4090,121,293,223,70,4,1,3,1
336,2429,0,0,144,144,0,1,0,1,0
3293,183,11910,121,293,223,70,4,0,3,1
289,2404,0,0,144,144,0,1,0,1,0
4228,183,13999,121,293,223,70,4,1,3,1
813,3095,0,0,139,139,0,1,0,1,0
2965,1377,0,0,114,114,0,1,0,1,0
17563,2469,0,0,145,145,0,1,0,1,0
10812,1600,0,0,68,68,0,1,0,1,0
6841,812,0,0,146,146,0,1,0,1,0
4846,333,0,0,146,146,0,1,0,1,0
3229,1351,0,0,84,84,0,1,0,1,0
1249,183,4884,121,293,223,70,4,0,3,1
261,932,0,0,155,155,0,1,0,1,0
692,1158,0,0,157,157,0,1,0,1,0
1959,183,7715,121,293,223,70,4,0,3,1
540,2570,0,0,144,144,0,1,0,1,0
634,1145,0,0,157,157,0,1,0,1,0
9233,1626,0,0,113,113,0,1,0,1,0
1972,183,7660,121,293,223,70,4,0,3,1
971,183,3789,121,293,223,70,4,1,3,1
8973,1543,0,0,124,124,0,1,0,1,0
1700,1341,0,0,114,114,0,1,0,1,0
3421,183,12466,121,293,223,70,4,0,3,1
8353,1195,0,0,152,152,0,1,0,1,0
16532,1766,0,0,145,145,0,1,0,1,0
2961,1359,0,0,117,117,0,1,0,1,0
16229,1543,0,0,66,66,0,1,0,1,0
2304,1672,0,0,65,65,0,1,0,1,0
1094,1176,0,0,153,153,0,1,0,1,0
1954,183,7561,121,293,223,70,4,0,3,1
826,3095,0,0,140,140,0,1,0,1,0
2170,518,0,0,62,62,0,1,0,1,0
8262,1260,0,0,154,154,0,1,0,1,0
1807,183,6815,121,293,223,70,4,0,3,1
2241,183,8421,121,293,223,70,4,0,3,1
2172,3095,0,0,157,157,0,1,0,1,0
1407,183,4859,121,293,223,70,4,1,3,1
8307,1458,0,0,148,148,0,1,0,1,0
1946,348,0,0,118,118,0,1,0,1,0
2899,1682,0,0,63,63,0,1,0,1,0
2085,1176,0,0,143,143,0,1,0,1,0
8327,1604,0,0,146,146,0,1,0,1,0
1400,3095,0,0,139,139,0,1,0,1,0
2913,1246,0,0,136,136,0,1,0,1,0
7828,2255,0,0,106,106,0,1,0,1,0
843,1176,0,0,141,141,0,1,0,1,0
745,2704,0,0,144,144,0,1,0,1,0
1713,183,6440,121,293,223,70,4,0,3,1
2462,1543,0,0,86,86,0,1,0,1,0
10581,1556,0,0,69,69,0,1,0,1,0
1978,329,0,0,115,115,0,1,0,1,0
13872,475,0,0,131,131,0,1,0,1,0
4320,183,15277,121,293,223,70,4,1,3,1
8397,183,15458,121,293,223,70,4,0,3,1
755,1560,0,0,153,153,0,1,0,1,0
8019,2089,0,0,121,121,0,1,0,1,0
19422,1543,0,0,62,62,0,1,0,1,0
397,1090,0,0,157,157,0,1,0,1,0
10150,1543,0,0,84,84,0,1,0,1,0
8600,1543,0,0,136,136,0,1,0,1,0
8353,1191,0,0,152,152,0,1,0,1,0
5995,782,0,0,129,129,0,1,0,1,0
2168,183,8748,121,293,223,70,4,0,3,1
1631,183,5977,121,293,223,70,4,0,3,1
1095,183,3967,121,293,223,70,4,1,3,1
2825,1176,0,0,147,147,0,1,0,1,0
8279,1400,0,0,152,152,0,1,0,1,0
13247,803,0,0,113,113,0,1,0,1,0
771,1176,0,0,156,156,0,1,0,1,0
2036,2054,0,0,82,82,0,1,0,1,0
8327,1673,0,0,146,146,0,1,0,1,0
2496,1694,0,0,62,62,0,1,0,1,0
953,3095,0,0,140,140,0,1,0,1,0
2554,2431,0,0,113,113,0,1,0,1,0
3023,1678,0,0,62,62,0,1,0,1,0
1224,3095,0,0,139,139,0,1,0,1,0
1940,1073,0,0,118,118,0,1,0,1,0
2149,224,0,0,98,98,0,1,0,1,0
1702,2646,0,0,114,114,0,1,0,1,0
3120,1604,0,0,67,67,0,1,0,1,0
1039,183,3859,121,293,223,70,4,1,3,1
7627,2544,0,0,90,90,0,1,0,1,0
2219,183,9043,121,293,223,70,4,0,3,1
4872,330,0,0,146,146,0,1,0,1,0
2336,269,0,0,62,62,0,1,0,1,0
2047,183,8054,121,293,223,70,4,0,3,1
1791,670,0,0,108,108,0,1,0,1,0
7586,2601,0,0,86,86,0,1,0,1,0
665,1388,0,0,154,154,0,1,0,1,0
3877,336,0,0,132,132,0,1,0,1,0
4125,426,0,0,144,144,0,1,0,1,0
540,1176,0,0,149,149,0,1,0,1,0
1370,734,0,0,150,150,0,1,0,1,0
632,1458,0,0,154,154,0,1,0,1,0
2483,1527,0,0,89,89,0,1,0,1,0
2586,1443,0,0,103,103,0,1,0,1,0
11345,1668,0,0,63,63,0,1,0,1,0
8349,2524,0,0,65,65,0,1,0,1,0
3764,851,0,0,116,116,0,1,0,1,0
99,1592,0,0,151,151,0,1,0,1,0
2695,1509,0,0,62,62,0,1,0,1,0
1907,183,7457,121,293,223,70,4,0,3,1
5915,329,0,0,146,146,0,1,0,1,0
10573,1570,0,0,70,70,0,1,0,1,0
8317,1706,0,0,145,145,0,1,0,1,0
2029,1031,0,0,62,62,0,1,0,1,0
14617,461,0,0,145,145,0,1,0,1,0
2613,183,9215,121,293,223,70,4,1,3,1
1363,235,3725,102,271,211,59,3,0,2,0
2528,1495,0,0,93,93,0,1,0,1,0
2123,183,8565,121,293,223,70,4,0,3,1
180,1083,0,0,150,150,0,1,0,1,0
4187,183,14804,121,293,223,70,4,1,3,1
1935,1484,0,0,93,93,0,1,0,1,0
680,1176,0,0,153,153,0,1,0,1,0
2055,183,8097,121,293,223,70,4,0,3,1
345,2442,0,0,144,144,0,1,0,1,0
2118,1454,0,0,99,99,0,1,0,1,0
2976,1422,0,0,107,107,0,1,0,1,0
402,1157,0,0,143,143,0,1,0,1,0
1792,1176,0,0,141,141,0,1,0,1,0
13845,490,0,0,131,131,0,1,0,1,0
8317,1501,0,0,147,147,0,1,0,1,0
1582,731,0,0,145,145,0,1,0,1,0
568,1176,0,0,150,150,0,1,0,1,0
1376,183,4709,121,293,223,70,4,1,3,1
3599,747,0,0,146,146,0,1,0,1,0
10610,1514,0,0,69,69,0,1,0,1,0
8245,1658,0,0,139,139,0,1,0,1,0
1904,1110,0,0,143,143,0,1,0,1,0
2904,1176,0,0,147,147,0,1,0,1,0
2919,1694,0,0,62,62,0,1,0,1,0
3456,1211,0,0,93,93,0,1,0,1,0
1817,183,6909,121,293,223,70,4,0,3,1
513,1101,0,0,143,143,0,1,0,1,0
10682,1543,0,0,64,64,0,1,0,1,0
853,3095,0,0,139,139,0,1,0,1,0
642,2999,0,0,139,139,0,1,0,1,0
1945,847,0,0,63,63,0,1,0,1,0
10649,1579,0,0,69,69,0,1,0,1,0
1471,1058,0,0,140,140,0,1,0,1,0
852,516,2379,80,247,200,46,2,0,2,0
3530,183,12471,121,293,223,70,4,1,3,1
2340,1642,0,0,70,70,0,1,0,1,0
1916,649,0,0,104,104,0,1,0,1,0
1453,183,5087,121,293,223,70,4,1,3,1
10544,1543,0,0,70,70,0,1,0,1,0
2647,1466,0,0,62,62,0,1,0,1,0
1750,183,6577,121,293,223,70,4,0,3,1
6355,1421,0,0,110,110,0,1,0,1,0
1198,183,4405,121,293,223,70,4,1,3,1
617,2962,0,0,140,140,0,1,0,1,0
3994,183,11018,121,293,223,70,4,0,3,1
2110,1245,0,0,62,62,0,1,0,1,0
1603,183,5839,121,293,223,70,4,0,3,1
8285,1437,0,0,151,151,0,1,0,1,0
3058,183,11640,121,293,223,70,4,0,3,1
942,183,3708,121,293,223,70,4,1,3,1
1593,1176,0,0,147,147,0,1,0,1,0
2469,28,0,0,66,66,0,1,0,1,0
1707,999,0,0,98,98,0,1,0,1,0
10805,1543,0,0,62,62,0,1,0,1,0
454,2513,0,0,144,144,0,1,0,1,0
7897,1843,0,0,123,123,0,1,0,1,0
1099,3095,0,0,144,144,0,1,0,1,0
626,1176,0,0,152,152,0,1,0,1,0
515,896,1008,34,185,165,19,1,0,1,0
886,3095,0,0,139,139,0,1,0,1,0
1241,1176,0,0,139,139,0,1,0,1,0
1378,183,4719,121,293,223,70,4,1,3,1
1925,1176,0,0,142,142,0,1,0,1,0
2648,183,8734,121,293,223,70,4,0,3,1
2323,117,0,0,81,81,0,1,0,1,0
1475,183,5719,121,293,223,70,4,0,3,1
1742,183,6495,121,293,223,70,4,0,3,1
1817,3095,0,0,151,151,0,1,0,1,0
8041,1951,0,0,123,123,0,1,0,1,0
4526,183,15956,121,293,223,70,4,1,3,1
1549,424,1326,36,191,170,21,1,0,1,0
11526,1691,0,0,62,62,0,1,0,1,0
1394,3095,0,0,147,147,0,1,0,1,0
8535,1678,0,0,138,138,0,1,0,1,0
281,2400,0,0,144,144,0,1,0,1,0
822,946,0,0,144,144,0,1,0,1,0
1260,1176,0,0,143,143,0,1,0,1,0
956,183,3805,121,293,223,70,4,0,3,1
964,2810,0,0,141,141,0,1,0,1,0
3278,189,0,0,101,101,0,1,0,1,0
78,1033,0,0,154,154,0,1,0,1,0
231,2292,0,0,145,145,0,1,0,1,0
2093,1250,0,0,131,131,0,1,0,1,0
2111,183,8443,121,293,223,70,4,0,3,1
13954,379,0,0,136,136,0,1,0,1,0
8974,2219,0,0,67,67,0,1,0,1,0
9477,1624,0,0,107,107,0,1,0,1,0
1687,3095,0,0,151,151,0,1,0,1,0
1416,3095,0,0,144,144,0,1,0,1,0
1142,183,4253,121,293,223,70,4,1,3,1
11170,1697,0,0,79,79,0,1,0,1,0
8266,1278,0,0,153,153,0,1,0,1,0
8624,1675,0,0,135,135,0,1,0,1,0
11986,1107,0,0,89,89,0,1,0,1,0
1467,3095,0,0,145,145,0,1,0,1,0
466,1106,0,0,157,157,0,1,0,1,0
2924,1208,0,0,142,142,0,1,0,1,0
2240,1637,0,0,70,70,0,1,0,1,0
1557,183,5595,121,293,223,70,4,0,3,1
791,2735,0,0,143,143,0,1,0,1,0
774,2723,0,0,143,143,0,1,0,1,0
8621,1676,0,0,136,136,0,1,0,1,0
1361,233,3752,103,271,212,59,3,0,2,0
21685,1491,1070,4,70,68,2,1,0,1,0
2308,417,0,0,90,90,0,1,0,1,0
2342,1176,0,0,145,145,0,1,0,1,0
3057,134,0,0,89,89,0,1,0,1,0
2669,1485,0,0,62,62,0,1,0,1,0
10139,1694,0,0,98,98,0,1,0,1,0
1063,183,3906,121,293,223,70,4,1,3,1
371,2596,0,0,143,143,0,1,0,1,0
3156,183,11636,121,293,223,70,4,0,3,1
8269,1339,0,0,153,153,0,1,0,1,0
1654,183,6061,121,293,223,70,4,0,3,1
2482,48,0,0,62,62,0,1,0,1,0
10154,1507,0,0,80,80,0,1,0,1,0
21,1024,0,0,156,156,0,1,0,1,0
1495,183,5304,121,293,223,70,4,0,3,1
1754,3095,0,0,150,150,0,1,0,1,0
2239,183,9163,121,293,223,70,4,0,3,1
10768,1694,0,0,82,82,0,1,0,1,0
17955,887,0,0,104,104,0,1,0,1,0
1476,183,5237,121,293,223,70,4,0,3,1
2052,183,8080,121,293,223,70,4,0,3,1
11075,1597,0,0,62,62,0,1,0,1,0
1479,1205,0,0,134,134,0,1,0,1,0
1380,183,4722,121,293,223,70,4,0,3,1
2097,1252,0,0,130,130,0,1,0,1,0
1871,183,7179,121,293,223,70,4,0,3,1
354,1170,0,0,143,143,0,1,0,1,0
1530,183,5471,121,293,223,70,4,0,3,1
11203,1623,0,0,62,62,0,1,0,1,0
3623,183,13113,121,293,223,70,4,0,3,1
2222,1546,0,0,62,62,0,1,0,1,0
1173,183,4339,121,293,223,70,4,1,3,1
13222,816,0,0,112,112,0,1,0,1,0
612,713,1667,56,212,180,32,2,0,1,0
1078,183,3935,121,293,223,70,4,1,3,1
1970,183,7770,121,293,223,70,4,0,3,1
10540,1484,0,0,75,75,0,1,0,1,0
813,3095,0,0,139,139,0,1,0,1,0
2427,94,0,0,68,68,0,1,0,1,0
1554,183,5583,121,293,223,70,4,0,3,1
2167,183,8756,121,293,223,70,4,0,3,1
5300,288,0,0,146,146,0,1,0,1,0
1188,183,4378,121,293,223,70,4,1,3,1
2477,183,9205,121,293,223,70,4,0,3,1
2514,1,0,0,62,62,0,1,0,1,0
3714,183,13123,121,293,223,70,4,1,3,1
2349,1694,0,0,62,62,0,1,0,1,0
69,1014,0,0,157,157,0,1,0,1,0
10659,1581,0,0,69,69,0,1,0,1,0
11008,1543,0,0,62,62,0,1,0,1,0
2980,115,0,0,85,85,0,1,0,1,0
8877,1653,0,0,125,125,0,1,0,1,0
259,1948,0,0,144,144,0,1,0,1,0
1381,405,1278,43,199,174,25,2,0,1,0
8251,1231,0,0,155,155,0,1,0,1,0
1400,3095,0,0,140,140,0,1,0,1,0
2396,2769,0,0,136,136,0,1,0,1,0
8916,1292,0,0,129,129,0,1,0,1,0
1544,183,5975,121,293,223,70,4,0,3,1
1798,941,0,0,85,85,0,1,0,1,0
2263,2327,0,0,105,105,0,1,0,1,0
11429,1688,0,0,65,65,0,1,0,1,0
6851,818,0,0,146,146,0,1,0,1,0
892,3095,0,0,139,139,0,1,0,1,0
2736,1694,0,0,62,62,0,1,0,1,0
1532,616,0,0,149,149,0,1,0,1,0
862,436,2666,90,258,206,52,3,0,2,0
510,2535,0,0,143,143,0,1,0,1,0
1705,183,6350,121,293,223,70,4,0,3,1
1397,3095,0,0,140,140,0,1,0,1,0
2189,183,8908,121,293,223,70,4,0,3,1
1046,183,3873,121,293,223,70,4,1,3,1
8327,1627,0,0,146,146,0,1,0,1,0
842,592,2104,71,236,195,41,2,0,2,0
1471,183,5177,121,293,223,70,4,0,3,1
2761,1301,0,0,127,127,0,1,0,1,0
8125,183,14530,121,293,223,70,4,0,3,1
356,2449,0,0,144,144,0,1,0,1,0
2060,183,8240,121,293,223,70,4,0,3,1
2562,1694,0,0,62,62,0,1,0,1,0
2124,183,8491,121,293,223,70,4,0,3,1
1845,1176,0,0,142,142,0,1,0,1,0
2448,99,0,0,62,62,0,1,0,1,0
10171,1451,0,0,85,85,0,1,0,1,0
1081,3095,0,0,141,141,0,1,0,1,0
2900,1662,0,0,67,67,0,1,0,1,0
817,1176,0,0,156,156,0,1,0,1,0
1125,183,4027,121,293,223,70,4,1,3,1
2039,1336,0,0,117,117,0,1,0,1,0
660,622,1994,67,226,187,38,2,0,2,0
1351,3095,0,0,143,143,0,1,0,1,0
10985,1622,0,0,66,66,0,1,0,1,0
2232,425,0,0,62,62,0,1,0,1,0
10148,1543,0,0,84,84,0,1,0,1,0
10524,1543,0,0,68,68,0,1,0,1,0
1346,3095,0,0,147,147,0,1,0,1,0
1858,183,7111,121,293,223,70,4,0,3,1
8261,1292,0,0,154,154,0,1,0,1,0
1588,1176,0,0,140,140,0,1,0,1,0
4382,183,14866,121,293,223,70,4,0,3,1
1676,1019,0,0,103,103,0,1,0,1,0
21624,1579,0,0,63,63,0,1,0,1,0
2243,3095,0,0,158,158,0,1,0,1,0
4405,377,0,0,146,146,0,1,0,1,0
1857,183,7060,121,293,223,70,4,0,3,1
1408,183,5471,121,293,223,70,4,0,3,1
3503,807,0,0,147,147,0,1,0,1,0
249,2020,0,0,144,144,0,1,0,1,0
2966,1379,0,0,114,114,0,1,0,1,0
1631,183,6011,121,293,223,70,4,0,3,1
1558,801,0,0,144,144,0,1,0,1,0
2643,183,9776,121,293,223,70,4,0,3,1
2038,1054,0,0,62,62,0,1,0,1,0
1618,183,6246,121,293,223,70,4,0,3,1
907,1073,0,0,155,155,0,1,0,1,0
8854,1281,0,0,132,132,0,1,0,1,0
205,1096,0,0,149,149,0,1,0,1,0
8319,1650,0,0,146,146,0,1,0,1,0
1508,950,0,0,142,142,0,1,0,1,0
2100,1219,0,0,62,62,0,1,0,1,0
575,2900,0,0,140,140,0,1,0,1,0
2246,183,9200,121,293,223,70,4,0,3,1
3024,1694,0,0,62,62,0,1,0,1,0
1869,896,0,0,74,74,0,1,0,1,0
8142,1139,0,0,156,156,0,1,0,1,0
2017,1303,0,0,123,123,0,1,0,1,0
1249,1176,0,0,143,143,0,1,0,1,0
16159,573,0,0,124,124,0,1,0,1,0
1094,1176,0,0,153,153,0,1,0,1,0
2240,1638,0,0,70,70,0,1,0,1,0
410,1176,0,0,144,144,0,1,0,1,0
2389,1694,0,0,62,62,0,1,0,1,0
47,1217,0,0,155,155,0,1,0,1,0
8327,1596,0,0,146,146,0,1,0,1,0
5130,305,0,0,146,146,0,1,0,1,0
1269,3095,0,0,139,139,0,1,0,1,0
1055,183,3891,121,293,223,70,4,1,3,1
765,1176,0,0,156,156,0,1,0,1,0
8137,1379,0,0,146,146,0,1,0,1,0
8317,1634,0,0,147,147,0,1,0,1,0
1954,183,7552,121,293,223,70,4,0,3,1
8264,1306,0,0,154,154,0,1,0,1,0
342,1077,0,0,157,157,0,1,0,1,0
6227,1194,0,0,117,117,0,1,0,1,0
2803,1267,0,0,132,132,0,1,0,1,0
2048,1082,0,0,62,62,0,1,0,1,0
209,1098,0,0,149,149,0,1,0,1,0
1433,1169,0,0,139,139,0,1,0,1,0
1611,183,5853,121,293,223,70,4,0,3,1
1037,1176,0,0,153,153,0,1,0,1,0
7703,2496,0,0,96,96,0,1,0,1,0
4678,183,16143,121,293,223,70,4,1,3,1
2237,1632,0,0,71,71,0,1,0,1,0
14465,183,23475,121,293,223,70,4,0,3,1
1907,1176,0,0,142,142,0,1,0,1,0
8191,1868,0,0,135,135,0,1,0,1,0
11433,1670,0,0,62,62,0,1,0,1,0
8306,1570,0,0,148,148,0,1,0,1,0
1625,183,5928,121,293,223,70,4,0,3,1
1807,687,0,0,104,104,0,1,0,1,0
1494,1214,0,0,133,133,0,1,0,1,0
1575,1176,0,0,140,140,0,1,0,1,0
548,833,1234,41,194,170,24,2,0,1,0
1669,569,0,0,147,147,0,1,0,1,0
1352,183,4588,121,293,223,70,4,1,3,1
13389,729,0,0,117,117,0,1,0,1,0
11143,1675,0,0,72,72,0,1,0,1,0
2181,183,8871,121,293,223,70,4,0,3,1
1751,183,6655,121,293,223,70,4,0,3,1
2903,1694,0,0,62,62,0,1,0,1,0
1059,1176,0,0,153,153,0,1,0,1,0
7788,2797,0,0,63,63,0,1,0,1,0
260,1938,0,0,144,144,0,1,0,1,0
1878,390,0,0,125,125,0,1,0,1,0
7300,3036,0,0,62,62,0,1,0,1,0
1326,197,4201,115,286,219,67,3,0,2,0
1899,2259,0,0,94,94,0,1,0,1,0
8327,1632,0,0,146,146,0,1,0,1,0
1273,3095,0,0,139,139,0,1,0,1,0
13307,771,0,0,114,114,0,1,0,1,0
10776,1595,0,0,68,68,0,1,0,1,0
1373,183,4694,121,293,223,70,4,0,3,1
9418,1612,0,0,106,106,0,1,0,1,0
1407,183,4853,121,293,223,70,4,0,3,1
13482,183,20586,121,293,223,70,4,0,3,1
2035,183,7990,121,293,223,70,4,0,3,1
400,1176,0,0,144,144,0,1,0,1,0
2912,1291,0,0,128,128,0,1,0,1,0
1249,3095,0,0,146,146,0,1,0,1,0
8279,1335,0,0,152,152,0,1,0,1,0
1390,183,4930,121,293,223,70,4,1,3,1
1662,183,6567,121,293,223,70,4,0,3,1
2979,1694,0,0,62,62,0,1,0,1,0
7289,1032,0,0,146,146,0,1,0,1,0
2909,1181,0,0,147,147,0,1,0,1,0
8263,1302,0,0,154,154,0,1,0,1,0
2333,1694,0,0,62,62,0,1,0,1,0
2020,183,7909,121,293,223,70,4,0,3,1
1483,183,5236,121,293,223,70,4,0,3,1
1931,183,7425,121,293,223,70,4,0,3,1
1681,183,5829,121,293,223,70,4,1,3,1
1646,1176,0,0,140,140,0,1,0,1,0
10180,1543,0,0,78,78,0,1,0,1,0
2903,1557,0,0,84,84,0,1,0,1,0
368,1176,0,0,142,142,0,1,0,1,0
1318,1176,0,0,142,142,0,1,0,1,0
1705,183,6398,121,293,223,70,4,0,3,1
3942,183,14133,121,293,223,70,4,0,3,1
7922,2214,0,0,113,113,0,1,0,1,0
905,183,3600,121,293,223,70,4,1,3,1
51,1245,0,0,154,154,0,1,0,1,0
1656,3095,0,0,151,151,0,1,0,1,0
9266,1543,0,0,111,111,0,1,0,1,0
1314,1176,0,0,139,139,0,1,0,1,0
10529,1503,0,0,72,72,0,1,0,1,0
1082,183,4089,121,293,223,70,4,1,3,1
9322,1633,0,0,112,112,0,1,0,1,0
10837,1603,0,0,67,67,0,1,0,1,0
1676,3095,0,0,148,148,0,1,0,1,0
4261,183,14385,121,293,223,70,4,0,3,1
2092,183,7929,121,293,223,70,4,0,3,1
1922,183,7380,121,293,223,70,4,0,3,1
7645,2331,0,0,98,98,0,1,0,1,0
1903,2313,0,0,96,96,0,1,0,1,0
144,1065,0,0,151,151,0,1,0,1,0
1419,3095,0,0,139,139,0,1,0,1,0
900,183,3590,121,293,223,70,4,1,3,1
7750,996,0,0,154,154,0,1,0,1,0
2274,1841,0,0,72,72,0,1,0,1,0
1172,183,4602,121,293,223,70,4,0,3,1
8327,1558,0,0,146,146,0,1,0,1,0
2155,183,8674,121,293,223,70,4,0,3,1
210,2299,0,0,144,144,0,1,0,1,0
1709,587,0,0,131,131,0,1,0,1,0
7698,2442,0,0,95,95,0,1,0,1,0
6479,1641,0,0,104,104,0,1,0,1,0
1898,1096,0,0,143,143,0,1,0,1,0
8243,1176,0,0,156,156,0,1,0,1,0
2062,183,8251,121,293,223,70,4,0,3,1
4024,480,0,0,146,146,0,1,0,1,0
10279,1543,0,0,79,79,0,1,0,1,0
4323,183,14711,121,293,223,70,4,0,3,1
7777,1006,0,0,154,154,0,1,0,1,0
2985,183,10012,121,293,223,70,4,1,3,1
2247,1648,0,0,69,69,0,1,0,1,0
14875,2365,0,0,105,105,0,1,0,1,0
1999,3095,0,0,152,152,0,1,0,1,0
13100,1543,0,0,69,69,0,1,0,1,0
1470,1176,0,0,139,139,0,1,0,1,0
860,247,3347,113,283,217,65,3,0,2,0
1855,183,7047,121,293,223,70,4,0,3,1
3022,1607,0,0,76,76,0,1,0,1,0
864,420,2725,92,260,207,53,3,0,2,0
421,1176,0,0,144,144,0,1,0,1,0
2028,1541,0,0,84,84,0,1,0,1,0
1874,183,7195,121,293,223,70,4,0,3,1
775,1170,0,0,156,156,0,1,0,1,0
7499,2758,0,0,80,80,0,1,0,1,0
2846,1602,0,0,76,76,0,1,0,1,0
2060,183,8122,121,293,223,70,4,0,3,1
1802,183,6900,121,293,223,70,4,0,3,1
2052,3095,0,0,155,155,0,1,0,1,0
7923,1792,0,0,125,125,0,1,0,1,0
7230,2972,0,0,64,64,0,1,0,1,0
4119,436,0,0,143,143,0,1,0,1,0
2097,629,0,0,62,62,0,1,0,1,0
11317,1647,0,0,62,62,0,1,0,1,0
1394,3095,0,0,140,140,0,1,0,1,0
1599,681,0,0,145,145,0,1,0,1,0
944,1046,0,0,155,155,0,1,0,1,0
1041,3095,0,0,139,139,0,1,0,1,0
21464,756,16459,69,195,155,40,2,0,2,0
1668,3095,0,0,144,144,0,1,0,1,0
9533,1604,0,0,102,102,0,1,0,1,0
1425,183,4955,121,293,223,70,4,0,3,1
2093,183,8317,121,293,223,70,4,0,3,1
9625,1603,0,0,112,112,0,1,0,1,0
2928,1694,0,0,62,62,0,1,0,1,0
2913,1252,0,0,135,135,0,1,0,1,0
2220,183,9052,121,293,223,70,4,0,3,1
21695,1524,397,1,65,64,0,1,0,1,0
1731,3095,0,0,146,146,0,1,0,1,0
1496,984,0,0,141,141,0,1,0,1,0
1055,702,0,0,151,151,0,1,0,1,0
9423,1543,0,0,106,106,0,1,0,1,0
2096,3095,0,0,155,155,0,1,0,1,0
9754,1607,0,0,97,97,0,1,0,1,0
1940,822,0,0,66,66,0,1,0,1,0
2092,183,7363,121,293,223,70,4,1,3,1
523,1176,0,0,148,148,0,1,0,1,0
1546,421,1364,37,193,171,21,1,0,1,0
1610,183,5928,121,293,223,70,4,0,3,1
1250,3095,0,0,142,142,0,1,0,1,0
4609,183,15220,121,293,223,70,4,1,3,1
761,3095,0,0,139,139,0,1,0,1,0
1516,391,1744,48,205,177,27,2,0,1,0
2320,293,0,0,62,62,0,1,0,1,0
2219,1606,0,0,75,75,0,1,0,1,0
234,2394,0,0,144,144,0,1,0,1,0
2388,1603,0,0,76,76,0,1,0,1,0
3386,183,12220,121,293,223,70,4,0,3,1
9180,1338,0,0,119,119,0,1,0,1,0
794,971,736,24,184,170,14,1,0,1,0
2198,1574,0,0,80,80,0,1,0,1,0
1829,183,6970,121,293,223,70,4,0,3,1
1577,183,5691,121,293,223,70,4,0,3,1
2876,183,10147,121,293,223,70,4,1,3,1
2070,1382,0,0,110,110,0,1,0,1,0
11355,1669,0,0,63,63,0,1,0,1,0
1951,183,7535,121,293,223,70,4,0,3,1
822,1176,0,0,141,141,0,1,0,1,0
2446,1556,0,0,84,84,0,1,0,1,0
2921,1694,0,0,62,62,0,1,0,1,0
12317,679,0,0,145,145,0,1,0,1,0
2196,1571,0,0,81,81,0,1,0,1,0
3000,1694,0,0,62,62,0,1,0,1,0
2911,1323,0,0,123,123,0,1,0,1,0
634,1145,0,0,157,157,0,1,0,1,0
257,1962,0,0,144,144,0,1,0,1,0
708,3095,0,0,139,139,0,1,0,1,0
1861,183,7128,121,293,223,70,4,0,3,1
1929,1169,0,0,143,143,0,1,0,1,0
1903,784,0,0,77,77,0,1,0,1,0
15883,183,22739,121,293,223,70,4,0,3,1
1315,3079,0,0,143,143,0,1,0,1,0
9375,1630,0,0,110,110,0,1,0,1,0
2209,1591,0,0,78,78,0,1,0,1,0
16620,183,25049,121,293,223,70,4,0,3,1
1408,183,4865,121,293,223,70,4,1,3,1
10757,1593,0,0,68,68,0,1,0,1,0
932,3095,0,0,140,140,0,1,0,1,0
10925,1566,0,0,62,62,0,1,0,1,0
11566,1698,0,0,62,62,0,1,0,1,0
1323,183,4445,121,293,223,70,4,0,3,1
1591,3095,0,0,142,142,0,1,0,1,0
2536,2470,0,0,115,115,0,1,0,1,0
2337,183,8235,121,293,223,70,4,1,3,1
2006,1286,0,0,125,125,0,1,0,1,0
2401,1593,0,0,78,78,0,1,0,1,0
1405,183,4850,121,293,223,70,4,1,3,1
2289,183,8850,121,293,223,70,4,0,3,1
1773,808,0,0,145,145,0,1,0,1,0
1712,669,0,0,146,146,0,1,0,1,0
1874,183,6590,121,293,223,70,4,1,3,1
18686,2996,0,0,139,139,0,1,0,1,0
1691,619,0,0,147,147,0,1,0,1,0
1638,183,5993,121,293,223,70,4,0,3,1
8295,1404,0,0,150,150,0,1,0,1,0
1413,183,4884,121,293,223,70,4,0,3,1
8239,1806,0,0,139,139,0,1,0,1,0
21660,1562,0,0,63,63,0,1,0,1,0
2440,1448,0,0,100,100,0,1,0,1,0
2127,1467,0,0,97,97,0,1,0,1,0
345,2434,0,0,144,144,0,1,0,1,0
2784,792,0,0,119,119,0,1,0,1,0
3347,905,0,0,147,147,0,1,0,1,0
1845,975,0,0,144,144,0,1,0,1,0
4801,183,15894,121,293,223,70,4,0,3,1
2160,1379,0,0,62,62,0,1,0,1,0
1701,1003,0,0,99,99,0,1,0,1,0
766,1222,0,0,156,156,0,1,0,1,0
11543,1693,0,0,62,62,0,1,0,1,0
1348,183,4566,121,293,223,70,4,0,3,1
2305,1671,0,0,65,65,0,1,0,1,0
7630,1200,0,0,146,146,0,1,0,1,0
1999,1275,0,0,127,127,0,1,0,1,0
2120,1457,0,0,99,99,0,1,0,1,0
1442,183,5036,121,293,223,70,4,1,3,1
2412,1176,0,0,145,145,0,1,0,1,0
4115,775,0,0,147,147,0,1,0,1,0
1403,3095,0,0,148,148,0,1,0,1,0
7586,2646,0,0,86,86,0,1,0,1,0
1342,387,1464,49,207,178,28,2,0,1,0
8327,1562,0,0,146,146,0,1,0,1,0
1426,3095,0,0,139,139,0,1,0,1,0
2426,177,0,0,74,74,0,1,0,1,0
2855,1225,0,0,139,139,0,1,0,1,0
3442,183,11867,121,293,223,70,4,0,3,1
1927,183,6779,121,293,223,70,4,1,3,1
8848,1694,0,0,132,132,0,1,0,1,0
7399,2807,0,0,74,74,0,1,0,1,0
4483,369,0,0,146,146,0,1,0,1,0
1951,183,7541,121,293,223,70,4,0,3,1
1643,1305,0,0,119,119,0,1,0,1,0
3010,1558,0,0,84,84,0,1,0,1,0
9407,1543,0,0,106,106,0,1,0,1,0
8278,1396,0,0,152,152,0,1,0,1,0
2922,183,11238,121,293,223,70,4,0,3,1
1189,3095,0,0,139,139,0,1,0,1,0
3248,183,11913,121,293,223,70,4,0,3,1
4971,183,16398,121,293,223,70,4,0,3,1
2443,107,0,0,62,62,0,1,0,1,0
21537,1000,11353,48,154,126,27,2,0,1,0
2009,183,7850,121,293,223,70,4,0,3,1
60,1024,0,0,155,155,0,1,0,1,0
13894,2218,0,0,103,103,0,1,0,1,0
2004,183,7840,121,293,223,70,4,0,3,1
770,3095,0,0,139,139,0,1,0,1,0
10663,1543,0,0,65,65,0,1,0,1,0
9206,1628,0,0,113,113,0,1,0,1,0
1072,183,4064,121,293,223,70,4,1,3,1
1161,3095,0,0,141,141,0,1,0,1,0
145,1928,0,0,148,148,0,1,0,1,0
890,216,3458,116,288,220,67,3,0,2,0
1463,337,2430,67,228,189,38,2,0,2,0
2431,51,0,0,70,70,0,1,0,1,0
1991,789,0,0,62,62,0,1,0,1,0
1512,599,0,0,147,147,0,1,0,1,0
2519,1349,0,0,62,62,0,1,0,1,0
2531,1694,0,0,62,62,0,1,0,1,0
1443,183,5866,121,293,223,70,4,0,3,1
2132,1475,0,0,96,96,0,1,0,1,0
7449,887,0,0,153,153,0,1,0,1,0
42,1015,0,0,156,156,0,1,0,1,0
1962,338,0,0,116,116,0,1,0,1,0
16157,2650,0,0,124,124,0,1,0,1,0
2298,1694,0,0,62,62,0,1,0,1,0
2689,1503,0,0,62,62,0,1,0,1,0
7947,1746,0,0,128,128,0,1,0,1,0
10615,1543,0,0,66,66,0,1,0,1,0
8470,1694,0,0,142,142,0,1,0,1,0
1238,183,4515,121,293,223,70,4,1,3,1
1011,183,3898,121,293,223,70,4,1,3,1
2922,1172,0,0,147,147,0,1,0,1,0
10745,1543,0,0,63,63,0,1,0,1,0
916,183,3621,121,293,223,70,4,1,3,1
15434,1017,0,0,145,145,0,1,0,1,0
2332,1694,0,0,62,62,0,1,0,1,0
9716,1431,0,0,97,97,0,1,0,1,0
967,183,3776,121,293,223,70,4,1,3,1
1486,183,5251,121,293,223,70,4,0,3,1
1272,3095,0,0,139,139,0,1,0,1,0
2687,507,0,0,99,99,0,1,0,1,0
2624,1694,0,0,62,62,0,1,0,1,0
8480,1543,0,0,140,140,0,1,0,1,0
327,1156,0,0,144,144,0,1,0,1,0
11026,183,20797,121,293,223,70,4,0,3,1
1186,183,4144,121,293,223,70,4,1,3,1
612,1176,0,0,151,151,0,1,0,1,0
1687,183,6232,121,293,223,70,4,0,3,1
2273,1863,0,0,73,73,0,1,0,1,0
2117,183,8474,121,293,223,70,4,0,3,1
1779,658,0,0,112,112,0,1,0,1,0
2801,1694,0,0,62,62,0,1,0,1,0
10300,1543,0,0,74,74,0,1,0,1,0
8672,1543,0,0,133,133,0,1,0,1,0
1848,3095,0,0,149,149,0,1,0,1,0
1013,183,3810,121,293,223,70,4,1,3,1
13981,418,0,0,135,135,0,1,0,1,0
2582,1524,0,0,88,88,0,1,0,1,0
11181,1676,0,0,71,71,0,1,0,1,0
436,2693,0,0,142,142,0,1,0,1,0
4752,342,0,0,146,146,0,1,0,1,0
697,3080,0,0,139,139,0,1,0,1,0
2619,308,0,0,84,84,0,1,0,1,0
6552,670,0,0,146,146,0,1,0,1,0
18312,2979,0,0,145,145,0,1,0,1,0
10743,1591,0,0,68,68,0,1,0,1,0
2072,1250,0,0,131,131,0,1,0,1,0
1429,1175,0,0,139,139,0,1,0,1,0
2496,20,0,0,63,63,0,1,0,1,0
8078,2013,0,0,126,126,0,1,0,1,0
7656,2862,0,0,63,63,0,1,0,1,0
939,183,3745,121,293,223,70,4,0,3,1
2225,183,9079,121,293,223,70,4,0,3,1
1301,3095,0,0,146,146,0,1,0,1,0
2469,28,0,0,66,66,0,1,0,1,0
1195,661,0,0,150,150,0,1,0,1,0
9850,1454,0,0,92,92,0,1,0,1,0
9152,2132,0,0,68,68,0,1,0,1,0
8180,1752,0,0,134,134,0,1,0,1,0
1241,183,5026,121,293,223,70,4,0,3,1
2740,2033,0,0,85,85,0,1,0,1,0
2145,3095,0,0,157,157,0,1,0,1,0
10886,1694,0,0,79,79,0,1,0,1,0
2963,1367,0,0,116,116,0,1,0,1,0
15982,1391,0,0,145,145,0,1,0,1,0
313,1559,0,0,143,143,0,1,0,1,0
1887,2276,0,0,95,95,0,1,0,1,0
519,1118,0,0,157,157,0,1,0,1,0
2277,358,0,0,62,62,0,1,0,1,0
2761,1301,0,0,127,127,0,1,0,1,0
2939,1694,0,0,62,62,0,1,0,1,0
1149,2970,0,0,143,143,0,1,0,1,0
1941,183,7427,121,293,223,70,4,0,3,1
19147,2774,0,0,127,127,0,1,0,1,0
2018,1001,0,0,62,62,0,1,0,1,0
1611,1176,0,0,146,146,0,1,0,1,0
334,1160,0,0,144,144,0,1,0,1,0
15636,1155,0,0,145,145,0,1,0,1,0
1685,183,6291,121,293,223,70,4,0,3,1
1788,183,6720,121,293,223,70,4,0,3,1
1558,803,0,0,144,144,0,1,0,1,0
8283,1425,0,0,151,151,0,1,0,1,0
1896,777,0,0,79,79,0,1,0,1,0
1034,183,3959,121,293,223,70,4,1,3,1
1133,183,4042,121,293,223,70,4,1,3,1
12968,2041,0,0,95,95,0,1,0,1,0
1572,761,0,0,144,144,0,1,0,1,0
15297,2486,0,0,116,116,0,1,0,1,0
1677,183,6463,121,293,223,70,4,0,3,1
873,1098,0,0,155,155,0,1,0,1,0
395,1176,0,0,144,144,0,1,0,1,0
8301,1538,0,0,149,149,0,1,0,1,0
2120,3095,0,0,155,155,0,1,0,1,0
1357,183,4839,121,293,223,70,4,1,3,1
4414,183,15610,121,293,223,70,4,1,3,1
641,658,1865,63,221,184,36,2,0,2,0
1313,183,4393,121,293,223,70,4,0,3,1
4351,183,15385,121,293,223,70,4,1,3,1
2225,3095,0,0,158,158,0,1,0,1,0
1634,183,5964,121,293,223,70,4,0,3,1
2154,1364,0,0,62,62,0,1,0,1,0
8110,1852,0,0,128,128,0,1,0,1,0
9879,1543,0,0,89,89,0,1,0,1,0
1955,1186,0,0,141,141,0,1,0,1,0
3846,183,13746,121,293,223,70,4,0,3,1
1523,183,5429,121,293,223,70,4,0,3,1
2407,2747,0,0,134,134,0,1,0,1,0
8319,1648,0,0,146,146,0,1,0,1,0
8691,1543,0,0,132,132,0,1,0,1,0
2959,1352,0,0,118,118,0,1,0,1,0
8084,1482,0,0,141,141,0,1,0,1,0
2322,1694,0,0,62,62,0,1,0,1,0
2135,1906,0,0,74,74,0,1,0,1,0
8584,1678,0,0,137,137,0,1,0,1,0
1744,183,6544,121,293,223,70,4,0,3,1
2911,1323,0,0,123,123,0,1,0,1,0
10319,1543,0,0,78,78,0,1,0,1,0
2496,27,0,0,62,62,0,1,0,1,0
9751,1588,0,0,94,94,0,1,0,1,0
2403,167,0,0,62,62,0,1,0,1,0
2875,89,0,0,80,80,0,1,0,1,0
8285,1435,0,0,151,151,0,1,0,1,0
4574,183,16015,121,293,223,70,4,1,3,1
311,1572,0,0,143,143,0,1,0,1,0
1315,183,4405,121,293,223,70,4,1,3,1
8242,1175,0,0,156,156,0,1,0,1,0
2958,1694,0,0,62,62,0,1,0,1,0
41,1014,0,0,156,156,0,1,0,1,0
7531,2717,0,0,82,82,0,1,0,1,0
2188,183,8865,121,293,223,70,4,0,3,1
8303,1186,0,0,154,154,0,1,0,1,0
949,183,3684,121,293,223,70,4,1,3,1
181,2182,0,0,146,146,0,1,0,1,0
2693,2134,0,0,92,92,0,1,0,1,0
2504,1176,0,0,145,145,0,1,0,1,0
7759,1382,0,0,146,146,0,1,0,1,0
857,759,0,0,152,152,0,1,0,1,0
10844,1550,0,0,62,62,0,1,0,1,0
1686,183,6221,121,293,223,70,4,0,3,1
2499,1331,0,0,62,62,0,1,0,1,0
467,1176,0,0,146,146,0,1,0,1,0
2084,1176,0,0,143,143,0,1,0,1,0
1609,183,5923,121,293,223,70,4,0,3,1
1501,970,0,0,141,141,0,1,0,1,0
3026,1694,0,0,62,62,0,1,0,1,0
2344,1640,0,0,70,70,0,1,0,1,0
1513,183,5392,121,293,223,70,4,0,3,1
1886,1070,0,0,143,143,0,1,0,1,0
172,2122,0,0,147,147,0,1,0,1,0
1682,599,0,0,147,147,0,1,0,1,0
2878,1563,0,0,62,62,0,1,0,1,0
7998,1513,0,0,146,146,0,1,0,1,0
9515,1543,0,0,102,102,0,1,0,1,0
1059,1176,0,0,153,153,0,1,0,1,0
2468,1694,0,0,62,62,0,1,0,1,0
450,2714,0,0,142,142,0,1,0,1,0
1637,183,6040,121,293,223,70,4,0,3,1
17372,1543,0,0,65,65,0,1,0,1,0
1590,183,5775,121,293,223,70,4,0,3,1
1392,183,4934,121,293,223,70,4,1,3,1
8327,1585,0,0,146,146,0,1,0,1,0
7943,2722,0,0,64,64,0,1,0,1,0
7521,2571,0,0,86,86,0,1,0,1,0
10115,1543,0,0,85,85,0,1,0,1,0
1908,183,7450,121,293,223,70,4,0,3,1
2201,1578,0,0,80,80,0,1,0,1,0
1503,183,5341,121,293,223,70,4,0,3,1
1310,183,4384,121,293,223,70,4,1,3,1
2904,1514,0,0,91,91,0,1,0,1,0
2548,183,8984,121,293,223,70,4,1,3,1
7515,911,0,0,153,153,0,1,0,1,0
862,1106,0,0,156,156,0,1,0,1,0
2227,183,9107,121,293,223,70,4,0,3,1
219,1103,0,0,148,148,0,1,0,1,0
1703,646,0,0,147,147,0,1,0,1,0
1929,183,7415,121,293,223,70,4,0,3,1
3154,183,11615,121,293,223,70,4,0,3,1
12567,819,0,0,112,112,0,1,0,1,0
3289,1290,0,0,88,88,0,1,0,1,0
17643,2934,0,0,137,137,0,1,0,1,0
4740,183,16221,121,293,223,70,4,1,3,1
9527,1543,0,0,102,102,0,1,0,1,0
18194,2899,0,0,145,145,0,1,0,1,0
3012,1566,0,0,83,83,0,1,0,1,0
8259,1247,0,0,154,154,0,1,0,1,0
2905,1487,0,0,96,96,0,1,0,1,0
2215,183,9020,121,293,223,70,4,0,3,1
9321,1330,0,0,117,117,0,1,0,1,0
8287,1368,0,0,151,151,0,1,0,1,0
1422,3095,0,0,139,139,0,1,0,1,0
1401,3095,0,0,140,140,0,1,0,1,0
9886,1411,0,0,96,96,0,1,0,1,0
3552,776,0,0,146,146,0,1,0,1,0
1707,999,0,0,98,98,0,1,0,1,0
2324,117,0,0,80,80,0,1,0,1,0
5111,306,0,0,146,146,0,1,0,1,0
4936,183,16465,121,293,223,70,4,1,3,1
1946,995,0,0,99,99,0,1,0,1,0
8186,1875,0,0,134,134,0,1,0,1,0
10774,1545,0,0,63,63,0,1,0,1,0
8598,1237,0,0,142,142,0,1,0,1,0
7393,2818,0,0,73,73,0,1,0,1,0
2219,3095,0,0,158,158,0,1,0,1,0
17989,183,26049,121,293,223,70,4,0,3,1
2665,1379,0,0,114,114,0,1,0,1,0
2147,183,8647,121,293,223,70,4,0,3,1
598,2608,0,0,144,144,0,1,0,1,0
746,1867,0,0,150,150,0,1,0,1,0
2062,682,0,0,62,62,0,1,0,1,0
13777,2144,0,0,88,88,0,1,0,1,0
1421,3095,0,0,139,139,0,1,0,1,0
502,2530,0,0,143,143,0,1,0,1,0
304,1145,0,0,145,145,0,1,0,1,0
21638,1572,0,0,63,63,0,1,0,1,0
39,1007,0,0,157,157,0,1,0,1,0
21626,1295,5177,22,104,91,12,1,0,1,0
1405,183,4852,121,293,223,70,4,1,3,1
646,2617,0,0,142,142,0,1,0,1,0
419,1176,0,0,144,144,0,1,0,1,0
4965,183,16501,121,293,223,70,4,1,3,1
2099,626,0,0,62,62,0,1,0,1,0
4742,183,16223,121,293,223,70,4,1,3,1
12929,969,0,0,103,103,0,1,0,1,0
1240,183,4249,121,293,223,70,4,1,3,1
4479,369,0,0,146,146,0,1,0,1,0
472,871,0,0,154,154,0,1,0,1,0
10552,1543,0,0,67,67,0,1,0,1,0
2507,1507,0,0,92,92,0,1,0,1,0
11388,1673,0,0,63,63,0,1,0,1,0
11296,1642,0,0,62,62,0,1,0,1,0
10576,1557,0,0,69,69,0,1,0,1,0
1944,1020,0,0,105,105,0,1,0,1,0
8257,1237,0,0,155,155,0,1,0,1,0
7990,2024,0,0,119,119,0,1,0,1,0
1783,662,0,0,110,110,0,1,0,1,0
3033,1652,0,0,68,68,0,1,0,1,0
1268,3048,0,0,143,143,0,1,0,1,0
11523,1689,0,0,62,62,0,1,0,1,0
1788,667,0,0,109,109,0,1,0,1,0
11934,183,19025,121,293,223,70,4,0,3,1
8276,1380,0,0,152,152,0,1,0,1,0
1950,944,0,0,87,87,0,1,0,1,0
1334,183,4499,121,293,223,70,4,1,3,1
1959,3095,0,0,155,155,0,1,0,1,0
2151,1504,0,0,91,91,0,1,0,1,0
20475,2133,0,0,93,93,0,1,0,1,0
445,1101,0,0,157,157,0,1,0,1,0
776,2725,0,0,143,143,0,1,0,1,0
2914,1224,0,0,140,140,0,1,0,1,0
1715,994,0,0,97,97,0,1,0,1,0
1650,3095,0,0,151,151,0,1,0,1,0
20340,1304,0,0,77,77,0,1,0,1,0
12134,961,0,0,104,104,0,1,0,1,0
1462,183,5134,121,293,223,70,4,0,3,1
1626,183,6011,121,293,223,70,4,0,3,1
2020,183,7921,121,293,223,70,4,0,3,1
536,2567,0,0,144,144,0,1,0,1,0
955,1176,0,0,151,151,0,1,0,1,0
2612,1694,0,0,62,62,0,1,0,1,0
1571,765,0,0,144,144,0,1,0,1,0
9062,1639,0,0,119,119,0,1,0,1,0
1341,619,0,0,149,149,0,1,0,1,0
1516,3095,0,0,141,141,0,1,0,1,0
2444,183,8909,121,293,223,70,4,0,3,1
21480,808,15378,65,186,148,37,2,0,2,0
775,3095,0,0,139,139,0,1,0,1,0
7729,1249,0,0,146,146,0,1,0,1,0
73,1404,0,0,153,153,0,1,0,1,0
206,1096,0,0,149,149,0,1,0,1,0
1213,183,4447,121,293,223,70,4,1,3,1
266,1898,0,0,144,144,0,1,0,1,0
4514,183,15940,121,293,223,70,4,1,3,1
8304,1442,0,0,148,148,0,1,0,1,0
7286,3023,0,0,63,63,0,1,0,1,0
1398,3074,0,0,139,139,0,1,0,1,0
4222,183,15094,121,293,223,70,4,0,3,1
2027,864,0,0,68,68,0,1,0,1,0
1419,183,4925,121,293,223,70,4,0,3,1
1335,183,4502,121,293,223,70,4,1,3,1
1933,855,0,0,65,65,0,1,0,1,0
1859,183,7121,121,293,223,70,4,0,3,1
541,1087,0,0,143,143,0,1,0,1,0
181,1084,0,0,150,150,0,1,0,1,0
2584,1694,0,0,62,62,0,1,0,1,0
236,2368,0,0,144,144,0,1,0,1,0
7941,2094,0,0,115,115,0,1,0,1,0
17576,2921,0,0,136,136,0,1,0,1,0
8840,1662,0,0,128,128,0,1,0,1,0
1779,953,0,0,88,88,0,1,0,1,0
10675,1543,0,0,64,64,0,1,0,1,0
4673,183,16138,121,293,223,70,4,1,3,1
2876,1694,0,0,62,62,0,1,0,1,0
1625,964,0,0,125,125,0,1,0,1,0
2073,183,8230,121,293,223,70,4,0,3,1
1985,3095,0,0,155,155,0,1,0,1,0
310,1580,0,0,143,143,0,1,0,1,0
1211,183,4440,121,293,223,70,4,1,3,1
350,1289,0,0,143,143,0,1,0,1,0
486,1176,0,0,142,142,0,1,0,1,0
742,3095,0,0,139,139,0,1,0,1,0
2225,183,9098,121,293,223,70,4,0,3,1
3889,183,13890,121,293,223,70,4,0,3,1
10500,1498,0,0,73,73,0,1,0,1,0
4605,183,15208,121,293,223,70,4,1,3,1
795,1176,0,0,156,156,0,1,0,1,0
2040,1338,0,0,117,117,0,1,0,1,0
108,1661,0,0,151,151,0,1,0,1,0
1812,1176,0,0,142,142,0,1,0,1,0
20913,1543,0,0,62,62,0,1,0,1,0
2592,1438,0,0,104,104,0,1,0,1,0
1567,443,1084,29,183,166,17,1,0,1,0
1528,619,0,0,149,149,0,1,0,1,0
122,1760,0,0,150,150,0,1,0,1,0
19550,1543,0,0,62,62,0,1,0,1,0
4629,183,16083,121,293,223,70,4,1,3,1
1318,183,4420,121,293,223,70,4,1,3,1
17406,2361,0,0,145,145,0,1,0,1,0
3631,726,0,0,146,146,0,1,0,1,0
1230,183,4229,121,293,223,70,4,1,3,1
7358,2928,0,0,68,68,0,1,0,1,0
2812,1259,0,0,134,134,0,1,0,1,0
14221,2233,0,0,98,98,0,1,0,1,0
10632,1553,0,0,67,67,0,1,0,1,0
1418,596,0,0,149,149,0,1,0,1,0
45,1200,0,0,155,155,0,1,0,1,0
2159,218,0,0,97,97,0,1,0,1,0
1579,739,0,0,145,145,0,1,0,1,0
2161,533,0,0,62,62,0,1,0,1,0
6740,2103,0,0,90,90,0,1,0,1,0
8275,1318,0,0,152,152,0,1,0,1,0
18654,3011,0,0,140,140,0,1,0,1,0
1277,3054,0,0,143,143,0,1,0,1,0
1421,183,4928,121,293,223,70,4,1,3,1
8470,1683,0,0,140,140,0,1,0,1,0
948,183,3683,121,293,223,70,4,1,3,1
8310,1591,0,0,148,148,0,1,0,1,0
1724,988,0,0,96,96,0,1,0,1,0
1609,183,5846,121,293,223,70,4,0,3,1
5967,383,0,0,146,146,0,1,0,1,0
7653,2506,0,0,92,92,0,1,0,1,0
1419,422,1101,37,192,171,21,1,0,1,0
1681,183,6292,121,293,223,70,4,0,3,1
4001,183,14437,121,293,223,70,4,0,3,1
10668,1652,0,0,84,84,0,1,0,1,0
5023,183,16572,121,293,223,70,4,1,3,1
8591,1236,0,0,143,143,0,1,0,1,0
10729,1589,0,0,68,68,0,1,0,1,0
1984,909,0,0,62,62,0,1,0,1,0
2565,183,9043,121,293,223,70,4,1,3,1
2142,1611,0,0,74,74,0,1,0,1,0
1401,183,4830,121,293,223,70,4,1,3,1
1628,183,5964,121,293,223,70,4,0,3,1
2766,1977,0,0,81,81,0,1,0,1,0
2783,789,0,0,119,119,0,1,0,1,0
861,2781,0,0,143,143,0,1,0,1,0
1629,506,288,7,157,152,4,1,0,1,0
1994,1268,0,0,128,128,0,1,0,1,0
2101,835,0,0,119,119,0,1,0,1,0
3728,183,13173,121,293,223,70,4,1,3,1
9597,1268,0,0,145,145,0,1,0,1,0
652,638,1939,65,224,186,37,2,0,2,0
1679,3095,0,0,145,145,0,1,0,1,0
644,821,0,0,153,153,0,1,0,1,0
1840,183,7098,121,293,223,70,4,0,3,1
3096,183,10931,121,293,223,70,4,1,3,1
10011,1428,0,0,91,91,0,1,0,1,0
2992,183,11203,121,293,223,70,4,0,3,1
1169,3095,0,0,141,141,0,1,0,1,0
1802,1176,0,0,141,141,0,1,0,1,0
1700,578,0,0,134,134,0,1,0,1,0
192,2268,0,0,145,145,0,1,0,1,0
2937,1694,0,0,62,62,0,1,0,1,0
6734,627,0,0,150,150,0,1,0,1,0
8147,2622,0,0,64,64,0,1,0,1,0
2254,183,9248,121,293,223,70,4,0,3,1
4251,183,14522,121,293,223,70,4,0,3,1
2117,183,8455,121,293,223,70,4,0,3,1
2586,1334,0,0,62,62,0,1,0,1,0
1591,3095,0,0,142,142,0,1,0,1,0
2314,301,0,0,62,62,0,1,0,1,0
2094,1203,0,0,62,62,0,1,0,1,0
1988,1259,0,0,129,129,0,1,0,1,0
760,787,0,0,152,152,0,1,0,1,0
9339,1332,0,0,116,116,0,1,0,1,0
10779,1012,0,0,145,145,0,1,0,1,0
15209,864,0,0,145,145,0,1,0,1,0
2222,1610,0,0,74,74,0,1,0,1,0
947,1044,0,0,155,155,0,1,0,1,0
1951,844,0,0,62,62,0,1,0,1,0
1029,183,3947,121,293,223,70,4,1,3,1
10371,1544,0,0,71,71,0,1,0,1,0
2444,1694,0,0,62,62,0,1,0,1,0
2968,1634,0,0,62,62,0,1,0,1,0
2112,607,0,0,62,62,0,1,0,1,0
2555,2430,0,0,113,113,0,1,0,1,0
1713,183,6386,121,293,223,70,4,0,3,1
2605,1694,0,0,62,62,0,1,0,1,0
1158,672,0,0,150,150,0,1,0,1,0
4072,183,14496,121,293,223,70,4,0,3,1
16879,1614,0,0,62,62,0,1,0,1,0
1414,183,4895,121,293,223,70,4,1,3,1
3773,183,12541,121,293,223,70,4,1,3,1
2144,1336,0,0,62,62,0,1,0,1,0
1728,183,6428,121,293,223,70,4,0,3,1
1718,183,6380,121,293,223,70,4,0,3,1
1359,231,3769,103,272,212,60,3,0,2,0
7548,183,14602,121,293,223,70,4,0,3,1
1841,183,7029,121,293,223,70,4,0,3,1
13036,1543,0,0,62,62,0,1,0,1,0
2493,183,9965,121,293,223,70,4,0,3,1
2197,1814,0,0,68,68,0,1,0,1,0
1896,1091,0,0,143,143,0,1,0,1,0
267,1127,0,0,146,146,0,1,0,1,0
3613,183,12972,121,293,223,70,4,0,3,1
1101,688,0,0,151,151,0,1,0,1,0
2351,1694,0,0,62,62,0,1,0,1,0
951,1176,0,0,152,152,0,1,0,1,0
2887,92,0,0,81,81,0,1,0,1,0
2329,970,0,0,95,95,0,1,0,1,0
11131,935,0,0,145,145,0,1,0,1,0
10208,1554,0,0,77,77,0,1,0,1,0
1905,373,0,0,122,122,0,1,0,1,0
12627,1127,0,0,94,94,0,1,0,1,0
8525,1216,0,0,146,146,0,1,0,1,0
841,597,2084,70,236,195,40,2,0,2,0
1413,703,0,0,150,150,0,1,0,1,0
4509,183,11537,121,293,223,70,4,0,3,1
2960,1354,0,0,118,118,0,1,0,1,0
6784,847,0,0,146,146,0,1,0,1,0
7786,2389,0,0,102,102,0,1,0,1,0
17794,2626,0,0,145,145,0,1,0,1,0
1946,847,0,0,63,63,0,1,0,1,0
1369,3095,0,0,141,141,0,1,0,1,0
9176,1309,0,0,122,122,0,1,0,1,0
1503,962,0,0,141,141,0,1,0,1,0
1738,183,6478,121,293,223,70,4,0,3,1
6310,1342,0,0,113,113,0,1,0,1,0
1205,3095,0,0,142,142,0,1,0,1,0
290,2170,0,0,146,146,0,1,0,1,0
8715,1670,0,0,132,132,0,1,0,1,0
1590,183,5748,121,293,223,70,4,0,3,1
1733,717,0,0,146,146,0,1,0,1,0
3191,183,12034,121,293,223,70,4,0,3,1
1510,1125,0,0,127,127,0,1,0,1,0
6784,645,0,0,150,150,0,1,0,1,0
579,2905,0,0,140,140,0,1,0,1,0
3346,183,12496,121,293,223,70,4,0,3,1
10489,1543,0,0,69,69,0,1,0,1,0
2117,1452,0,0,99,99,0,1,0,1,0
3620,947,0,0,110,110,0,1,0,1,0
2510,3,0,0,62,62,0,1,0,1,0
1436,1176,0,0,148,148,0,1,0,1,0
8320,1514,0,0,146,146,0,1,0,1,0
19464,1543,0,0,62,62,0,1,0,1,0
5564,261,0,0,146,146,0,1,0,1,0
1974,183,7691,121,293,223,70,4,0,3,1
453,1131,0,0,143,143,0,1,0,1,0
8270,1346,0,0,153,153,0,1,0,1,0
2095,1206,0,0,62,62,0,1,0,1,0
8606,1543,0,0,136,136,0,1,0,1,0
1336,3036,0,0,139,139,0,1,0,1,0
17121,2167,0,0,145,145,0,1,0,1,0
1937,1120,0,0,129,129,0,1,0,1,0
1754,183,6746,121,293,223,70,4,0,3,1
8881,1286,0,0,131,131,0,1,0,1,0
9065,1318,0,0,123,123,0,1,0,1,0
1240,735,0,0,146,146,0,1,0,1,0
318,1517,0,0,143,143,0,1,0,1,0
2523,1176,0,0,146,146,0,1,0,1,0
1713,183,6393,121,293,223,70,4,0,3,1
8605,1556,0,0,138,138,0,1,0,1,0
1579,741,0,0,145,145,0,1,0,1,0
11485,1686,0,0,62,62,0,1,0,1,0
1544,842,0,0,143,143,0,1,0,1,0
1575,754,0,0,144,144,0,1,0,1,0
2401,1694,0,0,62,62,0,1,0,1,0
1328,183,4471,121,293,223,70,4,1,3,1
2093,1200,0,0,62,62,0,1,0,1,0
130,1058,0,0,152,152,0,1,0,1,0
2083,183,8258,121,293,223,70,4,0,3,1
11519,1162,0,0,93,93,0,1,0,1,0
8248,1202,0,0,156,156,0,1,0,1,0
2119,183,8545,121,293,223,70,4,0,3,1
3068,183,11166,121,293,223,70,4,0,3,1
1593,183,5771,121,293,223,70,4,0,3,1
8325,1686,0,0,146,146,0,1,0,1,0
8327,1655,0,0,146,146,0,1,0,1,0
2993,1490,0,0,95,95,0,1,0,1,0
522,1097,0,0,143,143,0,1,0,1,0
2640,1459,0,0,62,62,0,1,0,1,0
4376,380,0,0,146,146,0,1,0,1,0
2087,261,0,0,104,104,0,1,0,1,0
1324,3029,0,0,139,139,0,1,0,1,0
10930,1567,0,0,62,62,0,1,0,1,0
2824,1852,0,0,72,72,0,1,0,1,0
2985,1457,0,0,101,101,0,1,0,1,0
4467,371,0,0,146,146,0,1,0,1,0
14096,294,0,0,145,145,0,1,0,1,0
717,2749,0,0,142,142,0,1,0,1,0
1682,3095,0,0,145,145,0,1,0,1,0
2069,183,8178,121,293,223,70,4,0,3,1
2567,1694,0,0,62,62,0,1,0,1,0
597,1136,0,0,157,157,0,1,0,1,0
7549,2695,0,0,83,83,0,1,0,1,0
1135,3095,0,0,139,139,0,1,0,1,0
17086,1543,0,0,62,62,0,1,0,1,0
2046,183,8049,121,293,223,70,4,0,3,1
6421,1538,0,0,107,107,0,1,0,1,0
2902,1590,0,0,79,79,0,1,0,1,0
17901,2977,0,0,138,138,0,1,0,1,0
1882,183,7178,121,293,223,70,4,0,3,1
2090,183,8324,121,293,223,70,4,0,3,1
1927,360,0,0,120,120,0,1,0,1,0
1604,564,0,0,148,148,0,1,0,1,0
2941,1279,0,0,130,130,0,1,0,1,0
1627,183,5962,121,293,223,70,4,0,3,1
13882,405,0,0,134,134,0,1,0,1,0
458,1176,0,0,146,146,0,1,0,1,0
1699,1004,0,0,99,99,0,1,0,1,0
1873,1040,0,0,144,144,0,1,0,1,0
1297,3067,0,0,143,143,0,1,0,1,0
1570,767,0,0,144,144,0,1,0,1,0
1848,183,7065,121,293,223,70,4,0,3,1
10143,1505,0,0,80,80,0,1,0,1,0
3027,127,0,0,88,88,0,1,0,1,0
9496,1543,0,0,103,103,0,1,0,1,0
16143,1543,0,0,62,62,0,1,0,1,0
2076,183,8218,121,293,223,70,4,0,3,1
1125,183,4208,121,293,223,70,4,1,3,1
2441,1694,0,0,62,62,0,1,0,1,0
4003,183,13650,121,293,223,70,4,0,3,1
3616,1024,0,0,105,105,0,1,0,1,0
13288,781,0,0,114,114,0,1,0,1,0
7485,2945,0,0,62,62,0,1,0,1,0
14715,2375,0,0,111,111,0,1,0,1,0
1835,715,0,0,96,96,0,1,0,1,0
7314,183,18026,121,293,223,70,4,0,3,1
2015,183,7878,121,293,223,70,4,0,3,1
1215,3095,0,0,139,139,0,1,0,1,0
13995,411,0,0,135,135,0,1,0,1,0
2163,183,8735,121,293,223,70,4,0,3,1
1513,1176,0,0,139,139,0,1,0,1,0
1500,1131,0,0,128,128,0,1,0,1,0
2899,1664,0,0,66,66,0,1,0,1,0
6193,1133,0,0,119,119,0,1,0,1,0
15453,2516,0,0,117,117,0,1,0,1,0
123,1763,0,0,150,150,0,1,0,1,0
632,1176,0,0,152,152,0,1,0,1,0
277,1131,0,0,146,146,0,1,0,1,0
7753,2431,0,0,100,100,0,1,0,1,0
1923,804,0,0,71,71,0,1,0,1,0
9196,2110,0,0,68,68,0,1,0,1,0
1436,1179,0,0,138,138,0,1,0,1,0
647,648,1902,64,222,185,37,2,0,2,0
4234,183,15033,121,293,223,70,4,0,3,1
979,183,3811,121,293,223,70,4,1,3,1
4923,183,16448,121,293,223,70,4,1,3,1
19543,2583,0,0,117,117,0,1,0,1,0
1021,3095,0,0,139,139,0,1,0,1,0
2142,183,7309,121,293,223,70,4,1,3,1
1354,3095,0,0,142,142,0,1,0,1,0
2459,1458,0,0,98,98,0,1,0,1,0
1985,183,7716,121,293,223,70,4,0,3,1
1020,3095,0,0,140,140,0,1,0,1,0
8280,1753,0,0,142,142,0,1,0,1,0
1602,565,0,0,148,148,0,1,0,1,0
1375,3095,0,0,141,141,0,1,0,1,0
1403,601,0,0,149,149,0,1,0,1,0
2181,1292,0,0,124,124,0,1,0,1,0
1639,537,0,0,148,148,0,1,0,1,0
1212,1176,0,0,144,144,0,1,0,1,0
2874,1694,0,0,62,62,0,1,0,1,0
789,380,2866,96,263,207,56,3,0,2,0
20835,1960,0,0,84,84,0,1,0,1,0
2124,3095,0,0,157,157,0,1,0,1,0
3472,1100,0,0,100,100,0,1,0,1,0
16735,183,25133,121,293,223,70,4,0,3,1
11325,1665,0,0,63,63,0,1,0,1,0
2959,1694,0,0,62,62,0,1,0,1,0
2970,1694,0,0,62,62,0,1,0,1,0
1952,183,7549,121,293,223,70,4,0,3,1
220,2372,0,0,144,144,0,1,0,1,0
1676,183,6265,121,293,223,70,4,0,3,1
1408,3095,0,0,139,139,0,1,0,1,0
12423,945,0,0,100,100,0,1,0,1,0
2142,3095,0,0,157,157,0,1,0,1,0
18532,3070,0,0,143,143,0,1,0,1,0
874,346,2992,101,270,212,58,3,0,2,0
2466,1694,0,0,62,62,0,1,0,1,0
2618,1176,0,0,146,146,0,1,0,1,0
206,1046,0,0,157,157,0,1,0,1,0
908,183,3606,121,293,223,70,4,1,3,1
2094,183,8423,121,293,223,70,4,0,3,1
527,2829,0,0,141,141,0,1,0,1,0
1914,183,7549,121,293,223,70,4,0,3,1
3367,183,12558,121,293,223,70,4,0,3,1
11157,1644,0,0,65,65,0,1,0,1,0
10909,1612,0,0,67,67,0,1,0,1,0
8562,1679,0,0,138,138,0,1,0,1,0
2312,1379,0,0,111,111,0,1,0,1,0
6319,476,0,0,148,148,0,1,0,1,0
387,1176,0,0,143,143,0,1,0,1,0
2531,1360,0,0,62,62,0,1,0,1,0
7256,1017,0,0,146,146,0,1,0,1,0
9150,1581,0,0,124,124,0,1,0,1,0
111,1024,0,0,157,157,0,1,0,1,0
4274,183,11300,121,293,223,70,4,0,3,1
1389,183,4771,121,293,223,70,4,1,3,1
961,3095,0,0,139,139,0,1,0,1,0
2170,183,8760,121,293,223,70,4,0,3,1
10802,1599,0,0,68,68,0,1,0,1,0
8775,1268,0,0,135,135,0,1,0,1,0
1936,183,7598,121,293,223,70,4,0,3,1
2682,2156,0,0,94,94,0,1,0,1,0
609,2950,0,0,140,140,0,1,0,1,0
1956,3095,0,0,151,151,0,1,0,1,0
2245,3063,0,0,156,156,0,1,0,1,0
1588,1075,0,0,116,116,0,1,0,1,0
8565,183,19165,121,293,223,70,4,0,3,1
2141,3095,0,0,157,157,0,1,0,1,0
10254,1524,0,0,76,76,0,1,0,1,0
1969,183,7634,121,293,223,70,4,0,3,1
2102,183,8467,121,293,223,70,4,0,3,1
3373,889,0,0,147,147,0,1,0,1,0
7905,1829,0,0,123,123,0,1,0,1,0
10231,1543,0,0,76,76,0,1,0,1,0
2598,247,0,0,80,80,0,1,0,1,0
2139,566,0,0,62,62,0,1,0,1,0
55,1272,0,0,154,154,0,1,0,1,0
1933,1170,0,0,141,141,0,1,0,1,0
12770,2003,0,0,93,93,0,1,0,1,0
10714,183,20735,121,293,223,70,4,0,3,1
903,183,3602,121,293,223,70,4,1,3,1
10875,1556,0,0,62,62,0,1,0,1,0
1472,1054,0,0,140,140,0,1,0,1,0
10485,1562,0,0,72,72,0,1,0,1,0
2071,1384,0,0,110,110,0,1,0,1,0
2076,183,8162,121,293,223,70,4,0,3,1
318,1072,0,0,157,157,0,1,0,1,0
2042,1550,0,0,83,83,0,1,0,1,0
12977,536,0,0,145,145,0,1,0,1,0
4064,183,13822,121,293,223,70,4,0,3,1
4111,183,14625,121,293,223,70,4,0,3,1
2957,1694,0,0,62,62,0,1,0,1,0
14395,264,0,0,143,143,0,1,0,1,0
2084,939,0,0,62,62,0,1,0,1,0
1380,183,4742,121,293,223,70,4,0,3,1
760,1425,0,0,154,154,0,1,0,1,0
261,2433,0,0,144,144,0,1,0,1,0
2391,991,0,0,100,100,0,1,0,1,0
2063,183,8139,121,293,223,70,4,0,3,1
1464,443,886,29,183,166,17,1,0,1,0
2267,1687,0,0,62,62,0,1,0,1,0
1039,3095,0,0,141,141,0,1,0,1,0
2622,1362,0,0,62,62,0,1,0,1,0
16465,2687,0,0,123,123,0,1,0,1,0
2811,1176,0,0,147,147,0,1,0,1,0
1680,183,6195,121,293,223,70,4,0,3,1
3631,183,13031,121,293,223,70,4,0,3,1
16501,183,24962,121,293,223,70,4,0,3,1
2681,2160,0,0,94,94,0,1,0,1,0
3978,509,0,0,146,146,0,1,0,1,0
9804,1543,0,0,92,92,0,1,0,1,0
11339,1684,0,0,67,67,0,1,0,1,0
10869,1607,0,0,67,67,0,1,0,1,0
1152,3095,0,0,144,144,0,1,0,1,0
1146,183,4264,121,293,223,70,4,1,3,1
3386,1293,0,0,88,88,0,1,0,1,0
1573,1085,0,0,118,118,0,1,0,1,0
3164,1552,0,0,71,71,0,1,0,1,0
8436,1543,0,0,142,142,0,1,0,1,0
1135,3095,0,0,141,141,0,1,0,1,0
2812,1585,0,0,78,78,0,1,0,1,0
1127,3095,0,0,139,139,0,1,0,1,0
2911,1694,0,0,62,62,0,1,0,1,0
1393,183,4790,121,293,223,70,4,1,3,1
1607,3095,0,0,150,150,0,1,0,1,0
413,2486,0,0,144,144,0,1,0,1,0
1304,3017,0,0,139,139,0,1,0,1,0
4200,183,15026,121,293,223,70,4,0,3,1
1945,1009,0,0,102,102,0,1,0,1,0
2808,862,0,0,125,125,0,1,0,1,0
4060,505,0,0,139,139,0,1,0,1,0
183,2199,0,0,146,146,0,1,0,1,0
7814,2353,0,0,105,105,0,1,0,1,0
7862,2761,0,0,63,63,0,1,0,1,0
1747,470,0,0,138,138,0,1,0,1,0
800,3095,0,0,139,139,0,1,0,1,0
2275,1689,0,0,62,62,0,1,0,1,0
5010,183,16514,121,293,223,70,4,0,3,1
10536,1543,0,0,71,71,0,1,0,1,0
20805,1974,0,0,85,85,0,1,0,1,0
4519,365,0,0,146,146,0,1,0,1,0
2730,1694,0,0,62,62,0,1,0,1,0
10754,1543,0,0,63,63,0,1,0,1,0
972,183,3729,121,293,223,70,4,1,3,1
318,1522,0,0,143,143,0,1,0,1,0
252,1996,0,0,144,144,0,1,0,1,0
11630,1649,0,0,64,64,0,1,0,1,0
9207,1628,0,0,113,113,0,1,0,1,0
520,1176,0,0,142,142,0,1,0,1,0
960,183,3759,121,293,223,70,4,1,3,1
1570,1176,0,0,140,140,0,1,0,1,0
9302,1543,0,0,112,112,0,1,0,1,0
2228,1619,0,0,73,73,0,1,0,1,0
236,1111,0,0,148,148,0,1,0,1,0
457,1104,0,0,157,157,0,1,0,1,0
601,1057,0,0,143,143,0,1,0,1,0
1363,183,4639,121,293,223,70,4,0,3,1
9836,1543,0,0,91,91,0,1,0,1,0
8327,1594,0,0,146,146,0,1,0,1,0
4343,699,0,0,146,146,0,1,0,1,0
1452,1162,0,0,135,135,0,1,0,1,0
1934,1151,0,0,137,137,0,1,0,1,0
903,3095,0,0,140,140,0,1,0,1,0
21679,1470,1510,6,74,70,3,1,0,1,0
1386,3095,0,0,139,139,0,1,0,1,0
935,3095,0,0,139,139,0,1,0,1,0
100,1596,0,0,151,151,0,1,0,1,0
2966,1378,0,0,114,114,0,1,0,1,0
2050,183,8098,121,293,223,70,4,0,3,1
1139,3095,0,0,139,139,0,1,0,1,0
8960,1300,0,0,128,128,0,1,0,1,0
1112,3095,0,0,139,139,0,1,0,1,0
2775,1568,0,0,81,81,0,1,0,1,0
248,1117,0,0,147,147,0,1,0,1,0
10617,1575,0,0,69,69,0,1,0,1,0
1408,3095,0,0,139,139,0,1,0,1,0
1687,1012,0,0,101,101,0,1,0,1,0
2970,183,10707,121,293,223,70,4,0,3,1
8906,1543,0,0,124,124,0,1,0,1,0
2274,3031,0,0,154,154,0,1,0,1,0
10770,1537,0,0,63,63,0,1,0,1,0
1941,183,7656,121,293,223,70,4,0,3,1
1702,645,0,0,147,147,0,1,0,1,0
1983,3095,0,0,152,152,0,1,0,1,0
1349,3095,0,0,142,142,0,1,0,1,0
8249,1204,0,0,156,156,0,1,0,1,0
1657,183,6112,121,293,223,70,4,0,3,1
931,1176,0,0,152,152,0,1,0,1,0
10493,1543,0,0,69,69,0,1,0,1,0
6730,758,0,0,146,146,0,1,0,1,0
2625,325,0,0,85,85,0,1,0,1,0
6396,504,0,0,149,149,0,1,0,1,0
3919,183,13853,121,293,223,70,4,1,3,1
8497,1543,0,0,140,140,0,1,0,1,0
1218,846,0,0,152,152,0,1,0,1,0
11192,1694,0,0,71,71,0,1,0,1,0
2088,643,0,0,62,62,0,1,0,1,0
2226,183,8262,121,293,223,70,4,0,3,1
2058,183,8432,121,293,223,70,4,0,3,1
9148,1632,0,0,116,116,0,1,0,1,0
14656,487,0,0,145,145,0,1,0,1,0
15859,183,22983,121,293,223,70,4,0,3,1
11193,1543,0,0,71,71,0,1,0,1,0
4849,333,0,0,146,146,0,1,0,1,0
753,447,2624,88,252,201,51,3,0,2,0
109,1663,0,0,151,151,0,1,0,1,0
2021,1009,0,0,62,62,0,1,0,1,0
1965,1176,0,0,143,143,0,1,0,1,0
1512,936,0,0,142,142,0,1,0,1,0
1863,1015,0,0,144,144,0,1,0,1,0
2422,139,0,0,62,62,0,1,0,1,0
5651,253,0,0,146,146,0,1,0,1,0
17909,2704,0,0,145,145,0,1,0,1,0
527,1176,0,0,148,148,0,1,0,1,0
1465,339,2408,66,227,189,38,2,0,2,0
942,2797,0,0,141,141,0,1,0,1,0
3575,1072,0,0,102,102,0,1,0,1,0
1013,3095,0,0,139,139,0,1,0,1,0
16591,1806,0,0,145,145,0,1,0,1,0
2840,1176,0,0,147,147,0,1,0,1,0
4834,183,16337,121,293,223,70,4,1,3,1
764,1176,0,0,156,156,0,1,0,1,0
2007,970,0,0,62,62,0,1,0,1,0
9604,1543,0,0,102,102,0,1,0,1,0
1009,999,0,0,154,154,0,1,0,1,0
1729,183,6519,121,293,223,70,4,0,3,1
1646,526,28,0,149,148,0,1,0,1,0
8327,1569,0,0,146,146,0,1,0,1,0
1330,3089,0,0,143,143,0,1,0,1,0
7819,1415,0,0,146,146,0,1,0,1,0
3003,1694,0,0,62,62,0,1,0,1,0
8313,1483,0,0,147,147,0,1,0,1,0
1356,183,4606,121,293,223,70,4,1,3,1
1959,837,0,0,62,62,0,1,0,1,0
1532,3095,0,0,146,146,0,1,0,1,0
6440,658,0,0,146,146,0,1,0,1,0
1231,183,4231,121,293,223,70,4,1,3,1
12592,883,0,0,104,104,0,1,0,1,0
10540,1565,0,0,70,70,0,1,0,1,0
567,1129,0,0,157,157,0,1,0,1,0
8327,1667,0,0,146,146,0,1,0,1,0
6069,433,0,0,146,146,0,1,0,1,0
331,2537,0,0,143,143,0,1,0,1,0
1601,1067,0,0,114,114,0,1,0,1,0
1938,183,7515,121,293,223,70,4,0,3,1
1010,183,3893,121,293,223,70,4,1,3,1
1578,183,5694,121,293,223,70,4,0,3,1
1576,183,5701,121,293,223,70,4,0,3,1
2148,3095,0,0,157,157,0,1,0,1,0
2282,1694,0,0,62,62,0,1,0,1,0
1576,183,5689,121,293,223,70,4,0,3,1
2412,1694,0,0,62,62,0,1,0,1,0
10658,1543,0,0,65,65,0,1,0,1,0
62,1327,0,0,154,154,0,1,0,1,0
2293,446,0,0,92,92,0,1,0,1,0
9648,1604,0,0,111,111,0,1,0,1,0
10496,1560,0,0,70,70,0,1,0,1,0
1949,183,7665,121,293,223,70,4,0,3,1
15441,1022,0,0,145,145,0,1,0,1,0
4638,601,0,0,146,146,0,1,0,1,0
1630,183,5953,121,293,223,70,4,0,3,1
1453,183,5090,121,293,223,70,4,1,3,1
13322,571,0,0,126,126,0,1,0,1,0
5270,291,0,0,146,146,0,1,0,1,0
4734,183,16214,121,293,223,70,4,1,3,1
9406,1543,0,0,109,109,0,1,0,1,0
3870,689,0,0,127,127,0,1,0,1,0
1379,183,4724,121,293,223,70,4,1,3,1
20634,1543,0,0,62,62,0,1,0,1,0
7960,1362,0,0,146,146,0,1,0,1,0
578,1176,0,0,150,150,0,1,0,1,0
5418,183,16867,121,293,223,70,4,0,3,1
1375,3095,0,0,141,141,0,1,0,1,0
1251,3095,0,0,146,146,0,1,0,1,0
825,728,1614,54,218,186,31,2,0,1,0
2031,906,0,0,62,62,0,1,0,1,0
2900,1694,0,0,62,62,0,1,0,1,0
3813,876,0,0,147,147,0,1,0,1,0
8327,1558,0,0,146,146,0,1,0,1,0
8305,1447,0,0,148,148,0,1,0,1,0
1055,829,0,0,145,145,0,1,0,1,0
2510,6,0,0,62,62,0,1,0,1,0
6878,2347,0,0,83,83,0,1,0,1,0
1437,1156,0,0,139,139,0,1,0,1,0
9013,1694,0,0,128,128,0,1,0,1,0
1938,1100,0,0,124,124,0,1,0,1,0
3013,1569,0,0,82,82,0,1,0,1,0
1378,3095,0,0,141,141,0,1,0,1,0
176,2152,0,0,146,146,0,1,0,1,0
1157,3095,0,0,139,139,0,1,0,1,0
2709,1538,0,0,86,86,0,1,0,1,0
13184,836,0,0,111,111,0,1,0,1,0
1355,3095,0,0,142,142,0,1,0,1,0
5103,307,0,0,146,146,0,1,0,1,0
15359,966,0,0,145,145,0,1,0,1,0
526,1120,0,0,157,157,0,1,0,1,0
11177,1618,0,0,62,62,0,1,0,1,0
817,1176,0,0,156,156,0,1,0,1,0
1454,3095,0,0,139,139,0,1,0,1,0
1341,3095,0,0,142,142,0,1,0,1,0
201,2332,0,0,145,145,0,1,0,1,0
1424,1176,0,0,139,139,0,1,0,1,0
12489,1200,0,0,90,90,0,1,0,1,0
553,1126,0,0,157,157,0,1,0,1,0
1262,183,4291,121,293,223,70,4,1,3,1
2136,183,8586,121,293,223,70,4,0,3,1
343,1165,0,0,143,143,0,1,0,1,0
1611,647,0,0,146,146,0,1,0,1,0
7870,2195,0,0,109,109,0,1,0,1,0
1751,3095,0,0,150,150,0,1,0,1,0
4581,183,16023,121,293,223,70,4,1,3,1
2000,183,7884,121,293,223,70,4,0,3,1
8327,1551,0,0,146,146,0,1,0,1,0
7921,2733,0,0,64,64,0,1,0,1,0
1236,183,4242,121,293,223,70,4,1,3,1
11158,1614,0,0,62,62,0,1,0,1,0
779,1167,0,0,156,156,0,1,0,1,0
1594,183,6303,121,293,223,70,4,0,3,1
21575,1124,8762,37,133,111,21,1,0,1,0
2452,1418,0,0,105,105,0,1,0,1,0
1060,3095,0,0,141,141,0,1,0,1,0
2163,183,8737,121,293,223,70,4,0,3,1
2926,1217,0,0,141,141,0,1,0,1,0
2534,1694,0,0,62,62,0,1,0,1,0
938,183,3699,121,293,223,70,4,1,3,1
8936,1296,0,0,129,129,0,1,0,1,0
1589,1074,0,0,115,115,0,1,0,1,0
1374,1176,0,0,149,149,0,1,0,1,0
10398,1543,0,0,71,71,0,1,0,1,0
8198,1727,0,0,135,135,0,1,0,1,0
1351,391,1423,48,205,177,27,2,0,1,0
308,2131,0,0,147,147,0,1,0,1,0
7456,2814,0,0,76,76,0,1,0,1,0
2718,1176,0,0,146,146,0,1,0,1,0
1171,183,4115,121,293,223,70,4,1,3,1
467,1176,0,0,146,146,0,1,0,1,0
2068,273,0,0,106,106,0,1,0,1,0
4309,183,15349,121,293,223,70,4,0,3,1
8794,1271,0,0,134,134,0,1,0,1,0
1192,183,4156,121,293,223,70,4,1,3,1
804,1099,0,0,146,146,0,1,0,1,0
10130,1543,0,0,80,80,0,1,0,1,0
19490,183,26556,121,293,223,70,4,0,3,1
2229,429,0,0,62,62,0,1,0,1,0
1875,183,7196,121,293,223,70,4,0,3,1
10101,1543,0,0,85,85,0,1,0,1,0
9153,1632,0,0,115,115,0,1,0,1,0
11194,1649,0,0,64,64,0,1,0,1,0
3134,1038,0,0,147,147,0,1,0,1,0
2907,1694,0,0,62,62,0,1,0,1,0
8281,1182,0,0,155,155,0,1,0,1,0
1542,3095,0,0,149,149,0,1,0,1,0
2707,1694,0,0,62,62,0,1,0,1,0
189,2243,0,0,145,145,0,1,0,1,0
2641,373,0,0,89,89,0,1,0,1,0
10575,1543,0,0,67,67,0,1,0,1,0
2913,1239,0,0,137,137,0,1,0,1,0
1658,524,0,0,147,147,0,1,0,1,0
5780,291,0,0,146,146,0,1,0,1,0
2083,183,7838,121,293,223,70,4,0,3,1
3011,1694,0,0,62,62,0,1,0,1,0
1355,183,4601,121,293,223,70,4,1,3,1
313,1071,0,0,157,157,0,1,0,1,0
7998,2012,0,0,119,119,0,1,0,1,0
2989,1694,0,0,62,62,0,1,0,1,0
1863,1176,0,0,142,142,0,1,0,1,0
12674,602,0,0,145,145,0,1,0,1,0
7638,2344,0,0,97,97,0,1,0,1,0
2052,183,8080,121,293,223,70,4,0,3,1
3488,1084,0,0,101,101,0,1,0,1,0
1646,183,6506,121,293,223,70,4,0,3,1
900,1176,0,0,153,153,0,1,0,1,0
11763,1579,0,0,68,68,0,1,0,1,0
2171,183,8778,121,293,223,70,4,0,3,1
1810,183,6873,121,293,223,70,4,0,3,1
15666,183,22509,121,293,223,70,4,0,3,1
1314,183,4402,121,293,223,70,4,1,3,1
86,1036,0,0,154,154,0,1,0,1,0
3224,175,0,0,98,98,0,1,0,1,0
3681,183,13487,121,293,223,70,4,0,3,1
233,1052,0,0,157,157,0,1,0,1,0
2948,1305,0,0,126,126,0,1,0,1,0
2561,1694,0,0,62,62,0,1,0,1,0
2821,183,10025,121,293,223,70,4,0,3,1
2906,1462,0,0,100,100,0,1,0,1,0
7605,944,0,0,154,154,0,1,0,1,0
1943,3095,0,0,151,151,0,1,0,1,0
331,1158,0,0,144,144,0,1,0,1,0
3893,849,0,0,147,147,0,1,0,1,0
1737,183,6469,121,293,223,70,4,0,3,1
8509,1680,0,0,139,139,0,1,0,1,0
2225,1176,0,0,144,144,0,1,0,1,0
9496,1543,0,0,106,106,0,1,0,1,0
484,1110,0,0,157,157,0,1,0,1,0
1343,618,0,0,149,149,0,1,0,1,0
9950,1573,0,0,86,86,0,1,0,1,0
1286,183,5212,121,293,223,70,4,0,3,1
800,923,909,30,191,173,17,1,0,1,0
1707,657,0,0,147,147,0,1,0,1,0
1370,183,5433,121,293,223,70,4,0,3,1
8327,1664,0,0,146,146,0,1,0,1,0
1664,183,6148,121,293,223,70,4,0,3,1
1653,183,6092,121,293,223,70,4,0,3,1
8683,1543,0,0,133,133,0,1,0,1,0
1798,677,0,0,106,106,0,1,0,1,0
1694,183,6524,121,293,223,70,4,0,3,1
11422,1316,0,0,76,76,0,1,0,1,0
8265,1179,0,0,156,156,0,1,0,1,0
9927,1543,0,0,87,87,0,1,0,1,0
4724,345,0,0,146,146,0,1,0,1,0
2010,760,0,0,62,62,0,1,0,1,0
1812,1176,0,0,142,142,0,1,0,1,0
1872,1176,0,0,142,142,0,1,0,1,0
1476,183,5205,121,293,223,70,4,0,3,1
3062,1524,0,0,73,73,0,1,0,1,0
1948,966,0,0,92,92,0,1,0,1,0
10498,1498,0,0,73,73,0,1,0,1,0
9180,2119,0,0,68,68,0,1,0,1,0
6990,2546,0,0,77,77,0,1,0,1,0
1477,183,5195,121,293,223,70,4,0,3,1
8166,1605,0,0,146,146,0,1,0,1,0
12014,1448,0,0,76,76,0,1,0,1,0
412,1176,0,0,144,144,0,1,0,1,0
5018,316,0,0,146,146,0,1,0,1,0
2802,1503,0,0,62,62,0,1,0,1,0
2476,1247,0,0,62,62,0,1,0,1,0
1778,3095,0,0,152,152,0,1,0,1,0
8527,1543,0,0,138,138,0,1,0,1,0
1516,183,5406,121,293,223,70,4,0,3,1
1995,1050,0,0,134,134,0,1,0,1,0
2848,1694,0,0,62,62,0,1,0,1,0
2451,1694,0,0,62,62,0,1,0,1,0
2253,1657,0,0,67,67,0,1,0,1,0
1860,710,0,0,108,108,0,1,0,1,0
1113,183,4174,121,293,223,70,4,1,3,1
9684,1543,0,0,100,100,0,1,0,1,0
2021,183,6919,121,293,223,70,4,1,3,1
2710,1523,0,0,62,62,0,1,0,1,0
257,1961,0,0,144,144,0,1,0,1,0
2988,1469,0,0,99,99,0,1,0,1,0
2978,1429,0,0,105,105,0,1,0,1,0
1446,183,5081,121,293,223,70,4,1,3,1
1797,863,0,0,145,145,0,1,0,1,0
1770,801,0,0,145,145,0,1,0,1,0
510,2550,0,0,144,144,0,1,0,1,0
387,1088,0,0,157,157,0,1,0,1,0
2925,1694,0,0,62,62,0,1,0,1,0
1705,2547,0,0,111,111,0,1,0,1,0
8845,1662,0,0,128,128,0,1,0,1,0
1952,183,7580,121,293,223,70,4,0,3,1
8276,1382,0,0,152,152,0,1,0,1,0
9983,1727,0,0,70,70,0,1,0,1,0
1400,1176,0,0,139,139,0,1,0,1,0
1262,183,4291,121,293,223,70,4,1,3,1
9893,1616,0,0,105,105,0,1,0,1,0
1215,183,4200,121,293,223,70,4,1,3,1
12162,1543,0,0,70,70,0,1,0,1,0
2148,183,8701,121,293,223,70,4,0,3,1
1497,980,0,0,141,141,0,1,0,1,0
2426,1573,0,0,82,82,0,1,0,1,0
8405,2496,0,0,65,65,0,1,0,1,0
2936,1694,0,0,62,62,0,1,0,1,0
2883,1164,0,0,145,145,0,1,0,1,0
2113,183,8518,121,293,223,70,4,0,3,1
2555,2429,0,0,112,112,0,1,0,1,0
1570,183,5659,121,293,223,70,4,0,3,1
4227,395,0,0,146,146,0,1,0,1,0
1832,183,6934,121,293,223,70,4,0,3,1
9093,1323,0,0,122,122,0,1,0,1,0
2889,1166,0,0,145,145,0,1,0,1,0
1072,3095,0,0,139,139,0,1,0,1,0
4979,183,16518,121,293,223,70,4,1,3,1
1425,183,4950,121,293,223,70,4,1,3,1
472,1176,0,0,146,146,0,1,0,1,0
13238,644,0,0,119,119,0,1,0,1,0
9967,1594,0,0,90,90,0,1,0,1,0
1384,3095,0,0,139,139,0,1,0,1,0
10362,1479,0,0,78,78,0,1,0,1,0
550,1083,0,0,143,143,0,1,0,1,0
2686,1694,0,0,62,62,0,1,0,1,0
1722,691,0,0,146,146,0,1,0,1,0
2042,183,8148,121,293,223,70,4,0,3,1
1660,1176,0,0,140,140,0,1,0,1,0
4689,183,16158,121,293,223,70,4,1,3,1
1466,622,0,0,147,147,0,1,0,1,0
3241,183,11443,121,293,223,70,4,1,3,1
8052,1543,0,0,138,138,0,1,0,1,0
2224,3095,0,0,158,158,0,1,0,1,0
13701,565,0,0,126,126,0,1,0,1,0
1981,3095,0,0,155,155,0,1,0,1,0
2913,1250,0,0,135,135,0,1,0,1,0
1922,183,7381,121,293,223,70,4,0,3,1
11747,1588,0,0,68,68,0,1,0,1,0
1089,3095,0,0,141,141,0,1,0,1,0
94,1553,0,0,152,152,0,1,0,1,0
2987,1463,0,0,100,100,0,1,0,1,0
2339,2893,0,0,145,145,0,1,0,1,0
7720,2410,0,0,97,97,0,1,0,1,0
1490,183,5281,121,293,223,70,4,0,3,1
21479,805,15428,65,187,149,37,2,0,2,0
3334,183,11132,121,293,223,70,4,1,3,1
2947,1618,0,0,62,62,0,1,0,1,0
821,1136,0,0,156,156,0,1,0,1,0
2137,1903,0,0,74,74,0,1,0,1,0
8273,1180,0,0,155,155,0,1,0,1,0
8659,2373,0,0,66,66,0,1,0,1,0
2935,1694,0,0,62,62,0,1,0,1,0
1953,183,7586,121,293,223,70,4,0,3,1
744,465,2559,86,250,200,50,3,0,2,0
11176,1646,0,0,65,65,0,1,0,1,0
1862,3095,0,0,154,154,0,1,0,1,0
2149,551,0,0,62,62,0,1,0,1,0
1284,3095,0,0,139,139,0,1,0,1,0
1272,3051,0,0,143,143,0,1,0,1,0
20759,1996,0,0,86,86,0,1,0,1,0
1949,953,0,0,89,89,0,1,0,1,0
2905,1499,0,0,94,94,0,1,0,1,0
1024,3095,0,0,141,141,0,1,0,1,0
2606,1067,0,0,120,120,0,1,0,1,0
1809,890,0,0,145,145,0,1,0,1,0
9445,1347,0,0,112,112,0,1,0,1,0
7337,1056,0,0,146,146,0,1,0,1,0
2033,1222,0,0,135,135,0,1,0,1,0
749,456,2593,87,251,200,50,3,0,2,0
49,1018,0,0,155,155,0,1,0,1,0
20204,1543,0,0,63,63,0,1,0,1,0
11268,1245,0,0,88,88,0,1,0,1,0
8288,1455,0,0,151,151,0,1,0,1,0
1109,183,4163,121,293,223,70,4,1,3,1
1881,762,0,0,83,83,0,1,0,1,0
16579,1619,0,0,62,62,0,1,0,1,0
356,2449,0,0,144,144,0,1,0,1,0
4432,183,10622,121,293,223,70,4,0,3,1
1752,3095,0,0,146,146,0,1,0,1,0
4345,183,14542,121,293,223,70,4,0,3,1
2029,3095,0,0,155,155,0,1,0,1,0
9310,1543,0,0,110,110,0,1,0,1,0
3078,183,11430,121,293,223,70,4,0,3,1
13767,2141,0,0,94,94,0,1,0,1,0
1841,914,0,0,78,78,0,1,0,1,0
2330,1651,0,0,69,69,0,1,0,1,0
9906,1617,0,0,104,104,0,1,0,1,0
1329,1176,0,0,141,141,0,1,0,1,0
11334,1667,0,0,63,63,0,1,0,1,0
2423,1694,0,0,62,62,0,1,0,1,0
9745,1543,0,0,97,97,0,1,0,1,0
2184,183,8854,121,293,223,70,4,0,3,1
13024,920,0,0,106,106,0,1,0,1,0
8142,1592,0,0,146,146,0,1,0,1,0
1666,1025,0,0,104,104,0,1,0,1,0
10431,1543,0,0,74,74,0,1,0,1,0
11256,1633,0,0,66,66,0,1,0,1,0
800,1176,0,0,156,156,0,1,0,1,0
7354,2934,0,0,68,68,0,1,0,1,0
496,1740,0,0,151,151,0,1,0,1,0
1514,1122,0,0,126,126,0,1,0,1,0
10308,1546,0,0,73,73,0,1,0,1,0
1732,183,6446,121,293,223,70,4,0,3,1
1500,973,0,0,141,141,0,1,0,1,0
19418,2643,0,0,120,120,0,1,0,1,0
9520,1543,0,0,102,102,0,1,0,1,0
21465,760,16378,69,194,154,40,2,0,2,0
1217,183,4457,121,293,223,70,4,1,3,1
2899,1677,0,0,64,64,0,1,0,1,0
1002,1176,0,0,154,154,0,1,0,1,0
9555,1403,0,0,104,104,0,1,0,1,0
1450,630,0,0,147,147,0,1,0,1,0
34,1121,0,0,155,155,0,1,0,1,0
1519,1176,0,0,139,139,0,1,0,1,0
1565,183,5633,121,293,223,70,4,0,3,1
4815,183,16314,121,293,223,70,4,1,3,1
2492,1694,0,0,62,62,0,1,0,1,0
2833,1242,0,0,136,136,0,1,0,1,0
5321,183,11563,121,293,223,70,4,0,3,1
3394,183,12246,121,293,223,70,4,0,3,1
2775,183,9338,121,293,223,70,4,1,3,1
1172,183,4334,121,293,223,70,4,1,3,1
1415,183,4902,121,293,223,70,4,1,3,1
2331,1650,0,0,69,69,0,1,0,1,0
1529,886,0,0,143,143,0,1,0,1,0
15825,2557,0,0,116,116,0,1,0,1,0
2139,183,8602,121,293,223,70,4,0,3,1
20287,2224,0,0,98,98,0,1,0,1,0
8327,1689,0,0,146,146,0,1,0,1,0
284,1135,0,0,146,146,0,1,0,1,0
461,2730,0,0,141,141,0,1,0,1,0
2135,3095,0,0,156,156,0,1,0,1,0
8022,1602,0,0,135,135,0,1,0,1,0
7403,2797,0,0,74,74,0,1,0,1,0
10436,1552,0,0,71,71,0,1,0,1,0
6385,1474,0,0,109,109,0,1,0,1,0
2691,1694,0,0,62,62,0,1,0,1,0
3594,183,10615,121,293,223,70,4,0,3,1
3322,199,0,0,103,103,0,1,0,1,0
9411,183,19591,121,293,223,70,4,0,3,1
13849,487,0,0,131,131,0,1,0,1,0
8327,1659,0,0,146,146,0,1,0,1,0
2433,1176,0,0,145,145,0,1,0,1,0
3014,1573,0,0,82,82,0,1,0,1,0
1662,1028,0,0,105,105,0,1,0,1,0
6903,688,0,0,151,151,0,1,0,1,0
1554,813,0,0,144,144,0,1,0,1,0
2090,1192,0,0,62,62,0,1,0,1,0
6798,183,17875,121,293,223,70,4,0,3,1
6667,783,0,0,146,146,0,1,0,1,0
4462,371,0,0,146,146,0,1,0,1,0
630,2980,0,0,139,139,0,1,0,1,0
979,183,3932,121,293,223,70,4,0,3,1
3694,183,13341,121,293,223,70,4,0,3,1
1571,1176,0,0,140,140,0,1,0,1,0
4853,183,16109,121,293,223,70,4,0,3,1
333,2434,0,0,144,144,0,1,0,1,0
4961,321,0,0,146,146,0,1,0,1,0
4710,183,16184,121,293,223,70,4,1,3,1
8327,1687,0,0,146,146,0,1,0,1,0
8415,1688,0,0,142,142,0,1,0,1,0
2386,1605,0,0,76,76,0,1,0,1,0
8502,1543,0,0,140,140,0,1,0,1,0
8273,1307,0,0,153,153,0,1,0,1,0
9891,1543,0,0,93,93,0,1,0,1,0
18628,3024,0,0,141,141,0,1,0,1,0
4802,183,16298,121,293,223,70,4,1,3,1
4116,440,0,0,143,143,0,1,0,1,0
1923,804,0,0,71,71,0,1,0,1,0
2429,2700,0,0,131,131,0,1,0,1,0
2041,183,8022,121,293,223,70,4,0,3,1
2343,1176,0,0,145,145,0,1,0,1,0
156,2006,0,0,148,148,0,1,0,1,0
1187,3095,0,0,142,142,0,1,0,1,0
9314,1543,0,0,112,112,0,1,0,1,0
1486,3095,0,0,145,145,0,1,0,1,0
952,183,3737,121,293,223,70,4,1,3,1
529,1176,0,0,148,148,0,1,0,1,0
2176,1541,0,0,85,85,0,1,0,1,0
8090,1881,0,0,127,127,0,1,0,1,0
16161,183,24714,121,293,223,70,4,0,3,1
4861,183,16130,121,293,223,70,4,0,3,1
15420,2476,0,0,108,108,0,1,0,1,0
11222,1627,0,0,62,62,0,1,0,1,0
2041,1062,0,0,62,62,0,1,0,1,0
2511,1445,0,0,100,100,0,1,0,1,0
7465,2679,0,0,80,80,0,1,0,1,0
306,1146,0,0,145,145,0,1,0,1,0
18560,3057,0,0,142,142,0,1,0,1,0
8167,1898,0,0,133,133,0,1,0,1,0
641,2636,0,0,144,144,0,1,0,1,0
87,1037,0,0,154,154,0,1,0,1,0
9798,1584,0,0,92,92,0,1,0,1,0
1950,941,0,0,86,86,0,1,0,1,0
2372,1694,0,0,62,62,0,1,0,1,0
5365,281,0,0,146,146,0,1,0,1,0
2155,1367,0,0,62,62,0,1,0,1,0
1951,833,0,0,63,63,0,1,0,1,0
8501,1694,0,0,141,141,0,1,0,1,0
296,1067,0,0,157,157,0,1,0,1,0
8284,1429,0,0,151,151,0,1,0,1,0
1642,183,6005,121,293,223,70,4,0,3,1
1479,655,0,0,149,149,0,1,0,1,0
9408,1613,0,0,106,106,0,1,0,1,0
2187,3095,0,0,158,158,0,1,0,1,0
1677,183,6213,121,293,223,70,4,0,3,1
2720,1543,0,0,85,85,0,1,0,1,0
8117,1130,0,0,156,156,0,1,0,1,0
2292,1176,0,0,144,144,0,1,0,1,0
765,3095,0,0,139,139,0,1,0,1,0
1588,183,6280,121,293,223,70,4,0,3,1
2612,1176,0,0,146,146,0,1,0,1,0
1710,663,0,0,146,146,0,1,0,1,0
553,1126,0,0,157,157,0,1,0,1,0
12655,1113,0,0,95,95,0,1,0,1,0
1814,3095,0,0,151,151,0,1,0,1,0
1545,183,5538,121,293,223,70,4,0,3,1
4035,473,0,0,146,146,0,1,0,1,0
10437,1543,0,0,70,70,0,1,0,1,0
1545,480,504,17,168,158,9,1,0,1,0
2144,1289,0,0,125,125,0,1,0,1,0
2155,183,8388,121,293,223,70,4,0,3,1
1553,816,0,0,144,144,0,1,0,1,0
5628,255,0,0,146,146,0,1,0,1,0
1353,225,3846,106,275,213,61,3,0,2,0
1022,241,2974,100,268,210,58,3,0,2,0
10031,1431,0,0,90,90,0,1,0,1,0
13618,609,0,0,124,124,0,1,0,1,0
4320,183,15340,121,293,223,70,4,0,3,1
1147,183,4068,121,293,223,70,4,1,3,1
2890,1689,0,0,62,62,0,1,0,1,0
2451,95,0,0,62,62,0,1,0,1,0
2253,2748,0,0,135,135,0,1,0,1,0
8314,1489,0,0,147,147,0,1,0,1,0
1547,183,5545,121,293,223,70,4,0,3,1
8728,1543,0,0,132,132,0,1,0,1,0
8651,1543,0,0,134,134,0,1,0,1,0
1738,727,0,0,146,146,0,1,0,1,0
2509,1694,0,0,62,62,0,1,0,1,0
1916,183,7347,121,293,223,70,4,0,3,1
1665,183,6211,121,293,223,70,4,0,3,1
16841,2763,0,0,127,127,0,1,0,1,0
1424,183,4943,121,293,223,70,4,1,3,1
1339,619,0,0,149,149,0,1,0,1,0
8327,1639,0,0,146,146,0,1,0,1,0
263,2436,0,0,144,144,0,1,0,1,0
8451,1205,0,0,149,149,0,1,0,1,0
7042,183,14092,121,293,223,70,4,0,3,1
3568,183,12938,121,293,223,70,4,0,3,1
1448,1176,0,0,139,139,0,1,0,1,0
444,1176,0,0,145,145,0,1,0,1,0
11223,1652,0,0,64,64,0,1,0,1,0
20493,1560,0,0,62,62,0,1,0,1,0
360,1215,0,0,143,143,0,1,0,1,0
4939,183,16468,121,293,223,70,4,1,3,1
13895,183,22939,121,293,223,70,4,0,3,1
120,1741,0,0,150,150,0,1,0,1,0
3014,1694,0,0,62,62,0,1,0,1,0
10351,1543,0,0,72,72,0,1,0,1,0
7990,2023,0,0,119,119,0,1,0,1,0
178,1082,0,0,150,150,0,1,0,1,0
1945,1008,0,0,102,102,0,1,0,1,0
8801,2303,0,0,66,66,0,1,0,1,0
10348,1543,0,0,72,72,0,1,0,1,0
1735,183,6573,121,293,223,70,4,0,3,1
388,1133,153,5,149,146,2,1,0,1,0
8327,1614,0,0,146,146,0,1,0,1,0
1779,183,6716,121,293,223,70,4,0,3,1
1839,960,0,0,144,144,0,1,0,1,0
2009,183,7849,121,293,223,70,4,0,3,1
353,1169,0,0,143,143,0,1,0,1,0
8470,1549,0,0,142,142,0,1,0,1,0
3002,1527,0,0,89,89,0,1,0,1,0
264,1911,0,0,144,144,0,1,0,1,0
21403,553,20705,88,230,179,50,3,0,2,0
960,3095,0,0,140,140,0,1,0,1,0
18531,183,25541,121,293,223,70,4,0,3,1
2116,1594,0,0,76,76,0,1,0,1,0
2172,1535,0,0,86,86,0,1,0,1,0
5205,297,0,0,146,146,0,1,0,1,0
1471,183,5210,121,293,223,70,4,0,3,1
1818,928,0,0,82,82,0,1,0,1,0
1374,183,4699,121,293,223,70,4,1,3,1
13493,549,0,0,125,125,0,1,0,1,0
8893,1543,0,0,125,125,0,1,0,1,0
1649,183,6517,121,293,223,70,4,0,3,1
1714,183,6360,121,293,223,70,4,0,3,1
9111,1300,0,0,124,124,0,1,0,1,0
2792,1276,0,0,131,131,0,1,0,1,0
1999,1176,0,0,143,143,0,1,0,1,0
8488,1218,0,0,147,147,0,1,0,1,0
4039,376,0,0,140,140,0,1,0,1,0
1121,183,4413,121,293,223,70,4,0,3,1
1664,183,6143,121,293,223,70,4,0,3,1
9713,1430,0,0,97,97,0,1,0,1,0
11301,1662,0,0,64,64,0,1,0,1,0
20825,1965,0,0,84,84,0,1,0,1,0
557,2872,0,0,140,140,0,1,0,1,0
1598,183,5818,121,293,223,70,4,0,3,1
1228,3095,0,0,139,139,0,1,0,1,0
1118,3095,0,0,139,139,0,1,0,1,0
927,1058,0,0,155,155,0,1,0,1,0
3122,1602,0,0,67,67,0,1,0,1,0
2531,1176,0,0,146,146,0,1,0,1,0
1561,1092,0,0,119,119,0,1,0,1,0
18084,3014,0,0,140,140,0,1,0,1,0
1342,183,4799,121,293,223,70,4,1,3,1
8256,1655,0,0,146,146,0,1,0,1,0
1441,1176,0,0,139,139,0,1,0,1,0
322,914,0,0,155,155,0,1,0,1,0
11111,1604,0,0,62,62,0,1,0,1,0
1676,514,0,0,145,145,0,1,0,1,0
2144,1494,0,0,93,93,0,1,0,1,0
15513,183,24241,121,293,223,70,4,0,3,1
3186,1527,0,0,72,72,0,1,0,1,0
2904,1531,0,0,89,89,0,1,0,1,0
2265,2221,0,0,98,98,0,1,0,1,0
2001,1278,0,0,127,127,0,1,0,1,0
21303,1473,0,0,66,66,0,1,0,1,0
1132,183,4225,121,293,223,70,4,1,3,1
1920,183,7369,121,293,223,70,4,0,3,1
2609,2314,0,0,104,104,0,1,0,1,0
3950,183,14090,121,293,223,70,4,0,3,1
1220,3017,0,0,143,143,0,1,0,1,0
2295,183,8361,121,293,223,70,4,0,3,1
10132,1543,0,0,84,84,0,1,0,1,0
2069,1249,0,0,131,131,0,1,0,1,0
643,655,1878,63,221,184,36,2,0,2,0
2100,1987,0,0,78,78,0,1,0,1,0
2229,183,9119,121,293,223,70,4,0,3,1
7374,2905,0,0,70,70,0,1,0,1,0
8327,1617,0,0,146,146,0,1,0,1,0
9660,1543,0,0,100,100,0,1,0,1,0
8225,1687,0,0,137,137,0,1,0,1,0
7205,798,0,0,152,152,0,1,0,1,0
8327,1683,0,0,146,146,0,1,0,1,0
3121,183,11020,121,293,223,70,4,1,3,1
951,183,3689,121,293,223,70,4,1,3,1
8308,1579,0,0,148,148,0,1,0,1,0
1883,183,7184,121,293,223,70,4,0,3,1
10625,1456,0,0,76,76,0,1,0,1,0
2540,1176,0,0,146,146,0,1,0,1,0
16534,638,0,0,119,119,0,1,0,1,0
8318,1643,0,0,147,147,0,1,0,1,0
1625,2775,0,0,121,121,0,1,0,1,0
1240,3095,0,0,139,139,0,1,0,1,0
6258,558,0,0,146,146,0,1,0,1,0
1360,3062,0,0,141,141,0,1,0,1,0
1941,1067,0,0,116,116,0,1,0,1,0
1676,554,0,0,141,141,0,1,0,1,0
9339,1618,0,0,109,109,0,1,0,1,0
2030,3095,0,0,155,155,0,1,0,1,0
918,3095,0,0,141,141,0,1,0,1,0
1405,183,4849,121,293,223,70,4,1,3,1
2204,190,0,0,92,92,0,1,0,1,0
20,1004,0,0,156,156,0,1,0,1,0
2079,1254,0,0,130,130,0,1,0,1,0
1885,766,0,0,82,82,0,1,0,1,0
1962,183,7632,121,293,223,70,4,0,3,1
2077,1393,0,0,109,109,0,1,0,1,0
1725,698,0,0,146,146,0,1,0,1,0
692,1176,0,0,154,154,0,1,0,1,0
3022,183,11192,121,293,223,70,4,0,3,1
19334,1578,0,0,62,62,0,1,0,1,0
1767,183,6659,121,293,223,70,4,0,3,1
2438,1694,0,0,62,62,0,1,0,1,0
935,3095,0,0,140,140,0,1,0,1,0
2397,1176,0,0,145,145,0,1,0,1,0
1451,183,5080,121,293,223,70,4,1,3,1
8576,1543,0,0,137,137,0,1,0,1,0
20311,1299,0,0,77,77,0,1,0,1,0
858,1109,0,0,156,156,0,1,0,1,0
9108,1646,0,0,119,119,0,1,0,1,0
1295,183,4671,121,293,223,70,4,1,3,1
8688,1671,0,0,133,133,0,1,0,1,0
32,1107,0,0,156,156,0,1,0,1,0
1766,3095,0,0,150,150,0,1,0,1,0
1432,183,4984,121,293,223,70,4,1,3,1
8270,1296,0,0,153,153,0,1,0,1,0
1765,813,0,0,115,115,0,1,0,1,0
1348,3095,0,0,142,142,0,1,0,1,0
12852,563,0,0,145,145,0,1,0,1,0
2027,2108,0,0,84,84,0,1,0,1,0
3163,1554,0,0,71,71,0,1,0,1,0
1451,3095,0,0,139,139,0,1,0,1,0
11565,1683,0,0,62,62,0,1,0,1,0
1578,582,0,0,148,148,0,1,0,1,0
3029,1104,0,0,147,147,0,1,0,1,0
4668,351,0,0,146,146,0,1,0,1,0
10859,1606,0,0,67,67,0,1,0,1,0
2209,1591,0,0,78,78,0,1,0,1,0
12292,909,0,0,107,107,0,1,0,1,0
9482,1608,0,0,103,103,0,1,0,1,0
2102,183,8366,121,293,223,70,4,0,3,1
2664,1087,0,0,125,125,0,1,0,1,0
2916,1694,0,0,62,62,0,1,0,1,0
3467,183,11939,121,293,223,70,4,0,3,1
8396,1197,0,0,151,151,0,1,0,1,0
1196,862,0,0,152,152,0,1,0,1,0
2227,432,0,0,62,62,0,1,0,1,0
497,1176,0,0,147,147,0,1,0,1,0
10635,1543,0,0,65,65,0,1,0,1,0
1738,616,0,0,123,123,0,1,0,1,0
2312,183,8516,121,293,223,70,4,0,3,1
2021,183,7937,121,293,223,70,4,0,3,1
2344,104,0,0,78,78,0,1,0,1,0
8195,1731,0,0,135,135,0,1,0,1,0
10443,1543,0,0,70,70,0,1,0,1,0
2044,183,8036,121,293,223,70,4,0,3,1
2265,2207,0,0,97,97,0,1,0,1,0
1791,1176,0,0,141,141,0,1,0,1,0
1738,183,7098,121,293,223,70,4,0,3,1
2324,117,0,0,80,80,0,1,0,1,0
295,1140,0,0,145,145,0,1,0,1,0
13481,680,0,0,120,120,0,1,0,1,0
2260,2448,0,0,114,114,0,1,0,1,0
1204,3095,0,0,145,145,0,1,0,1,0
4027,183,13353,121,293,223,70,4,1,3,1
3019,125,0,0,87,87,0,1,0,1,0
2909,1380,0,0,114,114,0,1,0,1,0
761,1176,0,0,156,156,0,1,0,1,0
498,1061,0,0,150,150,0,1,0,1,0
2099,183,8350,121,293,223,70,4,0,3,1
1610,651,0,0,146,146,0,1,0,1,0
345,1166,0,0,143,143,0,1,0,1,0
2766,1694,0,0,62,62,0,1,0,1,0
7791,1011,0,0,155,155,0,1,0,1,0
9887,1205,0,0,145,145,0,1,0,1,0
2306,183,8637,121,293,223,70,4,0,3,1
2398,1694,0,0,62,62,0,1,0,1,0
14015,400,0,0,136,136,0,1,0,1,0
1820,183,6993,121,293,223,70,4,0,3,1
10664,1581,0,0,69,69,0,1,0,1,0
2195,1473,0,0,62,62,0,1,0,1,0
478,1176,0,0,146,146,0,1,0,1,0
3238,183,12174,121,293,223,70,4,0,3,1
11099,1637,0,0,65,65,0,1,0,1,0
906,183,3612,121,293,223,70,4,1,3,1
1983,183,7721,121,293,223,70,4,0,3,1
1823,183,7024,121,293,223,70,4,0,3,1
4848,183,16355,121,293,223,70,4,1,3,1
191,2257,0,0,145,145,0,1,0,1,0
1123,1176,0,0,147,147,0,1,0,1,0
531,2835,0,0,141,141,0,1,0,1,0
4741,183,16222,121,293,223,70,4,1,3,1
3977,602,0,0,133,133,0,1,0,1,0
1929,1168,0,0,143,143,0,1,0,1,0
1818,183,6984,121,293,223,70,4,0,3,1
2005,183,7956,121,293,223,70,4,0,3,1
1575,494,361,12,162,155,7,1,0,1,0
1824,927,0,0,144,144,0,1,0,1,0
1836,1176,0,0,142,142,0,1,0,1,0
10537,1565,0,0,70,70,0,1,0,1,0
2938,1268,0,0,132,132,0,1,0,1,0
1965,183,7613,121,293,223,70,4,0,3,1
2127,1468,0,0,97,97,0,1,0,1,0
2016,541,0,0,97,97,0,1,0,1,0
8327,1583,0,0,146,146,0,1,0,1,0
7213,995,0,0,146,146,0,1,0,1,0
2634,2261,0,0,101,101,0,1,0,1,0
2756,1559,0,0,82,82,0,1,0,1,0
430,2685,0,0,142,142,0,1,0,1,0
1439,432,1003,33,188,169,19,1,0,1,0
11423,1668,0,0,62,62,0,1,0,1,0
2906,1465,0,0,100,100,0,1,0,1,0
787,1176,0,0,156,156,0,1,0,1,0
1940,2198,0,0,91,91,0,1,0,1,0
1436,183,5031,121,293,223,70,4,0,3,1
1657,3095,0,0,148,148,0,1,0,1,0
8733,1694,0,0,135,135,0,1,0,1,0
1411,3095,0,0,139,139,0,1,0,1,0
2246,291,0,0,81,81,0,1,0,1,0
979,1176,0,0,151,151,0,1,0,1,0
2926,1694,0,0,62,62,0,1,0,1,0
1933,183,7487,121,293,223,70,4,0,3,1
2176,1862,0,0,71,71,0,1,0,1,0
1365,3095,0,0,141,141,0,1,0,1,0
2912,1694,0,0,62,62,0,1,0,1,0
2929,1232,0,0,138,138,0,1,0,1,0
2857,183,9603,121,293,223,70,4,1,3,1
1178,3095,0,0,139,139,0,1,0,1,0
2046,947,0,0,127,127,0,1,0,1,0
8567,1554,0,0,139,139,0,1,0,1,0
4126,183,14191,121,293,223,70,4,0,3,1
8837,1543,0,0,128,128,0,1,0,1,0
3093,183,11059,121,293,223,70,4,0,3,1
614,1176,0,0,142,142,0,1,0,1,0
10571,1543,0,0,71,71,0,1,0,1,0
2083,183,8258,121,293,223,70,4,0,3,1
1573,183,5690,121,293,223,70,4,0,3,1
11625,1708,0,0,70,70,0,1,0,1,0
2816,183,10921,121,293,223,70,4,0,3,1
559,2876,0,0,140,140,0,1,0,1,0
1795,3095,0,0,153,153,0,1,0,1,0
9597,1369,0,0,106,106,0,1,0,1,0
737,2125,0,0,148,148,0,1,0,1,0
8261,1291,0,0,154,154,0,1,0,1,0
2842,961,0,0,132,132,0,1,0,1,0
3305,183,11662,121,293,223,70,4,0,3,1
1792,1176,0,0,141,141,0,1,0,1,0
1058,183,3896,121,293,223,70,4,1,3,1
539,1123,0,0,157,157,0,1,0,1,0
177,1082,0,0,150,150,0,1,0,1,0
1341,183,4534,121,293,223,70,4,1,3,1
1820,183,6926,121,293,223,70,4,0,3,1
12495,1197,0,0,90,90,0,1,0,1,0
19489,2609,0,0,119,119,0,1,0,1,0
1809,183,6825,121,293,223,70,4,0,3,1
860,2780,0,0,143,143,0,1,0,1,0
1093,3095,0,0,139,139,0,1,0,1,0
2432,1408,0,0,106,106,0,1,0,1,0
8327,1552,0,0,146,146,0,1,0,1,0
2116,3095,0,0,156,156,0,1,0,1,0
2651,1176,0,0,146,146,0,1,0,1,0
1523,566,0,0,148,148,0,1,0,1,0
1634,1176,0,0,140,140,0,1,0,1,0
7853,1929,0,0,118,118,0,1,0,1,0
1234,183,4504,121,293,223,70,4,1,3,1
2963,1694,0,0,62,62,0,1,0,1,0
2078,1162,0,0,62,62,0,1,0,1,0
3034,1694,0,0,62,62,0,1,0,1,0
2429,1570,0,0,82,82,0,1,0,1,0
3123,183,10922,121,293,223,70,4,0,3,1
12968,687,0,0,120,120,0,1,0,1,0
228,2363,0,0,144,144,0,1,0,1,0
18876,183,26026,121,293,223,70,4,0,3,1
1876,3095,0,0,149,149,0,1,0,1,0
3859,584,0,0,146,146,0,1,0,1,0
1344,3095,0,0,142,142,0,1,0,1,0
4041,376,0,0,140,140,0,1,0,1,0
2190,3095,0,0,158,158,0,1,0,1,0
1926,183,7451,121,293,223,70,4,0,3,1
1369,3095,0,0,141,141,0,1,0,1,0
1215,3095,0,0,145,145,0,1,0,1,0
2196,195,0,0,93,93,0,1,0,1,0
10741,1020,0,0,145,145,0,1,0,1,0
1370,183,4673,121,293,223,70,4,0,3,1
128,1805,0,0,149,149,0,1,0,1,0
946,2799,0,0,141,141,0,1,0,1,0
1307,183,4379,121,293,223,70,4,1,3,1
210,2359,0,0,144,144,0,1,0,1,0
970,183,3784,121,293,223,70,4,1,3,1
1820,183,6994,121,293,223,70,4,0,3,1
487,1114,0,0,143,143,0,1,0,1,0
780,1176,0,0,156,156,0,1,0,1,0
563,844,0,0,153,153,0,1,0,1,0
2105,1435,0,0,102,102,0,1,0,1,0
2493,1437,0,0,102,102,0,1,0,1,0
2191,1462,0,0,62,62,0,1,0,1,0
1072,183,4234,121,293,223,70,4,0,3,1
1508,949,0,0,142,142,0,1,0,1,0
605,1138,0,0,157,157,0,1,0,1,0
7872,2278,0,0,109,109,0,1,0,1,0
1457,1176,0,0,139,139,0,1,0,1,0
14285,255,0,0,144,144,0,1,0,1,0
1242,3031,0,0,143,143,0,1,0,1,0
2616,1358,0,0,62,62,0,1,0,1,0
16135,183,24612,121,293,223,70,4,0,3,1
3021,1603,0,0,77,77,0,1,0,1,0
2158,3095,0,0,156,156,0,1,0,1,0
2362,1176,0,0,145,145,0,1,0,1,0
2248,2965,0,0,150,150,0,1,0,1,0
84,1036,0,0,154,154,0,1,0,1,0
7441,2809,0,0,75,75,0,1,0,1,0
7733,2392,0,0,98,98,0,1,0,1,0
728,2693,0,0,144,144,0,1,0,1,0
1914,183,7549,121,293,223,70,4,0,3,1
2034,1230,0,0,134,134,0,1,0,1,0
1947,980,0,0,95,95,0,1,0,1,0
4501,183,15917,121,293,223,70,4,1,3,1
8582,1543,0,0,137,137,0,1,0,1,0
2948,1694,0,0,62,62,0,1,0,1,0
5455,272,0,0,146,146,0,1,0,1,0
1344,3095,0,0,142,142,0,1,0,1,0
7960,1721,0,0,129,129,0,1,0,1,0
1384,3095,0,0,139,139,0,1,0,1,0
1702,1002,0,0,99,99,0,1,0,1,0
3116,1609,0,0,67,67,0,1,0,1,0
2914,1214,0,0,141,141,0,1,0,1,0
7892,2253,0,0,111,111,0,1,0,1,0
17620,2507,0,0,145,145,0,1,0,1,0
2081,1169,0,0,62,62,0,1,0,1,0
10554,1543,0,0,67,67,0,1,0,1,0
16591,183,24952,121,293,223,70,4,0,3,1
446,2508,0,0,144,144,0,1,0,1,0
8327,1641,0,0,146,146,0,1,0,1,0
2022,183,7917,121,293,223,70,4,0,3,1
8288,1376,0,0,150,150,0,1,0,1,0
1941,1067,0,0,116,116,0,1,0,1,0
3026,1694,0,0,62,62,0,1,0,1,0
1703,581,0,0,133,133,0,1,0,1,0
1483,3095,0,0,140,140,0,1,0,1,0
2855,1224,0,0,139,139,0,1,0,1,0
4151,183,13967,121,293,223,70,4,0,3,1
1944,183,7496,121,293,223,70,4,0,3,1
4894,328,0,0,146,146,0,1,0,1,0
2640,1459,0,0,62,62,0,1,0,1,0
1873,1176,0,0,142,142,0,1,0,1,0
7264,183,17989,121,293,223,70,4,0,3,1
1362,3095,0,0,142,142,0,1,0,1,0
10162,1508,0,0,79,79,0,1,0,1,0
1534,183,5484,121,293,223,70,4,0,3,1
1941,1066,0,0,116,116,0,1,0,1,0
1087,183,4384,121,293,223,70,4,0,3,1
2930,183,10707,121,293,223,70,4,0,3,1
254,1979,0,0,144,144,0,1,0,1,0
1514,183,5379,121,293,223,70,4,0,3,1
6932,857,0,0,146,146,0,1,0,1,0
1497,1176,0,0,139,139,0,1,0,1,0
7356,2930,0,0,68,68,0,1,0,1,0
4707,183,16180,121,293,223,70,4,1,3,1
10436,1543,0,0,70,70,0,1,0,1,0
18317,183,25462,121,293,223,70,4,0,3,1
1860,2316,0,0,97,97,0,1,0,1,0
2411,155,0,0,62,62,0,1,0,1,0
7839,1956,0,0,117,117,0,1,0,1,0
1390,183,4777,121,293,223,70,4,0,3,1
1454,183,5098,121,293,223,70,4,0,3,1
8742,1694,0,0,135,135,0,1,0,1,0
489,866,0,0,154,154,0,1,0,1,0
4392,183,14758,121,293,223,70,4,0,3,1
20220,2256,0,0,100,100,0,1,0,1,0
633,1144,0,0,157,157,0,1,0,1,0
2964,1694,0,0,62,62,0,1,0,1,0
2155,995,0,0,62,62,0,1,0,1,0
3067,1666,0,0,63,63,0,1,0,1,0
1941,1057,0,0,114,114,0,1,0,1,0
1891,1080,0,0,143,143,0,1,0,1,0
2140,1272,0,0,127,127,0,1,0,1,0
491,1112,0,0,157,157,0,1,0,1,0
1082,183,4089,121,293,223,70,4,1,3,1
2622,318,0,0,85,85,0,1,0,1,0
1791,183,6780,121,293,223,70,4,0,3,1
9545,1603,0,0,101,101,0,1,0,1,0
10430,1543,0,0,70,70,0,1,0,1,0
10549,1567,0,0,70,70,0,1,0,1,0
735,2185,0,0,147,147,0,1,0,1,0
1377,183,4895,121,293,223,70,4,1,3,1
1298,183,4360,121,293,223,70,4,1,3,1
1122,3095,0,0,141,141,0,1,0,1,0
387,2621,0,0,142,142,0,1,0,1,0
1994,936,0,0,62,62,0,1,0,1,0
1815,183,6899,121,293,223,70,4,0,3,1
16376,2669,0,0,119,119,0,1,0,1,0
9336,1543,0,0,109,109,0,1,0,1,0
1878,1176,0,0,142,142,0,1,0,1,0
1315,3079,0,0,143,143,0,1,0,1,0
759,1432,0,0,154,154,0,1,0,1,0
1920,864,0,0,67,67,0,1,0,1,0
1535,3095,0,0,146,146,0,1,0,1,0
1949,183,7665,121,293,223,70,4,0,3,1
7426,2831,0,0,74,74,0,1,0,1,0
368,1045,0,0,152,152,0,1,0,1,0
2590,1528,0,0,87,87,0,1,0,1,0
3668,183,12962,121,293,223,70,4,1,3,1
1139,3095,0,0,141,141,0,1,0,1,0
917,1066,0,0,155,155,0,1,0,1,0
279,1063,0,0,157,157,0,1,0,1,0
1948,964,0,0,92,92,0,1,0,1,0
2796,1273,0,0,131,131,0,1,0,1,0
1808,688,0,0,103,103,0,1,0,1,0
1931,183,7432,121,293,223,70,4,0,3,1
2298,235,0,0,77,77,0,1,0,1,0
2902,1579,0,0,80,80,0,1,0,1,0
14165,322,0,0,140,140,0,1,0,1,0
763,1174,0,0,157,157,0,1,0,1,0
14061,339,0,0,139,139,0,1,0,1,0
20,1004,0,0,156,156,0,1,0,1,0
3034,1657,0,0,68,68,0,1,0,1,0
2162,1385,0,0,62,62,0,1,0,1,0
10664,1652,0,0,85,85,0,1,0,1,0
2899,95,0,0,81,81,0,1,0,1,0
2907,1173,0,0,147,147,0,1,0,1,0
1469,662,0,0,149,149,0,1,0,1,0
4613,183,16064,121,293,223,70,4,1,3,1
238,2277,0,0,145,145,0,1,0,1,0
2913,1178,0,0,147,147,0,1,0,1,0
4990,183,16445,121,293,223,70,4,1,3,1
1421,183,4935,121,293,223,70,4,0,3,1
12599,618,0,0,145,145,0,1,0,1,0
1714,592,0,0,130,130,0,1,0,1,0
8327,1610,0,0,146,146,0,1,0,1,0
5795,285,0,0,146,146,0,1,0,1,0
2990,1651,0,0,62,62,0,1,0,1,0
2913,1255,0,0,134,134,0,1,0,1,0
8318,1507,0,0,147,147,0,1,0,1,0
20418,1318,0,0,76,76,0,1,0,1,0
3482,239,0,0,111,111,0,1,0,1,0
814,1176,0,0,141,141,0,1,0,1,0
2399,1694,0,0,62,62,0,1,0,1,0
290,1065,0,0,157,157,0,1,0,1,0
1942,1053,0,0,113,113,0,1,0,1,0
1769,183,6668,121,293,223,70,4,0,3,1
1021,2845,0,0,141,141,0,1,0,1,0
1538,183,5557,121,293,223,70,4,0,3,1
14705,521,0,0,145,145,0,1,0,1,0
1516,924,0,0,142,142,0,1,0,1,0
15873,183,24503,121,293,223,70,4,0,3,1
2918,1694,0,0,62,62,0,1,0,1,0
6884,834,0,0,146,146,0,1,0,1,0
2591,228,0,0,78,78,0,1,0,1,0
1223,3095,0,0,142,142,0,1,0,1,0
1945,1002,0,0,101,101,0,1,0,1,0
9504,1598,0,0,115,115,0,1,0,1,0
1447,1165,0,0,136,136,0,1,0,1,0
11370,1658,0,0,62,62,0,1,0,1,0
1451,183,5083,121,293,223,70,4,0,3,1
7407,2877,0,0,72,72,0,1,0,1,0
1352,1166,0,0,140,140,0,1,0,1,0
1633,183,5990,121,293,223,70,4,0,3,1
2902,1580,0,0,80,80,0,1,0,1,0
4415,376,0,0,146,146,0,1,0,1,0
838,623,1991,67,232,193,38,2,0,2,0
1936,1130,0,0,131,131,0,1,0,1,0
1444,183,5077,121,293,223,70,4,1,3,1
1695,573,0,0,135,135,0,1,0,1,0
8027,1971,0,0,122,122,0,1,0,1,0
3021,183,11190,121,293,223,70,4,0,3,1
1257,1176,0,0,143,143,0,1,0,1,0
1836,183,6955,121,293,223,70,4,0,3,1
8909,1291,0,0,130,130,0,1,0,1,0
2660,428,0,0,93,93,0,1,0,1,0
10365,1543,0,0,76,76,0,1,0,1,0
1938,183,7464,121,293,223,70,4,0,3,1
3027,1694,0,0,62,62,0,1,0,1,0
1885,183,7333,121,293,223,70,4,0,3,1
2643,378,0,0,89,89,0,1,0,1,0
9205,1543,0,0,114,114,0,1,0,1,0
8395,1202,0,0,150,150,0,1,0,1,0
1976,3095,0,0,152,152,0,1,0,1,0
2905,1497,0,0,94,94,0,1,0,1,0
2902,1583,0,0,80,80,0,1,0,1,0
13188,1543,0,0,62,62,0,1,0,1,0
2664,442,0,0,94,94,0,1,0,1,0
2009,1176,0,0,143,143,0,1,0,1,0
3824,183,13913,121,293,223,70,4,0,3,1
17759,1601,0,0,62,62,0,1,0,1,0
9677,1593,0,0,96,96,0,1,0,1,0
926,183,3640,121,293,223,70,4,1,3,1
8389,1689,0,0,143,143,0,1,0,1,0
3989,587,0,0,133,133,0,1,0,1,0
1997,183,7805,121,293,223,70,4,0,3,1
8418,1543,0,0,142,142,0,1,0,1,0
762,3095,0,0,139,139,0,1,0,1,0
1954,1131,0,0,139,139,0,1,0,1,0
18393,3077,0,0,143,143,0,1,0,1,0
249,2016,0,0,144,144,0,1,0,1,0
1898,183,7314,121,293,223,70,4,0,3,1
8810,1543,0,0,129,129,0,1,0,1,0
669,1176,0,0,153,153,0,1,0,1,0
2089,3095,0,0,156,156,0,1,0,1,0
3804,183,13343,121,293,223,70,4,0,3,1
1639,516,158,4,153,150,2,1,0,1,0
1331,3095,0,0,142,142,0,1,0,1,0
1697,183,6273,121,293,223,70,4,0,3,1
1561,793,0,0,144,144,0,1,0,1,0
3081,183,10320,121,293,223,70,4,1,3,1
7959,1723,0,0,129,129,0,1,0,1,0
8327,1649,0,0,146,146,0,1,0,1,0
1322,183,4441,121,293,223,70,4,0,3,1
17412,1543,0,0,65,65,0,1,0,1,0
1770,183,6674,121,293,223,70,4,0,3,1
908,1176,0,0,153,153,0,1,0,1,0
3091,1638,0,0,65,65,0,1,0,1,0
2867,1694,0,0,62,62,0,1,0,1,0
9907,1414,0,0,95,95,0,1,0,1,0
1751,183,6539,121,293,223,70,4,0,3,1
1342,183,4539,121,293,223,70,4,1,3,1
2409,1586,0,0,79,79,0,1,0,1,0
1536,183,5504,121,293,223,70,4,0,3,1
2550,2440,0,0,113,113,0,1,0,1,0
9755,1543,0,0,94,94,0,1,0,1,0
1390,183,4778,121,293,223,70,4,0,3,1
426,2678,0,0,142,142,0,1,0,1,0
606,1054,0,0,143,143,0,1,0,1,0
1977,183,7688,121,293,223,70,4,0,3,1
35,1129,0,0,155,155,0,1,0,1,0
692,2645,0,0,142,142,0,1,0,1,0
2772,1176,0,0,147,147,0,1,0,1,0
3694,183,12613,121,293,223,70,4,0,3,1
8124,1404,0,0,145,145,0,1,0,1,0
8594,1674,0,0,136,136,0,1,0,1,0
1944,1025,0,0,106,106,0,1,0,1,0
831,676,1801,60,225,190,35,2,0,2,0
2031,183,7976,121,293,223,70,4,0,3,1
2824,1694,0,0,62,62,0,1,0,1,0
2799,1694,0,0,62,62,0,1,0,1,0
1335,688,0,0,146,146,0,1,0,1,0
3035,1687,0,0,62,62,0,1,0,1,0
2269,2050,0,0,86,86,0,1,0,1,0
2679,1694,0,0,62,62,0,1,0,1,0
2682,493,0,0,98,98,0,1,0,1,0
18086,1596,0,0,62,62,0,1,0,1,0
20327,1543,0,0,62,62,0,1,0,1,0
4058,495,0,0,139,139,0,1,0,1,0
399,1113,224,7,152,148,4,1,0,1,0
10627,1543,0,0,66,66,0,1,0,1,0
2412,1694,0,0,62,62,0,1,0,1,0
1613,641,0,0,146,146,0,1,0,1,0
2833,1834,0,0,71,71,0,1,0,1,0
11148,1543,0,0,71,71,0,1,0,1,0
4242,183,15090,121,293,223,70,4,0,3,1
909,183,3608,121,293,223,70,4,1,3,1
8320,1515,0,0,146,146,0,1,0,1,0
8549,183,15612,121,293,223,70,4,0,3,1
16980,1543,0,0,66,66,0,1,0,1,0
327,2531,0,0,143,143,0,1,0,1,0
12308,1294,0,0,84,84,0,1,0,1,0
509,1176,0,0,147,147,0,1,0,1,0
8287,1370,0,0,151,151,0,1,0,1,0
1581,735,0,0,145,145,0,1,0,1,0
2456,1292,0,0,62,62,0,1,0,1,0
8327,1644,0,0,146,146,0,1,0,1,0
2765,1694,0,0,62,62,0,1,0,1,0
5710,277,0,0,145,145,0,1,0,1,0
227,2181,0,0,144,144,0,1,0,1,0
2250,286,0,0,80,80,0,1,0,1,0
6442,521,0,0,149,149,0,1,0,1,0
17918,2710,0,0,145,145,0,1,0,1,0
1944,1017,0,0,104,104,0,1,0,1,0
19996,2364,0,0,105,105,0,1,0,1,0
2323,288,0,0,62,62,0,1,0,1,0
750,1176,0,0,156,156,0,1,0,1,0
237,2103,0,0,144,144,0,1,0,1,0
563,1176,0,0,142,142,0,1,0,1,0
1422,3095,0,0,139,139,0,1,0,1,0
1513,933,0,0,142,142,0,1,0,1,0
1354,3095,0,0,142,142,0,1,0,1,0
9008,1285,0,0,128,128,0,1,0,1,0
2819,892,0,0,127,127,0,1,0,1,0
3873,183,13144,121,293,223,70,4,0,3,1
367,1176,0,0,143,143,0,1,0,1,0
4001,183,13862,121,293,223,70,4,0,3,1
1195,183,4162,121,293,223,70,4,1,3,1
1085,1176,0,0,148,148,0,1,0,1,0
2196,183,8910,121,293,223,70,4,0,3,1
2069,3095,0,0,156,156,0,1,0,1,0
977,3095,0,0,139,139,0,1,0,1,0
1564,440,1123,30,185,167,17,1,0,1,0
424,1052,0,0,151,151,0,1,0,1,0
1869,183,7116,121,293,223,70,4,0,3,1
2822,1176,0,0,147,147,0,1,0,1,0
7347,1061,0,0,146,146,0,1,0,1,0
4985,183,16445,121,293,223,70,4,0,3,1
3159,1424,0,0,79,79,0,1,0,1,0
9499,1597,0,0,115,115,0,1,0,1,0
2398,183,9079,121,293,223,70,4,0,3,1
8148,2622,0,0,64,64,0,1,0,1,0
2056,3095,0,0,156,156,0,1,0,1,0
1788,183,6724,121,293,223,70,4,0,3,1
4091,388,0,0,143,143,0,1,0,1,0
2931,1694,0,0,62,62,0,1,0,1,0
1002,3095,0,0,140,140,0,1,0,1,0
2557,1694,0,0,62,62,0,1,0,1,0
2287,459,0,0,93,93,0,1,0,1,0
1083,183,3945,121,293,223,70,4,1,3,1
14123,316,0,0,140,140,0,1,0,1,0
1272,806,0,0,151,151,0,1,0,1,0
1741,3095,0,0,152,152,0,1,0,1,0
1296,3095,0,0,139,139,0,1,0,1,0
5359,282,0,0,146,146,0,1,0,1,0
8029,1967,0,0,122,122,0,1,0,1,0
9261,1352,0,0,116,116,0,1,0,1,0
11055,1315,0,0,84,84,0,1,0,1,0
2615,1176,0,0,146,146,0,1,0,1,0
8327,1188,0,0,153,153,0,1,0,1,0
2042,1066,0,0,62,62,0,1,0,1,0
3593,183,12786,121,293,223,70,4,0,3,1
20055,2336,0,0,104,104,0,1,0,1,0
2183,1552,0,0,84,84,0,1,0,1,0
1797,183,6811,121,293,223,70,4,0,3,1
847,557,2228,75,241,198,43,2,0,2,0
1569,2866,0,0,126,126,0,1,0,1,0
2772,1292,0,0,128,128,0,1,0,1,0
12486,1883,0,0,73,73,0,1,0,1,0
666,2629,0,0,142,142,0,1,0,1,0
1924,183,7389,121,293,223,70,4,0,3,1
7638,2528,0,0,91,91,0,1,0,1,0
3539,1114,0,0,99,99,0,1,0,1,0
9970,1620,0,0,103,103,0,1,0,1,0
1697,500,0,0,143,143,0,1,0,1,0
7513,2740,0,0,81,81,0,1,0,1,0
3633,183,13346,121,293,223,70,4,0,3,1
17971,2991,0,0,138,138,0,1,0,1,0
9379,1543,0,0,110,110,0,1,0,1,0
3478,183,11974,121,293,223,70,4,0,3,1
2948,1307,0,0,126,126,0,1,0,1,0
1729,183,6520,121,293,223,70,4,0,3,1
3017,1694,0,0,62,62,0,1,0,1,0
8369,2514,0,0,65,65,0,1,0,1,0
4008,547,0,0,136,136,0,1,0,1,0
9863,1456,0,0,91,91,0,1,0,1,0
2328,376,0,0,87,87,0,1,0,1,0
1397,1176,0,0,139,139,0,1,0,1,0
2903,1545,0,0,86,86,0,1,0,1,0
13553,183,22684,121,293,223,70,4,0,3,1
2588,1411,0,0,62,62,0,1,0,1,0
3390,1186,0,0,95,95,0,1,0,1,0
3687,941,0,0,110,110,0,1,0,1,0
3031,1644,0,0,70,70,0,1,0,1,0
2063,183,8141,121,293,223,70,4,0,3,1
8256,1235,0,0,155,155,0,1,0,1,0
1961,183,6900,121,293,223,70,4,1,3,1
153,1070,0,0,151,151,0,1,0,1,0
7998,183,14396,121,293,223,70,4,0,3,1
4351,183,15476,121,293,223,70,4,0,3,1
4881,183,16396,121,293,223,70,4,1,3,1
1346,1165,0,0,140,140,0,1,0,1,0
9084,1321,0,0,123,123,0,1,0,1,0
2501,2546,0,0,120,120,0,1,0,1,0
1952,909,0,0,78,78,0,1,0,1,0
9612,1908,0,0,69,69,0,1,0,1,0
2265,375,0,0,62,62,0,1,0,1,0
2884,1201,0,0,143,143,0,1,0,1,0
2911,1306,0,0,126,126,0,1,0,1,0
10649,1543,0,0,65,65,0,1,0,1,0
8280,1410,0,0,152,152,0,1,0,1,0
1695,183,6269,121,293,223,70,4,0,3,1
9324,1330,0,0,116,116,0,1,0,1,0
1588,183,5764,121,293,223,70,4,0,3,1
2273,950,0,0,90,90,0,1,0,1,0
1631,1176,0,0,140,140,0,1,0,1,0
1947,1182,0,0,141,141,0,1,0,1,0
8560,1676,0,0,137,137,0,1,0,1,0
1448,183,5735,121,293,223,70,4,0,3,1
1471,183,5185,121,293,223,70,4,0,3,1
1276,183,4620,121,293,223,70,4,1,3,1
2622,1694,0,0,62,62,0,1,0,1,0
7819,1994,0,0,115,115,0,1,0,1,0
7411,2872,0,0,72,72,0,1,0,1,0
938,202,3373,114,284,218,65,3,0,2,0
3400,219,0,0,107,107,0,1,0,1,0
21353,1710,0,0,70,70,0,1,0,1,0
13372,555,0,0,127,127,0,1,0,1,0
21433,1672,0,0,68,68,0,1,0,1,0
2896,1694,0,0,62,62,0,1,0,1,0
4536,183,15273,121,293,223,70,4,0,3,1
980,3095,0,0,140,140,0,1,0,1,0
13387,730,0,0,117,117,0,1,0,1,0
2818,1254,0,0,134,134,0,1,0,1,0
8282,1417,0,0,151,151,0,1,0,1,0
8846,1662,0,0,128,128,0,1,0,1,0
890,1176,0,0,153,153,0,1,0,1,0
3243,183,11450,121,293,223,70,4,1,3,1
2168,183,8749,121,293,223,70,4,0,3,1
3691,936,0,0,111,111,0,1,0,1,0
4550,183,15985,121,293,223,70,4,1,3,1
1496,984,0,0,141,141,0,1,0,1,0
1715,489,0,0,141,141,0,1,0,1,0
1893,881,0,0,71,71,0,1,0,1,0
1484,1018,0,0,141,141,0,1,0,1,0
2882,183,10169,121,293,223,70,4,1,3,1
2738,183,10071,121,293,223,70,4,0,3,1
8332,1693,0,0,145,145,0,1,0,1,0
1904,1176,0,0,142,142,0,1,0,1,0
10292,1694,0,0,94,94,0,1,0,1,0
1844,972,0,0,144,144,0,1,0,1,0
13892,183,20632,121,293,223,70,4,0,3,1
8994,1543,0,0,121,121,0,1,0,1,0
4522,640,0,0,146,146,0,1,0,1,0
1952,183,7692,121,293,223,70,4,0,3,1
1773,809,0,0,145,145,0,1,0,1,0
5262,292,0,0,146,146,0,1,0,1,0
13310,770,0,0,115,115,0,1,0,1,0
20266,2234,0,0,98,98,0,1,0,1,0
16507,2717,0,0,127,127,0,1,0,1,0
2009,3095,0,0,153,153,0,1,0,1,0
4118,183,14648,121,293,223,70,4,0,3,1
4230,394,0,0,146,146,0,1,0,1,0
1614,490,485,13,164,156,7,1,0,1,0
2004,1032,0,0,133,133,0,1,0,1,0
11918,765,0,0,145,145,0,1,0,1,0
8428,1543,0,0,142,142,0,1,0,1,0
1176,3095,0,0,145,145,0,1,0,1,0
1527,183,5450,121,293,223,70,4,0,3,1
2153,183,8662,121,293,223,70,4,0,3,1
2914,1222,0,0,140,140,0,1,0,1,0
2063,912,0,0,124,124,0,1,0,1,0
1311,627,0,0,149,149,0,1,0,1,0
1400,1176,0,0,149,149,0,1,0,1,0
17952,2734,0,0,145,145,0,1,0,1,0
2315,300,0,0,62,62,0,1,0,1,0
21640,1340,4236,18,96,85,10,1,0,1,0
2567,1458,0,0,101,101,0,1,0,1,0
2791,1924,0,0,77,77,0,1,0,1,0
1400,3095,0,0,140,140,0,1,0,1,0
2374,283,0,0,81,81,0,1,0,1,0
81,1017,0,0,157,157,0,1,0,1,0
8548,1543,0,0,137,137,0,1,0,1,0
2165,1879,0,0,72,72,0,1,0,1,0
7903,2239,0,0,112,112,0,1,0,1,0
9133,1580,0,0,124,124,0,1,0,1,0
9276,1636,0,0,113,113,0,1,0,1,0
9410,1628,0,0,109,109,0,1,0,1,0
1202,1176,0,0,145,145,0,1,0,1,0
2613,1421,0,0,107,107,0,1,0,1,0
4049,464,0,0,146,146,0,1,0,1,0
3140,183,11885,121,293,223,70,4,0,3,1
13862,481,0,0,131,131,0,1,0,1,0
1942,1050,0,0,112,112,0,1,0,1,0
2670,1694,0,0,62,62,0,1,0,1,0
9030,1543,0,0,120,120,0,1,0,1,0
7768,2341,0,0,101,101,0,1,0,1,0
8801,1565,0,0,133,133,0,1,0,1,0
9717,1543,0,0,98,98,0,1,0,1,0
13011,2049,0,0,95,95,0,1,0,1,0
1452,1176,0,0,139,139,0,1,0,1,0
8270,1294,0,0,153,153,0,1,0,1,0
1949,954,0,0,89,89,0,1,0,1,0
7040,910,0,0,146,146,0,1,0,1,0
1586,183,5730,121,293,223,70,4,0,3,1
1552,1098,0,0,121,121,0,1,0,1,0
1937,183,7506,121,293,223,70,4,0,3,1
4155,183,11180,121,293,223,70,4,0,3,1
124,1772,0,0,150,150,0,1,0,1,0
1718,183,6466,121,293,223,70,4,0,3,1
448,1176,0,0,145,145,0,1,0,1,0
2545,1694,0,0,62,62,0,1,0,1,0
1659,183,6092,121,293,223,70,4,0,3,1
6620,585,0,0,149,149,0,1,0,1,0
8337,1543,0,0,145,145,0,1,0,1,0
9054,1639,0,0,119,119,0,1,0,1,0
1200,1176,0,0,145,145,0,1,0,1,0
9839,1797,0,0,70,70,0,1,0,1,0
2575,180,0,0,75,75,0,1,0,1,0
3814,747,0,0,123,123,0,1,0,1,0
2439,82,0,0,67,67,0,1,0,1,0
2905,1687,0,0,62,62,0,1,0,1,0
1818,183,6913,121,293,223,70,4,0,3,1
435,1044,472,15,162,153,9,1,0,1,0
500,1176,0,0,147,147,0,1,0,1,0
301,1143,0,0,145,145,0,1,0,1,0
1671,183,6152,121,293,223,70,4,0,3,1
8263,1264,0,0,154,154,0,1,0,1,0
2024,1313,0,0,121,121,0,1,0,1,0
2243,1602,0,0,62,62,0,1,0,1,0
1129,183,4034,121,293,223,70,4,1,3,1
629,1144,0,0,157,157,0,1,0,1,0
160,2030,0,0,147,147,0,1,0,1,0
804,2743,0,0,143,143,0,1,0,1,0
2375,986,0,0,99,99,0,1,0,1,0
8775,1660,0,0,129,129,0,1,0,1,0
104,1045,0,0,153,153,0,1,0,1,0
4993,183,16534,121,293,223,70,4,1,3,1
8302,1436,0,0,149,149,0,1,0,1,0
2280,1691,0,0,62,62,0,1,0,1,0
2232,183,9121,121,293,223,70,4,0,3,1
3820,322,0,0,129,129,0,1,0,1,0
1599,183,5794,121,293,223,70,4,0,3,1
1994,319,0,0,113,113,0,1,0,1,0
8171,1466,0,0,146,146,0,1,0,1,0
2863,1022,0,0,136,136,0,1,0,1,0
1351,3095,0,0,142,142,0,1,0,1,0
2922,1694,0,0,62,62,0,1,0,1,0
18436,3064,0,0,145,145,0,1,0,1,0
254,2244,0,0,146,146,0,1,0,1,0
1935,1148,0,0,136,136,0,1,0,1,0
2037,1546,0,0,83,83,0,1,0,1,0
868,2752,0,0,141,141,0,1,0,1,0
2076,183,8245,121,293,223,70,4,0,3,1
1838,183,7013,121,293,223,70,4,0,3,1
8279,1399,0,0,152,152,0,1,0,1,0
1705,495,0,0,142,142,0,1,0,1,0
2763,1985,0,0,82,82,0,1,0,1,0
1385,183,4753,121,293,223,70,4,1,3,1
2423,1694,0,0,62,62,0,1,0,1,0
4981,183,16428,121,293,223,70,4,0,3,1
1518,1176,0,0,139,139,0,1,0,1,0
9186,183,19619,121,293,223,70,4,0,3,1
8297,1731,0,0,143,143,0,1,0,1,0
10134,1584,0,0,84,84,0,1,0,1,0
1542,183,5521,121,293,223,70,4,0,3,1
3392,183,11910,121,293,223,70,4,0,3,1
2676,1694,0,0,62,62,0,1,0,1,0
669,1381,0,0,154,154,0,1,0,1,0
14192,286,0,0,142,142,0,1,0,1,0
8284,1431,0,0,151,151,0,1,0,1,0
8708,1460,0,0,145,145,0,1,0,1,0
2049,183,8092,121,293,223,70,4,0,3,1
2119,3095,0,0,156,156,0,1,0,1,0
1545,420,1378,38,193,171,21,1,0,1,0
2249,2899,0,0,145,145,0,1,0,1,0
9825,1402,0,0,98,98,0,1,0,1,0
2441,2675,0,0,129,129,0,1,0,1,0
1423,1176,0,0,139,139,0,1,0,1,0
8796,1271,0,0,134,134,0,1,0,1,0
1357,1176,0,0,141,141,0,1,0,1,0
10164,1582,0,0,83,83,0,1,0,1,0
3948,609,0,0,132,132,0,1,0,1,0
1954,183,7551,121,293,223,70,4,0,3,1
18283,183,25278,121,293,223,70,4,0,3,1
11303,1663,0,0,64,64,0,1,0,1,0
12725,591,0,0,145,145,0,1,0,1,0
338,1376,0,0,143,143,0,1,0,1,0
1084,183,4094,121,293,223,70,4,1,3,1
14681,505,0,0,145,145,0,1,0,1,0
2470,2611,0,0,125,125,0,1,0,1,0
2900,1637,0,0,71,71,0,1,0,1,0
4668,183,16132,121,293,223,70,4,1,3,1
10147,1694,0,0,98,98,0,1,0,1,0
559,1176,0,0,149,149,0,1,0,1,0
2626,1694,0,0,62,62,0,1,0,1,0
1003,1123,0,0,144,144,0,1,0,1,0
1859,1437,0,0,100,100,0,1,0,1,0
3242,1339,0,0,85,85,0,1,0,1,0
2528,1495,0,0,93,93,0,1,0,1,0
8323,1526,0,0,146,146,0,1,0,1,0
2905,183,10252,121,293,223,70,4,1,3,1
2725,1536,0,0,62,62,0,1,0,1,0
1815,1176,0,0,142,142,0,1,0,1,0
2913,1261,0,0,133,133,0,1,0,1,0
2829,1694,0,0,62,62,0,1,0,1,0
3048,1131,0,0,147,147,0,1,0,1,0
8307,1458,0,0,148,148,0,1,0,1,0
2994,1670,0,0,65,65,0,1,0,1,0
13880,2164,0,0,95,95,0,1,0,1,0
3000,1517,0,0,91,91,0,1,0,1,0
1258,183,4569,121,293,223,70,4,1,3,1
2486,1025,0,0,109,109,0,1,0,1,0
715,3095,0,0,139,139,0,1,0,1,0
269,1128,0,0,146,146,0,1,0,1,0
3577,760,0,0,146,146,0,1,0,1,0
1047,833,0,0,145,145,0,1,0,1,0
873,2788,0,0,143,143,0,1,0,1,0
2014,183,7899,121,293,223,70,4,0,3,1
4816,183,16316,121,293,223,70,4,1,3,1
1538,183,5497,121,293,223,70,4,0,3,1
1168,2934,0,0,140,140,0,1,0,1,0
430,2486,0,0,143,143,0,1,0,1,0
9103,1646,0,0,119,119,0,1,0,1,0
1679,557,0,0,140,140,0,1,0,1,0
2650,1391,0,0,112,112,0,1,0,1,0
18431,3084,0,0,144,144,0,1,0,1,0
623,2971,0,0,139,139,0,1,0,1,0
2220,180,0,0,91,91,0,1,0,1,0
2205,183,8974,121,293,223,70,4,0,3,1
1066,261,2770,93,260,206,54,3,0,2,0
1250,183,4268,121,293,223,70,4,1,3,1
2184,183,8232,121,293,223,70,4,0,3,1
1618,183,5915,121,293,223,70,4,0,3,1
10423,1543,0,0,70,70,0,1,0,1,0
1962,183,7596,121,293,223,70,4,0,3,1
247,1116,0,0,147,147,0,1,0,1,0
10667,1543,0,0,65,65,0,1,0,1,0
7566,2673,0,0,85,85,0,1,0,1,0
8975,1302,0,0,127,127,0,1,0,1,0
2624,2281,0,0,102,102,0,1,0,1,0
1735,1176,0,0,145,145,0,1,0,1,0
8255,1178,0,0,156,156,0,1,0,1,0
6220,537,0,0,146,146,0,1,0,1,0
16804,2774,0,0,129,129,0,1,0,1,0
10083,1694,0,0,100,100,0,1,0,1,0
1738,183,6478,121,293,223,70,4,0,3,1
12807,803,0,0,109,109,0,1,0,1,0
13549,497,0,0,130,130,0,1,0,1,0
4818,183,15970,121,293,223,70,4,0,3,1
10734,1543,0,0,63,63,0,1,0,1,0
9092,1637,0,0,118,118,0,1,0,1,0
1408,183,4863,121,293,223,70,4,1,3,1
469,2523,0,0,144,144,0,1,0,1,0
4233,183,14303,121,293,223,70,4,0,3,1
2526,183,9974,121,293,223,70,4,0,3,1
1736,3095,0,0,146,146,0,1,0,1,0
1366,738,0,0,150,150,0,1,0,1,0
1967,1228,0,0,134,134,0,1,0,1,0
2968,1390,0,0,112,112,0,1,0,1,0
71,1029,0,0,154,154,0,1,0,1,0
1948,968,0,0,93,93,0,1,0,1,0
7762,2103,0,0,109,109,0,1,0,1,0
2790,1176,0,0,147,147,0,1,0,1,0
1689,183,6236,121,293,223,70,4,0,3,1
1953,900,0,0,76,76,0,1,0,1,0
17009,2797,0,0,127,127,0,1,0,1,0
1810,1176,0,0,142,142,0,1,0,1,0
1703,183,6339,121,293,223,70,4,0,3,1
13936,442,0,0,133,133,0,1,0,1,0
1666,3095,0,0,148,148,0,1,0,1,0
4953,322,0,0,146,146,0,1,0,1,0
2448,100,0,0,62,62,0,1,0,1,0
8270,1346,0,0,153,153,0,1,0,1,0
458,1104,0,0,157,157,0,1,0,1,0
1707,183,6324,121,293,223,70,4,0,3,1
1617,183,5888,121,293,223,70,4,0,3,1
1182,183,4362,121,293,223,70,4,1,3,1
2379,183,8714,121,293,223,70,4,0,3,1
14837,611,0,0,145,145,0,1,0,1,0
8880,1543,0,0,127,127,0,1,0,1,0
1852,991,0,0,144,144,0,1,0,1,0
1647,2737,0,0,119,119,0,1,0,1,0
2150,183,8644,121,293,223,70,4,0,3,1
8301,1537,0,0,149,149,0,1,0,1,0
2234,183,9136,121,293,223,70,4,0,3,1
10733,1655,0,0,83,83,0,1,0,1,0
8251,1214,0,0,155,155,0,1,0,1,0
1483,3095,0,0,145,145,0,1,0,1,0
1521,566,0,0,148,148,0,1,0,1,0
1117,183,4010,121,293,223,70,4,1,3,1
8281,1752,0,0,142,142,0,1,0,1,0
12484,1202,0,0,90,90,0,1,0,1,0
373,2451,0,0,144,144,0,1,0,1,0
2602,1694,0,0,62,62,0,1,0,1,0
1671,573,0,0,147,147,0,1,0,1,0
2791,1276,0,0,131,131,0,1,0,1,0
10940,1570,0,0,62,62,0,1,0,1,0
2625,1694,0,0,62,62,0,1,0,1,0
8837,1662,0,0,128,128,0,1,0,1,0
2498,1176,0,0,145,145,0,1,0,1,0
759,3095,0,0,139,139,0,1,0,1,0
19942,2390,0,0,107,107,0,1,0,1,0
10741,1547,0,0,64,64,0,1,0,1,0
899,1176,0,0,153,153,0,1,0,1,0
8081,1894,0,0,126,126,0,1,0,1,0
2938,1268,0,0,132,132,0,1,0,1,0
8904,1543,0,0,126,126,0,1,0,1,0
13607,507,0,0,128,128,0,1,0,1,0
8931,1412,0,0,145,145,0,1,0,1,0
15298,2486,0,0,116,116,0,1,0,1,0
2708,1694,0,0,62,62,0,1,0,1,0
1379,3095,0,0,143,143,0,1,0,1,0
2902,1598,0,0,77,77,0,1,0,1,0
1554,430,1254,34,189,169,20,1,0,1,0
8327,1644,0,0,146,146,0,1,0,1,0
1517,1176,0,0,139,139,0,1,0,1,0
8532,1543,0,0,138,138,0,1,0,1,0
1241,3031,0,0,143,143,0,1,0,1,0
1720,183,6391,121,293,223,70,4,0,3,1
19816,2451,0,0,110,110,0,1,0,1,0
461,2518,0,0,144,144,0,1,0,1,0
714,2659,0,0,142,142,0,1,0,1,0
8924,1413,0,0,145,145,0,1,0,1,0
2914,1177,0,0,147,147,0,1,0,1,0
1749,830,0,0,116,116,0,1,0,1,0
2724,1108,0,0,130,130,0,1,0,1,0
2046,183,8052,121,293,223,70,4,0,3,1
10421,1566,0,0,75,75,0,1,0,1,0
15768,1245,0,0,145,145,0,1,0,1,0
1951,183,7533,121,293,223,70,4,0,3,1
1039,183,3859,121,293,223,70,4,1,3,1
313,1559,0,0,143,143,0,1,0,1,0
19299,2700,0,0,123,123,0,1,0,1,0
3014,1574,0,0,81,81,0,1,0,1,0
1370,183,4874,121,293,223,70,4,1,3,1
1084,3095,0,0,141,141,0,1,0,1,0
11559,1687,0,0,62,62,0,1,0,1,0
4022,481,0,0,146,146,0,1,0,1,0
1162,887,0,0,152,152,0,1,0,1,0
8256,1260,0,0,155,155,0,1,0,1,0
11178,1647,0,0,65,65,0,1,0,1,0
8323,1669,0,0,146,146,0,1,0,1,0
9385,1629,0,0,110,110,0,1,0,1,0
21558,1611,0,0,65,65,0,1,0,1,0
1938,1096,0,0,123,123,0,1,0,1,0
2352,1694,0,0,62,62,0,1,0,1,0
203,1095,0,0,149,149,0,1,0,1,0
1334,205,4101,113,283,218,65,3,0,2,0
1181,183,4360,121,293,223,70,4,1,3,1
1341,183,4530,121,293,223,70,4,0,3,1
2562,1051,0,0,116,116,0,1,0,1,0
1741,736,0,0,146,146,0,1,0,1,0
1358,183,4841,121,293,223,70,4,1,3,1
4681,183,16148,121,293,223,70,4,1,3,1
891,210,3480,117,289,221,68,3,0,2,0
1997,183,7801,121,293,223,70,4,0,3,1
1615,183,5899,121,293,223,70,4,0,3,1
790,1159,0,0,156,156,0,1,0,1,0
1063,1176,0,0,148,148,0,1,0,1,0
7293,3039,0,0,62,62,0,1,0,1,0
4001,367,0,0,138,138,0,1,0,1,0
538,1176,0,0,149,149,0,1,0,1,0
8256,1233,0,0,155,155,0,1,0,1,0
1868,3095,0,0,152,152,0,1,0,1,0
139,1063,0,0,152,152,0,1,0,1,0
8327,1570,0,0,146,146,0,1,0,1,0
3628,728,0,0,146,146,0,1,0,1,0
1748,183,6561,121,293,223,70,4,0,3,1
146,1066,0,0,151,151,0,1,0,1,0
145,1924,0,0,148,148,0,1,0,1,0
2011,983,0,0,62,62,0,1,0,1,0
1350,183,4577,121,293,223,70,4,1,3,1
2000,183,7797,121,293,223,70,4,0,3,1
8913,2249,0,0,67,67,0,1,0,1,0
1343,3095,0,0,142,142,0,1,0,1,0
2337,183,7933,121,293,223,70,4,1,3,1
12726,183,22205,121,293,223,70,4,0,3,1
13415,578,0,0,123,123,0,1,0,1,0
8099,1868,0,0,127,127,0,1,0,1,0
1574,756,0,0,144,144,0,1,0,1,0
774,1126,176,5,163,160,3,1,0,1,0
2163,183,8773,121,293,223,70,4,0,3,1
19293,2703,0,0,124,124,0,1,0,1,0
1956,183,7573,121,293,223,70,4,0,3,1
4410,376,0,0,146,146,0,1,0,1,0
8399,1543,0,0,143,143,0,1,0,1,0
69,1028,0,0,154,154,0,1,0,1,0
231,2292,0,0,145,145,0,1,0,1,0
1428,3095,0,0,148,148,0,1,0,1,0
2142,1490,0,0,93,93,0,1,0,1,0
15143,819,0,0,145,145,0,1,0,1,0
12411,1240,0,0,88,88,0,1,0,1,0
4054,461,0,0,146,146,0,1,0,1,0
2179,1633,0,0,70,70,0,1,0,1,0
2021,183,7915,121,293,223,70,4,0,3,1
2810,1261,0,0,133,133,0,1,0,1,0
887,913,0,0,145,145,0,1,0,1,0
15197,856,0,0,145,145,0,1,0,1,0
8794,1665,0,0,130,130,0,1,0,1,0
8252,1233,0,0,155,155,0,1,0,1,0
14110,291,0,0,145,145,0,1,0,1,0
1834,1423,0,0,102,102,0,1,0,1,0
1458,183,5112,121,293,223,70,4,1,3,1
3007,1694,0,0,62,62,0,1,0,1,0
8900,1651,0,0,125,125,0,1,0,1,0
10207,1579,0,0,82,82,0,1,0,1,0
1394,3095,0,0,140,140,0,1,0,1,0
2262,2338,0,0,106,106,0,1,0,1,0
1163,183,4099,121,293,223,70,4,1,3,1
1666,563,0,0,147,147,0,1,0,1,0
353,1267,0,0,143,143,0,1,0,1,0
2966,1380,0,0,113,113,0,1,0,1,0
9353,1368,0,0,112,112,0,1,0,1,0
581,1132,0,0,157,157,0,1,0,1,0
1751,183,6637,121,293,223,70,4,0,3,1
1251,183,4549,121,293,223,70,4,1,3,1
18589,1543,0,0,62,62,0,1,0,1,0
12786,1944,0,0,76,76,0,1,0,1,0
1918,1176,0,0,142,142,0,1,0,1,0
945,183,3677,121,293,223,70,4,1,3,1
2774,762,0,0,117,117,0,1,0,1,0
2641,373,0,0,89,89,0,1,0,1,0
1643,183,6099,121,293,223,70,4,0,3,1
754,1595,0,0,153,153,0,1,0,1,0
1139,3095,0,0,141,141,0,1,0,1,0
2100,1219,0,0,62,62,0,1,0,1,0
3487,1085,0,0,101,101,0,1,0,1,0
10967,1620,0,0,66,66,0,1,0,1,0
9771,1543,0,0,93,93,0,1,0,1,0
16688,2732,0,0,125,125,0,1,0,1,0
114,1051,0,0,153,153,0,1,0,1,0
1636,512,203,5,154,151,3,1,0,1,0
8441,1204,0,0,149,149,0,1,0,1,0
2117,183,8478,121,293,223,70,4,0,3,1
8967,1573,0,0,129,129,0,1,0,1,0
1952,916,0,0,80,80,0,1,0,1,0
2105,1233,0,0,62,62,0,1,0,1,0
2067,926,0,0,62,62,0,1,0,1,0
762,1174,0,0,157,157,0,1,0,1,0
2740,1694,0,0,62,62,0,1,0,1,0
1088,271,2665,90,255,203,52,3,0,2,0
1710,664,0,0,146,146,0,1,0,1,0
203,1095,0,0,149,149,0,1,0,1,0
1192,759,0,0,146,146,0,1,0,1,0
1729,183,6433,121,293,223,70,4,0,3,1
443,1176,0,0,145,145,0,1,0,1,0
2024,1312,0,0,121,121,0,1,0,1,0
2213,183,9007,121,293,223,70,4,0,3,1
9319,1633,0,0,112,112,0,1,0,1,0
1473,1176,0,0,139,139,0,1,0,1,0
2253,394,0,0,62,62,0,1,0,1,0
149,1955,0,0,148,148,0,1,0,1,0
1399,183,4814,121,293,223,70,4,0,3,1
1949,949,0,0,88,88,0,1,0,1,0
1505,957,0,0,142,142,0,1,0,1,0
1648,1037,0,0,107,107,0,1,0,1,0
1622,183,5909,121,293,223,70,4,0,3,1
8327,1647,0,0,146,146,0,1,0,1,0
1097,3095,0,0,144,144,0,1,0,1,0
1405,3095,0,0,140,140,0,1,0,1,0
9804,1604,0,0,95,95,0,1,0,1,0
2163,183,8774,121,293,223,70,4,0,3,1
2683,1364,0,0,116,116,0,1,0,1,0
1814,183,6961,121,293,223,70,4,0,3,1
16998,1543,0,0,62,62,0,1,0,1,0
13065,517,0,0,145,145,0,1,0,1,0
1630,183,5973,121,293,223,70,4,0,3,1
5039,467,0,0,146,146,0,1,0,1,0
1978,183,7682,121,293,223,70,4,0,3,1
17968,2745,0,0,145,145,0,1,0,1,0
3682,884,0,0,114,114,0,1,0,1,0
8391,1197,0,0,151,151,0,1,0,1,0
531,2834,0,0,141,141,0,1,0,1,0
1939,353,0,0,119,119,0,1,0,1,0
2614,2303,0,0,104,104,0,1,0,1,0
545,839,1213,41,193,170,23,2,0,1,0
16412,183,24897,121,293,223,70,4,0,3,1
9847,1601,0,0,94,94,0,1,0,1,0
2517,1694,0,0,62,62,0,1,0,1,0
599,2609,0,0,144,144,0,1,0,1,0
1751,183,6635,121,293,223,70,4,0,3,1
2946,1301,0,0,127,127,0,1,0,1,0
10230,1543,0,0,76,76,0,1,0,1,0
11037,1543,0,0,62,62,0,1,0,1,0
2603,183,9622,121,293,223,70,4,0,3,1
2336,183,8738,121,293,223,70,4,0,3,1
8764,1667,0,0,131,131,0,1,0,1,0
1693,570,0,0,136,136,0,1,0,1,0
10180,1453,0,0,85,85,0,1,0,1,0
3006,1542,0,0,87,87,0,1,0,1,0
711,527,2336,78,240,195,45,2,0,2,0
8298,1515,0,0,149,149,0,1,0,1,0
17578,2479,0,0,145,145,0,1,0,1,0
13568,2155,0,0,100,100,0,1,0,1,0
2251,1623,0,0,62,62,0,1,0,1,0
8703,1543,0,0,132,132,0,1,0,1,0
433,2499,0,0,144,144,0,1,0,1,0
1170,3095,0,0,139,139,0,1,0,1,0
2861,183,10478,121,293,223,70,4,0,3,1
9915,1694,0,0,104,104,0,1,0,1,0
776,1169,0,0,156,156,0,1,0,1,0
1217,1176,0,0,144,144,0,1,0,1,0
8987,1543,0,0,121,121,0,1,0,1,0
11136,1421,0,0,69,69,0,1,0,1,0
7555,2645,0,0,84,84,0,1,0,1,0
2735,1545,0,0,62,62,0,1,0,1,0
4835,183,16339,121,293,223,70,4,1,3,1
6193,1134,0,0,119,119,0,1,0,1,0
8254,1244,0,0,155,155,0,1,0,1,0
9443,1626,0,0,108,108,0,1,0,1,0
317,1524,0,0,143,143,0,1,0,1,0
21599,1204,7077,30,119,102,17,1,0,1,0
2913,1249,0,0,135,135,0,1,0,1,0
17314,2299,0,0,145,145,0,1,0,1,0
2933,1164,0,0,147,147,0,1,0,1,0
2191,487,0,0,62,62,0,1,0,1,0
1659,927,0,0,122,122,0,1,0,1,0
20432,183,27834,121,293,223,70,4,0,3,1
9944,1419,0,0,94,94,0,1,0,1,0
839,618,2008,67,233,194,39,2,0,2,0
346,1318,0,0,143,143,0,1,0,1,0
11627,1651,0,0,64,64,0,1,0,1,0
2107,3095,0,0,157,157,0,1,0,1,0
762,1345,0,0,155,155,0,1,0,1,0
9258,1351,0,0,116,116,0,1,0,1,0
10942,1570,0,0,62,62,0,1,0,1,0
14303,250,0,0,144,144,0,1,0,1,0
8327,1560,0,0,146,146,0,1,0,1,0
3511,183,12571,121,293,223,70,4,0,3,1
8279,1399,0,0,152,152,0,1,0,1,0
9248,1543,0,0,112,112,0,1,0,1,0
11466,1677,0,0,62,62,0,1,0,1,0
2255,2666,0,0,129,129,0,1,0,1,0
2119,1272,0,0,62,62,0,1,0,1,0
1428,183,5031,121,293,223,70,4,1,3,1
9908,1694,0,0,104,104,0,1,0,1,0
1454,1190,0,0,136,136,0,1,0,1,0
457,1822,0,0,150,150,0,1,0,1,0
2291,337,0,0,62,62,0,1,0,1,0
1961,183,7597,121,293,223,70,4,0,3,1
7425,2756,0,0,76,76,0,1,0,1,0
3363,183,12546,121,293,223,70,4,0,3,1
2435,1694,0,0,62,62,0,1,0,1,0
2190,351,0,0,84,84,0,1,0,1,0
1699,2556,0,0,111,111,0,1,0,1,0
9923,1575,0,0,87,87,0,1,0,1,0
694,1176,0,0,154,154,0,1,0,1,0
1417,183,4910,121,293,223,70,4,1,3,1
9719,1241,0,0,145,145,0,1,0,1,0
2303,318,0,0,62,62,0,1,0,1,0
2808,1263,0,0,133,133,0,1,0,1,0
1340,386,1471,49,207,178,28,2,0,1,0
2577,2381,0,0,109,109,0,1,0,1,0
2030,183,7970,121,293,223,70,4,0,3,1
7913,1339,0,0,146,146,0,1,0,1,0
4140,410,0,0,145,145,0,1,0,1,0
2490,183,8425,121,293,223,70,4,1,3,1
1806,183,6853,121,293,223,70,4,0,3,1
603,1074,0,0,149,149,0,1,0,1,0
18384,962,0,0,99,99,0,1,0,1,0
1889,183,7365,121,293,223,70,4,0,3,1
2931,183,11263,121,293,223,70,4,0,3,1
90,1038,0,0,154,154,0,1,0,1,0
3202,1380,0,0,82,82,0,1,0,1,0
1969,183,6927,121,293,223,70,4,1,3,1
14581,2307,0,0,98,98,0,1,0,1,0
10515,1543,0,0,68,68,0,1,0,1,0
302,1144,0,0,145,145,0,1,0,1,0
10202,1456,0,0,84,84,0,1,0,1,0
21635,1574,0,0,63,63,0,1,0,1,0
1569,183,5673,121,293,223,70,4,0,3,1
2254,2706,0,0,132,132,0,1,0,1,0
7829,2334,0,0,106,106,0,1,0,1,0
1347,751,0,0,151,151,0,1,0,1,0
1762,641,0,0,116,116,0,1,0,1,0
1405,3095,0,0,140,140,0,1,0,1,0
1913,183,7391,121,293,223,70,4,0,3,1
2702,1349,0,0,119,119,0,1,0,1,0
8248,1201,0,0,156,156,0,1,0,1,0
18770,2956,0,0,137,137,0,1,0,1,0
413,888,0,0,154,154,0,1,0,1,0
1161,2930,0,0,140,140,0,1,0,1,0
8257,1241,0,0,155,155,0,1,0,1,0
13683,1543,0,0,62,62,0,1,0,1,0
2950,1694,0,0,62,62,0,1,0,1,0
2392,183,0,0,62,62,0,1,0,1,0
2674,1694,0,0,62,62,0,1,0,1,0
3100,183,10945,121,293,223,70,4,1,3,1
1152,1176,0,0,140,140,0,1,0,1,0
1339,1176,0,0,141,141,0,1,0,1,0
1352,183,4827,121,293,223,70,4,1,3,1
10198,1580,0,0,82,82,0,1,0,1,0
1236,833,0,0,152,152,0,1,0,1,0
1343,3095,0,0,142,142,0,1,0,1,0
2224,183,9071,121,293,223,70,4,0,3,1
216,2257,0,0,144,144,0,1,0,1,0
10015,1622,0,0,101,101,0,1,0,1,0
13675,482,0,0,130,130,0,1,0,1,0
1689,2571,0,0,112,112,0,1,0,1,0
7719,2187,0,0,105,105,0,1,0,1,0
11342,890,0,0,145,145,0,1,0,1,0
8701,1560,0,0,136,136,0,1,0,1,0
8316,1497,0,0,147,147,0,1,0,1,0
2137,1483,0,0,94,94,0,1,0,1,0
8327,1600,0,0,146,146,0,1,0,1,0
3680,949,0,0,110,110,0,1,0,1,0
1332,183,4771,121,293,223,70,4,1,3,1
4463,371,0,0,146,146,0,1,0,1,0
7852,1930,0,0,118,118,0,1,0,1,0
9530,183,19680,121,293,223,70,4,0,3,1
2585,1409,0,0,62,62,0,1,0,1,0
1774,183,6695,121,293,223,70,4,0,3,1
10292,1469,0,0,81,81,0,1,0,1,0
1935,1138,0,0,134,134,0,1,0,1,0
817,787,1400,47,210,182,27,2,0,1,0
2000,183,7593,121,293,223,70,4,0,3,1
1404,183,4844,121,293,223,70,4,1,3,1
1389,183,4772,121,293,223,70,4,1,3,1
11003,1624,0,0,66,66,0,1,0,1,0
276,1824,0,0,144,144,0,1,0,1,0
2312,1353,0,0,115,115,0,1,0,1,0
2646,1694,0,0,62,62,0,1,0,1,0
3047,183,10063,121,293,223,70,4,0,3,1
288,1739,0,0,143,143,0,1,0,1,0
11369,1671,0,0,63,63,0,1,0,1,0
8254,1507,0,0,146,146,0,1,0,1,0
1932,183,7437,121,293,223,70,4,0,3,1
14639,183,21752,121,293,223,70,4,0,3,1
9230,1347,0,0,117,117,0,1,0,1,0
1032,3095,0,0,141,141,0,1,0,1,0
8686,1543,0,0,133,133,0,1,0,1,0
10126,1543,0,0,80,80,0,1,0,1,0
1934,1160,0,0,139,139,0,1,0,1,0
79,1447,0,0,153,153,0,1,0,1,0
7934,1772,0,0,126,126,0,1,0,1,0
100,979,0,0,156,156,0,1,0,1,0
4948,323,0,0,146,146,0,1,0,1,0
1874,183,7276,121,293,223,70,4,0,3,1
2704,1694,0,0,62,62,0,1,0,1,0
1187,183,4377,121,293,223,70,4,1,3,1
6539,183,17447,121,293,223,70,4,0,3,1
12579,183,19676,121,293,223,70,4,0,3,1
9512,1395,0,0,106,106,0,1,0,1,0
8753,1450,0,0,145,145,0,1,0,1,0
2406,163,0,0,62,62,0,1,0,1,0
3873,723,0,0,125,125,0,1,0,1,0
1752,759,0,0,146,146,0,1,0,1,0
1944,183,6838,121,293,223,70,4,1,3,1
1267,1176,0,0,143,143,0,1,0,1,0
173,1080,0,0,150,150,0,1,0,1,0
120,1743,0,0,150,150,0,1,0,1,0
14613,1543,0,0,68,68,0,1,0,1,0
1553,183,5606,121,293,223,70,4,0,3,1
3037,1666,0,0,66,66,0,1,0,1,0
8542,1227,0,0,144,144,0,1,0,1,0
6909,2402,0,0,81,81,0,1,0,1,0
1234,834,0,0,152,152,0,1,0,1,0
3810,183,10832,121,293,223,70,4,0,3,1
1954,884,0,0,72,72,0,1,0,1,0
12508,183,22046,121,293,223,70,4,0,3,1
11535,1692,0,0,62,62,0,1,0,1,0
8279,1754,0,0,142,142,0,1,0,1,0
1590,1176,0,0,140,140,0,1,0,1,0
3003,183,10948,121,293,223,70,4,0,3,1
9643,1596,0,0,98,98,0,1,0,1,0
7973,1499,0,0,146,146,0,1,0,1,0
10788,1597,0,0,68,68,0,1,0,1,0
1887,183,7204,121,293,223,70,4,0,3,1
1451,1115,0,0,139,139,0,1,0,1,0
2400,1694,0,0,62,62,0,1,0,1,0
1567,183,5660,121,293,223,70,4,0,3,1
1972,879,0,0,62,62,0,1,0,1,0
1492,2995,0,0,133,133,0,1,0,1,0
12198,1352,0,0,81,81,0,1,0,1,0
2170,3095,0,0,157,157,0,1,0,1,0
10789,1543,0,0,62,62,0,1,0,1,0
1615,3095,0,0,150,150,0,1,0,1,0
3739,183,13171,121,293,223,70,4,0,3,1
531,2564,0,0,144,144,0,1,0,1,0
1147,298,2388,80,244,198,46,3,0,2,0
2252,1626,0,0,62,62,0,1,0,1,0
1623,1176,0,0,140,140,0,1,0,1,0
12056,986,0,0,103,103,0,1,0,1,0
2038,183,8010,121,293,223,70,4,0,3,1
963,183,3832,121,293,223,70,4,0,3,1
10412,1543,0,0,70,70,0,1,0,1,0
1933,855,0,0,65,65,0,1,0,1,0
1149,183,4643,121,293,223,70,4,0,3,1
5129,305,0,0,146,146,0,1,0,1,0
4586,183,16030,121,293,223,70,4,1,3,1
1131,290,2463,83,247,199,48,3,0,2,0
8441,1543,0,0,141,141,0,1,0,1,0
3567,1003,0,0,106,106,0,1,0,1,0
9741,1390,0,0,101,101,0,1,0,1,0
2815,1694,0,0,62,62,0,1,0,1,0
8494,2453,0,0,65,65,0,1,0,1,0
2171,3095,0,0,158,158,0,1,0,1,0
3681,183,12243,121,293,223,70,4,1,3,1
743,1962,0,0,149,149,0,1,0,1,0
1082,3095,0,0,141,141,0,1,0,1,0
304,1069,0,0,157,157,0,1,0,1,0
710,1176,0,0,154,154,0,1,0,1,0
2729,54,0,0,73,73,0,1,0,1,0
1616,1176,0,0,140,140,0,1,0,1,0
1908,183,7361,121,293,223,70,4,0,3,1
2134,573,0,0,62,62,0,1,0,1,0
1342,3095,0,0,142,142,0,1,0,1,0
476,1176,0,0,142,142,0,1,0,1,0
19208,1106,0,0,89,89,0,1,0,1,0
14186,183,23271,121,293,223,70,4,0,3,1
591,2923,0,0,140,140,0,1,0,1,0
1223,3095,0,0,142,142,0,1,0,1,0
2959,1353,0,0,118,118,0,1,0,1,0
1275,804,0,0,151,151,0,1,0,1,0
8017,1390,0,0,146,146,0,1,0,1,0
7732,2458,0,0,98,98,0,1,0,1,0
8259,1248,0,0,154,154,0,1,0,1,0
7795,2041,0,0,113,113,0,1,0,1,0
1164,2980,0,0,143,143,0,1,0,1,0
2264,183,8499,121,293,223,70,4,0,3,1
10128,1502,0,0,81,81,0,1,0,1,0
11152,1613,0,0,62,62,0,1,0,1,0
8114,1846,0,0,129,129,0,1,0,1,0
9263,1624,0,0,111,111,0,1,0,1,0
2036,183,8002,121,293,223,70,4,0,3,1
1474,1202,0,0,135,135,0,1,0,1,0
999,230,3084,104,272,212,60,3,0,2,0
93,1040,0,0,153,153,0,1,0,1,0
2013,1213,0,0,137,137,0,1,0,1,0
1436,183,5002,121,293,223,70,4,1,3,1
2228,1619,0,0,73,73,0,1,0,1,0
2984,183,11422,121,293,223,70,4,0,3,1
2124,183,8516,121,293,223,70,4,0,3,1
1457,1097,0,0,140,140,0,1,0,1,0
9056,1694,0,0,126,126,0,1,0,1,0
1342,183,4539,121,293,223,70,4,1,3,1
17788,183,24928,121,293,223,70,4,0,3,1
7104,941,0,0,146,146,0,1,0,1,0
2003,183,7816,121,293,223,70,4,0,3,1
8327,1550,0,0,146,146,0,1,0,1,0
1412,3095,0,0,148,148,0,1,0,1,0
2422,183,9275,121,293,223,70,4,0,3,1
20041,2342,0,0,104,104,0,1,0,1,0
1342,3095,0,0,142,142,0,1,0,1,0
2750,1463,0,0,62,62,0,1,0,1,0
2068,1135,0,0,62,62,0,1,0,1,0
2450,40,0,0,68,68,0,1,0,1,0
2358,96,0,0,77,77,0,1,0,1,0
3817,875,0,0,147,147,0,1,0,1,0
13276,787,0,0,114,114,0,1,0,1,0
10870,1555,0,0,62,62,0,1,0,1,0
853,2743,0,0,141,141,0,1,0,1,0
7737,2153,0,0,107,107,0,1,0,1,0
421,2491,0,0,144,144,0,1,0,1,0
21636,1328,4497,19,98,87,11,1,0,1,0
11450,1681,0,0,62,62,0,1,0,1,0
13707,445,0,0,133,133,0,1,0,1,0
879,305,3137,106,276,214,61,3,0,2,0
1347,617,0,0,149,149,0,1,0,1,0
7387,2829,0,0,73,73,0,1,0,1,0
11336,1684,0,0,67,67,0,1,0,1,0
17556,2464,0,0,145,145,0,1,0,1,0
13823,501,0,0,130,130,0,1,0,1,0
9619,1543,0,0,98,98,0,1,0,1,0
17909,2704,0,0,145,145,0,1,0,1,0
779,3095,0,0,139,139,0,1,0,1,0
1925,183,7398,121,293,223,70,4,0,3,1
780,398,2802,94,260,205,54,3,0,2,0
1730,183,6658,121,293,223,70,4,0,3,1
2363,227,0,0,62,62,0,1,0,1,0
386,1176,0,0,143,143,0,1,0,1,0
12800,1945,0,0,83,83,0,1,0,1,0
231,2390,0,0,144,144,0,1,0,1,0
9083,1647,0,0,120,120,0,1,0,1,0
7545,183,18198,121,293,223,70,4,0,3,1
25,1004,0,0,157,157,0,1,0,1,0
2100,1219,0,0,62,62,0,1,0,1,0
11560,1686,0,0,62,62,0,1,0,1,0
3602,183,12727,121,293,223,70,4,1,3,1
4082,479,0,0,141,141,0,1,0,1,0
11401,1675,0,0,63,63,0,1,0,1,0
1925,183,7393,121,293,223,70,4,0,3,1
7976,1501,0,0,146,146,0,1,0,1,0
1375,1176,0,0,140,140,0,1,0,1,0
229,2386,0,0,144,144,0,1,0,1,0
1051,2905,0,0,143,143,0,1,0,1,0
8598,1677,0,0,136,136,0,1,0,1,0
2730,183,10668,121,293,223,70,4,0,3,1
8285,1361,0,0,151,151,0,1,0,1,0
1859,183,7120,121,293,223,70,4,0,3,1
859,927,0,0,144,144,0,1,0,1,0
9858,1455,0,0,92,92,0,1,0,1,0
2907,1420,0,0,107,107,0,1,0,1,0
15463,2484,0,0,112,112,0,1,0,1,0
11094,1636,0,0,65,65,0,1,0,1,0
1495,183,5296,121,293,223,70,4,0,3,1
2260,2434,0,0,113,113,0,1,0,1,0
10180,1511,0,0,79,79,0,1,0,1,0
464,1176,0,0,146,146,0,1,0,1,0
3640,278,0,0,119,119,0,1,0,1,0
7290,3025,0,0,63,63,0,1,0,1,0
2111,183,8418,121,293,223,70,4,0,3,1
20792,1543,0,0,62,62,0,1,0,1,0
2743,1610,0,0,75,75,0,1,0,1,0
2386,1387,0,0,109,109,0,1,0,1,0
2241,1638,0,0,70,70,0,1,0,1,0
2004,183,7051,121,293,223,70,4,1,3,1
10586,1543,0,0,66,66,0,1,0,1,0
10268,1575,0,0,80,80,0,1,0,1,0
2071,183,8304,121,293,223,70,4,0,3,1
349,2565,0,0,143,143,0,1,0,1,0
10999,1624,0,0,66,66,0,1,0,1,0
1369,183,4670,121,293,223,70,4,1,3,1
2255,2663,0,0,129,129,0,1,0,1,0
1469,1134,0,0,136,136,0,1,0,1,0
1935,1139,0,0,134,134,0,1,0,1,0
1422,3095,0,0,139,139,0,1,0,1,0
2055,183,7030,121,293,223,70,4,1,3,1
305,1145,0,0,145,145,0,1,0,1,0
1747,748,0,0,146,146,0,1,0,1,0
1330,183,4479,121,293,223,70,4,0,3,1
10993,1623,0,0,66,66,0,1,0,1,0
1900,3095,0,0,150,150,0,1,0,1,0
2109,1441,0,0,101,101,0,1,0,1,0
1483,1142,0,0,131,131,0,1,0,1,0
1582,732,0,0,145,145,0,1,0,1,0
11751,1735,0,0,64,64,0,1,0,1,0
976,725,0,0,151,151,0,1,0,1,0
11499,1688,0,0,62,62,0,1,0,1,0
3159,1424,0,0,79,79,0,1,0,1,0
2848,1230,0,0,138,138,0,1,0,1,0
1581,580,0,0,148,148,0,1,0,1,0
1416,3095,0,0,139,139,0,1,0,1,0
2361,94,0,0,77,77,0,1,0,1,0
766,3095,0,0,139,139,0,1,0,1,0
10087,1694,0,0,100,100,0,1,0,1,0
2968,1388,0,0,112,112,0,1,0,1,0
827,3095,0,0,139,139,0,1,0,1,0
2751,1694,0,0,62,62,0,1,0,1,0
4578,360,0,0,146,146,0,1,0,1,0
1894,183,7239,121,293,223,70,4,0,3,1
7970,1703,0,0,130,130,0,1,0,1,0
1885,183,7197,121,293,223,70,4,0,3,1
208,2316,0,0,144,144,0,1,0,1,0
1296,1176,0,0,142,142,0,1,0,1,0
1463,183,5137,121,293,223,70,4,0,3,1
19347,1543,0,0,64,64,0,1,0,1,0
9888,1411,0,0,96,96,0,1,0,1,0
1884,183,6626,121,293,223,70,4,1,3,1
8327,1622,0,0,146,146,0,1,0,1,0
13877,473,0,0,132,132,0,1,0,1,0
17481,2413,0,0,145,145,0,1,0,1,0
1304,183,4372,121,293,223,70,4,1,3,1
1816,907,0,0,145,145,0,1,0,1,0
2117,183,8457,121,293,223,70,4,0,3,1
9923,1617,0,0,104,104,0,1,0,1,0
1598,1069,0,0,114,114,0,1,0,1,0
2813,1512,0,0,62,62,0,1,0,1,0
10082,1439,0,0,88,88,0,1,0,1,0
7414,2777,0,0,75,75,0,1,0,1,0
1663,1176,0,0,146,146,0,1,0,1,0
2728,1694,0,0,62,62,0,1,0,1,0
1790,786,0,0,113,113,0,1,0,1,0
8327,1543,0,0,146,146,0,1,0,1,0
8327,1669,0,0,146,146,0,1,0,1,0
1825,3095,0,0,153,153,0,1,0,1,0
1917,1139,0,0,143,143,0,1,0,1,0
2269,2056,0,0,87,87,0,1,0,1,0
1979,3095,0,0,154,154,0,1,0,1,0
8915,1292,0,0,130,130,0,1,0,1,0
9313,2054,0,0,68,68,0,1,0,1,0
2853,992,0,0,134,134,0,1,0,1,0
3003,1694,0,0,62,62,0,1,0,1,0
11430,1670,0,0,62,62,0,1,0,1,0
3663,903,0,0,113,113,0,1,0,1,0
366,2447,0,0,144,144,0,1,0,1,0
2237,1176,0,0,144,144,0,1,0,1,0
2164,1882,0,0,72,72,0,1,0,1,0
1409,1176,0,0,139,139,0,1,0,1,0
9283,183,19496,121,293,223,70,4,0,3,1
157,2011,0,0,148,148,0,1,0,1,0
1953,898,0,0,76,76,0,1,0,1,0
854,497,2446,82,249,202,47,3,0,2,0
2218,1782,0,0,67,67,0,1,0,1,0
866,3095,0,0,140,140,0,1,0,1,0
9991,1543,0,0,85,85,0,1,0,1,0
1042,183,4154,121,293,223,70,4,0,3,1
2205,183,8995,121,293,223,70,4,0,3,1
6365,1438,0,0,110,110,0,1,0,1,0
4755,183,16240,121,293,223,70,4,1,3,1
1135,293,2440,82,246,199,47,3,0,2,0
1638,950,0,0,124,124,0,1,0,1,0
9650,1613,0,0,101,101,0,1,0,1,0
1399,1176,0,0,139,139,0,1,0,1,0
10529,1559,0,0,71,71,0,1,0,1,0
1879,183,7167,121,293,223,70,4,0,3,1
3991,500,0,0,146,146,0,1,0,1,0
8269,1292,0,0,153,153,0,1,0,1,0
1916,1138,0,0,143,143,0,1,0,1,0
12145,1048,0,0,93,93,0,1,0,1,0
2670,1374,0,0,114,114,0,1,0,1,0
221,2312,0,0,145,145,0,1,0,1,0
257,1058,0,0,157,157,0,1,0,1,0
4935,183,16463,121,293,223,70,4,1,3,1
2124,1463,0,0,98,98,0,1,0,1,0
1235,1176,0,0,144,144,0,1,0,1,0
10810,1543,0,0,62,62,0,1,0,1,0
8992,1644,0,0,121,121,0,1,0,1,0
4950,183,16482,121,293,223,70,4,1,3,1
12288,1305,0,0,84,84,0,1,0,1,0
3252,965,0,0,147,147,0,1,0,1,0
706,3094,0,0,139,139,0,1,0,1,0
20445,2148,0,0,94,94,0,1,0,1,0
1170,668,0,0,150,150,0,1,0,1,0
2742,1317,0,0,124,124,0,1,0,1,0
1302,183,5081,121,293,223,70,4,0,3,1
2430,1694,0,0,62,62,0,1,0,1,0
870,1100,0,0,155,155,0,1,0,1,0
2908,1401,0,0,110,110,0,1,0,1,0
10950,1572,0,0,62,62,0,1,0,1,0
3536,183,12146,121,293,223,70,4,0,3,1
2969,1393,0,0,111,111,0,1,0,1,0
1799,1176,0,0,141,141,0,1,0,1,0
63,1025,0,0,155,155,0,1,0,1,0
1140,183,4604,121,293,223,70,4,0,3,1
2943,1694,0,0,62,62,0,1,0,1,0
10975,1621,0,0,66,66,0,1,0,1,0
1910,183,7315,121,293,223,70,4,0,3,1
10505,1543,0,0,68,68,0,1,0,1,0
8302,1435,0,0,149,149,0,1,0,1,0
618,1176,0,0,151,151,0,1,0,1,0
687,1157,0,0,157,157,0,1,0,1,0
2166,183,8456,121,293,223,70,4,0,3,1
9299,1327,0,0,117,117,0,1,0,1,0
1566,3095,0,0,150,150,0,1,0,1,0
2193,3095,0,0,158,158,0,1,0,1,0
16843,1978,0,0,145,145,0,1,0,1,0
1886,1176,0,0,142,142,0,1,0,1,0
760,1418,0,0,154,154,0,1,0,1,0
1118,919,0,0,153,153,0,1,0,1,0
4376,183,14713,121,293,223,70,4,0,3,1
3115,183,10896,121,293,223,70,4,0,3,1
1855,905,0,0,76,76,0,1,0,1,0
2494,1694,0,0,62,62,0,1,0,1,0
4695,348,0,0,146,146,0,1,0,1,0
8121,1411,0,0,145,145,0,1,0,1,0
17074,1611,0,0,62,62,0,1,0,1,0
1314,374,1597,53,212,181,31,2,0,1,0
1328,183,4469,121,293,223,70,4,1,3,1
315,1071,0,0,157,157,0,1,0,1,0
8327,1620,0,0,146,146,0,1,0,1,0
13992,183,21100,121,293,223,70,4,0,3,1
8274,1371,0,0,152,152,0,1,0,1,0
1902,783,0,0,77,77,0,1,0,1,0
1501,183,5314,121,293,223,70,4,0,3,1
17541,183,25722,121,293,223,70,4,0,3,1
2019,1000,0,0,130,130,0,1,0,1,0
10315,1543,0,0,73,73,0,1,0,1,0
7482,2780,0,0,78,78,0,1,0,1,0
8327,1583,0,0,146,146,0,1,0,1,0
1935,1140,0,0,134,134,0,1,0,1,0
14764,183,21879,121,293,223,70,4,0,3,1
14066,374,0,0,137,137,0,1,0,1,0
8065,1519,0,0,139,139,0,1,0,1,0
2533,1694,0,0,62,62,0,1,0,1,0
7896,2158,0,0,111,111,0,1,0,1,0
8490,183,19111,121,293,223,70,4,0,3,1
423,1892,0,0,149,149,0,1,0,1,0
2618,183,9234,121,293,223,70,4,1,3,1
8298,1730,0,0,143,143,0,1,0,1,0
7998,2117,0,0,119,119,0,1,0,1,0
2068,3095,0,0,154,154,0,1,0,1,0
553,2867,0,0,140,140,0,1,0,1,0
886,245,3353,113,284,218,65,3,0,2,0
2247,183,9207,121,293,223,70,4,0,3,1
9331,1694,0,0,119,119,0,1,0,1,0
5471,271,0,0,146,146,0,1,0,1,0
1239,3095,0,0,142,142,0,1,0,1,0
1218,846,0,0,152,152,0,1,0,1,0
1755,768,0,0,146,146,0,1,0,1,0
1383,406,1271,42,199,174,24,2,0,1,0
2259,2460,0,0,115,115,0,1,0,1,0
9328,1633,0,0,112,112,0,1,0,1,0
1640,183,6021,121,293,223,70,4,0,3,1
278,1062,0,0,157,157,0,1,0,1,0
6983,956,0,0,146,146,0,1,0,1,0
3525,183,11745,121,293,223,70,4,1,3,1
521,1176,0,0,142,142,0,1,0,1,0
2991,1482,0,0,97,97,0,1,0,1,0
1211,183,4441,121,293,223,70,4,1,3,1
9928,1694,0,0,104,104,0,1,0,1,0
306,1146,0,0,145,145,0,1,0,1,0
915,742,0,0,152,152,0,1,0,1,0
8158,1339,0,0,148,148,0,1,0,1,0
764,1289,0,0,155,155,0,1,0,1,0
1183,2992,0,0,143,143,0,1,0,1,0
17292,2284,0,0,145,145,0,1,0,1,0
2297,438,0,0,92,92,0,1,0,1,0
15887,1327,0,0,145,145,0,1,0,1,0
1545,841,0,0,143,143,0,1,0,1,0
2830,927,0,0,129,129,0,1,0,1,0
973,1025,0,0,154,154,0,1,0,1,0
8134,1941,0,0,130,130,0,1,0,1,0
14697,515,0,0,145,145,0,1,0,1,0
19311,2695,0,0,123,123,0,1,0,1,0
5872,566,0,0,136,136,0,1,0,1,0
1069,183,3917,121,293,223,70,4,1,3,1
2028,1176,0,0,143,143,0,1,0,1,0
1876,3095,0,0,152,152,0,1,0,1,0
1721,599,0,0,128,128,0,1,0,1,0
13354,747,0,0,116,116,0,1,0,1,0
12866,721,0,0,118,118,0,1,0,1,0
5130,305,0,0,146,146,0,1,0,1,0
10559,1507,0,0,71,71,0,1,0,1,0
11378,1658,0,0,68,68,0,1,0,1,0
11623,1543,0,0,70,70,0,1,0,1,0
10438,1552,0,0,71,71,0,1,0,1,0
2901,1620,0,0,74,74,0,1,0,1,0
8239,1183,0,0,156,156,0,1,0,1,0
944,183,3714,121,293,223,70,4,1,3,1
2359,234,0,0,62,62,0,1,0,1,0
968,183,3722,121,293,223,70,4,1,3,1
1968,183,7637,121,293,223,70,4,0,3,1
7464,2803,0,0,77,77,0,1,0,1,0
2778,1694,0,0,62,62,0,1,0,1,0
9270,1543,0,0,111,111,0,1,0,1,0
9344,1632,0,0,111,111,0,1,0,1,0
7753,2814,0,0,63,63,0,1,0,1,0
2272,365,0,0,62,62,0,1,0,1,0
9989,1543,0,0,85,85,0,1,0,1,0
9597,1543,0,0,103,103,0,1,0,1,0
14244,271,0,0,143,143,0,1,0,1,0
21305,1733,0,0,72,72,0,1,0,1,0
1565,554,0,0,148,148,0,1,0,1,0
1587,3095,0,0,142,142,0,1,0,1,0
776,1176,0,0,141,141,0,1,0,1,0
1464,1176,0,0,139,139,0,1,0,1,0
2378,1694,0,0,62,62,0,1,0,1,0
10712,1543,0,0,64,64,0,1,0,1,0
6808,654,0,0,150,150,0,1,0,1,0
418,1095,0,0,157,157,0,1,0,1,0
2494,183,8572,121,293,223,70,4,0,3,1
1838,3095,0,0,149,149,0,1,0,1,0
1732,713,0,0,146,146,0,1,0,1,0
11187,1620,0,0,62,62,0,1,0,1,0
2219,183,8240,121,293,223,70,4,0,3,1
12162,1371,0,0,80,80,0,1,0,1,0
8537,1543,0,0,138,138,0,1,0,1,0
2130,183,8530,121,293,223,70,4,0,3,1
16528,1543,0,0,66,66,0,1,0,1,0
873,348,2982,100,270,211,58,3,0,2,0
1245,826,0,0,152,152,0,1,0,1,0
1683,183,6211,121,293,223,70,4,0,3,1
9988,1543,0,0,85,85,0,1,0,1,0
2041,183,8021,121,293,223,70,4,0,3,1
3085,183,10808,121,293,223,70,4,0,3,1
4863,183,16373,121,293,223,70,4,1,3,1
2973,1694,0,0,62,62,0,1,0,1,0
1751,758,0,0,146,146,0,1,0,1,0
637,1176,0,0,152,152,0,1,0,1,0
8935,1657,0,0,125,125,0,1,0,1,0
1565,592,0,0,148,148,0,1,0,1,0
2150,183,8645,121,293,223,70,4,0,3,1
1420,183,4926,121,293,223,70,4,1,3,1
3012,1566,0,0,83,83,0,1,0,1,0
12721,835,0,0,107,107,0,1,0,1,0
6781,2176,0,0,88,88,0,1,0,1,0
1128,183,4441,121,293,223,70,4,0,3,1
3893,700,0,0,126,126,0,1,0,1,0
1860,1008,0,0,144,144,0,1,0,1,0
19159,2768,0,0,127,127,0,1,0,1,0
8310,1594,0,0,148,148,0,1,0,1,0
1754,183,6555,121,293,223,70,4,0,3,1
905,183,3600,121,293,223,70,4,1,3,1
7856,2216,0,0,108,108,0,1,0,1,0
2313,1353,0,0,115,115,0,1,0,1,0
2329,1694,0,0,62,62,0,1,0,1,0
2894,1193,0,0,145,145,0,1,0,1,0
1771,1176,0,0,141,141,0,1,0,1,0
1697,2560,0,0,112,112,0,1,0,1,0
3630,275,0,0,119,119,0,1,0,1,0
1961,183,7591,121,293,223,70,4,0,3,1
1955,342,0,0,117,117,0,1,0,1,0
2177,682,0,0,108,108,0,1,0,1,0
2481,49,0,0,62,62,0,1,0,1,0
14827,604,0,0,145,145,0,1,0,1,0
1631,183,6014,121,293,223,70,4,0,3,1
325,2529,0,0,143,143,0,1,0,1,0
2933,1244,0,0,136,136,0,1,0,1,0
2132,576,0,0,62,62,0,1,0,1,0
476,2753,0,0,141,141,0,1,0,1,0
2259,2461,0,0,115,115,0,1,0,1,0
3683,183,13205,121,293,223,70,4,0,3,1
21626,1294,5208,22,104,91,12,1,0,1,0
2304,424,0,0,91,91,0,1,0,1,0
1656,183,6074,121,293,223,70,4,0,3,1
949,183,3728,121,293,223,70,4,1,3,1
9716,1543,0,0,95,95,0,1,0,1,0
1708,1176,0,0,141,141,0,1,0,1,0
21040,1861,0,0,79,79,0,1,0,1,0
3089,183,11459,121,293,223,70,4,0,3,1
1771,1176,0,0,141,141,0,1,0,1,0
2961,1359,0,0,117,117,0,1,0,1,0
564,2883,0,0,140,140,0,1,0,1,0
8933,1543,0,0,123,123,0,1,0,1,0
10444,1558,0,0,72,72,0,1,0,1,0
2316,183,9440,121,293,223,70,4,0,3,1
1633,538,0,0,147,147,0,1,0,1,0
1669,1321,0,0,117,117,0,1,0,1,0
2907,1448,0,0,102,102,0,1,0,1,0
8258,1243,0,0,154,154,0,1,0,1,0
2523,1451,0,0,99,99,0,1,0,1,0
1733,3095,0,0,146,146,0,1,0,1,0
1296,3066,0,0,143,143,0,1,0,1,0
12708,1085,0,0,96,96,0,1,0,1,0
2125,3095,0,0,157,157,0,1,0,1,0
2041,183,8027,121,293,223,70,4,0,3,1
2961,1694,0,0,62,62,0,1,0,1,0
1531,616,0,0,149,149,0,1,0,1,0
282,926,0,0,155,155,0,1,0,1,0
12364,967,0,0,98,98,0,1,0,1,0
4218,183,15014,121,293,223,70,4,0,3,1
8290,1381,0,0,150,150,0,1,0,1,0
1505,183,5354,121,293,223,70,4,0,3,1
2081,3095,0,0,154,154,0,1,0,1,0
6528,1728,0,0,101,101,0,1,0,1,0
1368,3095,0,0,141,141,0,1,0,1,0
1479,183,5224,121,293,223,70,4,0,3,1
1331,183,4484,121,293,223,70,4,1,3,1
2346,1694,0,0,62,62,0,1,0,1,0
829,698,1722,58,222,188,33,2,0,1,0
3433,183,12506,121,293,223,70,4,0,3,1
2906,183,10977,121,293,223,70,4,0,3,1
19989,2368,0,0,106,106,0,1,0,1,0
2718,1336,0,0,121,121,0,1,0,1,0
3807,800,0,0,120,120,0,1,0,1,0
1333,183,4495,121,293,223,70,4,1,3,1
2451,94,0,0,62,62,0,1,0,1,0
1222,1176,0,0,144,144,0,1,0,1,0
7322,3025,0,0,62,62,0,1,0,1,0
1881,3095,0,0,150,150,0,1,0,1,0
2073,1147,0,0,62,62,0,1,0,1,0
2345,1639,0,0,71,71,0,1,0,1,0
963,183,3713,121,293,223,70,4,1,3,1
1488,3095,0,0,145,145,0,1,0,1,0
1889,1176,0,0,142,142,0,1,0,1,0
2016,3095,0,0,153,153,0,1,0,1,0
10806,1628,0,0,76,76,0,1,0,1,0
1983,908,0,0,62,62,0,1,0,1,0
17981,2753,0,0,145,145,0,1,0,1,0
1309,183,4382,121,293,223,70,4,1,3,1
409,1176,0,0,144,144,0,1,0,1,0
2519,2507,0,0,118,118,0,1,0,1,0
1951,1138,0,0,140,140,0,1,0,1,0
2024,183,8064,121,293,223,70,4,0,3,1
18296,2968,0,0,145,145,0,1,0,1,0
18896,1584,0,0,62,62,0,1,0,1,0
1778,2520,0,0,107,107,0,1,0,1,0
8326,1690,0,0,146,146,0,1,0,1,0
2276,358,0,0,62,62,0,1,0,1,0
2033,3095,0,0,153,153,0,1,0,1,0
12423,1234,0,0,88,88,0,1,0,1,0
2718,1335,0,0,121,121,0,1,0,1,0
1944,183,7544,121,293,223,70,4,0,3,1
1313,3095,0,0,139,139,0,1,0,1,0
9501,1543,0,0,103,103,0,1,0,1,0
1606,1176,0,0,140,140,0,1,0,1,0
4901,183,16421,121,293,223,70,4,1,3,1
2231,1665,0,0,66,66,0,1,0,1,0
1690,183,6318,121,293,223,70,4,0,3,1
2404,1245,0,0,62,62,0,1,0,1,0
65,1013,0,0,157,157,0,1,0,1,0
9021,1310,0,0,125,125,0,1,0,1,0
8252,1236,0,0,155,155,0,1,0,1,0
8615,1676,0,0,136,136,0,1,0,1,0
12357,1543,0,0,70,70,0,1,0,1,0
2038,183,8003,121,293,223,70,4,0,3,1
10598,1694,0,0,86,86,0,1,0,1,0
384,1176,0,0,143,143,0,1,0,1,0
13131,2014,0,0,80,80,0,1,0,1,0
3744,183,13409,121,293,223,70,4,0,3,1
8263,1267,0,0,154,154,0,1,0,1,0
15624,2517,0,0,110,110,0,1,0,1,0
2899,1683,0,0,63,63,0,1,0,1,0
965,3095,0,0,139,139,0,1,0,1,0
427,2495,0,0,144,144,0,1,0,1,0
1425,1176,0,0,139,139,0,1,0,1,0
9683,1593,0,0,96,96,0,1,0,1,0
4630,183,16084,121,293,223,70,4,1,3,1
1751,183,6582,121,293,223,70,4,0,3,1
10308,1543,0,0,73,73,0,1,0,1,0
13140,183,19836,121,293,223,70,4,0,3,1
297,1067,0,0,157,157,0,1,0,1,0
953,183,3823,121,293,223,70,4,0,3,1
1655,2724,0,0,118,118,0,1,0,1,0
6100,448,0,0,146,146,0,1,0,1,0
669,1023,0,0,144,144,0,1,0,1,0
4023,531,0,0,137,137,0,1,0,1,0
2621,1694,0,0,62,62,0,1,0,1,0
61,1024,0,0,155,155,0,1,0,1,0
8322,1663,0,0,146,146,0,1,0,1,0
7138,774,0,0,152,152,0,1,0,1,0
1406,183,4848,121,293,223,70,4,0,3,1
750,3095,0,0,139,139,0,1,0,1,0
1208,3095,0,0,142,142,0,1,0,1,0
9897,1616,0,0,105,105,0,1,0,1,0
1830,921,0,0,80,80,0,1,0,1,0
12982,683,0,0,120,120,0,1,0,1,0
10948,1694,0,0,77,77,0,1,0,1,0
1797,864,0,0,145,145,0,1,0,1,0
1914,1471,0,0,95,95,0,1,0,1,0
336,1161,0,0,144,144,0,1,0,1,0
1917,183,7352,121,293,223,70,4,0,3,1
666,814,0,0,153,153,0,1,0,1,0
2030,525,0,0,96,96,0,1,0,1,0
5360,282,0,0,146,146,0,1,0,1,0
1742,183,6495,121,293,223,70,4,0,3,1
2358,96,0,0,77,77,0,1,0,1,0
2048,1082,0,0,62,62,0,1,0,1,0
1329,183,4763,121,293,223,70,4,1,3,1
9915,1415,0,0,95,95,0,1,0,1,0
8319,1649,0,0,146,146,0,1,0,1,0
2485,2580,0,0,123,123,0,1,0,1,0
1873,183,7187,121,293,223,70,4,0,3,1
982,183,3748,121,293,223,70,4,1,3,1
2634,1552,0,0,84,84,0,1,0,1,0
1975,813,0,0,62,62,0,1,0,1,0
10723,1655,0,0,83,83,0,1,0,1,0
400,1176,0,0,144,144,0,1,0,1,0
1400,3095,0,0,140,140,0,1,0,1,0
1557,183,5591,121,293,223,70,4,0,3,1
2215,3095,0,0,158,158,0,1,0,1,0
1376,667,0,0,146,146,0,1,0,1,0
2092,1415,0,0,105,105,0,1,0,1,0
5323,372,0,0,146,146,0,1,0,1,0
21000,1543,0,0,62,62,0,1,0,1,0
413,2486,0,0,144,144,0,1,0,1,0
9692,1543,0,0,96,96,0,1,0,1,0
8257,1241,0,0,155,155,0,1,0,1,0
1870,3095,0,0,149,149,0,1,0,1,0
5332,284,0,0,146,146,0,1,0,1,0
8301,1431,0,0,149,149,0,1,0,1,0
1312,183,4390,121,293,223,70,4,0,3,1
2906,1461,0,0,100,100,0,1,0,1,0
2239,183,9191,121,293,223,70,4,0,3,1
2235,564,0,0,100,100,0,1,0,1,0
3021,1601,0,0,77,77,0,1,0,1,0
3537,1117,0,0,99,99,0,1,0,1,0
11117,1606,0,0,62,62,0,1,0,1,0
1045,972,0,0,154,154,0,1,0,1,0
12947,960,0,0,104,104,0,1,0,1,0
2559,1386,0,0,62,62,0,1,0,1,0
2090,183,8326,121,293,223,70,4,0,3,1
4396,183,15607,121,293,223,70,4,0,3,1
1264,3095,0,0,139,139,0,1,0,1,0
2766,740,0,0,116,116,0,1,0,1,0
1148,3095,0,0,141,141,0,1,0,1,0
748,1215,0,0,156,156,0,1,0,1,0
4487,183,15877,121,293,223,70,4,0,3,1
11167,1676,0,0,71,71,0,1,0,1,0
253,2246,0,0,146,146,0,1,0,1,0
2304,425,0,0,91,91,0,1,0,1,0
2722,52,0,0,72,72,0,1,0,1,0
1159,183,4092,121,293,223,70,4,1,3,1
1722,1176,0,0,141,141,0,1,0,1,0
1307,183,4703,121,293,223,70,4,1,3,1
465,1106,0,0,157,157,0,1,0,1,0
11247,1655,0,0,64,64,0,1,0,1,0
8497,1683,0,0,140,140,0,1,0,1,0
709,2681,0,0,144,144,0,1,0,1,0
9396,1614,0,0,107,107,0,1,0,1,0
8248,1211,0,0,156,156,0,1,0,1,0
636,1145,0,0,157,157,0,1,0,1,0
9622,1262,0,0,145,145,0,1,0,1,0
10724,1543,0,0,63,63,0,1,0,1,0
2087,3095,0,0,156,156,0,1,0,1,0
4015,557,0,0,135,135,0,1,0,1,0
345,2558,0,0,143,143,0,1,0,1,0
280,2190,0,0,146,146,0,1,0,1,0
20406,2167,0,0,95,95,0,1,0,1,0
7106,2751,0,0,70,70,0,1,0,1,0
5217,183,16720,121,293,223,70,4,0,3,1
12915,763,0,0,111,111,0,1,0,1,0
8327,1677,0,0,146,146,0,1,0,1,0
2065,1375,0,0,111,111,0,1,0,1,0
1528,3095,0,0,141,141,0,1,0,1,0
19886,2417,0,0,108,108,0,1,0,1,0
1734,478,0,0,139,139,0,1,0,1,0
10650,1543,0,0,65,65,0,1,0,1,0
1039,183,3859,121,293,223,70,4,1,3,1
635,1145,0,0,157,157,0,1,0,1,0
2009,1217,0,0,136,136,0,1,0,1,0
1658,183,6117,121,293,223,70,4,0,3,1
1247,3095,0,0,142,142,0,1,0,1,0
13740,1543,0,0,69,69,0,1,0,1,0
8297,1185,0,0,154,154,0,1,0,1,0
3541,183,12650,121,293,223,70,4,0,3,1
1819,928,0,0,82,82,0,1,0,1,0
2005,856,0,0,66,66,0,1,0,1,0
232,2391,0,0,144,144,0,1,0,1,0
2799,834,0,0,123,123,0,1,0,1,0
5010,183,16556,121,293,223,70,4,1,3,1
2429,1407,0,0,106,106,0,1,0,1,0
2120,797,0,0,116,116,0,1,0,1,0
13984,417,0,0,135,135,0,1,0,1,0
2632,1694,0,0,62,62,0,1,0,1,0
16684,183,23815,121,293,223,70,4,0,3,1
2013,2131,0,0,86,86,0,1,0,1,0
1501,968,0,0,141,141,0,1,0,1,0
13287,183,22485,121,293,223,70,4,0,3,1
9062,1543,0,0,119,119,0,1,0,1,0
2196,1056,0,0,62,62,0,1,0,1,0
588,2919,0,0,140,140,0,1,0,1,0
1408,183,4977,121,293,223,70,4,1,3,1
15801,2553,0,0,112,112,0,1,0,1,0
2838,1694,0,0,62,62,0,1,0,1,0
21634,1574,0,0,63,63,0,1,0,1,0
3605,945,0,0,147,147,0,1,0,1,0
2083,183,8256,121,293,223,70,4,0,3,1
10498,1543,0,0,68,68,0,1,0,1,0
532,1121,0,0,157,157,0,1,0,1,0
2168,183,8766,121,293,223,70,4,0,3,1
1377,3095,0,0,141,141,0,1,0,1,0
15841,2590,0,0,121,121,0,1,0,1,0
1334,183,4497,121,293,223,70,4,1,3,1
1926,3095,0,0,153,153,0,1,0,1,0
1542,608,0,0,149,149,0,1,0,1,0
1355,3095,0,0,142,142,0,1,0,1,0
9369,1630,0,0,110,110,0,1,0,1,0
2982,1445,0,0,103,103,0,1,0,1,0
2005,183,7845,121,293,223,70,4,0,3,1
11588,1671,0,0,63,63,0,1,0,1,0
2902,1694,0,0,62,62,0,1,0,1,0
1621,183,5932,121,293,223,70,4,0,3,1
1714,2535,0,0,110,110,0,1,0,1,0
1660,2717,0,0,118,118,0,1,0,1,0
1533,183,5473,121,293,223,70,4,0,3,1
2115,1259,0,0,62,62,0,1,0,1,0
13598,619,0,0,123,123,0,1,0,1,0
8327,1626,0,0,146,146,0,1,0,1,0
1380,253,3499,96,263,207,55,3,0,2,0
771,3095,0,0,139,139,0,1,0,1,0
2171,183,8768,121,293,223,70,4,0,3,1
1567,183,5646,121,293,223,70,4,0,3,1
956,2843,0,0,143,143,0,1,0,1,0
2244,1643,0,0,69,69,0,1,0,1,0
7634,2533,0,0,90,90,0,1,0,1,0
1253,3095,0,0,139,139,0,1,0,1,0
7565,2673,0,0,85,85,0,1,0,1,0
9566,1618,0,0,104,104,0,1,0,1,0
2185,1847,0,0,70,70,0,1,0,1,0
1059,1176,0,0,149,149,0,1,0,1,0
2121,183,8559,121,293,223,70,4,0,3,1
2802,1694,0,0,62,62,0,1,0,1,0
249,2376,0,0,144,144,0,1,0,1,0
2303,1694,0,0,62,62,0,1,0,1,0
1921,183,7374,121,293,223,70,4,0,3,1
8264,1512,0,0,146,146,0,1,0,1,0
7387,2830,0,0,73,73,0,1,0,1,0
265,1125,0,0,147,147,0,1,0,1,0
1958,1176,0,0,143,143,0,1,0,1,0
1152,1176,0,0,146,146,0,1,0,1,0
15890,2571,0,0,113,113,0,1,0,1,0
19410,2647,0,0,121,121,0,1,0,1,0
2098,183,8437,121,293,223,70,4,0,3,1
1323,194,4243,117,288,220,67,3,0,2,0
1748,751,0,0,146,146,0,1,0,1,0
1126,289,2483,83,248,200,48,3,0,2,0
2060,183,7251,121,293,223,70,4,1,3,1
231,2292,0,0,145,145,0,1,0,1,0
8286,1366,0,0,151,151,0,1,0,1,0
21490,844,14615,62,180,144,35,2,0,2,0
6470,630,0,0,146,146,0,1,0,1,0
3986,183,14209,121,293,223,70,4,0,3,1
2095,1207,0,0,62,62,0,1,0,1,0
1821,919,0,0,144,144,0,1,0,1,0
3601,1041,0,0,104,104,0,1,0,1,0
17669,2930,0,0,135,135,0,1,0,1,0
2918,1187,0,0,146,146,0,1,0,1,0
302,2494,0,0,143,143,0,1,0,1,0
19958,183,27487,121,293,223,70,4,0,3,1
2152,183,8659,121,293,223,70,4,0,3,1
5694,249,0,0,146,146,0,1,0,1,0
2941,1277,0,0,131,131,0,1,0,1,0
1579,495,343,11,161,155,6,1,0,1,0
447,1176,0,0,145,145,0,1,0,1,0
32,1110,0,0,156,156,0,1,0,1,0
2229,430,0,0,62,62,0,1,0,1,0
1698,576,0,0,134,134,0,1,0,1,0
1894,1087,0,0,143,143,0,1,0,1,0
1798,677,0,0,106,106,0,1,0,1,0
11329,1666,0,0,63,63,0,1,0,1,0
2511,1176,0,0,145,145,0,1,0,1,0
1380,3095,0,0,141,141,0,1,0,1,0
8923,1543,0,0,124,124,0,1,0,1,0
1121,183,4018,121,293,223,70,4,1,3,1
21355,1709,0,0,70,70,0,1,0,1,0
1358,3095,0,0,142,142,0,1,0,1,0
11527,183,21329,121,293,223,70,4,0,3,1
357,1171,0,0,143,143,0,1,0,1,0
7596,2891,0,0,63,63,0,1,0,1,0
1265,3095,0,0,146,146,0,1,0,1,0
14691,511,0,0,145,145,0,1,0,1,0
3042,1694,0,0,62,62,0,1,0,1,0
20528,183,27691,121,293,223,70,4,0,3,1
160,1074,0,0,151,151,0,1,0,1,0
12580,1543,0,0,70,70,0,1,0,1,0
430,883,0,0,154,154,0,1,0,1,0
1732,611,0,0,125,125,0,1,0,1,0
4783,183,15924,121,293,223,70,4,0,3,1
2521,1176,0,0,145,145,0,1,0,1,0
1441,1176,0,0,139,139,0,1,0,1,0
2000,183,7938,121,293,223,70,4,0,3,1
1623,183,5918,121,293,223,70,4,0,3,1
853,510,2398,81,248,201,46,3,0,2,0
1231,3024,0,0,143,143,0,1,0,1,0
4489,183,15882,121,293,223,70,4,0,3,1
378,1176,0,0,143,143,0,1,0,1,0
289,1730,0,0,143,143,0,1,0,1,0
1650,533,0,0,147,147,0,1,0,1,0
1369,3095,0,0,141,141,0,1,0,1,0
11023,1627,0,0,66,66,0,1,0,1,0
988,3095,0,0,140,140,0,1,0,1,0
8302,1434,0,0,149,149,0,1,0,1,0
3034,1654,0,0,68,68,0,1,0,1,0
1374,1176,0,0,140,140,0,1,0,1,0
2059,493,0,0,94,94,0,1,0,1,0
50,1010,0,0,157,157,0,1,0,1,0
2520,183,10046,121,293,223,70,4,0,3,1
1725,484,0,0,140,140,0,1,0,1,0
3100,1627,0,0,66,66,0,1,0,1,0
9570,1543,0,0,103,103,0,1,0,1,0
14065,375,0,0,137,137,0,1,0,1,0
3031,183,10700,121,293,223,70,4,1,3,1
8375,1691,0,0,144,144,0,1,0,1,0
362,1202,0,0,143,143,0,1,0,1,0
966,183,3844,121,293,223,70,4,0,3,1
1307,3095,0,0,139,139,0,1,0,1,0
1892,183,7283,121,293,223,70,4,0,3,1
9566,1543,0,0,104,104,0,1,0,1,0
1351,3095,0,0,142,142,0,1,0,1,0
491,2775,0,0,141,141,0,1,0,1,0
2155,1295,0,0,124,124,0,1,0,1,0
8327,1640,0,0,146,146,0,1,0,1,0
2783,1176,0,0,147,147,0,1,0,1,0
9272,1623,0,0,111,111,0,1,0,1,0
2599,1694,0,0,62,62,0,1,0,1,0
1248,183,4541,121,293,223,70,4,1,3,1
2031,183,7965,121,293,223,70,4,0,3,1
2662,1381,0,0,113,113,0,1,0,1,0
2916,183,10291,121,293,223,70,4,1,3,1
1997,183,7914,121,293,223,70,4,0,3,1
2144,558,0,0,62,62,0,1,0,1,0
1013,1176,0,0,150,150,0,1,0,1,0
20099,2315,0,0,103,103,0,1,0,1,0
1766,458,0,0,136,136,0,1,0,1,0
1969,1102,0,0,137,137,0,1,0,1,0
1727,987,0,0,95,95,0,1,0,1,0
1053,3095,0,0,141,141,0,1,0,1,0
1938,852,0,0,64,64,0,1,0,1,0
2200,183,8933,121,293,223,70,4,0,3,1
2910,1339,0,0,120,120,0,1,0,1,0
10777,1596,0,0,68,68,0,1,0,1,0
1060,3095,0,0,139,139,0,1,0,1,0
1480,183,5225,121,293,223,70,4,0,3,1
1105,3095,0,0,139,139,0,1,0,1,0
8348,1543,0,0,145,145,0,1,0,1,0
7420,2861,0,0,73,73,0,1,0,1,0
9489,1392,0,0,106,106,0,1,0,1,0
2125,1464,0,0,97,97,0,1,0,1,0
1642,183,6336,121,293,223,70,4,0,3,1
2039,1056,0,0,62,62,0,1,0,1,0
15691,2530,0,0,114,114,0,1,0,1,0
1581,183,5711,121,293,223,70,4,0,3,1
9982,1543,0,0,85,85,0,1,0,1,0
8237,1186,0,0,156,156,0,1,0,1,0
1360,3095,0,0,142,142,0,1,0,1,0
1983,862,0,0,62,62,0,1,0,1,0
1174,183,4122,121,293,223,70,4,1,3,1
1382,183,4735,121,293,223,70,4,1,3,1
4382,183,14727,121,293,223,70,4,0,3,1
2992,1485,0,0,96,96,0,1,0,1,0
7685,2461,0,0,94,94,0,1,0,1,0
16887,2790,0,0,130,130,0,1,0,1,0
2913,1248,0,0,135,135,0,1,0,1,0
2383,265,0,0,80,80,0,1,0,1,0
1473,3025,0,0,135,135,0,1,0,1,0
2876,1161,0,0,144,144,0,1,0,1,0
326,2423,0,0,144,144,0,1,0,1,0
2147,1498,0,0,92,92,0,1,0,1,0
1949,959,0,0,90,90,0,1,0,1,0
2256,521,0,0,97,97,0,1,0,1,0
491,1176,0,0,147,147,0,1,0,1,0
1799,867,0,0,145,145,0,1,0,1,0
1771,1176,0,0,141,141,0,1,0,1,0
1958,1124,0,0,139,139,0,1,0,1,0
9723,1543,0,0,95,95,0,1,0,1,0
4723,183,16200,121,293,223,70,4,1,3,1
1690,3095,0,0,149,149,0,1,0,1,0
1643,524,42,1,149,148,0,1,0,1,0
1611,183,5909,121,293,223,70,4,0,3,1
1980,183,7709,121,293,223,70,4,0,3,1
19380,2661,0,0,121,121,0,1,0,1,0
4782,183,16135,121,293,223,70,4,0,3,1
745,1170,0,0,157,157,0,1,0,1,0
715,1285,0,0,155,155,0,1,0,1,0
8833,1433,0,0,145,145,0,1,0,1,0
2118,597,0,0,62,62,0,1,0,1,0
2144,3095,0,0,157,157,0,1,0,1,0
1873,183,7190,121,293,223,70,4,0,3,1
8397,1689,0,0,143,143,0,1,0,1,0
688,2643,0,0,142,142,0,1,0,1,0
720,2670,0,0,142,142,0,1,0,1,0
678,3052,0,0,139,139,0,1,0,1,0
15646,1543,0,0,62,62,0,1,0,1,0
13500,670,0,0,120,120,0,1,0,1,0
3746,183,13505,121,293,223,70,4,0,3,1
2648,1694,0,0,62,62,0,1,0,1,0
884,3095,0,0,139,139,0,1,0,1,0
17339,2864,0,0,131,131,0,1,0,1,0
1396,1176,0,0,139,139,0,1,0,1,0
2961,1655,0,0,68,68,0,1,0,1,0
1866,3095,0,0,149,149,0,1,0,1,0
1807,183,6857,121,293,223,70,4,0,3,1
1787,667,0,0,109,109,0,1,0,1,0
3142,183,11889,121,293,223,70,4,0,3,1
2679,1407,0,0,62,62,0,1,0,1,0
12204,183,21676,121,293,223,70,4,0,3,1
1790,669,0,0,109,109,0,1,0,1,0
5142,303,0,0,146,146,0,1,0,1,0
1978,183,7683,121,293,223,70,4,0,3,1
2626,1694,0,0,62,62,0,1,0,1,0
4560,183,15997,121,293,223,70,4,1,3,1
2714,1105,0,0,129,129,0,1,0,1,0
712,2908,0,0,140,140,0,1,0,1,0
8923,1543,0,0,124,124,0,1,0,1,0
17523,2901,0,0,133,133,0,1,0,1,0
2989,1694,0,0,62,62,0,1,0,1,0
631,2983,0,0,139,139,0,1,0,1,0
496,2782,0,0,141,141,0,1,0,1,0
1286,3095,0,0,139,139,0,1,0,1,0
984,183,3753,121,293,223,70,4,1,3,1
15795,183,22645,121,293,223,70,4,0,3,1
1671,548,0,0,142,142,0,1,0,1,0
19573,2568,0,0,116,116,0,1,0,1,0
175,2145,0,0,146,146,0,1,0,1,0
2859,86,0,0,79,79,0,1,0,1,0
781,3095,0,0,139,139,0,1,0,1,0
1618,1056,0,0,111,111,0,1,0,1,0
878,309,3124,105,275,214,61,3,0,2,0
2941,1694,0,0,62,62,0,1,0,1,0
3350,1335,0,0,85,85,0,1,0,1,0
4651,183,16111,121,293,223,70,4,1,3,1
318,2424,0,0,144,144,0,1,0,1,0
2301,321,0,0,62,62,0,1,0,1,0
3244,183,11749,121,293,223,70,4,0,3,1
12256,1835,0,0,77,77,0,1,0,1,0
3041,1684,0,0,63,63,0,1,0,1,0
2185,183,8891,121,293,223,70,4,0,3,1
468,2741,0,0,141,141,0,1,0,1,0
1977,183,7707,121,293,223,70,4,0,3,1
1418,3095,0,0,139,139,0,1,0,1,0
8261,1257,0,0,154,154,0,1,0,1,0
501,921,919,31,181,163,17,1,0,1,0
1743,183,6535,121,293,223,70,4,0,3,1
2154,183,8685,121,293,223,70,4,0,3,1
8327,1681,0,0,146,146,0,1,0,1,0
1821,927,0,0,81,81,0,1,0,1,0
2108,1947,0,0,76,76,0,1,0,1,0
4285,183,14453,121,293,223,70,4,0,3,1
2143,3095,0,0,156,156,0,1,0,1,0
8274,1368,0,0,152,152,0,1,0,1,0
2289,1684,0,0,63,63,0,1,0,1,0
7745,1374,0,0,146,146,0,1,0,1,0
3627,729,0,0,146,146,0,1,0,1,0
10619,1543,0,0,66,66,0,1,0,1,0
2097,1992,0,0,78,78,0,1,0,1,0
2233,183,9126,121,293,223,70,4,0,3,1
10935,1616,0,0,67,67,0,1,0,1,0
14342,2303,0,0,107,107,0,1,0,1,0
8300,1530,0,0,149,149,0,1,0,1,0
5364,281,0,0,146,146,0,1,0,1,0
1829,937,0,0,144,144,0,1,0,1,0
20925,1916,0,0,81,81,0,1,0,1,0
7781,2067,0,0,111,111,0,1,0,1,0
1550,3095,0,0,141,141,0,1,0,1,0
2122,1460,0,0,98,98,0,1,0,1,0
17504,2897,0,0,134,134,0,1,0,1,0
1934,1151,0,0,136,136,0,1,0,1,0
9120,1543,0,0,117,117,0,1,0,1,0
10614,1543,0,0,66,66,0,1,0,1,0
1961,183,7627,121,293,223,70,4,0,3,1
1424,183,4945,121,293,223,70,4,1,3,1
2178,917,0,0,81,81,0,1,0,1,0
1940,1074,0,0,118,118,0,1,0,1,0
2986,1462,0,0,100,100,0,1,0,1,0
2635,1404,0,0,110,110,0,1,0,1,0
2408,1176,0,0,145,145,0,1,0,1,0
1753,183,6589,121,293,223,70,4,0,3,1
2144,183,8608,121,293,223,70,4,0,3,1
7925,2117,0,0,113,113,0,1,0,1,0
10486,1543,0,0,72,72,0,1,0,1,0
39,1013,0,0,156,156,0,1,0,1,0
263,1125,0,0,147,147,0,1,0,1,0
2472,26,0,0,66,66,0,1,0,1,0
2900,1188,0,0,145,145,0,1,0,1,0
8345,1694,0,0,145,145,0,1,0,1,0
1778,183,6713,121,293,223,70,4,0,3,1
211,1099,0,0,149,149,0,1,0,1,0
6654,721,0,0,146,146,0,1,0,1,0
8327,1651,0,0,146,146,0,1,0,1,0
2166,183,8790,121,293,223,70,4,0,3,1
1664,557,0,0,147,147,0,1,0,1,0
2899,1672,0,0,65,65,0,1,0,1,0
1489,3095,0,0,140,140,0,1,0,1,0
8327,1680,0,0,146,146,0,1,0,1,0
11326,1649,0,0,62,62,0,1,0,1,0
887,3095,0,0,140,140,0,1,0,1,0
2916,1694,0,0,62,62,0,1,0,1,0
8770,1661,0,0,129,129,0,1,0,1,0
10983,1622,0,0,66,66,0,1,0,1,0
4660,183,15519,121,293,223,70,4,0,3,1
2913,1254,0,0,134,134,0,1,0,1,0
8327,1653,0,0,146,146,0,1,0,1,0
10552,1647,0,0,87,87,0,1,0,1,0
9076,1295,0,0,126,126,0,1,0,1,0
8262,1293,0,0,154,154,0,1,0,1,0
7465,183,14518,121,293,223,70,4,0,3,1
741,1169,0,0,157,157,0,1,0,1,0
16095,183,22963,121,293,223,70,4,0,3,1
2764,1694,0,0,62,62,0,1,0,1,0
2718,2081,0,0,88,88,0,1,0,1,0
5129,437,0,0,146,146,0,1,0,1,0
13434,183,20147,121,293,223,70,4,0,3,1
2536,1484,0,0,96,96,0,1,0,1,0
2277,1735,0,0,64,64,0,1,0,1,0
8312,1478,0,0,147,147,0,1,0,1,0
14912,662,0,0,145,145,0,1,0,1,0
6051,445,0,0,146,146,0,1,0,1,0
2287,3003,0,0,152,152,0,1,0,1,0
811,3095,0,0,139,139,0,1,0,1,0
1099,1176,0,0,147,147,0,1,0,1,0
1400,1172,0,0,139,139,0,1,0,1,0
9002,1543,0,0,123,123,0,1,0,1,0
731,1167,0,0,157,157,0,1,0,1,0
1420,183,4949,121,293,223,70,4,0,3,1
10541,1543,0,0,67,67,0,1,0,1,0
122,1758,0,0,150,150,0,1,0,1,0
469,982,698,23,172,158,13,1,0,1,0
9485,1543,0,0,106,106,0,1,0,1,0
107,1652,0,0,151,151,0,1,0,1,0
2010,760,0,0,62,62,0,1,0,1,0
7666,2290,0,0,100,100,0,1,0,1,0
643,1176,0,0,152,152,0,1,0,1,0
4759,183,15860,121,293,223,70,4,0,3,1
331,1424,0,0,143,143,0,1,0,1,0
2554,183,9697,121,293,223,70,4,0,3,1
2218,446,0,0,62,62,0,1,0,1,0
2479,1694,0,0,62,62,0,1,0,1,0
1150,183,4575,121,293,223,70,4,0,3,1
11034,1589,0,0,62,62,0,1,0,1,0
2622,1176,0,0,146,146,0,1,0,1,0
666,611,2035,68,228,188,39,2,0,2,0
13475,684,0,0,120,120,0,1,0,1,0
8501,1543,0,0,139,139,0,1,0,1,0
1810,1176,0,0,142,142,0,1,0,1,0
1350,183,4580,121,293,223,70,4,1,3,1
1067,2916,0,0,143,143,0,1,0,1,0
1617,1176,0,0,140,140,0,1,0,1,0
1006,2876,0,0,143,143,0,1,0,1,0
1197,183,4841,121,293,223,70,4,0,3,1
1229,3095,0,0,142,142,0,1,0,1,0
14181,289,0,0,142,142,0,1,0,1,0
3729,183,13179,121,293,223,70,4,1,3,1
98,1585,0,0,151,151,0,1,0,1,0
1787,183,6823,121,293,223,70,4,0,3,1
1928,2273,0,0,93,93,0,1,0,1,0
2147,554,0,0,62,62,0,1,0,1,0
1728,2513,0,0,109,109,0,1,0,1,0
10091,1543,0,0,81,81,0,1,0,1,0
1863,1016,0,0,144,144,0,1,0,1,0
1625,1052,0,0,110,110,0,1,0,1,0
8575,1675,0,0,136,136,0,1,0,1,0
4542,183,15975,121,293,223,70,4,1,3,1
2591,1439,0,0,104,104,0,1,0,1,0
451,1176,0,0,145,145,0,1,0,1,0
10861,1606,0,0,67,67,0,1,0,1,0
1943,183,7493,121,293,223,70,4,0,3,1
2932,1241,0,0,137,137,0,1,0,1,0
1907,1118,0,0,143,143,0,1,0,1,0
1366,183,4656,121,293,223,70,4,1,3,1
2363,163,0,0,72,72,0,1,0,1,0
1285,797,0,0,151,151,0,1,0,1,0
1488,1008,0,0,141,141,0,1,0,1,0
2226,183,9104,121,293,223,70,4,0,3,1
1275,638,0,0,150,150,0,1,0,1,0
3244,180,0,0,99,99,0,1,0,1,0
8259,1780,0,0,140,140,0,1,0,1,0
2705,1694,0,0,62,62,0,1,0,1,0
17049,2805,0,0,129,129,0,1,0,1,0
1803,183,6794,121,293,223,70,4,0,3,1
10879,1557,0,0,62,62,0,1,0,1,0
1934,1151,0,0,136,136,0,1,0,1,0
5548,263,0,0,146,146,0,1,0,1,0
17440,2385,0,0,145,145,0,1,0,1,0
1701,642,0,0,147,147,0,1,0,1,0
2761,1176,0,0,147,147,0,1,0,1,0
3180,183,11090,121,293,223,70,4,0,3,1
15579,2508,0,0,110,110,0,1,0,1,0
2316,183,7866,121,293,223,70,4,1,3,1
3043,1693,0,0,62,62,0,1,0,1,0
786,1176,0,0,156,156,0,1,0,1,0
11224,1628,0,0,62,62,0,1,0,1,0
3015,1694,0,0,62,62,0,1,0,1,0
1852,3095,0,0,153,153,0,1,0,1,0
1173,3095,0,0,145,145,0,1,0,1,0
2814,183,9927,121,293,223,70,4,1,3,1
2627,1176,0,0,146,146,0,1,0,1,0
2376,1613,0,0,75,75,0,1,0,1,0
10424,1555,0,0,72,72,0,1,0,1,0
1848,183,7061,121,293,223,70,4,0,3,1
13543,531,0,0,126,126,0,1,0,1,0
1948,183,7563,121,293,223,70,4,0,3,1
2227,934,0,0,86,86,0,1,0,1,0
7513,1143,0,0,146,146,0,1,0,1,0
1974,183,7672,121,293,223,70,4,0,3,1
1316,3095,0,0,142,142,0,1,0,1,0
15201,2432,0,0,105,105,0,1,0,1,0
2522,1176,0,0,145,145,0,1,0,1,0
1142,3095,0,0,139,139,0,1,0,1,0
56,1278,0,0,154,154,0,1,0,1,0
1264,3095,0,0,139,139,0,1,0,1,0
8297,1412,0,0,149,149,0,1,0,1,0
2081,1574,0,0,79,79,0,1,0,1,0
256,2383,0,0,144,144,0,1,0,1,0
2560,1464,0,0,100,100,0,1,0,1,0
1952,915,0,0,80,80,0,1,0,1,0
9997,1543,0,0,85,85,0,1,0,1,0
2951,1694,0,0,62,62,0,1,0,1,0
1530,617,0,0,149,149,0,1,0,1,0
2647,1176,0,0,146,146,0,1,0,1,0
983,183,3751,121,293,223,70,4,1,3,1
8327,1646,0,0,146,146,0,1,0,1,0
1796,861,0,0,145,145,0,1,0,1,0
300,2492,0,0,143,143,0,1,0,1,0
8327,1693,0,0,146,146,0,1,0,1,0
1934,1153,0,0,137,137,0,1,0,1,0
2210,1512,0,0,62,62,0,1,0,1,0
1763,183,6779,121,293,223,70,4,0,3,1
2072,183,8225,121,293,223,70,4,0,3,1
3004,1533,0,0,88,88,0,1,0,1,0
995,2830,0,0,141,141,0,1,0,1,0
17640,183,24779,121,293,223,70,4,0,3,1
2100,183,8358,121,293,223,70,4,0,3,1
8289,1462,0,0,150,150,0,1,0,1,0
5242,293,0,0,146,146,0,1,0,1,0
2573,183,9522,121,293,223,70,4,0,3,1
1110,183,4374,121,293,223,70,4,0,3,1
2986,1694,0,0,62,62,0,1,0,1,0
7373,2907,0,0,69,69,0,1,0,1,0
1212,1176,0,0,144,144,0,1,0,1,0
9563,1543,0,0,101,101,0,1,0,1,0
2142,1331,0,0,62,62,0,1,0,1,0
1571,1176,0,0,140,140,0,1,0,1,0
2083,1574,0,0,79,79,0,1,0,1,0
1137,905,0,0,153,153,0,1,0,1,0
10348,1477,0,0,79,79,0,1,0,1,0
1150,1176,0,0,146,146,0,1,0,1,0
1073,183,4067,121,293,223,70,4,1,3,1
2190,3095,0,0,158,158,0,1,0,1,0
16303,183,23183,121,293,223,70,4,0,3,1
1601,677,0,0,145,145,0,1,0,1,0
415,2662,0,0,142,142,0,1,0,1,0
1537,864,0,0,143,143,0,1,0,1,0
1253,1176,0,0,151,151,0,1,0,1,0
7660,183,18284,121,293,223,70,4,0,3,1
1650,1176,0,0,146,146,0,1,0,1,0
2134,1309,0,0,62,62,0,1,0,1,0
3509,1062,0,0,103,103,0,1,0,1,0
2693,1694,0,0,62,62,0,1,0,1,0
1644,3095,0,0,148,148,0,1,0,1,0
317,2418,0,0,144,144,0,1,0,1,0
1498,3095,0,0,149,149,0,1,0,1,0
1046,183,3872,121,293,223,70,4,1,3,1
2005,183,7845,121,293,223,70,4,0,3,1
21410,576,20217,85,226,176,49,3,0,2,0
8287,1453,0,0,151,151,0,1,0,1,0
2218,183,9062,121,293,223,70,4,0,3,1
791,3095,0,0,139,139,0,1,0,1,0
10441,1553,0,0,71,71,0,1,0,1,0
2113,183,8428,121,293,223,70,4,0,3,1
8985,1645,0,0,122,122,0,1,0,1,0
1396,1176,0,0,139,139,0,1,0,1,0
1838,3095,0,0,151,151,0,1,0,1,0
5033,183,16584,121,293,223,70,4,1,3,1
1073,1132,0,0,143,143,0,1,0,1,0
2081,1245,0,0,132,132,0,1,0,1,0
810,341,3009,101,269,210,58,3,0,2,0
2034,723,0,0,62,62,0,1,0,1,0
7591,2640,0,0,87,87,0,1,0,1,0
8293,1485,0,0,150,150,0,1,0,1,0
410,1051,0,0,152,152,0,1,0,1,0
1666,1176,0,0,140,140,0,1,0,1,0
2096,845,0,0,120,120,0,1,0,1,0
11203,1650,0,0,64,64,0,1,0,1,0
1646,942,0,0,123,123,0,1,0,1,0
16849,2764,0,0,127,127,0,1,0,1,0
8831,1543,0,0,127,127,0,1,0,1,0
2051,924,0,0,62,62,0,1,0,1,0
822,1176,0,0,141,141,0,1,0,1,0
8358,1543,0,0,144,144,0,1,0,1,0
1667,1176,0,0,146,146,0,1,0,1,0
1540,856,0,0,143,143,0,1,0,1,0
1524,1176,0,0,139,139,0,1,0,1,0
2592,1438,0,0,104,104,0,1,0,1,0
7459,2690,0,0,80,80,0,1,0,1,0
12721,1078,0,0,97,97,0,1,0,1,0
254,2243,0,0,146,146,0,1,0,1,0
1817,183,6865,121,293,223,70,4,0,3,1
1736,844,0,0,117,117,0,1,0,1,0
723,1176,0,0,155,155,0,1,0,1,0
77,1434,0,0,153,153,0,1,0,1,0
1236,832,0,0,152,152,0,1,0,1,0
1010,2879,0,0,143,143,0,1,0,1,0
1707,3095,0,0,145,145,0,1,0,1,0
10762,1543,0,0,63,63,0,1,0,1,0
1876,183,7300,121,293,223,70,4,0,3,1
1936,2203,0,0,91,91,0,1,0,1,0
2589,1694,0,0,62,62,0,1,0,1,0
654,1030,0,0,144,144,0,1,0,1,0
224,2201,0,0,144,144,0,1,0,1,0
2193,183,8902,121,293,223,70,4,0,3,1
1481,183,5740,121,293,223,70,4,0,3,1
1416,183,5609,121,293,223,70,4,0,3,1
9141,1331,0,0,120,120,0,1,0,1,0
8279,1399,0,0,152,152,0,1,0,1,0
8434,1543,0,0,142,142,0,1,0,1,0
1362,3095,0,0,147,147,0,1,0,1,0
1907,1176,0,0,142,142,0,1,0,1,0
8327,1684,0,0,146,146,0,1,0,1,0
1817,3095,0,0,148,148,0,1,0,1,0
2155,183,8673,121,293,223,70,4,0,3,1
1238,831,0,0,152,152,0,1,0,1,0
1333,183,4496,121,293,223,70,4,1,3,1
13141,858,0,0,109,109,0,1,0,1,0
1162,3095,0,0,144,144,0,1,0,1,0
503,1115,0,0,157,157,0,1,0,1,0
286,1136,0,0,146,146,0,1,0,1,0
1333,183,4493,121,293,223,70,4,0,3,1
2972,183,11385,121,293,223,70,4,0,3,1
3798,183,13671,121,293,223,70,4,0,3,1
2724,617,0,0,107,107,0,1,0,1,0
216,1101,0,0,149,149,0,1,0,1,0
3030,1694,0,0,62,62,0,1,0,1,0
8327,1576,0,0,146,146,0,1,0,1,0
2317,1381,0,0,110,110,0,1,0,1,0
797,1176,0,0,156,156,0,1,0,1,0
1136,2915,0,0,140,140,0,1,0,1,0
8715,1543,0,0,132,132,0,1,0,1,0
2416,183,8826,121,293,223,70,4,0,3,1
1005,233,3055,103,271,212,59,3,0,2,0
542,2554,0,0,143,143,0,1,0,1,0
1408,3095,0,0,140,140,0,1,0,1,0
1284,797,0,0,151,151,0,1,0,1,0
11887,183,18510,121,293,223,70,4,0,3,1
1471,183,5704,121,293,223,70,4,0,3,1
257,1058,0,0,157,157,0,1,0,1,0
1445,434,977,33,187,168,19,1,0,1,0
2344,1694,0,0,62,62,0,1,0,1,0
9244,1349,0,0,116,116,0,1,0,1,0
2261,155,0,0,87,87,0,1,0,1,0
1962,183,7596,121,293,223,70,4,0,3,1
2057,3095,0,0,155,155,0,1,0,1,0
1334,183,4498,121,293,223,70,4,1,3,1
174,957,0,0,156,156,0,1,0,1,0
11120,1606,0,0,62,62,0,1,0,1,0
1916,797,0,0,73,73,0,1,0,1,0
1125,3095,0,0,141,141,0,1,0,1,0
9328,1619,0,0,109,109,0,1,0,1,0
7769,2339,0,0,101,101,0,1,0,1,0
1777,183,6668,121,293,223,70,4,0,3,1
6977,879,0,0,146,146,0,1,0,1,0
4410,376,0,0,146,146,0,1,0,1,0
2235,421,0,0,62,62,0,1,0,1,0
15749,1232,0,0,145,145,0,1,0,1,0
1801,183,6921,121,293,223,70,4,0,3,1
752,1656,0,0,152,152,0,1,0,1,0
361,1173,0,0,143,143,0,1,0,1,0
9343,1618,0,0,109,109,0,1,0,1,0
252,2421,0,0,144,144,0,1,0,1,0
1459,1176,0,0,139,139,0,1,0,1,0
9158,1643,0,0,117,117,0,1,0,1,0
78,1032,0,0,154,154,0,1,0,1,0
7938,2098,0,0,114,114,0,1,0,1,0
612,2955,0,0,140,140,0,1,0,1,0
2393,183,0,0,62,62,0,1,0,1,0
1607,183,5861,121,293,223,70,4,0,3,1
4002,573,0,0,134,134,0,1,0,1,0
11134,1641,0,0,65,65,0,1,0,1,0
1784,663,0,0,110,110,0,1,0,1,0
7800,2791,0,0,63,63,0,1,0,1,0
692,807,0,0,153,153,0,1,0,1,0
2238,1176,0,0,144,144,0,1,0,1,0
8277,1324,0,0,152,152,0,1,0,1,0
8251,1227,0,0,155,155,0,1,0,1,0
3772,791,0,0,120,120,0,1,0,1,0
8302,1542,0,0,149,149,0,1,0,1,0
1182,183,4362,121,293,223,70,4,1,3,1
1807,183,6858,121,293,223,70,4,0,3,1
1856,3095,0,0,152,152,0,1,0,1,0
3714,183,13404,121,293,223,70,4,0,3,1
3910,680,0,0,127,127,0,1,0,1,0
823,3095,0,0,139,139,0,1,0,1,0
2449,1285,0,0,62,62,0,1,0,1,0
1748,973,0,0,92,92,0,1,0,1,0
1617,2788,0,0,122,122,0,1,0,1,0
851,1114,0,0,156,156,0,1,0,1,0
1065,183,4044,121,293,223,70,4,1,3,1
448,2711,0,0,142,142,0,1,0,1,0
1954,183,7553,121,293,223,70,4,0,3,1
1525,399,1638,45,202,176,26,2,0,1,0
769,3095,0,0,139,139,0,1,0,1,0
1554,183,5609,121,293,223,70,4,0,3,1
17744,2592,0,0,145,145,0,1,0,1,0
9276,1623,0,0,111,111,0,1,0,1,0
49,1010,0,0,157,157,0,1,0,1,0
2952,1322,0,0,123,123,0,1,0,1,0
3592,1053,0,0,103,103,0,1,0,1,0
19275,2712,0,0,124,124,0,1,0,1,0
2198,3095,0,0,158,158,0,1,0,1,0
205,2334,0,0,144,144,0,1,0,1,0
1281,1176,0,0,143,143,0,1,0,1,0
8295,1500,0,0,150,150,0,1,0,1,0
4160,183,14709,121,293,223,70,4,1,3,1
12950,750,0,0,112,112,0,1,0,1,0
914,183,3633,121,293,223,70,4,1,3,1
149,1956,0,0,148,148,0,1,0,1,0
1527,893,0,0,142,142,0,1,0,1,0
192,1043,0,0,157,157,0,1,0,1,0
4310,183,14262,121,293,223,70,4,1,3,1
14975,704,0,0,145,145,0,1,0,1,0
5526,304,0,0,146,146,0,1,0,1,0
724,2545,0,0,144,144,0,1,0,1,0
10593,1543,0,0,66,66,0,1,0,1,0
10447,1565,0,0,74,74,0,1,0,1,0
3225,175,0,0,98,98,0,1,0,1,0
3977,579,0,0,134,134,0,1,0,1,0
8327,1570,0,0,146,146,0,1,0,1,0
2727,1694,0,0,62,62,0,1,0,1,0
1719,3095,0,0,152,152,0,1,0,1,0
10110,1626,0,0,99,99,0,1,0,1,0
10652,1447,0,0,77,77,0,1,0,1,0
15895,1332,0,0,145,145,0,1,0,1,0
9425,1543,0,0,108,108,0,1,0,1,0
8147,1141,0,0,156,156,0,1,0,1,0
648,3008,0,0,139,139,0,1,0,1,0
8905,1694,0,0,130,130,0,1,0,1,0
279,1063,0,0,157,157,0,1,0,1,0
4630,183,16085,121,293,223,70,4,1,3,1
6389,1481,0,0,109,109,0,1,0,1,0
3016,1581,0,0,80,80,0,1,0,1,0
1468,183,5162,121,293,223,70,4,0,3,1
16344,2663,0,0,119,119,0,1,0,1,0
2942,1694,0,0,62,62,0,1,0,1,0
489,866,0,0,154,154,0,1,0,1,0
1522,2821,0,0,127,127,0,1,0,1,0
2859,1694,0,0,62,62,0,1,0,1,0
1750,972,0,0,92,92,0,1,0,1,0
61,1316,0,0,154,154,0,1,0,1,0
2002,183,7941,121,293,223,70,4,0,3,1
1717,489,0,0,141,141,0,1,0,1,0
4203,183,14860,121,293,223,70,4,1,3,1
1921,183,7371,121,293,223,70,4,0,3,1
7943,183,18711,121,293,223,70,4,0,3,1
1884,1063,0,0,143,143,0,1,0,1,0
2226,183,9082,121,293,223,70,4,0,3,1
601,734,1592,53,209,178,31,2,0,1,0
1821,701,0,0,100,100,0,1,0,1,0
3843,594,0,0,146,146,0,1,0,1,0
19187,2754,0,0,126,126,0,1,0,1,0
1830,939,0,0,144,144,0,1,0,1,0
4168,183,14814,121,293,223,70,4,0,3,1
8627,1675,0,0,135,135,0,1,0,1,0
893,1176,0,0,153,153,0,1,0,1,0
156,2004,0,0,148,148,0,1,0,1,0
1453,183,5089,121,293,223,70,4,1,3,1
13956,2179,0,0,96,96,0,1,0,1,0
2766,1694,0,0,62,62,0,1,0,1,0
2346,103,0,0,78,78,0,1,0,1,0
8168,1769,0,0,133,133,0,1,0,1,0
8445,1211,0,0,148,148,0,1,0,1,0
1607,183,5836,121,293,223,70,4,0,3,1
9476,1624,0,0,107,107,0,1,0,1,0
532,2836,0,0,141,141,0,1,0,1,0
2255,2648,0,0,128,128,0,1,0,1,0
8327,1580,0,0,146,146,0,1,0,1,0
8136,1380,0,0,146,146,0,1,0,1,0
11133,1641,0,0,65,65,0,1,0,1,0
1624,536,0,0,148,148,0,1,0,1,0
2319,1694,0,0,62,62,0,1,0,1,0
1322,1176,0,0,141,141,0,1,0,1,0
1014,183,3905,121,293,223,70,4,1,3,1
2053,1232,0,0,134,134,0,1,0,1,0
4562,183,16000,121,293,223,70,4,1,3,1
2913,1243,0,0,136,136,0,1,0,1,0
8730,1669,0,0,132,132,0,1,0,1,0
12937,965,0,0,103,103,0,1,0,1,0
980,183,3937,121,293,223,70,4,0,3,1
10511,1543,0,0,68,68,0,1,0,1,0
880,1093,0,0,155,155,0,1,0,1,0
12267,1316,0,0,83,83,0,1,0,1,0
2789,183,10193,121,293,223,70,4,0,3,1
8630,1231,0,0,142,142,0,1,0,1,0
1630,1176,0,0,140,140,0,1,0,1,0
1570,3095,0,0,150,150,0,1,0,1,0
4553,362,0,0,146,146,0,1,0,1,0
815,3095,0,0,139,139,0,1,0,1,0
8733,1562,0,0,135,135,0,1,0,1,0
1249,823,0,0,152,152,0,1,0,1,0
1333,689,0,0,146,146,0,1,0,1,0
110,1048,0,0,153,153,0,1,0,1,0
3026,1694,0,0,62,62,0,1,0,1,0
1775,801,0,0,114,114,0,1,0,1,0
899,183,3588,121,293,223,70,4,1,3,1
2005,312,0,0,112,112,0,1,0,1,0
1422,3095,0,0,139,139,0,1,0,1,0
7426,2853,0,0,74,74,0,1,0,1,0
8655,1674,0,0,134,134,0,1,0,1,0
106,1046,0,0,153,153,0,1,0,1,0
3281,183,11964,121,293,223,70,4,0,3,1
2900,1634,0,0,71,71,0,1,0,1,0
6286,540,0,0,146,146,0,1,0,1,0
1364,397,1359,45,203,176,26,2,0,1,0
7344,2912,0,0,68,68,0,1,0,1,0
895,3095,0,0,139,139,0,1,0,1,0
1733,612,0,0,125,125,0,1,0,1,0
5096,308,0,0,146,146,0,1,0,1,0
1027,183,3836,121,293,223,70,4,1,3,1
6036,183,17072,121,293,223,70,4,0,3,1
10506,1561,0,0,72,72,0,1,0,1,0
1665,1176,0,0,140,140,0,1,0,1,0
1435,1163,0,0,139,139,0,1,0,1,0
9419,1543,0,0,109,109,0,1,0,1,0
127,1028,0,0,157,157,0,1,0,1,0
8821,1276,0,0,133,133,0,1,0,1,0
1419,183,5007,121,293,223,70,4,1,3,1
2655,1694,0,0,62,62,0,1,0,1,0
1348,183,4571,121,293,223,70,4,0,3,1
11751,1086,0,0,97,97,0,1,0,1,0
1773,183,6647,121,293,223,70,4,0,3,1
3129,183,10938,121,293,223,70,4,0,3,1
1351,1176,0,0,141,141,0,1,0,1,0
1594,697,0,0,145,145,0,1,0,1,0
1517,1228,0,0,131,131,0,1,0,1,0
13708,183,22799,121,293,223,70,4,0,3,1
659,1176,0,0,153,153,0,1,0,1,0
1950,937,0,0,85,85,0,1,0,1,0
1443,1139,0,0,139,139,0,1,0,1,0
4177,183,14325,121,293,223,70,4,0,3,1
10375,1543,0,0,71,71,0,1,0,1,0
2390,76,0,0,74,74,0,1,0,1,0
1073,2920,0,0,143,143,0,1,0,1,0
7572,1279,0,0,146,146,0,1,0,1,0
10472,1563,0,0,73,73,0,1,0,1,0
1857,403,0,0,127,127,0,1,0,1,0
8327,1661,0,0,146,146,0,1,0,1,0
12617,802,0,0,113,113,0,1,0,1,0
2181,183,8826,121,293,223,70,4,0,3,1
3759,183,12806,121,293,223,70,4,0,3,1
1904,1110,0,0,143,143,0,1,0,1,0
1115,1176,0,0,152,152,0,1,0,1,0
721,1165,0,0,157,157,0,1,0,1,0
20417,1318,0,0,76,76,0,1,0,1,0
8359,1192,0,0,152,152,0,1,0,1,0
2916,1694,0,0,62,62,0,1,0,1,0
1047,183,3875,121,293,223,70,4,1,3,1
969,216,3229,109,278,215,63,3,0,2,0
11206,1624,0,0,62,62,0,1,0,1,0
13883,2216,0,0,103,103,0,1,0,1,0
1382,3095,0,0,139,139,0,1,0,1,0
3434,1003,0,0,147,147,0,1,0,1,0
3006,1540,0,0,87,87,0,1,0,1,0
2082,883,0,0,73,73,0,1,0,1,0
3028,1694,0,0,62,62,0,1,0,1,0
3011,1694,0,0,62,62,0,1,0,1,0
1718,183,6465,121,293,223,70,4,0,3,1
3401,1275,0,0,89,89,0,1,0,1,0
2080,183,8270,121,293,223,70,4,0,3,1
2054,183,7801,121,293,223,70,4,0,3,1
1343,183,4544,121,293,223,70,4,1,3,1
727,2693,0,0,144,144,0,1,0,1,0
2174,1538,0,0,86,86,0,1,0,1,0
2240,183,9164,121,293,223,70,4,0,3,1
1412,649,0,0,147,147,0,1,0,1,0
8167,1464,0,0,146,146,0,1,0,1,0
1685,562,0,0,138,138,0,1,0,1,0
3495,183,11648,121,293,223,70,4,1,3,1
2250,162,0,0,88,88,0,1,0,1,0
7996,1652,0,0,132,132,0,1,0,1,0
11808,1543,0,0,62,62,0,1,0,1,0
20507,2118,0,0,92,92,0,1,0,1,0
13789,183,20896,121,293,223,70,4,0,3,1
1203,183,4865,121,293,223,70,4,0,3,1
7778,2073,0,0,111,111,0,1,0,1,0
5489,183,12525,121,293,223,70,4,0,3,1
344,2434,0,0,144,144,0,1,0,1,0
1811,933,0,0,83,83,0,1,0,1,0
1030,1176,0,0,153,153,0,1,0,1,0
2083,183,8257,121,293,223,70,4,0,3,1
2800,1604,0,0,62,62,0,1,0,1,0
8294,1401,0,0,150,150,0,1,0,1,0
1530,1176,0,0,139,139,0,1,0,1,0
9338,1618,0,0,109,109,0,1,0,1,0
2672,1488,0,0,62,62,0,1,0,1,0
257,1961,0,0,144,144,0,1,0,1,0
1934,2206,0,0,91,91,0,1,0,1,0
2068,3095,0,0,155,155,0,1,0,1,0
8288,1457,0,0,151,151,0,1,0,1,0
18692,2993,0,0,139,139,0,1,0,1,0
2864,1024,0,0,136,136,0,1,0,1,0
7921,2216,0,0,113,113,0,1,0,1,0
2024,183,7940,121,293,223,70,4,0,3,1
2113,183,8456,121,293,223,70,4,0,3,1
2325,2921,0,0,147,147,0,1,0,1,0
1758,2554,0,0,109,109,0,1,0,1,0
61,1012,0,0,157,157,0,1,0,1,0
1431,3095,0,0,139,139,0,1,0,1,0
8247,1197,0,0,156,156,0,1,0,1,0
10414,1543,0,0,70,70,0,1,0,1,0
1033,1176,0,0,153,153,0,1,0,1,0
8285,1362,0,0,151,151,0,1,0,1,0
1924,183,7392,121,293,223,70,4,0,3,1
2198,193,0,0,93,93,0,1,0,1,0
2260,275,0,0,79,79,0,1,0,1,0
8327,1620,0,0,146,146,0,1,0,1,0
10960,1574,0,0,62,62,0,1,0,1,0
2189,183,8880,121,293,223,70,4,0,3,1
981,1019,0,0,154,154,0,1,0,1,0
1479,183,5733,121,293,223,70,4,0,3,1
1697,183,6705,121,293,223,70,4,0,3,1
2124,183,8577,121,293,223,70,4,0,3,1
21544,1023,10876,46,150,123,26,2,0,1,0
4651,183,16111,121,293,223,70,4,1,3,1
9855,1543,0,0,94,94,0,1,0,1,0
2016,751,0,0,62,62,0,1,0,1,0
10872,1555,0,0,62,62,0,1,0,1,0
461,1176,0,0,146,146,0,1,0,1,0
11473,1684,0,0,62,62,0,1,0,1,0
2294,332,0,0,62,62,0,1,0,1,0
1127,3095,0,0,144,144,0,1,0,1,0
1380,1169,0,0,139,139,0,1,0,1,0
1628,598,0,0,147,147,0,1,0,1,0
1690,616,0,0,147,147,0,1,0,1,0
2056,281,0,0,107,107,0,1,0,1,0
462,1176,0,0,146,146,0,1,0,1,0
1225,183,4220,121,293,223,70,4,1,3,1
873,353,2966,100,269,211,58,3,0,2,0
6199,432,0,0,148,148,0,1,0,1,0
206,1096,0,0,149,149,0,1,0,1,0
5068,311,0,0,146,146,0,1,0,1,0
3812,613,0,0,146,146,0,1,0,1,0
1767,3095,0,0,147,147,0,1,0,1,0
17433,1606,0,0,62,62,0,1,0,1,0
1379,3095,0,0,143,143,0,1,0,1,0
1913,183,7388,121,293,223,70,4,0,3,1
3820,608,0,0,146,146,0,1,0,1,0
235,2396,0,0,144,144,0,1,0,1,0
10218,1553,0,0,77,77,0,1,0,1,0
9907,1597,0,0,92,92,0,1,0,1,0
10092,1440,0,0,88,88,0,1,0,1,0
2871,1694,0,0,62,62,0,1,0,1,0
1832,183,6935,121,293,223,70,4,0,3,1
1963,2214,0,0,90,90,0,1,0,1,0
1835,3095,0,0,153,153,0,1,0,1,0
12323,982,0,0,97,97,0,1,0,1,0
1647,183,6510,121,293,223,70,4,0,3,1
6890,183,17942,121,293,223,70,4,0,3,1
968,1176,0,0,151,151,0,1,0,1,0
11146,1418,0,0,70,70,0,1,0,1,0
20510,2117,0,0,92,92,0,1,0,1,0
464,1176,0,0,146,146,0,1,0,1,0
718,2718,0,0,142,142,0,1,0,1,0
1713,183,6351,121,293,223,70,4,0,3,1
2081,3095,0,0,156,156,0,1,0,1,0
11494,1683,0,0,62,62,0,1,0,1,0
1254,819,0,0,152,152,0,1,0,1,0
1502,183,5335,121,293,223,70,4,0,3,1
734,2223,0,0,147,147,0,1,0,1,0
2260,1722,0,0,63,63,0,1,0,1,0
4922,183,16267,121,293,223,70,4,0,3,1
1013,183,3809,121,293,223,70,4,1,3,1
1368,1176,0,0,140,140,0,1,0,1,0
2058,1109,0,0,62,62,0,1,0,1,0
500,1062,0,0,150,150,0,1,0,1,0
2953,1326,0,0,123,123,0,1,0,1,0
2166,3095,0,0,157,157,0,1,0,1,0
10327,1537,0,0,73,73,0,1,0,1,0
8672,1559,0,0,136,136,0,1,0,1,0
2902,1628,0,0,72,72,0,1,0,1,0
2936,1643,0,0,69,69,0,1,0,1,0
8664,1694,0,0,137,137,0,1,0,1,0
4045,522,0,0,138,138,0,1,0,1,0
8326,1539,0,0,146,146,0,1,0,1,0
9967,1572,0,0,86,86,0,1,0,1,0
1726,183,6527,121,293,223,70,4,0,3,1
638,2993,0,0,139,139,0,1,0,1,0
2684,1694,0,0,62,62,0,1,0,1,0
717,1281,0,0,155,155,0,1,0,1,0
8260,1250,0,0,154,154,0,1,0,1,0
2000,1277,0,0,127,127,0,1,0,1,0
525,1176,0,0,148,148,0,1,0,1,0
2228,183,9098,121,293,223,70,4,0,3,1
997,3095,0,0,140,140,0,1,0,1,0
463,2733,0,0,141,141,0,1,0,1,0
2728,627,0,0,107,107,0,1,0,1,0
1486,1014,0,0,141,141,0,1,0,1,0
1530,183,5475,121,293,223,70,4,0,3,1
18159,3029,0,0,141,141,0,1,0,1,0
1933,183,7486,121,293,223,70,4,0,3,1
2060,183,8442,121,293,223,70,4,0,3,1
10834,1633,0,0,76,76,0,1,0,1,0
1277,3095,0,0,146,146,0,1,0,1,0
7714,2481,0,0,97,97,0,1,0,1,0
13570,2156,0,0,100,100,0,1,0,1,0
1719,992,0,0,96,96,0,1,0,1,0
9426,1345,0,0,113,113,0,1,0,1,0
2376,85,0,0,75,75,0,1,0,1,0
4209,183,14410,121,293,223,70,4,0,3,1
9679,1424,0,0,99,99,0,1,0,1,0
1955,878,0,0,71,71,0,1,0,1,0
664,1026,0,0,144,144,0,1,0,1,0
9624,1597,0,0,98,98,0,1,0,1,0
2113,1273,0,0,127,127,0,1,0,1,0
6868,826,0,0,146,146,0,1,0,1,0
1094,2934,0,0,143,143,0,1,0,1,0
14114,349,0,0,139,139,0,1,0,1,0
1983,2181,0,0,88,88,0,1,0,1,0
2253,2739,0,0,134,134,0,1,0,1,0
10757,1543,0,0,63,63,0,1,0,1,0
93,1040,0,0,153,153,0,1,0,1,0
18235,936,0,0,100,100,0,1,0,1,0
3341,909,0,0,147,147,0,1,0,1,0
2211,183,9000,121,293,223,70,4,0,3,1
508,1176,0,0,147,147,0,1,0,1,0
8307,1570,0,0,148,148,0,1,0,1,0
2005,2144,0,0,86,86,0,1,0,1,0
1087,3095,0,0,141,141,0,1,0,1,0
9477,1389,0,0,107,107,0,1,0,1,0
8307,1574,0,0,148,148,0,1,0,1,0
1621,183,5907,121,293,223,70,4,0,3,1
15782,507,0,0,128,128,0,1,0,1,0
1039,2856,0,0,140,140,0,1,0,1,0
1964,183,7643,121,293,223,70,4,0,3,1
1486,183,5256,121,293,223,70,4,0,3,1
10600,1513,0,0,69,69,0,1,0,1,0
7626,951,0,0,154,154,0,1,0,1,0
1840,3095,0,0,153,153,0,1,0,1,0
367,2009,0,0,148,148,0,1,0,1,0
1490,183,5273,121,293,223,70,4,0,3,1
502,1062,0,0,150,150,0,1,0,1,0
3014,1694,0,0,62,62,0,1,0,1,0
9434,1382,0,0,109,109,0,1,0,1,0
7979,2141,0,0,118,118,0,1,0,1,0
2450,1694,0,0,62,62,0,1,0,1,0
1397,183,4812,121,293,223,70,4,1,3,1
1980,183,7706,121,293,223,70,4,0,3,1
1834,417,0,0,129,129,0,1,0,1,0
1945,1011,0,0,103,103,0,1,0,1,0
1267,183,4951,121,293,223,70,4,0,3,1
8313,1609,0,0,147,147,0,1,0,1,0
8292,1391,0,0,150,150,0,1,0,1,0
2956,1337,0,0,121,121,0,1,0,1,0
1725,699,0,0,146,146,0,1,0,1,0
380,1980,0,0,148,148,0,1,0,1,0
822,3095,0,0,139,139,0,1,0,1,0
1513,1123,0,0,126,126,0,1,0,1,0
2585,1444,0,0,103,103,0,1,0,1,0
1521,910,0,0,142,142,0,1,0,1,0
1219,183,4845,121,293,223,70,4,0,3,1
1976,183,7668,121,293,223,70,4,0,3,1
8303,1547,0,0,149,149,0,1,0,1,0
390,2625,0,0,142,142,0,1,0,1,0
1047,3095,0,0,141,141,0,1,0,1,0
21291,1740,0,0,72,72,0,1,0,1,0
1656,2621,0,0,115,115,0,1,0,1,0
151,1069,0,0,151,151,0,1,0,1,0
9704,1610,0,0,99,99,0,1,0,1,0
2298,1346,0,0,116,116,0,1,0,1,0
5559,262,0,0,146,146,0,1,0,1,0
1956,854,0,0,65,65,0,1,0,1,0
6037,417,0,0,146,146,0,1,0,1,0
7645,2329,0,0,98,98,0,1,0,1,0
17199,2220,0,0,145,145,0,1,0,1,0
1405,3095,0,0,140,140,0,1,0,1,0
1432,1174,0,0,138,138,0,1,0,1,0
2096,3095,0,0,155,155,0,1,0,1,0
2161,1176,0,0,144,144,0,1,0,1,0
1817,183,7173,121,293,223,70,4,0,3,1
8301,1536,0,0,149,149,0,1,0,1,0
2374,210,0,0,62,62,0,1,0,1,0
1008,1176,0,0,150,150,0,1,0,1,0
1682,1329,0,0,116,116,0,1,0,1,0
4111,183,14535,121,293,223,70,4,1,3,1
893,1176,0,0,141,141,0,1,0,1,0
422,1176,0,0,144,144,0,1,0,1,0
2873,183,10179,121,293,223,70,4,0,3,1
17150,183,25436,121,293,223,70,4,0,3,1
1367,3095,0,0,141,141,0,1,0,1,0
2161,216,0,0,97,97,0,1,0,1,0
1206,1176,0,0,145,145,0,1,0,1,0
8325,1687,0,0,146,146,0,1,0,1,0
10766,1543,0,0,62,62,0,1,0,1,0
18612,1543,0,0,64,64,0,1,0,1,0
8255,1252,0,0,155,155,0,1,0,1,0
2090,183,8404,121,293,223,70,4,0,3,1
4720,183,16196,121,293,223,70,4,1,3,1
4854,332,0,0,146,146,0,1,0,1,0
2954,1694,0,0,62,62,0,1,0,1,0
8277,1391,0,0,152,152,0,1,0,1,0
1363,3095,0,0,141,141,0,1,0,1,0
10720,1530,0,0,65,65,0,1,0,1,0
1722,990,0,0,96,96,0,1,0,1,0
1737,183,6471,121,293,223,70,4,0,3,1
2249,1650,0,0,68,68,0,1,0,1,0
2804,1136,0,0,138,138,0,1,0,1,0
2567,156,0,0,73,73,0,1,0,1,0
1349,3044,0,0,139,139,0,1,0,1,0
1732,983,0,0,94,94,0,1,0,1,0
8321,1663,0,0,146,146,0,1,0,1,0
2087,183,8279,121,293,223,70,4,0,3,1
2051,1176,0,0,143,143,0,1,0,1,0
8327,1615,0,0,146,146,0,1,0,1,0
8327,1592,0,0,146,146,0,1,0,1,0
1104,1176,0,0,152,152,0,1,0,1,0
1558,1094,0,0,120,120,0,1,0,1,0
890,750,0,0,152,152,0,1,0,1,0
11126,1608,0,0,62,62,0,1,0,1,0
3083,1071,0,0,147,147,0,1,0,1,0
917,183,3641,121,293,223,70,4,1,3,1
2934,1251,0,0,135,135,0,1,0,1,0
10958,1619,0,0,66,66,0,1,0,1,0
2489,1694,0,0,62,62,0,1,0,1,0
1718,992,0,0,97,97,0,1,0,1,0
18859,2913,0,0,135,135,0,1,0,1,0
8058,2040,0,0,124,124,0,1,0,1,0
1322,183,4441,121,293,223,70,4,1,3,1
10530,1543,0,0,68,68,0,1,0,1,0
8086,1477,0,0,141,141,0,1,0,1,0
1355,393,1401,47,204,177,27,2,0,1,0
4537,183,15969,121,293,223,70,4,1,3,1
2850,1694,0,0,62,62,0,1,0,1,0
9862,1600,0,0,94,94,0,1,0,1,0
1451,1176,0,0,139,139,0,1,0,1,0
331,1425,0,0,143,143,0,1,0,1,0
1659,183,6180,121,293,223,70,4,0,3,1
1934,1161,0,0,139,139,0,1,0,1,0
837,635,1948,65,231,192,38,2,0,2,0
1638,1176,0,0,140,140,0,1,0,1,0
19176,1543,0,0,62,62,0,1,0,1,0
1836,716,0,0,96,96,0,1,0,1,0
1097,934,0,0,153,153,0,1,0,1,0
10636,1543,0,0,65,65,0,1,0,1,0
1313,184,4371,120,292,222,69,3,0,2,0
890,2765,0,0,141,141,0,1,0,1,0
1928,1166,0,0,143,143,0,1,0,1,0
4520,183,15947,121,293,223,70,4,1,3,1
4464,371,0,0,146,146,0,1,0,1,0
2695,1694,0,0,62,62,0,1,0,1,0
16868,1995,0,0,145,145,0,1,0,1,0
2640,369,0,0,88,88,0,1,0,1,0
7306,3007,0,0,64,64,0,1,0,1,0
1996,3095,0,0,154,154,0,1,0,1,0
2186,1450,0,0,62,62,0,1,0,1,0
924,183,3661,121,293,223,70,4,1,3,1
1479,2885,0,0,130,130,0,1,0,1,0
21470,776,16031,68,192,152,39,2,0,2,0
20492,2125,0,0,93,93,0,1,0,1,0
1954,343,0,0,117,117,0,1,0,1,0
991,2866,0,0,143,143,0,1,0,1,0
260,1938,0,0,144,144,0,1,0,1,0
4790,183,16284,121,293,223,70,4,1,3,1
7683,2462,0,0,94,94,0,1,0,1,0
2028,183,7952,121,293,223,70,4,0,3,1
567,2587,0,0,144,144,0,1,0,1,0
8327,1573,0,0,146,146,0,1,0,1,0
1978,809,0,0,62,62,0,1,0,1,0
9298,1634,0,0,113,113,0,1,0,1,0
8294,1492,0,0,150,150,0,1,0,1,0
1967,865,0,0,62,62,0,1,0,1,0
1970,183,7674,121,293,223,70,4,0,3,1
12057,1543,0,0,62,62,0,1,0,1,0
1703,647,0,0,147,147,0,1,0,1,0
916,1067,0,0,155,155,0,1,0,1,0
4567,183,16007,121,293,223,70,4,1,3,1
908,902,0,0,145,145,0,1,0,1,0
1877,757,0,0,84,84,0,1,0,1,0
1980,1247,0,0,131,131,0,1,0,1,0
18651,1543,0,0,62,62,0,1,0,1,0
478,1109,0,0,157,157,0,1,0,1,0
2264,1673,0,0,65,65,0,1,0,1,0
3450,997,0,0,147,147,0,1,0,1,0
4775,183,16264,121,293,223,70,4,1,3,1
2411,1694,0,0,62,62,0,1,0,1,0
1450,2928,0,0,133,133,0,1,0,1,0
1747,974,0,0,92,92,0,1,0,1,0
1772,2531,0,0,108,108,0,1,0,1,0
2017,183,7892,121,293,223,70,4,0,3,1
2260,513,0,0,97,97,0,1,0,1,0
889,2765,0,0,141,141,0,1,0,1,0
1348,1176,0,0,141,141,0,1,0,1,0
1698,3095,0,0,149,149,0,1,0,1,0
13722,554,0,0,127,127,0,1,0,1,0
1760,1176,0,0,141,141,0,1,0,1,0
8897,1543,0,0,126,126,0,1,0,1,0
974,3095,0,0,139,139,0,1,0,1,0
21695,1525,363,1,64,64,0,1,0,1,0
6326,559,0,0,146,146,0,1,0,1,0
2003,1032,0,0,133,133,0,1,0,1,0
3597,1046,0,0,104,104,0,1,0,1,0
11371,1658,0,0,62,62,0,1,0,1,0
2585,2365,0,0,108,108,0,1,0,1,0
8327,1622,0,0,146,146,0,1,0,1,0
349,1167,0,0,143,143,0,1,0,1,0
1334,183,4499,121,293,223,70,4,0,3,1
733,2268,0,0,146,146,0,1,0,1,0
2019,183,7917,121,293,223,70,4,0,3,1
1458,183,5118,121,293,223,70,4,0,3,1
1463,1081,0,0,140,140,0,1,0,1,0
14030,351,0,0,138,138,0,1,0,1,0
18118,2847,0,0,145,145,0,1,0,1,0
2643,1694,0,0,62,62,0,1,0,1,0
1455,183,5129,121,293,223,70,4,0,3,1
3694,932,0,0,111,111,0,1,0,1,0
16231,1543,0,0,66,66,0,1,0,1,0
1149,2970,0,0,143,143,0,1,0,1,0
1441,1145,0,0,139,139,0,1,0,1,0
1319,183,4427,121,293,223,70,4,1,3,1
21458,737,16859,71,198,157,41,2,0,2,0
8914,1658,0,0,126,126,0,1,0,1,0
1370,1176,0,0,140,140,0,1,0,1,0
9413,1307,0,0,145,145,0,1,0,1,0
1791,2500,0,0,106,106,0,1,0,1,0
1566,2871,0,0,126,126,0,1,0,1,0
8029,2076,0,0,122,122,0,1,0,1,0
2909,1371,0,0,115,115,0,1,0,1,0
2856,183,10663,121,293,223,70,4,0,3,1
2969,1694,0,0,62,62,0,1,0,1,0
8319,1510,0,0,146,146,0,1,0,1,0
2991,1694,0,0,62,62,0,1,0,1,0
8689,1667,0,0,132,132,0,1,0,1,0
7601,2627,0,0,88,88,0,1,0,1,0
2112,183,7437,121,293,223,70,4,1,3,1
7908,2233,0,0,112,112,0,1,0,1,0
3021,1694,0,0,62,62,0,1,0,1,0
1343,3095,0,0,142,142,0,1,0,1,0
978,3095,0,0,140,140,0,1,0,1,0
7990,2126,0,0,119,119,0,1,0,1,0
1475,183,5719,121,293,223,70,4,0,3,1
9738,1435,0,0,96,96,0,1,0,1,0
15796,1264,0,0,145,145,0,1,0,1,0
1599,183,6175,121,293,223,70,4,0,3,1
2020,303,0,0,111,111,0,1,0,1,0
7988,183,18529,121,293,223,70,4,0,3,1
292,1139,0,0,145,145,0,1,0,1,0
9466,1979,0,0,69,69,0,1,0,1,0
10776,1012,0,0,145,145,0,1,0,1,0
204,1095,0,0,149,149,0,1,0,1,0
4978,183,16517,121,293,223,70,4,1,3,1
7634,2584,0,0,90,90,0,1,0,1,0
1611,183,5933,121,293,223,70,4,0,3,1
2812,1694,0,0,62,62,0,1,0,1,0
363,1195,0,0,143,143,0,1,0,1,0
8283,1427,0,0,151,151,0,1,0,1,0
431,1053,443,14,161,152,8,1,0,1,0
2481,49,0,0,62,62,0,1,0,1,0
75,1031,0,0,154,154,0,1,0,1,0
2228,175,0,0,90,90,0,1,0,1,0
1418,3095,0,0,139,139,0,1,0,1,0
106,1046,0,0,153,153,0,1,0,1,0
10153,183,20325,121,293,223,70,4,0,3,1
8327,1624,0,0,146,146,0,1,0,1,0
1167,3095,0,0,139,139,0,1,0,1,0
42,1183,0,0,155,155,0,1,0,1,0
9090,1694,0,0,126,126,0,1,0,1,0
376,1990,0,0,148,148,0,1,0,1,0
2399,1176,0,0,145,145,0,1,0,1,0
497,1176,0,0,147,147,0,1,0,1,0
3595,183,12913,121,293,223,70,4,0,3,1
11480,1685,0,0,62,62,0,1,0,1,0
2059,1243,0,0,132,132,0,1,0,1,0
1478,1146,0,0,132,132,0,1,0,1,0
1941,823,0,0,66,66,0,1,0,1,0
15977,1388,0,0,145,145,0,1,0,1,0
12975,685,0,0,120,120,0,1,0,1,0
2970,1620,0,0,66,66,0,1,0,1,0
16297,1623,0,0,62,62,0,1,0,1,0
11212,1263,0,0,87,87,0,1,0,1,0
1319,183,4427,121,293,223,70,4,1,3,1
7445,2828,0,0,75,75,0,1,0,1,0
1040,183,3975,121,293,223,70,4,1,3,1
1532,1176,0,0,147,147,0,1,0,1,0
1335,183,5295,121,293,223,70,4,0,3,1
1903,3095,0,0,150,150,0,1,0,1,0
1085,1176,0,0,148,148,0,1,0,1,0
2103,1226,0,0,62,62,0,1,0,1,0
1700,578,0,0,134,134,0,1,0,1,0
996,183,3952,121,293,223,70,4,0,3,1
10454,1564,0,0,73,73,0,1,0,1,0
68,1014,0,0,157,157,0,1,0,1,0
2018,1176,0,0,143,143,0,1,0,1,0
9044,1576,0,0,127,127,0,1,0,1,0
1233,2974,0,0,139,139,0,1,0,1,0
1623,3095,0,0,143,143,0,1,0,1,0
976,3095,0,0,142,142,0,1,0,1,0
1144,183,4258,121,293,223,70,4,1,3,1
9470,1388,0,0,107,107,0,1,0,1,0
2915,1180,0,0,147,147,0,1,0,1,0
8711,1670,0,0,132,132,0,1,0,1,0
3197,169,0,0,97,97,0,1,0,1,0
2658,1384,0,0,113,113,0,1,0,1,0
8027,1591,0,0,135,135,0,1,0,1,0
2439,1277,0,0,62,62,0,1,0,1,0
2898,183,9732,121,293,223,70,4,1,3,1
1599,567,0,0,148,148,0,1,0,1,0
1961,1218,0,0,136,136,0,1,0,1,0
8262,1263,0,0,154,154,0,1,0,1,0
2951,1694,0,0,62,62,0,1,0,1,0
2284,1694,0,0,62,62,0,1,0,1,0
1804,938,0,0,84,84,0,1,0,1,0
8733,1260,0,0,137,137,0,1,0,1,0
2380,1694,0,0,62,62,0,1,0,1,0
1827,707,0,0,98,98,0,1,0,1,0
10046,1433,0,0,90,90,0,1,0,1,0
973,183,3869,121,293,223,70,4,0,3,1
1372,3058,0,0,139,139,0,1,0,1,0
2031,296,0,0,110,110,0,1,0,1,0
1119,918,0,0,153,153,0,1,0,1,0
5647,253,0,0,146,146,0,1,0,1,0
1313,183,4720,121,293,223,70,4,1,3,1
9955,1472,0,0,88,88,0,1,0,1,0
9775,1441,0,0,95,95,0,1,0,1,0
683,579,2151,72,233,191,42,2,0,2,0
3002,183,11475,121,293,223,70,4,0,3,1
6100,396,0,0,147,147,0,1,0,1,0
2332,1362,0,0,113,113,0,1,0,1,0
1131,1176,0,0,140,140,0,1,0,1,0
3998,183,13262,121,293,223,70,4,1,3,1
10245,1551,0,0,76,76,0,1,0,1,0
1895,3095,0,0,150,150,0,1,0,1,0
2421,1176,0,0,145,145,0,1,0,1,0
5064,459,0,0,146,146,0,1,0,1,0
1933,1176,0,0,142,142,0,1,0,1,0
3408,183,12425,121,293,223,70,4,0,3,1
10965,1694,0,0,77,77,0,1,0,1,0
3133,183,10950,121,293,223,70,4,0,3,1
205,2350,0,0,144,144,0,1,0,1,0
7863,2289,0,0,109,109,0,1,0,1,0
715,1176,0,0,155,155,0,1,0,1,0
2011,3095,0,0,154,154,0,1,0,1,0
1721,689,0,0,146,146,0,1,0,1,0
928,3095,0,0,139,139,0,1,0,1,0
13045,908,0,0,107,107,0,1,0,1,0
1400,183,4821,121,293,223,70,4,0,3,1
134,1061,0,0,152,152,0,1,0,1,0
1535,183,5500,121,293,223,70,4,0,3,1
1807,886,0,0,145,145,0,1,0,1,0
7936,1064,0,0,155,155,0,1,0,1,0
359,1222,0,0,143,143,0,1,0,1,0
3035,1659,0,0,67,67,0,1,0,1,0
1333,1176,0,0,141,141,0,1,0,1,0
2415,1694,0,0,62,62,0,1,0,1,0
2916,1178,0,0,147,147,0,1,0,1,0
1976,183,7701,121,293,223,70,4,0,3,1
6406,508,0,0,149,149,0,1,0,1,0
11527,1690,0,0,62,62,0,1,0,1,0
738,2117,0,0,148,148,0,1,0,1,0
1582,2731,0,0,121,121,0,1,0,1,0
1395,3095,0,0,143,143,0,1,0,1,0
1262,1176,0,0,143,143,0,1,0,1,0
2744,675,0,0,111,111,0,1,0,1,0
1282,3058,0,0,143,143,0,1,0,1,0
9456,1610,0,0,104,104,0,1,0,1,0
8283,1350,0,0,151,151,0,1,0,1,0
2084,1178,0,0,62,62,0,1,0,1,0
2960,1357,0,0,117,117,0,1,0,1,0
1603,670,0,0,146,146,0,1,0,1,0
2021,1010,0,0,62,62,0,1,0,1,0
9699,1607,0,0,110,110,0,1,0,1,0
2184,183,8855,121,293,223,70,4,0,3,1
567,2588,0,0,144,144,0,1,0,1,0
14519,286,0,0,142,142,0,1,0,1,0
1360,395,1377,46,203,176,26,2,0,1,0
2855,1225,0,0,139,139,0,1,0,1,0
488,1060,0,0,151,151,0,1,0,1,0
2900,1652,0,0,68,68,0,1,0,1,0
1942,183,7486,121,293,223,70,4,0,3,1
1390,3095,0,0,140,140,0,1,0,1,0
1531,183,5490,121,293,223,70,4,0,3,1
94,1558,0,0,152,152,0,1,0,1,0
270,1061,0,0,157,157,0,1,0,1,0
948,1116,0,0,145,145,0,1,0,1,0
613,1140,0,0,157,157,0,1,0,1,0
895,1176,0,0,153,153,0,1,0,1,0
942,204,3353,113,283,218,65,3,0,2,0
4789,183,16282,121,293,223,70,4,1,3,1
2235,171,0,0,89,89,0,1,0,1,0
962,183,3829,121,293,223,70,4,0,3,1
1432,1171,0,0,139,139,0,1,0,1,0
10705,1543,0,0,64,64,0,1,0,1,0
10904,1694,0,0,78,78,0,1,0,1,0
792,1176,0,0,156,156,0,1,0,1,0
10660,1652,0,0,85,85,0,1,0,1,0
2233,183,9128,121,293,223,70,4,0,3,1
1586,1007,0,0,127,127,0,1,0,1,0
2985,1457,0,0,101,101,0,1,0,1,0
17402,2359,0,0,145,145,0,1,0,1,0
9632,1416,0,0,101,101,0,1,0,1,0
1162,183,4308,121,293,223,70,4,1,3,1
726,3095,0,0,139,139,0,1,0,1,0
9501,1622,0,0,106,106,0,1,0,1,0
11984,751,0,0,145,145,0,1,0,1,0
8327,1561,0,0,146,146,0,1,0,1,0
13602,1663,0,0,62,62,0,1,0,1,0
631,1460,0,0,154,154,0,1,0,1,0
1541,3095,0,0,146,146,0,1,0,1,0
9485,1608,0,0,103,103,0,1,0,1,0
1533,183,5473,121,293,223,70,4,0,3,1
13760,534,0,0,128,128,0,1,0,1,0
162,2048,0,0,147,147,0,1,0,1,0
2110,1943,0,0,76,76,0,1,0,1,0
2145,183,8103,121,293,223,70,4,0,3,1
9661,1378,0,0,104,104,0,1,0,1,0
606,2945,0,0,140,140,0,1,0,1,0
1261,183,4289,121,293,223,70,4,1,3,1
6551,560,0,0,149,149,0,1,0,1,0
1951,920,0,0,81,81,0,1,0,1,0
10875,1556,0,0,62,62,0,1,0,1,0
8459,1206,0,0,148,148,0,1,0,1,0
12191,1356,0,0,81,81,0,1,0,1,0
2908,183,10531,121,293,223,70,4,0,3,1
719,3095,0,0,139,139,0,1,0,1,0
94,1020,0,0,157,157,0,1,0,1,0
1080,183,3940,121,293,223,70,4,1,3,1
1333,183,4496,121,293,223,70,4,1,3,1
1342,755,0,0,151,151,0,1,0,1,0
19034,2828,0,0,130,130,0,1,0,1,0
3693,872,0,0,115,115,0,1,0,1,0
2831,1594,0,0,77,77,0,1,0,1,0
10813,1543,0,0,62,62,0,1,0,1,0
2075,1389,0,0,109,109,0,1,0,1,0
16670,1860,0,0,145,145,0,1,0,1,0
9677,1593,0,0,96,96,0,1,0,1,0
8106,1439,0,0,143,143,0,1,0,1,0
1841,1176,0,0,144,144,0,1,0,1,0
1454,1108,0,0,139,139,0,1,0,1,0
1632,183,6042,121,293,223,70,4,0,3,1
2952,1694,0,0,62,62,0,1,0,1,0
1433,1176,0,0,139,139,0,1,0,1,0
1800,3095,0,0,151,151,0,1,0,1,0
1742,183,6493,121,293,223,70,4,0,3,1
2032,183,7974,121,293,223,70,4,0,3,1
12680,600,0,0,145,145,0,1,0,1,0
2164,912,0,0,80,80,0,1,0,1,0
7630,2538,0,0,90,90,0,1,0,1,0
750,1718,0,0,151,151,0,1,0,1,0
2007,972,0,0,62,62,0,1,0,1,0
7792,2382,0,0,103,103,0,1,0,1,0
899,3095,0,0,140,140,0,1,0,1,0
4468,183,14907,121,293,223,70,4,0,3,1
3714,674,0,0,146,146,0,1,0,1,0
1018,239,2994,101,269,210,58,3,0,2,0
2249,399,0,0,62,62,0,1,0,1,0
2382,81,0,0,75,75,0,1,0,1,0
16918,706,0,0,115,115,0,1,0,1,0
15005,183,22122,121,293,223,70,4,0,3,1
2261,1648,0,0,62,62,0,1,0,1,0
16482,629,0,0,120,120,0,1,0,1,0
1677,183,6179,121,293,223,70,4,0,3,1
2969,1694,0,0,62,62,0,1,0,1,0
8393,1543,0,0,143,143,0,1,0,1,0
1222,1150,0,0,141,141,0,1,0,1,0
597,2932,0,0,140,140,0,1,0,1,0
4377,183,15523,121,293,223,70,4,0,3,1
8236,1810,0,0,138,138,0,1,0,1,0
21557,1065,9993,42,143,118,24,2,0,1,0
21559,1611,0,0,65,65,0,1,0,1,0
925,1176,0,0,155,155,0,1,0,1,0
8289,1378,0,0,150,150,0,1,0,1,0
791,3095,0,0,139,139,0,1,0,1,0
1121,183,4195,121,293,223,70,4,1,3,1
2946,1694,0,0,62,62,0,1,0,1,0
2491,14,0,0,64,64,0,1,0,1,0
1447,183,5884,121,293,223,70,4,0,3,1
2891,1104,0,0,142,142,0,1,0,1,0
9323,1589,0,0,120,120,0,1,0,1,0
10500,1543,0,0,68,68,0,1,0,1,0
2360,232,0,0,62,62,0,1,0,1,0
2218,1534,0,0,62,62,0,1,0,1,0
1707,585,0,0,132,132,0,1,0,1,0
8327,1597,0,0,146,146,0,1,0,1,0
263,1914,0,0,144,144,0,1,0,1,0
8565,1222,0,0,145,145,0,1,0,1,0
70,1015,0,0,157,157,0,1,0,1,0
1698,1176,0,0,141,141,0,1,0,1,0
2115,183,8528,121,293,223,70,4,0,3,1
10965,1344,0,0,83,83,0,1,0,1,0
1150,3095,0,0,139,139,0,1,0,1,0
1933,1175,0,0,142,142,0,1,0,1,0
1993,1053,0,0,134,134,0,1,0,1,0
1638,538,0,0,148,148,0,1,0,1,0
6101,183,12388,121,293,223,70,4,0,3,1
1531,183,5462,121,293,223,70,4,0,3,1
1773,1385,0,0,107,107,0,1,0,1,0
1949,948,0,0,88,88,0,1,0,1,0
3055,1680,0,0,62,62,0,1,0,1,0
1591,1176,0,0,140,140,0,1,0,1,0
14056,330,0,0,140,140,0,1,0,1,0
5720,263,0,0,146,146,0,1,0,1,0
2946,1694,0,0,62,62,0,1,0,1,0
2476,2599,0,0,124,124,0,1,0,1,0
2077,183,7312,121,293,223,70,4,1,3,1
427,1097,0,0,157,157,0,1,0,1,0
20769,1992,0,0,86,86,0,1,0,1,0
1434,183,5831,121,293,223,70,4,0,3,1
2060,1561,0,0,81,81,0,1,0,1,0
5234,294,0,0,146,146,0,1,0,1,0
906,1176,0,0,155,155,0,1,0,1,0
2154,994,0,0,62,62,0,1,0,1,0
1911,1176,0,0,142,142,0,1,0,1,0
1939,1087,0,0,121,121,0,1,0,1,0
10443,1553,0,0,71,71,0,1,0,1,0
1315,1176,0,0,142,142,0,1,0,1,0
7708,2427,0,0,96,96,0,1,0,1,0
2343,185,0,0,74,74,0,1,0,1,0
1045,183,4134,121,293,223,70,4,0,3,1
2117,183,8475,121,293,223,70,4,0,3,1
9708,1429,0,0,98,98,0,1,0,1,0
11396,878,0,0,145,145,0,1,0,1,0
2518,1499,0,0,94,94,0,1,0,1,0
13022,1990,0,0,85,85,0,1,0,1,0
1745,183,6511,121,293,223,70,4,0,3,1
11240,1631,0,0,62,62,0,1,0,1,0
601,1137,0,0,157,157,0,1,0,1,0
3813,183,13476,121,293,223,70,4,1,3,1
1369,3095,0,0,141,141,0,1,0,1,0
535,1176,0,0,148,148,0,1,0,1,0
1464,183,5146,121,293,223,70,4,0,3,1
4778,183,16269,121,293,223,70,4,1,3,1
13235,2035,0,0,82,82,0,1,0,1,0
13770,183,22967,121,293,223,70,4,0,3,1
14072,325,0,0,140,140,0,1,0,1,0
623,1142,0,0,157,157,0,1,0,1,0
3053,183,11115,121,293,223,70,4,0,3,1
2322,1657,0,0,67,67,0,1,0,1,0
1856,183,7051,121,293,223,70,4,0,3,1
2046,183,8174,121,293,223,70,4,0,3,1
8718,1543,0,0,131,131,0,1,0,1,0
1402,3095,0,0,140,140,0,1,0,1,0
4509,366,0,0,146,146,0,1,0,1,0
10464,1556,0,0,71,71,0,1,0,1,0
2049,702,0,0,62,62,0,1,0,1,0
8085,1480,0,0,141,141,0,1,0,1,0
8027,1971,0,0,122,122,0,1,0,1,0
20466,2138,0,0,93,93,0,1,0,1,0
1992,183,7755,121,293,223,70,4,0,3,1
365,1180,0,0,143,143,0,1,0,1,0
288,1137,0,0,146,146,0,1,0,1,0
10638,1578,0,0,69,69,0,1,0,1,0
10289,1635,0,0,94,94,0,1,0,1,0
8299,1524,0,0,149,149,0,1,0,1,0
9812,1400,0,0,98,98,0,1,0,1,0
1827,932,0,0,144,144,0,1,0,1,0
154,1994,0,0,148,148,0,1,0,1,0
5011,183,16557,121,293,223,70,4,1,3,1
155,1071,0,0,151,151,0,1,0,1,0
14592,299,0,0,141,141,0,1,0,1,0
1739,729,0,0,146,146,0,1,0,1,0
5598,258,0,0,146,146,0,1,0,1,0
5141,304,0,0,146,146,0,1,0,1,0
428,1097,0,0,157,157,0,1,0,1,0
21364,1543,0,0,62,62,0,1,0,1,0
5353,362,0,0,146,146,0,1,0,1,0
2548,2445,0,0,114,114,0,1,0,1,0
1945,1006,0,0,102,102,0,1,0,1,0
1429,183,4965,121,293,223,70,4,0,3,1
10256,1524,0,0,76,76,0,1,0,1,0
10702,1028,0,0,145,145,0,1,0,1,0
2903,1694,0,0,62,62,0,1,0,1,0
8327,1610,0,0,146,146,0,1,0,1,0
1554,3095,0,0,142,142,0,1,0,1,0
9514,1543,0,0,105,105,0,1,0,1,0
1603,183,5844,121,293,223,70,4,0,3,1
1690,1176,0,0,141,141,0,1,0,1,0
635,1176,0,0,152,152,0,1,0,1,0
2908,183,10981,121,293,223,70,4,0,3,1
13206,655,0,0,118,118,0,1,0,1,0
11280,1639,0,0,62,62,0,1,0,1,0
2031,183,7964,121,293,223,70,4,0,3,1
2310,963,0,0,93,93,0,1,0,1,0
10495,1560,0,0,70,70,0,1,0,1,0
10051,1543,0,0,87,87,0,1,0,1,0
20247,183,27698,121,293,223,70,4,0,3,1
7027,904,0,0,146,146,0,1,0,1,0
1872,894,0,0,74,74,0,1,0,1,0
1831,942,0,0,144,144,0,1,0,1,0
832,673,1812,61,225,190,35,2,0,2,0
9236,1318,0,0,120,120,0,1,0,1,0
2836,1176,0,0,147,147,0,1,0,1,0
1941,183,6827,121,293,223,70,4,1,3,1
1936,183,7457,121,293,223,70,4,0,3,1
1055,3095,0,0,143,143,0,1,0,1,0
2252,530,0,0,98,98,0,1,0,1,0
1827,183,6912,121,293,223,70,4,0,3,1
1727,853,0,0,117,117,0,1,0,1,0
3817,183,13120,121,293,223,70,4,0,3,1
10526,1564,0,0,70,70,0,1,0,1,0
1142,183,4544,121,293,223,70,4,0,3,1
1350,1166,0,0,140,140,0,1,0,1,0
6547,559,0,0,149,149,0,1,0,1,0
8327,1663,0,0,146,146,0,1,0,1,0
16813,1543,0,0,62,62,0,1,0,1,0
818,2722,0,0,141,141,0,1,0,1,0
855,495,2453,82,250,202,47,3,0,2,0
3005,1119,0,0,147,147,0,1,0,1,0
2032,183,7984,121,293,223,70,4,0,3,1
2515,1694,0,0,62,62,0,1,0,1,0
1914,183,7551,121,293,223,70,4,0,3,1
2948,183,10955,121,293,223,70,4,0,3,1
1303,183,4371,121,293,223,70,4,1,3,1
1960,183,7583,121,293,223,70,4,0,3,1
1958,183,7572,121,293,223,70,4,0,3,1
1356,3095,0,0,143,143,0,1,0,1,0
1811,896,0,0,145,145,0,1,0,1,0
1935,1139,0,0,134,134,0,1,0,1,0
2975,1415,0,0,108,108,0,1,0,1,0
2644,382,0,0,89,89,0,1,0,1,0
1353,183,4829,121,293,223,70,4,1,3,1
710,3095,0,0,139,139,0,1,0,1,0
2932,1243,0,0,136,136,0,1,0,1,0
1735,183,6500,121,293,223,70,4,0,3,1
2253,183,9243,121,293,223,70,4,0,3,1
765,1250,0,0,156,156,0,1,0,1,0
156,1034,0,0,157,157,0,1,0,1,0
2084,869,0,0,121,121,0,1,0,1,0
1778,657,0,0,112,112,0,1,0,1,0
15928,1543,0,0,67,67,0,1,0,1,0
21403,553,20710,88,230,179,50,3,0,2,0
4043,183,14455,121,293,223,70,4,0,3,1
15460,1635,0,0,62,62,0,1,0,1,0
8315,1621,0,0,147,147,0,1,0,1,0
203,2348,0,0,145,145,0,1,0,1,0
633,2610,0,0,142,142,0,1,0,1,0
2689,1359,0,0,117,117,0,1,0,1,0
1813,183,6890,121,293,223,70,4,0,3,1
1313,3095,0,0,139,139,0,1,0,1,0
163,2055,0,0,147,147,0,1,0,1,0
10542,1543,0,0,67,67,0,1,0,1,0
8327,1656,0,0,146,146,0,1,0,1,0
1146,3095,0,0,141,141,0,1,0,1,0
8748,1248,0,0,138,138,0,1,0,1,0
2905,1176,0,0,147,147,0,1,0,1,0
11113,1638,0,0,65,65,0,1,0,1,0
1917,183,7354,121,293,223,70,4,0,3,1
2011,183,7929,121,293,223,70,4,0,3,1
17258,765,0,0,111,111,0,1,0,1,0
1141,902,0,0,153,153,0,1,0,1,0
17681,1543,0,0,62,62,0,1,0,1,0
3026,1624,0,0,73,73,0,1,0,1,0
1427,3095,0,0,139,139,0,1,0,1,0
8281,1345,0,0,151,151,0,1,0,1,0
10894,1560,0,0,62,62,0,1,0,1,0
336,2544,0,0,143,143,0,1,0,1,0
3594,750,0,0,146,146,0,1,0,1,0
3901,183,13360,121,293,223,70,4,0,3,1
1818,2454,0,0,103,103,0,1,0,1,0
974,183,3874,121,293,223,70,4,0,3,1
6219,1179,0,0,118,118,0,1,0,1,0
2101,1223,0,0,62,62,0,1,0,1,0
4049,464,0,0,146,146,0,1,0,1,0
14046,305,0,0,145,145,0,1,0,1,0
1708,998,0,0,98,98,0,1,0,1,0
10574,183,20633,121,293,223,70,4,0,3,1
367,2456,0,0,144,144,0,1,0,1,0
9905,1597,0,0,92,92,0,1,0,1,0
503,1115,0,0,157,157,0,1,0,1,0
15986,1394,0,0,145,145,0,1,0,1,0
8106,1858,0,0,128,128,0,1,0,1,0
3015,1694,0,0,62,62,0,1,0,1,0
8327,1684,0,0,146,146,0,1,0,1,0
2280,472,0,0,94,94,0,1,0,1,0
2734,183,9207,121,293,223,70,4,1,3,1
2901,1631,0,0,72,72,0,1,0,1,0
1170,3095,0,0,145,145,0,1,0,1,0
1357,183,4613,121,293,223,70,4,1,3,1
10336,1544,0,0,72,72,0,1,0,1,0
2867,87,0,0,80,80,0,1,0,1,0
1937,183,7464,121,293,223,70,4,0,3,1
10534,1565,0,0,70,70,0,1,0,1,0
1506,183,5393,121,293,223,70,4,0,3,1
3027,1626,0,0,73,73,0,1,0,1,0
1267,3095,0,0,139,139,0,1,0,1,0
1309,183,4708,121,293,223,70,4,1,3,1
1870,1445,0,0,99,99,0,1,0,1,0
643,1176,0,0,152,152,0,1,0,1,0
4182,183,14060,121,293,223,70,4,0,3,1
1839,183,7092,121,293,223,70,4,0,3,1
2462,32,0,0,67,67,0,1,0,1,0
11405,1676,0,0,63,63,0,1,0,1,0
3042,1694,0,0,62,62,0,1,0,1,0
2058,3095,0,0,154,154,0,1,0,1,0
9100,1543,0,0,117,117,0,1,0,1,0
18933,2877,0,0,133,133,0,1,0,1,0
1123,915,0,0,153,153,0,1,0,1,0
2808,73,0,0,77,77,0,1,0,1,0
1378,183,4717,121,293,223,70,4,1,3,1
1569,3095,0,0,147,147,0,1,0,1,0
3658,183,12924,121,293,223,70,4,1,3,1
3253,1327,0,0,85,85,0,1,0,1,0
10563,1543,0,0,67,67,0,1,0,1,0
12830,1953,0,0,77,77,0,1,0,1,0
9449,1694,0,0,116,116,0,1,0,1,0
1701,183,6330,121,293,223,70,4,0,3,1
8073,2659,0,0,64,64,0,1,0,1,0
590,1176,0,0,150,150,0,1,0,1,0
934,3095,0,0,139,139,0,1,0,1,0
1657,541,0,0,147,147,0,1,0,1,0
1719,3095,0,0,149,149,0,1,0,1,0
2111,183,8418,121,293,223,70,4,0,3,1
743,1961,0,0,149,149,0,1,0,1,0
669,2655,0,0,144,144,0,1,0,1,0
3936,650,0,0,129,129,0,1,0,1,0
2808,862,0,0,125,125,0,1,0,1,0
1216,183,4456,121,293,223,70,4,1,3,1
2294,183,8084,121,293,223,70,4,1,3,1
1562,791,0,0,144,144,0,1,0,1,0
4897,183,16415,121,293,223,70,4,1,3,1
8806,2301,0,0,66,66,0,1,0,1,0
1936,1130,0,0,131,131,0,1,0,1,0
3937,620,0,0,131,131,0,1,0,1,0
187,2230,0,0,146,146,0,1,0,1,0
3706,183,12650,121,293,223,70,4,0,3,1
18310,2977,0,0,145,145,0,1,0,1,0
2480,1250,0,0,62,62,0,1,0,1,0
10555,1558,0,0,70,70,0,1,0,1,0
3017,1586,0,0,79,79,0,1,0,1,0
9030,1651,0,0,122,122,0,1,0,1,0
2123,183,8513,121,293,223,70,4,0,3,1
7582,2898,0,0,62,62,0,1,0,1,0
266,1126,0,0,147,147,0,1,0,1,0
3614,183,13086,121,293,223,70,4,0,3,1
5282,289,0,0,146,146,0,1,0,1,0
2897,1693,0,0,62,62,0,1,0,1,0
495,1110,0,0,143,143,0,1,0,1,0
11524,1278,0,0,78,78,0,1,0,1,0
5449,330,0,0,146,146,0,1,0,1,0
2655,413,0,0,92,92,0,1,0,1,0
1898,377,0,0,123,123,0,1,0,1,0
4241,183,14495,121,293,223,70,4,0,3,1
1865,183,7225,121,293,223,70,4,0,3,1
7284,827,0,0,152,152,0,1,0,1,0
3074,183,11359,121,293,223,70,4,0,3,1
1873,754,0,0,85,85,0,1,0,1,0
990,1176,0,0,150,150,0,1,0,1,0
8802,1543,0,0,129,129,0,1,0,1,0
10388,1546,0,0,71,71,0,1,0,1,0
135,1849,0,0,149,149,0,1,0,1,0
4240,183,14231,121,293,223,70,4,0,3,1
1950,936,0,0,85,85,0,1,0,1,0
1175,183,4344,121,293,223,70,4,1,3,1
1063,3095,0,0,141,141,0,1,0,1,0
6700,801,0,0,146,146,0,1,0,1,0
2293,1694,0,0,62,62,0,1,0,1,0
2276,1690,0,0,62,62,0,1,0,1,0
10264,1526,0,0,75,75,0,1,0,1,0
1149,183,4072,121,293,223,70,4,1,3,1
1243,183,4254,121,293,223,70,4,1,3,1
2326,1176,0,0,145,145,0,1,0,1,0
21560,1075,9778,41,141,117,24,2,0,1,0
1454,183,5084,121,293,223,70,4,0,3,1
11318,1354,0,0,74,74,0,1,0,1,0
9599,1370,0,0,106,106,0,1,0,1,0
979,3095,0,0,142,142,0,1,0,1,0
334,1406,0,0,143,143,0,1,0,1,0
1480,183,5229,121,293,223,70,4,0,3,1
1291,3095,0,0,142,142,0,1,0,1,0
1708,183,6365,121,293,223,70,4,0,3,1
5433,335,0,0,146,146,0,1,0,1,0
11456,1675,0,0,62,62,0,1,0,1,0
2158,386,0,0,87,87,0,1,0,1,0
1210,1176,0,0,144,144,0,1,0,1,0
508,1176,0,0,147,147,0,1,0,1,0
9612,1603,0,0,112,112,0,1,0,1,0
1929,183,7418,121,293,223,70,4,0,3,1
2651,1561,0,0,82,82,0,1,0,1,0
1965,1225,0,0,135,135,0,1,0,1,0
1108,280,2571,86,252,201,50,3,0,2,0
359,2579,0,0,143,143,0,1,0,1,0
10307,1543,0,0,73,73,0,1,0,1,0
1973,183,7670,121,293,223,70,4,0,3,1
21261,183,28431,121,293,223,70,4,0,3,1
1424,3095,0,0,144,144,0,1,0,1,0
520,1064,0,0,150,150,0,1,0,1,0
10063,1565,0,0,82,82,0,1,0,1,0
2910,1351,0,0,118,118,0,1,0,1,0
4354,183,14570,121,293,223,70,4,0,3,1
2216,183,9028,121,293,223,70,4,0,3,1
2685,1095,0,0,127,127,0,1,0,1,0
1235,1176,0,0,151,151,0,1,0,1,0
1507,1092,0,0,133,133,0,1,0,1,0
8482,1210,0,0,148,148,0,1,0,1,0
1678,183,6188,121,293,223,70,4,0,3,1
9793,1543,0,0,96,96,0,1,0,1,0
2474,25,0,0,65,65,0,1,0,1,0
385,1176,0,0,142,142,0,1,0,1,0
8322,1668,0,0,146,146,0,1,0,1,0
9392,1340,0,0,114,114,0,1,0,1,0
8354,1543,0,0,144,144,0,1,0,1,0
2673,1373,0,0,115,115,0,1,0,1,0
8327,1663,0,0,146,146,0,1,0,1,0
10670,1543,0,0,66,66,0,1,0,1,0
1416,647,0,0,147,147,0,1,0,1,0
2567,1694,0,0,62,62,0,1,0,1,0
2531,1694,0,0,62,62,0,1,0,1,0
590,1134,0,0,157,157,0,1,0,1,0
2988,1469,0,0,99,99,0,1,0,1,0
8183,1290,0,0,151,151,0,1,0,1,0
892,3095,0,0,139,139,0,1,0,1,0
2272,1686,0,0,63,63,0,1,0,1,0
2906,1694,0,0,62,62,0,1,0,1,0
1020,3095,0,0,143,143,0,1,0,1,0
15370,2466,0,0,107,107,0,1,0,1,0
2023,183,7925,121,293,223,70,4,0,3,1
2602,183,9659,121,293,223,70,4,0,3,1
2653,1694,0,0,62,62,0,1,0,1,0
1052,183,4235,121,293,223,70,4,0,3,1
7865,2760,0,0,63,63,0,1,0,1,0
2044,183,8067,121,293,223,70,4,0,3,1
1641,183,6007,121,293,223,70,4,0,3,1
1803,183,6904,121,293,223,70,4,0,3,1
770,3095,0,0,139,139,0,1,0,1,0
2119,799,0,0,117,117,0,1,0,1,0
2216,1602,0,0,76,76,0,1,0,1,0
1991,928,0,0,62,62,0,1,0,1,0
2799,1135,0,0,137,137,0,1,0,1,0
1576,1176,0,0,140,140,0,1,0,1,0
1682,560,0,0,139,139,0,1,0,1,0
2098,183,8344,121,293,223,70,4,0,3,1
8327,1576,0,0,146,146,0,1,0,1,0
9152,1643,0,0,118,118,0,1,0,1,0
1381,183,4730,121,293,223,70,4,1,3,1
2575,183,10104,121,293,223,70,4,0,3,1
2133,3095,0,0,157,157,0,1,0,1,0
1740,3095,0,0,146,146,0,1,0,1,0
302,1637,0,0,143,143,0,1,0,1,0
190,2250,0,0,145,145,0,1,0,1,0
1765,183,6970,121,293,223,70,4,0,3,1
2184,1553,0,0,83,83,0,1,0,1,0
14476,183,21588,121,293,223,70,4,0,3,1
15556,2503,0,0,113,113,0,1,0,1,0
1041,183,3863,121,293,223,70,4,1,3,1
11990,1461,0,0,75,75,0,1,0,1,0
10704,1543,0,0,64,64,0,1,0,1,0
4946,183,16477,121,293,223,70,4,1,3,1
3092,183,10357,121,293,223,70,4,1,3,1
2031,1037,0,0,62,62,0,1,0,1,0
8327,1637,0,0,146,146,0,1,0,1,0
7372,3001,0,0,62,62,0,1,0,1,0
20634,2057,0,0,89,89,0,1,0,1,0
4872,330,0,0,146,146,0,1,0,1,0
1639,183,5989,121,293,223,70,4,0,3,1
1622,183,5910,121,293,223,70,4,0,3,1
10615,1575,0,0,69,69,0,1,0,1,0
1220,3095,0,0,142,142,0,1,0,1,0
2402,169,0,0,62,62,0,1,0,1,0
8569,1543,0,0,137,137,0,1,0,1,0
7500,2758,0,0,80,80,0,1,0,1,0
7703,2434,0,0,96,96,0,1,0,1,0
1631,3095,0,0,143,143,0,1,0,1,0
1799,940,0,0,85,85,0,1,0,1,0
8301,1429,0,0,149,149,0,1,0,1,0
2907,1429,0,0,105,105,0,1,0,1,0
1728,704,0,0,146,146,0,1,0,1,0
1000,2872,0,0,143,143,0,1,0,1,0
1426,183,4959,121,293,223,70,4,0,3,1
2009,976,0,0,62,62,0,1,0,1,0
3821,322,0,0,129,129,0,1,0,1,0
1438,1171,0,0,137,137,0,1,0,1,0
2241,1176,0,0,144,144,0,1,0,1,0
2561,1464,0,0,100,100,0,1,0,1,0
3366,183,11889,121,293,223,70,4,1,3,1
1839,961,0,0,144,144,0,1,0,1,0
1427,183,4961,121,293,223,70,4,1,3,1
1424,424,1076,36,191,170,21,1,0,1,0
2061,183,8132,121,293,223,70,4,0,3,1
10020,1430,0,0,91,91,0,1,0,1,0
743,3095,0,0,139,139,0,1,0,1,0
8264,1305,0,0,154,154,0,1,0,1,0
8019,1607,0,0,135,135,0,1,0,1,0
1424,3095,0,0,139,139,0,1,0,1,0
9398,1614,0,0,107,107,0,1,0,1,0
5696,250,0,0,146,146,0,1,0,1,0
1952,913,0,0,79,79,0,1,0,1,0
11248,1633,0,0,62,62,0,1,0,1,0
177,2155,0,0,146,146,0,1,0,1,0
20713,2018,0,0,87,87,0,1,0,1,0
713,2889,0,0,140,140,0,1,0,1,0
1731,3095,0,0,146,146,0,1,0,1,0
2080,1176,0,0,143,143,0,1,0,1,0
963,3095,0,0,139,139,0,1,0,1,0
4031,374,0,0,140,140,0,1,0,1,0
1683,1014,0,0,102,102,0,1,0,1,0
1097,3095,0,0,139,139,0,1,0,1,0
8252,1216,0,0,155,155,0,1,0,1,0
1626,3095,0,0,143,143,0,1,0,1,0
1552,183,5563,121,293,223,70,4,0,3,1
2053,1556,0,0,82,82,0,1,0,1,0
7692,2240,0,0,103,103,0,1,0,1,0
10281,1581,0,0,71,71,0,1,0,1,0
709,802,0,0,153,153,0,1,0,1,0
2541,1369,0,0,62,62,0,1,0,1,0
2996,119,0,0,86,86,0,1,0,1,0
1905,873,0,0,69,69,0,1,0,1,0
1509,1126,0,0,127,127,0,1,0,1,0
10382,1543,0,0,71,71,0,1,0,1,0
3016,1672,0,0,62,62,0,1,0,1,0
2138,230,0,0,99,99,0,1,0,1,0
1746,747,0,0,146,146,0,1,0,1,0
12997,532,0,0,145,145,0,1,0,1,0
14187,274,0,0,145,145,0,1,0,1,0
1707,999,0,0,98,98,0,1,0,1,0
2113,1259,0,0,129,129,0,1,0,1,0
8249,1213,0,0,156,156,0,1,0,1,0
1984,799,0,0,62,62,0,1,0,1,0
10583,1510,0,0,70,70,0,1,0,1,0
1523,1176,0,0,139,139,0,1,0,1,0
489,1755,0,0,151,151,0,1,0,1,0
1021,3095,0,0,140,140,0,1,0,1,0
1474,183,5192,121,293,223,70,4,0,3,1
467,872,0,0,154,154,0,1,0,1,0
587,1176,0,0,150,150,0,1,0,1,0
8327,1586,0,0,146,146,0,1,0,1,0
2050,1554,0,0,82,82,0,1,0,1,0
2063,680,0,0,62,62,0,1,0,1,0
2876,1207,0,0,142,142,0,1,0,1,0
7686,2252,0,0,102,102,0,1,0,1,0
1586,721,0,0,145,145,0,1,0,1,0
2700,546,0,0,101,101,0,1,0,1,0
816,1140,0,0,156,156,0,1,0,1,0
2157,183,8683,121,293,223,70,4,0,3,1
1329,183,4478,121,293,223,70,4,0,3,1
434,1176,0,0,142,142,0,1,0,1,0
5000,480,0,0,146,146,0,1,0,1,0
1416,3095,0,0,139,139,0,1,0,1,0
1469,1064,0,0,140,140,0,1,0,1,0
2176,207,0,0,95,95,0,1,0,1,0
1406,3095,0,0,140,140,0,1,0,1,0
12273,1313,0,0,83,83,0,1,0,1,0
7105,183,18099,121,293,223,70,4,0,3,1
197,2303,0,0,145,145,0,1,0,1,0
1865,183,7225,121,293,223,70,4,0,3,1
3639,928,0,0,111,111,0,1,0,1,0
7010,971,0,0,146,146,0,1,0,1,0
5005,183,16550,121,293,223,70,4,1,3,1
2552,1694,0,0,62,62,0,1,0,1,0
8707,1560,0,0,136,136,0,1,0,1,0
2214,183,9023,121,293,223,70,4,0,3,1
78,1010,0,0,156,156,0,1,0,1,0
8327,1596,0,0,146,146,0,1,0,1,0
1406,1176,0,0,139,139,0,1,0,1,0
1902,183,7294,121,293,223,70,4,0,3,1
16277,1623,0,0,62,62,0,1,0,1,0
8736,1543,0,0,132,132,0,1,0,1,0
10691,1543,0,0,64,64,0,1,0,1,0
7986,2029,0,0,118,118,0,1,0,1,0
5430,275,0,0,146,146,0,1,0,1,0
1627,183,5936,121,293,223,70,4,0,3,1
253,2245,0,0,146,146,0,1,0,1,0
8327,1580,0,0,146,146,0,1,0,1,0
1444,183,5043,121,293,223,70,4,1,3,1
2162,183,8730,121,293,223,70,4,0,3,1
2680,1694,0,0,62,62,0,1,0,1,0
2012,757,0,0,62,62,0,1,0,1,0
1782,183,6732,121,293,223,70,4,0,3,1
1183,3095,0,0,142,142,0,1,0,1,0
4699,183,16170,121,293,223,70,4,1,3,1
792,1176,0,0,156,156,0,1,0,1,0
2571,1694,0,0,62,62,0,1,0,1,0
810,840,1210,40,203,179,23,2,0,1,0
8252,1237,0,0,155,155,0,1,0,1,0
1456,1101,0,0,140,140,0,1,0,1,0
9988,1478,0,0,86,86,0,1,0,1,0
486,2768,0,0,141,141,0,1,0,1,0
2220,183,9049,121,293,223,70,4,0,3,1
7809,1288,0,0,146,146,0,1,0,1,0
3024,1694,0,0,62,62,0,1,0,1,0
7804,2366,0,0,104,104,0,1,0,1,0
355,2448,0,0,144,144,0,1,0,1,0
1545,1246,0,0,128,128,0,1,0,1,0
1392,183,4935,121,293,223,70,4,1,3,1
1719,183,6382,121,293,223,70,4,0,3,1
1770,183,6634,121,293,223,70,4,0,3,1
2956,1694,0,0,62,62,0,1,0,1,0
453,1131,0,0,143,143,0,1,0,1,0
2357,1403,0,0,107,107,0,1,0,1,0
1336,183,4515,121,293,223,70,4,0,3,1
8327,1596,0,0,146,146,0,1,0,1,0
16210,183,24750,121,293,223,70,4,0,3,1
1643,3095,0,0,148,148,0,1,0,1,0
1649,535,0,0,147,147,0,1,0,1,0
91,1537,0,0,152,152,0,1,0,1,0
449,2713,0,0,142,142,0,1,0,1,0
1517,921,0,0,142,142,0,1,0,1,0
2189,1640,0,0,70,70,0,1,0,1,0
928,2825,0,0,143,143,0,1,0,1,0
8777,1694,0,0,134,134,0,1,0,1,0
5877,349,0,0,146,146,0,1,0,1,0
16727,2759,0,0,129,129,0,1,0,1,0
8716,1543,0,0,132,132,0,1,0,1,0
1403,1176,0,0,149,149,0,1,0,1,0
10931,1615,0,0,67,67,0,1,0,1,0
1486,453,784,26,179,164,15,1,0,1,0
11295,1642,0,0,62,62,0,1,0,1,0
8027,1971,0,0,122,122,0,1,0,1,0
1717,183,6458,121,293,223,70,4,0,3,1
8029,1588,0,0,136,136,0,1,0,1,0
1129,911,0,0,153,153,0,1,0,1,0
2106,1257,0,0,130,130,0,1,0,1,0
2210,183,9022,121,293,223,70,4,0,3,1
2828,920,0,0,129,129,0,1,0,1,0
1756,968,0,0,91,91,0,1,0,1,0
2349,977,0,0,97,97,0,1,0,1,0
1374,183,4694,121,293,223,70,4,0,3,1
8013,1388,0,0,146,146,0,1,0,1,0
1385,3095,0,0,139,139,0,1,0,1,0
4855,332,0,0,146,146,0,1,0,1,0
1502,183,5338,121,293,223,70,4,0,3,1
7648,2514,0,0,91,91,0,1,0,1,0
2061,876,0,0,71,71,0,1,0,1,0
2189,491,0,0,62,62,0,1,0,1,0
2062,3095,0,0,154,154,0,1,0,1,0
20959,1900,0,0,81,81,0,1,0,1,0
3539,1114,0,0,99,99,0,1,0,1,0
15405,183,24162,121,293,223,70,4,0,3,1
1802,183,7365,121,293,223,70,4,0,3,1
2408,214,0,0,76,76,0,1,0,1,0
1928,183,7568,121,293,223,70,4,0,3,1
2785,793,0,0,119,119,0,1,0,1,0
1465,183,5136,121,293,223,70,4,0,3,1
1012,997,0,0,154,154,0,1,0,1,0
133,1840,0,0,149,149,0,1,0,1,0
1349,3095,0,0,139,139,0,1,0,1,0
12819,1027,0,0,100,100,0,1,0,1,0
7403,2798,0,0,74,74,0,1,0,1,0
2146,1613,0,0,73,73,0,1,0,1,0
1827,421,0,0,130,130,0,1,0,1,0
2084,183,8265,121,293,223,70,4,0,3,1
13019,725,0,0,114,114,0,1,0,1,0
1615,3095,0,0,143,143,0,1,0,1,0
7675,2475,0,0,93,93,0,1,0,1,0
18646,183,26529,121,293,223,70,4,0,3,1
21439,1669,0,0,68,68,0,1,0,1,0
1406,2994,0,0,137,137,0,1,0,1,0
1505,183,5333,121,293,223,70,4,0,3,1
9660,1594,0,0,97,97,0,1,0,1,0
979,183,3742,121,293,223,70,4,1,3,1
1889,183,7354,121,293,223,70,4,0,3,1
1797,183,6872,121,293,223,70,4,0,3,1
10429,1543,0,0,70,70,0,1,0,1,0
8316,1628,0,0,147,147,0,1,0,1,0
9476,1974,0,0,69,69,0,1,0,1,0
581,2909,0,0,140,140,0,1,0,1,0
9619,1598,0,0,98,98,0,1,0,1,0
2957,1653,0,0,68,68,0,1,0,1,0
204,2349,0,0,144,144,0,1,0,1,0
7236,1095,0,0,146,146,0,1,0,1,0
10768,1594,0,0,68,68,0,1,0,1,0
4962,183,16395,121,293,223,70,4,0,3,1
4026,183,14232,121,293,223,70,4,1,3,1
1442,183,5025,121,293,223,70,4,0,3,1
5805,303,0,0,146,146,0,1,0,1,0
1410,283,3110,85,250,201,49,3,0,2,0
2626,183,9928,121,293,223,70,4,0,3,1
2660,1392,0,0,62,62,0,1,0,1,0
768,973,0,0,144,144,0,1,0,1,0
2397,1694,0,0,62,62,0,1,0,1,0
1047,1176,0,0,140,140,0,1,0,1,0
243,937,0,0,155,155,0,1,0,1,0
7315,2990,0,0,65,65,0,1,0,1,0
1570,3095,0,0,147,147,0,1,0,1,0
1224,3095,0,0,142,142,0,1,0,1,0
1342,3095,0,0,142,142,0,1,0,1,0
2604,183,9626,121,293,223,70,4,0,3,1
9346,1590,0,0,119,119,0,1,0,1,0
19869,2426,0,0,109,109,0,1,0,1,0
3507,183,12058,121,293,223,70,4,0,3,1
1144,183,4259,121,293,223,70,4,1,3,1
9632,1597,0,0,98,98,0,1,0,1,0
8532,1543,0,0,139,139,0,1,0,1,0
1548,1176,0,0,139,139,0,1,0,1,0
2273,1176,0,0,144,144,0,1,0,1,0
1428,183,4956,121,293,223,70,4,0,3,1
473,2748,0,0,141,141,0,1,0,1,0
2114,3095,0,0,157,157,0,1,0,1,0
2251,2797,0,0,138,138,0,1,0,1,0
2513,1176,0,0,145,145,0,1,0,1,0
1187,762,0,0,146,146,0,1,0,1,0
15195,854,0,0,145,145,0,1,0,1,0
516,1176,0,0,148,148,0,1,0,1,0
11264,1658,0,0,64,64,0,1,0,1,0
2859,1176,0,0,147,147,0,1,0,1,0
8131,1391,0,0,146,146,0,1,0,1,0
1560,183,6031,121,293,223,70,4,0,3,1
21489,1546,0,0,62,62,0,1,0,1,0
12665,604,0,0,145,145,0,1,0,1,0
1302,3095,0,0,142,142,0,1,0,1,0
2089,260,0,0,104,104,0,1,0,1,0
1714,183,6397,121,293,223,70,4,0,3,1
11087,1672,0,0,73,73,0,1,0,1,0
2271,1684,0,0,63,63,0,1,0,1,0
2713,1594,0,0,77,77,0,1,0,1,0
1788,3095,0,0,150,150,0,1,0,1,0
399,2477,0,0,144,144,0,1,0,1,0
2274,1823,0,0,70,70,0,1,0,1,0
363,2453,0,0,144,144,0,1,0,1,0
16468,183,24860,121,293,223,70,4,0,3,1
8485,1543,0,0,140,140,0,1,0,1,0
19188,183,26341,121,293,223,70,4,0,3,1
1511,183,5383,121,293,223,70,4,0,3,1
2095,1251,0,0,131,131,0,1,0,1,0
289,2405,0,0,144,144,0,1,0,1,0
2060,1176,0,0,143,143,0,1,0,1,0
1533,183,5481,121,293,223,70,4,0,3,1
4150,183,13965,121,293,223,70,4,0,3,1
2762,1694,0,0,62,62,0,1,0,1,0
2753,1562,0,0,62,62,0,1,0,1,0
21313,1730,0,0,72,72,0,1,0,1,0
2460,1545,0,0,86,86,0,1,0,1,0
21461,747,16653,70,197,156,40,2,0,2,0
1635,183,5978,121,293,223,70,4,0,3,1
406,1092,0,0,157,157,0,1,0,1,0
3425,183,12343,121,293,223,70,4,0,3,1
18652,3012,0,0,140,140,0,1,0,1,0
2548,1474,0,0,98,98,0,1,0,1,0
5472,271,0,0,146,146,0,1,0,1,0
2273,1701,0,0,62,62,0,1,0,1,0
1739,841,0,0,117,117,0,1,0,1,0
1805,183,6807,121,293,223,70,4,0,3,1
10503,1543,0,0,68,68,0,1,0,1,0
2065,183,8266,121,293,223,70,4,0,3,1
1944,183,7498,121,293,223,70,4,0,3,1
2398,234,0,0,78,78,0,1,0,1,0
2140,1487,0,0,94,94,0,1,0,1,0
8141,2625,0,0,64,64,0,1,0,1,0
2236,1631,0,0,71,71,0,1,0,1,0
1973,183,7654,121,293,223,70,4,0,3,1
496,1110,0,0,143,143,0,1,0,1,0
1867,1025,0,0,144,144,0,1,0,1,0
6747,766,0,0,146,146,0,1,0,1,0
1967,183,7659,121,293,223,70,4,0,3,1
2246,404,0,0,62,62,0,1,0,1,0
8576,1223,0,0,144,144,0,1,0,1,0
1333,183,4492,121,293,223,70,4,0,3,1
9657,1378,0,0,104,104,0,1,0,1,0
1747,748,0,0,146,146,0,1,0,1,0
1691,183,6279,121,293,223,70,4,0,3,1
576,2901,0,0,140,140,0,1,0,1,0
15509,2493,0,0,112,112,0,1,0,1,0
1891,183,7363,121,293,223,70,4,0,3,1
1947,829,0,0,64,64,0,1,0,1,0
1929,3095,0,0,153,153,0,1,0,1,0
2539,1458,0,0,98,98,0,1,0,1,0
212,1047,0,0,157,157,0,1,0,1,0
2391,1233,0,0,62,62,0,1,0,1,0
1963,183,7741,121,293,223,70,4,0,3,1
1507,634,0,0,149,149,0,1,0,1,0
11592,183,18199,121,293,223,70,4,0,3,1
11080,1680,0,0,78,78,0,1,0,1,0
3374,1022,0,0,147,147,0,1,0,1,0
1972,817,0,0,62,62,0,1,0,1,0
8278,1396,0,0,152,152,0,1,0,1,0
1631,589,0,0,147,147,0,1,0,1,0
124,1056,0,0,152,152,0,1,0,1,0
2240,1593,0,0,62,62,0,1,0,1,0
11196,1622,0,0,62,62,0,1,0,1,0
186,2222,0,0,146,146,0,1,0,1,0
2044,1176,0,0,143,143,0,1,0,1,0
780,3095,0,0,139,139,0,1,0,1,0
2905,1184,0,0,146,146,0,1,0,1,0
2817,1694,0,0,62,62,0,1,0,1,0
16985,2792,0,0,128,128,0,1,0,1,0
9624,1543,0,0,102,102,0,1,0,1,0
1713,996,0,0,97,97,0,1,0,1,0
2176,183,8793,121,293,223,70,4,0,3,1
17410,792,0,0,110,110,0,1,0,1,0
4268,183,14127,121,293,223,70,4,1,3,1
2128,183,8519,121,293,223,70,4,0,3,1
8327,1677,0,0,146,146,0,1,0,1,0
154,1070,0,0,151,151,0,1,0,1,0
1913,1130,0,0,143,143,0,1,0,1,0
413,1176,0,0,144,144,0,1,0,1,0
8297,1415,0,0,149,149,0,1,0,1,0
9144,1543,0,0,116,116,0,1,0,1,0
604,2612,0,0,144,144,0,1,0,1,0
1945,1003,0,0,101,101,0,1,0,1,0
992,3095,0,0,140,140,0,1,0,1,0
33,1010,0,0,156,156,0,1,0,1,0
315,1542,0,0,143,143,0,1,0,1,0
773,1176,0,0,156,156,0,1,0,1,0
10777,1543,0,0,62,62,0,1,0,1,0
671,1176,0,0,153,153,0,1,0,1,0
1997,871,0,0,62,62,0,1,0,1,0
10588,183,17668,121,293,223,70,4,0,3,1
9788,1543,0,0,96,96,0,1,0,1,0
17305,183,25485,121,293,223,70,4,0,3,1
1584,183,5792,121,293,223,70,4,0,3,1
1718,183,6417,121,293,223,70,4,0,3,1
5386,279,0,0,146,146,0,1,0,1,0
9547,1362,0,0,108,108,0,1,0,1,0
20194,2269,0,0,100,100,0,1,0,1,0
2128,1469,0,0,97,97,0,1,0,1,0
10235,1632,0,0,96,96,0,1,0,1,0
8176,1305,0,0,150,150,0,1,0,1,0
1607,1176,0,0,140,140,0,1,0,1,0
215,1101,0,0,149,149,0,1,0,1,0
1025,3095,0,0,139,139,0,1,0,1,0
9419,1612,0,0,106,106,0,1,0,1,0
1944,183,7496,121,293,223,70,4,0,3,1
8327,1671,0,0,146,146,0,1,0,1,0
8252,1237,0,0,155,155,0,1,0,1,0
1989,1260,0,0,129,129,0,1,0,1,0
20866,1945,0,0,83,83,0,1,0,1,0
42,1015,0,0,156,156,0,1,0,1,0
21474,789,15758,66,189,151,38,2,0,2,0
1344,183,4547,121,293,223,70,4,1,3,1
21400,544,20887,88,231,180,51,3,0,2,0
2899,1690,0,0,62,62,0,1,0,1,0
3502,1157,0,0,96,96,0,1,0,1,0
2541,1694,0,0,62,62,0,1,0,1,0
1894,3095,0,0,154,154,0,1,0,1,0
10119,1584,0,0,85,85,0,1,0,1,0
2433,1176,0,0,145,145,0,1,0,1,0
624,2973,0,0,139,139,0,1,0,1,0
2999,183,10935,121,293,223,70,4,0,3,1
836,637,1942,65,230,192,37,2,0,2,0
2146,1342,0,0,62,62,0,1,0,1,0
686,3064,0,0,139,139,0,1,0,1,0
1093,1176,0,0,148,148,0,1,0,1,0
1712,183,6349,121,293,223,70,4,0,3,1
1734,718,0,0,146,146,0,1,0,1,0
497,1737,0,0,151,151,0,1,0,1,0
1053,183,3886,121,293,223,70,4,1,3,1
274,2201,0,0,146,146,0,1,0,1,0
4168,183,14735,121,293,223,70,4,1,3,1
9042,1576,0,0,127,127,0,1,0,1,0
2738,656,0,0,109,109,0,1,0,1,0
1588,715,0,0,145,145,0,1,0,1,0
937,1176,0,0,152,152,0,1,0,1,0
1483,652,0,0,149,149,0,1,0,1,0
8355,1543,0,0,145,145,0,1,0,1,0
7445,2803,0,0,75,75,0,1,0,1,0
1308,3095,0,0,142,142,0,1,0,1,0
20330,183,27445,121,293,223,70,4,0,3,1
11843,1689,0,0,62,62,0,1,0,1,0
263,2385,0,0,144,144,0,1,0,1,0
3742,877,0,0,115,115,0,1,0,1,0
914,183,3617,121,293,223,70,4,1,3,1
2915,1185,0,0,146,146,0,1,0,1,0
103,1618,0,0,151,151,0,1,0,1,0
2631,1176,0,0,146,146,0,1,0,1,0
1869,3095,0,0,154,154,0,1,0,1,0
2642,1398,0,0,111,111,0,1,0,1,0
1761,781,0,0,146,146,0,1,0,1,0
2199,193,0,0,93,93,0,1,0,1,0
1384,406,1265,42,199,174,24,2,0,1,0
1943,1028,0,0,107,107,0,1,0,1,0
3877,682,0,0,127,127,0,1,0,1,0
1334,3095,0,0,142,142,0,1,0,1,0
752,3095,0,0,139,139,0,1,0,1,0
8859,1661,0,0,127,127,0,1,0,1,0
8339,1543,0,0,145,145,0,1,0,1,0
2939,1694,0,0,62,62,0,1,0,1,0
8236,1810,0,0,138,138,0,1,0,1,0
1686,183,6256,121,293,223,70,4,0,3,1
20353,1307,0,0,77,77,0,1,0,1,0
1925,1159,0,0,143,143,0,1,0,1,0
322,1492,0,0,143,143,0,1,0,1,0
2136,183,7520,121,293,223,70,4,1,3,1
805,1176,0,0,155,155,0,1,0,1,0
8617,183,19203,121,293,223,70,4,0,3,1
1411,3095,0,0,139,139,0,1,0,1,0
1665,542,0,0,144,144,0,1,0,1,0
1702,183,6950,121,293,223,70,4,0,3,1
11941,1123,0,0,88,88,0,1,0,1,0
1602,183,5816,121,293,223,70,4,0,3,1
1701,3095,0,0,145,145,0,1,0,1,0
4106,451,0,0,142,142,0,1,0,1,0
10603,1573,0,0,69,69,0,1,0,1,0
2142,1490,0,0,93,93,0,1,0,1,0
1417,183,4908,121,293,223,70,4,1,3,1
2722,183,10233,121,293,223,70,4,0,3,1
1540,1242,0,0,129,129,0,1,0,1,0
2474,80,0,0,67,67,0,1,0,1,0
2361,94,0,0,77,77,0,1,0,1,0
8207,1847,0,0,136,136,0,1,0,1,0
1579,183,6102,121,293,223,70,4,0,3,1
630,2981,0,0,139,139,0,1,0,1,0
999,183,4017,121,293,223,70,4,0,3,1
3736,883,0,0,114,114,0,1,0,1,0
1910,1123,0,0,143,143,0,1,0,1,0
5128,183,11358,121,293,223,70,4,0,3,1
2185,496,0,0,62,62,0,1,0,1,0
2118,1176,0,0,143,143,0,1,0,1,0
9861,1786,0,0,70,70,0,1,0,1,0
2289,1176,0,0,144,144,0,1,0,1,0
8180,1882,0,0,134,134,0,1,0,1,0
2997,1694,0,0,62,62,0,1,0,1,0
14981,709,0,0,145,145,0,1,0,1,0
1215,1176,0,0,144,144,0,1,0,1,0
15435,1636,0,0,62,62,0,1,0,1,0
2754,703,0,0,113,113,0,1,0,1,0
2900,1638,0,0,71,71,0,1,0,1,0
19017,2836,0,0,131,131,0,1,0,1,0
2069,1138,0,0,62,62,0,1,0,1,0
1411,183,4880,121,293,223,70,4,1,3,1
7501,2723,0,0,80,80,0,1,0,1,0
2016,540,0,0,97,97,0,1,0,1,0
2293,446,0,0,92,92,0,1,0,1,0
2082,1172,0,0,62,62,0,1,0,1,0
1318,3095,0,0,142,142,0,1,0,1,0
2045,1228,0,0,134,134,0,1,0,1,0
1999,183,7815,121,293,223,70,4,0,3,1
6936,2451,0,0,79,79,0,1,0,1,0
8256,1259,0,0,155,155,0,1,0,1,0
7513,2586,0,0,85,85,0,1,0,1,0
2178,1545,0,0,85,85,0,1,0,1,0
472,1122,0,0,143,143,0,1,0,1,0
10911,1694,0,0,78,78,0,1,0,1,0
1703,647,0,0,147,147,0,1,0,1,0
1603,3095,0,0,143,143,0,1,0,1,0
11395,1674,0,0,63,63,0,1,0,1,0
1682,510,0,0,144,144,0,1,0,1,0
2002,183,7809,121,293,223,70,4,0,3,1
2741,1456,0,0,62,62,0,1,0,1,0
1587,183,5735,121,293,223,70,4,0,3,1
300,1068,0,0,157,157,0,1,0,1,0
2361,94,0,0,77,77,0,1,0,1,0
16518,1757,0,0,145,145,0,1,0,1,0
9580,1407,0,0,103,103,0,1,0,1,0
1483,1176,0,0,139,139,0,1,0,1,0
697,3080,0,0,139,139,0,1,0,1,0
777,1168,0,0,156,156,0,1,0,1,0
10279,1549,0,0,74,74,0,1,0,1,0
1367,3095,0,0,141,141,0,1,0,1,0
10637,1543,0,0,65,65,0,1,0,1,0
2898,183,11165,121,293,223,70,4,0,3,1
1379,183,4720,121,293,223,70,4,1,3,1
198,1092,0,0,149,149,0,1,0,1,0
21602,1214,6884,29,117,100,16,1,0,1,0
2865,1028,0,0,137,137,0,1,0,1,0
367,2591,0,0,143,143,0,1,0,1,0
311,2507,0,0,143,143,0,1,0,1,0
1889,183,7212,121,293,223,70,4,0,3,1
4561,183,15998,121,293,223,70,4,1,3,1
2479,52,0,0,62,62,0,1,0,1,0
635,1145,0,0,157,157,0,1,0,1,0
18773,2954,0,0,137,137,0,1,0,1,0
2900,1653,0,0,68,68,0,1,0,1,0
4991,183,16457,121,293,223,70,4,0,3,1
7588,2440,0,0,92,92,0,1,0,1,0
2801,1580,0,0,79,79,0,1,0,1,0
1412,704,0,0,150,150,0,1,0,1,0
2063,1246,0,0,132,132,0,1,0,1,0
303,1629,0,0,143,143,0,1,0,1,0
10483,1558,0,0,70,70,0,1,0,1,0
8249,1203,0,0,156,156,0,1,0,1,0
2726,2064,0,0,87,87,0,1,0,1,0
2064,1237,0,0,133,133,0,1,0,1,0
1692,183,6252,121,293,223,70,4,0,3,1
16099,1471,0,0,145,145,0,1,0,1,0
19779,2469,0,0,111,111,0,1,0,1,0
10769,1543,0,0,62,62,0,1,0,1,0
1477,2887,0,0,131,131,0,1,0,1,0
4548,183,15982,121,293,223,70,4,1,3,1
9671,1543,0,0,100,100,0,1,0,1,0
11074,948,0,0,145,145,0,1,0,1,0
680,1357,0,0,155,155,0,1,0,1,0
10773,1543,0,0,62,62,0,1,0,1,0
1217,846,0,0,152,152,0,1,0,1,0
9562,1404,0,0,104,104,0,1,0,1,0
2900,1634,0,0,71,71,0,1,0,1,0
2381,1694,0,0,62,62,0,1,0,1,0
1709,998,0,0,98,98,0,1,0,1,0
7817,183,14873,121,293,223,70,4,0,3,1
854,1176,0,0,141,141,0,1,0,1,0
1676,183,6204,121,293,223,70,4,0,3,1
1545,3095,0,0,146,146,0,1,0,1,0
8325,1536,0,0,146,146,0,1,0,1,0
1928,3095,0,0,153,153,0,1,0,1,0
2256,183,9255,121,293,223,70,4,0,3,1
13824,501,0,0,130,130,0,1,0,1,0
8002,2006,0,0,120,120,0,1,0,1,0
3730,835,0,0,117,117,0,1,0,1,0
3080,183,10873,121,293,223,70,4,1,3,1
2229,1621,0,0,73,73,0,1,0,1,0
8082,2008,0,0,126,126,0,1,0,1,0
360,1217,0,0,143,143,0,1,0,1,0
1954,884,0,0,72,72,0,1,0,1,0
2951,1694,0,0,62,62,0,1,0,1,0
10399,1543,0,0,75,75,0,1,0,1,0
8327,1544,0,0,146,146,0,1,0,1,0
185,1041,0,0,157,157,0,1,0,1,0
2053,283,0,0,107,107,0,1,0,1,0
10884,1558,0,0,62,62,0,1,0,1,0
1577,3095,0,0,142,142,0,1,0,1,0
2262,1652,0,0,62,62,0,1,0,1,0
2142,183,8670,121,293,223,70,4,0,3,1
88,1514,0,0,152,152,0,1,0,1,0
7053,995,0,0,146,146,0,1,0,1,0
2966,1381,0,0,113,113,0,1,0,1,0
97,1021,0,0,157,157,0,1,0,1,0
8878,1660,0,0,127,127,0,1,0,1,0
1415,183,4906,121,293,223,70,4,0,3,1
1985,324,0,0,114,114,0,1,0,1,0
21066,1432,0,0,69,69,0,1,0,1,0
1624,183,5942,121,293,223,70,4,0,3,1
1887,183,7207,121,293,223,70,4,0,3,1
10253,1550,0,0,75,75,0,1,0,1,0
17228,2240,0,0,145,145,0,1,0,1,0
4713,183,16187,121,293,223,70,4,1,3,1
2909,1368,0,0,115,115,0,1,0,1,0
21567,1607,0,0,65,65,0,1,0,1,0
2052,183,8083,121,293,223,70,4,0,3,1
2966,183,9952,121,293,223,70,4,1,3,1
2491,46,0,0,65,65,0,1,0,1,0
317,2418,0,0,144,144,0,1,0,1,0
5024,183,16557,121,293,223,70,4,0,3,1
2345,1694,0,0,62,62,0,1,0,1,0
1231,183,4495,121,293,223,70,4,1,3,1
2899,1671,0,0,65,65,0,1,0,1,0
1149,2970,0,0,143,143,0,1,0,1,0
992,2828,0,0,141,141,0,1,0,1,0
2232,1571,0,0,62,62,0,1,0,1,0
2343,1640,0,0,70,70,0,1,0,1,0
1286,3095,0,0,139,139,0,1,0,1,0
2428,1694,0,0,62,62,0,1,0,1,0
9679,1543,0,0,96,96,0,1,0,1,0
2238,558,0,0,100,100,0,1,0,1,0
8327,1576,0,0,146,146,0,1,0,1,0
751,1692,0,0,152,152,0,1,0,1,0
1450,3095,0,0,144,144,0,1,0,1,0
69,1028,0,0,154,154,0,1,0,1,0
8530,2435,0,0,66,66,0,1,0,1,0
20643,183,27978,121,293,223,70,4,0,3,1
691,1176,0,0,154,154,0,1,0,1,0
1950,1176,0,0,143,143,0,1,0,1,0
464,1105,0,0,157,157,0,1,0,1,0
3605,1036,0,0,104,104,0,1,0,1,0
1481,183,5226,121,293,223,70,4,0,3,1
3699,866,0,0,115,115,0,1,0,1,0
10659,1543,0,0,65,65,0,1,0,1,0
1456,183,5106,121,293,223,70,4,1,3,1
8278,1331,0,0,152,152,0,1,0,1,0
4002,813,0,0,147,147,0,1,0,1,0
5815,315,0,0,146,146,0,1,0,1,0
2794,1176,0,0,147,147,0,1,0,1,0
716,3095,0,0,139,139,0,1,0,1,0
2610,1694,0,0,62,62,0,1,0,1,0
3921,667,0,0,128,128,0,1,0,1,0
2190,183,8875,121,293,223,70,4,0,3,1
2899,1678,0,0,64,64,0,1,0,1,0
1807,687,0,0,104,104,0,1,0,1,0
8014,1617,0,0,134,134,0,1,0,1,0
501,1730,0,0,151,151,0,1,0,1,0
12636,1912,0,0,81,81,0,1,0,1,0
2023,183,7922,121,293,223,70,4,0,3,1
2002,183,7829,121,293,223,70,4,0,3,1
1573,3095,0,0,142,142,0,1,0,1,0
2114,183,8435,121,293,223,70,4,0,3,1
5651,253,0,0,146,146,0,1,0,1,0
7357,2929,0,0,68,68,0,1,0,1,0
7923,2213,0,0,113,113,0,1,0,1,0
1336,183,4508,121,293,223,70,4,1,3,1
2982,1694,0,0,62,62,0,1,0,1,0
2120,1272,0,0,62,62,0,1,0,1,0
11285,1694,0,0,68,68,0,1,0,1,0
71,1391,0,0,153,153,0,1,0,1,0
1524,183,5454,121,293,223,70,4,0,3,1
5187,418,0,0,146,146,0,1,0,1,0
973,183,3905,121,293,223,70,4,0,3,1
1376,3095,0,0,141,141,0,1,0,1,0
2948,1305,0,0,126,126,0,1,0,1,0
1379,183,4725,121,293,223,70,4,0,3,1
1100,183,4139,121,293,223,70,4,1,3,1
1639,2751,0,0,120,120,0,1,0,1,0
8883,2263,0,0,67,67,0,1,0,1,0
6697,742,0,0,146,146,0,1,0,1,0
1664,3095,0,0,148,148,0,1,0,1,0
3174,183,11985,121,293,223,70,4,0,3,1
18319,2984,0,0,145,145,0,1,0,1,0
18630,183,26474,121,293,223,70,4,0,3,1
1351,3095,0,0,143,143,0,1,0,1,0
9717,1543,0,0,95,95,0,1,0,1,0
2232,183,8294,121,293,223,70,4,0,3,1
1994,1268,0,0,128,128,0,1,0,1,0
1965,337,0,0,116,116,0,1,0,1,0
8276,1380,0,0,152,152,0,1,0,1,0
2243,183,9186,121,293,223,70,4,0,3,1
1884,2345,0,0,97,97,0,1,0,1,0
10411,1486,0,0,76,76,0,1,0,1,0
2637,1554,0,0,83,83,0,1,0,1,0
2687,183,10399,121,293,223,70,4,0,3,1
2540,1044,0,0,114,114,0,1,0,1,0
1497,606,0,0,147,147,0,1,0,1,0
707,3079,0,0,139,139,0,1,0,1,0
1913,1131,0,0,143,143,0,1,0,1,0
2239,183,7885,121,293,223,70,4,1,3,1
2207,3095,0,0,158,158,0,1,0,1,0
1403,1176,0,0,149,149,0,1,0,1,0
8317,1499,0,0,147,147,0,1,0,1,0
1265,1176,0,0,143,143,0,1,0,1,0
4834,535,0,0,146,146,0,1,0,1,0
3026,1561,0,0,70,70,0,1,0,1,0
4579,620,0,0,146,146,0,1,0,1,0
459,2516,0,0,144,144,0,1,0,1,0
2979,1431,0,0,105,105,0,1,0,1,0
2853,1694,0,0,62,62,0,1,0,1,0
1286,3006,0,0,139,139,0,1,0,1,0
11201,1543,0,0,62,62,0,1,0,1,0
2161,1382,0,0,62,62,0,1,0,1,0
2663,1694,0,0,62,62,0,1,0,1,0
2917,1180,0,0,147,147,0,1,0,1,0
1305,1176,0,0,139,139,0,1,0,1,0
15829,515,0,0,127,127,0,1,0,1,0
8053,1933,0,0,124,124,0,1,0,1,0
2289,1694,0,0,62,62,0,1,0,1,0
1965,183,7612,121,293,223,70,4,0,3,1
1010,3095,0,0,142,142,0,1,0,1,0
7618,2606,0,0,89,89,0,1,0,1,0
5480,270,0,0,146,146,0,1,0,1,0
1393,183,4790,121,293,223,70,4,1,3,1
1432,1170,0,0,139,139,0,1,0,1,0
2560,183,9571,121,293,223,70,4,0,3,1
8255,1230,0,0,155,155,0,1,0,1,0
10661,1543,0,0,65,65,0,1,0,1,0
15365,970,0,0,145,145,0,1,0,1,0
14155,183,23248,121,293,223,70,4,0,3,1
2905,1487,0,0,96,96,0,1,0,1,0
1600,476,662,18,169,159,10,1,0,1,0
2622,316,0,0,85,85,0,1,0,1,0
2212,183,9029,121,293,223,70,4,0,3,1
1821,3095,0,0,151,151,0,1,0,1,0
3684,882,0,0,114,114,0,1,0,1,0
16969,2064,0,0,145,145,0,1,0,1,0
9497,1622,0,0,106,106,0,1,0,1,0
7843,1948,0,0,117,117,0,1,0,1,0
2463,2626,0,0,126,126,0,1,0,1,0
1386,183,4754,121,293,223,70,4,1,3,1
20128,2301,0,0,102,102,0,1,0,1,0
4692,348,0,0,146,146,0,1,0,1,0
808,3095,0,0,140,140,0,1,0,1,0
965,183,3771,121,293,223,70,4,1,3,1
296,1141,0,0,145,145,0,1,0,1,0
1624,1176,0,0,140,140,0,1,0,1,0
15809,183,22933,121,293,223,70,4,0,3,1
1331,1176,0,0,150,150,0,1,0,1,0
12410,659,0,0,145,145,0,1,0,1,0
7239,1008,0,0,146,146,0,1,0,1,0
8275,1377,0,0,152,152,0,1,0,1,0
2450,1554,0,0,85,85,0,1,0,1,0
2342,1694,0,0,62,62,0,1,0,1,0
1451,3095,0,0,148,148,0,1,0,1,0
2892,183,10940,121,293,223,70,4,0,3,1
4831,183,15982,121,293,223,70,4,0,3,1
1427,1176,0,0,149,149,0,1,0,1,0
2475,1533,0,0,88,88,0,1,0,1,0
1982,183,7705,121,293,223,70,4,0,3,1
10203,1515,0,0,78,78,0,1,0,1,0
301,1068,0,0,157,157,0,1,0,1,0
1938,1098,0,0,124,124,0,1,0,1,0
16356,2665,0,0,122,122,0,1,0,1,0
750,1212,0,0,156,156,0,1,0,1,0
16473,1726,0,0,145,145,0,1,0,1,0
7439,2812,0,0,75,75,0,1,0,1,0
13111,1543,0,0,69,69,0,1,0,1,0
2449,98,0,0,62,62,0,1,0,1,0
11740,1592,0,0,67,67,0,1,0,1,0
2044,3095,0,0,154,154,0,1,0,1,0
2909,1384,0,0,113,113,0,1,0,1,0
20938,183,28105,121,293,223,70,4,0,3,1
642,1176,0,0,152,152,0,1,0,1,0
755,3095,0,0,139,139,0,1,0,1,0
81,1462,0,0,152,152,0,1,0,1,0
2406,1694,0,0,62,62,0,1,0,1,0
3293,183,11000,121,293,223,70,4,1,3,1
4115,441,0,0,143,143,0,1,0,1,0
96,1570,0,0,151,151,0,1,0,1,0
1790,444,0,0,134,134,0,1,0,1,0
2406,162,0,0,62,62,0,1,0,1,0
758,1487,0,0,154,154,0,1,0,1,0
6998,964,0,0,146,146,0,1,0,1,0
1929,811,0,0,69,69,0,1,0,1,0
1855,183,7049,121,293,223,70,4,0,3,1
12769,581,0,0,145,145,0,1,0,1,0
2432,165,0,0,73,73,0,1,0,1,0
2913,99,0,0,82,82,0,1,0,1,0
309,2418,0,0,144,144,0,1,0,1,0
1892,1083,0,0,143,143,0,1,0,1,0
10561,1543,0,0,67,67,0,1,0,1,0
1421,3095,0,0,139,139,0,1,0,1,0
859,3095,0,0,139,139,0,1,0,1,0
2309,1694,0,0,62,62,0,1,0,1,0
8402,1198,0,0,151,151,0,1,0,1,0
2620,1072,0,0,121,121,0,1,0,1,0
11606,1662,0,0,63,63,0,1,0,1,0
1915,1176,0,0,142,142,0,1,0,1,0
2685,502,0,0,98,98,0,1,0,1,0
1986,183,6809,121,293,223,70,4,1,3,1
12124,1543,0,0,70,70,0,1,0,1,0
1939,1084,0,0,120,120,0,1,0,1,0
2236,1756,0,0,65,65,0,1,0,1,0
1432,183,4989,121,293,223,70,4,0,3,1
2463,1694,0,0,62,62,0,1,0,1,0
1839,961,0,0,144,144,0,1,0,1,0
10792,1597,0,0,68,68,0,1,0,1,0
1175,183,4122,121,293,223,70,4,1,3,1
1641,183,6007,121,293,223,70,4,0,3,1
11437,1680,0,0,62,62,0,1,0,1,0
355,905,0,0,155,155,0,1,0,1,0
1466,183,5140,121,293,223,70,4,1,3,1
10132,1543,0,0,84,84,0,1,0,1,0
11154,1644,0,0,65,65,0,1,0,1,0
1005,183,3879,121,293,223,70,4,1,3,1
716,2685,0,0,144,144,0,1,0,1,0
1644,183,6101,121,293,223,70,4,0,3,1
1939,1087,0,0,121,121,0,1,0,1,0
1472,1055,0,0,140,140,0,1,0,1,0
108,1658,0,0,151,151,0,1,0,1,0
1692,183,6349,121,293,223,70,4,0,3,1
1495,3095,0,0,145,145,0,1,0,1,0
1655,183,6073,121,293,223,70,4,0,3,1
13726,183,20456,121,293,223,70,4,0,3,1
8347,1194,0,0,152,152,0,1,0,1,0
815,331,3044,102,270,211,59,3,0,2,0
2581,1447,0,0,102,102,0,1,0,1,0
649,3009,0,0,139,139,0,1,0,1,0
12893,712,0,0,118,118,0,1,0,1,0
288,1740,0,0,143,143,0,1,0,1,0
1716,594,0,0,129,129,0,1,0,1,0
8327,1566,0,0,146,146,0,1,0,1,0
2777,1176,0,0,147,147,0,1,0,1,0
12582,1151,0,0,93,93,0,1,0,1,0
2904,1514,0,0,91,91,0,1,0,1,0
8567,1543,0,0,137,137,0,1,0,1,0
2133,3095,0,0,156,156,0,1,0,1,0
1079,3095,0,0,139,139,0,1,0,1,0
1339,183,4523,121,293,223,70,4,1,3,1
2000,183,6854,121,293,223,70,4,1,3,1
2910,1330,0,0,122,122,0,1,0,1,0
13346,563,0,0,127,127,0,1,0,1,0
4669,183,15414,121,293,223,70,4,1,3,1
5202,412,0,0,146,146,0,1,0,1,0
4924,183,16260,121,293,223,70,4,0,3,1
1727,183,6423,121,293,223,70,4,0,3,1
7995,1655,0,0,132,132,0,1,0,1,0
1540,1105,0,0,122,122,0,1,0,1,0
936,3095,0,0,140,140,0,1,0,1,0
6136,491,0,0,146,146,0,1,0,1,0
2302,183,7820,121,293,223,70,4,1,3,1
2101,183,8248,121,293,223,70,4,0,3,1
2558,1384,0,0,62,62,0,1,0,1,0
2307,2960,0,0,149,149,0,1,0,1,0
1477,183,5207,121,293,223,70,4,0,3,1
11299,1643,0,0,62,62,0,1,0,1,0
14772,566,0,0,145,145,0,1,0,1,0
5948,388,0,0,146,146,0,1,0,1,0
13433,706,0,0,118,118,0,1,0,1,0
8262,1295,0,0,154,154,0,1,0,1,0
1411,3095,0,0,139,139,0,1,0,1,0
1951,924,0,0,82,82,0,1,0,1,0
1367,3095,0,0,141,141,0,1,0,1,0
1570,183,5673,121,293,223,70,4,0,3,1
4502,646,0,0,146,146,0,1,0,1,0
1934,183,7446,121,293,223,70,4,0,3,1
9972,1543,0,0,86,86,0,1,0,1,0
2105,3095,0,0,156,156,0,1,0,1,0
12084,1802,0,0,68,68,0,1,0,1,0
6881,900,0,0,146,146,0,1,0,1,0
2880,1163,0,0,144,144,0,1,0,1,0
2424,1263,0,0,62,62,0,1,0,1,0
2089,183,8290,121,293,223,70,4,0,3,1
9668,1694,0,0,110,110,0,1,0,1,0
1347,3095,0,0,142,142,0,1,0,1,0
18332,2993,0,0,145,145,0,1,0,1,0
2841,1236,0,0,138,138,0,1,0,1,0
303,1145,0,0,145,145,0,1,0,1,0
10665,1652,0,0,84,84,0,1,0,1,0
2293,1681,0,0,64,64,0,1,0,1,0
9428,1381,0,0,109,109,0,1,0,1,0
882,278,3235,109,279,216,63,3,0,2,0
2176,183,8205,121,293,223,70,4,0,3,1
2061,183,7773,121,293,223,70,4,0,3,1
1758,3095,0,0,147,147,0,1,0,1,0
8250,1221,0,0,156,156,0,1,0,1,0
10724,1543,0,0,71,71,0,1,0,1,0
9677,1593,0,0,96,96,0,1,0,1,0
9528,1599,0,0,114,114,0,1,0,1,0
1404,3095,0,0,140,140,0,1,0,1,0
2904,1536,0,0,88,88,0,1,0,1,0
363,2017,0,0,148,148,0,1,0,1,0
11196,1622,0,0,62,62,0,1,0,1,0
2279,1132,0,0,62,62,0,1,0,1,0
4615,183,16066,121,293,223,70,4,1,3,1
2157,1512,0,0,90,90,0,1,0,1,0
9575,1543,0,0,100,100,0,1,0,1,0
2008,1216,0,0,136,136,0,1,0,1,0
16699,1617,0,0,62,62,0,1,0,1,0
1887,2277,0,0,95,95,0,1,0,1,0
1255,818,0,0,152,152,0,1,0,1,0
1603,1176,0,0,140,140,0,1,0,1,0
4357,382,0,0,146,146,0,1,0,1,0
14180,314,0,0,141,141,0,1,0,1,0
1763,642,0,0,116,116,0,1,0,1,0
2772,1579,0,0,62,62,0,1,0,1,0
8849,183,19172,121,293,223,70,4,0,3,1
2795,1176,0,0,147,147,0,1,0,1,0
2385,1607,0,0,76,76,0,1,0,1,0
2516,1500,0,0,94,94,0,1,0,1,0
20451,183,27834,121,293,223,70,4,0,3,1
2906,1477,0,0,97,97,0,1,0,1,0
1195,1176,0,0,139,139,0,1,0,1,0
8320,1653,0,0,146,146,0,1,0,1,0
2056,183,8427,121,293,223,70,4,0,3,1
10790,1597,0,0,68,68,0,1,0,1,0
1677,1019,0,0,103,103,0,1,0,1,0
2660,1477,0,0,62,62,0,1,0,1,0
13751,183,20483,121,293,223,70,4,0,3,1
2525,1176,0,0,146,146,0,1,0,1,0
928,3095,0,0,141,141,0,1,0,1,0
1905,1176,0,0,142,142,0,1,0,1,0
1793,854,0,0,145,145,0,1,0,1,0
57,1022,0,0,155,155,0,1,0,1,0
7904,2146,0,0,112,112,0,1,0,1,0
10204,1543,0,0,82,82,0,1,0,1,0
992,3095,0,0,139,139,0,1,0,1,0
10416,1486,0,0,76,76,0,1,0,1,0
12493,1883,0,0,80,80,0,1,0,1,0
2448,1555,0,0,84,84,0,1,0,1,0
1380,405,1282,43,199,174,25,2,0,1,0
21455,725,17109,72,200,158,42,2,0,2,0
1767,1176,0,0,141,141,0,1,0,1,0
2930,1694,0,0,62,62,0,1,0,1,0
2063,1176,0,0,143,143,0,1,0,1,0
20799,1977,0,0,85,85,0,1,0,1,0
2253,160,0,0,87,87,0,1,0,1,0
1720,598,0,0,128,128,0,1,0,1,0
10223,1631,0,0,96,96,0,1,0,1,0
2014,1297,0,0,123,123,0,1,0,1,0
203,1045,0,0,157,157,0,1,0,1,0
1683,183,6236,121,293,223,70,4,0,3,1
574,1071,0,0,143,143,0,1,0,1,0
13989,352,0,0,139,139,0,1,0,1,0
1799,868,0,0,145,145,0,1,0,1,0
1695,183,5957,121,293,223,70,4,1,3,1
2009,1530,0,0,86,86,0,1,0,1,0
1773,183,6685,121,293,223,70,4,0,3,1
3011,1560,0,0,84,84,0,1,0,1,0
10338,1637,0,0,93,93,0,1,0,1,0
727,496,2449,82,245,197,47,3,0,2,0
11116,939,0,0,145,145,0,1,0,1,0
9034,1289,0,0,127,127,0,1,0,1,0
1859,1176,0,0,142,142,0,1,0,1,0
2183,1044,0,0,62,62,0,1,0,1,0
10226,1459,0,0,83,83,0,1,0,1,0
12871,183,22175,121,293,223,70,4,0,3,1
17399,2876,0,0,133,133,0,1,0,1,0
3499,183,12036,121,293,223,70,4,0,3,1
1768,647,0,0,115,115,0,1,0,1,0
1849,183,7066,121,293,223,70,4,0,3,1
1454,2922,0,0,133,133,0,1,0,1,0
3004,1694,0,0,62,62,0,1,0,1,0
2499,1331,0,0,62,62,0,1,0,1,0
4216,396,0,0,146,146,0,1,0,1,0
1640,183,5993,121,293,223,70,4,0,3,1
1978,183,7679,121,293,223,70,4,0,3,1
1627,183,5958,121,293,223,70,4,0,3,1
2901,1622,0,0,73,73,0,1,0,1,0
220,2228,0,0,144,144,0,1,0,1,0
2051,936,0,0,126,126,0,1,0,1,0
9920,1466,0,0,89,89,0,1,0,1,0
1581,580,0,0,148,148,0,1,0,1,0
2062,1245,0,0,132,132,0,1,0,1,0
198,2306,0,0,145,145,0,1,0,1,0
1661,523,0,0,147,147,0,1,0,1,0
8216,1700,0,0,137,137,0,1,0,1,0
9144,1644,0,0,118,118,0,1,0,1,0
4893,328,0,0,146,146,0,1,0,1,0
1085,183,4098,121,293,223,70,4,1,3,1
11651,183,21420,121,293,223,70,4,0,3,1
3429,183,12016,121,293,223,70,4,0,3,1
1377,3095,0,0,141,141,0,1,0,1,0
3606,183,12821,121,293,223,70,4,0,3,1
13573,632,0,0,122,122,0,1,0,1,0
1917,865,0,0,67,67,0,1,0,1,0
9636,1417,0,0,101,101,0,1,0,1,0
8295,1499,0,0,150,150,0,1,0,1,0
1003,1003,0,0,154,154,0,1,0,1,0
1528,1070,0,0,132,132,0,1,0,1,0
1098,1176,0,0,148,148,0,1,0,1,0
1643,3095,0,0,144,144,0,1,0,1,0
2020,1536,0,0,85,85,0,1,0,1,0
1985,3095,0,0,155,155,0,1,0,1,0
10744,1546,0,0,64,64,0,1,0,1,0
2781,183,10212,121,293,223,70,4,0,3,1
1232,1176,0,0,144,144,0,1,0,1,0
1966,183,7653,121,293,223,70,4,0,3,1
16807,1953,0,0,145,145,0,1,0,1,0
3847,754,0,0,123,123,0,1,0,1,0
1382,1176,0,0,149,149,0,1,0,1,0
2931,1240,0,0,137,137,0,1,0,1,0
1977,183,7690,121,293,223,70,4,0,3,1
3020,1110,0,0,147,147,0,1,0,1,0
167,2087,0,0,147,147,0,1,0,1,0
17353,2326,0,0,145,145,0,1,0,1,0
7992,2124,0,0,119,119,0,1,0,1,0
1806,1176,0,0,144,144,0,1,0,1,0
2327,378,0,0,88,88,0,1,0,1,0
1763,2545,0,0,108,108,0,1,0,1,0
14130,286,0,0,145,145,0,1,0,1,0
21694,1521,443,1,65,64,1,1,0,1,0
621,2967,0,0,140,140,0,1,0,1,0
2855,1224,0,0,139,139,0,1,0,1,0
9091,183,19549,121,293,223,70,4,0,3,1
2712,1539,0,0,86,86,0,1,0,1,0
1622,183,5935,121,293,223,70,4,0,3,1
1957,839,0,0,62,62,0,1,0,1,0
2018,183,8022,121,293,223,70,4,0,3,1
8436,1543,0,0,142,142,0,1,0,1,0
7751,1260,0,0,146,146,0,1,0,1,0
1475,183,5841,121,293,223,70,4,0,3,1
4489,369,0,0,146,146,0,1,0,1,0
2635,2257,0,0,101,101,0,1,0,1,0
1787,666,0,0,109,109,0,1,0,1,0
9068,1638,0,0,119,119,0,1,0,1,0
2446,183,9103,121,293,223,70,4,0,3,1
1224,3019,0,0,143,143,0,1,0,1,0
3070,137,0,0,90,90,0,1,0,1,0
1527,1176,0,0,147,147,0,1,0,1,0
7705,2432,0,0,96,96,0,1,0,1,0
8327,1658,0,0,146,146,0,1,0,1,0
10486,1644,0,0,89,89,0,1,0,1,0
19571,2569,0,0,116,116,0,1,0,1,0
1264,351,1833,61,222,186,35,2,0,2,0
3636,724,0,0,146,146,0,1,0,1,0
8327,1637,0,0,146,146,0,1,0,1,0
4362,381,0,0,146,146,0,1,0,1,0
8361,1196,0,0,152,152,0,1,0,1,0
1087,183,3952,121,293,223,70,4,1,3,1
1440,313,2735,75,238,194,43,2,0,2,0
2879,183,11109,121,293,223,70,4,0,3,1
3426,183,12731,121,293,223,70,4,0,3,1
1336,183,4510,121,293,223,70,4,0,3,1
13619,608,0,0,124,124,0,1,0,1,0
858,469,2548,86,253,203,49,3,0,2,0
2913,1256,0,0,134,134,0,1,0,1,0
2921,1172,0,0,147,147,0,1,0,1,0
11104,941,0,0,145,145,0,1,0,1,0
9274,1623,0,0,111,111,0,1,0,1,0
880,1176,0,0,153,153,0,1,0,1,0
18701,2989,0,0,139,139,0,1,0,1,0
12947,960,0,0,104,104,0,1,0,1,0
10384,1543,0,0,71,71,0,1,0,1,0
1170,183,4331,121,293,223,70,4,1,3,1
2450,1176,0,0,145,145,0,1,0,1,0
851,1105,0,0,146,146,0,1,0,1,0
1826,183,7206,121,293,223,70,4,0,3,1
1791,850,0,0,145,145,0,1,0,1,0
6061,183,17090,121,293,223,70,4,0,3,1
1025,987,0,0,154,154,0,1,0,1,0
2075,183,7813,121,293,223,70,4,0,3,1
4414,183,14595,121,293,223,70,4,1,3,1
2266,1677,0,0,64,64,0,1,0,1,0
251,2005,0,0,144,144,0,1,0,1,0
1888,183,6495,121,293,223,70,4,1,3,1
11542,1694,0,0,62,62,0,1,0,1,0
3855,183,13226,121,293,223,70,4,0,3,1
1616,1058,0,0,111,111,0,1,0,1,0
8570,1554,0,0,139,139,0,1,0,1,0
2828,183,10771,121,293,223,70,4,0,3,1
2189,183,8871,121,293,223,70,4,0,3,1
2025,183,7960,121,293,223,70,4,0,3,1
739,2061,0,0,148,148,0,1,0,1,0
2996,1501,0,0,93,93,0,1,0,1,0
424,2676,0,0,142,142,0,1,0,1,0
18853,2915,0,0,135,135,0,1,0,1,0
14772,2386,0,0,111,111,0,1,0,1,0
1150,183,4074,121,293,223,70,4,1,3,1
12125,1055,0,0,93,93,0,1,0,1,0
1334,3095,0,0,147,147,0,1,0,1,0
4079,183,14422,121,293,223,70,4,1,3,1
1489,1211,0,0,133,133,0,1,0,1,0
7870,1895,0,0,120,120,0,1,0,1,0
1233,3025,0,0,143,143,0,1,0,1,0
8895,1289,0,0,130,130,0,1,0,1,0
414,1911,0,0,149,149,0,1,0,1,0
1565,554,0,0,148,148,0,1,0,1,0
959,3095,0,0,140,140,0,1,0,1,0
5805,310,0,0,146,146,0,1,0,1,0
2214,3095,0,0,158,158,0,1,0,1,0
2861,183,11055,121,293,223,70,4,0,3,1
2777,183,9896,121,293,223,70,4,0,3,1
7805,2365,0,0,104,104,0,1,0,1,0
1872,183,7185,121,293,223,70,4,0,3,1
1896,183,7248,121,293,223,70,4,0,3,1
18647,3015,0,0,140,140,0,1,0,1,0
1293,1176,0,0,142,142,0,1,0,1,0
4161,183,14712,121,293,223,70,4,1,3,1
1044,3095,0,0,141,141,0,1,0,1,0
2388,255,0,0,79,79,0,1,0,1,0
10025,1622,0,0,101,101,0,1,0,1,0
1940,183,7477,121,293,223,70,4,0,3,1
20914,1922,0,0,82,82,0,1,0,1,0
794,3095,0,0,139,139,0,1,0,1,0
8605,1543,0,0,136,136,0,1,0,1,0
201,2331,0,0,145,145,0,1,0,1,0
1645,183,6021,121,293,223,70,4,0,3,1
548,1125,0,0,157,157,0,1,0,1,0
2951,1694,0,0,62,62,0,1,0,1,0
4321,385,0,0,146,146,0,1,0,1,0
12796,575,0,0,145,145,0,1,0,1,0
173,1080,0,0,150,150,0,1,0,1,0
7374,1075,0,0,146,146,0,1,0,1,0
1963,854,0,0,62,62,0,1,0,1,0
20627,2060,0,0,89,89,0,1,0,1,0
1185,3095,0,0,139,139,0,1,0,1,0
817,3095,0,0,139,139,0,1,0,1,0
218,1102,0,0,148,148,0,1,0,1,0
2253,1729,0,0,64,64,0,1,0,1,0
16467,627,0,0,120,120,0,1,0,1,0
3585,1060,0,0,103,103,0,1,0,1,0
352,1169,0,0,143,143,0,1,0,1,0
249,1118,0,0,147,147,0,1,0,1,0
1567,442,1094,30,184,166,17,1,0,1,0
4511,183,15937,121,293,223,70,4,1,3,1
2263,2313,0,0,104,104,0,1,0,1,0
2650,183,10430,121,293,223,70,4,0,3,1
16359,183,24858,121,293,223,70,4,0,3,1
1500,972,0,0,141,141,0,1,0,1,0
114,1051,0,0,153,153,0,1,0,1,0
1317,1176,0,0,142,142,0,1,0,1,0
734,2217,0,0,147,147,0,1,0,1,0
985,183,3914,121,293,223,70,4,0,3,1
9301,1543,0,0,113,113,0,1,0,1,0
709,3023,0,0,139,139,0,1,0,1,0
1249,3095,0,0,139,139,0,1,0,1,0
2884,1694,0,0,62,62,0,1,0,1,0
9410,1543,0,0,109,109,0,1,0,1,0
4614,183,16065,121,293,223,70,4,1,3,1
8323,1529,0,0,146,146,0,1,0,1,0
1700,578,0,0,134,134,0,1,0,1,0
7190,2900,0,0,66,66,0,1,0,1,0
1121,682,0,0,150,150,0,1,0,1,0
1467,3095,0,0,139,139,0,1,0,1,0
11584,1673,0,0,63,63,0,1,0,1,0
552,1176,0,0,149,149,0,1,0,1,0
2154,183,8730,121,293,223,70,4,0,3,1
12090,1068,0,0,92,92,0,1,0,1,0
20,1004,0,0,156,156,0,1,0,1,0
3986,363,0,0,137,137,0,1,0,1,0
1774,1176,0,0,144,144,0,1,0,1,0
1842,722,0,0,94,94,0,1,0,1,0
1076,2878,0,0,140,140,0,1,0,1,0
2059,875,0,0,71,71,0,1,0,1,0
2182,183,8827,121,293,223,70,4,0,3,1
1982,183,7716,121,293,223,70,4,0,3,1
8253,1239,0,0,155,155,0,1,0,1,0
2534,183,9631,121,293,223,70,4,0,3,1
1088,3095,0,0,143,143,0,1,0,1,0
1430,183,5554,121,293,223,70,4,0,3,1
9305,1543,0,0,112,112,0,1,0,1,0
8126,1830,0,0,129,129,0,1,0,1,0
14090,361,0,0,138,138,0,1,0,1,0
1124,1176,0,0,140,140,0,1,0,1,0
239,1054,0,0,157,157,0,1,0,1,0
10860,1606,0,0,67,67,0,1,0,1,0
3040,1694,0,0,62,62,0,1,0,1,0
7764,2417,0,0,101,101,0,1,0,1,0
383,1176,0,0,142,142,0,1,0,1,0
825,1134,0,0,156,156,0,1,0,1,0
5892,346,0,0,146,146,0,1,0,1,0
2263,2298,0,0,103,103,0,1,0,1,0
1771,183,6738,121,293,223,70,4,0,3,1
9067,1293,0,0,126,126,0,1,0,1,0
2277,183,8541,121,293,223,70,4,0,3,1
2981,1694,0,0,62,62,0,1,0,1,0
10585,1543,0,0,66,66,0,1,0,1,0
1655,183,6076,121,293,223,70,4,0,3,1
21343,353,24900,105,264,202,61,3,0,2,0
729,2387,0,0,145,145,0,1,0,1,0
2201,183,8942,121,293,223,70,4,0,3,1
1723,183,6492,121,293,223,70,4,0,3,1
2464,100,0,0,68,68,0,1,0,1,0
1703,183,6952,121,293,223,70,4,0,3,1
11036,1321,0,0,84,84,0,1,0,1,0
1834,714,0,0,96,96,0,1,0,1,0
2092,636,0,0,62,62,0,1,0,1,0
13550,528,0,0,127,127,0,1,0,1,0
227,2179,0,0,144,144,0,1,0,1,0
3903,342,0,0,133,133,0,1,0,1,0
13529,536,0,0,126,126,0,1,0,1,0
3766,797,0,0,120,120,0,1,0,1,0
10889,1610,0,0,67,67,0,1,0,1,0
1104,3095,0,0,139,139,0,1,0,1,0
1946,993,0,0,99,99,0,1,0,1,0
2669,1376,0,0,114,114,0,1,0,1,0
4637,183,15538,121,293,223,70,4,0,3,1
5831,324,0,0,146,146,0,1,0,1,0
2521,2,0,0,62,62,0,1,0,1,0
379,2464,0,0,144,144,0,1,0,1,0
2765,1694,0,0,62,62,0,1,0,1,0
1061,183,4229,121,293,223,70,4,0,3,1
7394,2894,0,0,71,71,0,1,0,1,0
9859,1694,0,0,106,106,0,1,0,1,0
8298,1416,0,0,149,149,0,1,0,1,0
66,1027,0,0,155,155,0,1,0,1,0
19160,2768,0,0,127,127,0,1,0,1,0
8327,1629,0,0,146,146,0,1,0,1,0
2301,1674,0,0,65,65,0,1,0,1,0
1949,952,0,0,89,89,0,1,0,1,0
1483,1207,0,0,134,134,0,1,0,1,0
10879,1642,0,0,76,76,0,1,0,1,0
13209,183,22558,121,293,223,70,4,0,3,1
6685,2006,0,0,93,93,0,1,0,1,0
2361,1176,0,0,145,145,0,1,0,1,0
812,951,0,0,144,144,0,1,0,1,0
2126,1290,0,0,62,62,0,1,0,1,0
1472,183,5184,121,293,223,70,4,0,3,1
6789,2190,0,0,87,87,0,1,0,1,0
2432,2694,0,0,131,131,0,1,0,1,0
8262,1298,0,0,154,154,0,1,0,1,0
2140,183,8654,121,293,223,70,4,0,3,1
2680,1367,0,0,116,116,0,1,0,1,0
605,2944,0,0,140,140,0,1,0,1,0
215,2365,0,0,144,144,0,1,0,1,0
343,2440,0,0,144,144,0,1,0,1,0
882,281,3224,108,279,216,63,3,0,2,0
1311,3076,0,0,143,143,0,1,0,1,0
1152,1176,0,0,140,140,0,1,0,1,0
1003,2874,0,0,143,143,0,1,0,1,0
1953,183,7557,121,293,223,70,4,0,3,1
1604,3095,0,0,143,143,0,1,0,1,0
1445,1176,0,0,139,139,0,1,0,1,0
16037,2627,0,0,123,123,0,1,0,1,0
10772,1595,0,0,68,68,0,1,0,1,0
1810,893,0,0,145,145,0,1,0,1,0
2416,1694,0,0,62,62,0,1,0,1,0
2007,1288,0,0,125,125,0,1,0,1,0
2484,19,0,0,64,64,0,1,0,1,0
2949,1694,0,0,62,62,0,1,0,1,0
2385,1176,0,0,145,145,0,1,0,1,0
8738,1668,0,0,132,132,0,1,0,1,0
1081,3095,0,0,141,141,0,1,0,1,0
84,1482,0,0,152,152,0,1,0,1,0
2810,1646,0,0,69,69,0,1,0,1,0
423,1176,0,0,144,144,0,1,0,1,0
10322,1543,0,0,73,73,0,1,0,1,0
2023,1014,0,0,62,62,0,1,0,1,0
1950,944,0,0,87,87,0,1,0,1,0
3220,1488,0,0,75,75,0,1,0,1,0
1008,3095,0,0,140,140,0,1,0,1,0
5858,183,12131,121,293,223,70,4,0,3,1
14391,2268,0,0,96,96,0,1,0,1,0
1622,1176,0,0,140,140,0,1,0,1,0
744,2677,0,0,142,142,0,1,0,1,0
4785,339,0,0,146,146,0,1,0,1,0
641,1079,0,0,149,149,0,1,0,1,0
10971,1342,0,0,83,83,0,1,0,1,0
2010,183,7872,121,293,223,70,4,0,3,1
18446,3070,0,0,145,145,0,1,0,1,0
2966,1694,0,0,62,62,0,1,0,1,0
11012,1584,0,0,62,62,0,1,0,1,0
13181,837,0,0,111,111,0,1,0,1,0
1333,3034,0,0,139,139,0,1,0,1,0
5100,447,0,0,146,146,0,1,0,1,0
15007,2430,0,0,113,113,0,1,0,1,0
2630,1407,0,0,109,109,0,1,0,1,0
2343,975,0,0,96,96,0,1,0,1,0
10076,1438,0,0,89,89,0,1,0,1,0
1460,1089,0,0,140,140,0,1,0,1,0
2911,1312,0,0,125,125,0,1,0,1,0
10540,1504,0,0,71,71,0,1,0,1,0
2774,1291,0,0,128,128,0,1,0,1,0
734,1168,0,0,157,157,0,1,0,1,0
9539,1361,0,0,108,108,0,1,0,1,0
13672,580,0,0,125,125,0,1,0,1,0
2510,1505,0,0,93,93,0,1,0,1,0
12397,955,0,0,99,99,0,1,0,1,0
1672,549,0,0,142,142,0,1,0,1,0
1673,1021,0,0,103,103,0,1,0,1,0
1915,183,7399,121,293,223,70,4,0,3,1
1786,839,0,0,145,145,0,1,0,1,0
2902,1694,0,0,62,62,0,1,0,1,0
1885,183,7195,121,293,223,70,4,0,3,1
8745,1543,0,0,131,131,0,1,0,1,0
1816,183,6858,121,293,223,70,4,0,3,1
12190,1356,0,0,81,81,0,1,0,1,0
1345,3042,0,0,139,139,0,1,0,1,0
2710,1103,0,0,129,129,0,1,0,1,0
358,1226,0,0,143,143,0,1,0,1,0
1863,183,7214,121,293,223,70,4,0,3,1
2048,183,8073,121,293,223,70,4,0,3,1
5823,477,0,0,139,139,0,1,0,1,0
1808,183,6819,121,293,223,70,4,0,3,1
11721,1601,0,0,67,67,0,1,0,1,0
636,1449,0,0,154,154,0,1,0,1,0
11133,935,0,0,145,145,0,1,0,1,0
467,2509,0,0,143,143,0,1,0,1,0
1362,3095,0,0,142,142,0,1,0,1,0
2281,1690,0,0,62,62,0,1,0,1,0
11387,1661,0,0,62,62,0,1,0,1,0
1410,183,4881,121,293,223,70,4,0,3,1
7951,2177,0,0,116,116,0,1,0,1,0
3591,183,12781,121,293,223,70,4,0,3,1
15431,1015,0,0,145,145,0,1,0,1,0
1017,3095,0,0,140,140,0,1,0,1,0
8638,1475,0,0,145,145,0,1,0,1,0
2157,219,0,0,97,97,0,1,0,1,0
2919,1694,0,0,62,62,0,1,0,1,0
2171,1871,0,0,71,71,0,1,0,1,0
8313,1483,0,0,147,147,0,1,0,1,0
7996,1086,0,0,155,155,0,1,0,1,0
10798,1543,0,0,62,62,0,1,0,1,0
1729,183,6431,121,293,223,70,4,0,3,1
3705,294,0,0,123,123,0,1,0,1,0
8327,1645,0,0,146,146,0,1,0,1,0
21626,1295,5186,22,104,91,12,1,0,1,0
3899,183,13994,121,293,223,70,4,0,3,1
26,1004,0,0,157,157,0,1,0,1,0
11855,1543,0,0,70,70,0,1,0,1,0
298,1665,0,0,143,143,0,1,0,1,0
572,1176,0,0,150,150,0,1,0,1,0
1770,649,0,0,114,114,0,1,0,1,0
2627,1694,0,0,62,62,0,1,0,1,0
917,183,3640,121,293,223,70,4,1,3,1
4254,183,15129,121,293,223,70,4,0,3,1
21422,617,19365,82,219,171,47,3,0,2,0
8518,1543,0,0,139,139,0,1,0,1,0
462,2732,0,0,141,141,0,1,0,1,0
2199,1823,0,0,69,69,0,1,0,1,0
2848,1694,0,0,62,62,0,1,0,1,0
1746,1176,0,0,141,141,0,1,0,1,0
2495,12,0,0,63,63,0,1,0,1,0
1471,1176,0,0,148,148,0,1,0,1,0
11303,1644,0,0,62,62,0,1,0,1,0
21495,861,14271,60,177,142,35,2,0,2,0
1904,3095,0,0,154,154,0,1,0,1,0
1077,183,3932,121,293,223,70,4,1,3,1
8140,1451,0,0,146,146,0,1,0,1,0
1393,3095,0,0,140,140,0,1,0,1,0
8246,1200,0,0,156,156,0,1,0,1,0
1146,1176,0,0,152,152,0,1,0,1,0
1676,585,0,0,147,147,0,1,0,1,0
2208,183,8977,121,293,223,70,4,0,3,1
1281,1176,0,0,139,139,0,1,0,1,0
3631,183,13137,121,293,223,70,4,0,3,1
8327,1602,0,0,146,146,0,1,0,1,0
3012,1694,0,0,62,62,0,1,0,1,0
2652,1083,0,0,124,124,0,1,0,1,0
308,2412,0,0,144,144,0,1,0,1,0
19089,1581,0,0,62,62,0,1,0,1,0
1823,924,0,0,144,144,0,1,0,1,0
2903,1543,0,0,86,86,0,1,0,1,0
1851,183,7026,121,293,223,70,4,0,3,1
17177,2845,0,0,133,133,0,1,0,1,0
1489,3095,0,0,140,140,0,1,0,1,0
9286,1356,0,0,115,115,0,1,0,1,0
1804,937,0,0,84,84,0,1,0,1,0
11061,1594,0,0,62,62,0,1,0,1,0
2153,545,0,0,62,62,0,1,0,1,0
211,2292,0,0,144,144,0,1,0,1,0
1939,1091,0,0,122,122,0,1,0,1,0
1943,183,7634,121,293,223,70,4,0,3,1
1657,534,0,0,146,146,0,1,0,1,0
2327,1694,0,0,62,62,0,1,0,1,0
1781,183,6687,121,293,223,70,4,0,3,1
1839,183,6969,121,293,223,70,4,0,3,1
1283,3095,0,0,139,139,0,1,0,1,0
3638,183,13361,121,293,223,70,4,0,3,1
1372,244,3610,99,267,209,57,3,0,2,0
10023,1543,0,0,88,88,0,1,0,1,0
5442,332,0,0,146,146,0,1,0,1,0
10304,1533,0,0,74,74,0,1,0,1,0
7534,2675,0,0,82,82,0,1,0,1,0
1560,183,5629,121,293,223,70,4,0,3,1
10474,1643,0,0,89,89,0,1,0,1,0
3844,717,0,0,125,125,0,1,0,1,0
10905,1562,0,0,62,62,0,1,0,1,0
8247,1201,0,0,156,156,0,1,0,1,0
1670,547,0,0,142,142,0,1,0,1,0
14675,500,0,0,145,145,0,1,0,1,0
2155,183,8671,121,293,223,70,4,0,3,1
11382,1673,0,0,63,63,0,1,0,1,0
10788,1597,0,0,68,68,0,1,0,1,0
1684,183,6244,121,293,223,70,4,0,3,1
8243,1176,0,0,156,156,0,1,0,1,0
4302,387,0,0,146,146,0,1,0,1,0
1654,3095,0,0,144,144,0,1,0,1,0
738,2092,0,0,148,148,0,1,0,1,0
4728,183,16206,121,293,223,70,4,1,3,1
3355,208,0,0,105,105,0,1,0,1,0
2668,1694,0,0,62,62,0,1,0,1,0
1469,1151,0,0,133,133,0,1,0,1,0
11834,1542,0,0,70,70,0,1,0,1,0
2199,1059,0,0,62,62,0,1,0,1,0
7981,2037,0,0,118,118,0,1,0,1,0
1622,616,0,0,146,146,0,1,0,1,0
2450,183,8637,121,293,223,70,4,1,3,1
2608,1068,0,0,120,120,0,1,0,1,0
7686,2517,0,0,94,94,0,1,0,1,0
11239,1631,0,0,62,62,0,1,0,1,0
515,1701,0,0,151,151,0,1,0,1,0
16959,1543,0,0,66,66,0,1,0,1,0
9281,1694,0,0,121,121,0,1,0,1,0
2739,1176,0,0,147,147,0,1,0,1,0
128,1799,0,0,149,149,0,1,0,1,0
2486,2577,0,0,123,123,0,1,0,1,0
10211,1543,0,0,82,82,0,1,0,1,0
4921,325,0,0,146,146,0,1,0,1,0
2190,489,0,0,62,62,0,1,0,1,0
7301,3013,0,0,64,64,0,1,0,1,0
8777,2315,0,0,66,66,0,1,0,1,0
2800,1694,0,0,62,62,0,1,0,1,0
7418,2863,0,0,73,73,0,1,0,1,0
1684,183,6872,121,293,223,70,4,0,3,1
1155,3095,0,0,139,139,0,1,0,1,0
2912,1271,0,0,132,132,0,1,0,1,0
1714,3095,0,0,152,152,0,1,0,1,0
6864,674,0,0,151,151,0,1,0,1,0
9923,1543,0,0,91,91,0,1,0,1,0
4509,183,15935,121,293,223,70,4,1,3,1
2779,1694,0,0,62,62,0,1,0,1,0
4178,183,14147,121,293,223,70,4,0,3,1
2468,28,0,0,66,66,0,1,0,1,0
2026,183,7942,121,293,223,70,4,0,3,1
1255,3095,0,0,139,139,0,1,0,1,0
15801,183,24362,121,293,223,70,4,0,3,1
2769,183,10174,121,293,223,70,4,0,3,1
15149,824,0,0,145,145,0,1,0,1,0
612,712,1671,56,213,180,32,2,0,1,0
2251,3081,0,0,158,158,0,1,0,1,0
1695,3095,0,0,149,149,0,1,0,1,0
2179,1546,0,0,85,85,0,1,0,1,0
1410,183,5728,121,293,223,70,4,0,3,1
544,2853,0,0,140,140,0,1,0,1,0
2613,1694,0,0,62,62,0,1,0,1,0
1365,3095,0,0,141,141,0,1,0,1,0
9384,1615,0,0,107,107,0,1,0,1,0
1376,3095,0,0,139,139,0,1,0,1,0
10592,1543,0,0,69,69,0,1,0,1,0
3036,1694,0,0,62,62,0,1,0,1,0
2276,481,0,0,95,95,0,1,0,1,0
2525,1694,0,0,62,62,0,1,0,1,0
8031,2074,0,0,122,122,0,1,0,1,0
8301,1184,0,0,154,154,0,1,0,1,0
50,1010,0,0,157,157,0,1,0,1,0
341,2063,0,0,147,147,0,1,0,1,0
8245,1186,0,0,156,156,0,1,0,1,0
15195,855,0,0,145,145,0,1,0,1,0
2984,1453,0,0,101,101,0,1,0,1,0
1514,183,5384,121,293,223,70,4,0,3,1
1701,1003,0,0,99,99,0,1,0,1,0
862,3095,0,0,141,141,0,1,0,1,0
1039,3095,0,0,139,139,0,1,0,1,0
1033,3095,0,0,141,141,0,1,0,1,0
9370,1543,0,0,108,108,0,1,0,1,0
1375,183,4718,121,293,223,70,4,0,3,1
8120,1131,0,0,156,156,0,1,0,1,0
8312,1607,0,0,147,147,0,1,0,1,0
11167,1676,0,0,71,71,0,1,0,1,0
1075,183,3929,121,293,223,70,4,1,3,1
2593,1530,0,0,87,87,0,1,0,1,0
913,3095,0,0,139,139,0,1,0,1,0
1949,959,0,0,90,90,0,1,0,1,0
10192,1513,0,0,78,78,0,1,0,1,0
2347,252,0,0,62,62,0,1,0,1,0
836,1176,0,0,155,155,0,1,0,1,0
1725,484,0,0,140,140,0,1,0,1,0
3812,749,0,0,123,123,0,1,0,1,0
757,2685,0,0,142,142,0,1,0,1,0
11415,874,0,0,145,145,0,1,0,1,0
4101,183,14126,121,293,223,70,4,0,3,1
10972,1576,0,0,62,62,0,1,0,1,0
2372,183,9115,121,293,223,70,4,0,3,1
1952,843,0,0,62,62,0,1,0,1,0
2733,1112,0,0,131,131,0,1,0,1,0
2068,1134,0,0,62,62,0,1,0,1,0
1109,2898,0,0,140,140,0,1,0,1,0
3114,1051,0,0,147,147,0,1,0,1,0
21405,559,20579,87,229,178,50,3,0,2,0
9026,1311,0,0,125,125,0,1,0,1,0
8336,1693,0,0,145,145,0,1,0,1,0
9010,1308,0,0,126,126,0,1,0,1,0
1999,183,7793,121,293,223,70,4,0,3,1
7921,2123,0,0,113,113,0,1,0,1,0
3773,637,0,0,146,146,0,1,0,1,0
8184,1615,0,0,146,146,0,1,0,1,0
2099,183,8376,121,293,223,70,4,0,3,1
1615,555,0,0,148,148,0,1,0,1,0
1696,631,0,0,147,147,0,1,0,1,0
3018,1589,0,0,79,79,0,1,0,1,0
3803,318,0,0,128,128,0,1,0,1,0
14533,404,0,0,145,145,0,1,0,1,0
7291,3026,0,0,63,63,0,1,0,1,0
1085,1176,0,0,148,148,0,1,0,1,0
1219,3095,0,0,142,142,0,1,0,1,0
2456,1549,0,0,86,86,0,1,0,1,0
13648,2171,0,0,101,101,0,1,0,1,0
2324,183,7891,121,293,223,70,4,1,3,1
2914,1217,0,0,141,141,0,1,0,1,0
1918,183,6590,121,293,223,70,4,1,3,1
654,1149,0,0,157,157,0,1,0,1,0
2037,183,8123,121,293,223,70,4,0,3,1
10807,1542,0,0,62,62,0,1,0,1,0
12313,986,0,0,97,97,0,1,0,1,0
8844,1280,0,0,132,132,0,1,0,1,0
137,1030,0,0,157,157,0,1,0,1,0
19010,2839,0,0,131,131,0,1,0,1,0
1540,477,528,17,169,159,10,1,0,1,0
800,1176,0,0,156,156,0,1,0,1,0
8327,1608,0,0,146,146,0,1,0,1,0
13980,419,0,0,135,135,0,1,0,1,0
1461,1156,0,0,134,134,0,1,0,1,0
331,2538,0,0,143,143,0,1,0,1,0
2203,1176,0,0,144,144,0,1,0,1,0
263,2437,0,0,144,144,0,1,0,1,0
12295,908,0,0,107,107,0,1,0,1,0
1486,183,5258,121,293,223,70,4,0,3,1
9298,1543,0,0,113,113,0,1,0,1,0
1948,183,7518,121,293,223,70,4,0,3,1
3384,183,11694,121,293,223,70,4,0,3,1
2069,183,8287,121,293,223,70,4,0,3,1
9470,1609,0,0,104,104,0,1,0,1,0
1277,3095,0,0,139,139,0,1,0,1,0
4726,345,0,0,146,146,0,1,0,1,0
11239,1631,0,0,62,62,0,1,0,1,0
2284,1694,0,0,62,62,0,1,0,1,0
4883,183,16398,121,293,223,70,4,1,3,1
13328,610,0,0,121,121,0,1,0,1,0
1953,835,0,0,63,63,0,1,0,1,0
8627,1557,0,0,138,138,0,1,0,1,0
2218,183,9039,121,293,223,70,4,0,3,1
1388,3095,0,0,140,140,0,1,0,1,0
12546,826,0,0,112,112,0,1,0,1,0
1486,1014,0,0,141,141,0,1,0,1,0
9013,2200,0,0,67,67,0,1,0,1,0
1281,183,5005,121,293,223,70,4,0,3,1
1693,183,6521,121,293,223,70,4,0,3,1
11537,1692,0,0,62,62,0,1,0,1,0
2971,1398,0,0,111,111,0,1,0,1,0
1980,3095,0,0,154,154,0,1,0,1,0
8298,1520,0,0,149,149,0,1,0,1,0
11373,1671,0,0,63,63,0,1,0,1,0
1121,682,0,0,150,150,0,1,0,1,0
2144,183,8630,121,293,223,70,4,0,3,1
11664,1543,0,0,62,62,0,1,0,1,0
1449,677,0,0,150,150,0,1,0,1,0
3800,761,0,0,122,122,0,1,0,1,0
2008,183,7862,121,293,223,70,4,0,3,1
1559,575,0,0,147,147,0,1,0,1,0
4119,432,0,0,144,144,0,1,0,1,0
2926,1219,0,0,140,140,0,1,0,1,0
1137,3095,0,0,144,144,0,1,0,1,0
1791,2420,0,0,103,103,0,1,0,1,0
1344,618,0,0,149,149,0,1,0,1,0
1832,945,0,0,144,144,0,1,0,1,0
1432,183,4987,121,293,223,70,4,0,3,1
1583,183,5742,121,293,223,70,4,0,3,1
3871,576,0,0,146,146,0,1,0,1,0
1467,663,0,0,149,149,0,1,0,1,0
2035,910,0,0,62,62,0,1,0,1,0
1764,643,0,0,116,116,0,1,0,1,0
714,3095,0,0,139,139,0,1,0,1,0
2754,1119,0,0,133,133,0,1,0,1,0
1777,183,6771,121,293,223,70,4,0,3,1
12054,183,19145,121,293,223,70,4,0,3,1
11180,1647,0,0,65,65,0,1,0,1,0
1453,1176,0,0,139,139,0,1,0,1,0
10276,183,20237,121,293,223,70,4,0,3,1
1624,183,6420,121,293,223,70,4,0,3,1
13495,2086,0,0,91,91,0,1,0,1,0
1350,3045,0,0,139,139,0,1,0,1,0
13776,526,0,0,129,129,0,1,0,1,0
778,3095,0,0,139,139,0,1,0,1,0
6675,731,0,0,146,146,0,1,0,1,0
4917,183,16440,121,293,223,70,4,1,3,1
2868,1694,0,0,62,62,0,1,0,1,0
976,3095,0,0,139,139,0,1,0,1,0
12225,699,0,0,145,145,0,1,0,1,0
21293,187,28366,120,292,222,69,3,0,2,0
4787,183,15881,121,293,223,70,4,0,3,1
2000,3095,0,0,155,155,0,1,0,1,0
1246,183,4948,121,293,223,70,4,0,3,1
9892,1616,0,0,105,105,0,1,0,1,0
2325,969,0,0,95,95,0,1,0,1,0
15152,2421,0,0,108,108,0,1,0,1,0
1080,3095,0,0,139,139,0,1,0,1,0
10583,1543,0,0,67,67,0,1,0,1,0
3944,612,0,0,132,132,0,1,0,1,0
601,2938,0,0,140,140,0,1,0,1,0
2221,1609,0,0,75,75,0,1,0,1,0
350,2566,0,0,143,143,0,1,0,1,0
2073,183,8199,121,293,223,70,4,0,3,1
8327,1615,0,0,146,146,0,1,0,1,0
10515,1572,0,0,73,73,0,1,0,1,0
1992,566,0,0,99,99,0,1,0,1,0
555,1176,0,0,149,149,0,1,0,1,0
9180,1310,0,0,122,122,0,1,0,1,0
7837,1959,0,0,117,117,0,1,0,1,0
2901,1627,0,0,72,72,0,1,0,1,0
1591,183,5806,121,293,223,70,4,0,3,1
1815,183,7164,121,293,223,70,4,0,3,1
4620,355,0,0,146,146,0,1,0,1,0
2172,371,0,0,86,86,0,1,0,1,0
11688,1619,0,0,66,66,0,1,0,1,0
650,641,1926,65,223,186,37,2,0,2,0
1981,1201,0,0,138,138,0,1,0,1,0
72,1015,0,0,157,157,0,1,0,1,0
1858,3095,0,0,152,152,0,1,0,1,0
1869,1176,0,0,142,142,0,1,0,1,0
3644,183,12921,121,293,223,70,4,0,3,1
2134,183,8354,121,293,223,70,4,0,3,1
2900,1637,0,0,71,71,0,1,0,1,0
9147,1543,0,0,118,118,0,1,0,1,0
3458,1208,0,0,93,93,0,1,0,1,0
2713,1176,0,0,146,146,0,1,0,1,0
10235,1129,0,0,145,145,0,1,0,1,0
1531,881,0,0,143,143,0,1,0,1,0
8327,1648,0,0,146,146,0,1,0,1,0
1400,3095,0,0,140,140,0,1,0,1,0
1241,2979,0,0,139,139,0,1,0,1,0
8303,1441,0,0,149,149,0,1,0,1,0
10418,1550,0,0,71,71,0,1,0,1,0
2425,2707,0,0,132,132,0,1,0,1,0
3805,183,13347,121,293,223,70,4,0,3,1
1746,745,0,0,146,146,0,1,0,1,0
11476,1679,0,0,62,62,0,1,0,1,0
178,1040,0,0,157,157,0,1,0,1,0
20511,2116,0,0,92,92,0,1,0,1,0
3074,183,11418,121,293,223,70,4,0,3,1
1128,2910,0,0,140,140,0,1,0,1,0
14378,298,0,0,145,145,0,1,0,1,0
318,1072,0,0,157,157,0,1,0,1,0
2232,3095,0,0,158,158,0,1,0,1,0
1937,1117,0,0,128,128,0,1,0,1,0
8307,1574,0,0,148,148,0,1,0,1,0
2011,759,0,0,62,62,0,1,0,1,0
1431,183,4980,121,293,223,70,4,1,3,1
972,3095,0,0,142,142,0,1,0,1,0
2453,1694,0,0,62,62,0,1,0,1,0
2010,183,7856,121,293,223,70,4,0,3,1
1931,1171,0,0,143,143,0,1,0,1,0
7346,850,0,0,153,153,0,1,0,1,0
9525,1950,0,0,69,69,0,1,0,1,0
18980,1543,0,0,64,64,0,1,0,1,0
1896,2263,0,0,94,94,0,1,0,1,0
8551,2425,0,0,66,66,0,1,0,1,0
6147,497,0,0,146,146,0,1,0,1,0
1489,1004,0,0,141,141,0,1,0,1,0
1695,1176,0,0,141,141,0,1,0,1,0
1879,183,7163,121,293,223,70,4,0,3,1
2935,1255,0,0,134,134,0,1,0,1,0
1226,183,4802,121,293,223,70,4,0,3,1
2075,183,7306,121,293,223,70,4,1,3,1
3818,874,0,0,147,147,0,1,0,1,0
2337,1392,0,0,109,109,0,1,0,1,0
867,396,2811,95,263,208,54,3,0,2,0
2014,1011,0,0,131,131,0,1,0,1,0
1822,183,7194,121,293,223,70,4,0,3,1
1075,3095,0,0,143,143,0,1,0,1,0
12970,743,0,0,113,113,0,1,0,1,0
1943,1030,0,0,107,107,0,1,0,1,0
2115,1449,0,0,100,100,0,1,0,1,0
3504,183,12551,121,293,223,70,4,0,3,1
10544,1543,0,0,67,67,0,1,0,1,0
1866,183,7099,121,293,223,70,4,0,3,1
2812,874,0,0,125,125,0,1,0,1,0
1520,183,5427,121,293,223,70,4,0,3,1
1616,183,5877,121,293,223,70,4,0,3,1
7819,2268,0,0,105,105,0,1,0,1,0
8494,1694,0,0,141,141,0,1,0,1,0
2811,871,0,0,125,125,0,1,0,1,0
2088,1578,0,0,79,79,0,1,0,1,0
3435,850,0,0,147,147,0,1,0,1,0
2368,984,0,0,98,98,0,1,0,1,0
1031,183,3845,121,293,223,70,4,1,3,1
303,1631,0,0,143,143,0,1,0,1,0
1971,183,7641,121,293,223,70,4,0,3,1
381,1168,0,0,143,143,0,1,0,1,0
17617,2929,0,0,137,137,0,1,0,1,0
19364,2669,0,0,122,122,0,1,0,1,0
2523,1494,0,0,95,95,0,1,0,1,0
784,1048,460,15,174,165,8,1,0,1,0
4809,544,0,0,146,146,0,1,0,1,0
2918,1694,0,0,62,62,0,1,0,1,0
1518,919,0,0,142,142,0,1,0,1,0
9881,1615,0,0,105,105,0,1,0,1,0
2270,493,0,0,95,95,0,1,0,1,0
1290,3095,0,0,139,139,0,1,0,1,0
8319,1646,0,0,147,147,0,1,0,1,0
2922,1694,0,0,62,62,0,1,0,1,0
9805,1604,0,0,95,95,0,1,0,1,0
1953,897,0,0,75,75,0,1,0,1,0
2855,1176,0,0,147,147,0,1,0,1,0
1640,183,5995,121,293,223,70,4,0,3,1
2330,113,0,0,80,80,0,1,0,1,0
4531,636,0,0,146,146,0,1,0,1,0
11503,1685,0,0,62,62,0,1,0,1,0
4321,385,0,0,146,146,0,1,0,1,0
8607,1239,0,0,142,142,0,1,0,1,0
2907,1426,0,0,106,106,0,1,0,1,0
1819,183,6918,121,293,223,70,4,0,3,1
1191,2998,0,0,143,143,0,1,0,1,0
1172,3095,0,0,145,145,0,1,0,1,0
1377,3095,0,0,147,147,0,1,0,1,0
1684,604,0,0,147,147,0,1,0,1,0
1392,3095,0,0,139,139,0,1,0,1,0
2948,1618,0,0,62,62,0,1,0,1,0
4901,183,16421,121,293,223,70,4,1,3,1
1971,183,7645,121,293,223,70,4,0,3,1
1804,3095,0,0,148,148,0,1,0,1,0
1743,2579,0,0,110,110,0,1,0,1,0
2968,1694,0,0,62,62,0,1,0,1,0
1603,1176,0,0,140,140,0,1,0,1,0
10667,1543,0,0,65,65,0,1,0,1,0
8856,1543,0,0,128,128,0,1,0,1,0
1497,183,5306,121,293,223,70,4,0,3,1
2040,183,8018,121,293,223,70,4,0,3,1
2951,183,10778,121,293,223,70,4,0,3,1
965,3095,0,0,140,140,0,1,0,1,0
2232,183,9119,121,293,223,70,4,0,3,1
3734,301,0,0,124,124,0,1,0,1,0
7303,3010,0,0,64,64,0,1,0,1,0
2891,1694,0,0,62,62,0,1,0,1,0
3284,183,10973,121,293,223,70,4,1,3,1
874,341,3008,101,271,212,58,3,0,2,0
2970,1694,0,0,62,62,0,1,0,1,0
14732,2337,0,0,100,100,0,1,0,1,0
2871,1160,0,0,144,144,0,1,0,1,0
20113,2308,0,0,102,102,0,1,0,1,0
8250,1220,0,0,156,156,0,1,0,1,0
2679,1576,0,0,80,80,0,1,0,1,0
1061,1176,0,0,149,149,0,1,0,1,0
2215,183,9046,121,293,223,70,4,0,3,1
9238,1348,0,0,117,117,0,1,0,1,0
1772,3095,0,0,150,150,0,1,0,1,0
991,183,3983,121,293,223,70,4,0,3,1
2257,2548,0,0,121,121,0,1,0,1,0
1115,183,4181,121,293,223,70,4,1,3,1
12129,720,0,0,145,145,0,1,0,1,0
16436,1700,0,0,145,145,0,1,0,1,0
729,2379,0,0,145,145,0,1,0,1,0
1918,183,7413,121,293,223,70,4,0,3,1
16444,1706,0,0,145,145,0,1,0,1,0
2266,2185,0,0,96,96,0,1,0,1,0
1314,183,5124,121,293,223,70,4,0,3,1
14095,326,0,0,139,139,0,1,0,1,0
9574,1694,0,0,113,113,0,1,0,1,0
17114,2818,0,0,130,130,0,1,0,1,0
4786,339,0,0,146,146,0,1,0,1,0
1621,183,5985,121,293,223,70,4,0,3,1
2383,989,0,0,100,100,0,1,0,1,0
2062,277,0,0,107,107,0,1,0,1,0
2164,1176,0,0,144,144,0,1,0,1,0
2832,932,0,0,130,130,0,1,0,1,0
1307,183,4380,121,293,223,70,4,1,3,1
2903,1568,0,0,82,82,0,1,0,1,0
10531,1543,0,0,68,68,0,1,0,1,0
8792,1665,0,0,130,130,0,1,0,1,0
923,3095,0,0,140,140,0,1,0,1,0
8327,1681,0,0,146,146,0,1,0,1,0
10784,1543,0,0,62,62,0,1,0,1,0
1941,1061,0,0,115,115,0,1,0,1,0
1826,183,6907,121,293,223,70,4,0,3,1
3279,183,12013,121,293,223,70,4,0,3,1
9794,1444,0,0,94,94,0,1,0,1,0
1213,183,4196,121,293,223,70,4,1,3,1
671,1376,0,0,154,154,0,1,0,1,0
480,2530,0,0,144,144,0,1,0,1,0
4013,183,14360,121,293,223,70,4,0,3,1
17350,2323,0,0,145,145,0,1,0,1,0
9543,1620,0,0,104,104,0,1,0,1,0
1094,274,2637,89,254,203,51,3,0,2,0
2710,183,10195,121,293,223,70,4,0,3,1
9740,1543,0,0,94,94,0,1,0,1,0
1244,3033,0,0,143,143,0,1,0,1,0
623,1046,0,0,144,144,0,1,0,1,0
1706,1000,0,0,98,98,0,1,0,1,0
13108,641,0,0,122,122,0,1,0,1,0
765,2718,0,0,144,144,0,1,0,1,0
2214,1788,0,0,67,67,0,1,0,1,0
1099,3095,0,0,139,139,0,1,0,1,0
13610,1543,0,0,62,62,0,1,0,1,0
2516,1488,0,0,94,94,0,1,0,1,0
7298,3002,0,0,64,64,0,1,0,1,0
13658,587,0,0,125,125,0,1,0,1,0
20197,2267,0,0,100,100,0,1,0,1,0
1517,923,0,0,142,142,0,1,0,1,0
21326,1723,0,0,71,71,0,1,0,1,0
557,2581,0,0,144,144,0,1,0,1,0
2564,1461,0,0,100,100,0,1,0,1,0
2626,183,8862,121,293,223,70,4,1,3,1
2742,1694,0,0,62,62,0,1,0,1,0
1925,183,7394,121,293,223,70,4,0,3,1
893,3095,0,0,141,141,0,1,0,1,0
2941,1280,0,0,130,130,0,1,0,1,0
8327,1548,0,0,146,146,0,1,0,1,0
1052,3095,0,0,139,139,0,1,0,1,0
11708,1608,0,0,66,66,0,1,0,1,0
2132,414,0,0,89,89,0,1,0,1,0
12330,1283,0,0,85,85,0,1,0,1,0
2068,183,8170,121,293,223,70,4,0,3,1
2317,1355,0,0,115,115,0,1,0,1,0
11729,1202,0,0,83,83,0,1,0,1,0
1395,3095,0,0,140,140,0,1,0,1,0
9073,1543,0,0,120,120,0,1,0,1,0
7652,961,0,0,154,154,0,1,0,1,0
1774,183,6691,121,293,223,70,4,0,3,1
684,1349,0,0,155,155,0,1,0,1,0
8299,1525,0,0,149,149,0,1,0,1,0
1109,3095,0,0,139,139,0,1,0,1,0
626,826,0,0,153,153,0,1,0,1,0
1565,183,5667,121,293,223,70,4,0,3,1
8327,1553,0,0,146,146,0,1,0,1,0
2088,1176,0,0,143,143,0,1,0,1,0
1931,183,7429,121,293,223,70,4,0,3,1
1869,896,0,0,74,74,0,1,0,1,0
1943,1039,0,0,110,110,0,1,0,1,0
8825,1276,0,0,133,133,0,1,0,1,0
1982,1249,0,0,131,131,0,1,0,1,0
2268,370,0,0,62,62,0,1,0,1,0
2610,1424,0,0,106,106,0,1,0,1,0
2416,198,0,0,75,75,0,1,0,1,0
3426,225,0,0,108,108,0,1,0,1,0
1432,3095,0,0,148,148,0,1,0,1,0
1922,183,7377,121,293,223,70,4,0,3,1
8270,1294,0,0,153,153,0,1,0,1,0
3000,1694,0,0,62,62,0,1,0,1,0
42,1008,0,0,157,157,0,1,0,1,0
11129,1640,0,0,65,65,0,1,0,1,0
1591,1073,0,0,115,115,0,1,0,1,0
3830,183,13931,121,293,223,70,4,0,3,1
2542,1694,0,0,62,62,0,1,0,1,0
1828,922,0,0,80,80,0,1,0,1,0
1480,3014,0,0,134,134,0,1,0,1,0
915,183,3620,121,293,223,70,4,1,3,1
1791,1176,0,0,141,141,0,1,0,1,0
2674,2174,0,0,95,95,0,1,0,1,0
981,1176,0,0,154,154,0,1,0,1,0
1471,3095,0,0,148,148,0,1,0,1,0
4786,183,16278,121,293,223,70,4,1,3,1
1433,1168,0,0,139,139,0,1,0,1,0
1829,420,0,0,130,130,0,1,0,1,0
4884,183,16400,121,293,223,70,4,1,3,1
1492,1136,0,0,129,129,0,1,0,1,0
19244,2727,0,0,125,125,0,1,0,1,0
1405,3095,0,0,140,140,0,1,0,1,0
921,195,3454,116,287,220,67,3,0,2,0
2034,183,8103,121,293,223,70,4,0,3,1
8273,1362,0,0,153,153,0,1,0,1,0
55,1273,0,0,154,154,0,1,0,1,0
10302,1532,0,0,74,74,0,1,0,1,0
1427,1176,0,0,139,139,0,1,0,1,0
9757,1587,0,0,93,93,0,1,0,1,0
2469,1242,0,0,62,62,0,1,0,1,0
2483,1432,0,0,102,102,0,1,0,1,0
1519,3095,0,0,149,149,0,1,0,1,0
9814,1694,0,0,107,107,0,1,0,1,0
832,3095,0,0,139,139,0,1,0,1,0
11623,1692,0,0,62,62,0,1,0,1,0
2549,183,9220,121,293,223,70,4,0,3,1
147,1067,0,0,151,151,0,1,0,1,0
10034,1590,0,0,88,88,0,1,0,1,0
4984,183,16524,121,293,223,70,4,1,3,1
1919,1474,0,0,94,94,0,1,0,1,0
2733,55,0,0,73,73,0,1,0,1,0
2907,1440,0,0,104,104,0,1,0,1,0
14514,390,0,0,145,145,0,1,0,1,0
2008,1176,0,0,143,143,0,1,0,1,0
448,1176,0,0,145,145,0,1,0,1,0
1124,3095,0,0,139,139,0,1,0,1,0
988,3095,0,0,139,139,0,1,0,1,0
11449,1681,0,0,62,62,0,1,0,1,0
8327,1622,0,0,146,146,0,1,0,1,0
613,1176,0,0,151,151,0,1,0,1,0
10477,1543,0,0,69,69,0,1,0,1,0
2416,1694,0,0,62,62,0,1,0,1,0
2727,1694,0,0,62,62,0,1,0,1,0
240,1054,0,0,157,157,0,1,0,1,0
1392,3095,0,0,140,140,0,1,0,1,0
2186,183,8851,121,293,223,70,4,0,3,1
7668,2484,0,0,93,93,0,1,0,1,0
13250,801,0,0,113,113,0,1,0,1,0
2131,183,8537,121,293,223,70,4,0,3,1
1425,594,0,0,149,149,0,1,0,1,0
11488,1694,0,0,63,63,0,1,0,1,0
6907,690,0,0,151,151,0,1,0,1,0
1355,183,4601,121,293,223,70,4,0,3,1
2419,1001,0,0,103,103,0,1,0,1,0
9221,1543,0,0,115,115,0,1,0,1,0
9931,1468,0,0,89,89,0,1,0,1,0
1946,997,0,0,100,100,0,1,0,1,0
13317,2051,0,0,83,83,0,1,0,1,0
876,3095,0,0,139,139,0,1,0,1,0
337,1378,0,0,143,143,0,1,0,1,0
1719,1176,0,0,141,141,0,1,0,1,0
750,1736,0,0,151,151,0,1,0,1,0
11060,1594,0,0,62,62,0,1,0,1,0
7656,2309,0,0,99,99,0,1,0,1,0
17619,183,24576,121,293,223,70,4,0,3,1
7829,1298,0,0,146,146,0,1,0,1,0
1407,3095,0,0,140,140,0,1,0,1,0
2108,183,8403,121,293,223,70,4,0,3,1
274,2453,0,0,144,144,0,1,0,1,0
1906,183,7438,121,293,223,70,4,0,3,1
1489,1211,0,0,133,133,0,1,0,1,0
1349,3095,0,0,142,142,0,1,0,1,0
8245,1187,0,0,156,156,0,1,0,1,0
13426,439,0,0,145,145,0,1,0,1,0
8248,1201,0,0,156,156,0,1,0,1,0
1911,2301,0,0,95,95,0,1,0,1,0
1982,1250,0,0,131,131,0,1,0,1,0
2147,1613,0,0,73,73,0,1,0,1,0
1512,599,0,0,147,147,0,1,0,1,0
3629,938,0,0,111,111,0,1,0,1,0
1269,3049,0,0,143,143,0,1,0,1,0
1740,733,0,0,146,146,0,1,0,1,0
21090,1837,0,0,77,77,0,1,0,1,0
11265,1374,0,0,72,72,0,1,0,1,0
10573,1543,0,0,67,67,0,1,0,1,0
1386,183,4750,121,293,223,70,4,0,3,1
9347,1543,0,0,111,111,0,1,0,1,0
11465,1683,0,0,62,62,0,1,0,1,0
7671,968,0,0,154,154,0,1,0,1,0
1751,3095,0,0,146,146,0,1,0,1,0
13087,1543,0,0,69,69,0,1,0,1,0
11376,1659,0,0,62,62,0,1,0,1,0
2660,1694,0,0,62,62,0,1,0,1,0
498,1176,0,0,147,147,0,1,0,1,0
8167,1899,0,0,133,133,0,1,0,1,0
2461,1545,0,0,86,86,0,1,0,1,0
10137,1583,0,0,84,84,0,1,0,1,0
2114,183,8460,121,293,223,70,4,0,3,1
2688,1694,0,0,62,62,0,1,0,1,0
2078,3095,0,0,154,154,0,1,0,1,0
17712,2570,0,0,145,145,0,1,0,1,0
3173,1410,0,0,80,80,0,1,0,1,0
8029,1588,0,0,136,136,0,1,0,1,0
2845,1176,0,0,147,147,0,1,0,1,0
1923,183,7367,121,293,223,70,4,0,3,1
1432,183,5674,121,293,223,70,4,0,3,1
2761,723,0,0,114,114,0,1,0,1,0
489,2772,0,0,141,141,0,1,0,1,0
11487,1686,0,0,62,62,0,1,0,1,0
1922,183,7380,121,293,223,70,4,0,3,1
8296,1503,0,0,150,150,0,1,0,1,0
7274,3047,0,0,62,62,0,1,0,1,0
14622,464,0,0,145,145,0,1,0,1,0
1958,183,6890,121,293,223,70,4,1,3,1
507,910,956,32,183,164,18,1,0,1,0
3019,1595,0,0,78,78,0,1,0,1,0
1112,924,0,0,153,153,0,1,0,1,0
1373,3095,0,0,141,141,0,1,0,1,0
1591,3095,0,0,147,147,0,1,0,1,0
1370,242,3635,100,268,210,58,3,0,2,0
1718,3095,0,0,149,149,0,1,0,1,0
4404,183,15574,121,293,223,70,4,1,3,1
3887,707,0,0,126,126,0,1,0,1,0
1854,994,0,0,144,144,0,1,0,1,0
7908,2232,0,0,112,112,0,1,0,1,0
679,3054,0,0,139,139,0,1,0,1,0
4602,183,15354,121,293,223,70,4,0,3,1
3386,183,12241,121,293,223,70,4,0,3,1
2229,183,9105,121,293,223,70,4,0,3,1
2769,1624,0,0,72,72,0,1,0,1,0
1822,183,6888,121,293,223,70,4,0,3,1
10816,1544,0,0,62,62,0,1,0,1,0
1813,692,0,0,102,102,0,1,0,1,0
2636,1504,0,0,91,91,0,1,0,1,0
7424,2833,0,0,74,74,0,1,0,1,0
7282,3036,0,0,62,62,0,1,0,1,0
7446,1210,0,0,146,146,0,1,0,1,0
8084,1482,0,0,141,141,0,1,0,1,0
2011,1218,0,0,136,136,0,1,0,1,0
1987,183,7757,121,293,223,70,4,0,3,1
10525,1543,0,0,68,68,0,1,0,1,0
11508,1686,0,0,62,62,0,1,0,1,0
1905,1176,0,0,142,142,0,1,0,1,0
18146,3030,0,0,141,141,0,1,0,1,0
11383,1660,0,0,62,62,0,1,0,1,0
2348,250,0,0,62,62,0,1,0,1,0
7973,2707,0,0,64,64,0,1,0,1,0
2216,930,0,0,85,85,0,1,0,1,0
2598,1343,0,0,62,62,0,1,0,1,0
13474,684,0,0,120,120,0,1,0,1,0
9452,1625,0,0,107,107,0,1,0,1,0
264,1059,0,0,157,157,0,1,0,1,0
8627,1230,0,0,142,142,0,1,0,1,0
1197,3095,0,0,142,142,0,1,0,1,0
1855,905,0,0,77,77,0,1,0,1,0
2151,1616,0,0,73,73,0,1,0,1,0
14005,2190,0,0,91,91,0,1,0,1,0
1828,708,0,0,98,98,0,1,0,1,0
10047,183,20066,121,293,223,70,4,0,3,1
1575,567,0,0,147,147,0,1,0,1,0
365,1179,0,0,143,143,0,1,0,1,0
2960,1694,0,0,62,62,0,1,0,1,0
10093,1496,0,0,82,82,0,1,0,1,0
27,1007,0,0,156,156,0,1,0,1,0
10663,1551,0,0,66,66,0,1,0,1,0
532,1121,0,0,157,157,0,1,0,1,0
1949,183,7534,121,293,223,70,4,0,3,1
11014,1585,0,0,62,62,0,1,0,1,0
1341,3095,0,0,142,142,0,1,0,1,0
1939,1088,0,0,121,121,0,1,0,1,0
10761,1657,0,0,82,82,0,1,0,1,0
1068,262,2757,93,259,205,53,3,0,2,0
3805,183,13694,121,293,223,70,4,0,3,1
1738,3095,0,0,146,146,0,1,0,1,0
3377,183,12327,121,293,223,70,4,0,3,1
1239,2977,0,0,139,139,0,1,0,1,0
3043,1690,0,0,62,62,0,1,0,1,0
8299,1422,0,0,149,149,0,1,0,1,0
10513,1543,0,0,68,68,0,1,0,1,0
2221,1079,0,0,62,62,0,1,0,1,0
1724,695,0,0,146,146,0,1,0,1,0
1807,1406,0,0,104,104,0,1,0,1,0
1923,1154,0,0,143,143,0,1,0,1,0
8327,1552,0,0,146,146,0,1,0,1,0
7328,2979,0,0,66,66,0,1,0,1,0
2577,1450,0,0,102,102,0,1,0,1,0
12837,2016,0,0,94,94,0,1,0,1,0
2126,183,8503,121,293,223,70,4,0,3,1
1546,480,497,16,168,158,9,1,0,1,0
1169,771,0,0,146,146,0,1,0,1,0
1054,966,0,0,154,154,0,1,0,1,0
1955,877,0,0,71,71,0,1,0,1,0
579,2906,0,0,140,140,0,1,0,1,0
4532,183,14975,121,293,223,70,4,1,3,1
994,183,3772,121,293,223,70,4,1,3,1
1934,183,7445,121,293,223,70,4,0,3,1
4402,183,14713,121,293,223,70,4,0,3,1
1394,183,4939,121,293,223,70,4,1,3,1
2128,183,8600,121,293,223,70,4,0,3,1
650,1176,0,0,152,152,0,1,0,1,0
7347,2944,0,0,67,67,0,1,0,1,0
1260,815,0,0,151,151,0,1,0,1,0
4582,183,16025,121,293,223,70,4,1,3,1
1653,531,0,0,147,147,0,1,0,1,0
8327,1686,0,0,146,146,0,1,0,1,0
775,783,0,0,152,152,0,1,0,1,0
3745,655,0,0,146,146,0,1,0,1,0
10895,1367,0,0,81,81,0,1,0,1,0
1418,3095,0,0,139,139,0,1,0,1,0
3163,1420,0,0,79,79,0,1,0,1,0
1270,3095,0,0,139,139,0,1,0,1,0
2047,183,8057,121,293,223,70,4,0,3,1
8327,1665,0,0,146,146,0,1,0,1,0
1576,584,0,0,148,148,0,1,0,1,0
14011,403,0,0,136,136,0,1,0,1,0
2134,3095,0,0,156,156,0,1,0,1,0
2331,1694,0,0,62,62,0,1,0,1,0
10445,1543,0,0,70,70,0,1,0,1,0
1111,183,4169,121,293,223,70,4,1,3,1
491,2775,0,0,141,141,0,1,0,1,0
956,3095,0,0,140,140,0,1,0,1,0
11456,1675,0,0,62,62,0,1,0,1,0
8231,1198,0,0,155,155,0,1,0,1,0
346,907,0,0,155,155,0,1,0,1,0
1295,183,4670,121,293,223,70,4,1,3,1
509,905,973,32,183,164,19,1,0,1,0
1302,1160,0,0,140,140,0,1,0,1,0
8867,1284,0,0,131,131,0,1,0,1,0
1900,3095,0,0,152,152,0,1,0,1,0
2912,1694,0,0,62,62,0,1,0,1,0
1797,183,6766,121,293,223,70,4,0,3,1
1737,183,6582,121,293,223,70,4,0,3,1
5087,451,0,0,146,146,0,1,0,1,0
13048,2056,0,0,96,96,0,1,0,1,0
10101,1498,0,0,82,82,0,1,0,1,0
1659,183,6116,121,293,223,70,4,0,3,1
2845,971,0,0,133,133,0,1,0,1,0
1855,1435,0,0,100,100,0,1,0,1,0
12283,1683,0,0,62,62,0,1,0,1,0
3030,1694,0,0,62,62,0,1,0,1,0
1711,183,6344,121,293,223,70,4,0,3,1
2257,2552,0,0,121,121,0,1,0,1,0
1478,3095,0,0,149,149,0,1,0,1,0
976,868,0,0,145,145,0,1,0,1,0
2244,183,9189,121,293,223,70,4,0,3,1
13372,737,0,0,116,116,0,1,0,1,0
2970,183,10484,121,293,223,70,4,1,3,1
1738,183,6513,121,293,223,70,4,0,3,1
1584,727,0,0,145,145,0,1,0,1,0
8787,2310,0,0,66,66,0,1,0,1,0
1037,183,3967,121,293,223,70,4,1,3,1
9248,1343,0,0,145,145,0,1,0,1,0
11224,1628,0,0,62,62,0,1,0,1,0
1192,1176,0,0,151,151,0,1,0,1,0
2162,1176,0,0,144,144,0,1,0,1,0
2996,1500,0,0,94,94,0,1,0,1,0
2959,1352,0,0,118,118,0,1,0,1,0
9573,183,19713,121,293,223,70,4,0,3,1
1955,183,7567,121,293,223,70,4,0,3,1
1525,183,5491,121,293,223,70,4,0,3,1
7571,2623,0,0,85,85,0,1,0,1,0
2090,886,0,0,73,73,0,1,0,1,0
2829,1843,0,0,72,72,0,1,0,1,0
10347,1543,0,0,77,77,0,1,0,1,0
5449,330,0,0,146,146,0,1,0,1,0
2128,183,8537,121,293,223,70,4,0,3,1
1628,504,308,8,158,153,4,1,0,1,0
17806,183,24773,121,293,223,70,4,0,3,1
3026,1694,0,0,62,62,0,1,0,1,0
1758,637,0,0,118,118,0,1,0,1,0
5292,288,0,0,146,146,0,1,0,1,0
2064,183,8145,121,293,223,70,4,0,3,1
7302,2993,0,0,64,64,0,1,0,1,0
7343,2915,0,0,68,68,0,1,0,1,0
1467,183,5188,121,293,223,70,4,0,3,1
21486,829,14935,63,183,146,36,2,0,2,0
8413,183,18846,121,293,223,70,4,0,3,1
1561,795,0,0,144,144,0,1,0,1,0
1463,1081,0,0,140,140,0,1,0,1,0
20757,183,28071,121,293,223,70,4,0,3,1
1747,183,6722,121,293,223,70,4,0,3,1
4824,183,15986,121,293,223,70,4,0,3,1
255,1120,0,0,147,147,0,1,0,1,0
1171,880,0,0,152,152,0,1,0,1,0
1645,3095,0,0,144,144,0,1,0,1,0
2842,1235,0,0,138,138,0,1,0,1,0
1940,1187,0,0,141,141,0,1,0,1,0
20076,2326,0,0,103,103,0,1,0,1,0
2933,1694,0,0,62,62,0,1,0,1,0
360,1214,0,0,143,143,0,1,0,1,0
2459,1546,0,0,86,86,0,1,0,1,0
550,2862,0,0,140,140,0,1,0,1,0
2777,771,0,0,118,118,0,1,0,1,0
1430,183,4977,121,293,223,70,4,0,3,1
3825,872,0,0,147,147,0,1,0,1,0
225,2190,0,0,144,144,0,1,0,1,0
1169,1176,0,0,146,146,0,1,0,1,0
1197,183,4165,121,293,223,70,4,1,3,1
15434,1018,0,0,145,145,0,1,0,1,0
1332,183,4490,121,293,223,70,4,1,3,1
2384,1176,0,0,145,145,0,1,0,1,0
1545,1176,0,0,139,139,0,1,0,1,0
2096,1210,0,0,62,62,0,1,0,1,0
7979,2140,0,0,118,118,0,1,0,1,0
4751,342,0,0,146,146,0,1,0,1,0
1057,3095,0,0,139,139,0,1,0,1,0
2127,3095,0,0,156,156,0,1,0,1,0
2693,2133,0,0,92,92,0,1,0,1,0
2846,1232,0,0,138,138,0,1,0,1,0
2708,1344,0,0,120,120,0,1,0,1,0
1884,765,0,0,82,82,0,1,0,1,0
7429,2748,0,0,77,77,0,1,0,1,0
8561,1231,0,0,144,144,0,1,0,1,0
10722,1655,0,0,83,83,0,1,0,1,0
1893,3095,0,0,152,152,0,1,0,1,0
1758,183,6075,121,293,223,70,4,1,3,1
2218,183,9036,121,293,223,70,4,0,3,1
857,1176,0,0,154,154,0,1,0,1,0
1553,183,5576,121,293,223,70,4,0,3,1
10667,1582,0,0,69,69,0,1,0,1,0
3477,183,12646,121,293,223,70,4,0,3,1
608,1139,0,0,157,157,0,1,0,1,0
7766,2344,0,0,101,101,0,1,0,1,0
722,2620,0,0,143,143,0,1,0,1,0
1291,364,1704,57,217,183,33,2,0,1,0
262,1927,0,0,144,144,0,1,0,1,0
2081,1255,0,0,130,130,0,1,0,1,0
1724,696,0,0,146,146,0,1,0,1,0
10441,1085,0,0,145,145,0,1,0,1,0
9956,1619,0,0,103,103,0,1,0,1,0
7771,1004,0,0,154,154,0,1,0,1,0
1025,3095,0,0,141,141,0,1,0,1,0
1004,3095,0,0,140,140,0,1,0,1,0
11256,1634,0,0,62,62,0,1,0,1,0
3135,183,10956,121,293,223,70,4,0,3,1
1276,183,5067,121,293,223,70,4,0,3,1
5572,289,0,0,146,146,0,1,0,1,0
1631,183,5979,121,293,223,70,4,0,3,1
4877,183,16390,121,293,223,70,4,1,3,1
2166,183,8734,121,293,223,70,4,0,3,1
2071,183,8187,121,293,223,70,4,0,3,1
8320,1652,0,0,146,146,0,1,0,1,0
2129,183,8521,121,293,223,70,4,0,3,1
2530,1488,0,0,96,96,0,1,0,1,0
11392,1662,0,0,62,62,0,1,0,1,0
521,1176,0,0,148,148,0,1,0,1,0
8569,183,19169,121,293,223,70,4,0,3,1
8215,1488,0,0,146,146,0,1,0,1,0
2499,1514,0,0,91,91,0,1,0,1,0
1068,183,4051,121,293,223,70,4,1,3,1
2304,1349,0,0,115,115,0,1,0,1,0
1670,183,6171,121,293,223,70,4,0,3,1
14590,1543,0,0,62,62,0,1,0,1,0
13590,483,0,0,131,131,0,1,0,1,0
1424,3095,0,0,139,139,0,1,0,1,0
277,1131,0,0,146,146,0,1,0,1,0
2047,1078,0,0,62,62,0,1,0,1,0
1299,183,5155,121,293,223,70,4,0,3,1
977,3095,0,0,142,142,0,1,0,1,0
1961,848,0,0,62,62,0,1,0,1,0
1460,183,5123,121,293,223,70,4,0,3,1
11401,1675,0,0,63,63,0,1,0,1,0
1603,1065,0,0,113,113,0,1,0,1,0
731,2310,0,0,146,146,0,1,0,1,0
3273,183,11364,121,293,223,70,4,0,3,1
1622,614,0,0,146,146,0,1,0,1,0
148,1945,0,0,148,148,0,1,0,1,0
1823,183,6891,121,293,223,70,4,0,3,1
11488,183,18575,121,293,223,70,4,0,3,1
4138,183,14758,121,293,223,70,4,0,3,1
8291,1388,0,0,150,150,0,1,0,1,0
1511,385,1816,50,208,179,28,2,0,1,0
2356,1694,0,0,62,62,0,1,0,1,0
1615,183,5930,121,293,223,70,4,0,3,1
17242,762,0,0,112,112,0,1,0,1,0
3713,852,0,0,116,116,0,1,0,1,0
8460,1207,0,0,148,148,0,1,0,1,0
20358,1308,0,0,77,77,0,1,0,1,0
1173,183,4337,121,293,223,70,4,1,3,1
3458,1115,0,0,99,99,0,1,0,1,0
2396,1597,0,0,77,77,0,1,0,1,0
915,899,0,0,145,145,0,1,0,1,0
1388,408,1245,42,198,174,24,2,0,1,0
2023,183,7924,121,293,223,70,4,0,3,1
5640,266,0,0,146,146,0,1,0,1,0
1988,183,8141,121,293,223,70,4,0,3,1
1756,183,6563,121,293,223,70,4,0,3,1
1812,1409,0,0,104,104,0,1,0,1,0
8648,1233,0,0,141,141,0,1,0,1,0
1970,183,7636,121,293,223,70,4,0,3,1
10622,1543,0,0,66,66,0,1,0,1,0
2491,183,8427,121,293,223,70,4,1,3,1
2087,1186,0,0,62,62,0,1,0,1,0
1824,3095,0,0,151,151,0,1,0,1,0
2155,3095,0,0,156,156,0,1,0,1,0
2277,183,8812,121,293,223,70,4,0,3,1
4234,183,15127,121,293,223,70,4,0,3,1
1040,3095,0,0,143,143,0,1,0,1,0
10705,1543,0,0,64,64,0,1,0,1,0
8246,1190,0,0,156,156,0,1,0,1,0
2428,53,0,0,70,70,0,1,0,1,0
9318,1620,0,0,109,109,0,1,0,1,0
498,1736,0,0,151,151,0,1,0,1,0
13030,721,0,0,114,114,0,1,0,1,0
1241,183,4250,121,293,223,70,4,1,3,1
2640,1694,0,0,62,62,0,1,0,1,0
200,2325,0,0,145,145,0,1,0,1,0
343,1164,0,0,143,143,0,1,0,1,0
3743,656,0,0,146,146,0,1,0,1,0
2401,1694,0,0,62,62,0,1,0,1,0
15281,914,0,0,145,145,0,1,0,1,0
369,1176,0,0,143,143,0,1,0,1,0
869,3095,0,0,139,139,0,1,0,1,0
3196,1515,0,0,73,73,0,1,0,1,0
1619,1291,0,0,121,121,0,1,0,1,0
10215,1517,0,0,77,77,0,1,0,1,0
2193,484,0,0,62,62,0,1,0,1,0
3834,726,0,0,124,124,0,1,0,1,0
2931,1694,0,0,62,62,0,1,0,1,0
9827,1450,0,0,93,93,0,1,0,1,0
7598,2422,0,0,93,93,0,1,0,1,0
1763,183,6642,121,293,223,70,4,0,3,1
16036,1428,0,0,145,145,0,1,0,1,0
1860,902,0,0,76,76,0,1,0,1,0
431,1176,0,0,142,142,0,1,0,1,0
2428,183,9165,121,293,223,70,4,0,3,1
7355,3009,0,0,62,62,0,1,0,1,0
1177,1176,0,0,145,145,0,1,0,1,0
10210,1554,0,0,77,77,0,1,0,1,0
2366,91,0,0,76,76,0,1,0,1,0
1667,565,0,0,147,147,0,1,0,1,0
3039,1677,0,0,64,64,0,1,0,1,0
8327,1624,0,0,146,146,0,1,0,1,0
8643,1233,0,0,142,142,0,1,0,1,0
2117,3095,0,0,156,156,0,1,0,1,0
5994,396,0,0,146,146,0,1,0,1,0
15617,2547,0,0,119,119,0,1,0,1,0
7734,2158,0,0,107,107,0,1,0,1,0
12545,1170,0,0,92,92,0,1,0,1,0
8272,1664,0,0,146,146,0,1,0,1,0
810,847,1185,40,202,178,23,1,0,1,0
1630,592,0,0,147,147,0,1,0,1,0
9396,1614,0,0,107,107,0,1,0,1,0
1372,1176,0,0,139,139,0,1,0,1,0
1550,183,5556,121,293,223,70,4,0,3,1
206,2334,0,0,144,144,0,1,0,1,0
5751,350,0,0,142,142,0,1,0,1,0
11710,1543,0,0,70,70,0,1,0,1,0
318,1520,0,0,143,143,0,1,0,1,0
1572,1262,0,0,126,126,0,1,0,1,0
1965,183,7647,121,293,223,70,4,0,3,1
634,671,1820,61,219,183,35,2,0,2,0
1811,431,0,0,132,132,0,1,0,1,0
11230,1653,0,0,64,64,0,1,0,1,0
5859,541,0,0,137,137,0,1,0,1,0
1294,790,0,0,151,151,0,1,0,1,0
2359,234,0,0,62,62,0,1,0,1,0
2342,259,0,0,62,62,0,1,0,1,0
1939,183,7939,121,293,223,70,4,0,3,1
1116,183,4009,121,293,223,70,4,1,3,1
1307,3095,0,0,146,146,0,1,0,1,0
293,1697,0,0,143,143,0,1,0,1,0
2985,1694,0,0,62,62,0,1,0,1,0
1377,3095,0,0,141,141,0,1,0,1,0
1994,183,7906,121,293,223,70,4,0,3,1
3409,183,12682,121,293,223,70,4,0,3,1
964,1176,0,0,151,151,0,1,0,1,0
2234,1577,0,0,62,62,0,1,0,1,0
2000,183,7824,121,293,223,70,4,0,3,1
8522,2440,0,0,66,66,0,1,0,1,0
798,3095,0,0,139,139,0,1,0,1,0
2460,1694,0,0,62,62,0,1,0,1,0
367,1083,0,0,157,157,0,1,0,1,0
4802,183,16297,121,293,223,70,4,1,3,1
517,1176,0,0,148,148,0,1,0,1,0
2179,183,8814,121,293,223,70,4,0,3,1
1806,686,0,0,104,104,0,1,0,1,0
2921,1174,0,0,147,147,0,1,0,1,0
7904,1830,0,0,123,123,0,1,0,1,0
8013,1619,0,0,134,134,0,1,0,1,0
816,794,1376,46,209,182,26,2,0,1,0
1829,3095,0,0,151,151,0,1,0,1,0
2019,183,7901,121,293,223,70,4,0,3,1
7941,2190,0,0,115,115,0,1,0,1,0
1853,183,7313,121,293,223,70,4,0,3,1
1903,1176,0,0,142,142,0,1,0,1,0
462,2731,0,0,141,141,0,1,0,1,0
2597,1532,0,0,87,87,0,1,0,1,0
256,1121,0,0,147,147,0,1,0,1,0
1681,183,6232,121,293,223,70,4,0,3,1
1091,183,4113,121,293,223,70,4,1,3,1
124,1772,0,0,150,150,0,1,0,1,0
598,1176,0,0,151,151,0,1,0,1,0
8327,1640,0,0,146,146,0,1,0,1,0
7480,2649,0,0,82,82,0,1,0,1,0
2012,3095,0,0,155,155,0,1,0,1,0
1817,1412,0,0,103,103,0,1,0,1,0
10092,1496,0,0,82,82,0,1,0,1,0
3349,206,0,0,104,104,0,1,0,1,0
304,1621,0,0,143,143,0,1,0,1,0
2315,1663,0,0,67,67,0,1,0,1,0
2595,239,0,0,79,79,0,1,0,1,0
1961,2165,0,0,89,89,0,1,0,1,0
13068,896,0,0,107,107,0,1,0,1,0
8039,1569,0,0,137,137,0,1,0,1,0
2245,405,0,0,62,62,0,1,0,1,0
3545,780,0,0,146,146,0,1,0,1,0
3621,733,0,0,146,146,0,1,0,1,0
498,2785,0,0,141,141,0,1,0,1,0
10505,183,17584,121,293,223,70,4,0,3,1
1414,183,4995,121,293,223,70,4,1,3,1
3446,183,12398,121,293,223,70,4,0,3,1
873,3095,0,0,140,140,0,1,0,1,0
1905,183,7348,121,293,223,70,4,0,3,1
1322,3095,0,0,147,147,0,1,0,1,0
4980,320,0,0,146,146,0,1,0,1,0
1850,1432,0,0,100,100,0,1,0,1,0
15322,941,0,0,145,145,0,1,0,1,0
2003,1176,0,0,143,143,0,1,0,1,0
11072,1596,0,0,64,64,0,1,0,1,0
8368,1197,0,0,151,151,0,1,0,1,0
13460,526,0,0,129,129,0,1,0,1,0
1337,183,4513,121,293,223,70,4,1,3,1
2922,1203,0,0,143,143,0,1,0,1,0
10279,1575,0,0,79,79,0,1,0,1,0
2011,546,0,0,97,97,0,1,0,1,0
2962,1694,0,0,62,62,0,1,0,1,0
10685,1543,0,0,64,64,0,1,0,1,0
1656,3095,0,0,148,148,0,1,0,1,0
1948,962,0,0,91,91,0,1,0,1,0
8635,1543,0,0,134,134,0,1,0,1,0
2958,1694,0,0,62,62,0,1,0,1,0
9677,1593,0,0,96,96,0,1,0,1,0
820,764,1483,50,213,184,29,2,0,1,0
1869,183,6432,121,293,223,70,4,1,3,1
2197,1057,0,0,62,62,0,1,0,1,0
8325,1187,0,0,153,153,0,1,0,1,0
4397,183,15573,121,293,223,70,4,0,3,1
752,1659,0,0,152,152,0,1,0,1,0
2253,2754,0,0,135,135,0,1,0,1,0
4412,183,14741,121,293,223,70,4,0,3,1
9537,1944,0,0,69,69,0,1,0,1,0
1919,183,7363,121,293,223,70,4,0,3,1
544,2853,0,0,140,140,0,1,0,1,0
10038,1543,0,0,83,83,0,1,0,1,0
8327,1633,0,0,146,146,0,1,0,1,0
2912,1276,0,0,131,131,0,1,0,1,0
93,1548,0,0,152,152,0,1,0,1,0
9282,1356,0,0,115,115,0,1,0,1,0
1041,183,3977,121,293,223,70,4,1,3,1
1707,183,6326,121,293,223,70,4,0,3,1
8745,1562,0,0,135,135,0,1,0,1,0
816,1176,0,0,155,155,0,1,0,1,0
582,2910,0,0,140,140,0,1,0,1,0
328,1157,0,0,144,144,0,1,0,1,0
16944,2046,0,0,145,145,0,1,0,1,0
742,1980,0,0,149,149,0,1,0,1,0
8363,1196,0,0,152,152,0,1,0,1,0
1878,183,7159,121,293,223,70,4,0,3,1
805,886,1045,35,196,176,20,1,0,1,0
1613,2793,0,0,122,122,0,1,0,1,0
306,1146,0,0,145,145,0,1,0,1,0
8370,1543,0,0,144,144,0,1,0,1,0
4140,411,0,0,145,145,0,1,0,1,0
10750,1694,0,0,82,82,0,1,0,1,0
75,1031,0,0,154,154,0,1,0,1,0
74,1030,0,0,154,154,0,1,0,1,0
2055,1101,0,0,62,62,0,1,0,1,0
808,3095,0,0,140,140,0,1,0,1,0
3038,1672,0,0,65,65,0,1,0,1,0
2940,1276,0,0,131,131,0,1,0,1,0
6851,817,0,0,146,146,0,1,0,1,0
2989,1694,0,0,62,62,0,1,0,1,0
8981,1303,0,0,127,127,0,1,0,1,0
1147,183,4069,121,293,223,70,4,1,3,1
1322,183,4439,121,293,223,70,4,1,3,1
15178,1543,0,0,62,62,0,1,0,1,0
18550,1543,0,0,62,62,0,1,0,1,0
2392,2777,0,0,137,137,0,1,0,1,0
1087,3095,0,0,143,143,0,1,0,1,0
155,1994,0,0,148,148,0,1,0,1,0
377,1176,0,0,143,143,0,1,0,1,0
7435,2841,0,0,74,74,0,1,0,1,0
1516,183,5395,121,293,223,70,4,0,3,1
1413,183,4892,121,293,223,70,4,1,3,1
2907,1422,0,0,107,107,0,1,0,1,0
3520,1051,0,0,103,103,0,1,0,1,0
1334,1176,0,0,139,139,0,1,0,1,0
10469,1494,0,0,74,74,0,1,0,1,0
1616,1176,0,0,140,140,0,1,0,1,0
2680,1576,0,0,80,80,0,1,0,1,0
1081,2925,0,0,143,143,0,1,0,1,0
1912,1128,0,0,143,143,0,1,0,1,0
394,2632,0,0,142,142,0,1,0,1,0
10674,1543,0,0,65,65,0,1,0,1,0
1669,183,6170,121,293,223,70,4,0,3,1
21201,1543,0,0,62,62,0,1,0,1,0
8633,1231,0,0,142,142,0,1,0,1,0
10684,1543,0,0,64,64,0,1,0,1,0
6555,672,0,0,146,146,0,1,0,1,0
17175,2831,0,0,129,129,0,1,0,1,0
914,183,3633,121,293,223,70,4,1,3,1
6942,703,0,0,151,151,0,1,0,1,0
8841,1694,0,0,132,132,0,1,0,1,0
2955,1333,0,0,121,121,0,1,0,1,0
1268,183,4302,121,293,223,70,4,1,3,1
1626,1176,0,0,140,140,0,1,0,1,0
2143,1492,0,0,93,93,0,1,0,1,0
2077,3095,0,0,156,156,0,1,0,1,0
8272,1304,0,0,153,153,0,1,0,1,0
11163,1645,0,0,65,65,0,1,0,1,0
1875,183,7197,121,293,223,70,4,0,3,1
9550,1603,0,0,101,101,0,1,0,1,0
11349,1668,0,0,63,63,0,1,0,1,0
4802,337,0,0,146,146,0,1,0,1,0
1188,183,4380,121,293,223,70,4,1,3,1
19917,2402,0,0,107,107,0,1,0,1,0
1427,693,0,0,150,150,0,1,0,1,0
308,1593,0,0,143,143,0,1,0,1,0
1711,183,6341,121,293,223,70,4,0,3,1
8305,1448,0,0,148,148,0,1,0,1,0
1804,880,0,0,145,145,0,1,0,1,0
521,1119,0,0,157,157,0,1,0,1,0
1489,2869,0,0,129,129,0,1,0,1,0
5013,183,16559,121,293,223,70,4,1,3,1
2511,2,0,0,62,62,0,1,0,1,0
2649,2227,0,0,98,98,0,1,0,1,0
14082,365,0,0,138,138,0,1,0,1,0
2633,1176,0,0,146,146,0,1,0,1,0
2900,1650,0,0,69,69,0,1,0,1,0
2871,1694,0,0,62,62,0,1,0,1,0
2088,1259,0,0,129,129,0,1,0,1,0
10362,1543,0,0,71,71,0,1,0,1,0
1174,1176,0,0,139,139,0,1,0,1,0
1484,183,5244,121,293,223,70,4,0,3,1
3021,1694,0,0,62,62,0,1,0,1,0
9206,1543,0,0,116,116,0,1,0,1,0
1757,183,6607,121,293,223,70,4,0,3,1
10590,1543,0,0,66,66,0,1,0,1,0
2101,624,0,0,62,62,0,1,0,1,0
4899,183,16418,121,293,223,70,4,1,3,1
20625,1543,0,0,62,62,0,1,0,1,0
1412,3095,0,0,139,139,0,1,0,1,0
1628,598,0,0,147,147,0,1,0,1,0
7562,2678,0,0,84,84,0,1,0,1,0
2091,259,0,0,104,104,0,1,0,1,0
9443,1611,0,0,105,105,0,1,0,1,0
1506,954,0,0,142,142,0,1,0,1,0
2663,438,0,0,94,94,0,1,0,1,0
12600,1141,0,0,93,93,0,1,0,1,0
947,3095,0,0,139,139,0,1,0,1,0
1129,183,4034,121,293,223,70,4,1,3,1
11032,1588,0,0,62,62,0,1,0,1,0
19433,1576,0,0,62,62,0,1,0,1,0
1636,183,6001,121,293,223,70,4,0,3,1
1890,771,0,0,80,80,0,1,0,1,0
10818,1601,0,0,68,68,0,1,0,1,0
2409,212,0,0,76,76,0,1,0,1,0
1826,747,0,0,110,110,0,1,0,1,0
2985,1455,0,0,101,101,0,1,0,1,0
982,3095,0,0,142,142,0,1,0,1,0
1830,2362,0,0,100,100,0,1,0,1,0
2473,2604,0,0,125,125,0,1,0,1,0
2913,1237,0,0,137,137,0,1,0,1,0
649,1176,0,0,152,152,0,1,0,1,0
2935,1694,0,0,62,62,0,1,0,1,0
1623,1053,0,0,110,110,0,1,0,1,0
265,1125,0,0,147,147,0,1,0,1,0
2236,1632,0,0,71,71,0,1,0,1,0
12390,1252,0,0,87,87,0,1,0,1,0
16504,2695,0,0,121,121,0,1,0,1,0
1309,1176,0,0,142,142,0,1,0,1,0
1877,1047,0,0,143,143,0,1,0,1,0
2239,183,9157,121,293,223,70,4,0,3,1
2228,183,9102,121,293,223,70,4,0,3,1
1707,494,0,0,142,142,0,1,0,1,0
1731,183,6441,121,293,223,70,4,0,3,1
3032,1688,0,0,62,62,0,1,0,1,0
8396,1543,0,0,143,143,0,1,0,1,0
8316,1630,0,0,147,147,0,1,0,1,0
4080,183,14425,121,293,223,70,4,1,3,1
6434,613,0,0,146,146,0,1,0,1,0
2913,1244,0,0,136,136,0,1,0,1,0
2150,183,8646,121,293,223,70,4,0,3,1
21649,1371,3586,15,91,82,8,1,0,1,0
2087,464,0,0,92,92,0,1,0,1,0
273,1844,0,0,144,144,0,1,0,1,0
4374,183,14628,121,293,223,70,4,0,3,1
288,1065,0,0,157,157,0,1,0,1,0
7899,2154,0,0,111,111,0,1,0,1,0
1631,3095,0,0,151,151,0,1,0,1,0
2903,1557,0,0,84,84,0,1,0,1,0
1341,756,0,0,151,151,0,1,0,1,0
1816,183,6857,121,293,223,70,4,0,3,1
1903,2252,0,0,94,94,0,1,0,1,0
2043,183,8031,121,293,223,70,4,0,3,1
260,2383,0,0,144,144,0,1,0,1,0
1961,183,7602,121,293,223,70,4,0,3,1
2560,1694,0,0,62,62,0,1,0,1,0
12914,705,0,0,119,119,0,1,0,1,0
1304,1176,0,0,142,142,0,1,0,1,0
1793,442,0,0,133,133,0,1,0,1,0
2133,183,8569,121,293,223,70,4,0,3,1
1459,2914,0,0,132,132,0,1,0,1,0
9709,1591,0,0,95,95,0,1,0,1,0
2295,2987,0,0,151,151,0,1,0,1,0
4128,183,14198,121,293,223,70,4,0,3,1
964,183,3714,121,293,223,70,4,1,3,1
208,2313,0,0,144,144,0,1,0,1,0
586,1065,0,0,143,143,0,1,0,1,0
10174,183,17250,121,293,223,70,4,0,3,1
20490,2126,0,0,93,93,0,1,0,1,0
8276,1666,0,0,146,146,0,1,0,1,0
310,2507,0,0,143,143,0,1,0,1,0
6591,575,0,0,149,149,0,1,0,1,0
2354,1694,0,0,62,62,0,1,0,1,0
3941,183,13078,121,293,223,70,4,1,3,1
8115,1966,0,0,129,129,0,1,0,1,0
737,2140,0,0,147,147,0,1,0,1,0
7712,2421,0,0,97,97,0,1,0,1,0
19629,2541,0,0,115,115,0,1,0,1,0
2275,1690,0,0,62,62,0,1,0,1,0
11810,1555,0,0,69,69,0,1,0,1,0
9542,1401,0,0,104,104,0,1,0,1,0
864,421,2720,91,260,207,53,3,0,2,0
8298,1185,0,0,154,154,0,1,0,1,0
4628,183,16082,121,293,223,70,4,1,3,1
8324,1533,0,0,146,146,0,1,0,1,0
2058,183,8110,121,293,223,70,4,0,3,1
1627,3095,0,0,148,148,0,1,0,1,0
14247,183,23316,121,293,223,70,4,0,3,1
62,1324,0,0,154,154,0,1,0,1,0
2899,1669,0,0,66,66,0,1,0,1,0
983,1176,0,0,151,151,0,1,0,1,0
1390,3095,0,0,139,139,0,1,0,1,0
3166,183,11960,121,293,223,70,4,0,3,1
8607,1694,0,0,138,138,0,1,0,1,0
13528,656,0,0,121,121,0,1,0,1,0
1049,253,2848,96,263,207,55,3,0,2,0
2905,1493,0,0,95,95,0,1,0,1,0
1675,552,0,0,141,141,0,1,0,1,0
1324,183,4449,121,293,223,70,4,1,3,1
1725,3095,0,0,146,146,0,1,0,1,0
1505,183,5355,121,293,223,70,4,0,3,1
335,1076,0,0,157,157,0,1,0,1,0
10791,1543,0,0,62,62,0,1,0,1,0
3333,183,11542,121,293,223,70,4,0,3,1
12045,1543,0,0,70,70,0,1,0,1,0
21587,1523,0,0,63,63,0,1,0,1,0
8333,1693,0,0,145,145,0,1,0,1,0
4601,613,0,0,146,146,0,1,0,1,0
17457,183,25661,121,293,223,70,4,0,3,1
8306,1568,0,0,148,148,0,1,0,1,0
2930,1233,0,0,138,138,0,1,0,1,0
8523,1543,0,0,138,138,0,1,0,1,0
1959,845,0,0,62,62,0,1,0,1,0
3824,323,0,0,129,129,0,1,0,1,0
1838,916,0,0,79,79,0,1,0,1,0
1425,425,1070,36,191,170,20,1,0,1,0
8312,1607,0,0,147,147,0,1,0,1,0
3756,648,0,0,146,146,0,1,0,1,0
11758,1084,0,0,97,97,0,1,0,1,0
9252,1637,0,0,114,114,0,1,0,1,0
4001,573,0,0,134,134,0,1,0,1,0
358,1230,0,0,143,143,0,1,0,1,0
7307,3006,0,0,64,64,0,1,0,1,0
2707,1694,0,0,62,62,0,1,0,1,0
16174,575,0,0,124,124,0,1,0,1,0
415,1150,0,0,143,143,0,1,0,1,0
1232,183,4234,121,293,223,70,4,1,3,1
507,910,958,32,183,164,18,1,0,1,0
2451,1176,0,0,145,145,0,1,0,1,0
2272,183,8003,121,293,223,70,4,1,3,1
1566,442,1099,30,184,166,17,1,0,1,0
2817,1141,0,0,139,139,0,1,0,1,0
1970,183,7653,121,293,223,70,4,0,3,1
9274,1323,0,0,118,118,0,1,0,1,0
601,1176,0,0,151,151,0,1,0,1,0
2111,3095,0,0,155,155,0,1,0,1,0
2295,1680,0,0,64,64,0,1,0,1,0
200,1044,0,0,157,157,0,1,0,1,0
1914,183,7337,121,293,223,70,4,0,3,1
542,2851,0,0,140,140,0,1,0,1,0
8259,1276,0,0,154,154,0,1,0,1,0
1386,3024,0,0,138,138,0,1,0,1,0
7473,2663,0,0,81,81,0,1,0,1,0
336,2429,0,0,144,144,0,1,0,1,0
1173,183,4337,121,293,223,70,4,1,3,1
4230,737,0,0,147,147,0,1,0,1,0
12279,1543,0,0,62,62,0,1,0,1,0
1912,3095,0,0,154,154,0,1,0,1,0
4536,183,15967,121,293,223,70,4,1,3,1
212,1099,0,0,149,149,0,1,0,1,0
3239,183,11265,121,293,223,70,4,0,3,1
4116,183,14690,121,293,223,70,4,0,3,1
8315,1622,0,0,147,147,0,1,0,1,0
18805,183,26605,121,293,223,70,4,0,3,1
2246,3012,0,0,153,153,0,1,0,1,0
1139,786,0,0,146,146,0,1,0,1,0
329,1074,0,0,157,157,0,1,0,1,0
1175,3095,0,0,145,145,0,1,0,1,0
2273,1682,0,0,62,62,0,1,0,1,0
8239,1806,0,0,139,139,0,1,0,1,0
2811,183,10518,121,293,223,70,4,0,3,1
2787,183,9377,121,293,223,70,4,1,3,1
2599,1421,0,0,62,62,0,1,0,1,0
9726,1590,0,0,95,95,0,1,0,1,0
1312,183,4388,121,293,223,70,4,0,3,1
2951,1321,0,0,123,123,0,1,0,1,0
291,2402,0,0,144,144,0,1,0,1,0
705,1176,0,0,154,154,0,1,0,1,0
107,1652,0,0,151,151,0,1,0,1,0
2453,1551,0,0,85,85,0,1,0,1,0
1369,183,5327,121,293,223,70,4,0,3,1
4506,183,15931,121,293,223,70,4,1,3,1
2796,1694,0,0,62,62,0,1,0,1,0
1623,183,5644,121,293,223,70,4,1,3,1
16076,2635,0,0,123,123,0,1,0,1,0
17799,183,24939,121,293,223,70,4,0,3,1
1952,843,0,0,62,62,0,1,0,1,0
2904,1529,0,0,89,89,0,1,0,1,0
621,2602,0,0,142,142,0,1,0,1,0
3737,183,13205,121,293,223,70,4,1,3,1
8442,1210,0,0,148,148,0,1,0,1,0
4506,183,15931,121,293,223,70,4,1,3,1
2269,369,0,0,62,62,0,1,0,1,0
1633,183,6020,121,293,223,70,4,0,3,1
1219,3095,0,0,139,139,0,1,0,1,0
1927,183,7407,121,293,223,70,4,0,3,1
10198,1543,0,0,77,77,0,1,0,1,0
13977,183,21085,121,293,223,70,4,0,3,1
1344,183,4547,121,293,223,70,4,1,3,1
1897,1095,0,0,143,143,0,1,0,1,0
8326,1691,0,0,146,146,0,1,0,1,0
2674,1372,0,0,115,115,0,1,0,1,0
1924,183,7389,121,293,223,70,4,0,3,1
2392,75,0,0,74,74,0,1,0,1,0
1574,2858,0,0,126,126,0,1,0,1,0
795,1176,0,0,156,156,0,1,0,1,0
1237,183,4244,121,293,223,70,4,1,3,1
1910,183,7315,121,293,223,70,4,0,3,1
934,1176,0,0,140,140,0,1,0,1,0
1541,183,5509,121,293,223,70,4,0,3,1
7719,2412,0,0,97,97,0,1,0,1,0
1973,1197,0,0,139,139,0,1,0,1,0
8707,1543,0,0,133,133,0,1,0,1,0
1845,1176,0,0,142,142,0,1,0,1,0
17021,2799,0,0,127,127,0,1,0,1,0
8509,1694,0,0,141,141,0,1,0,1,0
2901,1602,0,0,77,77,0,1,0,1,0
13867,392,0,0,136,136,0,1,0,1,0
2408,183,9714,121,293,223,70,4,0,3,1
4464,183,15789,121,293,223,70,4,1,3,1
1950,2237,0,0,91,91,0,1,0,1,0
2134,1176,0,0,144,144,0,1,0,1,0
7550,2693,0,0,84,84,0,1,0,1,0
979,3095,0,0,142,142,0,1,0,1,0
2253,2726,0,0,133,133,0,1,0,1,0
422,2673,0,0,142,142,0,1,0,1,0
835,647,1903,64,229,192,37,2,0,2,0
1434,307,2811,77,240,196,44,2,0,2,0
249,2020,0,0,144,144,0,1,0,1,0
4859,183,16369,121,293,223,70,4,1,3,1
2158,183,8748,121,293,223,70,4,0,3,1
13561,2154,0,0,100,100,0,1,0,1,0
8327,1690,0,0,146,146,0,1,0,1,0
1857,738,0,0,90,90,0,1,0,1,0
914,3095,0,0,140,140,0,1,0,1,0
5554,262,0,0,146,146,0,1,0,1,0
2123,1282,0,0,62,62,0,1,0,1,0
8296,1505,0,0,149,149,0,1,0,1,0
2042,954,0,0,127,127,0,1,0,1,0
1703,3095,0,0,151,151,0,1,0,1,0
1695,888,0,0,120,120,0,1,0,1,0
1280,1176,0,0,143,143,0,1,0,1,0
3405,183,12027,121,293,223,70,4,1,3,1
994,859,0,0,145,145,0,1,0,1,0
15545,1543,0,0,67,67,0,1,0,1,0
13396,725,0,0,117,117,0,1,0,1,0
8899,1289,0,0,130,130,0,1,0,1,0
4198,183,14914,121,293,223,70,4,0,3,1
11317,1647,0,0,62,62,0,1,0,1,0
8327,1671,0,0,146,146,0,1,0,1,0
3214,1367,0,0,83,83,0,1,0,1,0
772,1176,0,0,156,156,0,1,0,1,0
7515,2704,0,0,81,81,0,1,0,1,0
1017,1176,0,0,140,140,0,1,0,1,0
2902,1599,0,0,77,77,0,1,0,1,0
671,3042,0,0,139,139,0,1,0,1,0
1818,183,6913,121,293,223,70,4,0,3,1
2975,1661,0,0,67,67,0,1,0,1,0
882,3095,0,0,139,139,0,1,0,1,0
2932,1694,0,0,62,62,0,1,0,1,0
6310,587,0,0,146,146,0,1,0,1,0
2048,183,8089,121,293,223,70,4,0,3,1
2267,1665,0,0,62,62,0,1,0,1,0
1321,183,4438,121,293,223,70,4,0,3,1
1379,3095,0,0,139,139,0,1,0,1,0
8277,1387,0,0,152,152,0,1,0,1,0
10123,1584,0,0,85,85,0,1,0,1,0
1685,183,6215,121,293,223,70,4,0,3,1
1683,1176,0,0,141,141,0,1,0,1,0
1450,1176,0,0,139,139,0,1,0,1,0
2114,183,8291,121,293,223,70,4,0,3,1
16141,1500,0,0,145,145,0,1,0,1,0
5024,183,16574,121,293,223,70,4,1,3,1
4132,770,0,0,147,147,0,1,0,1,0
2797,1176,0,0,147,147,0,1,0,1,0
261,2433,0,0,144,144,0,1,0,1,0
18956,183,25990,121,293,223,70,4,0,3,1
4561,626,0,0,146,146,0,1,0,1,0
1342,183,5447,121,293,223,70,4,0,3,1
1297,1176,0,0,142,142,0,1,0,1,0
1769,183,6666,121,293,223,70,4,0,3,1
1335,183,4500,121,293,223,70,4,0,3,1
2066,2043,0,0,81,81,0,1,0,1,0
1281,3095,0,0,139,139,0,1,0,1,0
2913,1254,0,0,134,134,0,1,0,1,0
2470,1694,0,0,62,62,0,1,0,1,0
13559,1543,0,0,62,62,0,1,0,1,0
1189,663,0,0,150,150,0,1,0,1,0
2909,1374,0,0,114,114,0,1,0,1,0
1528,1176,0,0,139,139,0,1,0,1,0
1533,183,5473,121,293,223,70,4,0,3,1
1403,3095,0,0,140,140,0,1,0,1,0
2256,1660,0,0,67,67,0,1,0,1,0
8266,1279,0,0,153,153,0,1,0,1,0
8577,1543,0,0,136,136,0,1,0,1,0
2741,666,0,0,110,110,0,1,0,1,0
2233,1626,0,0,72,72,0,1,0,1,0
21160,183,28329,121,293,223,70,4,0,3,1
1865,183,7094,121,293,223,70,4,0,3,1
739,2076,0,0,148,148,0,1,0,1,0
940,203,3365,113,284,218,65,3,0,2,0
394,2464,0,0,144,144,0,1,0,1,0
4416,183,15638,121,293,223,70,4,0,3,1
381,1176,0,0,142,142,0,1,0,1,0
1496,3095,0,0,140,140,0,1,0,1,0
15979,1628,0,0,62,62,0,1,0,1,0
851,519,2367,80,246,200,46,2,0,2,0
10287,1543,0,0,74,74,0,1,0,1,0
2125,1287,0,0,62,62,0,1,0,1,0
4987,183,16528,121,293,223,70,4,1,3,1
2486,1433,0,0,102,102,0,1,0,1,0
1478,3018,0,0,134,134,0,1,0,1,0
883,276,3244,109,280,216,63,3,0,2,0
1401,3095,0,0,140,140,0,1,0,1,0
2828,1246,0,0,136,136,0,1,0,1,0
3227,1479,0,0,75,75,0,1,0,1,0
2188,492,0,0,62,62,0,1,0,1,0
1310,778,0,0,151,151,0,1,0,1,0
12055,1543,0,0,70,70,0,1,0,1,0
8267,1179,0,0,156,156,0,1,0,1,0
2360,1176,0,0,145,145,0,1,0,1,0
2209,1038,0,0,62,62,0,1,0,1,0
16643,1842,0,0,145,145,0,1,0,1,0
731,2326,0,0,146,146,0,1,0,1,0
7416,2865,0,0,73,73,0,1,0,1,0
1083,3095,0,0,139,139,0,1,0,1,0
14161,183,23253,121,293,223,70,4,0,3,1
1163,183,4627,121,293,223,70,4,0,3,1
1901,782,0,0,77,77,0,1,0,1,0
3003,1694,0,0,62,62,0,1,0,1,0
2092,1414,0,0,105,105,0,1,0,1,0
8294,1402,0,0,150,150,0,1,0,1,0
2254,183,9250,121,293,223,70,4,0,3,1
1973,1197,0,0,139,139,0,1,0,1,0
23,1045,0,0,156,156,0,1,0,1,0
2908,1396,0,0,111,111,0,1,0,1,0
9477,1389,0,0,107,107,0,1,0,1,0
10420,1543,0,0,70,70,0,1,0,1,0
2096,183,8426,121,293,223,70,4,0,3,1
1495,988,0,0,141,141,0,1,0,1,0
7899,2243,0,0,111,111,0,1,0,1,0
2042,183,8033,121,293,223,70,4,0,3,1
1921,183,7427,121,293,223,70,4,0,3,1
2443,1449,0,0,100,100,0,1,0,1,0
1625,3095,0,0,143,143,0,1,0,1,0
613,2956,0,0,140,140,0,1,0,1,0
10417,1543,0,0,70,70,0,1,0,1,0
8263,1267,0,0,154,154,0,1,0,1,0
2899,1679,0,0,64,64,0,1,0,1,0
972,2854,0,0,143,143,0,1,0,1,0
903,1176,0,0,153,153,0,1,0,1,0
625,1176,0,0,142,142,0,1,0,1,0
1820,183,6922,121,293,223,70,4,0,3,1
3706,183,12648,121,293,223,70,4,0,3,1
409,1153,0,0,143,143,0,1,0,1,0
3039,1674,0,0,65,65,0,1,0,1,0
1732,1176,0,0,141,141,0,1,0,1,0
11401,877,0,0,145,145,0,1,0,1,0
6157,476,0,0,146,146,0,1,0,1,0
2922,1694,0,0,62,62,0,1,0,1,0
1999,183,7811,121,293,223,70,4,0,3,1
2362,230,0,0,62,62,0,1,0,1,0
19500,2604,0,0,118,118,0,1,0,1,0
2910,1694,0,0,62,62,0,1,0,1,0
8327,1658,0,0,146,146,0,1,0,1,0
4610,183,15467,121,293,223,70,4,0,3,1
3316,183,11710,121,293,223,70,4,1,3,1
1196,1176,0,0,151,151,0,1,0,1,0
827,3095,0,0,139,139,0,1,0,1,0
7134,957,0,0,146,146,0,1,0,1,0
1924,861,0,0,66,66,0,1,0,1,0
2708,2102,0,0,90,90,0,1,0,1,0
1283,3095,0,0,142,142,0,1,0,1,0
2912,1295,0,0,128,128,0,1,0,1,0
1488,1008,0,0,141,141,0,1,0,1,0
1914,1132,0,0,143,143,0,1,0,1,0
2843,1643,0,0,62,62,0,1,0,1,0
3607,183,12007,121,293,223,70,4,1,3,1
1239,183,4516,121,293,223,70,4,1,3,1
3885,674,0,0,128,128,0,1,0,1,0
1798,183,6773,121,293,223,70,4,0,3,1
1995,1270,0,0,128,128,0,1,0,1,0
6568,678,0,0,146,146,0,1,0,1,0
8858,1543,0,0,126,126,0,1,0,1,0
1495,988,0,0,141,141,0,1,0,1,0
8319,1508,0,0,147,147,0,1,0,1,0
1801,1176,0,0,141,141,0,1,0,1,0
1640,183,6021,121,293,223,70,4,0,3,1
14921,668,0,0,145,145,0,1,0,1,0
1340,183,4531,121,293,223,70,4,1,3,1
10041,1694,0,0,101,101,0,1,0,1,0
1940,1068,0,0,117,117,0,1,0,1,0
13574,1663,0,0,62,62,0,1,0,1,0
168,1077,0,0,150,150,0,1,0,1,0
8327,1636,0,0,146,146,0,1,0,1,0
4780,183,16271,121,293,223,70,4,1,3,1
10471,1543,0,0,73,73,0,1,0,1,0
9039,1313,0,0,125,125,0,1,0,1,0
8081,2010,0,0,126,126,0,1,0,1,0
424,2494,0,0,144,144,0,1,0,1,0
2391,1694,0,0,62,62,0,1,0,1,0
9247,1625,0,0,112,112,0,1,0,1,0
1552,819,0,0,143,143,0,1,0,1,0
2968,1694,0,0,62,62,0,1,0,1,0
1669,1176,0,0,146,146,0,1,0,1,0
8296,1506,0,0,149,149,0,1,0,1,0
2856,183,10384,121,293,223,70,4,0,3,1
8256,1178,0,0,156,156,0,1,0,1,0
33,1004,0,0,156,156,0,1,0,1,0
11427,1669,0,0,62,62,0,1,0,1,0
1913,183,7387,121,293,223,70,4,0,3,1
9908,1576,0,0,88,88,0,1,0,1,0
3022,1694,0,0,62,62,0,1,0,1,0
98,1042,0,0,153,153,0,1,0,1,0
1288,183,4652,121,293,223,70,4,1,3,1
1620,622,0,0,146,146,0,1,0,1,0
525,1679,0,0,151,151,0,1,0,1,0
1821,918,0,0,144,144,0,1,0,1,0
795,3095,0,0,139,139,0,1,0,1,0
937,1176,0,0,152,152,0,1,0,1,0
2009,310,0,0,112,112,0,1,0,1,0
1629,595,0,0,147,147,0,1,0,1,0
2427,54,0,0,70,70,0,1,0,1,0
20809,1387,0,0,72,72,0,1,0,1,0
1746,183,6516,121,293,223,70,4,0,3,1
1834,918,0,0,80,80,0,1,0,1,0
18649,1588,0,0,62,62,0,1,0,1,0
1329,183,4473,121,293,223,70,4,0,3,1
17121,2819,0,0,130,130,0,1,0,1,0
2903,1694,0,0,62,62,0,1,0,1,0
1243,183,4528,121,293,223,70,4,1,3,1
10769,1543,0,0,62,62,0,1,0,1,0
1396,183,5427,121,293,223,70,4,0,3,1
8311,1599,0,0,148,148,0,1,0,1,0
10778,1544,0,0,63,63,0,1,0,1,0
1053,1176,0,0,149,149,0,1,0,1,0
8402,2498,0,0,65,65,0,1,0,1,0
8155,1788,0,0,132,132,0,1,0,1,0
2938,1267,0,0,132,132,0,1,0,1,0
3830,183,13930,121,293,223,70,4,0,3,1
1540,1106,0,0,123,123,0,1,0,1,0
1935,1139,0,0,134,134,0,1,0,1,0
2352,1371,0,0,112,112,0,1,0,1,0
20099,1543,0,0,62,62,0,1,0,1,0
8816,1664,0,0,129,129,0,1,0,1,0
2254,183,9243,121,293,223,70,4,0,3,1
913,183,3616,121,293,223,70,4,1,3,1
1293,3095,0,0,142,142,0,1,0,1,0
1387,1176,0,0,140,140,0,1,0,1,0
14558,1649,0,0,62,62,0,1,0,1,0
8110,1852,0,0,128,128,0,1,0,1,0
1479,183,5208,121,293,223,70,4,0,3,1
19187,183,26340,121,293,223,70,4,0,3,1
1846,183,7052,121,293,223,70,4,0,3,1
52,1253,0,0,154,154,0,1,0,1,0
2033,866,0,0,68,68,0,1,0,1,0
1289,3095,0,0,146,146,0,1,0,1,0
9681,1874,0,0,69,69,0,1,0,1,0
8887,1543,0,0,125,125,0,1,0,1,0
945,1176,0,0,152,152,0,1,0,1,0
2495,183,9058,121,293,223,70,4,0,3,1
77,1032,0,0,154,154,0,1,0,1,0
2346,1638,0,0,71,71,0,1,0,1,0
1922,183,7382,121,293,223,70,4,0,3,1
9732,1849,0,0,69,69,0,1,0,1,0
2392,1422,0,0,104,104,0,1,0,1,0
3293,1286,0,0,88,88,0,1,0,1,0
4052,183,14326,121,293,223,70,4,1,3,1
2047,183,7778,121,293,223,70,4,0,3,1
6408,1515,0,0,108,108,0,1,0,1,0
2479,1694,0,0,62,62,0,1,0,1,0
3363,183,11223,121,293,223,70,4,1,3,1
1170,1176,0,0,139,139,0,1,0,1,0
1779,821,0,0,145,145,0,1,0,1,0
2035,183,7991,121,293,223,70,4,0,3,1
20970,1543,0,0,62,62,0,1,0,1,0
985,1176,0,0,151,151,0,1,0,1,0
2218,183,9042,121,293,223,70,4,0,3,1
2192,1464,0,0,62,62,0,1,0,1,0
1719,3095,0,0,146,146,0,1,0,1,0
8760,1667,0,0,131,131,0,1,0,1,0
1948,183,7519,121,293,223,70,4,0,3,1
966,183,3879,121,293,223,70,4,0,3,1
1742,183,6497,121,293,223,70,4,0,3,1
1881,183,7230,121,293,223,70,4,0,3,1
9408,1543,0,0,106,106,0,1,0,1,0
9651,1605,0,0,111,111,0,1,0,1,0
378,1176,0,0,143,143,0,1,0,1,0
2488,183,9951,121,293,223,70,4,0,3,1
453,1176,0,0,146,146,0,1,0,1,0
8168,1769,0,0,133,133,0,1,0,1,0
1077,183,3933,121,293,223,70,4,1,3,1
1346,183,4561,121,293,223,70,4,1,3,1
1745,183,6550,121,293,223,70,4,0,3,1
67,1360,0,0,153,153,0,1,0,1,0
1414,3095,0,0,139,139,0,1,0,1,0
2263,1654,0,0,62,62,0,1,0,1,0
1795,183,6880,121,293,223,70,4,0,3,1
2362,1694,0,0,62,62,0,1,0,1,0
1608,183,5846,121,293,223,70,4,0,3,1
3044,183,10747,121,293,223,70,4,1,3,1
1396,716,0,0,150,150,0,1,0,1,0
13399,2067,0,0,90,90,0,1,0,1,0
7684,2848,0,0,63,63,0,1,0,1,0
1730,2510,0,0,109,109,0,1,0,1,0
10917,1565,0,0,62,62,0,1,0,1,0
10090,1674,0,0,71,71,0,1,0,1,0
2904,1520,0,0,90,90,0,1,0,1,0
1465,1176,0,0,139,139,0,1,0,1,0
2954,1652,0,0,68,68,0,1,0,1,0
3890,339,0,0,132,132,0,1,0,1,0
2098,1423,0,0,104,104,0,1,0,1,0
19392,2656,0,0,121,121,0,1,0,1,0
21641,1543,0,0,62,62,0,1,0,1,0
1031,1176,0,0,149,149,0,1,0,1,0
597,1176,0,0,151,151,0,1,0,1,0
6331,183,17292,121,293,223,70,4,0,3,1
9485,1391,0,0,107,107,0,1,0,1,0
1104,3095,0,0,141,141,0,1,0,1,0
5860,544,0,0,137,137,0,1,0,1,0
1596,503,263,8,158,153,5,1,0,1,0
292,1066,0,0,157,157,0,1,0,1,0
1745,2488,0,0,107,107,0,1,0,1,0
611,1176,0,0,151,151,0,1,0,1,0
606,1075,0,0,149,149,0,1,0,1,0
1646,546,0,0,147,147,0,1,0,1,0
2002,183,7833,121,293,223,70,4,0,3,1
10230,1552,0,0,76,76,0,1,0,1,0
5006,183,16551,121,293,223,70,4,1,3,1
2969,1620,0,0,66,66,0,1,0,1,0
1965,183,7613,121,293,223,70,4,0,3,1
1398,183,4816,121,293,223,70,4,1,3,1
7107,2754,0,0,70,70,0,1,0,1,0
21674,1456,1820,7,76,72,4,1,0,1,0
9215,1543,0,0,115,115,0,1,0,1,0
72,1394,0,0,153,153,0,1,0,1,0
8941,1648,0,0,123,123,0,1,0,1,0
8647,1674,0,0,135,135,0,1,0,1,0
1815,183,6852,121,293,223,70,4,0,3,1
880,1093,0,0,155,155,0,1,0,1,0
16713,2757,0,0,129,129,0,1,0,1,0
9286,1622,0,0,111,111,0,1,0,1,0
94,1553,0,0,152,152,0,1,0,1,0
2329,2912,0,0,146,146,0,1,0,1,0
7524,2691,0,0,81,81,0,1,0,1,0
1249,183,4266,121,293,223,70,4,1,3,1
330,2536,0,0,143,143,0,1,0,1,0
1420,1176,0,0,139,139,0,1,0,1,0
9641,1614,0,0,101,101,0,1,0,1,0
11353,1669,0,0,63,63,0,1,0,1,0
2216,183,9049,121,293,223,70,4,0,3,1
10439,1553,0,0,71,71,0,1,0,1,0
1381,253,3489,96,263,207,55,3,0,2,0
1406,3095,0,0,140,140,0,1,0,1,0
1933,1173,0,0,142,142,0,1,0,1,0
214,2273,0,0,144,144,0,1,0,1,0
1137,2962,0,0,143,143,0,1,0,1,0
1319,3081,0,0,143,143,0,1,0,1,0
7283,3036,0,0,62,62,0,1,0,1,0
1456,183,5105,121,293,223,70,4,1,3,1
1368,3095,0,0,141,141,0,1,0,1,0
9275,1323,0,0,118,118,0,1,0,1,0
1301,1176,0,0,150,150,0,1,0,1,0
2008,549,0,0,97,97,0,1,0,1,0
1588,2723,0,0,121,121,0,1,0,1,0
2452,1418,0,0,105,105,0,1,0,1,0
2040,183,8041,121,293,223,70,4,0,3,1
1383,664,0,0,146,146,0,1,0,1,0
1635,183,5973,121,293,223,70,4,0,3,1
10557,1568,0,0,70,70,0,1,0,1,0
1712,590,0,0,130,130,0,1,0,1,0
12386,1253,0,0,87,87,0,1,0,1,0
21691,1543,0,0,62,62,0,1,0,1,0
2527,1356,0,0,62,62,0,1,0,1,0
1345,183,4552,121,293,223,70,4,1,3,1
1988,183,7556,121,293,223,70,4,0,3,1
1055,2908,0,0,143,143,0,1,0,1,0
1788,844,0,0,145,145,0,1,0,1,0
1704,1176,0,0,141,141,0,1,0,1,0
1644,3095,0,0,151,151,0,1,0,1,0
3448,183,12426,121,293,223,70,4,0,3,1
1948,183,7528,121,293,223,70,4,0,3,1
5644,253,0,0,146,146,0,1,0,1,0
2254,1108,0,0,62,62,0,1,0,1,0
16357,183,24778,121,293,223,70,4,0,3,1
19134,2780,0,0,128,128,0,1,0,1,0
9678,1611,0,0,100,100,0,1,0,1,0
4309,386,0,0,146,146,0,1,0,1,0
1688,3095,0,0,145,145,0,1,0,1,0
2033,183,8098,121,293,223,70,4,0,3,1
741,3095,0,0,139,139,0,1,0,1,0
1679,512,0,0,145,145,0,1,0,1,0
2579,183,10220,121,293,223,70,4,0,3,1
2257,2577,0,0,123,123,0,1,0,1,0
1662,1317,0,0,117,117,0,1,0,1,0
9233,1543,0,0,115,115,0,1,0,1,0
8268,1333,0,0,153,153,0,1,0,1,0
754,1592,0,0,153,153,0,1,0,1,0
8256,1508,0,0,146,146,0,1,0,1,0
1043,250,2876,97,264,208,56,3,0,2,0
1138,3095,0,0,139,139,0,1,0,1,0
4450,183,14854,121,293,223,70,4,0,3,1
3241,972,0,0,147,147,0,1,0,1,0
1885,183,7436,121,293,223,70,4,0,3,1
4522,183,15950,121,293,223,70,4,1,3,1
2926,1219,0,0,140,140,0,1,0,1,0
1325,3085,0,0,143,143,0,1,0,1,0
1835,918,0,0,79,79,0,1,0,1,0
1657,1031,0,0,105,105,0,1,0,1,0
8294,1400,0,0,150,150,0,1,0,1,0
8073,2020,0,0,125,125,0,1,0,1,0
1560,795,0,0,144,144,0,1,0,1,0
10932,1615,0,0,67,67,0,1,0,1,0
12829,795,0,0,109,109,0,1,0,1,0
1697,575,0,0,135,135,0,1,0,1,0
2676,474,0,0,96,96,0,1,0,1,0
1606,661,0,0,146,146,0,1,0,1,0
1363,183,4638,121,293,223,70,4,0,3,1
1150,183,4573,121,293,223,70,4,0,3,1
520,2817,0,0,141,141,0,1,0,1,0
18889,2898,0,0,134,134,0,1,0,1,0
9871,1615,0,0,105,105,0,1,0,1,0
72,1015,0,0,157,157,0,1,0,1,0
1493,1135,0,0,129,129,0,1,0,1,0
5496,315,0,0,146,146,0,1,0,1,0
2230,183,9108,121,293,223,70,4,0,3,1
7161,2849,0,0,67,67,0,1,0,1,0
1591,546,0,0,148,148,0,1,0,1,0
2181,183,8822,121,293,223,70,4,0,3,1
8811,1543,0,0,128,128,0,1,0,1,0
1481,183,5230,121,293,223,70,4,0,3,1
2433,1694,0,0,62,62,0,1,0,1,0
1277,183,4988,121,293,223,70,4,0,3,1
1409,183,4870,121,293,223,70,4,1,3,1
6903,183,17719,121,293,223,70,4,0,3,1
2150,183,8642,121,293,223,70,4,0,3,1
491,2775,0,0,141,141,0,1,0,1,0
3002,1694,0,0,62,62,0,1,0,1,0
7367,857,0,0,153,153,0,1,0,1,0
13921,450,0,0,133,133,0,1,0,1,0
2486,56,0,0,65,65,0,1,0,1,0
196,1091,0,0,149,149,0,1,0,1,0
1748,750,0,0,146,146,0,1,0,1,0
4914,183,11946,121,293,223,70,4,0,3,1
1782,1176,0,0,141,141,0,1,0,1,0
1106,928,0,0,153,153,0,1,0,1,0
1512,465,660,22,174,161,12,1,0,1,0
905,2810,0,0,143,143,0,1,0,1,0
924,183,3660,121,293,223,70,4,1,3,1
2247,1647,0,0,69,69,0,1,0,1,0
930,1057,0,0,155,155,0,1,0,1,0
3017,1585,0,0,80,80,0,1,0,1,0
1728,606,0,0,126,126,0,1,0,1,0
2241,1639,0,0,70,70,0,1,0,1,0
19954,1568,0,0,62,62,0,1,0,1,0
1746,183,6518,121,293,223,70,4,0,3,1
9127,1634,0,0,116,116,0,1,0,1,0
8071,2022,0,0,125,125,0,1,0,1,0
4706,183,16179,121,293,223,70,4,1,3,1
2843,1694,0,0,62,62,0,1,0,1,0
8363,1691,0,0,144,144,0,1,0,1,0
10992,1543,0,0,71,71,0,1,0,1,0
14138,303,0,0,141,141,0,1,0,1,0
213,2278,0,0,144,144,0,1,0,1,0
2010,183,7924,121,293,223,70,4,0,3,1
761,1365,0,0,155,155,0,1,0,1,0
2935,1694,0,0,62,62,0,1,0,1,0
2890,183,10933,121,293,223,70,4,0,3,1
2027,183,7959,121,293,223,70,4,0,3,1
1206,183,4726,121,293,223,70,4,0,3,1
20023,1567,0,0,62,62,0,1,0,1,0
486,2534,0,0,144,144,0,1,0,1,0
1581,1013,0,0,128,128,0,1,0,1,0
430,1176,0,0,145,145,0,1,0,1,0
2187,183,8901,121,293,223,70,4,0,3,1
1759,637,0,0,117,117,0,1,0,1,0
11090,1600,0,0,62,62,0,1,0,1,0
1541,853,0,0,143,143,0,1,0,1,0
99,1594,0,0,151,151,0,1,0,1,0
89,1019,0,0,157,157,0,1,0,1,0
3012,1567,0,0,83,83,0,1,0,1,0
16887,1543,0,0,62,62,0,1,0,1,0
1249,3036,0,0,143,143,0,1,0,1,0
1483,357,2178,60,219,185,34,2,0,1,0
935,183,3658,121,293,223,70,4,1,3,1
79,1448,0,0,153,153,0,1,0,1,0
2185,1448,0,0,62,62,0,1,0,1,0
13243,183,19945,121,293,223,70,4,0,3,1
7781,2395,0,0,102,102,0,1,0,1,0
21007,183,28160,121,293,223,70,4,0,3,1
11290,1641,0,0,62,62,0,1,0,1,0
1388,183,4923,121,293,223,70,4,1,3,1
1197,183,4841,121,293,223,70,4,0,3,1
1948,1176,0,0,143,143,0,1,0,1,0
1410,3095,0,0,139,139,0,1,0,1,0
11119,1639,0,0,65,65,0,1,0,1,0
4855,183,16363,121,293,223,70,4,1,3,1
314,1549,0,0,143,143,0,1,0,1,0
1339,3095,0,0,142,142,0,1,0,1,0
14641,477,0,0,145,145,0,1,0,1,0
1382,3095,0,0,141,141,0,1,0,1,0
700,1316,0,0,155,155,0,1,0,1,0
938,183,3760,121,293,223,70,4,0,3,1
3005,1538,0,0,87,87,0,1,0,1,0
8295,1498,0,0,150,150,0,1,0,1,0
10483,1543,0,0,69,69,0,1,0,1,0
10259,1525,0,0,76,76,0,1,0,1,0
463,1105,0,0,157,157,0,1,0,1,0
2946,1694,0,0,62,62,0,1,0,1,0
1712,183,6388,121,293,223,70,4,0,3,1
826,1133,0,0,156,156,0,1,0,1,0
1267,1176,0,0,139,139,0,1,0,1,0
8246,1192,0,0,156,156,0,1,0,1,0
774,1176,0,0,156,156,0,1,0,1,0
1437,183,5036,121,293,223,70,4,0,3,1
2619,1694,0,0,62,62,0,1,0,1,0
9094,1297,0,0,125,125,0,1,0,1,0
19302,2699,0,0,123,123,0,1,0,1,0
1879,183,7219,121,293,223,70,4,0,3,1
2902,1601,0,0,77,77,0,1,0,1,0
1635,3095,0,0,148,148,0,1,0,1,0
889,2799,0,0,143,143,0,1,0,1,0
1623,183,5944,121,293,223,70,4,0,3,1
3902,656,0,0,129,129,0,1,0,1,0
120,1744,0,0,150,150,0,1,0,1,0
224,2198,0,0,144,144,0,1,0,1,0
8241,1178,0,0,156,156,0,1,0,1,0
4347,383,0,0,146,146,0,1,0,1,0
2969,1694,0,0,62,62,0,1,0,1,0
2159,1516,0,0,89,89,0,1,0,1,0
9183,1630,0,0,114,114,0,1,0,1,0
5805,446,0,0,140,140,0,1,0,1,0
8684,1239,0,0,140,140,0,1,0,1,0
9475,1596,0,0,116,116,0,1,0,1,0
1263,724,0,0,146,146,0,1,0,1,0
2267,2138,0,0,92,92,0,1,0,1,0
3810,183,13870,121,293,223,70,4,0,3,1
1811,431,0,0,132,132,0,1,0,1,0
8544,1680,0,0,138,138,0,1,0,1,0
16825,2760,0,0,125,125,0,1,0,1,0
10119,1543,0,0,80,80,0,1,0,1,0
10110,1543,0,0,85,85,0,1,0,1,0
842,594,2096,70,236,195,40,2,0,2,0
2000,183,6852,121,293,223,70,4,1,3,1
638,2993,0,0,139,139,0,1,0,1,0
2413,151,0,0,62,62,0,1,0,1,0
262,2226,0,0,146,146,0,1,0,1,0
9134,1303,0,0,123,123,0,1,0,1,0
2264,2259,0,0,101,101,0,1,0,1,0
12536,903,0,0,103,103,0,1,0,1,0
8317,1635,0,0,147,147,0,1,0,1,0
817,789,1395,47,209,182,27,2,0,1,0
9415,2004,0,0,68,68,0,1,0,1,0
1539,1106,0,0,123,123,0,1,0,1,0
10315,1543,0,0,73,73,0,1,0,1,0
10609,1543,0,0,68,68,0,1,0,1,0
10106,1543,0,0,81,81,0,1,0,1,0
69,1028,0,0,154,154,0,1,0,1,0
1187,1176,0,0,139,139,0,1,0,1,0
21212,183,28402,121,293,223,70,4,0,3,1
1872,894,0,0,74,74,0,1,0,1,0
1909,870,0,0,69,69,0,1,0,1,0
3019,1569,0,0,70,70,0,1,0,1,0
1477,2889,0,0,131,131,0,1,0,1,0
746,3095,0,0,139,139,0,1,0,1,0
1625,1052,0,0,110,110,0,1,0,1,0
8743,1262,0,0,136,136,0,1,0,1,0
2255,2660,0,0,128,128,0,1,0,1,0
2748,183,10075,121,293,223,70,4,0,3,1
1406,183,5464,121,293,223,70,4,0,3,1
2967,1694,0,0,62,62,0,1,0,1,0
12404,1244,0,0,87,87,0,1,0,1,0
298,2152,0,0,147,147,0,1,0,1,0
1395,3095,0,0,140,140,0,1,0,1,0
2922,1201,0,0,143,143,0,1,0,1,0
1317,188,4322,119,290,221,68,3,0,2,0
8350,1694,0,0,145,145,0,1,0,1,0
2802,1606,0,0,62,62,0,1,0,1,0
8327,1598,0,0,146,146,0,1,0,1,0
1666,1176,0,0,140,140,0,1,0,1,0
8813,1565,0,0,133,133,0,1,0,1,0
1056,1176,0,0,153,153,0,1,0,1,0
2894,1176,0,0,147,147,0,1,0,1,0
7467,2799,0,0,77,77,0,1,0,1,0
4652,183,16112,121,293,223,70,4,1,3,1
10391,1483,0,0,77,77,0,1,0,1,0
11299,1643,0,0,62,62,0,1,0,1,0
1492,183,5292,121,293,223,70,4,0,3,1
2231,183,8387,121,293,223,70,4,0,3,1
14626,2358,0,0,110,110,0,1,0,1,0
1106,1176,0,0,152,152,0,1,0,1,0
2742,2030,0,0,85,85,0,1,0,1,0
987,225,3141,106,275,213,61,3,0,2,0
1467,664,0,0,149,149,0,1,0,1,0
478,1109,0,0,157,157,0,1,0,1,0
1545,183,5539,121,293,223,70,4,0,3,1
1877,3095,0,0,149,149,0,1,0,1,0
1426,3095,0,0,139,139,0,1,0,1,0
10679,1543,0,0,64,64,0,1,0,1,0
9652,1256,0,0,145,145,0,1,0,1,0
1537,865,0,0,143,143,0,1,0,1,0
1718,1176,0,0,141,141,0,1,0,1,0
918,183,3626,121,293,223,70,4,1,3,1
11363,1337,0,0,75,75,0,1,0,1,0
16054,1440,0,0,145,145,0,1,0,1,0
3040,1694,0,0,62,62,0,1,0,1,0
12862,1004,0,0,101,101,0,1,0,1,0
1745,623,0,0,121,121,0,1,0,1,0
74,1031,0,0,154,154,0,1,0,1,0
1681,183,6641,121,293,223,70,4,0,3,1
21639,1338,4280,18,96,86,10,1,0,1,0
3916,183,12999,121,293,223,70,4,1,3,1
1969,821,0,0,62,62,0,1,0,1,0
11348,1653,0,0,62,62,0,1,0,1,0
823,741,1565,52,216,185,30,2,0,1,0
1970,1232,0,0,134,134,0,1,0,1,0
2684,1176,0,0,146,146,0,1,0,1,0
8294,1399,0,0,150,150,0,1,0,1,0
2853,1543,0,0,62,62,0,1,0,1,0
3123,183,11514,121,293,223,70,4,0,3,1
1188,183,4379,121,293,223,70,4,1,3,1
2588,183,10138,121,293,223,70,4,0,3,1
10540,1504,0,0,71,71,0,1,0,1,0
2026,183,7938,121,293,223,70,4,0,3,1
8087,2652,0,0,64,64,0,1,0,1,0
9163,1543,0,0,115,115,0,1,0,1,0
185,1086,0,0,150,150,0,1,0,1,0
2051,698,0,0,62,62,0,1,0,1,0
668,3037,0,0,139,139,0,1,0,1,0
1915,183,7342,121,293,223,70,4,0,3,1
2908,1400,0,0,110,110,0,1,0,1,0
1838,1176,0,0,144,144,0,1,0,1,0
21651,1378,3438,14,89,81,8,1,0,1,0
329,2087,0,0,147,147,0,1,0,1,0
11577,183,21366,121,293,223,70,4,0,3,1
18958,1543,0,0,62,62,0,1,0,1,0
8052,1407,0,0,146,146,0,1,0,1,0
10164,1145,0,0,145,145,0,1,0,1,0
1677,183,6180,121,293,223,70,4,0,3,1
1965,859,0,0,62,62,0,1,0,1,0
4181,753,0,0,147,147,0,1,0,1,0
2755,183,10741,121,293,223,70,4,0,3,1
8332,1188,0,0,153,153,0,1,0,1,0
1942,3095,0,0,155,155,0,1,0,1,0
10547,1543,0,0,70,70,0,1,0,1,0
2134,183,8554,121,293,223,70,4,0,3,1
8148,1596,0,0,146,146,0,1,0,1,0
2668,1376,0,0,114,114,0,1,0,1,0
9342,1543,0,0,109,109,0,1,0,1,0
2901,1694,0,0,62,62,0,1,0,1,0
15106,794,0,0,145,145,0,1,0,1,0
1935,1176,0,0,143,143,0,1,0,1,0
11809,1745,0,0,72,72,0,1,0,1,0
141,1064,0,0,152,152,0,1,0,1,0
2053,927,0,0,62,62,0,1,0,1,0
10259,1694,0,0,95,95,0,1,0,1,0
2743,1553,0,0,83,83,0,1,0,1,0
18105,2838,0,0,145,145,0,1,0,1,0
9638,1596,0,0,98,98,0,1,0,1,0
752,1176,0,0,156,156,0,1,0,1,0
2939,1694,0,0,62,62,0,1,0,1,0
629,825,0,0,153,153,0,1,0,1,0
811,832,1239,41,204,179,24,2,0,1,0
9867,1579,0,0,89,89,0,1,0,1,0
855,492,2465,83,250,202,48,3,0,2,0
1475,183,5195,121,293,223,70,4,0,3,1
1754,2475,0,0,107,107,0,1,0,1,0
1379,183,4723,121,293,223,70,4,0,3,1
9101,1543,0,0,117,117,0,1,0,1,0
3073,1123,0,0,147,147,0,1,0,1,0
8258,1272,0,0,154,154,0,1,0,1,0
98,979,0,0,156,156,0,1,0,1,0
13251,800,0,0,113,113,0,1,0,1,0
2219,183,9049,121,293,223,70,4,0,3,1
2901,1612,0,0,75,75,0,1,0,1,0
20413,2163,0,0,95,95,0,1,0,1,0
1250,731,0,0,146,146,0,1,0,1,0
268,2444,0,0,144,144,0,1,0,1,0
1919,801,0,0,72,72,0,1,0,1,0
8256,1262,0,0,155,155,0,1,0,1,0
4077,183,14062,121,293,223,70,4,0,3,1
4047,520,0,0,138,138,0,1,0,1,0
15453,1031,0,0,145,145,0,1,0,1,0
4967,183,16502,121,293,223,70,4,1,3,1
15647,1163,0,0,145,145,0,1,0,1,0
2245,183,9202,121,293,223,70,4,0,3,1
1569,771,0,0,144,144,0,1,0,1,0
1450,3063,0,0,137,137,0,1,0,1,0
4636,183,15309,121,293,223,70,4,1,3,1
11354,1654,0,0,62,62,0,1,0,1,0
8783,1253,0,0,137,137,0,1,0,1,0
1386,723,0,0,150,150,0,1,0,1,0
1891,1176,0,0,142,142,0,1,0,1,0
13750,2139,0,0,88,88,0,1,0,1,0
1902,784,0,0,77,77,0,1,0,1,0
1897,183,7307,121,293,223,70,4,0,3,1
259,1058,0,0,157,157,0,1,0,1,0
8327,1591,0,0,146,146,0,1,0,1,0
301,1068,0,0,157,157,0,1,0,1,0
1995,183,7771,121,293,223,70,4,0,3,1
1617,183,5913,121,293,223,70,4,0,3,1
738,2700,0,0,144,144,0,1,0,1,0
13596,2106,0,0,92,92,0,1,0,1,0
2769,1294,0,0,128,128,0,1,0,1,0
2439,1562,0,0,83,83,0,1,0,1,0
18226,3043,0,0,142,142,0,1,0,1,0
1368,183,4869,121,293,223,70,4,1,3,1
8327,1677,0,0,146,146,0,1,0,1,0
4009,183,13295,121,293,223,70,4,1,3,1
1205,1176,0,0,151,151,0,1,0,1,0
2428,1441,0,0,101,101,0,1,0,1,0
1908,183,7365,121,293,223,70,4,0,3,1
392,894,0,0,154,154,0,1,0,1,0
11196,1622,0,0,62,62,0,1,0,1,0
3639,277,0,0,119,119,0,1,0,1,0
2269,2059,0,0,87,87,0,1,0,1,0
8262,1294,0,0,154,154,0,1,0,1,0
284,925,0,0,155,155,0,1,0,1,0
8221,1168,0,0,156,156,0,1,0,1,0
4717,574,0,0,146,146,0,1,0,1,0
1796,2491,0,0,105,105,0,1,0,1,0
941,183,3759,121,293,223,70,4,0,3,1
1309,183,5309,121,293,223,70,4,0,3,1
2286,1694,0,0,62,62,0,1,0,1,0
1254,819,0,0,152,152,0,1,0,1,0
2136,183,8636,121,293,223,70,4,0,3,1
1188,868,0,0,152,152,0,1,0,1,0
4339,183,15440,121,293,223,70,4,0,3,1
9306,1543,0,0,112,112,0,1,0,1,0
260,1123,0,0,147,147,0,1,0,1,0
589,1547,0,0,153,153,0,1,0,1,0
1347,751,0,0,151,151,0,1,0,1,0
1730,710,0,0,146,146,0,1,0,1,0
708,1162,0,0,157,157,0,1,0,1,0
870,3095,0,0,140,140,0,1,0,1,0
1263,1176,0,0,139,139,0,1,0,1,0
10439,1552,0,0,71,71,0,1,0,1,0
15762,503,0,0,128,128,0,1,0,1,0
16694,1543,0,0,62,62,0,1,0,1,0
489,1060,0,0,150,150,0,1,0,1,0
1662,183,6133,121,293,223,70,4,0,3,1
1423,3095,0,0,139,139,0,1,0,1,0
2914,1694,0,0,62,62,0,1,0,1,0
11023,1627,0,0,66,66,0,1,0,1,0
1197,2952,0,0,140,140,0,1,0,1,0
3985,183,13475,121,293,223,70,4,0,3,1
733,2270,0,0,146,146,0,1,0,1,0
355,2448,0,0,144,144,0,1,0,1,0
3006,1694,0,0,62,62,0,1,0,1,0
1153,3095,0,0,141,141,0,1,0,1,0
15431,1015,0,0,145,145,0,1,0,1,0
1788,183,6826,121,293,223,70,4,0,3,1
1237,3028,0,0,143,143,0,1,0,1,0
1585,1176,0,0,140,140,0,1,0,1,0
6180,488,0,0,146,146,0,1,0,1,0
2776,1582,0,0,62,62,0,1,0,1,0
2143,183,8674,121,293,223,70,4,0,3,1
3031,1641,0,0,70,70,0,1,0,1,0
3449,1219,0,0,92,92,0,1,0,1,0
14131,340,0,0,139,139,0,1,0,1,0
2217,1044,0,0,62,62,0,1,0,1,0
1692,1009,0,0,100,100,0,1,0,1,0
21468,771,16150,68,193,153,39,2,0,2,0
1483,183,5237,121,293,223,70,4,0,3,1
1418,291,3015,83,247,199,48,3,0,2,0
7733,2160,0,0,107,107,0,1,0,1,0
1562,1176,0,0,147,147,0,1,0,1,0
1955,871,0,0,69,69,0,1,0,1,0
8264,1309,0,0,154,154,0,1,0,1,0
8978,1543,0,0,122,122,0,1,0,1,0
2346,976,0,0,96,96,0,1,0,1,0
1383,3095,0,0,141,141,0,1,0,1,0
10332,1545,0,0,73,73,0,1,0,1,0
8327,1610,0,0,146,146,0,1,0,1,0
14720,2376,0,0,111,111,0,1,0,1,0
8760,1667,0,0,131,131,0,1,0,1,0
8288,1458,0,0,150,150,0,1,0,1,0
2102,183,8394,121,293,223,70,4,0,3,1
2440,1412,0,0,106,106,0,1,0,1,0
6832,183,13162,121,293,223,70,4,0,3,1
2909,1363,0,0,116,116,0,1,0,1,0
2719,602,0,0,106,106,0,1,0,1,0
9258,1543,0,0,112,112,0,1,0,1,0
2512,1176,0,0,145,145,0,1,0,1,0
8315,1491,0,0,147,147,0,1,0,1,0
1620,183,5924,121,293,223,70,4,0,3,1
1943,183,7494,121,293,223,70,4,0,3,1
1512,183,5985,121,293,223,70,4,0,3,1
1954,882,0,0,72,72,0,1,0,1,0
4534,183,14980,121,293,223,70,4,1,3,1
461,2731,0,0,141,141,0,1,0,1,0
19395,1543,0,0,62,62,0,1,0,1,0
1703,183,6309,121,293,223,70,4,0,3,1
8327,1596,0,0,146,146,0,1,0,1,0
503,1114,0,0,157,157,0,1,0,1,0
2083,650,0,0,62,62,0,1,0,1,0
588,1176,0,0,150,150,0,1,0,1,0
2544,1694,0,0,62,62,0,1,0,1,0
1890,677,0,0,106,106,0,1,0,1,0
94,1020,0,0,157,157,0,1,0,1,0
13231,811,0,0,112,112,0,1,0,1,0
11433,1670,0,0,62,62,0,1,0,1,0
1874,755,0,0,85,85,0,1,0,1,0
19630,2541,0,0,115,115,0,1,0,1,0
1750,3095,0,0,150,150,0,1,0,1,0
14720,183,21508,121,293,223,70,4,0,3,1
1701,2554,0,0,111,111,0,1,0,1,0
1967,1228,0,0,134,134,0,1,0,1,0
2900,1637,0,0,71,71,0,1,0,1,0
8075,1499,0,0,140,140,0,1,0,1,0
9833,1451,0,0,93,93,0,1,0,1,0
3020,1694,0,0,62,62,0,1,0,1,0
12866,781,0,0,110,110,0,1,0,1,0
3002,1527,0,0,89,89,0,1,0,1,0
13759,1543,0,0,69,69,0,1,0,1,0
2913,1264,0,0,133,133,0,1,0,1,0
243,1115,0,0,147,147,0,1,0,1,0
1070,3095,0,0,141,141,0,1,0,1,0
1787,1176,0,0,141,141,0,1,0,1,0
1061,183,4033,121,293,223,70,4,1,3,1
2592,1338,0,0,62,62,0,1,0,1,0
1921,1176,0,0,143,143,0,1,0,1,0
3088,183,11730,121,293,223,70,4,0,3,1
1297,3095,0,0,139,139,0,1,0,1,0
2692,522,0,0,100,100,0,1,0,1,0
1558,2767,0,0,124,124,0,1,0,1,0
5710,256,0,0,146,146,0,1,0,1,0
997,183,4007,121,293,223,70,4,0,3,1
1723,989,0,0,96,96,0,1,0,1,0
9505,183,19852,121,293,223,70,4,0,3,1
9311,1543,0,0,112,112,0,1,0,1,0
1204,1176,0,0,145,145,0,1,0,1,0
1990,183,6820,121,293,223,70,4,1,3,1
2682,1176,0,0,146,146,0,1,0,1,0
8517,1215,0,0,146,146,0,1,0,1,0
1267,1176,0,0,143,143,0,1,0,1,0
8754,1694,0,0,134,134,0,1,0,1,0
2256,2627,0,0,126,126,0,1,0,1,0
1989,183,7767,121,293,223,70,4,0,3,1
10705,1543,0,0,64,64,0,1,0,1,0
2010,547,0,0,97,97,0,1,0,1,0
1712,183,6386,121,293,223,70,4,0,3,1
13776,526,0,0,129,129,0,1,0,1,0
1009,999,0,0,154,154,0,1,0,1,0
2964,1694,0,0,62,62,0,1,0,1,0
1156,1176,0,0,146,146,0,1,0,1,0
3418,1256,0,0,90,90,0,1,0,1,0
92,1544,0,0,152,152,0,1,0,1,0
60,1023,0,0,155,155,0,1,0,1,0
10398,1543,0,0,71,71,0,1,0,1,0
2080,655,0,0,62,62,0,1,0,1,0
2700,1350,0,0,118,118,0,1,0,1,0
1687,1176,0,0,141,141,0,1,0,1,0
10450,1543,0,0,69,69,0,1,0,1,0
17778,2615,0,0,145,145,0,1,0,1,0
1342,183,4538,121,293,223,70,4,1,3,1
1422,183,5017,121,293,223,70,4,1,3,1
821,3095,0,0,139,139,0,1,0,1,0
1416,183,4903,121,293,223,70,4,1,3,1
2914,1218,0,0,140,140,0,1,0,1,0
1896,1093,0,0,143,143,0,1,0,1,0
12260,1320,0,0,83,83,0,1,0,1,0
8327,1592,0,0,146,146,0,1,0,1,0
1579,1081,0,0,117,117,0,1,0,1,0
11035,1589,0,0,62,62,0,1,0,1,0
2085,466,0,0,92,92,0,1,0,1,0
454,1176,0,0,146,146,0,1,0,1,0
1443,3095,0,0,139,139,0,1,0,1,0
8073,1504,0,0,140,140,0,1,0,1,0
835,2764,0,0,143,143,0,1,0,1,0
1159,3095,0,0,139,139,0,1,0,1,0
1951,922,0,0,81,81,0,1,0,1,0
734,3095,0,0,139,139,0,1,0,1,0
9567,1601,0,0,113,113,0,1,0,1,0
1355,3095,0,0,139,139,0,1,0,1,0
1532,183,5525,121,293,223,70,4,0,3,1
8327,1578,0,0,146,146,0,1,0,1,0
19425,2640,0,0,120,120,0,1,0,1,0
16863,1543,0,0,62,62,0,1,0,1,0
2178,678,0,0,108,108,0,1,0,1,0
7861,2209,0,0,108,108,0,1,0,1,0
2472,1465,0,0,97,97,0,1,0,1,0
1348,3095,0,0,142,142,0,1,0,1,0
11078,1598,0,0,62,62,0,1,0,1,0
2991,1694,0,0,62,62,0,1,0,1,0
8254,1246,0,0,155,155,0,1,0,1,0
20505,183,27668,121,293,223,70,4,0,3,1
3014,1694,0,0,62,62,0,1,0,1,0
2187,201,0,0,94,94,0,1,0,1,0
1405,3095,0,0,140,140,0,1,0,1,0
701,2675,0,0,144,144,0,1,0,1,0
1853,906,0,0,77,77,0,1,0,1,0
1730,183,6471,121,293,223,70,4,0,3,1
9333,1632,0,0,111,111,0,1,0,1,0
2178,1176,0,0,144,144,0,1,0,1,0
3774,183,13338,121,293,223,70,4,1,3,1
2601,1346,0,0,62,62,0,1,0,1,0
1919,183,7521,121,293,223,70,4,0,3,1
2998,1694,0,0,62,62,0,1,0,1,0
10406,1548,0,0,71,71,0,1,0,1,0
8423,1543,0,0,142,142,0,1,0,1,0
1947,977,0,0,95,95,0,1,0,1,0
1393,183,4794,121,293,223,70,4,0,3,1
3013,1568,0,0,82,82,0,1,0,1,0
225,2193,0,0,144,144,0,1,0,1,0
1547,3095,0,0,141,141,0,1,0,1,0
881,284,3213,108,279,216,62,3,0,2,0
1588,1075,0,0,116,116,0,1,0,1,0
2567,1472,0,0,96,96,0,1,0,1,0
698,1159,0,0,157,157,0,1,0,1,0
1892,2268,0,0,95,95,0,1,0,1,0
78,1442,0,0,153,153,0,1,0,1,0
178,2165,0,0,146,146,0,1,0,1,0
2932,1694,0,0,62,62,0,1,0,1,0
1960,183,7596,121,293,223,70,4,0,3,1
2007,2097,0,0,85,85,0,1,0,1,0
2334,183,9469,121,293,223,70,4,0,3,1
4635,602,0,0,146,146,0,1,0,1,0
2046,183,8046,121,293,223,70,4,0,3,1
5298,288,0,0,146,146,0,1,0,1,0
1660,547,0,0,147,147,0,1,0,1,0
2264,2259,0,0,101,101,0,1,0,1,0
1402,183,4830,121,293,223,70,4,0,3,1
10726,1589,0,0,68,68,0,1,0,1,0
9361,1543,0,0,110,110,0,1,0,1,0
2332,274,0,0,62,62,0,1,0,1,0
3475,183,12640,121,293,223,70,4,0,3,1
1751,1176,0,0,145,145,0,1,0,1,0
9213,1640,0,0,115,115,0,1,0,1,0
2345,342,0,0,85,85,0,1,0,1,0
11134,1422,0,0,69,69,0,1,0,1,0
2200,474,0,0,62,62,0,1,0,1,0
1224,183,4218,121,293,223,70,4,1,3,1
13621,607,0,0,124,124,0,1,0,1,0
2406,218,0,0,76,76,0,1,0,1,0
2201,183,8940,121,293,223,70,4,0,3,1
2136,183,8562,121,293,223,70,4,0,3,1
1761,1176,0,0,145,145,0,1,0,1,0
2915,1202,0,0,143,143,0,1,0,1,0
2248,2940,0,0,148,148,0,1,0,1,0
12351,890,0,0,108,108,0,1,0,1,0
2905,1508,0,0,92,92,0,1,0,1,0
8399,1527,0,0,145,145,0,1,0,1,0
4812,336,0,0,146,146,0,1,0,1,0
1651,530,0,0,147,147,0,1,0,1,0
2106,1237,0,0,62,62,0,1,0,1,0
1430,3095,0,0,139,139,0,1,0,1,0
6415,644,0,0,146,146,0,1,0,1,0
1345,183,4552,121,293,223,70,4,1,3,1
2914,1208,0,0,142,142,0,1,0,1,0
1466,183,5154,121,293,223,70,4,0,3,1
1584,578,0,0,148,148,0,1,0,1,0
10378,1543,0,0,71,71,0,1,0,1,0
1652,3095,0,0,151,151,0,1,0,1,0
1349,183,4818,121,293,223,70,4,1,3,1
1727,2514,0,0,109,109,0,1,0,1,0
2100,183,8611,121,293,223,70,4,0,3,1
574,2897,0,0,140,140,0,1,0,1,0
8165,1901,0,0,133,133,0,1,0,1,0
21365,427,23348,99,251,194,57,3,0,2,0
1340,756,0,0,151,151,0,1,0,1,0
7930,1348,0,0,146,146,0,1,0,1,0
1992,183,8159,121,293,223,70,4,0,3,1
8060,1923,0,0,124,124,0,1,0,1,0
1564,593,0,0,148,148,0,1,0,1,0
3799,763,0,0,122,122,0,1,0,1,0
1890,1077,0,0,143,143,0,1,0,1,0
8292,1393,0,0,150,150,0,1,0,1,0
12163,951,0,0,105,105,0,1,0,1,0
380,1168,0,0,143,143,0,1,0,1,0
4836,183,15999,121,293,223,70,4,0,3,1
2274,1845,0,0,72,72,0,1,0,1,0
9205,1543,0,0,114,114,0,1,0,1,0
3805,617,0,0,146,146,0,1,0,1,0
975,3095,0,0,139,139,0,1,0,1,0
19882,183,27432,121,293,223,70,4,0,3,1
10639,1578,0,0,69,69,0,1,0,1,0
2672,1176,0,0,146,146,0,1,0,1,0
1151,3095,0,0,139,139,0,1,0,1,0
972,1176,0,0,140,140,0,1,0,1,0
2490,1694,0,0,62,62,0,1,0,1,0
1945,826,0,0,65,65,0,1,0,1,0
1835,1176,0,0,144,144,0,1,0,1,0
1942,183,7534,121,293,223,70,4,0,3,1
3281,183,12303,121,293,223,70,4,0,3,1
7492,2736,0,0,79,79,0,1,0,1,0
2264,1674,0,0,65,65,0,1,0,1,0
1843,2413,0,0,101,101,0,1,0,1,0
2642,1694,0,0,62,62,0,1,0,1,0
7790,2049,0,0,112,112,0,1,0,1,0
9728,1388,0,0,101,101,0,1,0,1,0
8259,1249,0,0,154,154,0,1,0,1,0
1612,183,5889,121,293,223,70,4,0,3,1
150,1962,0,0,148,148,0,1,0,1,0
2266,948,0,0,89,89,0,1,0,1,0
2772,1694,0,0,62,62,0,1,0,1,0
2914,1215,0,0,141,141,0,1,0,1,0
19716,1572,0,0,62,62,0,1,0,1,0
8327,1588,0,0,146,146,0,1,0,1,0
13270,473,0,0,145,145,0,1,0,1,0
11083,1635,0,0,65,65,0,1,0,1,0
2637,360,0,0,88,88,0,1,0,1,0
1733,3095,0,0,146,146,0,1,0,1,0
19011,183,26048,121,293,223,70,4,0,3,1
1383,183,4742,121,293,223,70,4,0,3,1
1754,2561,0,0,109,109,0,1,0,1,0
2762,1570,0,0,62,62,0,1,0,1,0
2339,1644,0,0,70,70,0,1,0,1,0
110,1048,0,0,153,153,0,1,0,1,0
1547,1176,0,0,139,139,0,1,0,1,0
19212,2742,0,0,126,126,0,1,0,1,0
21491,1643,0,0,67,67,0,1,0,1,0
1104,2940,0,0,143,143,0,1,0,1,0
2411,183,9239,121,293,223,70,4,0,3,1
3496,183,12349,121,293,223,70,4,1,3,1
3347,183,12231,121,293,223,70,4,0,3,1
775,1170,0,0,156,156,0,1,0,1,0
5626,255,0,0,146,146,0,1,0,1,0
2021,996,0,0,130,130,0,1,0,1,0
988,183,3833,121,293,223,70,4,1,3,1
10000,1569,0,0,85,85,0,1,0,1,0
2125,1279,0,0,126,126,0,1,0,1,0
1405,3095,0,0,140,140,0,1,0,1,0
3182,1531,0,0,72,72,0,1,0,1,0
14138,183,23121,121,293,223,70,4,0,3,1
17951,2733,0,0,145,145,0,1,0,1,0
11176,1275,0,0,87,87,0,1,0,1,0
2534,1485,0,0,96,96,0,1,0,1,0
2255,2659,0,0,128,128,0,1,0,1,0
1851,2330,0,0,98,98,0,1,0,1,0
1518,183,5419,121,293,223,70,4,0,3,1
19566,2571,0,0,117,117,0,1,0,1,0
8736,1246,0,0,138,138,0,1,0,1,0
2423,1694,0,0,62,62,0,1,0,1,0
10408,1567,0,0,75,75,0,1,0,1,0
8305,1447,0,0,148,148,0,1,0,1,0
2008,183,7844,121,293,223,70,4,0,3,1
970,2814,0,0,141,141,0,1,0,1,0
2474,1534,0,0,88,88,0,1,0,1,0
8718,1258,0,0,137,137,0,1,0,1,0
54,1265,0,0,154,154,0,1,0,1,0
1605,665,0,0,146,146,0,1,0,1,0
2251,1654,0,0,68,68,0,1,0,1,0
1745,1176,0,0,141,141,0,1,0,1,0
3011,123,0,0,87,87,0,1,0,1,0
10163,1629,0,0,98,98,0,1,0,1,0
3043,1694,0,0,62,62,0,1,0,1,0
1613,3095,0,0,147,147,0,1,0,1,0
14206,270,0,0,145,145,0,1,0,1,0
1201,183,4173,121,293,223,70,4,1,3,1
2253,393,0,0,62,62,0,1,0,1,0
2194,647,0,0,106,106,0,1,0,1,0
9600,1370,0,0,106,106,0,1,0,1,0
915,183,3635,121,293,223,70,4,1,3,1
796,949,815,27,187,172,15,1,0,1,0
9519,1543,0,0,105,105,0,1,0,1,0
8304,1723,0,0,144,144,0,1,0,1,0
11412,1676,0,0,63,63,0,1,0,1,0
17142,183,25431,121,293,223,70,4,0,3,1
1472,1176,0,0,139,139,0,1,0,1,0
8327,1568,0,0,146,146,0,1,0,1,0
1108,3095,0,0,141,141,0,1,0,1,0
1576,183,5492,121,293,223,70,4,1,3,1
1464,183,5143,121,293,223,70,4,0,3,1
367,1176,0,0,143,143,0,1,0,1,0
8327,1614,0,0,146,146,0,1,0,1,0
556,2562,0,0,143,143,0,1,0,1,0
3709,183,13092,121,293,223,70,4,0,3,1
2987,1466,0,0,99,99,0,1,0,1,0
2921,183,11235,121,293,223,70,4,0,3,1
1941,3095,0,0,151,151,0,1,0,1,0
323,1073,0,0,157,157,0,1,0,1,0
12332,896,0,0,108,108,0,1,0,1,0
1940,1081,0,0,120,120,0,1,0,1,0
1399,1176,0,0,139,139,0,1,0,1,0
3020,1600,0,0,77,77,0,1,0,1,0
2301,231,0,0,77,77,0,1,0,1,0
10504,1561,0,0,70,70,0,1,0,1,0
10165,1557,0,0,79,79,0,1,0,1,0
2901,1623,0,0,73,73,0,1,0,1,0
7865,1906,0,0,119,119,0,1,0,1,0
10848,1605,0,0,67,67,0,1,0,1,0
2419,1579,0,0,81,81,0,1,0,1,0
5052,312,0,0,146,146,0,1,0,1,0
2041,183,8022,121,293,223,70,4,0,3,1
3024,1694,0,0,62,62,0,1,0,1,0
1369,3095,0,0,141,141,0,1,0,1,0
2279,1176,0,0,144,144,0,1,0,1,0
13392,727,0,0,117,117,0,1,0,1,0
3921,183,13860,121,293,223,70,4,1,3,1
11979,1467,0,0,75,75,0,1,0,1,0
1579,183,5715,121,293,223,70,4,0,3,1
1493,992,0,0,141,141,0,1,0,1,0
1955,876,0,0,70,70,0,1,0,1,0
3910,183,13621,121,293,223,70,4,0,3,1
1474,1047,0,0,140,140,0,1,0,1,0
2866,1158,0,0,143,143,0,1,0,1,0
9146,1644,0,0,118,118,0,1,0,1,0
1333,1176,0,0,139,139,0,1,0,1,0
2900,1176,0,0,147,147,0,1,0,1,0
4913,183,16435,121,293,223,70,4,1,3,1
8960,1655,0,0,124,124,0,1,0,1,0
3929,539,0,0,146,146,0,1,0,1,0
8277,1388,0,0,152,152,0,1,0,1,0
1983,183,7739,121,293,223,70,4,0,3,1
18667,3005,0,0,140,140,0,1,0,1,0
3360,183,11819,121,293,223,70,4,0,3,1
1717,183,6412,121,293,223,70,4,0,3,1
18609,3033,0,0,141,141,0,1,0,1,0
8327,1670,0,0,146,146,0,1,0,1,0
7739,2382,0,0,99,99,0,1,0,1,0
20466,1326,0,0,75,75,0,1,0,1,0
15130,810,0,0,145,145,0,1,0,1,0
982,3095,0,0,140,140,0,1,0,1,0
1542,183,5536,121,293,223,70,4,0,3,1
1997,1272,0,0,127,127,0,1,0,1,0
10860,1553,0,0,62,62,0,1,0,1,0
10069,1543,0,0,87,87,0,1,0,1,0
1463,666,0,0,149,149,0,1,0,1,0
640,1176,0,0,152,152,0,1,0,1,0
2989,1694,0,0,62,62,0,1,0,1,0
2385,1606,0,0,76,76,0,1,0,1,0
1482,1176,0,0,139,139,0,1,0,1,0
2055,1359,0,0,114,114,0,1,0,1,0
2273,1682,0,0,62,62,0,1,0,1,0
8082,1892,0,0,126,126,0,1,0,1,0
8251,1225,0,0,155,155,0,1,0,1,0
556,1176,0,0,149,149,0,1,0,1,0
1783,448,0,0,134,134,0,1,0,1,0
2027,2108,0,0,84,84,0,1,0,1,0
824,732,1599,54,217,186,31,2,0,1,0
9739,1389,0,0,101,101,0,1,0,1,0
2728,628,0,0,107,107,0,1,0,1,0
2485,1694,0,0,62,62,0,1,0,1,0
10016,1177,0,0,145,145,0,1,0,1,0
1952,183,7697,121,293,223,70,4,0,3,1
1640,183,6025,121,293,223,70,4,0,3,1
1405,183,4845,121,293,223,70,4,0,3,1
3288,183,11614,121,293,223,70,4,0,3,1
2221,179,0,0,91,91,0,1,0,1,0
1987,183,7759,121,293,223,70,4,0,3,1
4939,183,16468,121,293,223,70,4,1,3,1
2997,1694,0,0,62,62,0,1,0,1,0
2896,1700,0,0,62,62,0,1,0,1,0
9893,1461,0,0,90,90,0,1,0,1,0
752,1659,0,0,152,152,0,1,0,1,0
9877,1409,0,0,96,96,0,1,0,1,0
3192,1520,0,0,73,73,0,1,0,1,0
3350,206,0,0,104,104,0,1,0,1,0
2004,1283,0,0,126,126,0,1,0,1,0
2202,191,0,0,93,93,0,1,0,1,0
8898,1543,0,0,126,126,0,1,0,1,0
16534,2700,0,0,123,123,0,1,0,1,0
587,2581,0,0,143,143,0,1,0,1,0
2807,183,9983,121,293,223,70,4,0,3,1
9690,1611,0,0,99,99,0,1,0,1,0
1416,183,5610,121,293,223,70,4,0,3,1
13129,865,0,0,109,109,0,1,0,1,0
746,1841,0,0,150,150,0,1,0,1,0
1246,183,4537,121,293,223,70,4,1,3,1
9924,1467,0,0,89,89,0,1,0,1,0
8612,1676,0,0,136,136,0,1,0,1,0
21543,1619,0,0,66,66,0,1,0,1,0
759,1174,0,0,157,157,0,1,0,1,0
3199,183,11758,121,293,223,70,4,0,3,1
18193,3039,0,0,142,142,0,1,0,1,0
2406,1589,0,0,79,79,0,1,0,1,0
2936,1258,0,0,134,134,0,1,0,1,0
3956,183,14112,121,293,223,70,4,0,3,1
1549,1100,0,0,121,121,0,1,0,1,0
2296,1694,0,0,62,62,0,1,0,1,0
8754,1662,0,0,130,130,0,1,0,1,0
9529,1543,0,0,102,102,0,1,0,1,0
17502,2427,0,0,145,145,0,1,0,1,0
2076,183,8331,121,293,223,70,4,0,3,1
316,1535,0,0,143,143,0,1,0,1,0
9947,1543,0,0,91,91,0,1,0,1,0
409,1093,0,0,157,157,0,1,0,1,0
2260,2424,0,0,112,112,0,1,0,1,0
13693,2127,0,0,87,87,0,1,0,1,0
2750,1117,0,0,133,133,0,1,0,1,0
1801,183,6783,121,293,223,70,4,0,3,1
92,1543,0,0,152,152,0,1,0,1,0
2297,183,9383,121,293,223,70,4,0,3,1
969,183,3724,121,293,223,70,4,1,3,1
1827,933,0,0,144,144,0,1,0,1,0
1931,813,0,0,69,69,0,1,0,1,0
1922,1476,0,0,94,94,0,1,0,1,0
8327,1622,0,0,146,146,0,1,0,1,0
756,442,2644,89,253,202,51,3,0,2,0
3709,183,13570,121,293,223,70,4,0,3,1
10832,1694,0,0,80,80,0,1,0,1,0
2844,1694,0,0,62,62,0,1,0,1,0
11019,1626,0,0,66,66,0,1,0,1,0
2053,1356,0,0,114,114,0,1,0,1,0
1997,183,7781,121,293,223,70,4,0,3,1
2063,935,0,0,62,62,0,1,0,1,0
1943,1030,0,0,108,108,0,1,0,1,0
2100,183,7888,121,293,223,70,4,0,3,1
1447,3095,0,0,148,148,0,1,0,1,0
1267,183,4301,121,293,223,70,4,1,3,1
19229,1110,0,0,89,89,0,1,0,1,0
2736,1694,0,0,62,62,0,1,0,1,0
10235,1460,0,0,83,83,0,1,0,1,0
9510,1357,0,0,110,110,0,1,0,1,0
1703,183,6302,121,293,223,70,4,0,3,1
1024,2888,0,0,143,143,0,1,0,1,0
881,1093,0,0,155,155,0,1,0,1,0
6597,577,0,0,149,149,0,1,0,1,0
1748,3095,0,0,152,152,0,1,0,1,0
8324,1529,0,0,146,146,0,1,0,1,0
11063,1312,0,0,85,85,0,1,0,1,0
22,1005,0,0,156,156,0,1,0,1,0
6343,485,0,0,148,148,0,1,0,1,0
1686,183,6296,121,293,223,70,4,0,3,1
3792,625,0,0,146,146,0,1,0,1,0
8069,2025,0,0,125,125,0,1,0,1,0
894,1176,0,0,155,155,0,1,0,1,0
17223,1543,0,0,65,65,0,1,0,1,0
1881,183,7324,121,293,223,70,4,0,3,1
1697,3095,0,0,149,149,0,1,0,1,0
9283,1543,0,0,113,113,0,1,0,1,0
1439,183,5024,121,293,223,70,4,0,3,1
1914,796,0,0,74,74,0,1,0,1,0
1299,3014,0,0,139,139,0,1,0,1,0
2160,183,8066,121,293,223,70,4,0,3,1
2474,183,8374,121,293,223,70,4,1,3,1
43,1015,0,0,155,155,0,1,0,1,0
1000,231,3081,104,272,212,60,3,0,2,0
2386,79,0,0,74,74,0,1,0,1,0
6130,407,0,0,147,147,0,1,0,1,0
1519,183,5413,121,293,223,70,4,0,3,1
2979,1694,0,0,62,62,0,1,0,1,0
891,2800,0,0,143,143,0,1,0,1,0
2222,1048,0,0,62,62,0,1,0,1,0
13617,2112,0,0,86,86,0,1,0,1,0
9369,1337,0,0,115,115,0,1,0,1,0
3977,183,14366,121,293,223,70,4,0,3,1
4600,183,16048,121,293,223,70,4,1,3,1
1830,183,6435,121,293,223,70,4,1,3,1
1325,183,4456,121,293,223,70,4,1,3,1
1794,1176,0,0,141,141,0,1,0,1,0
10524,1489,0,0,75,75,0,1,0,1,0
4144,406,0,0,145,145,0,1,0,1,0
1810,894,0,0,145,145,0,1,0,1,0
1351,3095,0,0,142,142,0,1,0,1,0
643,1176,0,0,141,141,0,1,0,1,0
351,2446,0,0,144,144,0,1,0,1,0
1815,904,0,0,145,145,0,1,0,1,0
1707,183,6325,121,293,223,70,4,0,3,1
2275,1687,0,0,62,62,0,1,0,1,0
18671,3003,0,0,140,140,0,1,0,1,0
11271,1371,0,0,72,72,0,1,0,1,0
14263,271,0,0,143,143,0,1,0,1,0
8487,1508,0,0,145,145,0,1,0,1,0
2254,2697,0,0,131,131,0,1,0,1,0
2045,707,0,0,62,62,0,1,0,1,0
1444,434,981,33,187,168,19,1,0,1,0
2329,2914,0,0,146,146,0,1,0,1,0
9604,1266,0,0,145,145,0,1,0,1,0
767,1184,0,0,156,156,0,1,0,1,0
1449,1120,0,0,139,139,0,1,0,1,0
950,183,3687,121,293,223,70,4,1,3,1
49,1010,0,0,157,157,0,1,0,1,0
1852,3095,0,0,149,149,0,1,0,1,0
15472,1044,0,0,145,145,0,1,0,1,0
15273,2445,0,0,110,110,0,1,0,1,0
2530,2483,0,0,116,116,0,1,0,1,0
1535,2924,0,0,129,129,0,1,0,1,0
5584,183,12622,121,293,223,70,4,0,3,1
971,3095,0,0,142,142,0,1,0,1,0
2312,124,0,0,82,82,0,1,0,1,0
1800,183,6782,121,293,223,70,4,0,3,1
2482,1432,0,0,102,102,0,1,0,1,0
14215,296,0,0,142,142,0,1,0,1,0
4722,183,16198,121,293,223,70,4,1,3,1
1525,470,600,20,172,160,11,1,0,1,0
1870,750,0,0,86,86,0,1,0,1,0
1936,1131,0,0,132,132,0,1,0,1,0
1389,3095,0,0,140,140,0,1,0,1,0
1619,3095,0,0,147,147,0,1,0,1,0
230,2366,0,0,144,144,0,1,0,1,0
10595,1543,0,0,66,66,0,1,0,1,0
21650,1543,0,0,62,62,0,1,0,1,0
847,556,2232,75,241,198,43,2,0,2,0
1229,838,0,0,152,152,0,1,0,1,0
19942,183,27476,121,293,223,70,4,0,3,1
8314,1488,0,0,147,147,0,1,0,1,0
11505,1685,0,0,62,62,0,1,0,1,0
863,1106,0,0,146,146,0,1,0,1,0
3376,183,12583,121,293,223,70,4,0,3,1
2770,1125,0,0,134,134,0,1,0,1,0
2048,183,8058,121,293,223,70,4,0,3,1
4650,352,0,0,146,146,0,1,0,1,0
1326,767,0,0,151,151,0,1,0,1,0
1832,183,6986,121,293,223,70,4,0,3,1
1135,3095,0,0,141,141,0,1,0,1,0
1711,183,6988,121,293,223,70,4,0,3,1
18129,2855,0,0,145,145,0,1,0,1,0
595,1136,0,0,157,157,0,1,0,1,0
1629,594,0,0,147,147,0,1,0,1,0
1445,183,5048,121,293,223,70,4,1,3,1
1302,1176,0,0,142,142,0,1,0,1,0
683,1156,0,0,157,157,0,1,0,1,0
13924,448,0,0,133,133,0,1,0,1,0
615,1176,0,0,151,151,0,1,0,1,0
1355,3048,0,0,139,139,0,1,0,1,0
13463,1665,0,0,62,62,0,1,0,1,0
10153,1644,0,0,71,71,0,1,0,1,0
329,2087,0,0,147,147,0,1,0,1,0
1784,663,0,0,110,110,0,1,0,1,0
2267,2121,0,0,91,91,0,1,0,1,0
1598,1278,0,0,123,123,0,1,0,1,0
11282,1639,0,0,62,62,0,1,0,1,0
2195,183,8916,121,293,223,70,4,0,3,1
1066,957,0,0,153,153,0,1,0,1,0
12862,1004,0,0,101,101,0,1,0,1,0
2804,1694,0,0,62,62,0,1,0,1,0
10618,1543,0,0,66,66,0,1,0,1,0
82,1035,0,0,154,154,0,1,0,1,0
7657,2308,0,0,99,99,0,1,0,1,0
760,1411,0,0,154,154,0,1,0,1,0
854,500,2436,82,249,201,47,3,0,2,0
1078,817,0,0,145,145,0,1,0,1,0
10522,1560,0,0,71,71,0,1,0,1,0
7370,2924,0,0,69,69,0,1,0,1,0
1445,1134,0,0,139,139,0,1,0,1,0
6897,2380,0,0,82,82,0,1,0,1,0
8944,2234,0,0,67,67,0,1,0,1,0
3196,183,12051,121,293,223,70,4,0,3,1
2147,1176,0,0,144,144,0,1,0,1,0
10408,1485,0,0,76,76,0,1,0,1,0
1950,832,0,0,64,64,0,1,0,1,0
1084,3095,0,0,141,141,0,1,0,1,0
4348,183,14631,121,293,223,70,4,0,3,1
2430,52,0,0,70,70,0,1,0,1,0
1704,183,6390,121,293,223,70,4,0,3,1
1834,714,0,0,96,96,0,1,0,1,0
183,1085,0,0,150,150,0,1,0,1,0
1346,3095,0,0,142,142,0,1,0,1,0
1211,3095,0,0,139,139,0,1,0,1,0
419,1095,0,0,157,157,0,1,0,1,0
8320,1513,0,0,146,146,0,1,0,1,0
49,1010,0,0,157,157,0,1,0,1,0
10298,1543,0,0,74,74,0,1,0,1,0
11491,1682,0,0,62,62,0,1,0,1,0
365,1182,0,0,143,143,0,1,0,1,0
2125,183,8520,121,293,223,70,4,0,3,1
2949,1313,0,0,125,125,0,1,0,1,0
1015,3095,0,0,139,139,0,1,0,1,0
1935,816,0,0,68,68,0,1,0,1,0
2203,926,0,0,84,84,0,1,0,1,0
184,1041,0,0,157,157,0,1,0,1,0
1578,183,5717,121,293,223,70,4,0,3,1
1274,183,4977,121,293,223,70,4,0,3,1
1660,183,5760,121,293,223,70,4,1,3,1
2069,273,0,0,106,106,0,1,0,1,0
9463,1624,0,0,107,107,0,1,0,1,0
438,1176,0,0,145,145,0,1,0,1,0
1357,183,4612,121,293,223,70,4,1,3,1
1770,649,0,0,114,114,0,1,0,1,0
1627,600,0,0,147,147,0,1,0,1,0
2208,183,9012,121,293,223,70,4,0,3,1
952,3095,0,0,142,142,0,1,0,1,0
9655,1378,0,0,104,104,0,1,0,1,0
10919,1614,0,0,67,67,0,1,0,1,0
2253,284,0,0,80,80,0,1,0,1,0
3331,183,11539,121,293,223,70,4,0,3,1
214,2275,0,0,144,144,0,1,0,1,0
8038,183,18567,121,293,223,70,4,0,3,1
1623,3095,0,0,143,143,0,1,0,1,0
18990,2849,0,0,131,131,0,1,0,1,0
17141,2824,0,0,128,128,0,1,0,1,0
13846,183,23023,121,293,223,70,4,0,3,1
2193,183,8544,121,293,223,70,4,0,3,1
1939,1091,0,0,122,122,0,1,0,1,0
1417,3095,0,0,139,139,0,1,0,1,0
1889,770,0,0,81,81,0,1,0,1,0
3459,233,0,0,110,110,0,1,0,1,0
2604,265,0,0,81,81,0,1,0,1,0
12934,183,22357,121,293,223,70,4,0,3,1
9568,1694,0,0,113,113,0,1,0,1,0
1739,617,0,0,123,123,0,1,0,1,0
1071,3095,0,0,139,139,0,1,0,1,0
1254,1176,0,0,143,143,0,1,0,1,0
2487,1176,0,0,145,145,0,1,0,1,0
410,1176,0,0,142,142,0,1,0,1,0
2192,349,0,0,84,84,0,1,0,1,0
2022,994,0,0,130,130,0,1,0,1,0
1453,183,5087,121,293,223,70,4,1,3,1
240,1113,0,0,148,148,0,1,0,1,0
8417,1543,0,0,142,142,0,1,0,1,0
12239,696,0,0,145,145,0,1,0,1,0
7956,2170,0,0,116,116,0,1,0,1,0
16937,2799,0,0,131,131,0,1,0,1,0
2975,1614,0,0,67,67,0,1,0,1,0
2572,1694,0,0,62,62,0,1,0,1,0
717,2775,0,0,141,141,0,1,0,1,0
2107,3095,0,0,156,156,0,1,0,1,0
467,1176,0,0,146,146,0,1,0,1,0
1921,644,0,0,104,104,0,1,0,1,0
4065,382,0,0,141,141,0,1,0,1,0
8289,1377,0,0,150,150,0,1,0,1,0
1758,183,6576,121,293,223,70,4,0,3,1
9151,1333,0,0,120,120,0,1,0,1,0
3933,183,13903,121,293,223,70,4,1,3,1
2730,1110,0,0,131,131,0,1,0,1,0
2067,183,7845,121,293,223,70,4,0,3,1
666,612,2033,68,228,188,39,2,0,2,0
2610,1694,0,0,62,62,0,1,0,1,0
11760,1190,0,0,84,84,0,1,0,1,0
1493,183,5288,121,293,223,70,4,0,3,1
1398,714,0,0,150,150,0,1,0,1,0
2888,1198,0,0,144,144,0,1,0,1,0
1999,777,0,0,62,62,0,1,0,1,0
21484,823,15058,64,184,147,37,2,0,2,0
7506,2600,0,0,84,84,0,1,0,1,0
5841,510,0,0,138,138,0,1,0,1,0
540,2847,0,0,140,140,0,1,0,1,0
7346,2945,0,0,67,67,0,1,0,1,0
2682,183,10107,121,293,223,70,4,0,3,1
3167,1549,0,0,71,71,0,1,0,1,0
16333,603,0,0,122,122,0,1,0,1,0
7978,1687,0,0,131,131,0,1,0,1,0
2280,353,0,0,62,62,0,1,0,1,0
1531,183,5463,121,293,223,70,4,0,3,1
3806,617,0,0,146,146,0,1,0,1,0
1788,1176,0,0,141,141,0,1,0,1,0
2721,183,10013,121,293,223,70,4,0,3,1
2918,1694,0,0,62,62,0,1,0,1,0
1951,1494,0,0,91,91,0,1,0,1,0
8327,1663,0,0,146,146,0,1,0,1,0
8327,1581,0,0,146,146,0,1,0,1,0
14237,2236,0,0,99,99,0,1,0,1,0
9593,1599,0,0,99,99,0,1,0,1,0
18407,3044,0,0,145,145,0,1,0,1,0
6250,522,0,0,146,146,0,1,0,1,0
10890,1610,0,0,67,67,0,1,0,1,0
1149,1176,0,0,152,152,0,1,0,1,0
2010,183,7856,121,293,223,70,4,0,3,1
1950,183,7529,121,293,223,70,4,0,3,1
2812,183,10912,121,293,223,70,4,0,3,1
1043,3095,0,0,141,141,0,1,0,1,0
2904,1530,0,0,89,89,0,1,0,1,0
9883,1543,0,0,89,89,0,1,0,1,0
3187,1395,0,0,81,81,0,1,0,1,0
1423,696,0,0,150,150,0,1,0,1,0
2108,1241,0,0,62,62,0,1,0,1,0
589,1063,0,0,143,143,0,1,0,1,0
8412,1543,0,0,142,142,0,1,0,1,0
2934,183,10362,121,293,223,70,4,0,3,1
3021,1683,0,0,63,63,0,1,0,1,0
2090,3095,0,0,155,155,0,1,0,1,0
2977,1694,0,0,62,62,0,1,0,1,0
1358,183,4615,121,293,223,70,4,0,3,1
1751,183,6539,121,293,223,70,4,0,3,1
7511,2743,0,0,80,80,0,1,0,1,0
1445,3095,0,0,139,139,0,1,0,1,0
785,388,2839,95,261,206,55,3,0,2,0
9628,1597,0,0,98,98,0,1,0,1,0
3038,183,11244,121,293,223,70,4,0,3,1
12365,1264,0,0,86,86,0,1,0,1,0
106,1640,0,0,151,151,0,1,0,1,0
1359,183,5293,121,293,223,70,4,0,3,1
7948,1357,0,0,146,146,0,1,0,1,0
2111,1443,0,0,101,101,0,1,0,1,0
1384,256,3450,95,262,206,55,3,0,2,0
517,1176,0,0,148,148,0,1,0,1,0
8398,1689,0,0,143,143,0,1,0,1,0
4995,183,16461,121,293,223,70,4,1,3,1
1637,1044,0,0,108,108,0,1,0,1,0
7842,2316,0,0,107,107,0,1,0,1,0
2085,1176,0,0,143,143,0,1,0,1,0
727,3095,0,0,139,139,0,1,0,1,0
1751,183,6578,121,293,223,70,4,0,3,1
8032,1532,0,0,146,146,0,1,0,1,0
8282,1420,0,0,151,151,0,1,0,1,0
258,1951,0,0,144,144,0,1,0,1,0
1747,749,0,0,146,146,0,1,0,1,0
9522,1543,0,0,105,105,0,1,0,1,0
2540,2461,0,0,115,115,0,1,0,1,0
8327,1675,0,0,146,146,0,1,0,1,0
1317,3080,0,0,143,143,0,1,0,1,0
1723,183,6439,121,293,223,70,4,0,3,1
7761,2421,0,0,100,100,0,1,0,1,0
7969,2154,0,0,117,117,0,1,0,1,0
817,787,1399,47,210,182,27,2,0,1,0
8849,1543,0,0,127,127,0,1,0,1,0
2423,1262,0,0,62,62,0,1,0,1,0
1906,872,0,0,69,69,0,1,0,1,0
8682,1543,0,0,133,133,0,1,0,1,0
2243,1602,0,0,62,62,0,1,0,1,0
10567,1543,0,0,70,70,0,1,0,1,0
2448,99,0,0,62,62,0,1,0,1,0
2527,1694,0,0,62,62,0,1,0,1,0
9031,1543,0,0,122,122,0,1,0,1,0
10760,1543,0,0,63,63,0,1,0,1,0
2511,1033,0,0,111,111,0,1,0,1,0
9155,1643,0,0,117,117,0,1,0,1,0
927,1176,0,0,155,155,0,1,0,1,0
13633,469,0,0,132,132,0,1,0,1,0
11419,1668,0,0,62,62,0,1,0,1,0
7417,2843,0,0,73,73,0,1,0,1,0
1951,923,0,0,82,82,0,1,0,1,0
1717,993,0,0,97,97,0,1,0,1,0
1904,1109,0,0,143,143,0,1,0,1,0
17298,2288,0,0,145,145,0,1,0,1,0
8276,1323,0,0,152,152,0,1,0,1,0
902,183,3610,121,293,223,70,4,0,3,1
2336,109,0,0,79,79,0,1,0,1,0
1854,3095,0,0,149,149,0,1,0,1,0
2213,183,9014,121,293,223,70,4,0,3,1
1343,1176,0,0,150,150,0,1,0,1,0
2961,1694,0,0,62,62,0,1,0,1,0
1273,638,0,0,150,150,0,1,0,1,0
1754,466,0,0,137,137,0,1,0,1,0
2344,2882,0,0,144,144,0,1,0,1,0
8432,1543,0,0,142,142,0,1,0,1,0
394,1176,0,0,143,143,0,1,0,1,0
21370,1702,0,0,70,70,0,1,0,1,0
3035,1694,0,0,62,62,0,1,0,1,0
2917,1694,0,0,62,62,0,1,0,1,0
1103,1176,0,0,147,147,0,1,0,1,0
754,1588,0,0,153,153,0,1,0,1,0
11221,1652,0,0,64,64,0,1,0,1,0
11127,1640,0,0,65,65,0,1,0,1,0
2944,1291,0,0,128,128,0,1,0,1,0
20977,183,28232,121,293,223,70,4,0,3,1
467,984,690,23,171,158,13,1,0,1,0
2120,1273,0,0,62,62,0,1,0,1,0
1682,183,6279,121,293,223,70,4,0,3,1
8327,1605,0,0,146,146,0,1,0,1,0
2613,183,9215,121,293,223,70,4,1,3,1
59,1302,0,0,154,154,0,1,0,1,0
1935,1145,0,0,135,135,0,1,0,1,0
155,1034,0,0,157,157,0,1,0,1,0
9944,1595,0,0,91,91,0,1,0,1,0
166,2079,0,0,147,147,0,1,0,1,0
10213,183,17289,121,293,223,70,4,0,3,1
2202,1648,0,0,68,68,0,1,0,1,0
2067,1378,0,0,111,111,0,1,0,1,0
9127,1543,0,0,118,118,0,1,0,1,0
2230,3095,0,0,158,158,0,1,0,1,0
729,1256,0,0,156,156,0,1,0,1,0
2494,1518,0,0,91,91,0,1,0,1,0
9321,1633,0,0,112,112,0,1,0,1,0
1703,1002,0,0,99,99,0,1,0,1,0
2986,117,0,0,86,86,0,1,0,1,0
10276,1543,0,0,75,75,0,1,0,1,0
10976,1577,0,0,62,62,0,1,0,1,0
20082,1567,0,0,62,62,0,1,0,1,0
802,907,966,32,193,174,18,1,0,1,0
4043,183,14561,121,293,223,70,4,0,3,1
3060,1527,0,0,72,72,0,1,0,1,0
19008,2841,0,0,131,131,0,1,0,1,0
4343,183,14764,121,293,223,70,4,0,3,1
2987,1464,0,0,100,100,0,1,0,1,0
1430,183,4967,121,293,223,70,4,0,3,1
8310,1592,0,0,148,148,0,1,0,1,0
9638,1543,0,0,98,98,0,1,0,1,0
345,1078,0,0,157,157,0,1,0,1,0
1392,3095,0,0,140,140,0,1,0,1,0
915,183,3620,121,293,223,70,4,1,3,1
1700,183,6325,121,293,223,70,4,0,3,1
857,3095,0,0,139,139,0,1,0,1,0
936,3095,0,0,140,140,0,1,0,1,0
608,1139,0,0,157,157,0,1,0,1,0
21280,1549,0,0,62,62,0,1,0,1,0
15409,1636,0,0,62,62,0,1,0,1,0
11944,1123,0,0,88,88,0,1,0,1,0
3002,1526,0,0,89,89,0,1,0,1,0
1552,483,469,15,167,157,9,1,0,1,0
537,1176,0,0,142,142,0,1,0,1,0
10237,1577,0,0,81,81,0,1,0,1,0
10239,1577,0,0,81,81,0,1,0,1,0
2006,183,7958,121,293,223,70,4,0,3,1
888,194,3537,119,291,222,69,3,0,2,0
14170,319,0,0,140,140,0,1,0,1,0
1585,183,5732,121,293,223,70,4,0,3,1
11162,1615,0,0,62,62,0,1,0,1,0
925,3095,0,0,140,140,0,1,0,1,0
1610,183,5853,121,293,223,70,4,0,3,1
1844,971,0,0,144,144,0,1,0,1,0
1824,704,0,0,99,99,0,1,0,1,0
7927,2114,0,0,114,114,0,1,0,1,0
662,618,2008,67,227,187,39,2,0,2,0
1877,1047,0,0,143,143,0,1,0,1,0
409,1176,0,0,144,144,0,1,0,1,0
2195,1473,0,0,62,62,0,1,0,1,0
2007,971,0,0,62,62,0,1,0,1,0
8778,1252,0,0,137,137,0,1,0,1,0
1936,818,0,0,67,67,0,1,0,1,0
755,1176,0,0,156,156,0,1,0,1,0
4897,183,16416,121,293,223,70,4,1,3,1
1671,2598,0,0,114,114,0,1,0,1,0
1521,183,5411,121,293,223,70,4,0,3,1
96,980,0,0,156,156,0,1,0,1,0
12642,183,19739,121,293,223,70,4,0,3,1
7253,3012,0,0,63,63,0,1,0,1,0
6057,427,0,0,146,146,0,1,0,1,0
4013,183,14299,121,293,223,70,4,0,3,1
8302,1436,0,0,149,149,0,1,0,1,0
12780,1047,0,0,99,99,0,1,0,1,0
7871,1041,0,0,155,155,0,1,0,1,0
1704,1001,0,0,99,99,0,1,0,1,0
1866,1176,0,0,143,143,0,1,0,1,0
4213,183,14999,121,293,223,70,4,0,3,1
94,1020,0,0,157,157,0,1,0,1,0
2832,1595,0,0,77,77,0,1,0,1,0
8881,1286,0,0,131,131,0,1,0,1,0
1822,926,0,0,81,81,0,1,0,1,0
9527,1359,0,0,109,109,0,1,0,1,0
2900,183,9001,121,293,223,70,4,0,3,1
41,1170,0,0,155,155,0,1,0,1,0
8310,1469,0,0,148,148,0,1,0,1,0
2322,1658,0,0,67,67,0,1,0,1,0
1674,911,0,0,121,121,0,1,0,1,0
12921,183,22212,121,293,223,70,4,0,3,1
1410,3095,0,0,139,139,0,1,0,1,0
2673,1694,0,0,62,62,0,1,0,1,0
206,2332,0,0,144,144,0,1,0,1,0
1987,183,7743,121,293,223,70,4,0,3,1
1019,2884,0,0,143,143,0,1,0,1,0
13025,722,0,0,114,114,0,1,0,1,0
1573,183,5692,121,293,223,70,4,0,3,1
2171,1534,0,0,86,86,0,1,0,1,0
4194,398,0,0,146,146,0,1,0,1,0
3887,183,13320,121,293,223,70,4,0,3,1
2918,1184,0,0,146,146,0,1,0,1,0
662,1176,0,0,153,153,0,1,0,1,0
1132,3095,0,0,141,141,0,1,0,1,0
3036,1662,0,0,67,67,0,1,0,1,0
10278,1694,0,0,95,95,0,1,0,1,0
13577,487,0,0,131,131,0,1,0,1,0
10747,1543,0,0,63,63,0,1,0,1,0
8302,1435,0,0,149,149,0,1,0,1,0
15246,1638,0,0,62,62,0,1,0,1,0
1648,1176,0,0,140,140,0,1,0,1,0
1777,451,0,0,135,135,0,1,0,1,0
1474,618,0,0,147,147,0,1,0,1,0
1956,838,0,0,62,62,0,1,0,1,0
8327,1672,0,0,146,146,0,1,0,1,0
6395,1492,0,0,108,108,0,1,0,1,0
1173,3095,0,0,139,139,0,1,0,1,0
8327,1669,0,0,146,146,0,1,0,1,0
2159,1297,0,0,124,124,0,1,0,1,0
1447,3095,0,0,144,144,0,1,0,1,0
4591,183,16036,121,293,223,70,4,1,3,1
3073,1659,0,0,64,64,0,1,0,1,0
18533,183,26402,121,293,223,70,4,0,3,1
2186,1449,0,0,62,62,0,1,0,1,0
7832,2329,0,0,106,106,0,1,0,1,0
5178,183,16691,121,293,223,70,4,0,3,1
6344,485,0,0,148,148,0,1,0,1,0
2024,301,0,0,110,110,0,1,0,1,0
7358,2940,0,0,68,68,0,1,0,1,0
10375,1543,0,0,71,71,0,1,0,1,0
1545,839,0,0,143,143,0,1,0,1,0
3078,183,11428,121,293,223,70,4,0,3,1
835,1176,0,0,141,141,0,1,0,1,0
8289,1596,0,0,143,143,0,1,0,1,0
10882,1558,0,0,62,62,0,1,0,1,0
2784,1694,0,0,62,62,0,1,0,1,0
2036,867,0,0,69,69,0,1,0,1,0
830,685,1767,59,224,189,34,2,0,1,0
9706,1591,0,0,95,95,0,1,0,1,0
21105,1830,0,0,77,77,0,1,0,1,0
8283,1521,0,0,146,146,0,1,0,1,0
3935,622,0,0,131,131,0,1,0,1,0
1026,986,0,0,154,154,0,1,0,1,0
3766,183,12975,121,293,223,70,4,0,3,1
16447,183,23336,121,293,223,70,4,0,3,1
1856,904,0,0,76,76,0,1,0,1,0
868,756,0,0,152,152,0,1,0,1,0
861,1176,0,0,154,154,0,1,0,1,0
3020,1598,0,0,77,77,0,1,0,1,0
2905,1498,0,0,94,94,0,1,0,1,0
872,357,2949,99,269,211,57,3,0,2,0
10367,1543,0,0,71,71,0,1,0,1,0
19911,183,27453,121,293,223,70,4,0,3,1
1946,183,7969,121,293,223,70,4,0,3,1
1380,1176,0,0,140,140,0,1,0,1,0
1348,183,4566,121,293,223,70,4,1,3,1
2194,482,0,0,62,62,0,1,0,1,0
825,314,3107,105,273,212,60,3,0,2,0
1957,1212,0,0,137,137,0,1,0,1,0
11562,1264,0,0,79,79,0,1,0,1,0
1707,999,0,0,98,98,0,1,0,1,0
9709,1430,0,0,98,98,0,1,0,1,0
700,548,2260,76,237,193,44,2,0,2,0
874,920,0,0,144,144,0,1,0,1,0
8962,1543,0,0,124,124,0,1,0,1,0
16981,2808,0,0,131,131,0,1,0,1,0
16326,2682,0,0,125,125,0,1,0,1,0
1833,183,6990,121,293,223,70,4,0,3,1
2153,1361,0,0,62,62,0,1,0,1,0
4421,183,15681,121,293,223,70,4,0,3,1
3491,183,12331,121,293,223,70,4,1,3,1
2143,559,0,0,62,62,0,1,0,1,0
2371,1618,0,0,74,74,0,1,0,1,0
855,488,2479,83,251,202,48,3,0,2,0
1643,183,6041,121,293,223,70,4,0,3,1
145,1032,0,0,157,157,0,1,0,1,0
1349,3095,0,0,142,142,0,1,0,1,0
10270,1465,0,0,81,81,0,1,0,1,0
1994,183,7899,121,293,223,70,4,0,3,1
21152,1551,0,0,62,62,0,1,0,1,0
1180,665,0,0,150,150,0,1,0,1,0
4226,395,0,0,146,146,0,1,0,1,0
10273,1694,0,0,95,95,0,1,0,1,0
7529,2684,0,0,82,82,0,1,0,1,0
2845,969,0,0,132,132,0,1,0,1,0
1753,3095,0,0,152,152,0,1,0,1,0
781,1070,379,12,171,163,7,1,0,1,0
2349,977,0,0,97,97,0,1,0,1,0
101,1607,0,0,151,151,0,1,0,1,0
3039,1676,0,0,64,64,0,1,0,1,0
2014,991,0,0,62,62,0,1,0,1,0
5799,287,0,0,146,146,0,1,0,1,0
387,1967,0,0,148,148,0,1,0,1,0
2980,1694,0,0,62,62,0,1,0,1,0
791,1176,0,0,141,141,0,1,0,1,0
803,899,995,33,194,175,19,1,0,1,0
1539,3095,0,0,141,141,0,1,0,1,0
2097,1992,0,0,78,78,0,1,0,1,0
2631,1369,0,0,62,62,0,1,0,1,0
10253,1524,0,0,76,76,0,1,0,1,0
9640,1543,0,0,98,98,0,1,0,1,0
5664,183,17046,121,293,223,70,4,0,3,1
1624,1176,0,0,146,146,0,1,0,1,0
709,3002,0,0,139,139,0,1,0,1,0
2195,1643,0,0,69,69,0,1,0,1,0
1398,3095,0,0,140,140,0,1,0,1,0
1152,894,0,0,153,153,0,1,0,1,0
10668,1582,0,0,69,69,0,1,0,1,0
2146,1343,0,0,62,62,0,1,0,1,0
1926,808,0,0,70,70,0,1,0,1,0
2537,1694,0,0,62,62,0,1,0,1,0
1361,183,4627,121,293,223,70,4,0,3,1
1835,183,6951,121,293,223,70,4,0,3,1
8818,1657,0,0,128,128,0,1,0,1,0
2904,1529,0,0,89,89,0,1,0,1,0
1951,183,7676,121,293,223,70,4,0,3,1
1965,1191,0,0,140,140,0,1,0,1,0
1964,183,7604,121,293,223,70,4,0,3,1
13171,2080,0,0,97,97,0,1,0,1,0
1327,183,4465,121,293,223,70,4,1,3,1
2811,1139,0,0,138,138,0,1,0,1,0
1522,397,1673,46,203,176,26,2,0,1,0
2088,3095,0,0,156,156,0,1,0,1,0
8249,1176,0,0,156,156,0,1,0,1,0
1046,183,3992,121,293,223,70,4,1,3,1
8255,1255,0,0,155,155,0,1,0,1,0
11794,1543,0,0,62,62,0,1,0,1,0
892,198,3522,119,290,221,68,3,0,2,0
2903,1552,0,0,85,85,0,1,0,1,0
2792,814,0,0,121,121,0,1,0,1,0
9123,1543,0,0,119,119,0,1,0,1,0
1295,183,4355,121,293,223,70,4,1,3,1
604,1176,0,0,151,151,0,1,0,1,0
13569,1543,0,0,62,62,0,1,0,1,0
1952,834,0,0,63,63,0,1,0,1,0
794,2737,0,0,143,143,0,1,0,1,0
410,2484,0,0,144,144,0,1,0,1,0
1334,183,4498,121,293,223,70,4,1,3,1
7337,2958,0,0,67,67,0,1,0,1,0
813,3095,0,0,140,140,0,1,0,1,0
2943,1287,0,0,129,129,0,1,0,1,0
1919,183,7365,121,293,223,70,4,0,3,1
1650,183,6046,121,293,223,70,4,0,3,1
10770,1543,0,0,62,62,0,1,0,1,0
1684,509,0,0,144,144,0,1,0,1,0
3805,183,12943,121,293,223,70,4,0,3,1
9871,1543,0,0,93,93,0,1,0,1,0
12816,800,0,0,109,109,0,1,0,1,0
6485,638,0,0,146,146,0,1,0,1,0
2168,1401,0,0,62,62,0,1,0,1,0
3975,822,0,0,147,147,0,1,0,1,0
970,1176,0,0,151,151,0,1,0,1,0
2362,165,0,0,72,72,0,1,0,1,0
135,1855,0,0,149,149,0,1,0,1,0
7635,2351,0,0,97,97,0,1,0,1,0
3040,1681,0,0,64,64,0,1,0,1,0
1096,183,3970,121,293,223,70,4,1,3,1
2083,183,8359,121,293,223,70,4,0,3,1
2994,183,10040,121,293,223,70,4,1,3,1
1367,3095,0,0,141,141,0,1,0,1,0
1240,830,0,0,152,152,0,1,0,1,0
1258,3095,0,0,139,139,0,1,0,1,0
165,1076,0,0,151,151,0,1,0,1,0
1400,183,4827,121,293,223,70,4,1,3,1
1792,671,0,0,108,108,0,1,0,1,0
104,1046,0,0,153,153,0,1,0,1,0
1892,183,7281,121,293,223,70,4,0,3,1
12816,2012,0,0,94,94,0,1,0,1,0
1160,3095,0,0,141,141,0,1,0,1,0
2144,1612,0,0,74,74,0,1,0,1,0
1433,1169,0,0,139,139,0,1,0,1,0
9226,2096,0,0,68,68,0,1,0,1,0
2019,183,7903,121,293,223,70,4,0,3,1
8308,1578,0,0,148,148,0,1,0,1,0
5251,293,0,0,146,146,0,1,0,1,0
2258,1642,0,0,62,62,0,1,0,1,0
11529,1691,0,0,62,62,0,1,0,1,0
2980,1437,0,0,104,104,0,1,0,1,0
10224,1578,0,0,81,81,0,1,0,1,0
8868,1265,0,0,133,133,0,1,0,1,0
3197,183,11592,121,293,223,70,4,0,3,1
8798,1543,0,0,128,128,0,1,0,1,0
2626,183,8859,121,293,223,70,4,1,3,1
171,2115,0,0,147,147,0,1,0,1,0
18848,2918,0,0,135,135,0,1,0,1,0
21160,1803,0,0,75,75,0,1,0,1,0
8216,1701,0,0,137,137,0,1,0,1,0
968,872,0,0,145,145,0,1,0,1,0
2904,183,11183,121,293,223,70,4,0,3,1
6087,465,0,0,146,146,0,1,0,1,0
2026,736,0,0,62,62,0,1,0,1,0
1457,3095,0,0,139,139,0,1,0,1,0
1937,1117,0,0,128,128,0,1,0,1,0
2454,1550,0,0,85,85,0,1,0,1,0
3053,183,10943,121,293,223,70,4,0,3,1
494,2779,0,0,141,141,0,1,0,1,0
1751,183,6579,121,293,223,70,4,0,3,1
2063,183,8456,121,293,223,70,4,0,3,1
9562,1404,0,0,104,104,0,1,0,1,0
14495,282,0,0,142,142,0,1,0,1,0
2245,1066,0,0,62,62,0,1,0,1,0
1066,3095,0,0,139,139,0,1,0,1,0
769,3095,0,0,139,139,0,1,0,1,0
1828,183,6918,121,293,223,70,4,0,3,1
2261,2401,0,0,110,110,0,1,0,1,0
9701,1543,0,0,99,99,0,1,0,1,0
9270,1543,0,0,114,114,0,1,0,1,0
1425,3095,0,0,139,139,0,1,0,1,0
1275,183,4615,121,293,223,70,4,1,3,1
9328,1633,0,0,112,112,0,1,0,1,0
4862,331,0,0,146,146,0,1,0,1,0
19625,1543,0,0,63,63,0,1,0,1,0
6397,183,17582,121,293,223,70,4,0,3,1
2982,1443,0,0,103,103,0,1,0,1,0
2260,3062,0,0,156,156,0,1,0,1,0
1575,753,0,0,144,144,0,1,0,1,0
2775,183,10194,121,293,223,70,4,0,3,1
2736,649,0,0,109,109,0,1,0,1,0
1292,3010,0,0,139,139,0,1,0,1,0
2253,1656,0,0,67,67,0,1,0,1,0
1177,1144,0,0,142,142,0,1,0,1,0
182,1084,0,0,150,150,0,1,0,1,0
290,1138,0,0,146,146,0,1,0,1,0
1025,183,3831,121,293,223,70,4,1,3,1
7810,2011,0,0,114,114,0,1,0,1,0
2238,169,0,0,89,89,0,1,0,1,0
1953,834,0,0,63,63,0,1,0,1,0
1876,183,7151,121,293,223,70,4,0,3,1
10556,1543,0,0,67,67,0,1,0,1,0
2906,1472,0,0,98,98,0,1,0,1,0
8272,1359,0,0,153,153,0,1,0,1,0
1801,183,6785,121,293,223,70,4,0,3,1
3546,1024,0,0,105,105,0,1,0,1,0
1894,1086,0,0,143,143,0,1,0,1,0
10571,1473,0,0,75,75,0,1,0,1,0
119,1053,0,0,152,152,0,1,0,1,0
1058,183,4263,121,293,223,70,4,0,3,1
3484,239,0,0,111,111,0,1,0,1,0
1672,1323,0,0,117,117,0,1,0,1,0
6029,371,0,0,147,147,0,1,0,1,0
1040,3095,0,0,141,141,0,1,0,1,0
2876,1741,0,0,65,65,0,1,0,1,0
2345,1694,0,0,62,62,0,1,0,1,0
12105,1805,0,0,76,76,0,1,0,1,0
1260,183,4288,121,293,223,70,4,1,3,1
1790,1176,0,0,141,141,0,1,0,1,0
14070,326,0,0,140,140,0,1,0,1,0
869,2786,0,0,143,143,0,1,0,1,0
2277,183,8023,121,293,223,70,4,1,3,1
1578,183,5693,121,293,223,70,4,0,3,1
538,2844,0,0,141,141,0,1,0,1,0
3963,593,0,0,133,133,0,1,0,1,0
2472,1020,0,0,108,108,0,1,0,1,0
2403,183,9651,121,293,223,70,4,0,3,1
1714,183,6393,121,293,223,70,4,0,3,1
1765,3095,0,0,150,150,0,1,0,1,0
7493,2735,0,0,79,79,0,1,0,1,0
1515,3095,0,0,141,141,0,1,0,1,0
10780,1543,0,0,62,62,0,1,0,1,0
1896,1176,0,0,142,142,0,1,0,1,0
2898,1176,0,0,147,147,0,1,0,1,0
2065,1127,0,0,62,62,0,1,0,1,0
595,1176,0,0,151,151,0,1,0,1,0
9621,1543,0,0,102,102,0,1,0,1,0
8248,1206,0,0,156,156,0,1,0,1,0
1739,183,6574,121,293,223,70,4,0,3,1
2245,1645,0,0,69,69,0,1,0,1,0
1870,1176,0,0,143,143,0,1,0,1,0
2410,183,8807,121,293,223,70,4,0,3,1
8279,1401,0,0,152,152,0,1,0,1,0
10396,1543,0,0,71,71,0,1,0,1,0
4909,183,16431,121,293,223,70,4,1,3,1
1095,183,3968,121,293,223,70,4,1,3,1
3026,1694,0,0,62,62,0,1,0,1,0
4516,183,15943,121,293,223,70,4,1,3,1
2057,1106,0,0,62,62,0,1,0,1,0
2076,183,8246,121,293,223,70,4,0,3,1
8045,1557,0,0,137,137,0,1,0,1,0
1469,3033,0,0,135,135,0,1,0,1,0
496,2541,0,0,144,144,0,1,0,1,0
9877,1578,0,0,89,89,0,1,0,1,0
8312,1603,0,0,147,147,0,1,0,1,0
10742,1543,0,0,63,63,0,1,0,1,0
3550,1020,0,0,105,105,0,1,0,1,0
2355,1631,0,0,72,72,0,1,0,1,0
850,3095,0,0,139,139,0,1,0,1,0
235,1110,0,0,148,148,0,1,0,1,0
301,1644,0,0,143,143,0,1,0,1,0
1089,1176,0,0,153,153,0,1,0,1,0
8214,1703,0,0,137,137,0,1,0,1,0
1097,1176,0,0,148,148,0,1,0,1,0
1680,183,6193,121,293,223,70,4,0,3,1
10669,1523,0,0,67,67,0,1,0,1,0
9358,1617,0,0,108,108,0,1,0,1,0
2715,1527,0,0,62,62,0,1,0,1,0
953,1176,0,0,151,151,0,1,0,1,0
2171,183,8782,121,293,223,70,4,0,3,1
1113,685,0,0,150,150,0,1,0,1,0
4983,183,16522,121,293,223,70,4,1,3,1
18024,2783,0,0,145,145,0,1,0,1,0
2606,1694,0,0,62,62,0,1,0,1,0
3104,183,11497,121,293,223,70,4,0,3,1
7072,1005,0,0,146,146,0,1,0,1,0
381,1168,0,0,143,143,0,1,0,1,0
8732,1562,0,0,135,135,0,1,0,1,0
356,2441,0,0,144,144,0,1,0,1,0
2025,901,0,0,62,62,0,1,0,1,0
7586,2445,0,0,92,92,0,1,0,1,0
1161,1176,0,0,146,146,0,1,0,1,0
1575,751,0,0,144,144,0,1,0,1,0
1035,2895,0,0,143,143,0,1,0,1,0
254,2244,0,0,146,146,0,1,0,1,0
865,238,3381,114,284,218,66,3,0,2,0
1387,3095,0,0,140,140,0,1,0,1,0
3033,183,11566,121,293,223,70,4,0,3,1
4110,183,14760,121,293,223,70,4,0,3,1
17824,2961,0,0,137,137,0,1,0,1,0
3190,183,11333,121,293,223,70,4,0,3,1
9934,1596,0,0,91,91,0,1,0,1,0
432,1176,0,0,145,145,0,1,0,1,0
212,1099,0,0,149,149,0,1,0,1,0
1958,183,7575,121,293,223,70,4,0,3,1
4162,183,14795,121,293,223,70,4,0,3,1
4695,183,16165,121,293,223,70,4,1,3,1
1732,183,6486,121,293,223,70,4,0,3,1
1374,402,1310,44,201,175,25,2,0,1,0
11362,1694,0,0,66,66,0,1,0,1,0
9294,1358,0,0,114,114,0,1,0,1,0
2970,1694,0,0,62,62,0,1,0,1,0
884,1109,0,0,145,145,0,1,0,1,0
10664,1581,0,0,69,69,0,1,0,1,0
8124,1954,0,0,129,129,0,1,0,1,0
2832,1694,0,0,62,62,0,1,0,1,0
9917,1543,0,0,92,92,0,1,0,1,0
606,2613,0,0,144,144,0,1,0,1,0
15855,1305,0,0,145,145,0,1,0,1,0
1718,3095,0,0,146,146,0,1,0,1,0
2059,183,8152,121,293,223,70,4,0,3,1
2001,183,7805,121,293,223,70,4,0,3,1
7341,2918,0,0,68,68,0,1,0,1,0
1346,3095,0,0,143,143,0,1,0,1,0
2229,1621,0,0,73,73,0,1,0,1,0
1388,3095,0,0,140,140,0,1,0,1,0
1775,183,6701,121,293,223,70,4,0,3,1
10650,1543,0,0,65,65,0,1,0,1,0
1960,183,7581,121,293,223,70,4,0,3,1
7889,2257,0,0,111,111,0,1,0,1,0
18330,2991,0,0,145,145,0,1,0,1,0
8327,1664,0,0,146,146,0,1,0,1,0
2742,183,9792,121,293,223,70,4,0,3,1
1106,183,4404,121,293,223,70,4,0,3,1
9815,1400,0,0,98,98,0,1,0,1,0
16933,2039,0,0,145,145,0,1,0,1,0
2344,183,8258,121,293,223,70,4,1,3,1
730,1176,0,0,155,155,0,1,0,1,0
3992,183,13496,121,293,223,70,4,0,3,1
838,621,1999,67,232,193,39,2,0,2,0
1978,183,7801,121,293,223,70,4,0,3,1
2286,247,0,0,78,78,0,1,0,1,0
2406,1396,0,0,108,108,0,1,0,1,0
1205,183,4788,121,293,223,70,4,0,3,1
2962,1694,0,0,62,62,0,1,0,1,0
1699,884,0,0,119,119,0,1,0,1,0
12985,737,0,0,113,113,0,1,0,1,0
9570,1543,0,0,100,100,0,1,0,1,0
974,183,3888,121,293,223,70,4,0,3,1
21589,1172,7762,33,125,105,19,1,0,1,0
2691,1694,0,0,62,62,0,1,0,1,0
4815,183,16314,121,293,223,70,4,1,3,1
1784,183,6271,121,293,223,70,4,1,3,1
1133,2960,0,0,143,143,0,1,0,1,0
488,2771,0,0,141,141,0,1,0,1,0
2189,1176,0,0,144,144,0,1,0,1,0
2012,3095,0,0,154,154,0,1,0,1,0
3229,1352,0,0,84,84,0,1,0,1,0
1770,183,6673,121,293,223,70,4,0,3,1
9295,1694,0,0,120,120,0,1,0,1,0
1262,724,0,0,146,146,0,1,0,1,0
2621,1694,0,0,62,62,0,1,0,1,0
1393,3095,0,0,140,140,0,1,0,1,0
2136,570,0,0,62,62,0,1,0,1,0
1045,3095,0,0,143,143,0,1,0,1,0
2726,2064,0,0,87,87,0,1,0,1,0
21,1003,0,0,157,157,0,1,0,1,0
2146,3095,0,0,157,157,0,1,0,1,0
8263,1300,0,0,154,154,0,1,0,1,0
11119,1606,0,0,62,62,0,1,0,1,0
13962,361,0,0,138,138,0,1,0,1,0
801,1176,0,0,156,156,0,1,0,1,0
1785,3095,0,0,150,150,0,1,0,1,0
1701,498,0,0,143,143,0,1,0,1,0
2684,499,0,0,98,98,0,1,0,1,0
964,183,3713,121,293,223,70,4,1,3,1
63,1025,0,0,155,155,0,1,0,1,0
818,3095,0,0,139,139,0,1,0,1,0
1603,671,0,0,146,146,0,1,0,1,0
2504,183,9085,121,293,223,70,4,0,3,1
414,2661,0,0,142,142,0,1,0,1,0
1886,885,0,0,72,72,0,1,0,1,0
3020,1694,0,0,62,62,0,1,0,1,0
8291,1387,0,0,150,150,0,1,0,1,0
2900,1642,0,0,70,70,0,1,0,1,0
1798,183,6772,121,293,223,70,4,0,3,1
988,183,3834,121,293,223,70,4,1,3,1
8258,1271,0,0,154,154,0,1,0,1,0
7389,2900,0,0,71,71,0,1,0,1,0
8236,1188,0,0,156,156,0,1,0,1,0
7153,2834,0,0,68,68,0,1,0,1,0
8994,2209,0,0,67,67,0,1,0,1,0
2194,1832,0,0,69,69,0,1,0,1,0
20416,183,27822,121,293,223,70,4,0,3,1
684,3062,0,0,139,139,0,1,0,1,0
7964,1074,0,0,155,155,0,1,0,1,0
2211,1325,0,0,119,119,0,1,0,1,0
11956,1118,0,0,89,89,0,1,0,1,0
10495,1562,0,0,72,72,0,1,0,1,0
956,183,3698,121,293,223,70,4,1,3,1
11822,1549,0,0,70,70,0,1,0,1,0
3028,1686,0,0,63,63,0,1,0,1,0
2207,1322,0,0,120,120,0,1,0,1,0
917,3095,0,0,139,139,0,1,0,1,0
2590,1337,0,0,62,62,0,1,0,1,0
2152,731,0,0,112,112,0,1,0,1,0
317,1526,0,0,143,143,0,1,0,1,0
17748,2594,0,0,145,145,0,1,0,1,0
2039,183,8011,121,293,223,70,4,0,3,1
1839,1176,0,0,142,142,0,1,0,1,0
9258,1624,0,0,112,112,0,1,0,1,0
2198,183,8920,121,293,223,70,4,0,3,1
8677,1238,0,0,140,140,0,1,0,1,0
1964,1223,0,0,135,135,0,1,0,1,0
1786,183,6712,121,293,223,70,4,0,3,1
4076,183,13744,121,293,223,70,4,0,3,1
1060,183,4226,121,293,223,70,4,0,3,1
1975,854,0,0,62,62,0,1,0,1,0
1545,183,5564,121,293,223,70,4,0,3,1
1519,918,0,0,142,142,0,1,0,1,0
3073,1659,0,0,64,64,0,1,0,1,0
2488,1694,0,0,62,62,0,1,0,1,0
1632,183,5984,121,293,223,70,4,0,3,1
1406,3095,0,0,140,140,0,1,0,1,0
1973,845,0,0,63,63,0,1,0,1,0
2977,1694,0,0,62,62,0,1,0,1,0
3700,683,0,0,146,146,0,1,0,1,0
2920,183,10318,121,293,223,70,4,0,3,1
111,1024,0,0,157,157,0,1,0,1,0
3005,1694,0,0,62,62,0,1,0,1,0
389,2624,0,0,142,142,0,1,0,1,0
9703,1384,0,0,102,102,0,1,0,1,0
8474,1543,0,0,141,141,0,1,0,1,0
1340,3095,0,0,143,143,0,1,0,1,0
3808,183,12950,121,293,223,70,4,0,3,1
419,2669,0,0,142,142,0,1,0,1,0
2935,1694,0,0,62,62,0,1,0,1,0
3630,183,13029,121,293,223,70,4,0,3,1
4940,183,16470,121,293,223,70,4,1,3,1
742,1973,0,0,149,149,0,1,0,1,0
894,3095,0,0,140,140,0,1,0,1,0
4687,183,15558,121,293,223,70,4,0,3,1
9127,183,19379,121,293,223,70,4,0,3,1
2022,1011,0,0,62,62,0,1,0,1,0
692,562,2211,74,235,192,43,2,0,2,0
1299,3095,0,0,142,142,0,1,0,1,0
1237,1176,0,0,144,144,0,1,0,1,0
9812,1447,0,0,94,94,0,1,0,1,0
1750,754,0,0,146,146,0,1,0,1,0
3062,183,11388,121,293,223,70,4,0,3,1
1394,3095,0,0,140,140,0,1,0,1,0
1941,351,0,0,119,119,0,1,0,1,0
10295,1547,0,0,74,74,0,1,0,1,0
10529,1564,0,0,70,70,0,1,0,1,0
858,470,2544,85,253,203,49,3,0,2,0
1634,520,82,2,151,149,1,1,0,1,0
2553,183,9521,121,293,223,70,4,0,3,1
926,1176,0,0,140,140,0,1,0,1,0
9858,1543,0,0,90,90,0,1,0,1,0
16286,2675,0,0,125,125,0,1,0,1,0
702,2676,0,0,144,144,0,1,0,1,0
2319,1694,0,0,62,62,0,1,0,1,0
9624,1373,0,0,105,105,0,1,0,1,0
1389,183,4772,121,293,223,70,4,1,3,1
10431,1519,0,0,73,73,0,1,0,1,0
1453,1161,0,0,135,135,0,1,0,1,0
734,1168,0,0,157,157,0,1,0,1,0
1329,3095,0,0,139,139,0,1,0,1,0
1559,183,5637,121,293,223,70,4,0,3,1
2376,1613,0,0,75,75,0,1,0,1,0
2674,469,0,0,96,96,0,1,0,1,0
1343,3095,0,0,142,142,0,1,0,1,0
1978,183,7682,121,293,223,70,4,0,3,1
4666,351,0,0,146,146,0,1,0,1,0
2563,1389,0,0,62,62,0,1,0,1,0
1133,2913,0,0,140,140,0,1,0,1,0
2512,2,0,0,62,62,0,1,0,1,0
7629,2540,0,0,90,90,0,1,0,1,0
927,1058,0,0,155,155,0,1,0,1,0
7806,2287,0,0,104,104,0,1,0,1,0
1429,183,4968,121,293,223,70,4,1,3,1
95,1565,0,0,151,151,0,1,0,1,0
21578,1521,0,0,63,63,0,1,0,1,0
11275,1243,0,0,88,88,0,1,0,1,0
4392,183,14682,121,293,223,70,4,0,3,1
1934,1158,0,0,138,138,0,1,0,1,0
2116,600,0,0,62,62,0,1,0,1,0
491,1751,0,0,151,151,0,1,0,1,0
8617,1543,0,0,136,136,0,1,0,1,0
1354,615,0,0,149,149,0,1,0,1,0
2505,1176,0,0,145,145,0,1,0,1,0
2100,1585,0,0,78,78,0,1,0,1,0
1441,183,5036,121,293,223,70,4,0,3,1
9504,1606,0,0,103,103,0,1,0,1,0
9269,1543,0,0,111,111,0,1,0,1,0
2195,1055,0,0,62,62,0,1,0,1,0
1259,183,4286,121,293,223,70,4,1,3,1
2566,1459,0,0,100,100,0,1,0,1,0
10509,1543,0,0,68,68,0,1,0,1,0
3649,280,0,0,120,120,0,1,0,1,0
214,1048,0,0,157,157,0,1,0,1,0
2484,1253,0,0,62,62,0,1,0,1,0
1446,319,2656,73,235,193,42,2,0,2,0
3034,1654,0,0,68,68,0,1,0,1,0
324,1073,0,0,157,157,0,1,0,1,0
4527,183,15083,121,293,223,70,4,0,3,1
20077,2325,0,0,103,103,0,1,0,1,0
10695,1585,0,0,69,69,0,1,0,1,0
1482,1026,0,0,141,141,0,1,0,1,0
1950,3095,0,0,153,153,0,1,0,1,0
2907,1176,0,0,147,147,0,1,0,1,0
1576,183,5703,121,293,223,70,4,0,3,1
645,1147,0,0,157,157,0,1,0,1,0
9732,1389,0,0,101,101,0,1,0,1,0
12826,1950,0,0,83,83,0,1,0,1,0
906,183,3601,121,293,223,70,4,1,3,1
6224,1188,0,0,117,117,0,1,0,1,0
9726,1590,0,0,95,95,0,1,0,1,0
8280,1338,0,0,152,152,0,1,0,1,0
1554,3095,0,0,142,142,0,1,0,1,0
6373,1452,0,0,109,109,0,1,0,1,0
2307,183,8820,121,293,223,70,4,0,3,1
1925,183,7541,121,293,223,70,4,0,3,1
8316,1627,0,0,147,147,0,1,0,1,0
2038,291,0,0,109,109,0,1,0,1,0
8110,1432,0,0,144,144,0,1,0,1,0
318,2424,0,0,144,144,0,1,0,1,0
13061,657,0,0,121,121,0,1,0,1,0
2122,1598,0,0,76,76,0,1,0,1,0
1949,954,0,0,89,89,0,1,0,1,0
1775,183,6698,121,293,223,70,4,0,3,1
2373,153,0,0,72,72,0,1,0,1,0
3654,281,0,0,120,120,0,1,0,1,0
8262,1261,0,0,154,154,0,1,0,1,0
2016,1300,0,0,123,123,0,1,0,1,0
4527,183,15957,121,293,223,70,4,1,3,1
991,2866,0,0,143,143,0,1,0,1,0
2275,1799,0,0,69,69,0,1,0,1,0
2247,2968,0,0,150,150,0,1,0,1,0
1537,863,0,0,143,143,0,1,0,1,0
1057,183,4023,121,293,223,70,4,1,3,1
2997,1694,0,0,62,62,0,1,0,1,0
11500,1684,0,0,62,62,0,1,0,1,0
7629,2591,0,0,90,90,0,1,0,1,0
1839,719,0,0,95,95,0,1,0,1,0
3011,1560,0,0,84,84,0,1,0,1,0
2806,854,0,0,124,124,0,1,0,1,0
1797,677,0,0,107,107,0,1,0,1,0
7881,1874,0,0,121,121,0,1,0,1,0
275,1832,0,0,144,144,0,1,0,1,0
8267,1284,0,0,153,153,0,1,0,1,0
9358,1543,0,0,108,108,0,1,0,1,0
181,1040,0,0,157,157,0,1,0,1,0
3371,1205,0,0,93,93,0,1,0,1,0
7552,2510,0,0,89,89,0,1,0,1,0
3620,183,12048,121,293,223,70,4,1,3,1
7375,2853,0,0,71,71,0,1,0,1,0
1620,183,5923,121,293,223,70,4,0,3,1
2602,1430,0,0,105,105,0,1,0,1,0
1522,1232,0,0,130,130,0,1,0,1,0
8600,1237,0,0,142,142,0,1,0,1,0
1225,3095,0,0,142,142,0,1,0,1,0
801,915,937,31,192,174,18,1,0,1,0
1781,183,6727,121,293,223,70,4,0,3,1
1396,183,4806,121,293,223,70,4,1,3,1
1848,909,0,0,77,77,0,1,0,1,0
2201,183,8518,121,293,223,70,4,0,3,1
8289,1380,0,0,150,150,0,1,0,1,0
9522,1951,0,0,69,69,0,1,0,1,0
4996,318,0,0,146,146,0,1,0,1,0
8327,1573,0,0,146,146,0,1,0,1,0
10972,1667,0,0,76,76,0,1,0,1,0
20490,2126,0,0,93,93,0,1,0,1,0
8804,1543,0,0,128,128,0,1,0,1,0
2072,1146,0,0,62,62,0,1,0,1,0
683,1156,0,0,157,157,0,1,0,1,0
553,1621,0,0,152,152,0,1,0,1,0
893,2802,0,0,143,143,0,1,0,1,0
1405,3095,0,0,148,148,0,1,0,1,0
10681,1543,0,0,64,64,0,1,0,1,0
1793,672,0,0,108,108,0,1,0,1,0
11004,1543,0,0,62,62,0,1,0,1,0
1341,619,0,0,149,149,0,1,0,1,0
8568,1232,0,0,143,143,0,1,0,1,0
697,1176,0,0,154,154,0,1,0,1,0
1134,3095,0,0,141,141,0,1,0,1,0
9999,1569,0,0,85,85,0,1,0,1,0
11435,1688,0,0,64,64,0,1,0,1,0
1882,183,7234,121,293,223,70,4,0,3,1
774,3095,0,0,139,139,0,1,0,1,0
1890,183,7359,121,293,223,70,4,0,3,1
1740,183,6488,121,293,223,70,4,0,3,1
910,902,0,0,145,145,0,1,0,1,0
15871,522,0,0,127,127,0,1,0,1,0
1555,183,5579,121,293,223,70,4,0,3,1
21648,1369,3630,15,91,82,8,1,0,1,0
560,1069,0,0,150,150,0,1,0,1,0
2669,456,0,0,95,95,0,1,0,1,0
11770,1187,0,0,84,84,0,1,0,1,0
2937,1264,0,0,133,133,0,1,0,1,0
1463,667,0,0,149,149,0,1,0,1,0
11765,1578,0,0,68,68,0,1,0,1,0
1276,3054,0,0,143,143,0,1,0,1,0
1413,3095,0,0,139,139,0,1,0,1,0
6251,451,0,0,148,148,0,1,0,1,0
7557,2500,0,0,89,89,0,1,0,1,0
3288,183,11614,121,293,223,70,4,0,3,1
1959,183,7587,121,293,223,70,4,0,3,1
8947,1276,0,0,130,130,0,1,0,1,0
1376,183,4705,121,293,223,70,4,1,3,1
1686,3095,0,0,149,149,0,1,0,1,0
8902,1543,0,0,125,125,0,1,0,1,0
1268,3095,0,0,146,146,0,1,0,1,0
4900,328,0,0,146,146,0,1,0,1,0
2041,3095,0,0,154,154,0,1,0,1,0
1161,3095,0,0,139,139,0,1,0,1,0
1624,183,6420,121,293,223,70,4,0,3,1
8191,1275,0,0,151,151,0,1,0,1,0
9583,1694,0,0,113,113,0,1,0,1,0
549,2861,0,0,140,140,0,1,0,1,0
1055,183,4171,121,293,223,70,4,0,3,1
3703,183,12314,121,293,223,70,4,1,3,1
215,2266,0,0,144,144,0,1,0,1,0
1371,183,4682,121,293,223,70,4,1,3,1
6133,408,0,0,147,147,0,1,0,1,0
862,3095,0,0,141,141,0,1,0,1,0
2075,183,8210,121,293,223,70,4,0,3,1
951,183,3690,121,293,223,70,4,1,3,1
11471,1684,0,0,62,62,0,1,0,1,0
1488,183,6057,121,293,223,70,4,0,3,1
12558,1163,0,0,92,92,0,1,0,1,0
10013,1568,0,0,84,84,0,1,0,1,0
14214,183,23292,121,293,223,70,4,0,3,1
1330,1176,0,0,139,139,0,1,0,1,0
32,1104,0,0,156,156,0,1,0,1,0
1407,183,4856,121,293,223,70,4,0,3,1
1478,3095,0,0,149,149,0,1,0,1,0
2351,1176,0,0,145,145,0,1,0,1,0
7288,3027,0,0,63,63,0,1,0,1,0
2020,3095,0,0,156,156,0,1,0,1,0
2915,1195,0,0,144,144,0,1,0,1,0
7646,1208,0,0,146,146,0,1,0,1,0
9806,1446,0,0,94,94,0,1,0,1,0
1881,183,7226,121,293,223,70,4,0,3,1
407,1097,282,9,154,149,5,1,0,1,0
332,2539,0,0,143,143,0,1,0,1,0
1782,183,6732,121,293,223,70,4,0,3,1
404,2645,0,0,142,142,0,1,0,1,0
1207,183,4184,121,293,223,70,4,1,3,1
1578,744,0,0,145,145,0,1,0,1,0
1413,419,1128,38,193,171,22,1,0,1,0
8273,1310,0,0,152,152,0,1,0,1,0
10452,1492,0,0,75,75,0,1,0,1,0
7981,2037,0,0,118,118,0,1,0,1,0
8251,1214,0,0,155,155,0,1,0,1,0
2047,183,8055,121,293,223,70,4,0,3,1
8626,1230,0,0,142,142,0,1,0,1,0
10418,1566,0,0,75,75,0,1,0,1,0
2500,183,9905,121,293,223,70,4,0,3,1
1216,1176,0,0,151,151,0,1,0,1,0
2192,183,8899,121,293,223,70,4,0,3,1
837,632,1958,66,231,193,38,2,0,2,0
1821,183,7447,121,293,223,70,4,0,3,1
1968,183,7760,121,293,223,70,4,0,3,1
10640,1553,0,0,67,67,0,1,0,1,0
238,2276,0,0,145,145,0,1,0,1,0
8243,1181,0,0,156,156,0,1,0,1,0
9243,2088,0,0,68,68,0,1,0,1,0
2984,1694,0,0,62,62,0,1,0,1,0
21121,1822,0,0,76,76,0,1,0,1,0
246,1055,0,0,157,157,0,1,0,1,0
12813,738,0,0,117,117,0,1,0,1,0
7969,2053,0,0,117,117,0,1,0,1,0
3032,183,11223,121,293,223,70,4,0,3,1
1178,183,4128,121,293,223,70,4,1,3,1
10799,1543,0,0,62,62,0,1,0,1,0
2388,991,0,0,100,100,0,1,0,1,0
1712,183,6384,121,293,223,70,4,0,3,1
2823,904,0,0,128,128,0,1,0,1,0
2531,1694,0,0,62,62,0,1,0,1,0
8993,1306,0,0,126,126,0,1,0,1,0
3484,183,12669,121,293,223,70,4,0,3,1
19570,183,27204,121,293,223,70,4,0,3,1
1768,183,6621,121,293,223,70,4,0,3,1
14833,608,0,0,145,145,0,1,0,1,0
495,1176,0,0,142,142,0,1,0,1,0
1086,183,4100,121,293,223,70,4,1,3,1
656,1176,0,0,153,153,0,1,0,1,0
2513,1694,0,0,62,62,0,1,0,1,0
2277,1736,0,0,64,64,0,1,0,1,0
11284,1640,0,0,62,62,0,1,0,1,0
1668,1176,0,0,140,140,0,1,0,1,0
2204,468,0,0,62,62,0,1,0,1,0
2276,1753,0,0,66,66,0,1,0,1,0
11742,1591,0,0,67,67,0,1,0,1,0
200,1093,0,0,149,149,0,1,0,1,0
10133,1559,0,0,80,80,0,1,0,1,0
11213,1625,0,0,62,62,0,1,0,1,0
558,814,1302,44,197,172,25,2,0,1,0
1400,3095,0,0,140,140,0,1,0,1,0
1680,557,0,0,140,140,0,1,0,1,0
1817,183,6908,121,293,223,70,4,0,3,1
2240,1756,0,0,65,65,0,1,0,1,0
8977,1654,0,0,123,123,0,1,0,1,0
2312,1352,0,0,115,115,0,1,0,1,0
8983,1654,0,0,123,123,0,1,0,1,0
1611,647,0,0,146,146,0,1,0,1,0
2177,1844,0,0,70,70,0,1,0,1,0
2061,3095,0,0,156,156,0,1,0,1,0
10214,1614,0,0,71,71,0,1,0,1,0
5250,396,0,0,146,146,0,1,0,1,0
8790,1659,0,0,129,129,0,1,0,1,0
1239,830,0,0,152,152,0,1,0,1,0
8594,1677,0,0,136,136,0,1,0,1,0
1740,2583,0,0,110,110,0,1,0,1,0
1412,183,4881,121,293,223,70,4,0,3,1
1669,183,6168,121,293,223,70,4,0,3,1
2787,183,9832,121,293,223,70,4,1,3,1
1430,183,4972,121,293,223,70,4,1,3,1
21073,1845,0,0,78,78,0,1,0,1,0
2735,1694,0,0,62,62,0,1,0,1,0
1550,826,0,0,143,143,0,1,0,1,0
3281,1298,0,0,87,87,0,1,0,1,0
10511,1543,0,0,68,68,0,1,0,1,0
1703,1002,0,0,99,99,0,1,0,1,0
2539,1694,0,0,62,62,0,1,0,1,0
2712,1694,0,0,62,62,0,1,0,1,0
252,2420,0,0,144,144,0,1,0,1,0
1947,183,7522,121,293,223,70,4,0,3,1
10881,1694,0,0,79,79,0,1,0,1,0
1390,1176,0,0,140,140,0,1,0,1,0
950,3095,0,0,142,142,0,1,0,1,0
8298,1418,0,0,149,149,0,1,0,1,0
1125,914,0,0,153,153,0,1,0,1,0
2195,183,8941,121,293,223,70,4,0,3,1
18439,3066,0,0,145,145,0,1,0,1,0
8266,1277,0,0,153,153,0,1,0,1,0
1994,938,0,0,62,62,0,1,0,1,0
2340,262,0,0,62,62,0,1,0,1,0
1559,183,5636,121,293,223,70,4,0,3,1
8524,1679,0,0,138,138,0,1,0,1,0
1790,183,7066,121,293,223,70,4,0,3,1
10373,1543,0,0,71,71,0,1,0,1,0
1701,1176,0,0,141,141,0,1,0,1,0
2401,1593,0,0,78,78,0,1,0,1,0
7702,1351,0,0,146,146,0,1,0,1,0
2186,201,0,0,94,94,0,1,0,1,0
2796,827,0,0,122,122,0,1,0,1,0
2909,1366,0,0,116,116,0,1,0,1,0
1594,3095,0,0,143,143,0,1,0,1,0
9297,1326,0,0,117,117,0,1,0,1,0
1343,3095,0,0,142,142,0,1,0,1,0
101,1044,0,0,153,153,0,1,0,1,0
180,2180,0,0,146,146,0,1,0,1,0
1584,2729,0,0,121,121,0,1,0,1,0
1738,3095,0,0,146,146,0,1,0,1,0
1418,183,4914,121,293,223,70,4,1,3,1
757,3095,0,0,139,139,0,1,0,1,0
1182,183,4136,121,293,223,70,4,1,3,1
1759,183,6577,121,293,223,70,4,0,3,1
1840,183,6974,121,293,223,70,4,0,3,1
1002,3095,0,0,139,139,0,1,0,1,0
1114,2947,0,0,143,143,0,1,0,1,0
1840,731,0,0,109,109,0,1,0,1,0
20300,2218,0,0,98,98,0,1,0,1,0
2260,945,0,0,89,89,0,1,0,1,0
1408,3095,0,0,140,140,0,1,0,1,0
657,1176,0,0,153,153,0,1,0,1,0
8158,1784,0,0,132,132,0,1,0,1,0
1920,183,7368,121,293,223,70,4,0,3,1
2092,183,8209,121,293,223,70,4,0,3,1
2935,183,11052,121,293,223,70,4,0,3,1
1228,183,4226,121,293,223,70,4,1,3,1
1023,2887,0,0,143,143,0,1,0,1,0
10897,1561,0,0,62,62,0,1,0,1,0
2036,183,8004,121,293,223,70,4,0,3,1
1010,183,3804,121,293,223,70,4,1,3,1
1552,183,5569,121,293,223,70,4,0,3,1
409,1922,0,0,149,149,0,1,0,1,0
2295,443,0,0,92,92,0,1,0,1,0
4777,340,0,0,146,146,0,1,0,1,0
1348,750,0,0,151,151,0,1,0,1,0
3882,183,13305,121,293,223,70,4,0,3,1
121,973,0,0,156,156,0,1,0,1,0
1515,390,1761,48,206,178,28,2,0,1,0
720,1176,0,0,155,155,0,1,0,1,0
2671,1571,0,0,81,81,0,1,0,1,0
1842,722,0,0,94,94,0,1,0,1,0
19928,183,27466,121,293,223,70,4,0,3,1
16974,2806,0,0,131,131,0,1,0,1,0
559,1609,0,0,152,152,0,1,0,1,0
1091,1176,0,0,140,140,0,1,0,1,0
8327,1686,0,0,146,146,0,1,0,1,0
10413,1543,0,0,70,70,0,1,0,1,0
2233,183,9122,121,293,223,70,4,0,3,1
8918,1292,0,0,129,129,0,1,0,1,0
8863,1543,0,0,126,126,0,1,0,1,0
2364,92,0,0,76,76,0,1,0,1,0
12886,992,0,0,102,102,0,1,0,1,0
2203,183,7760,121,293,223,70,4,1,3,1
2023,183,7976,121,293,223,70,4,0,3,1
10756,1546,0,0,63,63,0,1,0,1,0
213,2329,0,0,145,145,0,1,0,1,0
8327,1656,0,0,146,146,0,1,0,1,0
2414,151,0,0,62,62,0,1,0,1,0
11465,1683,0,0,62,62,0,1,0,1,0
2948,1307,0,0,126,126,0,1,0,1,0
950,183,3729,121,293,223,70,4,1,3,1
1734,1176,0,0,141,141,0,1,0,1,0
1839,183,6971,121,293,223,70,4,0,3,1
2252,2777,0,0,137,137,0,1,0,1,0
1964,183,7617,121,293,223,70,4,0,3,1
8893,1651,0,0,125,125,0,1,0,1,0
1635,183,6462,121,293,223,70,4,0,3,1
1396,1176,0,0,139,139,0,1,0,1,0
8309,1568,0,0,144,144,0,1,0,1,0
277,1813,0,0,144,144,0,1,0,1,0
8113,2639,0,0,64,64,0,1,0,1,0
2156,539,0,0,62,62,0,1,0,1,0
2016,3095,0,0,156,156,0,1,0,1,0
1378,1176,0,0,149,149,0,1,0,1,0
8378,183,15439,121,293,223,70,4,0,3,1
900,183,3600,121,293,223,70,4,0,3,1
1966,183,7616,121,293,223,70,4,0,3,1
7352,2948,0,0,68,68,0,1,0,1,0
2100,1987,0,0,78,78,0,1,0,1,0
1713,3095,0,0,152,152,0,1,0,1,0
1306,629,0,0,149,149,0,1,0,1,0
2362,228,0,0,62,62,0,1,0,1,0
1879,183,7166,121,293,223,70,4,0,3,1
9973,1620,0,0,103,103,0,1,0,1,0
4578,183,15234,121,293,223,70,4,0,3,1
752,2682,0,0,142,142,0,1,0,1,0
2904,1522,0,0,90,90,0,1,0,1,0
479,1176,0,0,146,146,0,1,0,1,0
1158,777,0,0,146,146,0,1,0,1,0
13230,601,0,0,125,125,0,1,0,1,0
156,2006,0,0,148,148,0,1,0,1,0
4529,183,15959,121,293,223,70,4,1,3,1
2998,1657,0,0,62,62,0,1,0,1,0
2684,1363,0,0,116,116,0,1,0,1,0
2111,183,8262,121,293,223,70,4,0,3,1
3270,187,0,0,100,100,0,1,0,1,0
1609,560,0,0,148,148,0,1,0,1,0
8543,1227,0,0,144,144,0,1,0,1,0
1378,183,4715,121,293,223,70,4,1,3,1
2055,1100,0,0,62,62,0,1,0,1,0
74,1031,0,0,154,154,0,1,0,1,0
943,183,3712,121,293,223,70,4,1,3,1
764,1287,0,0,155,155,0,1,0,1,0
8258,1268,0,0,155,155,0,1,0,1,0
921,183,3652,121,293,223,70,4,1,3,1
2275,1801,0,0,69,69,0,1,0,1,0
2446,1694,0,0,62,62,0,1,0,1,0
1943,183,7633,121,293,223,70,4,0,3,1
1744,1367,0,0,110,110,0,1,0,1,0
2913,1256,0,0,134,134,0,1,0,1,0
7946,2720,0,0,64,64,0,1,0,1,0
1427,183,5803,121,293,223,70,4,0,3,1
8266,1323,0,0,153,153,0,1,0,1,0
2407,1430,0,0,103,103,0,1,0,1,0
559,1176,0,0,142,142,0,1,0,1,0
862,3095,0,0,139,139,0,1,0,1,0
8327,1638,0,0,146,146,0,1,0,1,0
1410,3095,0,0,139,139,0,1,0,1,0
125,1027,0,0,157,157,0,1,0,1,0
8999,1543,0,0,123,123,0,1,0,1,0
1817,697,0,0,101,101,0,1,0,1,0
8317,1706,0,0,145,145,0,1,0,1,0
1993,3095,0,0,154,154,0,1,0,1,0
10934,1616,0,0,67,67,0,1,0,1,0
1434,1173,0,0,138,138,0,1,0,1,0
9553,1403,0,0,104,104,0,1,0,1,0
7815,2275,0,0,105,105,0,1,0,1,0
513,1117,0,0,157,157,0,1,0,1,0
1562,183,5634,121,293,223,70,4,0,3,1
1964,183,7640,121,293,223,70,4,0,3,1
7281,3038,0,0,62,62,0,1,0,1,0
12132,183,19225,121,293,223,70,4,0,3,1
14893,1543,0,0,68,68,0,1,0,1,0
2654,1388,0,0,112,112,0,1,0,1,0
179,2171,0,0,146,146,0,1,0,1,0
1770,2534,0,0,108,108,0,1,0,1,0
2229,3095,0,0,158,158,0,1,0,1,0
7695,2234,0,0,103,103,0,1,0,1,0
2715,1435,0,0,62,62,0,1,0,1,0
2450,69,0,0,66,66,0,1,0,1,0
3178,164,0,0,96,96,0,1,0,1,0
5918,646,0,0,134,134,0,1,0,1,0
7983,2702,0,0,64,64,0,1,0,1,0
1858,1176,0,0,142,142,0,1,0,1,0
2749,1176,0,0,147,147,0,1,0,1,0
1705,3095,0,0,149,149,0,1,0,1,0
2248,2941,0,0,148,148,0,1,0,1,0
38,1013,0,0,156,156,0,1,0,1,0
1827,932,0,0,144,144,0,1,0,1,0
1196,3095,0,0,142,142,0,1,0,1,0
929,183,3647,121,293,223,70,4,1,3,1
10988,1579,0,0,62,62,0,1,0,1,0
541,1176,0,0,149,149,0,1,0,1,0
516,1063,0,0,150,150,0,1,0,1,0
1941,183,7528,121,293,223,70,4,0,3,1
1823,703,0,0,99,99,0,1,0,1,0
1894,672,0,0,106,106,0,1,0,1,0
9488,1607,0,0,103,103,0,1,0,1,0
1945,1009,0,0,102,102,0,1,0,1,0
2152,183,8824,121,293,223,70,4,0,3,1
1931,183,7583,121,293,223,70,4,0,3,1
8327,1577,0,0,146,146,0,1,0,1,0
1355,226,3831,105,274,213,61,3,0,2,0
2442,108,0,0,62,62,0,1,0,1,0
2762,1694,0,0,62,62,0,1,0,1,0
1183,314,2217,74,237,194,43,2,0,2,0
1947,984,0,0,96,96,0,1,0,1,0
8336,1540,0,0,145,145,0,1,0,1,0
16129,1491,0,0,145,145,0,1,0,1,0
745,1176,0,0,141,141,0,1,0,1,0
134,1843,0,0,149,149,0,1,0,1,0
13180,2081,0,0,97,97,0,1,0,1,0
16355,607,0,0,121,121,0,1,0,1,0
1893,774,0,0,80,80,0,1,0,1,0
15931,1356,0,0,145,145,0,1,0,1,0
10426,1488,0,0,76,76,0,1,0,1,0
1408,183,4860,121,293,223,70,4,0,3,1
1952,1205,0,0,138,138,0,1,0,1,0
8327,1657,0,0,146,146,0,1,0,1,0
8322,1665,0,0,146,146,0,1,0,1,0
2791,1132,0,0,136,136,0,1,0,1,0
12529,906,0,0,102,102,0,1,0,1,0
2114,3095,0,0,156,156,0,1,0,1,0
1731,183,6476,121,293,223,70,4,0,3,1
2227,1618,0,0,73,73,0,1,0,1,0
699,1176,0,0,154,154,0,1,0,1,0
2223,183,9086,121,293,223,70,4,0,3,1
2182,1551,0,0,84,84,0,1,0,1,0
9230,1626,0,0,113,113,0,1,0,1,0
4453,372,0,0,146,146,0,1,0,1,0
2155,3095,0,0,157,157,0,1,0,1,0
12069,1543,0,0,62,62,0,1,0,1,0
7498,1135,0,0,146,146,0,1,0,1,0
2428,53,0,0,70,70,0,1,0,1,0
1716,677,0,0,146,146,0,1,0,1,0
2520,1490,0,0,93,93,0,1,0,1,0
3889,705,0,0,126,126,0,1,0,1,0
4524,183,15953,121,293,223,70,4,1,3,1
1390,3095,0,0,140,140,0,1,0,1,0
381,1146,107,3,147,145,2,1,0,1,0
2752,1694,0,0,62,62,0,1,0,1,0
8690,1253,0,0,139,139,0,1,0,1,0
1548,481,490,16,167,158,9,1,0,1,0
699,1176,0,0,154,154,0,1,0,1,0
8926,1543,0,0,124,124,0,1,0,1,0
8770,1661,0,0,129,129,0,1,0,1,0
15219,871,0,0,145,145,0,1,0,1,0
1357,183,4611,121,293,223,70,4,1,3,1
2139,183,8602,121,293,223,70,4,0,3,1
910,2778,0,0,141,141,0,1,0,1,0
6321,557,0,0,146,146,0,1,0,1,0
2810,1694,0,0,62,62,0,1,0,1,0
18347,3003,0,0,145,145,0,1,0,1,0
286,1136,0,0,146,146,0,1,0,1,0
8327,1596,0,0,146,146,0,1,0,1,0
8024,1974,0,0,121,121,0,1,0,1,0
20471,2135,0,0,93,93,0,1,0,1,0
1521,183,5414,121,293,223,70,4,0,3,1
953,183,3796,121,293,223,70,4,0,3,1
9299,1588,0,0,120,120,0,1,0,1,0
3655,911,0,0,112,112,0,1,0,1,0
9286,1543,0,0,113,113,0,1,0,1,0
14177,316,0,0,141,141,0,1,0,1,0
9127,1329,0,0,121,121,0,1,0,1,0
4552,362,0,0,146,146,0,1,0,1,0
1475,183,5188,121,293,223,70,4,0,3,1
3026,183,11544,121,293,223,70,4,0,3,1
2003,961,0,0,62,62,0,1,0,1,0
1157,3095,0,0,139,139,0,1,0,1,0
2211,1176,0,0,144,144,0,1,0,1,0
8327,1627,0,0,146,146,0,1,0,1,0
2321,1169,0,0,62,62,0,1,0,1,0
8322,1666,0,0,146,146,0,1,0,1,0
1776,1176,0,0,141,141,0,1,0,1,0
1805,183,6849,121,293,223,70,4,0,3,1
10846,1694,0,0,80,80,0,1,0,1,0
9709,1607,0,0,109,109,0,1,0,1,0
798,2710,0,0,142,142,0,1,0,1,0
2276,1750,0,0,65,65,0,1,0,1,0
1412,3095,0,0,139,139,0,1,0,1,0
1595,3095,0,0,147,147,0,1,0,1,0
1566,183,5675,121,293,223,70,4,0,3,1
1617,183,5907,121,293,223,70,4,0,3,1
2911,1313,0,0,125,125,0,1,0,1,0
1922,1176,0,0,142,142,0,1,0,1,0
11043,1670,0,0,75,75,0,1,0,1,0
2149,738,0,0,112,112,0,1,0,1,0
17746,2946,0,0,137,137,0,1,0,1,0
2828,1176,0,0,147,147,0,1,0,1,0
3754,183,12941,121,293,223,70,4,0,3,1
2731,1604,0,0,76,76,0,1,0,1,0
1665,542,0,0,144,144,0,1,0,1,0
1474,183,5182,121,293,223,70,4,0,3,1
891,3095,0,0,140,140,0,1,0,1,0
1764,183,6603,121,293,223,70,4,0,3,1
20852,1394,0,0,71,71,0,1,0,1,0
4542,183,15976,121,293,223,70,4,1,3,1
1585,183,5748,121,293,223,70,4,0,3,1
17116,2164,0,0,145,145,0,1,0,1,0
2014,307,0,0,111,111,0,1,0,1,0
1963,853,0,0,62,62,0,1,0,1,0
10207,1516,0,0,78,78,0,1,0,1,0
3747,183,13416,121,293,223,70,4,0,3,1
2903,1694,0,0,62,62,0,1,0,1,0
8327,1664,0,0,146,146,0,1,0,1,0
1142,2965,0,0,143,143,0,1,0,1,0
2616,1542,0,0,85,85,0,1,0,1,0
1504,183,5352,121,293,223,70,4,0,3,1
21409,575,20251,86,226,176,49,3,0,2,0
2200,183,8971,121,293,223,70,4,0,3,1
11746,1589,0,0,68,68,0,1,0,1,0
8068,2661,0,0,64,64,0,1,0,1,0
9768,1586,0,0,93,93,0,1,0,1,0
7307,2984,0,0,65,65,0,1,0,1,0
1510,1224,0,0,131,131,0,1,0,1,0
2861,1660,0,0,62,62,0,1,0,1,0
20780,183,28080,121,293,223,70,4,0,3,1
378,1176,0,0,143,143,0,1,0,1,0
1067,3095,0,0,141,141,0,1,0,1,0
12514,1889,0,0,73,73,0,1,0,1,0
8719,1664,0,0,131,131,0,1,0,1,0
2183,183,8836,121,293,223,70,4,0,3,1
1280,358,1759,59,219,184,34,2,0,1,0
2437,84,0,0,67,67,0,1,0,1,0
21620,1543,0,0,62,62,0,1,0,1,0
18893,183,26671,121,293,223,70,4,0,3,1
2441,183,9336,121,293,223,70,4,0,3,1
1385,3095,0,0,147,147,0,1,0,1,0
3480,1183,0,0,95,95,0,1,0,1,0
10430,1694,0,0,91,91,0,1,0,1,0
20059,2334,0,0,104,104,0,1,0,1,0
911,1176,0,0,155,155,0,1,0,1,0
9556,1543,0,0,101,101,0,1,0,1,0
2199,183,9024,121,293,223,70,4,0,3,1
8284,1356,0,0,151,151,0,1,0,1,0
1858,183,7208,121,293,223,70,4,0,3,1
1657,183,6112,121,293,223,70,4,0,3,1
16251,2643,0,0,120,120,0,1,0,1,0
10620,1543,0,0,66,66,0,1,0,1,0
20548,1543,0,0,63,63,0,1,0,1,0
3209,183,11174,121,293,223,70,4,0,3,1
1191,3095,0,0,142,142,0,1,0,1,0
10340,1694,0,0,93,93,0,1,0,1,0
758,788,0,0,152,152,0,1,0,1,0
11534,1692,0,0,62,62,0,1,0,1,0
2621,1176,0,0,146,146,0,1,0,1,0
2338,265,0,0,62,62,0,1,0,1,0
1875,1176,0,0,142,142,0,1,0,1,0
2376,1613,0,0,75,75,0,1,0,1,0
973,183,3732,121,293,223,70,4,1,3,1
9816,1448,0,0,93,93,0,1,0,1,0
16993,2080,0,0,145,145,0,1,0,1,0
3329,183,12090,121,293,223,70,4,0,3,1
2989,1473,0,0,98,98,0,1,0,1,0
1083,814,0,0,145,145,0,1,0,1,0
880,3095,0,0,140,140,0,1,0,1,0
2164,183,8738,121,293,223,70,4,0,3,1
1284,3058,0,0,143,143,0,1,0,1,0
1346,682,0,0,146,146,0,1,0,1,0
1838,183,6964,121,293,223,70,4,0,3,1
19421,2641,0,0,120,120,0,1,0,1,0
1482,1176,0,0,139,139,0,1,0,1,0
6896,839,0,0,146,146,0,1,0,1,0
985,183,3827,121,293,223,70,4,1,3,1
510,2803,0,0,141,141,0,1,0,1,0
1460,1088,0,0,140,140,0,1,0,1,0
2483,62,0,0,66,66,0,1,0,1,0
1932,631,0,0,103,103,0,1,0,1,0
4134,769,0,0,147,147,0,1,0,1,0
919,897,0,0,145,145,0,1,0,1,0
1812,183,6960,121,293,223,70,4,0,3,1
1836,1176,0,0,144,144,0,1,0,1,0
6820,183,17891,121,293,223,70,4,0,3,1
1389,183,5644,121,293,223,70,4,0,3,1
10710,1428,0,0,78,78,0,1,0,1,0
496,1176,0,0,147,147,0,1,0,1,0
1164,1176,0,0,146,146,0,1,0,1,0
1476,183,5192,121,293,223,70,4,0,3,1
319,1513,0,0,143,143,0,1,0,1,0
7773,2083,0,0,110,110,0,1,0,1,0
1981,3095,0,0,154,154,0,1,0,1,0
13602,479,0,0,131,131,0,1,0,1,0
2213,183,9011,121,293,223,70,4,0,3,1
2166,3095,0,0,157,157,0,1,0,1,0
2177,1306,0,0,122,122,0,1,0,1,0
2332,1390,0,0,109,109,0,1,0,1,0
2254,183,9249,121,293,223,70,4,0,3,1
2463,1237,0,0,62,62,0,1,0,1,0
2197,1057,0,0,62,62,0,1,0,1,0
4918,183,16442,121,293,223,70,4,1,3,1
2088,183,8314,121,293,223,70,4,0,3,1
1923,861,0,0,66,66,0,1,0,1,0
9925,1617,0,0,104,104,0,1,0,1,0
1171,183,4115,121,293,223,70,4,1,3,1
15809,2555,0,0,113,113,0,1,0,1,0
950,183,3786,121,293,223,70,4,0,3,1
396,2475,0,0,144,144,0,1,0,1,0
1949,183,7567,121,293,223,70,4,0,3,1
8265,1274,0,0,154,154,0,1,0,1,0
7389,2900,0,0,71,71,0,1,0,1,0
627,1176,0,0,152,152,0,1,0,1,0
2655,183,10444,121,293,223,70,4,0,3,1
748,1171,0,0,157,157,0,1,0,1,0
3138,183,11399,121,293,223,70,4,0,3,1
1947,183,7520,121,293,223,70,4,0,3,1
690,2668,0,0,144,144,0,1,0,1,0
1013,183,3902,121,293,223,70,4,1,3,1
3020,1694,0,0,62,62,0,1,0,1,0
1428,1176,0,0,139,139,0,1,0,1,0
20798,1556,0,0,62,62,0,1,0,1,0
9938,1543,0,0,87,87,0,1,0,1,0
719,1164,0,0,157,157,0,1,0,1,0
2199,3095,0,0,158,158,0,1,0,1,0
1362,3095,0,0,141,141,0,1,0,1,0
10977,1340,0,0,83,83,0,1,0,1,0
14126,315,0,0,140,140,0,1,0,1,0
1934,183,7449,121,293,223,70,4,0,3,1
7613,2563,0,0,89,89,0,1,0,1,0
2426,1694,0,0,62,62,0,1,0,1,0
9476,1294,0,0,145,145,0,1,0,1,0
895,1176,0,0,153,153,0,1,0,1,0
1571,2747,0,0,122,122,0,1,0,1,0
2411,1694,0,0,62,62,0,1,0,1,0
3015,1694,0,0,62,62,0,1,0,1,0
17621,2930,0,0,137,137,0,1,0,1,0
9075,1295,0,0,126,126,0,1,0,1,0
715,2816,0,0,141,141,0,1,0,1,0
9971,1475,0,0,87,87,0,1,0,1,0
3693,183,13050,121,293,223,70,4,0,3,1
13493,674,0,0,120,120,0,1,0,1,0
3352,183,11838,121,293,223,70,4,1,3,1
1398,3095,0,0,140,140,0,1,0,1,0
4507,367,0,0,146,146,0,1,0,1,0
1391,1176,0,0,139,139,0,1,0,1,0
8327,1644,0,0,146,146,0,1,0,1,0
799,931,882,29,190,173,17,1,0,1,0
2329,114,0,0,80,80,0,1,0,1,0
1794,3095,0,0,151,151,0,1,0,1,0
427,1884,0,0,149,149,0,1,0,1,0
1546,606,0,0,149,149,0,1,0,1,0
2016,1220,0,0,135,135,0,1,0,1,0
8281,1343,0,0,151,151,0,1,0,1,0
2108,1439,0,0,101,101,0,1,0,1,0
3020,1683,0,0,63,63,0,1,0,1,0
8283,1427,0,0,151,151,0,1,0,1,0
2401,229,0,0,77,77,0,1,0,1,0
985,183,3931,121,293,223,70,4,0,3,1
10964,1574,0,0,62,62,0,1,0,1,0
19219,1108,0,0,89,89,0,1,0,1,0
11014,1585,0,0,62,62,0,1,0,1,0
8465,1683,0,0,140,140,0,1,0,1,0
19592,1174,0,0,85,85,0,1,0,1,0
2316,215,0,0,76,76,0,1,0,1,0
2515,183,8868,121,293,223,70,4,1,3,1
21348,1712,0,0,71,71,0,1,0,1,0
1518,183,5414,121,293,223,70,4,0,3,1
1538,477,537,18,169,159,10,1,0,1,0
1928,183,7410,121,293,223,70,4,0,3,1
1508,950,0,0,142,142,0,1,0,1,0
1630,1048,0,0,109,109,0,1,0,1,0
2013,183,7886,121,293,223,70,4,0,3,1
7737,2453,0,0,98,98,0,1,0,1,0
3969,183,13552,121,293,223,70,4,0,3,1
1685,183,6222,121,293,223,70,4,0,3,1
8299,1525,0,0,149,149,0,1,0,1,0
8278,1392,0,0,152,152,0,1,0,1,0
2100,183,8355,121,293,223,70,4,0,3,1
9681,1694,0,0,110,110,0,1,0,1,0
1369,3095,0,0,141,141,0,1,0,1,0
7572,2664,0,0,85,85,0,1,0,1,0
1915,183,7339,121,293,223,70,4,0,3,1
20249,2242,0,0,99,99,0,1,0,1,0
1227,183,4484,121,293,223,70,4,1,3,1
1875,756,0,0,85,85,0,1,0,1,0
18934,183,26739,121,293,223,70,4,0,3,1
10760,1543,0,0,63,63,0,1,0,1,0
4306,183,14250,121,293,223,70,4,1,3,1
1479,1205,0,0,134,134,0,1,0,1,0
1411,183,4877,121,293,223,70,4,0,3,1
10264,1576,0,0,80,80,0,1,0,1,0
1365,183,4656,121,293,223,70,4,0,3,1
8192,1867,0,0,135,135,0,1,0,1,0
762,1186,0,0,156,156,0,1,0,1,0
15641,2520,0,0,114,114,0,1,0,1,0
2912,1694,0,0,62,62,0,1,0,1,0
2196,183,8908,121,293,223,70,4,0,3,1
1744,183,6508,121,293,223,70,4,0,3,1
4639,600,0,0,146,146,0,1,0,1,0
1644,183,6043,121,293,223,70,4,0,3,1
7807,1287,0,0,146,146,0,1,0,1,0
18130,2855,0,0,145,145,0,1,0,1,0
2640,183,9310,121,293,223,70,4,1,3,1
4060,493,0,0,140,140,0,1,0,1,0
1071,263,2743,92,259,205,53,3,0,2,0
1736,614,0,0,124,124,0,1,0,1,0
10975,1621,0,0,66,66,0,1,0,1,0
1619,623,0,0,146,146,0,1,0,1,0
2013,3095,0,0,153,153,0,1,0,1,0
2900,1694,0,0,62,62,0,1,0,1,0
1620,183,5955,121,293,223,70,4,0,3,1
880,298,3163,106,277,215,61,3,0,2,0
843,1176,0,0,154,154,0,1,0,1,0
1708,1176,0,0,141,141,0,1,0,1,0
1143,183,4061,121,293,223,70,4,1,3,1
9216,1344,0,0,117,117,0,1,0,1,0
2008,1289,0,0,125,125,0,1,0,1,0
1515,1121,0,0,126,126,0,1,0,1,0
10302,1543,0,0,74,74,0,1,0,1,0
1661,538,0,0,145,145,0,1,0,1,0
1264,641,0,0,150,150,0,1,0,1,0
1845,183,6996,121,293,223,70,4,0,3,1
9613,1543,0,0,102,102,0,1,0,1,0
1737,476,0,0,139,139,0,1,0,1,0
2248,183,9213,121,293,223,70,4,0,3,1
142,1905,0,0,148,148,0,1,0,1,0
1563,183,6045,121,293,223,70,4,0,3,1
436,1042,479,16,163,153,9,1,0,1,0
2234,1176,0,0,144,144,0,1,0,1,0
8303,1576,0,0,144,144,0,1,0,1,0
16873,1998,0,0,145,145,0,1,0,1,0
8327,1588,0,0,146,146,0,1,0,1,0
1612,644,0,0,146,146,0,1,0,1,0
1044,183,3870,121,293,223,70,4,1,3,1
271,2209,0,0,146,146,0,1,0,1,0
315,1543,0,0,143,143,0,1,0,1,0
2231,1569,0,0,62,62,0,1,0,1,0
2971,1400,0,0,110,110,0,1,0,1,0
2851,1694,0,0,62,62,0,1,0,1,0
8277,1388,0,0,152,152,0,1,0,1,0
9274,1543,0,0,113,113,0,1,0,1,0
1298,183,4361,121,293,223,70,4,1,3,1
1967,183,7621,121,293,223,70,4,0,3,1
8802,1658,0,0,128,128,0,1,0,1,0
8254,1247,0,0,155,155,0,1,0,1,0
2244,1321,0,0,120,120,0,1,0,1,0
2162,531,0,0,62,62,0,1,0,1,0
1884,886,0,0,72,72,0,1,0,1,0
525,1095,0,0,143,143,0,1,0,1,0
66,1355,0,0,153,153,0,1,0,1,0
2017,183,7905,121,293,223,70,4,0,3,1
340,2550,0,0,143,143,0,1,0,1,0
2819,1694,0,0,62,62,0,1,0,1,0
1082,1176,0,0,153,153,0,1,0,1,0
8097,1457,0,0,142,142,0,1,0,1,0
1751,971,0,0,92,92,0,1,0,1,0
6037,183,17073,121,293,223,70,4,0,3,1
1942,1051,0,0,113,113,0,1,0,1,0
1923,183,7386,121,293,223,70,4,0,3,1
8565,1554,0,0,139,139,0,1,0,1,0
10023,1430,0,0,91,91,0,1,0,1,0
1574,756,0,0,144,144,0,1,0,1,0
4718,183,16194,121,293,223,70,4,1,3,1
1990,869,0,0,62,62,0,1,0,1,0
1128,289,2475,83,248,199,48,3,0,2,0
2383,183,9036,121,293,223,70,4,0,3,1
6596,744,0,0,146,146,0,1,0,1,0
8662,1669,0,0,133,133,0,1,0,1,0
1756,183,6602,121,293,223,70,4,0,3,1
20944,1543,0,0,62,62,0,1,0,1,0
1960,3095,0,0,153,153,0,1,0,1,0
1442,183,5036,121,293,223,70,4,1,3,1
436,2694,0,0,142,142,0,1,0,1,0
2900,1644,0,0,70,70,0,1,0,1,0
8312,1480,0,0,147,147,0,1,0,1,0
1550,183,5580,121,293,223,70,4,0,3,1
2735,1694,0,0,62,62,0,1,0,1,0
14389,183,21500,121,293,223,70,4,0,3,1
9387,1543,0,0,107,107,0,1,0,1,0
1663,183,6136,121,293,223,70,4,0,3,1
2901,1694,0,0,62,62,0,1,0,1,0
13487,2084,0,0,90,90,0,1,0,1,0
1847,183,7007,121,293,223,70,4,0,3,1
13641,597,0,0,125,125,0,1,0,1,0
2379,1694,0,0,62,62,0,1,0,1,0
2263,507,0,0,96,96,0,1,0,1,0
2438,183,9743,121,293,223,70,4,0,3,1
339,1162,0,0,144,144,0,1,0,1,0
2012,1176,0,0,143,143,0,1,0,1,0
1545,183,5537,121,293,223,70,4,0,3,1
1420,3095,0,0,139,139,0,1,0,1,0
1469,1062,0,0,140,140,0,1,0,1,0
10159,1508,0,0,80,80,0,1,0,1,0
1351,183,4585,121,293,223,70,4,1,3,1
16307,1613,0,0,145,145,0,1,0,1,0
1852,991,0,0,144,144,0,1,0,1,0
944,183,3715,121,293,223,70,4,1,3,1
1796,779,0,0,113,113,0,1,0,1,0
1598,3095,0,0,147,147,0,1,0,1,0
1567,571,0,0,147,147,0,1,0,1,0
1562,183,5633,121,293,223,70,4,0,3,1
10241,1461,0,0,83,83,0,1,0,1,0
1758,1176,0,0,145,145,0,1,0,1,0
718,1176,0,0,141,141,0,1,0,1,0
1870,395,0,0,126,126,0,1,0,1,0
1682,183,6207,121,293,223,70,4,0,3,1
10885,1558,0,0,62,62,0,1,0,1,0
1365,183,4655,121,293,223,70,4,0,3,1
2629,1408,0,0,109,109,0,1,0,1,0
1437,183,5056,121,293,223,70,4,1,3,1
3009,1552,0,0,85,85,0,1,0,1,0
1318,183,4421,121,293,223,70,4,0,3,1
856,3095,0,0,140,140,0,1,0,1,0
1817,183,6997,121,293,223,70,4,0,3,1
1734,183,6459,121,293,223,70,4,0,3,1
4782,183,16274,121,293,223,70,4,1,3,1
764,1176,0,0,156,156,0,1,0,1,0
10738,1532,0,0,64,64,0,1,0,1,0
9435,1626,0,0,108,108,0,1,0,1,0
1563,183,5683,121,293,223,70,4,0,3,1
2713,183,9570,121,293,223,70,4,1,3,1
12911,183,22340,121,293,223,70,4,0,3,1
21317,1727,0,0,71,71,0,1,0,1,0
2116,183,8449,121,293,223,70,4,0,3,1
1915,183,7340,121,293,223,70,4,0,3,1
345,1165,0,0,143,143,0,1,0,1,0
1391,604,0,0,149,149,0,1,0,1,0
2625,1411,0,0,108,108,0,1,0,1,0
744,1928,0,0,149,149,0,1,0,1,0
9460,1596,0,0,116,116,0,1,0,1,0
4150,402,0,0,146,146,0,1,0,1,0
553,1176,0,0,149,149,0,1,0,1,0
1832,183,6312,121,293,223,70,4,1,3,1
2996,1694,0,0,62,62,0,1,0,1,0
541,1176,0,0,149,149,0,1,0,1,0
2821,1142,0,0,139,139,0,1,0,1,0
3245,969,0,0,147,147,0,1,0,1,0
10479,1543,0,0,69,69,0,1,0,1,0
9860,1456,0,0,92,92,0,1,0,1,0
913,183,3615,121,293,223,70,4,1,3,1
2342,260,0,0,62,62,0,1,0,1,0
2937,1261,0,0,133,133,0,1,0,1,0
3777,183,13349,121,293,223,70,4,1,3,1
1578,3095,0,0,147,147,0,1,0,1,0
1404,183,4849,121,293,223,70,4,0,3,1
1120,3095,0,0,139,139,0,1,0,1,0
1891,183,7223,121,293,223,70,4,0,3,1
1066,183,4296,121,293,223,70,4,0,3,1
1799,678,0,0,106,106,0,1,0,1,0
4752,183,16235,121,293,223,70,4,1,3,1
374,2602,0,0,142,142,0,1,0,1,0
3008,1694,0,0,62,62,0,1,0,1,0
13085,888,0,0,108,108,0,1,0,1,0
2979,1694,0,0,62,62,0,1,0,1,0
8960,1278,0,0,130,130,0,1,0,1,0
21368,436,23154,98,249,192,56,3,0,2,0
1715,183,6400,121,293,223,70,4,0,3,1
2166,525,0,0,62,62,0,1,0,1,0
1696,631,0,0,147,147,0,1,0,1,0
363,1193,0,0,143,143,0,1,0,1,0
7844,2314,0,0,107,107,0,1,0,1,0
3287,1052,0,0,147,147,0,1,0,1,0
4012,542,0,0,136,136,0,1,0,1,0
4931,183,16255,121,293,223,70,4,1,3,1
784,1163,0,0,156,156,0,1,0,1,0
10634,1553,0,0,67,67,0,1,0,1,0
11191,1648,0,0,64,64,0,1,0,1,0
2560,1176,0,0,146,146,0,1,0,1,0
7855,2217,0,0,108,108,0,1,0,1,0
2580,1477,0,0,95,95,0,1,0,1,0
2266,2182,0,0,95,95,0,1,0,1,0
2227,1560,0,0,62,62,0,1,0,1,0
2408,1176,0,0,145,145,0,1,0,1,0
1599,682,0,0,145,145,0,1,0,1,0
13511,1543,0,0,62,62,0,1,0,1,0
7589,2642,0,0,87,87,0,1,0,1,0
11158,1675,0,0,72,72,0,1,0,1,0
2840,1819,0,0,70,70,0,1,0,1,0
2235,183,9136,121,293,223,70,4,0,3,1
7747,2133,0,0,108,108,0,1,0,1,0
3818,183,13655,121,293,223,70,4,0,3,1
8636,1232,0,0,142,142,0,1,0,1,0
8300,1428,0,0,149,149,0,1,0,1,0
1087,183,3953,121,293,223,70,4,1,3,1
1165,183,4103,121,293,223,70,4,1,3,1
11136,1610,0,0,62,62,0,1,0,1,0
1946,998,0,0,100,100,0,1,0,1,0
1584,183,5749,121,293,223,70,4,0,3,1
8505,1543,0,0,139,139,0,1,0,1,0
1250,3095,0,0,142,142,0,1,0,1,0
9135,1543,0,0,116,116,0,1,0,1,0
918,183,3625,121,293,223,70,4,1,3,1
9352,1368,0,0,112,112,0,1,0,1,0
2862,1019,0,0,136,136,0,1,0,1,0
8345,1543,0,0,145,145,0,1,0,1,0
459,1176,0,0,146,146,0,1,0,1,0
1375,183,4703,121,293,223,70,4,1,3,1
2075,269,0,0,105,105,0,1,0,1,0
12390,1251,0,0,87,87,0,1,0,1,0
7943,2187,0,0,115,115,0,1,0,1,0
2915,1694,0,0,62,62,0,1,0,1,0
8297,1509,0,0,149,149,0,1,0,1,0
2513,1,0,0,62,62,0,1,0,1,0
734,2237,0,0,147,147,0,1,0,1,0
8279,1400,0,0,152,152,0,1,0,1,0
1284,3095,0,0,146,146,0,1,0,1,0
2242,1640,0,0,70,70,0,1,0,1,0
2736,650,0,0,109,109,0,1,0,1,0
18672,3003,0,0,140,140,0,1,0,1,0
2083,1175,0,0,62,62,0,1,0,1,0
2209,183,8994,121,293,223,70,4,0,3,1
845,2770,0,0,143,143,0,1,0,1,0
2228,183,9096,121,293,223,70,4,0,3,1
3890,183,13195,121,293,223,70,4,0,3,1
1369,3095,0,0,141,141,0,1,0,1,0
8327,1690,0,0,146,146,0,1,0,1,0
10051,1565,0,0,83,83,0,1,0,1,0
7763,2349,0,0,101,101,0,1,0,1,0
1507,3095,0,0,140,140,0,1,0,1,0
1557,1253,0,0,127,127,0,1,0,1,0
719,1176,0,0,155,155,0,1,0,1,0
2120,1457,0,0,99,99,0,1,0,1,0
7486,2775,0,0,78,78,0,1,0,1,0
916,183,3621,121,293,223,70,4,1,3,1
1017,183,4056,121,293,223,70,4,0,3,1
7838,2242,0,0,107,107,0,1,0,1,0
694,1176,0,0,154,154,0,1,0,1,0
7606,944,0,0,154,154,0,1,0,1,0
1439,183,5017,121,293,223,70,4,1,3,1
2911,1322,0,0,123,123,0,1,0,1,0
7858,2297,0,0,108,108,0,1,0,1,0
9760,183,19852,121,293,223,70,4,0,3,1
11404,1664,0,0,62,62,0,1,0,1,0
2046,183,8382,121,293,223,70,4,0,3,1
1408,3095,0,0,140,140,0,1,0,1,0
8522,1543,0,0,138,138,0,1,0,1,0
14346,2304,0,0,107,107,0,1,0,1,0
487,2769,0,0,141,141,0,1,0,1,0
16349,1641,0,0,145,145,0,1,0,1,0
2281,252,0,0,78,78,0,1,0,1,0
8327,1576,0,0,146,146,0,1,0,1,0
17961,183,25103,121,293,223,70,4,0,3,1
1384,1176,0,0,139,139,0,1,0,1,0
1365,1176,0,0,139,139,0,1,0,1,0
1972,1235,0,0,133,133,0,1,0,1,0
3571,1076,0,0,102,102,0,1,0,1,0
1852,990,0,0,144,144,0,1,0,1,0
1628,183,5941,121,293,223,70,4,0,3,1
1664,3095,0,0,151,151,0,1,0,1,0
9580,1600,0,0,100,100,0,1,0,1,0
2541,1480,0,0,97,97,0,1,0,1,0
1854,734,0,0,91,91,0,1,0,1,0
11397,1687,0,0,65,65,0,1,0,1,0
2484,46,0,0,62,62,0,1,0,1,0
2923,1205,0,0,143,143,0,1,0,1,0
2459,1458,0,0,98,98,0,1,0,1,0
9127,1543,0,0,116,116,0,1,0,1,0
8315,1494,0,0,147,147,0,1,0,1,0
898,183,3593,121,293,223,70,4,0,3,1
210,1047,0,0,157,157,0,1,0,1,0
21680,1539,0,0,62,62,0,1,0,1,0
1416,3095,0,0,144,144,0,1,0,1,0
748,2679,0,0,142,142,0,1,0,1,0
21572,1543,0,0,62,62,0,1,0,1,0
1946,999,0,0,100,100,0,1,0,1,0
2760,722,0,0,114,114,0,1,0,1,0
7806,1287,0,0,146,146,0,1,0,1,0
9552,1277,0,0,145,145,0,1,0,1,0
1529,183,5451,121,293,223,70,4,0,3,1
844,1176,0,0,154,154,0,1,0,1,0
1297,788,0,0,151,151,0,1,0,1,0
1428,3095,0,0,139,139,0,1,0,1,0
1631,3095,0,0,151,151,0,1,0,1,0
1818,183,6913,121,293,223,70,4,0,3,1
2386,259,0,0,79,79,0,1,0,1,0
5707,273,0,0,145,145,0,1,0,1,0
519,2816,0,0,141,141,0,1,0,1,0
18974,183,26124,121,293,223,70,4,0,3,1
18552,3060,0,0,143,143,0,1,0,1,0
1073,183,4275,121,293,223,70,4,0,3,1
1061,1176,0,0,149,149,0,1,0,1,0
1392,3095,0,0,139,139,0,1,0,1,0
10136,1504,0,0,80,80,0,1,0,1,0
8327,1602,0,0,146,146,0,1,0,1,0
2905,1493,0,0,95,95,0,1,0,1,0
1363,3095,0,0,141,141,0,1,0,1,0
159,2026,0,0,147,147,0,1,0,1,0
2105,1176,0,0,143,143,0,1,0,1,0
1017,183,3816,121,293,223,70,4,1,3,1
2715,1527,0,0,62,62,0,1,0,1,0
8750,1694,0,0,134,134,0,1,0,1,0
1770,183,6674,121,293,223,70,4,0,3,1
1613,183,5885,121,293,223,70,4,0,3,1
1485,1176,0,0,139,139,0,1,0,1,0
5801,440,0,0,140,140,0,1,0,1,0
1955,869,0,0,69,69,0,1,0,1,0
1444,183,5076,121,293,223,70,4,1,3,1
2344,975,0,0,96,96,0,1,0,1,0
1407,183,4862,121,293,223,70,4,1,3,1
3585,755,0,0,146,146,0,1,0,1,0
1409,183,5474,121,293,223,70,4,0,3,1
2947,1304,0,0,126,126,0,1,0,1,0
8317,1632,0,0,147,147,0,1,0,1,0
2431,183,9303,121,293,223,70,4,0,3,1
1809,183,6823,121,293,223,70,4,0,3,1
456,2723,0,0,141,141,0,1,0,1,0
3005,1538,0,0,87,87,0,1,0,1,0
8313,1486,0,0,147,147,0,1,0,1,0
5148,431,0,0,146,146,0,1,0,1,0
4096,456,0,0,142,142,0,1,0,1,0
8327,1681,0,0,146,146,0,1,0,1,0
18339,954,0,0,99,99,0,1,0,1,0
2253,183,9243,121,293,223,70,4,0,3,1
1616,3095,0,0,143,143,0,1,0,1,0
212,2286,0,0,144,144,0,1,0,1,0
2203,3095,0,0,158,158,0,1,0,1,0
1626,3095,0,0,143,143,0,1,0,1,0
2221,3095,0,0,158,158,0,1,0,1,0
1521,183,5430,121,293,223,70,4,0,3,1
9582,1617,0,0,103,103,0,1,0,1,0
2055,928,0,0,125,125,0,1,0,1,0
1746,975,0,0,92,92,0,1,0,1,0
2266,2165,0,0,94,94,0,1,0,1,0
2179,183,8826,121,293,223,70,4,0,3,1
175,2142,0,0,146,146,0,1,0,1,0
2266,2199,0,0,97,97,0,1,0,1,0
865,1176,0,0,154,154,0,1,0,1,0
6302,1327,0,0,113,113,0,1,0,1,0
4281,183,15189,121,293,223,70,4,0,3,1
19504,183,27127,121,293,223,70,4,0,3,1
14418,326,0,0,145,145,0,1,0,1,0
7859,1313,0,0,146,146,0,1,0,1,0
15449,183,24194,121,293,223,70,4,0,3,1
13542,183,20262,121,293,223,70,4,0,3,1
4708,183,16181,121,293,223,70,4,1,3,1
11541,1693,0,0,62,62,0,1,0,1,0
2903,1567,0,0,83,83,0,1,0,1,0
2709,571,0,0,103,103,0,1,0,1,0
9754,1392,0,0,101,101,0,1,0,1,0
1356,3095,0,0,142,142,0,1,0,1,0
21168,1799,0,0,75,75,0,1,0,1,0
16241,1543,0,0,66,66,0,1,0,1,0
939,183,3702,121,293,223,70,4,1,3,1
2310,125,0,0,82,82,0,1,0,1,0
97,1021,0,0,157,157,0,1,0,1,0
3930,349,0,0,134,134,0,1,0,1,0
619,1176,0,0,151,151,0,1,0,1,0
2855,183,10126,121,293,223,70,4,0,3,1
2418,1176,0,0,145,145,0,1,0,1,0
1592,183,5785,121,293,223,70,4,0,3,1
1038,977,0,0,154,154,0,1,0,1,0
1117,284,2526,85,250,200,49,3,0,2,0
1934,2206,0,0,91,91,0,1,0,1,0
2081,2019,0,0,79,79,0,1,0,1,0
1777,1176,0,0,141,141,0,1,0,1,0
18030,2787,0,0,145,145,0,1,0,1,0
7629,2362,0,0,96,96,0,1,0,1,0
1810,764,0,0,112,112,0,1,0,1,0
2176,3095,0,0,157,157,0,1,0,1,0
2144,3095,0,0,157,157,0,1,0,1,0
1960,183,7723,121,293,223,70,4,0,3,1
10539,1559,0,0,71,71,0,1,0,1,0
4490,183,15035,121,293,223,70,4,0,3,1
1438,3095,0,0,144,144,0,1,0,1,0
6366,1441,0,0,110,110,0,1,0,1,0
3100,183,11078,121,293,223,70,4,0,3,1
8726,1259,0,0,137,137,0,1,0,1,0
1669,183,6144,121,293,223,70,4,0,3,1
9332,1619,0,0,109,109,0,1,0,1,0
10444,1543,0,0,70,70,0,1,0,1,0
1519,183,5417,121,293,223,70,4,0,3,1
3641,278,0,0,119,119,0,1,0,1,0
3868,578,0,0,146,146,0,1,0,1,0
1720,598,0,0,128,128,0,1,0,1,0
11457,1303,0,0,77,77,0,1,0,1,0
6581,684,0,0,146,146,0,1,0,1,0
338,1162,0,0,144,144,0,1,0,1,0
3018,1592,0,0,78,78,0,1,0,1,0
1069,183,4055,121,293,223,70,4,1,3,1
2442,1694,0,0,62,62,0,1,0,1,0
8049,1550,0,0,137,137,0,1,0,1,0
500,1114,0,0,157,157,0,1,0,1,0
5050,313,0,0,146,146,0,1,0,1,0
7923,1793,0,0,125,125,0,1,0,1,0
12519,1184,0,0,91,91,0,1,0,1,0
1486,3095,0,0,145,145,0,1,0,1,0
2088,261,0,0,104,104,0,1,0,1,0
2108,1439,0,0,101,101,0,1,0,1,0
2422,57,0,0,71,71,0,1,0,1,0
2899,1683,0,0,63,63,0,1,0,1,0
1092,1134,0,0,143,143,0,1,0,1,0
2042,183,8026,121,293,223,70,4,0,3,1
7676,2271,0,0,101,101,0,1,0,1,0
1410,3095,0,0,139,139,0,1,0,1,0
1993,183,7760,121,293,223,70,4,0,3,1
5744,274,0,0,146,146,0,1,0,1,0
1154,183,4083,121,293,223,70,4,1,3,1
7788,2313,0,0,103,103,0,1,0,1,0
3462,833,0,0,147,147,0,1,0,1,0
3022,1604,0,0,76,76,0,1,0,1,0
9399,1543,0,0,106,106,0,1,0,1,0
1638,183,6476,121,293,223,70,4,0,3,1
4369,183,15528,121,293,223,70,4,0,3,1
3017,1694,0,0,62,62,0,1,0,1,0
7387,2902,0,0,71,71,0,1,0,1,0
2064,183,8261,121,293,223,70,4,0,3,1
2716,1176,0,0,146,146,0,1,0,1,0
9328,1364,0,0,113,113,0,1,0,1,0
1402,3095,0,0,140,140,0,1,0,1,0
10544,1543,0,0,67,67,0,1,0,1,0
1511,183,5371,121,293,223,70,4,0,3,1
14898,652,0,0,145,145,0,1,0,1,0
4727,345,0,0,146,146,0,1,0,1,0
747,1171,0,0,157,157,0,1,0,1,0
1107,1176,0,0,147,147,0,1,0,1,0
8074,1904,0,0,125,125,0,1,0,1,0
927,1059,0,0,155,155,0,1,0,1,0
17902,2699,0,0,145,145,0,1,0,1,0
13004,1543,0,0,69,69,0,1,0,1,0
121,1054,0,0,152,152,0,1,0,1,0
1181,183,4358,121,293,223,70,4,1,3,1
4803,183,16300,121,293,223,70,4,1,3,1
21414,589,19958,84,223,174,49,3,0,2,0
2158,1375,0,0,62,62,0,1,0,1,0
1637,3095,0,0,151,151,0,1,0,1,0
1964,1222,0,0,135,135,0,1,0,1,0
3604,269,0,0,118,118,0,1,0,1,0
1408,3095,0,0,139,139,0,1,0,1,0
1885,766,0,0,82,82,0,1,0,1,0
1477,3018,0,0,134,134,0,1,0,1,0
1246,646,0,0,150,150,0,1,0,1,0
6602,747,0,0,146,146,0,1,0,1,0
446,1176,0,0,145,145,0,1,0,1,0
1949,947,0,0,88,88,0,1,0,1,0
9747,1543,0,0,94,94,0,1,0,1,0
14251,2239,0,0,99,99,0,1,0,1,0
1904,183,7430,121,293,223,70,4,0,3,1
1160,3095,0,0,139,139,0,1,0,1,0
9467,1543,0,0,107,107,0,1,0,1,0
1945,349,0,0,118,118,0,1,0,1,0
762,3095,0,0,139,139,0,1,0,1,0
2168,3095,0,0,157,157,0,1,0,1,0
1797,778,0,0,112,112,0,1,0,1,0
5216,296,0,0,146,146,0,1,0,1,0
7501,2608,0,0,84,84,0,1,0,1,0
2593,1694,0,0,62,62,0,1,0,1,0
10828,1546,0,0,62,62,0,1,0,1,0
15011,183,23772,121,293,223,70,4,0,3,1
2200,1030,0,0,62,62,0,1,0,1,0
14655,1543,0,0,68,68,0,1,0,1,0
1054,183,3889,121,293,223,70,4,1,3,1
7233,808,0,0,152,152,0,1,0,1,0
945,1116,0,0,145,145,0,1,0,1,0
3034,1694,0,0,62,62,0,1,0,1,0
229,2364,0,0,144,144,0,1,0,1,0
5010,183,16556,121,293,223,70,4,1,3,1
1967,183,7657,121,293,223,70,4,0,3,1
1608,509,205,6,156,152,4,1,0,1,0
36,1012,0,0,156,156,0,1,0,1,0
2694,1176,0,0,146,146,0,1,0,1,0
1861,183,7207,121,293,223,70,4,0,3,1
11220,1652,0,0,64,64,0,1,0,1,0
820,767,1474,49,213,184,28,2,0,1,0
333,1412,0,0,143,143,0,1,0,1,0
13789,440,0,0,132,132,0,1,0,1,0
1803,938,0,0,84,84,0,1,0,1,0
167,2087,0,0,147,147,0,1,0,1,0
3801,620,0,0,146,146,0,1,0,1,0
2346,1694,0,0,62,62,0,1,0,1,0
17627,183,24584,121,293,223,70,4,0,3,1
9128,1329,0,0,121,121,0,1,0,1,0
791,991,663,22,182,169,12,1,0,1,0
8912,1543,0,0,124,124,0,1,0,1,0
386,2468,0,0,144,144,0,1,0,1,0
1865,898,0,0,75,75,0,1,0,1,0
1819,3095,0,0,148,148,0,1,0,1,0
1564,183,6372,121,293,223,70,4,0,3,1
1327,183,4464,121,293,223,70,4,1,3,1
256,1966,0,0,144,144,0,1,0,1,0
1305,3095,0,0,139,139,0,1,0,1,0
3410,1011,0,0,147,147,0,1,0,1,0
1666,544,0,0,143,143,0,1,0,1,0
2907,1182,0,0,146,146,0,1,0,1,0
21591,1179,7597,32,123,104,18,1,0,1,0
17080,1543,0,0,62,62,0,1,0,1,0
1481,183,5217,121,293,223,70,4,0,3,1
6398,635,0,0,146,146,0,1,0,1,0
3892,667,0,0,128,128,0,1,0,1,0
1956,865,0,0,68,68,0,1,0,1,0
1598,686,0,0,145,145,0,1,0,1,0
2831,1694,0,0,62,62,0,1,0,1,0
5995,397,0,0,146,146,0,1,0,1,0
1843,969,0,0,144,144,0,1,0,1,0
2151,1176,0,0,144,144,0,1,0,1,0
2530,1694,0,0,62,62,0,1,0,1,0
8571,1543,0,0,137,137,0,1,0,1,0
1159,183,4554,121,293,223,70,4,0,3,1
858,3095,0,0,139,139,0,1,0,1,0
7988,1508,0,0,146,146,0,1,0,1,0
1832,3095,0,0,151,151,0,1,0,1,0
20919,1919,0,0,82,82,0,1,0,1,0
994,183,3771,121,293,223,70,4,1,3,1
19299,183,26974,121,293,223,70,4,0,3,1
2741,1694,0,0,62,62,0,1,0,1,0
100,1596,0,0,151,151,0,1,0,1,0
10029,1567,0,0,84,84,0,1,0,1,0
17490,2894,0,0,134,134,0,1,0,1,0
19486,2610,0,0,119,119,0,1,0,1,0
2003,962,0,0,62,62,0,1,0,1,0
2130,1603,0,0,75,75,0,1,0,1,0
9528,1543,0,0,102,102,0,1,0,1,0
8314,1488,0,0,147,147,0,1,0,1,0
816,796,1369,46,209,182,26,2,0,1,0
1032,840,0,0,145,145,0,1,0,1,0
1786,666,0,0,110,110,0,1,0,1,0
1937,1111,0,0,127,127,0,1,0,1,0
2041,1176,0,0,143,143,0,1,0,1,0
1999,183,7796,121,293,223,70,4,0,3,1
3002,1525,0,0,89,89,0,1,0,1,0
2901,1626,0,0,73,73,0,1,0,1,0
2058,3095,0,0,155,155,0,1,0,1,0
1887,183,7206,121,293,223,70,4,0,3,1
9243,1585,0,0,122,122,0,1,0,1,0
969,3095,0,0,142,142,0,1,0,1,0
801,3095,0,0,139,139,0,1,0,1,0
235,1053,0,0,157,157,0,1,0,1,0
440,1035,504,17,164,154,9,1,0,1,0
265,1905,0,0,144,144,0,1,0,1,0
1478,1035,0,0,140,140,0,1,0,1,0
1386,183,4758,121,293,223,70,4,1,3,1
1182,872,0,0,152,152,0,1,0,1,0
2555,183,8634,121,293,223,70,4,1,3,1
756,1542,0,0,153,153,0,1,0,1,0
18628,3024,0,0,141,141,0,1,0,1,0
610,1504,0,0,153,153,0,1,0,1,0
8404,1689,0,0,143,143,0,1,0,1,0
2002,875,0,0,62,62,0,1,0,1,0
8435,1543,0,0,142,142,0,1,0,1,0
1941,1188,0,0,141,141,0,1,0,1,0
3021,1694,0,0,62,62,0,1,0,1,0
1877,3095,0,0,152,152,0,1,0,1,0
1596,183,5832,121,293,223,70,4,0,3,1
4770,183,15801,121,293,223,70,4,0,3,1
8793,1442,0,0,145,145,0,1,0,1,0
4654,183,16114,121,293,223,70,4,1,3,1
813,335,3030,102,269,210,59,3,0,2,0
8508,1543,0,0,139,139,0,1,0,1,0
8327,1578,0,0,146,146,0,1,0,1,0
6692,183,17562,121,293,223,70,4,0,3,1
2190,199,0,0,94,94,0,1,0,1,0
561,2879,0,0,140,140,0,1,0,1,0
8287,1745,0,0,142,142,0,1,0,1,0
1318,183,4419,121,293,223,70,4,1,3,1
8904,1651,0,0,124,124,0,1,0,1,0
8327,1641,0,0,146,146,0,1,0,1,0
8261,1258,0,0,154,154,0,1,0,1,0
2264,1674,0,0,65,65,0,1,0,1,0
1478,183,5202,121,293,223,70,4,0,3,1
1320,3095,0,0,142,142,0,1,0,1,0
1869,3095,0,0,149,149,0,1,0,1,0
2272,183,8720,121,293,223,70,4,0,3,1
19146,2774,0,0,127,127,0,1,0,1,0
8256,1258,0,0,155,155,0,1,0,1,0
614,830,0,0,153,153,0,1,0,1,0
2874,183,10434,121,293,223,70,4,0,3,1
10370,1543,0,0,71,71,0,1,0,1,0
1686,3095,0,0,149,149,0,1,0,1,0
2242,183,9176,121,293,223,70,4,0,3,1
9313,1543,0,0,110,110,0,1,0,1,0
927,183,3643,121,293,223,70,4,1,3,1
8377,1543,0,0,144,144,0,1,0,1,0
3893,849,0,0,147,147,0,1,0,1,0
2158,3095,0,0,156,156,0,1,0,1,0
2556,1468,0,0,99,99,0,1,0,1,0
848,543,2281,77,243,199,44,2,0,2,0
13181,617,0,0,124,124,0,1,0,1,0
9612,1598,0,0,99,99,0,1,0,1,0
1877,758,0,0,84,84,0,1,0,1,0
1738,727,0,0,146,146,0,1,0,1,0
1566,591,0,0,148,148,0,1,0,1,0
2904,1519,0,0,90,90,0,1,0,1,0
1598,183,5818,121,293,223,70,4,0,3,1
1972,1096,0,0,137,137,0,1,0,1,0
966,1176,0,0,154,154,0,1,0,1,0
382,1047,0,0,152,152,0,1,0,1,0
10601,1543,0,0,66,66,0,1,0,1,0
518,2815,0,0,141,141,0,1,0,1,0
2226,183,9090,121,293,223,70,4,0,3,1
2047,183,8053,121,293,223,70,4,0,3,1
1199,3003,0,0,143,143,0,1,0,1,0
7475,1226,0,0,146,146,0,1,0,1,0
1858,1004,0,0,144,144,0,1,0,1,0
2266,1355,0,0,114,114,0,1,0,1,0
10950,1572,0,0,62,62,0,1,0,1,0
1335,183,4503,121,293,223,70,4,0,3,1
2173,183,8789,121,293,223,70,4,0,3,1
5658,252,0,0,146,146,0,1,0,1,0
8302,1725,0,0,144,144,0,1,0,1,0
5074,310,0,0,146,146,0,1,0,1,0
1909,183,7313,121,293,223,70,4,0,3,1
1944,183,7666,121,293,223,70,4,0,3,1
1403,1176,0,0,139,139,0,1,0,1,0
1452,1112,0,0,139,139,0,1,0,1,0
844,574,2169,73,239,196,42,2,0,2,0
9697,1610,0,0,99,99,0,1,0,1,0
7959,1723,0,0,129,129,0,1,0,1,0
10760,1593,0,0,68,68,0,1,0,1,0
8327,1582,0,0,146,146,0,1,0,1,0
10618,1543,0,0,66,66,0,1,0,1,0
1498,183,5307,121,293,223,70,4,0,3,1
729,3095,0,0,139,139,0,1,0,1,0
10710,1587,0,0,69,69,0,1,0,1,0
12037,993,0,0,103,103,0,1,0,1,0
1923,183,7383,121,293,223,70,4,0,3,1
871,363,2928,98,268,210,57,3,0,2,0
806,349,2979,100,267,209,58,3,0,2,0
991,183,3766,121,293,223,70,4,1,3,1
2967,1386,0,0,113,113,0,1,0,1,0
414,1176,0,0,144,144,0,1,0,1,0
8238,1807,0,0,138,138,0,1,0,1,0
11392,1662,0,0,62,62,0,1,0,1,0
3672,923,0,0,147,147,0,1,0,1,0
2119,1176,0,0,143,143,0,1,0,1,0
8250,1224,0,0,155,155,0,1,0,1,0
9748,1436,0,0,96,96,0,1,0,1,0
2032,183,7970,121,293,223,70,4,0,3,1
1327,1176,0,0,139,139,0,1,0,1,0
18880,1543,0,0,62,62,0,1,0,1,0
2200,474,0,0,62,62,0,1,0,1,0
4392,378,0,0,146,146,0,1,0,1,0
477,2528,0,0,144,144,0,1,0,1,0
962,3095,0,0,139,139,0,1,0,1,0
1631,2764,0,0,120,120,0,1,0,1,0
1316,3095,0,0,146,146,0,1,0,1,0
2605,183,8792,121,293,223,70,4,1,3,1
2224,1332,0,0,118,118,0,1,0,1,0
1456,183,5103,121,293,223,70,4,1,3,1
1900,376,0,0,123,123,0,1,0,1,0
311,2507,0,0,143,143,0,1,0,1,0
2756,1120,0,0,133,133,0,1,0,1,0
1702,183,6334,121,293,223,70,4,0,3,1
2477,183,9305,121,293,223,70,4,0,3,1
7410,2982,0,0,62,62,0,1,0,1,0
1371,3095,0,0,141,141,0,1,0,1,0
20645,2051,0,0,89,89,0,1,0,1,0
7771,2337,0,0,101,101,0,1,0,1,0
1233,3095,0,0,142,142,0,1,0,1,0
1271,3095,0,0,139,139,0,1,0,1,0
21430,1673,0,0,68,68,0,1,0,1,0
2090,183,8203,121,293,223,70,4,0,3,1
991,183,3766,121,293,223,70,4,1,3,1
11969,183,21501,121,293,223,70,4,0,3,1
2684,1694,0,0,62,62,0,1,0,1,0
1601,676,0,0,145,145,0,1,0,1,0
6556,562,0,0,149,149,0,1,0,1,0
10180,1556,0,0,78,78,0,1,0,1,0
2250,1677,0,0,64,64,0,1,0,1,0
1445,183,5610,121,293,223,70,4,0,3,1
14101,2210,0,0,92,92,0,1,0,1,0
814,1142,0,0,156,156,0,1,0,1,0
733,486,2486,84,247,198,48,3,0,2,0
2687,1361,0,0,117,117,0,1,0,1,0
933,1054,0,0,155,155,0,1,0,1,0
2683,1694,0,0,62,62,0,1,0,1,0
743,1931,0,0,149,149,0,1,0,1,0
8302,1435,0,0,149,149,0,1,0,1,0
8889,1694,0,0,131,131,0,1,0,1,0
11915,183,18540,121,293,223,70,4,0,3,1
21548,1037,10583,44,147,121,26,2,0,1,0
1948,967,0,0,92,92,0,1,0,1,0
1486,1140,0,0,130,130,0,1,0,1,0
6907,845,0,0,146,146,0,1,0,1,0
2484,32,0,0,64,64,0,1,0,1,0
835,1126,0,0,156,156,0,1,0,1,0
21179,1794,0,0,75,75,0,1,0,1,0
1829,1176,0,0,142,142,0,1,0,1,0
1459,1158,0,0,134,134,0,1,0,1,0
4230,394,0,0,146,146,0,1,0,1,0
1683,600,0,0,147,147,0,1,0,1,0
8480,1550,0,0,141,141,0,1,0,1,0
8305,1573,0,0,144,144,0,1,0,1,0
13826,352,0,0,145,145,0,1,0,1,0
18665,1543,0,0,64,64,0,1,0,1,0
1299,183,4682,121,293,223,70,4,1,3,1
1319,3082,0,0,143,143,0,1,0,1,0
4274,390,0,0,146,146,0,1,0,1,0
1772,183,6997,121,293,223,70,4,0,3,1
1420,3095,0,0,139,139,0,1,0,1,0
3020,1694,0,0,62,62,0,1,0,1,0
2072,183,8309,121,293,223,70,4,0,3,1
2997,1694,0,0,62,62,0,1,0,1,0
8327,1558,0,0,146,146,0,1,0,1,0
1716,183,6472,121,293,223,70,4,0,3,1
1376,730,0,0,150,150,0,1,0,1,0
1229,183,4228,121,293,223,70,4,1,3,1
1784,2511,0,0,106,106,0,1,0,1,0
2591,1694,0,0,62,62,0,1,0,1,0
8511,1543,0,0,139,139,0,1,0,1,0
811,1100,0,0,146,146,0,1,0,1,0
9990,1621,0,0,102,102,0,1,0,1,0
1610,487,529,14,165,157,8,1,0,1,0
1498,183,5310,121,293,223,70,4,0,3,1
2136,3095,0,0,156,156,0,1,0,1,0
1091,1176,0,0,148,148,0,1,0,1,0
2294,239,0,0,77,77,0,1,0,1,0
1338,3095,0,0,147,147,0,1,0,1,0
960,876,0,0,145,145,0,1,0,1,0
1947,183,7520,121,293,223,70,4,0,3,1
1697,501,0,0,143,143,0,1,0,1,0
1188,183,4378,121,293,223,70,4,1,3,1
2109,611,0,0,62,62,0,1,0,1,0
2954,1694,0,0,62,62,0,1,0,1,0
3034,1655,0,0,68,68,0,1,0,1,0
1177,183,4349,121,293,223,70,4,1,3,1
9839,1543,0,0,94,94,0,1,0,1,0
2666,1694,0,0,62,62,0,1,0,1,0
1490,3095,0,0,145,145,0,1,0,1,0
831,1176,0,0,155,155,0,1,0,1,0
1013,714,0,0,151,151,0,1,0,1,0
8258,1242,0,0,155,155,0,1,0,1,0
712,2906,0,0,140,140,0,1,0,1,0
21357,1482,0,0,65,65,0,1,0,1,0
13795,359,0,0,145,145,0,1,0,1,0
889,3095,0,0,139,139,0,1,0,1,0
11299,1694,0,0,68,68,0,1,0,1,0
10719,1588,0,0,68,68,0,1,0,1,0
3973,183,14168,121,293,223,70,4,0,3,1
1384,3095,0,0,139,139,0,1,0,1,0
21156,183,28325,121,293,223,70,4,0,3,1
8617,1543,0,0,136,136,0,1,0,1,0
9952,1191,0,0,145,145,0,1,0,1,0
8066,1517,0,0,139,139,0,1,0,1,0
1360,183,4628,121,293,223,70,4,1,3,1
8306,1569,0,0,148,148,0,1,0,1,0
8277,1385,0,0,152,152,0,1,0,1,0
7614,2611,0,0,89,89,0,1,0,1,0
1933,1166,0,0,140,140,0,1,0,1,0
1285,183,4337,121,293,223,70,4,1,3,1
1363,3095,0,0,141,141,0,1,0,1,0
19428,183,26489,121,293,223,70,4,0,3,1
223,2378,0,0,144,144,0,1,0,1,0
12601,808,0,0,113,113,0,1,0,1,0
85,1494,0,0,152,152,0,1,0,1,0
996,3095,0,0,139,139,0,1,0,1,0
2424,1575,0,0,81,81,0,1,0,1,0
1947,980,0,0,95,95,0,1,0,1,0
8744,1262,0,0,136,136,0,1,0,1,0
303,2141,0,0,147,147,0,1,0,1,0
17691,2943,0,0,137,137,0,1,0,1,0
2367,1378,0,0,111,111,0,1,0,1,0
2823,1251,0,0,135,135,0,1,0,1,0
1887,2276,0,0,95,95,0,1,0,1,0
112,1049,0,0,153,153,0,1,0,1,0
11316,1694,0,0,68,68,0,1,0,1,0
2760,1301,0,0,127,127,0,1,0,1,0
1944,1027,0,0,107,107,0,1,0,1,0
1317,183,4413,121,293,223,70,4,0,3,1
1699,577,0,0,134,134,0,1,0,1,0
10599,1573,0,0,69,69,0,1,0,1,0
1678,183,6279,121,293,223,70,4,0,3,1
1592,183,5785,121,293,223,70,4,0,3,1
16990,2078,0,0,145,145,0,1,0,1,0
1354,183,4599,121,293,223,70,4,0,3,1
1584,1176,0,0,140,140,0,1,0,1,0
17425,2881,0,0,132,132,0,1,0,1,0
2076,183,8219,121,293,223,70,4,0,3,1
1578,745,0,0,144,144,0,1,0,1,0
3466,235,0,0,110,110,0,1,0,1,0
1909,790,0,0,75,75,0,1,0,1,0
8276,1385,0,0,152,152,0,1,0,1,0
302,2413,0,0,144,144,0,1,0,1,0
1511,3095,0,0,149,149,0,1,0,1,0
10788,1540,0,0,62,62,0,1,0,1,0
1586,720,0,0,145,145,0,1,0,1,0
7991,2022,0,0,119,119,0,1,0,1,0
1427,183,4953,121,293,223,70,4,0,3,1
3094,183,10362,121,293,223,70,4,1,3,1
304,1624,0,0,143,143,0,1,0,1,0
7874,2276,0,0,109,109,0,1,0,1,0
2962,1364,0,0,116,116,0,1,0,1,0
453,2719,0,0,142,142,0,1,0,1,0
1278,1176,0,0,143,143,0,1,0,1,0
1237,737,0,0,146,146,0,1,0,1,0
1504,3095,0,0,149,149,0,1,0,1,0
361,2583,0,0,143,143,0,1,0,1,0
1781,1176,0,0,144,144,0,1,0,1,0
2223,183,9071,121,293,223,70,4,0,3,1
8327,1682,0,0,146,146,0,1,0,1,0
1531,1176,0,0,139,139,0,1,0,1,0
8477,1682,0,0,140,140,0,1,0,1,0
1467,183,5156,121,293,223,70,4,0,3,1
1879,389,0,0,125,125,0,1,0,1,0
7409,2786,0,0,75,75,0,1,0,1,0
1719,183,6469,121,293,223,70,4,0,3,1
2990,1668,0,0,65,65,0,1,0,1,0
10675,183,17755,121,293,223,70,4,0,3,1
16991,1543,0,0,66,66,0,1,0,1,0
807,2745,0,0,143,143,0,1,0,1,0
1773,183,6649,121,293,223,70,4,0,3,1
1521,395,1687,46,203,176,26,2,0,1,0
9259,1637,0,0,114,114,0,1,0,1,0
1967,864,0,0,62,62,0,1,0,1,0
4775,183,15754,121,293,223,70,4,1,3,1
1598,1176,0,0,140,140,0,1,0,1,0
2902,1589,0,0,79,79,0,1,0,1,0
11149,1643,0,0,65,65,0,1,0,1,0
7479,2948,0,0,62,62,0,1,0,1,0
9206,1543,0,0,113,113,0,1,0,1,0
1496,183,5921,121,293,223,70,4,0,3,1
21593,1185,7472,31,122,104,18,1,0,1,0
871,369,2908,98,267,210,56,3,0,2,0
2314,1664,0,0,66,66,0,1,0,1,0
1846,1176,0,0,142,142,0,1,0,1,0
1952,1205,0,0,138,138,0,1,0,1,0
3804,183,13083,121,293,223,70,4,0,3,1
3814,183,13479,121,293,223,70,4,1,3,1
9257,1586,0,0,121,121,0,1,0,1,0
1984,1253,0,0,130,130,0,1,0,1,0
1692,3095,0,0,145,145,0,1,0,1,0
2373,2820,0,0,139,139,0,1,0,1,0
926,3095,0,0,140,140,0,1,0,1,0
1569,589,0,0,148,148,0,1,0,1,0
2177,183,8813,121,293,223,70,4,0,3,1
9509,1543,0,0,105,105,0,1,0,1,0
7806,2286,0,0,104,104,0,1,0,1,0
2019,1176,0,0,143,143,0,1,0,1,0
7796,2038,0,0,113,113,0,1,0,1,0
3942,183,14261,121,293,223,70,4,0,3,1
2186,1556,0,0,83,83,0,1,0,1,0
8784,183,19326,121,293,223,70,4,0,3,1
3019,1694,0,0,62,62,0,1,0,1,0
2563,1694,0,0,62,62,0,1,0,1,0
1935,1140,0,0,134,134,0,1,0,1,0
2065,877,0,0,71,71,0,1,0,1,0
8138,1812,0,0,130,130,0,1,0,1,0
8597,1673,0,0,136,136,0,1,0,1,0
1716,594,0,0,129,129,0,1,0,1,0
1492,3095,0,0,145,145,0,1,0,1,0
3587,265,0,0,117,117,0,1,0,1,0
1935,183,7448,121,293,223,70,4,0,3,1
335,2435,0,0,144,144,0,1,0,1,0
10456,1564,0,0,73,73,0,1,0,1,0
8755,1543,0,0,130,130,0,1,0,1,0
2083,651,0,0,62,62,0,1,0,1,0
13424,538,0,0,128,128,0,1,0,1,0
1009,1176,0,0,150,150,0,1,0,1,0
11670,1717,0,0,71,71,0,1,0,1,0
1014,183,4044,121,293,223,70,4,0,3,1
6324,478,0,0,148,148,0,1,0,1,0
1204,658,0,0,150,150,0,1,0,1,0
2904,1534,0,0,88,88,0,1,0,1,0
2911,1694,0,0,62,62,0,1,0,1,0
1969,183,7665,121,293,223,70,4,0,3,1
12393,183,19487,121,293,223,70,4,0,3,1
1354,1176,0,0,141,141,0,1,0,1,0
13212,653,0,0,119,119,0,1,0,1,0
1970,183,7652,121,293,223,70,4,0,3,1
1412,3095,0,0,139,139,0,1,0,1,0
627,1176,0,0,152,152,0,1,0,1,0
2221,183,9054,121,293,223,70,4,0,3,1
1484,183,5246,121,293,223,70,4,0,3,1
878,3095,0,0,141,141,0,1,0,1,0
8320,1654,0,0,146,146,0,1,0,1,0
1667,544,0,0,143,143,0,1,0,1,0
8283,1424,0,0,151,151,0,1,0,1,0
11341,1730,0,0,80,80,0,1,0,1,0
641,2998,0,0,139,139,0,1,0,1,0
3043,1692,0,0,62,62,0,1,0,1,0
1625,3095,0,0,148,148,0,1,0,1,0
674,1369,0,0,155,155,0,1,0,1,0
186,2222,0,0,146,146,0,1,0,1,0
3010,1694,0,0,62,62,0,1,0,1,0
1864,3095,0,0,154,154,0,1,0,1,0
2133,1309,0,0,62,62,0,1,0,1,0
1414,3095,0,0,139,139,0,1,0,1,0
4131,770,0,0,147,147,0,1,0,1,0
1702,498,0,0,142,142,0,1,0,1,0
606,1176,0,0,151,151,0,1,0,1,0
9203,1694,0,0,123,123,0,1,0,1,0
2850,1153,0,0,142,142,0,1,0,1,0
7767,2414,0,0,101,101,0,1,0,1,0
1780,3095,0,0,147,147,0,1,0,1,0
8056,1929,0,0,124,124,0,1,0,1,0
998,3095,0,0,140,140,0,1,0,1,0
9286,1543,0,0,111,111,0,1,0,1,0
17221,1543,0,0,62,62,0,1,0,1,0
1095,3095,0,0,141,141,0,1,0,1,0
1460,1193,0,0,136,136,0,1,0,1,0
1061,1176,0,0,140,140,0,1,0,1,0
1981,183,7715,121,293,223,70,4,0,3,1
1849,183,7018,121,293,223,70,4,0,3,1
1800,3095,0,0,153,153,0,1,0,1,0
1477,183,5208,121,293,223,70,4,0,3,1
2107,1437,0,0,102,102,0,1,0,1,0
2718,1694,0,0,62,62,0,1,0,1,0
1941,183,7479,121,293,223,70,4,0,3,1
1690,505,0,0,144,144,0,1,0,1,0
2795,1694,0,0,62,62,0,1,0,1,0
9497,1355,0,0,110,110,0,1,0,1,0
3284,183,11601,121,293,223,70,4,0,3,1
1631,543,0,0,148,148,0,1,0,1,0
773,970,0,0,144,144,0,1,0,1,0
905,183,3619,121,293,223,70,4,0,3,1
1822,183,6884,121,293,223,70,4,0,3,1
464,1176,0,0,146,146,0,1,0,1,0
1271,1176,0,0,143,143,0,1,0,1,0
10887,1559,0,0,62,62,0,1,0,1,0
787,3095,0,0,139,139,0,1,0,1,0
921,183,3652,121,293,223,70,4,1,3,1
1273,3095,0,0,139,139,0,1,0,1,0
2151,735,0,0,112,112,0,1,0,1,0
9873,1543,0,0,89,89,0,1,0,1,0
178,1039,0,0,157,157,0,1,0,1,0
5353,282,0,0,146,146,0,1,0,1,0
8280,1339,0,0,152,152,0,1,0,1,0
3679,287,0,0,121,121,0,1,0,1,0
465,989,674,22,171,158,13,1,0,1,0
2819,1694,0,0,62,62,0,1,0,1,0
7963,2161,0,0,117,117,0,1,0,1,0
220,2226,0,0,144,144,0,1,0,1,0
1012,183,3898,121,293,223,70,4,1,3,1
7636,2582,0,0,90,90,0,1,0,1,0
2196,183,8911,121,293,223,70,4,0,3,1
2256,2585,0,0,123,123,0,1,0,1,0
5877,349,0,0,146,146,0,1,0,1,0
8827,1259,0,0,135,135,0,1,0,1,0
2389,183,9170,121,293,223,70,4,0,3,1
1226,3095,0,0,142,142,0,1,0,1,0
8252,1232,0,0,155,155,0,1,0,1,0
2947,1694,0,0,62,62,0,1,0,1,0
10612,1543,0,0,68,68,0,1,0,1,0
1836,183,6952,121,293,223,70,4,0,3,1
1288,183,4650,121,293,223,70,4,1,3,1
13666,2122,0,0,87,87,0,1,0,1,0
2268,2083,0,0,88,88,0,1,0,1,0
1458,183,5112,121,293,223,70,4,1,3,1
1348,220,3915,107,277,214,62,3,0,2,0
1837,183,7010,121,293,223,70,4,0,3,1
1569,552,0,0,148,148,0,1,0,1,0
2740,183,10292,121,293,223,70,4,0,3,1
2930,1232,0,0,138,138,0,1,0,1,0
732,2304,0,0,146,146,0,1,0,1,0
1581,183,5752,121,293,223,70,4,0,3,1
11165,1279,0,0,86,86,0,1,0,1,0
7374,1074,0,0,146,146,0,1,0,1,0
3274,183,11946,121,293,223,70,4,0,3,1
548,1176,0,0,149,149,0,1,0,1,0
1933,1176,0,0,142,142,0,1,0,1,0
10860,1553,0,0,62,62,0,1,0,1,0
1785,3095,0,0,147,147,0,1,0,1,0
1948,1199,0,0,139,139,0,1,0,1,0
1695,1176,0,0,145,145,0,1,0,1,0
1995,183,7773,121,293,223,70,4,0,3,1
1188,1176,0,0,145,145,0,1,0,1,0
2224,183,9091,121,293,223,70,4,0,3,1
1614,3095,0,0,147,147,0,1,0,1,0
4055,510,0,0,138,138,0,1,0,1,0
1261,1176,0,0,143,143,0,1,0,1,0
797,941,843,28,189,172,16,1,0,1,0
1230,3095,0,0,145,145,0,1,0,1,0
4927,325,0,0,146,146,0,1,0,1,0
2097,1212,0,0,62,62,0,1,0,1,0
8141,1808,0,0,131,131,0,1,0,1,0
1678,3095,0,0,149,149,0,1,0,1,0
1330,1176,0,0,141,141,0,1,0,1,0
303,1068,0,0,157,157,0,1,0,1,0
3660,183,12962,121,293,223,70,4,0,3,1
3989,588,0,0,133,133,0,1,0,1,0
2909,1360,0,0,117,117,0,1,0,1,0
1504,959,0,0,142,142,0,1,0,1,0
1315,183,4406,121,293,223,70,4,1,3,1
16463,183,23592,121,293,223,70,4,0,3,1
1997,183,7784,121,293,223,70,4,0,3,1
8490,1550,0,0,141,141,0,1,0,1,0
5028,183,16578,121,293,223,70,4,1,3,1
1302,1176,0,0,142,142,0,1,0,1,0
2250,2879,0,0,144,144,0,1,0,1,0
2260,2432,0,0,113,113,0,1,0,1,0
14311,183,21422,121,293,223,70,4,0,3,1
7656,2501,0,0,92,92,0,1,0,1,0
1824,3095,0,0,153,153,0,1,0,1,0
2191,3095,0,0,157,157,0,1,0,1,0
9236,1543,0,0,115,115,0,1,0,1,0
10809,1543,0,0,62,62,0,1,0,1,0
4260,727,0,0,147,147,0,1,0,1,0
21490,842,14659,62,180,144,36,2,0,2,0
1480,183,5737,121,293,223,70,4,0,3,1
1670,183,6141,121,293,223,70,4,0,3,1
2018,183,7897,121,293,223,70,4,0,3,1
2267,2123,0,0,91,91,0,1,0,1,0
1302,183,4369,121,293,223,70,4,1,3,1
2612,1694,0,0,62,62,0,1,0,1,0
1140,183,4485,121,293,223,70,4,0,3,1
2847,1231,0,0,138,138,0,1,0,1,0
2237,183,9147,121,293,223,70,4,0,3,1
8018,1983,0,0,121,121,0,1,0,1,0
2397,1238,0,0,62,62,0,1,0,1,0
9995,1543,0,0,85,85,0,1,0,1,0
8418,1543,0,0,142,142,0,1,0,1,0
2063,1372,0,0,112,112,0,1,0,1,0
8093,1464,0,0,142,142,0,1,0,1,0
381,1176,0,0,143,143,0,1,0,1,0
2145,1340,0,0,62,62,0,1,0,1,0
1421,3095,0,0,139,139,0,1,0,1,0
965,3095,0,0,142,142,0,1,0,1,0
1028,3095,0,0,141,141,0,1,0,1,0
1349,183,4574,121,293,223,70,4,1,3,1
2031,1036,0,0,62,62,0,1,0,1,0
1325,183,4455,121,293,223,70,4,1,3,1
2189,1050,0,0,62,62,0,1,0,1,0
1438,1176,0,0,139,139,0,1,0,1,0
1107,183,4157,121,293,223,70,4,1,3,1
2906,1459,0,0,100,100,0,1,0,1,0
2578,183,10216,121,293,223,70,4,0,3,1
671,1153,0,0,157,157,0,1,0,1,0
16619,183,24973,121,293,223,70,4,0,3,1
1475,1176,0,0,139,139,0,1,0,1,0
7529,2720,0,0,82,82,0,1,0,1,0
263,2384,0,0,144,144,0,1,0,1,0
1980,183,7723,121,293,223,70,4,0,3,1
1188,3095,0,0,142,142,0,1,0,1,0
8817,1543,0,0,128,128,0,1,0,1,0
2902,1591,0,0,78,78,0,1,0,1,0
8293,1488,0,0,150,150,0,1,0,1,0
12354,671,0,0,145,145,0,1,0,1,0
2032,183,7970,121,293,223,70,4,0,3,1
19151,183,26864,121,293,223,70,4,0,3,1
1780,953,0,0,87,87,0,1,0,1,0
8717,2344,0,0,66,66,0,1,0,1,0
1516,183,5405,121,293,223,70,4,0,3,1
2094,1203,0,0,62,62,0,1,0,1,0
1795,780,0,0,113,113,0,1,0,1,0
2444,1558,0,0,84,84,0,1,0,1,0
1935,1140,0,0,134,134,0,1,0,1,0
1522,183,6198,121,293,223,70,4,0,3,1
1448,1186,0,0,137,137,0,1,0,1,0
1930,183,7420,121,293,223,70,4,0,3,1
8159,1782,0,0,132,132,0,1,0,1,0
15660,2524,0,0,114,114,0,1,0,1,0
2158,3095,0,0,156,156,0,1,0,1,0
319,1511,0,0,143,143,0,1,0,1,0
20621,2063,0,0,89,89,0,1,0,1,0
2038,183,8013,121,293,223,70,4,0,3,1
19851,2434,0,0,109,109,0,1,0,1,0
11448,1681,0,0,62,62,0,1,0,1,0
1125,183,4027,121,293,223,70,4,1,3,1
8693,1666,0,0,132,132,0,1,0,1,0
2639,1694,0,0,62,62,0,1,0,1,0
1635,576,0,0,147,147,0,1,0,1,0
2318,1166,0,0,62,62,0,1,0,1,0
1946,998,0,0,100,100,0,1,0,1,0
20590,1348,0,0,74,74,0,1,0,1,0
2274,1699,0,0,62,62,0,1,0,1,0
774,3095,0,0,139,139,0,1,0,1,0
2473,1428,0,0,103,103,0,1,0,1,0
2437,183,9072,121,293,223,70,4,0,3,1
8310,1591,0,0,148,148,0,1,0,1,0
10576,1509,0,0,70,70,0,1,0,1,0
19664,1573,0,0,62,62,0,1,0,1,0
19895,183,27053,121,293,223,70,4,0,3,1
296,2485,0,0,143,143,0,1,0,1,0
10446,1565,0,0,74,74,0,1,0,1,0
1888,1074,0,0,143,143,0,1,0,1,0
2358,96,0,0,77,77,0,1,0,1,0
949,183,3686,121,293,223,70,4,1,3,1
4616,183,15345,121,293,223,70,4,0,3,1
19596,2557,0,0,116,116,0,1,0,1,0
2129,236,0,0,100,100,0,1,0,1,0
1237,832,0,0,152,152,0,1,0,1,0
10492,1543,0,0,69,69,0,1,0,1,0
1534,615,0,0,149,149,0,1,0,1,0
1319,183,4425,121,293,223,70,4,0,3,1
1457,183,5109,121,293,223,70,4,1,3,1
1005,3095,0,0,139,139,0,1,0,1,0
8327,1610,0,0,146,146,0,1,0,1,0
2170,1628,0,0,71,71,0,1,0,1,0
1787,1176,0,0,141,141,0,1,0,1,0
4549,183,15203,121,293,223,70,4,0,3,1
19429,2637,0,0,120,120,0,1,0,1,0
8572,1233,0,0,143,143,0,1,0,1,0
2663,1380,0,0,113,113,0,1,0,1,0
2376,183,8706,121,293,223,70,4,0,3,1
10821,1545,0,0,62,62,0,1,0,1,0
504,1062,0,0,150,150,0,1,0,1,0
18396,3036,0,0,145,145,0,1,0,1,0
7710,2205,0,0,104,104,0,1,0,1,0
1360,3095,0,0,142,142,0,1,0,1,0
2243,183,9183,121,293,223,70,4,0,3,1
2007,1288,0,0,125,125,0,1,0,1,0
2254,2696,0,0,131,131,0,1,0,1,0
2071,183,8187,121,293,223,70,4,0,3,1
197,2299,0,0,145,145,0,1,0,1,0
338,1378,0,0,143,143,0,1,0,1,0
2326,1694,0,0,62,62,0,1,0,1,0
912,183,3613,121,293,223,70,4,1,3,1
19850,1570,0,0,62,62,0,1,0,1,0
1902,183,7334,121,293,223,70,4,0,3,1
11020,1626,0,0,66,66,0,1,0,1,0
2209,928,0,0,84,84,0,1,0,1,0
2944,183,10943,121,293,223,70,4,0,3,1
2062,183,8125,121,293,223,70,4,0,3,1
1571,3095,0,0,150,150,0,1,0,1,0
1802,682,0,0,105,105,0,1,0,1,0
8310,1469,0,0,148,148,0,1,0,1,0
1078,3095,0,0,139,139,0,1,0,1,0
15874,2568,0,0,113,113,0,1,0,1,0
1356,3095,0,0,142,142,0,1,0,1,0
1908,658,0,0,105,105,0,1,0,1,0
1030,1176,0,0,153,153,0,1,0,1,0
1428,183,4963,121,293,223,70,4,1,3,1
21477,801,15519,65,187,149,38,2,0,2,0
1389,3095,0,0,140,140,0,1,0,1,0
7864,1907,0,0,119,119,0,1,0,1,0
1025,183,3934,121,293,223,70,4,1,3,1
1930,183,7428,121,293,223,70,4,0,3,1
1465,183,5680,121,293,223,70,4,0,3,1
2117,1453,0,0,99,99,0,1,0,1,0
1335,183,4502,121,293,223,70,4,0,3,1
2089,3095,0,0,156,156,0,1,0,1,0
2890,1622,0,0,73,73,0,1,0,1,0
3489,241,0,0,112,112,0,1,0,1,0
2962,1694,0,0,62,62,0,1,0,1,0
1469,343,2355,64,225,188,37,2,0,2,0
18030,3003,0,0,139,139,0,1,0,1,0
1338,3095,0,0,139,139,0,1,0,1,0
2026,1317,0,0,120,120,0,1,0,1,0
88,1514,0,0,152,152,0,1,0,1,0
2087,644,0,0,62,62,0,1,0,1,0
1792,442,0,0,133,133,0,1,0,1,0
2514,3,0,0,62,62,0,1,0,1,0
1602,183,5807,121,293,223,70,4,0,3,1
4042,377,0,0,140,140,0,1,0,1,0
1200,3095,0,0,145,145,0,1,0,1,0
43,1008,0,0,157,157,0,1,0,1,0
1376,3095,0,0,141,141,0,1,0,1,0
4329,183,15409,121,293,223,70,4,0,3,1
446,1176,0,0,142,142,0,1,0,1,0
1326,183,4461,121,293,223,70,4,0,3,1
9484,1970,0,0,69,69,0,1,0,1,0
2281,143,0,0,85,85,0,1,0,1,0
15980,1390,0,0,145,145,0,1,0,1,0
1903,183,7295,121,293,223,70,4,0,3,1
2224,3095,0,0,158,158,0,1,0,1,0
5275,388,0,0,146,146,0,1,0,1,0
10743,1591,0,0,68,68,0,1,0,1,0
2994,1694,0,0,62,62,0,1,0,1,0
1767,1176,0,0,141,141,0,1,0,1,0
7666,2543,0,0,93,93,0,1,0,1,0
2072,3095,0,0,154,154,0,1,0,1,0
2264,1659,0,0,62,62,0,1,0,1,0
2242,410,0,0,62,62,0,1,0,1,0
3014,183,11166,121,293,223,70,4,0,3,1
2940,1694,0,0,62,62,0,1,0,1,0
714,2859,0,0,141,141,0,1,0,1,0
1389,3095,0,0,140,140,0,1,0,1,0
8266,1629,0,0,141,141,0,1,0,1,0
1165,2932,0,0,140,140,0,1,0,1,0
2267,183,9292,121,293,223,70,4,0,3,1
8327,1663,0,0,146,146,0,1,0,1,0
2530,1694,0,0,62,62,0,1,0,1,0
488,2771,0,0,141,141,0,1,0,1,0
2629,1075,0,0,122,122,0,1,0,1,0
9675,1424,0,0,99,99,0,1,0,1,0
399,1942,0,0,149,149,0,1,0,1,0
1453,183,5090,121,293,223,70,4,1,3,1
1176,876,0,0,152,152,0,1,0,1,0
819,325,3067,103,271,211,59,3,0,2,0
5473,270,0,0,146,146,0,1,0,1,0
8765,1661,0,0,130,130,0,1,0,1,0
1645,183,6709,121,293,223,70,4,0,3,1
1058,183,4026,121,293,223,70,4,1,3,1
1730,1176,0,0,141,141,0,1,0,1,0
8327,1561,0,0,146,146,0,1,0,1,0
11532,849,0,0,145,145,0,1,0,1,0
150,1960,0,0,148,148,0,1,0,1,0
1933,1168,0,0,141,141,0,1,0,1,0
380,2610,0,0,142,142,0,1,0,1,0
1556,3095,0,0,142,142,0,1,0,1,0
1195,863,0,0,152,152,0,1,0,1,0
819,947,0,0,144,144,0,1,0,1,0
12071,982,0,0,103,103,0,1,0,1,0
8481,1694,0,0,141,141,0,1,0,1,0
555,1176,0,0,149,149,0,1,0,1,0
1586,183,5732,121,293,223,70,4,0,3,1
9604,1370,0,0,106,106,0,1,0,1,0
1775,956,0,0,88,88,0,1,0,1,0
150,1033,0,0,157,157,0,1,0,1,0
8536,1543,0,0,138,138,0,1,0,1,0
1938,1100,0,0,124,124,0,1,0,1,0
2296,1694,0,0,62,62,0,1,0,1,0
1908,1467,0,0,95,95,0,1,0,1,0
2025,2111,0,0,84,84,0,1,0,1,0
1818,183,7435,121,293,223,70,4,0,3,1
1302,1176,0,0,142,142,0,1,0,1,0
8266,1320,0,0,153,153,0,1,0,1,0
1417,183,5614,121,293,223,70,4,0,3,1
19480,2613,0,0,119,119,0,1,0,1,0
2012,183,7992,121,293,223,70,4,0,3,1
8557,1676,0,0,137,137,0,1,0,1,0
10541,1566,0,0,70,70,0,1,0,1,0
603,1056,0,0,143,143,0,1,0,1,0
8847,1662,0,0,128,128,0,1,0,1,0
283,2182,0,0,146,146,0,1,0,1,0
1996,870,0,0,62,62,0,1,0,1,0
317,2112,0,0,147,147,0,1,0,1,0
24,1052,0,0,156,156,0,1,0,1,0
1961,843,0,0,62,62,0,1,0,1,0
1954,888,0,0,73,73,0,1,0,1,0
8241,1178,0,0,156,156,0,1,0,1,0
2984,1453,0,0,101,101,0,1,0,1,0
2345,975,0,0,96,96,0,1,0,1,0
9210,1351,0,0,145,145,0,1,0,1,0
763,1329,0,0,155,155,0,1,0,1,0
2351,183,9047,121,293,223,70,4,0,3,1
1689,183,6236,121,293,223,70,4,0,3,1
9116,1645,0,0,119,119,0,1,0,1,0
2331,276,0,0,62,62,0,1,0,1,0
2487,1025,0,0,109,109,0,1,0,1,0
2922,1694,0,0,62,62,0,1,0,1,0
11586,1672,0,0,63,63,0,1,0,1,0
1547,581,0,0,147,147,0,1,0,1,0
8141,1932,0,0,131,131,0,1,0,1,0
683,580,2147,72,232,190,41,2,0,2,0
776,3095,0,0,139,139,0,1,0,1,0
16750,1543,0,0,62,62,0,1,0,1,0
1949,948,0,0,88,88,0,1,0,1,0
3197,183,11742,121,293,223,70,4,0,3,1
6325,595,0,0,146,146,0,1,0,1,0
4821,335,0,0,146,146,0,1,0,1,0
18137,183,26106,121,293,223,70,4,0,3,1
2904,1171,0,0,146,146,0,1,0,1,0
763,2716,0,0,144,144,0,1,0,1,0
20851,1952,0,0,83,83,0,1,0,1,0
1725,3095,0,0,146,146,0,1,0,1,0
16385,612,0,0,121,121,0,1,0,1,0
100,1599,0,0,151,151,0,1,0,1,0
3894,699,0,0,126,126,0,1,0,1,0
1610,649,0,0,146,146,0,1,0,1,0
10958,1573,0,0,62,62,0,1,0,1,0
1937,1113,0,0,127,127,0,1,0,1,0
256,1969,0,0,144,144,0,1,0,1,0
1850,1176,0,0,142,142,0,1,0,1,0
186,2219,0,0,146,146,0,1,0,1,0
8193,183,18682,121,293,223,70,4,0,3,1
3376,1305,0,0,87,87,0,1,0,1,0
3207,183,11323,121,293,223,70,4,1,3,1
744,1905,0,0,150,150,0,1,0,1,0
9081,1295,0,0,125,125,0,1,0,1,0
603,2940,0,0,140,140,0,1,0,1,0
1588,1176,0,0,147,147,0,1,0,1,0
17777,183,24917,121,293,223,70,4,0,3,1
1138,183,4242,121,293,223,70,4,1,3,1
1281,183,4328,121,293,223,70,4,1,3,1
4685,349,0,0,146,146,0,1,0,1,0
10199,1137,0,0,145,145,0,1,0,1,0
2157,1620,0,0,72,72,0,1,0,1,0
8528,1543,0,0,138,138,0,1,0,1,0
21337,333,25311,107,267,205,62,3,0,2,0
1243,183,4255,121,293,223,70,4,1,3,1
2958,1349,0,0,119,119,0,1,0,1,0
8266,1513,0,0,146,146,0,1,0,1,0
7975,1692,0,0,130,130,0,1,0,1,0
1364,183,4858,121,293,223,70,4,1,3,1
1371,3095,0,0,141,141,0,1,0,1,0
1641,183,6029,121,293,223,70,4,0,3,1
2532,1694,0,0,62,62,0,1,0,1,0
10410,1567,0,0,75,75,0,1,0,1,0
417,2666,0,0,142,142,0,1,0,1,0
1506,2971,0,0,132,132,0,1,0,1,0
2029,2064,0,0,83,83,0,1,0,1,0
9804,1604,0,0,96,96,0,1,0,1,0
1988,183,7736,121,293,223,70,4,0,3,1
1586,183,6272,121,293,223,70,4,0,3,1
1781,183,6687,121,293,223,70,4,0,3,1
8276,1383,0,0,152,152,0,1,0,1,0
1648,183,6516,121,293,223,70,4,0,3,1
4505,367,0,0,146,146,0,1,0,1,0
10947,1571,0,0,62,62,0,1,0,1,0
11550,1691,0,0,62,62,0,1,0,1,0
2602,1535,0,0,86,86,0,1,0,1,0
6950,938,0,0,146,146,0,1,0,1,0
3161,160,0,0,95,95,0,1,0,1,0
4961,183,16351,121,293,223,70,4,1,3,1
2260,1647,0,0,62,62,0,1,0,1,0
3016,1694,0,0,62,62,0,1,0,1,0
1010,3095,0,0,140,140,0,1,0,1,0
1447,1126,0,0,139,139,0,1,0,1,0
19571,1543,0,0,63,63,0,1,0,1,0
1692,183,6251,121,293,223,70,4,0,3,1
7461,2807,0,0,76,76,0,1,0,1,0
1808,183,6946,121,293,223,70,4,0,3,1
1368,183,5424,121,293,223,70,4,0,3,1
2720,1694,0,0,62,62,0,1,0,1,0
7929,2112,0,0,114,114,0,1,0,1,0
703,1176,0,0,154,154,0,1,0,1,0
14803,1645,0,0,62,62,0,1,0,1,0
1717,595,0,0,129,129,0,1,0,1,0
4828,183,15998,121,293,223,70,4,0,3,1
1545,841,0,0,143,143,0,1,0,1,0
8308,1579,0,0,148,148,0,1,0,1,0
10498,1498,0,0,73,73,0,1,0,1,0
6614,583,0,0,149,149,0,1,0,1,0
6311,1343,0,0,113,113,0,1,0,1,0
2093,1262,0,0,129,129,0,1,0,1,0
2901,1620,0,0,74,74,0,1,0,1,0
2436,117,0,0,62,62,0,1,0,1,0
1787,948,0,0,86,86,0,1,0,1,0
1640,537,0,0,148,148,0,1,0,1,0
10420,1543,0,0,70,70,0,1,0,1,0
1748,3095,0,0,146,146,0,1,0,1,0
8278,1331,0,0,152,152,0,1,0,1,0
583,1176,0,0,142,142,0,1,0,1,0
1457,183,5109,121,293,223,70,4,1,3,1
1979,1176,0,0,143,143,0,1,0,1,0
458,2516,0,0,144,144,0,1,0,1,0
8354,2521,0,0,65,65,0,1,0,1,0
872,1176,0,0,141,141,0,1,0,1,0
19492,2607,0,0,118,118,0,1,0,1,0
21402,549,20797,88,230,179,51,3,0,2,0
11448,1681,0,0,62,62,0,1,0,1,0
2925,1213,0,0,141,141,0,1,0,1,0
13590,183,22836,121,293,223,70,4,0,3,1
687,1085,0,0,148,148,0,1,0,1,0
2997,1694,0,0,62,62,0,1,0,1,0
2595,1341,0,0,62,62,0,1,0,1,0
2474,59,0,0,62,62,0,1,0,1,0
5764,283,0,0,146,146,0,1,0,1,0
8554,1680,0,0,138,138,0,1,0,1,0
1685,563,0,0,138,138,0,1,0,1,0
242,2069,0,0,144,144,0,1,0,1,0
7681,2261,0,0,101,101,0,1,0,1,0
2129,183,8600,121,293,223,70,4,0,3,1
1301,785,0,0,151,151,0,1,0,1,0
2277,1734,0,0,64,64,0,1,0,1,0
1286,3095,0,0,139,139,0,1,0,1,0
2024,183,7931,121,293,223,70,4,0,3,1
3847,183,13749,121,293,223,70,4,0,3,1
1812,430,0,0,131,131,0,1,0,1,0
2160,1176,0,0,144,144,0,1,0,1,0
824,3095,0,0,140,140,0,1,0,1,0
2346,1192,0,0,62,62,0,1,0,1,0
2910,1340,0,0,120,120,0,1,0,1,0
1395,183,5424,121,293,223,70,4,0,3,1
1988,793,0,0,62,62,0,1,0,1,0
2007,1215,0,0,136,136,0,1,0,1,0
1675,1019,0,0,103,103,0,1,0,1,0
1437,1176,0,0,139,139,0,1,0,1,0
1504,636,0,0,149,149,0,1,0,1,0
1519,2825,0,0,127,127,0,1,0,1,0
7170,2865,0,0,67,67,0,1,0,1,0
2260,3061,0,0,156,156,0,1,0,1,0
8329,1188,0,0,153,153,0,1,0,1,0
7833,1968,0,0,116,116,0,1,0,1,0
1993,2165,0,0,87,87,0,1,0,1,0
2038,1176,0,0,143,143,0,1,0,1,0
1112,3095,0,0,141,141,0,1,0,1,0
1446,679,0,0,150,150,0,1,0,1,0
8327,1556,0,0,146,146,0,1,0,1,0
3852,588,0,0,146,146,0,1,0,1,0
355,1044,0,0,152,152,0,1,0,1,0
7394,2894,0,0,71,71,0,1,0,1,0
2526,1452,0,0,99,99,0,1,0,1,0
1679,3095,0,0,149,149,0,1,0,1,0
2135,572,0,0,62,62,0,1,0,1,0
8305,1562,0,0,148,148,0,1,0,1,0
4188,398,0,0,146,146,0,1,0,1,0
2140,183,8588,121,293,223,70,4,0,3,1
268,2444,0,0,144,144,0,1,0,1,0
2042,183,8153,121,293,223,70,4,0,3,1
2003,1281,0,0,126,126,0,1,0,1,0
739,1176,0,0,141,141,0,1,0,1,0
2984,1453,0,0,101,101,0,1,0,1,0
3082,1649,0,0,64,64,0,1,0,1,0
470,979,708,23,172,158,13,1,0,1,0
1398,412,1200,40,196,173,23,2,0,1,0
787,1026,538,18,177,166,10,1,0,1,0
1663,1176,0,0,140,140,0,1,0,1,0
1577,3095,0,0,147,147,0,1,0,1,0
3380,1300,0,0,87,87,0,1,0,1,0
1846,911,0,0,78,78,0,1,0,1,0
2254,183,9244,121,293,223,70,4,0,3,1
15479,1543,0,0,67,67,0,1,0,1,0
12019,1446,0,0,76,76,0,1,0,1,0
13281,785,0,0,114,114,0,1,0,1,0
11973,1014,0,0,101,101,0,1,0,1,0
1421,183,4935,121,293,223,70,4,0,3,1
2165,3095,0,0,157,157,0,1,0,1,0
7524,2690,0,0,81,81,0,1,0,1,0
1352,183,4589,121,293,223,70,4,0,3,1
2454,91,0,0,62,62,0,1,0,1,0
1469,1062,0,0,140,140,0,1,0,1,0
1434,183,4995,121,293,223,70,4,1,3,1
2027,183,7956,121,293,223,70,4,0,3,1
15876,1319,0,0,145,145,0,1,0,1,0
2049,1176,0,0,143,143,0,1,0,1,0
2563,183,9037,121,293,223,70,4,1,3,1
4700,183,16172,121,293,223,70,4,1,3,1
1554,183,5596,121,293,223,70,4,0,3,1
1639,538,0,0,148,148,0,1,0,1,0
1672,2696,0,0,117,117,0,1,0,1,0
3318,199,0,0,103,103,0,1,0,1,0
11000,1543,0,0,71,71,0,1,0,1,0
1734,1176,0,0,141,141,0,1,0,1,0
2006,969,0,0,62,62,0,1,0,1,0
10151,1543,0,0,79,79,0,1,0,1,0
2991,183,11095,121,293,223,70,4,0,3,1
586,2915,0,0,140,140,0,1,0,1,0
258,1954,0,0,144,144,0,1,0,1,0
12284,1543,0,0,70,70,0,1,0,1,0
1769,183,6628,121,293,223,70,4,0,3,1
3924,633,0,0,130,130,0,1,0,1,0
2972,1694,0,0,62,62,0,1,0,1,0
10438,1565,0,0,74,74,0,1,0,1,0
10615,1575,0,0,69,69,0,1,0,1,0
2394,242,0,0,78,78,0,1,0,1,0
1108,183,4470,121,293,223,70,4,0,3,1
12633,611,0,0,145,145,0,1,0,1,0
4735,344,0,0,146,146,0,1,0,1,0
1902,1105,0,0,143,143,0,1,0,1,0
2170,1406,0,0,62,62,0,1,0,1,0
1469,183,5160,121,293,223,70,4,0,3,1
2094,183,8320,121,293,223,70,4,0,3,1
9565,1618,0,0,104,104,0,1,0,1,0
2992,1486,0,0,96,96,0,1,0,1,0
7400,2804,0,0,74,74,0,1,0,1,0
7174,2873,0,0,67,67,0,1,0,1,0
2174,183,7412,121,293,223,70,4,1,3,1
3033,1651,0,0,69,69,0,1,0,1,0
21621,1278,5545,23,107,93,13,1,0,1,0
2380,183,9630,121,293,223,70,4,0,3,1
9081,1321,0,0,123,123,0,1,0,1,0
774,1176,0,0,156,156,0,1,0,1,0
2046,183,8054,121,293,223,70,4,0,3,1
1698,183,6931,121,293,223,70,4,0,3,1
9566,1543,0,0,100,100,0,1,0,1,0
1971,819,0,0,62,62,0,1,0,1,0
2805,1694,0,0,62,62,0,1,0,1,0
2819,1254,0,0,134,134,0,1,0,1,0
1971,183,6936,121,293,223,70,4,1,3,1
750,1722,0,0,151,151,0,1,0,1,0
9670,1543,0,0,100,100,0,1,0,1,0
2675,183,10503,121,293,223,70,4,0,3,1
8327,1679,0,0,146,146,0,1,0,1,0
1412,183,4887,121,293,223,70,4,1,3,1
939,1050,0,0,155,155,0,1,0,1,0
1691,504,0,0,144,144,0,1,0,1,0
2239,1635,0,0,71,71,0,1,0,1,0
508,2548,0,0,144,144,0,1,0,1,0
8730,1664,0,0,131,131,0,1,0,1,0
8078,1493,0,0,140,140,0,1,0,1,0
5656,261,0,0,146,146,0,1,0,1,0
1032,3095,0,0,139,139,0,1,0,1,0
18252,1594,0,0,62,62,0,1,0,1,0
2911,1318,0,0,124,124,0,1,0,1,0
13924,331,0,0,145,145,0,1,0,1,0
1877,1048,0,0,143,143,0,1,0,1,0
772,784,0,0,152,152,0,1,0,1,0
1684,1176,0,0,145,145,0,1,0,1,0
1453,1189,0,0,136,136,0,1,0,1,0
2346,103,0,0,78,78,0,1,0,1,0
1024,988,0,0,154,154,0,1,0,1,0
7977,2042,0,0,118,118,0,1,0,1,0
10728,1543,0,0,63,63,0,1,0,1,0
1062,1176,0,0,140,140,0,1,0,1,0
1953,893,0,0,74,74,0,1,0,1,0
2571,1396,0,0,62,62,0,1,0,1,0
8251,1215,0,0,155,155,0,1,0,1,0
7911,183,18688,121,293,223,70,4,0,3,1
8294,1493,0,0,150,150,0,1,0,1,0
2374,282,0,0,81,81,0,1,0,1,0
17727,2950,0,0,138,138,0,1,0,1,0
1319,183,4427,121,293,223,70,4,1,3,1
9531,1543,0,0,102,102,0,1,0,1,0
2995,1694,0,0,62,62,0,1,0,1,0
1501,3095,0,0,149,149,0,1,0,1,0
12737,1997,0,0,93,93,0,1,0,1,0
376,2604,0,0,142,142,0,1,0,1,0
2937,1261,0,0,133,133,0,1,0,1,0
7385,2833,0,0,72,72,0,1,0,1,0
1858,183,7064,121,293,223,70,4,0,3,1
8450,1543,0,0,141,141,0,1,0,1,0
1648,1176,0,0,140,140,0,1,0,1,0
2560,1176,0,0,146,146,0,1,0,1,0
1542,183,5532,121,293,223,70,4,0,3,1
2742,1114,0,0,132,132,0,1,0,1,0
2118,183,8460,121,293,223,70,4,0,3,1
116,1051,0,0,153,153,0,1,0,1,0
755,1173,0,0,157,157,0,1,0,1,0
8287,1371,0,0,151,151,0,1,0,1,0
11851,1543,0,0,62,62,0,1,0,1,0
1790,183,6836,121,293,223,70,4,0,3,1
1365,3095,0,0,141,141,0,1,0,1,0
21147,183,28316,121,293,223,70,4,0,3,1
2292,2994,0,0,152,152,0,1,0,1,0
10543,1543,0,0,67,67,0,1,0,1,0
14059,2200,0,0,97,97,0,1,0,1,0
1645,2637,0,0,116,116,0,1,0,1,0
823,1135,0,0,156,156,0,1,0,1,0
8295,1407,0,0,150,150,0,1,0,1,0
11224,1628,0,0,62,62,0,1,0,1,0
2639,1078,0,0,123,123,0,1,0,1,0
2373,1694,0,0,62,62,0,1,0,1,0
11120,1639,0,0,65,65,0,1,0,1,0
1319,1176,0,0,142,142,0,1,0,1,0
2451,1013,0,0,106,106,0,1,0,1,0
587,1176,0,0,150,150,0,1,0,1,0
1830,939,0,0,144,144,0,1,0,1,0
10985,1694,0,0,76,76,0,1,0,1,0
1469,183,5696,121,293,223,70,4,0,3,1
1502,965,0,0,141,141,0,1,0,1,0
1956,863,0,0,67,67,0,1,0,1,0
9917,1466,0,0,89,89,0,1,0,1,0
1092,183,3963,121,293,223,70,4,1,3,1
1621,183,5909,121,293,223,70,4,0,3,1
2904,1694,0,0,62,62,0,1,0,1,0
2726,1694,0,0,62,62,0,1,0,1,0
673,2657,0,0,144,144,0,1,0,1,0
762,1347,0,0,155,155,0,1,0,1,0
2410,156,0,0,62,62,0,1,0,1,0
1160,183,4094,121,293,223,70,4,1,3,1
8246,1196,0,0,156,156,0,1,0,1,0
1781,449,0,0,135,135,0,1,0,1,0
2639,1694,0,0,62,62,0,1,0,1,0
10604,183,17683,121,293,223,70,4,0,3,1
2831,79,0,0,78,78,0,1,0,1,0
2059,2055,0,0,81,81,0,1,0,1,0
259,1032,0,0,153,153,0,1,0,1,0
1481,1176,0,0,139,139,0,1,0,1,0
2170,3095,0,0,157,157,0,1,0,1,0
3791,183,13047,121,293,223,70,4,0,3,1
3125,1044,0,0,147,147,0,1,0,1,0
2020,183,7922,121,293,223,70,4,0,3,1
4419,375,0,0,146,146,0,1,0,1,0
2077,948,0,0,62,62,0,1,0,1,0
843,3095,0,0,139,139,0,1,0,1,0
1755,3095,0,0,152,152,0,1,0,1,0
216,1101,0,0,149,149,0,1,0,1,0
9741,1390,0,0,101,101,0,1,0,1,0
21505,1543,0,0,62,62,0,1,0,1,0
1372,183,4689,121,293,223,70,4,1,3,1
1098,183,4134,121,293,223,70,4,1,3,1
696,556,2234,75,236,192,43,2,0,2,0
1167,669,0,0,150,150,0,1,0,1,0
1436,183,5005,121,293,223,70,4,1,3,1
2134,1310,0,0,62,62,0,1,0,1,0
10682,1694,0,0,84,84,0,1,0,1,0
2071,183,8220,121,293,223,70,4,0,3,1
1356,1176,0,0,141,141,0,1,0,1,0
1943,1033,0,0,108,108,0,1,0,1,0
1672,576,0,0,147,147,0,1,0,1,0
2005,1284,0,0,126,126,0,1,0,1,0
1022,989,0,0,154,154,0,1,0,1,0
1947,829,0,0,65,65,0,1,0,1,0
1942,1053,0,0,113,113,0,1,0,1,0
985,3095,0,0,139,139,0,1,0,1,0
214,2271,0,0,144,144,0,1,0,1,0
804,1149,0,0,156,156,0,1,0,1,0
2074,664,0,0,62,62,0,1,0,1,0
3912,646,0,0,130,130,0,1,0,1,0
19002,2844,0,0,131,131,0,1,0,1,0
2424,182,0,0,74,74,0,1,0,1,0
1399,183,4954,121,293,223,70,4,1,3,1
747,1834,0,0,150,150,0,1,0,1,0
1651,530,0,0,147,147,0,1,0,1,0
3008,183,10023,121,293,223,70,4,0,3,1
4598,183,15436,121,293,223,70,4,0,3,1
4424,183,14977,121,293,223,70,4,0,3,1
2136,1315,0,0,62,62,0,1,0,1,0
2611,1069,0,0,120,120,0,1,0,1,0
8327,1677,0,0,146,146,0,1,0,1,0
2179,1430,0,0,62,62,0,1,0,1,0
21484,821,15100,64,184,147,37,2,0,2,0
1165,3095,0,0,141,141,0,1,0,1,0
9247,1543,0,0,112,112,0,1,0,1,0
2203,183,8949,121,293,223,70,4,0,3,1
13263,634,0,0,120,120,0,1,0,1,0
8760,1563,0,0,134,134,0,1,0,1,0
2832,1836,0,0,71,71,0,1,0,1,0
8116,1843,0,0,129,129,0,1,0,1,0
1542,608,0,0,149,149,0,1,0,1,0
11442,1680,0,0,62,62,0,1,0,1,0
4119,420,0,0,146,146,0,1,0,1,0
2015,542,0,0,97,97,0,1,0,1,0
9695,1543,0,0,99,99,0,1,0,1,0
10551,1506,0,0,71,71,0,1,0,1,0
1625,183,6273,121,293,223,70,4,0,3,1
8246,1192,0,0,156,156,0,1,0,1,0
1947,615,0,0,102,102,0,1,0,1,0
1002,183,3977,121,293,223,70,4,0,3,1
1081,1176,0,0,148,148,0,1,0,1,0
805,3095,0,0,139,139,0,1,0,1,0
188,1087,0,0,150,150,0,1,0,1,0
1647,2738,0,0,119,119,0,1,0,1,0
8281,1416,0,0,151,151,0,1,0,1,0
1934,1160,0,0,139,139,0,1,0,1,0
9983,1571,0,0,85,85,0,1,0,1,0
8112,1128,0,0,156,156,0,1,0,1,0
998,3095,0,0,142,142,0,1,0,1,0
4285,183,14366,121,293,223,70,4,0,3,1
12919,974,0,0,103,103,0,1,0,1,0
2226,3095,0,0,158,158,0,1,0,1,0
1591,183,5806,121,293,223,70,4,0,3,1
2157,183,8703,121,293,223,70,4,0,3,1
733,2253,0,0,146,146,0,1,0,1,0
8215,1837,0,0,137,137,0,1,0,1,0
9040,1694,0,0,127,127,0,1,0,1,0
10983,1543,0,0,71,71,0,1,0,1,0
5795,285,0,0,146,146,0,1,0,1,0
2593,1694,0,0,62,62,0,1,0,1,0
1728,606,0,0,126,126,0,1,0,1,0
1993,1208,0,0,137,137,0,1,0,1,0
3329,183,12030,121,293,223,70,4,0,3,1
10725,1543,0,0,64,64,0,1,0,1,0
3004,183,10953,121,293,223,70,4,0,3,1
7431,2824,0,0,74,74,0,1,0,1,0
1789,1176,0,0,141,141,0,1,0,1,0
115,1711,0,0,150,150,0,1,0,1,0
1347,3095,0,0,142,142,0,1,0,1,0
8264,1308,0,0,154,154,0,1,0,1,0
7240,2990,0,0,63,63,0,1,0,1,0
7677,2268,0,0,101,101,0,1,0,1,0
3956,183,13984,121,293,223,70,4,1,3,1
15907,183,22764,121,293,223,70,4,0,3,1
2646,1394,0,0,111,111,0,1,0,1,0
20380,183,27543,121,293,223,70,4,0,3,1
1712,590,0,0,130,130,0,1,0,1,0
1484,358,2162,59,219,184,34,2,0,1,0
1474,1176,0,0,139,139,0,1,0,1,0
4779,183,15913,121,293,223,70,4,0,3,1
4235,183,14021,121,293,223,70,4,1,3,1
1730,3095,0,0,149,149,0,1,0,1,0
4314,183,15323,121,293,223,70,4,0,3,1
736,1176,0,0,155,155,0,1,0,1,0
1163,183,4100,121,293,223,70,4,1,3,1
58,1293,0,0,154,154,0,1,0,1,0
3029,1694,0,0,62,62,0,1,0,1,0
1602,183,5862,121,293,223,70,4,0,3,1
1511,386,1811,49,207,178,28,2,0,1,0
9589,1600,0,0,100,100,0,1,0,1,0
279,1802,0,0,144,144,0,1,0,1,0
1195,758,0,0,146,146,0,1,0,1,0
20980,183,28147,121,293,223,70,4,0,3,1
1916,183,7345,121,293,223,70,4,0,3,1
1652,183,6059,121,293,223,70,4,0,3,1
1949,957,0,0,90,90,0,1,0,1,0
2443,43,0,0,68,68,0,1,0,1,0
2804,1694,0,0,62,62,0,1,0,1,0
1748,183,6617,121,293,223,70,4,0,3,1
10344,1543,0,0,77,77,0,1,0,1,0
4723,183,15698,121,293,223,70,4,0,3,1
2116,601,0,0,62,62,0,1,0,1,0
7739,2383,0,0,99,99,0,1,0,1,0
1602,674,0,0,145,145,0,1,0,1,0
16652,1848,0,0,145,145,0,1,0,1,0
2409,1176,0,0,145,145,0,1,0,1,0
9952,1472,0,0,88,88,0,1,0,1,0
2940,1276,0,0,131,131,0,1,0,1,0
8080,1491,0,0,141,141,0,1,0,1,0
1212,3011,0,0,143,143,0,1,0,1,0
2073,183,8228,121,293,223,70,4,0,3,1
1723,601,0,0,127,127,0,1,0,1,0
1973,1094,0,0,137,137,0,1,0,1,0
1505,183,5345,121,293,223,70,4,0,3,1
2948,1694,0,0,62,62,0,1,0,1,0
4196,398,0,0,146,146,0,1,0,1,0
1741,1176,0,0,141,141,0,1,0,1,0
348,1303,0,0,143,143,0,1,0,1,0
11468,1678,0,0,62,62,0,1,0,1,0
1337,1176,0,0,141,141,0,1,0,1,0
9851,1694,0,0,106,106,0,1,0,1,0
922,183,3653,121,293,223,70,4,1,3,1
1989,183,8148,121,293,223,70,4,0,3,1
1981,903,0,0,62,62,0,1,0,1,0
1718,683,0,0,146,146,0,1,0,1,0
1589,1074,0,0,115,115,0,1,0,1,0
9725,1240,0,0,145,145,0,1,0,1,0
1565,1090,0,0,119,119,0,1,0,1,0
21410,1543,0,0,62,62,0,1,0,1,0
1017,2883,0,0,143,143,0,1,0,1,0
2368,90,0,0,76,76,0,1,0,1,0
2538,1694,0,0,62,62,0,1,0,1,0
2161,1282,0,0,126,126,0,1,0,1,0
9666,1543,0,0,97,97,0,1,0,1,0
1600,183,5800,121,293,223,70,4,0,3,1
17041,2113,0,0,145,145,0,1,0,1,0
7731,2459,0,0,98,98,0,1,0,1,0
33,1113,0,0,156,156,0,1,0,1,0
18865,2910,0,0,135,135,0,1,0,1,0
893,2802,0,0,143,143,0,1,0,1,0
2747,1313,0,0,125,125,0,1,0,1,0
19127,183,26171,121,293,223,70,4,0,3,1
8237,1808,0,0,138,138,0,1,0,1,0
814,3095,0,0,139,139,0,1,0,1,0
11538,1693,0,0,62,62,0,1,0,1,0
1386,1176,0,0,139,139,0,1,0,1,0
2002,1280,0,0,126,126,0,1,0,1,0
9036,1641,0,0,120,120,0,1,0,1,0
8473,1216,0,0,147,147,0,1,0,1,0
1999,183,7793,121,293,223,70,4,0,3,1
10087,1543,0,0,86,86,0,1,0,1,0
8308,1460,0,0,148,148,0,1,0,1,0
2058,1109,0,0,62,62,0,1,0,1,0
2109,183,8407,121,293,223,70,4,0,3,1
1869,183,7114,121,293,223,70,4,0,3,1
692,1332,0,0,155,155,0,1,0,1,0
21575,1124,8757,37,133,111,21,1,0,1,0
11319,1647,0,0,62,62,0,1,0,1,0
2216,1656,0,0,67,67,0,1,0,1,0
2712,1341,0,0,120,120,0,1,0,1,0
17071,2133,0,0,145,145,0,1,0,1,0
734,2230,0,0,147,147,0,1,0,1,0
1375,183,4706,121,293,223,70,4,0,3,1
533,1664,0,0,152,152,0,1,0,1,0
8287,1449,0,0,151,151,0,1,0,1,0
15995,1400,0,0,145,145,0,1,0,1,0
12353,971,0,0,98,98,0,1,0,1,0
728,495,2452,82,245,197,47,3,0,2,0
2165,183,8786,121,293,223,70,4,0,3,1
1771,183,6638,121,293,223,70,4,0,3,1
8317,1502,0,0,147,147,0,1,0,1,0
1758,183,6578,121,293,223,70,4,0,3,1
11481,183,21137,121,293,223,70,4,0,3,1
4581,183,16024,121,293,223,70,4,1,3,1
2111,183,8262,121,293,223,70,4,0,3,1
8491,2455,0,0,65,65,0,1,0,1,0
1322,1176,0,0,141,141,0,1,0,1,0
11261,1635,0,0,62,62,0,1,0,1,0
137,1030,0,0,157,157,0,1,0,1,0
19567,183,27174,121,293,223,70,4,0,3,1
333,2434,0,0,144,144,0,1,0,1,0
2113,1254,0,0,62,62,0,1,0,1,0
2172,183,8770,121,293,223,70,4,0,3,1
1689,505,0,0,144,144,0,1,0,1,0
10268,1549,0,0,75,75,0,1,0,1,0
217,2320,0,0,145,145,0,1,0,1,0
1424,183,4946,121,293,223,70,4,1,3,1
1972,3095,0,0,152,152,0,1,0,1,0
2393,74,0,0,74,74,0,1,0,1,0
474,1787,0,0,150,150,0,1,0,1,0
1743,621,0,0,122,122,0,1,0,1,0
1430,183,4976,121,293,223,70,4,1,3,1
21581,1144,8332,35,129,109,20,1,0,1,0
2196,183,8950,121,293,223,70,4,0,3,1
1127,183,4212,121,293,223,70,4,1,3,1
361,1173,0,0,143,143,0,1,0,1,0
2045,183,8072,121,293,223,70,4,0,3,1
14646,2319,0,0,103,103,0,1,0,1,0
2029,183,7954,121,293,223,70,4,0,3,1
10551,1543,0,0,67,67,0,1,0,1,0
2456,2641,0,0,127,127,0,1,0,1,0
9979,1476,0,0,87,87,0,1,0,1,0
1820,183,6879,121,293,223,70,4,0,3,1
2056,1102,0,0,62,62,0,1,0,1,0
4653,183,16114,121,293,223,70,4,1,3,1
1587,1176,0,0,140,140,0,1,0,1,0
1498,1176,0,0,139,139,0,1,0,1,0
915,1067,0,0,155,155,0,1,0,1,0
1403,183,4841,121,293,223,70,4,1,3,1
10355,1543,0,0,72,72,0,1,0,1,0
1944,1176,0,0,143,143,0,1,0,1,0
16580,1798,0,0,145,145,0,1,0,1,0
1963,183,7599,121,293,223,70,4,0,3,1
2165,183,8745,121,293,223,70,4,0,3,1
2515,1694,0,0,62,62,0,1,0,1,0
968,2813,0,0,141,141,0,1,0,1,0
17439,1606,0,0,62,62,0,1,0,1,0
1627,1176,0,0,140,140,0,1,0,1,0
2246,3024,0,0,154,154,0,1,0,1,0
8929,1294,0,0,129,129,0,1,0,1,0
2512,3,0,0,62,62,0,1,0,1,0
549,2576,0,0,144,144,0,1,0,1,0
1395,183,4801,121,293,223,70,4,1,3,1
20620,183,27784,121,293,223,70,4,0,3,1
707,3086,0,0,139,139,0,1,0,1,0
1346,682,0,0,146,146,0,1,0,1,0
1905,1112,0,0,143,143,0,1,0,1,0
19333,1543,0,0,62,62,0,1,0,1,0
2855,999,0,0,135,135,0,1,0,1,0
8175,1889,0,0,133,133,0,1,0,1,0
1564,1176,0,0,140,140,0,1,0,1,0
20402,2169,0,0,95,95,0,1,0,1,0
10881,1609,0,0,67,67,0,1,0,1,0
14837,2398,0,0,112,112,0,1,0,1,0
653,1415,0,0,154,154,0,1,0,1,0
1163,3095,0,0,141,141,0,1,0,1,0
845,568,2190,74,240,197,42,2,0,2,0
1399,3095,0,0,140,140,0,1,0,1,0
622,1478,0,0,153,153,0,1,0,1,0
1600,1067,0,0,114,114,0,1,0,1,0
1460,3095,0,0,145,145,0,1,0,1,0
2602,1430,0,0,105,105,0,1,0,1,0
8149,1922,0,0,131,131,0,1,0,1,0
8327,1674,0,0,146,146,0,1,0,1,0
890,220,3446,116,287,220,67,3,0,2,0
1389,3095,0,0,140,140,0,1,0,1,0
9312,1543,0,0,110,110,0,1,0,1,0
225,2303,0,0,145,145,0,1,0,1,0
2515,1694,0,0,62,62,0,1,0,1,0
4671,590,0,0,146,146,0,1,0,1,0
729,2380,0,0,145,145,0,1,0,1,0
660,1176,0,0,153,153,0,1,0,1,0
419,2668,0,0,142,142,0,1,0,1,0
1519,917,0,0,142,142,0,1,0,1,0
2794,1274,0,0,131,131,0,1,0,1,0
19412,2646,0,0,121,121,0,1,0,1,0
2067,183,8275,121,293,223,70,4,0,3,1
1993,3095,0,0,154,154,0,1,0,1,0
1771,650,0,0,114,114,0,1,0,1,0
2590,183,9625,121,293,223,70,4,0,3,1
8314,1489,0,0,147,147,0,1,0,1,0
1127,1176,0,0,140,140,0,1,0,1,0
5941,384,0,0,146,146,0,1,0,1,0
1535,869,0,0,143,143,0,1,0,1,0
8148,1141,0,0,156,156,0,1,0,1,0
2961,1694,0,0,62,62,0,1,0,1,0
3040,1679,0,0,64,64,0,1,0,1,0
542,845,1191,40,192,169,23,1,0,1,0
1574,449,1005,27,181,165,16,1,0,1,0
8302,1437,0,0,149,149,0,1,0,1,0
10285,1548,0,0,74,74,0,1,0,1,0
4556,362,0,0,146,146,0,1,0,1,0
15286,2449,0,0,106,106,0,1,0,1,0
14240,273,0,0,143,143,0,1,0,1,0
8283,1351,0,0,151,151,0,1,0,1,0
2364,227,0,0,62,62,0,1,0,1,0
1416,421,1112,37,193,171,21,1,0,1,0
2229,576,0,0,101,101,0,1,0,1,0
9940,1543,0,0,87,87,0,1,0,1,0
3038,1694,0,0,62,62,0,1,0,1,0
4337,183,14518,121,293,223,70,4,0,3,1
8935,1543,0,0,125,125,0,1,0,1,0
2915,1192,0,0,145,145,0,1,0,1,0
10160,1450,0,0,86,86,0,1,0,1,0
11222,1694,0,0,70,70,0,1,0,1,0
1850,1176,0,0,142,142,0,1,0,1,0
779,3095,0,0,139,139,0,1,0,1,0
2866,183,10693,121,293,223,70,4,0,3,1
4421,183,15683,121,293,223,70,4,0,3,1
2785,1573,0,0,80,80,0,1,0,1,0
1497,981,0,0,141,141,0,1,0,1,0
269,1872,0,0,144,144,0,1,0,1,0
1962,183,7595,121,293,223,70,4,0,3,1
4128,415,0,0,146,146,0,1,0,1,0
2877,1694,0,0,62,62,0,1,0,1,0
7741,2447,0,0,99,99,0,1,0,1,0
7290,3025,0,0,63,63,0,1,0,1,0
9842,1601,0,0,94,94,0,1,0,1,0
8881,1286,0,0,131,131,0,1,0,1,0
1971,183,8073,121,293,223,70,4,0,3,1
2507,1338,0,0,62,62,0,1,0,1,0
835,3095,0,0,139,139,0,1,0,1,0
1078,1176,0,0,148,148,0,1,0,1,0
1712,1176,0,0,141,141,0,1,0,1,0
7457,2959,0,0,62,62,0,1,0,1,0
946,183,3770,121,293,223,70,4,0,3,1
986,2824,0,0,141,141,0,1,0,1,0
1956,856,0,0,66,66,0,1,0,1,0
2174,1539,0,0,86,86,0,1,0,1,0
9071,1294,0,0,126,126,0,1,0,1,0
9027,1543,0,0,120,120,0,1,0,1,0
8742,2332,0,0,66,66,0,1,0,1,0
11401,1664,0,0,62,62,0,1,0,1,0
4821,335,0,0,146,146,0,1,0,1,0
4372,183,14840,121,293,223,70,4,0,3,1
1994,784,0,0,62,62,0,1,0,1,0
2945,1694,0,0,62,62,0,1,0,1,0
1938,1095,0,0,123,123,0,1,0,1,0
8901,183,19211,121,293,223,70,4,0,3,1
5864,332,0,0,146,146,0,1,0,1,0
2221,3095,0,0,158,158,0,1,0,1,0
2377,1383,0,0,110,110,0,1,0,1,0
11140,1610,0,0,62,62,0,1,0,1,0
1388,183,4767,121,293,223,70,4,1,3,1
17104,2156,0,0,145,145,0,1,0,1,0
2019,183,7900,121,293,223,70,4,0,3,1
4907,183,16428,121,293,223,70,4,1,3,1
8327,1677,0,0,146,146,0,1,0,1,0
1402,711,0,0,150,150,0,1,0,1,0
1895,183,7300,121,293,223,70,4,0,3,1
806,875,1083,36,198,176,21,1,0,1,0
2030,730,0,0,62,62,0,1,0,1,0
6459,668,0,0,146,146,0,1,0,1,0
1683,2679,0,0,116,116,0,1,0,1,0
1035,183,3961,121,293,223,70,4,1,3,1
1396,183,4808,121,293,223,70,4,1,3,1
246,2411,0,0,144,144,0,1,0,1,0
10202,1579,0,0,82,82,0,1,0,1,0
1742,183,6496,121,293,223,70,4,0,3,1
11158,1613,0,0,65,65,0,1,0,1,0
8791,1659,0,0,129,129,0,1,0,1,0
1371,3095,0,0,143,143,0,1,0,1,0
14278,2245,0,0,94,94,0,1,0,1,0
8059,2665,0,0,64,64,0,1,0,1,0
14220,293,0,0,142,142,0,1,0,1,0
18231,183,26177,121,293,223,70,4,0,3,1
1892,1176,0,0,142,142,0,1,0,1,0
898,183,3589,121,293,223,70,4,1,3,1
1577,183,6429,121,293,223,70,4,0,3,1
9905,1464,0,0,90,90,0,1,0,1,0
8245,1188,0,0,156,156,0,1,0,1,0
2520,183,8885,121,293,223,70,4,1,3,1
1827,707,0,0,98,98,0,1,0,1,0
7787,2056,0,0,112,112,0,1,0,1,0
2222,1610,0,0,75,75,0,1,0,1,0
21373,1700,0,0,70,70,0,1,0,1,0
3997,183,14248,121,293,223,70,4,0,3,1
761,1190,0,0,156,156,0,1,0,1,0
9521,1621,0,0,105,105,0,1,0,1,0
345,2558,0,0,143,143,0,1,0,1,0
660,1176,0,0,153,153,0,1,0,1,0
2176,183,8796,121,293,223,70,4,0,3,1
2929,1229,0,0,139,139,0,1,0,1,0
1857,1176,0,0,142,142,0,1,0,1,0
3718,183,13115,121,293,223,70,4,0,3,1
2170,183,8773,121,293,223,70,4,0,3,1
2736,1694,0,0,62,62,0,1,0,1,0
1944,1015,0,0,104,104,0,1,0,1,0
2971,1694,0,0,62,62,0,1,0,1,0
1846,3095,0,0,149,149,0,1,0,1,0
321,2104,0,0,147,147,0,1,0,1,0
1413,3095,0,0,139,139,0,1,0,1,0
4938,183,16466,121,293,223,70,4,1,3,1
2932,1694,0,0,62,62,0,1,0,1,0
21161,1543,0,0,62,62,0,1,0,1,0
1034,183,4121,121,293,223,70,4,0,3,1
1378,183,4896,121,293,223,70,4,1,3,1
1877,891,0,0,73,73,0,1,0,1,0
2505,1694,0,0,62,62,0,1,0,1,0
1905,183,6547,121,293,223,70,4,1,3,1
2922,1204,0,0,143,143,0,1,0,1,0
1382,183,4736,121,293,223,70,4,1,3,1
369,1046,0,0,152,152,0,1,0,1,0
11257,1376,0,0,72,72,0,1,0,1,0
13491,183,20208,121,293,223,70,4,0,3,1
2376,1613,0,0,75,75,0,1,0,1,0
2094,1262,0,0,129,129,0,1,0,1,0
2744,183,10303,121,293,223,70,4,0,3,1
40,1014,0,0,156,156,0,1,0,1,0
2357,237,0,0,62,62,0,1,0,1,0
13595,482,0,0,131,131,0,1,0,1,0
1939,183,7472,121,293,223,70,4,0,3,1
1152,1176,0,0,140,140,0,1,0,1,0
953,183,3809,121,293,223,70,4,0,3,1
939,1176,0,0,152,152,0,1,0,1,0
8317,1501,0,0,147,147,0,1,0,1,0
21170,1798,0,0,75,75,0,1,0,1,0
992,227,3120,105,274,213,61,3,0,2,0
1224,183,4217,121,293,223,70,4,1,3,1
1796,183,7090,121,293,223,70,4,0,3,1
2183,1176,0,0,144,144,0,1,0,1,0
2129,183,8731,121,293,223,70,4,0,3,1
2089,183,8320,121,293,223,70,4,0,3,1
998,1176,0,0,154,154,0,1,0,1,0
7693,2238,0,0,103,103,0,1,0,1,0
1556,556,0,0,148,148,0,1,0,1,0
10931,1568,0,0,62,62,0,1,0,1,0
8626,1675,0,0,135,135,0,1,0,1,0
9109,1694,0,0,125,125,0,1,0,1,0
3418,183,11403,121,293,223,70,4,1,3,1
6502,542,0,0,149,149,0,1,0,1,0
5537,301,0,0,146,146,0,1,0,1,0
3579,1068,0,0,102,102,0,1,0,1,0
8080,1895,0,0,126,126,0,1,0,1,0
2785,183,10228,121,293,223,70,4,0,3,1
10886,1558,0,0,62,62,0,1,0,1,0
2840,183,10083,121,293,223,70,4,0,3,1
4938,183,16277,121,293,223,70,4,1,3,1
1848,909,0,0,77,77,0,1,0,1,0
4215,396,0,0,146,146,0,1,0,1,0
9712,1386,0,0,102,102,0,1,0,1,0
16980,1613,0,0,62,62,0,1,0,1,0
19761,183,27318,121,293,223,70,4,0,3,1
867,394,2816,95,263,208,55,3,0,2,0
1356,183,4609,121,293,223,70,4,1,3,1
2553,1694,0,0,62,62,0,1,0,1,0
676,3050,0,0,139,139,0,1,0,1,0
917,183,3624,121,293,223,70,4,1,3,1
986,183,3917,121,293,223,70,4,0,3,1
1728,606,0,0,126,126,0,1,0,1,0
2019,183,7903,121,293,223,70,4,0,3,1
1694,183,6266,121,293,223,70,4,0,3,1
2105,974,0,0,62,62,0,1,0,1,0
14910,183,22026,121,293,223,70,4,0,3,1
1509,1125,0,0,127,127,0,1,0,1,0
1411,284,3103,85,250,201,49,3,0,2,0
319,1515,0,0,143,143,0,1,0,1,0
1881,687,0,0,106,106,0,1,0,1,0
7532,917,0,0,153,153,0,1,0,1,0
1484,1176,0,0,139,139,0,1,0,1,0
482,1176,0,0,147,147,0,1,0,1,0
297,1669,0,0,143,143,0,1,0,1,0
3489,1083,0,0,101,101,0,1,0,1,0
1412,1176,0,0,139,139,0,1,0,1,0
1847,910,0,0,78,78,0,1,0,1,0
2989,1472,0,0,98,98,0,1,0,1,0
2751,1464,0,0,62,62,0,1,0,1,0
1774,810,0,0,145,145,0,1,0,1,0
20563,2091,0,0,91,91,0,1,0,1,0
2915,1186,0,0,146,146,0,1,0,1,0
928,183,3717,121,293,223,70,4,0,3,1
1943,619,0,0,102,102,0,1,0,1,0
8265,1274,0,0,154,154,0,1,0,1,0
235,2119,0,0,144,144,0,1,0,1,0
1693,183,6254,121,293,223,70,4,0,3,1
10835,1603,0,0,67,67,0,1,0,1,0
8308,1579,0,0,148,148,0,1,0,1,0
1923,183,7384,121,293,223,70,4,0,3,1
4697,348,0,0,146,146,0,1,0,1,0
1996,1271,0,0,128,128,0,1,0,1,0
2332,367,0,0,87,87,0,1,0,1,0
11327,1666,0,0,63,63,0,1,0,1,0
2060,183,8154,121,293,223,70,4,0,3,1
4378,380,0,0,146,146,0,1,0,1,0
722,506,2412,81,244,196,47,3,0,2,0
1598,555,0,0,147,147,0,1,0,1,0
1462,183,5132,121,293,223,70,4,0,3,1
1530,1176,0,0,139,139,0,1,0,1,0
8267,1328,0,0,153,153,0,1,0,1,0
639,2995,0,0,139,139,0,1,0,1,0
490,1060,0,0,150,150,0,1,0,1,0
1655,1032,0,0,106,106,0,1,0,1,0
7647,1209,0,0,146,146,0,1,0,1,0
2781,1694,0,0,62,62,0,1,0,1,0
1363,397,1363,46,203,176,26,2,0,1,0
2905,1510,0,0,92,92,0,1,0,1,0
1702,183,6305,121,293,223,70,4,0,3,1
1608,1062,0,0,113,113,0,1,0,1,0
2074,1569,0,0,80,80,0,1,0,1,0
2394,1423,0,0,104,104,0,1,0,1,0
1857,737,0,0,90,90,0,1,0,1,0
2147,1614,0,0,73,73,0,1,0,1,0
1838,414,0,0,129,129,0,1,0,1,0
2247,2968,0,0,150,150,0,1,0,1,0
8327,1623,0,0,146,146,0,1,0,1,0
10403,1543,0,0,71,71,0,1,0,1,0
2364,226,0,0,62,62,0,1,0,1,0
2416,61,0,0,71,71,0,1,0,1,0
2998,1508,0,0,92,92,0,1,0,1,0
7626,951,0,0,154,154,0,1,0,1,0
2912,1284,0,0,130,130,0,1,0,1,0
259,2431,0,0,144,144,0,1,0,1,0
1047,971,0,0,154,154,0,1,0,1,0
1734,982,0,0,94,94,0,1,0,1,0
1717,865,0,0,118,118,0,1,0,1,0
11645,1543,0,0,62,62,0,1,0,1,0
10755,1593,0,0,68,68,0,1,0,1,0
10061,1491,0,0,84,84,0,1,0,1,0
1541,416,1428,39,195,172,22,1,0,1,0
985,183,3827,121,293,223,70,4,1,3,1
395,1949,0,0,149,149,0,1,0,1,0
1320,3095,0,0,142,142,0,1,0,1,0
2914,1226,0,0,139,139,0,1,0,1,0
2193,1833,0,0,69,69,0,1,0,1,0
1051,1176,0,0,140,140,0,1,0,1,0
1787,1176,0,0,141,141,0,1,0,1,0
6436,518,0,0,149,149,0,1,0,1,0
2337,1694,0,0,62,62,0,1,0,1,0
8258,1270,0,0,154,154,0,1,0,1,0
226,2182,0,0,144,144,0,1,0,1,0
1743,183,6498,121,293,223,70,4,0,3,1
2074,664,0,0,62,62,0,1,0,1,0
13554,2098,0,0,91,91,0,1,0,1,0
18263,2946,0,0,145,145,0,1,0,1,0
1833,919,0,0,80,80,0,1,0,1,0
787,3095,0,0,139,139,0,1,0,1,0
1987,3095,0,0,152,152,0,1,0,1,0
2905,1488,0,0,96,96,0,1,0,1,0
12839,566,0,0,145,145,0,1,0,1,0
11322,1665,0,0,63,63,0,1,0,1,0
1327,3095,0,0,142,142,0,1,0,1,0
4475,183,15827,121,293,223,70,4,1,3,1
2972,1694,0,0,62,62,0,1,0,1,0
2061,921,0,0,62,62,0,1,0,1,0
1521,3095,0,0,141,141,0,1,0,1,0
1738,183,6688,121,293,223,70,4,0,3,1
4688,183,16156,121,293,223,70,4,1,3,1
10968,1575,0,0,62,62,0,1,0,1,0
1224,1176,0,0,144,144,0,1,0,1,0
17402,2359,0,0,145,145,0,1,0,1,0
1349,183,4818,121,293,223,70,4,1,3,1
20314,1300,0,0,77,77,0,1,0,1,0
4770,183,16258,121,293,223,70,4,1,3,1
2809,1694,0,0,62,62,0,1,0,1,0
4113,183,14680,121,293,223,70,4,0,3,1
9264,1636,0,0,114,114,0,1,0,1,0
7938,2194,0,0,114,114,0,1,0,1,0
910,2778,0,0,141,141,0,1,0,1,0
8157,1341,0,0,148,148,0,1,0,1,0
1158,3095,0,0,141,141,0,1,0,1,0
1854,1434,0,0,100,100,0,1,0,1,0
1627,599,0,0,147,147,0,1,0,1,0
2566,1459,0,0,100,100,0,1,0,1,0
1745,624,0,0,121,121,0,1,0,1,0
2085,1247,0,0,131,131,0,1,0,1,0
10679,1543,0,0,64,64,0,1,0,1,0
2619,1176,0,0,146,146,0,1,0,1,0
7417,2771,0,0,76,76,0,1,0,1,0
1682,2679,0,0,116,116,0,1,0,1,0
1923,1154,0,0,143,143,0,1,0,1,0
12122,721,0,0,145,145,0,1,0,1,0
9424,1999,0,0,68,68,0,1,0,1,0
9211,1628,0,0,113,113,0,1,0,1,0
2480,67,0,0,66,66,0,1,0,1,0
1926,183,7544,121,293,223,70,4,0,3,1
429,1057,426,14,160,152,8,1,0,1,0
1287,1176,0,0,150,150,0,1,0,1,0
1492,995,0,0,141,141,0,1,0,1,0
7952,2078,0,0,116,116,0,1,0,1,0
2985,1694,0,0,62,62,0,1,0,1,0
8771,1543,0,0,129,129,0,1,0,1,0
3448,183,12427,121,293,223,70,4,0,3,1
1260,350,1849,62,222,186,36,2,0,2,0
9192,1629,0,0,114,114,0,1,0,1,0
8951,1277,0,0,130,130,0,1,0,1,0
1286,362,1727,58,217,184,33,2,0,1,0
177,1082,0,0,150,150,0,1,0,1,0
391,1128,172,5,150,146,3,1,0,1,0
1355,227,3823,105,274,213,61,3,0,2,0
15609,2514,0,0,110,110,0,1,0,1,0
1577,183,6237,121,293,223,70,4,0,3,1
1622,615,0,0,146,146,0,1,0,1,0
2856,1001,0,0,135,135,0,1,0,1,0
14412,321,0,0,145,145,0,1,0,1,0
1442,589,0,0,149,149,0,1,0,1,0
2081,654,0,0,62,62,0,1,0,1,0
4726,183,16203,121,293,223,70,4,1,3,1
9389,1629,0,0,110,110,0,1,0,1,0
2069,672,0,0,62,62,0,1,0,1,0
4634,183,16089,121,293,223,70,4,1,3,1
2520,1176,0,0,145,145,0,1,0,1,0
1354,1176,0,0,141,141,0,1,0,1,0
1142,296,2407,81,245,198,47,3,0,2,0
1233,183,4502,121,293,223,70,4,1,3,1
304,2415,0,0,144,144,0,1,0,1,0
7940,2096,0,0,115,115,0,1,0,1,0
2402,169,0,0,62,62,0,1,0,1,0
3434,1237,0,0,91,91,0,1,0,1,0
852,263,3290,111,280,216,64,3,0,2,0
2360,1375,0,0,111,111,0,1,0,1,0
1513,183,5383,121,293,223,70,4,0,3,1
606,1176,0,0,151,151,0,1,0,1,0
9728,1589,0,0,95,95,0,1,0,1,0
4435,374,0,0,146,146,0,1,0,1,0
17435,1543,0,0,65,65,0,1,0,1,0
3627,183,13327,121,293,223,70,4,0,3,1
2245,1748,0,0,64,64,0,1,0,1,0
2760,1301,0,0,127,127,0,1,0,1,0
743,1957,0,0,149,149,0,1,0,1,0
13892,465,0,0,132,132,0,1,0,1,0
1866,183,7246,121,293,223,70,4,0,3,1
7381,2895,0,0,70,70,0,1,0,1,0
2075,183,8213,121,293,223,70,4,0,3,1
13446,2076,0,0,90,90,0,1,0,1,0
2026,1226,0,0,135,135,0,1,0,1,0
8271,1354,0,0,153,153,0,1,0,1,0
11307,1663,0,0,64,64,0,1,0,1,0
10118,1561,0,0,80,80,0,1,0,1,0
8262,1259,0,0,154,154,0,1,0,1,0
9999,1543,0,0,85,85,0,1,0,1,0
4075,183,13855,121,293,223,70,4,0,3,1
3037,1694,0,0,62,62,0,1,0,1,0
331,2432,0,0,144,144,0,1,0,1,0
2188,183,8866,121,293,223,70,4,0,3,1
2041,1063,0,0,62,62,0,1,0,1,0
14404,266,0,0,143,143,0,1,0,1,0
8294,1494,0,0,150,150,0,1,0,1,0
1578,183,5713,121,293,223,70,4,0,3,1
10654,183,20520,121,293,223,70,4,0,3,1
2643,2240,0,0,99,99,0,1,0,1,0
3810,183,12659,121,293,223,70,4,1,3,1
2799,1176,0,0,147,147,0,1,0,1,0
1317,3025,0,0,139,139,0,1,0,1,0
1580,183,5708,121,293,223,70,4,0,3,1
1362,3095,0,0,141,141,0,1,0,1,0
2037,1546,0,0,83,83,0,1,0,1,0
16666,1857,0,0,145,145,0,1,0,1,0
4409,183,15627,121,293,223,70,4,0,3,1
2988,1694,0,0,62,62,0,1,0,1,0
1217,183,4459,121,293,223,70,4,1,3,1
4799,338,0,0,146,146,0,1,0,1,0
7669,967,0,0,154,154,0,1,0,1,0
14209,280,0,0,143,143,0,1,0,1,0
4620,183,16072,121,293,223,70,4,1,3,1
1433,183,4995,121,293,223,70,4,0,3,1
16842,2763,0,0,127,127,0,1,0,1,0
1558,183,5595,121,293,223,70,4,0,3,1
2810,1261,0,0,133,133,0,1,0,1,0
7322,2955,0,0,66,66,0,1,0,1,0
2328,202,0,0,75,75,0,1,0,1,0
9353,183,19548,121,293,223,70,4,0,3,1
7660,2860,0,0,63,63,0,1,0,1,0
2008,183,7840,121,293,223,70,4,0,3,1
2163,183,8738,121,293,223,70,4,0,3,1
17339,1543,0,0,62,62,0,1,0,1,0
3036,1694,0,0,62,62,0,1,0,1,0
10778,1543,0,0,62,62,0,1,0,1,0
895,183,3580,121,293,223,70,4,1,3,1
9576,1601,0,0,100,100,0,1,0,1,0
7704,2494,0,0,96,96,0,1,0,1,0
1383,3095,0,0,141,141,0,1,0,1,0
21551,1045,10407,44,146,120,25,2,0,1,0
2001,183,7803,121,293,223,70,4,0,3,1
1968,183,7626,121,293,223,70,4,0,3,1
799,3095,0,0,139,139,0,1,0,1,0
1368,3095,0,0,139,139,0,1,0,1,0
1058,3095,0,0,139,139,0,1,0,1,0
1012,2880,0,0,143,143,0,1,0,1,0
9624,1597,0,0,98,98,0,1,0,1,0
1730,183,6659,121,293,223,70,4,0,3,1
2857,1694,0,0,62,62,0,1,0,1,0
3415,183,10434,121,293,223,70,4,0,3,1
11399,1664,0,0,62,62,0,1,0,1,0
1387,3095,0,0,140,140,0,1,0,1,0
4014,370,0,0,139,139,0,1,0,1,0
8065,1518,0,0,139,139,0,1,0,1,0
579,1132,0,0,157,157,0,1,0,1,0
12283,1683,0,0,62,62,0,1,0,1,0
4845,183,16351,121,293,223,70,4,1,3,1
1421,3095,0,0,139,139,0,1,0,1,0
1830,183,7063,121,293,223,70,4,0,3,1
2029,1030,0,0,62,62,0,1,0,1,0
13801,513,0,0,129,129,0,1,0,1,0
10532,1559,0,0,71,71,0,1,0,1,0
2914,1223,0,0,140,140,0,1,0,1,0
1219,331,2043,69,230,190,39,2,0,2,0
329,1439,0,0,143,143,0,1,0,1,0
3038,1672,0,0,65,65,0,1,0,1,0
987,183,3832,121,293,223,70,4,1,3,1
21451,712,17385,73,203,160,42,2,0,2,0
8277,1388,0,0,152,152,0,1,0,1,0
2039,183,7708,121,293,223,70,4,0,3,1
1291,183,4348,121,293,223,70,4,1,3,1
1787,666,0,0,109,109,0,1,0,1,0
2453,1418,0,0,105,105,0,1,0,1,0
1633,584,0,0,147,147,0,1,0,1,0
2323,1176,0,0,144,144,0,1,0,1,0
1064,183,3908,121,293,223,70,4,1,3,1
1794,183,6896,121,293,223,70,4,0,3,1
1436,309,2779,76,239,195,44,2,0,2,0
13305,2048,0,0,89,89,0,1,0,1,0
16492,1739,0,0,145,145,0,1,0,1,0
1527,1114,0,0,124,124,0,1,0,1,0
9761,1587,0,0,93,93,0,1,0,1,0
2200,1810,0,0,68,68,0,1,0,1,0
1053,1176,0,0,149,149,0,1,0,1,0
344,1042,0,0,152,152,0,1,0,1,0
15607,2513,0,0,113,113,0,1,0,1,0
4556,183,15993,121,293,223,70,4,1,3,1
3475,183,12275,121,293,223,70,4,1,3,1
8748,1543,0,0,130,130,0,1,0,1,0
10848,1551,0,0,62,62,0,1,0,1,0
10904,1612,0,0,67,67,0,1,0,1,0
3015,1577,0,0,81,81,0,1,0,1,0
793,1157,0,0,156,156,0,1,0,1,0
9411,1613,0,0,106,106,0,1,0,1,0
549,1176,0,0,149,149,0,1,0,1,0
7211,1081,0,0,146,146,0,1,0,1,0
3344,1233,0,0,91,91,0,1,0,1,0
3008,1550,0,0,85,85,0,1,0,1,0
997,183,3858,121,293,223,70,4,1,3,1
2912,1268,0,0,132,132,0,1,0,1,0
1552,557,0,0,148,148,0,1,0,1,0
10138,1543,0,0,84,84,0,1,0,1,0
2748,1613,0,0,74,74,0,1,0,1,0
939,3095,0,0,140,140,0,1,0,1,0
10645,1543,0,0,65,65,0,1,0,1,0
978,183,3886,121,293,223,70,4,0,3,1
3715,296,0,0,123,123,0,1,0,1,0
10986,1579,0,0,62,62,0,1,0,1,0
1649,535,0,0,147,147,0,1,0,1,0
12016,1447,0,0,76,76,0,1,0,1,0
781,3095,0,0,139,139,0,1,0,1,0
125,1779,0,0,150,150,0,1,0,1,0
1253,183,4899,121,293,223,70,4,0,3,1
10465,1643,0,0,90,90,0,1,0,1,0
1600,476,667,18,170,159,10,1,0,1,0
2826,1654,0,0,68,68,0,1,0,1,0
1910,370,0,0,122,122,0,1,0,1,0
719,2716,0,0,142,142,0,1,0,1,0
1965,828,0,0,62,62,0,1,0,1,0
10657,1543,0,0,65,65,0,1,0,1,0
2176,183,8793,121,293,223,70,4,0,3,1
7607,2620,0,0,88,88,0,1,0,1,0
9288,1635,0,0,113,113,0,1,0,1,0
9839,1613,0,0,106,106,0,1,0,1,0
10618,1554,0,0,68,68,0,1,0,1,0
1188,1176,0,0,145,145,0,1,0,1,0
3370,183,11653,121,293,223,70,4,0,3,1
2089,1411,0,0,106,106,0,1,0,1,0
8620,1241,0,0,141,141,0,1,0,1,0
9689,1592,0,0,96,96,0,1,0,1,0
7538,2671,0,0,83,83,0,1,0,1,0
1607,1063,0,0,113,113,0,1,0,1,0
2932,1694,0,0,62,62,0,1,0,1,0
2271,1676,0,0,62,62,0,1,0,1,0
1005,183,3794,121,293,223,70,4,1,3,1
7873,2191,0,0,109,109,0,1,0,1,0
2211,1176,0,0,144,144,0,1,0,1,0
2050,183,8070,121,293,223,70,4,0,3,1
8763,1661,0,0,130,130,0,1,0,1,0
10640,1543,0,0,65,65,0,1,0,1,0
2621,1414,0,0,108,108,0,1,0,1,0
10208,1554,0,0,77,77,0,1,0,1,0
2923,1206,0,0,142,142,0,1,0,1,0
10579,1543,0,0,67,67,0,1,0,1,0
4697,183,16167,121,293,223,70,4,1,3,1
11131,1641,0,0,65,65,0,1,0,1,0
1092,183,4347,121,293,223,70,4,0,3,1
10227,1578,0,0,81,81,0,1,0,1,0
1320,183,4738,121,293,223,70,4,1,3,1
1798,183,6770,121,293,223,70,4,0,3,1
7691,183,14746,121,293,223,70,4,0,3,1
18308,2976,0,0,145,145,0,1,0,1,0
51,1019,0,0,155,155,0,1,0,1,0
2768,1694,0,0,62,62,0,1,0,1,0
15025,2396,0,0,103,103,0,1,0,1,0
8327,1600,0,0,146,146,0,1,0,1,0
20472,183,27595,121,293,223,70,4,0,3,1
3955,183,13125,121,293,223,70,4,1,3,1
1094,183,4358,121,293,223,70,4,0,3,1
7715,984,0,0,154,154,0,1,0,1,0
1657,541,0,0,147,147,0,1,0,1,0
1711,1176,0,0,141,141,0,1,0,1,0
1971,183,7659,121,293,223,70,4,0,3,1
9063,1543,0,0,119,119,0,1,0,1,0
3621,183,13108,121,293,223,70,4,0,3,1
1315,183,5129,121,293,223,70,4,0,3,1
3291,183,11622,121,293,223,70,4,0,3,1
20645,2051,0,0,89,89,0,1,0,1,0
9229,1694,0,0,122,122,0,1,0,1,0
3680,921,0,0,147,147,0,1,0,1,0
486,1176,0,0,147,147,0,1,0,1,0
16724,1897,0,0,145,145,0,1,0,1,0
2903,1545,0,0,86,86,0,1,0,1,0
1989,1260,0,0,129,129,0,1,0,1,0
8327,1583,0,0,146,146,0,1,0,1,0
1792,183,6864,121,293,223,70,4,0,3,1
7432,2742,0,0,77,77,0,1,0,1,0
1359,183,4625,121,293,223,70,4,1,3,1
2206,3095,0,0,158,158,0,1,0,1,0
1469,183,5171,121,293,223,70,4,0,3,1
4387,183,15555,121,293,223,70,4,0,3,1
1423,183,4938,121,293,223,70,4,1,3,1
1737,183,6508,121,293,223,70,4,0,3,1
9233,1543,0,0,115,115,0,1,0,1,0
613,711,1673,56,213,180,32,2,0,1,0
2676,1405,0,0,62,62,0,1,0,1,0
2009,1291,0,0,124,124,0,1,0,1,0
20609,2069,0,0,90,90,0,1,0,1,0
1893,183,6658,121,293,223,70,4,1,3,1
8163,1777,0,0,132,132,0,1,0,1,0
2256,1637,0,0,62,62,0,1,0,1,0
1357,183,4611,121,293,223,70,4,1,3,1
7918,2734,0,0,64,64,0,1,0,1,0
1205,1176,0,0,151,151,0,1,0,1,0
2206,1035,0,0,62,62,0,1,0,1,0
902,746,0,0,152,152,0,1,0,1,0
946,3095,0,0,140,140,0,1,0,1,0
2233,183,9130,121,293,223,70,4,0,3,1
8287,1368,0,0,151,151,0,1,0,1,0
8320,1514,0,0,146,146,0,1,0,1,0
3713,183,13306,121,293,223,70,4,0,3,1
2499,1694,0,0,62,62,0,1,0,1,0
10341,1476,0,0,79,79,0,1,0,1,0
1720,3095,0,0,146,146,0,1,0,1,0
557,2873,0,0,140,140,0,1,0,1,0
841,604,2059,69,235,194,40,2,0,2,0
1909,790,0,0,75,75,0,1,0,1,0
7599,942,0,0,154,154,0,1,0,1,0
727,3095,0,0,139,139,0,1,0,1,0
60,1024,0,0,155,155,0,1,0,1,0
6329,597,0,0,146,146,0,1,0,1,0
1628,2769,0,0,121,121,0,1,0,1,0
21246,1762,0,0,73,73,0,1,0,1,0
9886,1616,0,0,105,105,0,1,0,1,0
4408,183,14576,121,293,223,70,4,1,3,1
3270,953,0,0,147,147,0,1,0,1,0
21074,1844,0,0,78,78,0,1,0,1,0
1936,183,7462,121,293,223,70,4,0,3,1
2140,183,8608,121,293,223,70,4,0,3,1
1809,2470,0,0,104,104,0,1,0,1,0
14541,1649,0,0,62,62,0,1,0,1,0
12534,1176,0,0,91,91,0,1,0,1,0
1651,1310,0,0,118,118,0,1,0,1,0
2252,183,9233,121,293,223,70,4,0,3,1
2840,1662,0,0,66,66,0,1,0,1,0
2550,1377,0,0,62,62,0,1,0,1,0
15829,2559,0,0,113,113,0,1,0,1,0
2527,1491,0,0,95,95,0,1,0,1,0
373,1995,0,0,148,148,0,1,0,1,0
1383,183,4744,121,293,223,70,4,1,3,1
7298,3018,0,0,63,63,0,1,0,1,0
2743,672,0,0,111,111,0,1,0,1,0
13463,560,0,0,124,124,0,1,0,1,0
2015,183,8006,121,293,223,70,4,0,3,1
10284,1543,0,0,74,74,0,1,0,1,0
8549,1543,0,0,137,137,0,1,0,1,0
1936,1133,0,0,132,132,0,1,0,1,0
4059,505,0,0,139,139,0,1,0,1,0
4575,183,16016,121,293,223,70,4,1,3,1
2586,211,0,0,77,77,0,1,0,1,0
2240,1061,0,0,62,62,0,1,0,1,0
17773,2612,0,0,145,145,0,1,0,1,0
2111,183,8417,121,293,223,70,4,0,3,1
3011,1562,0,0,83,83,0,1,0,1,0
1409,183,4872,121,293,223,70,4,1,3,1
1352,3095,0,0,142,142,0,1,0,1,0
1534,409,1510,41,197,173,24,2,0,1,0
1696,3095,0,0,151,151,0,1,0,1,0
1050,3095,0,0,139,139,0,1,0,1,0
1581,2732,0,0,122,122,0,1,0,1,0
11165,1616,0,0,62,62,0,1,0,1,0
2916,1176,0,0,147,147,0,1,0,1,0
95,1020,0,0,157,157,0,1,0,1,0
2897,183,10953,121,293,223,70,4,0,3,1
1478,352,2233,61,221,186,35,2,0,2,0
2709,1694,0,0,62,62,0,1,0,1,0
2014,891,0,0,62,62,0,1,0,1,0
21544,1023,10865,46,150,123,26,2,0,1,0
18050,3012,0,0,141,141,0,1,0,1,0
40,1014,0,0,156,156,0,1,0,1,0
7985,2702,0,0,64,64,0,1,0,1,0
11273,1638,0,0,62,62,0,1,0,1,0
1948,1199,0,0,139,139,0,1,0,1,0
1727,702,0,0,146,146,0,1,0,1,0
1953,183,7546,121,293,223,70,4,0,3,1
233,1110,0,0,148,148,0,1,0,1,0
2627,183,9264,121,293,223,70,4,1,3,1
759,3095,0,0,139,139,0,1,0,1,0
343,1340,0,0,143,143,0,1,0,1,0
2340,263,0,0,62,62,0,1,0,1,0
5646,253,0,0,146,146,0,1,0,1,0
1462,1083,0,0,140,140,0,1,0,1,0
4955,322,0,0,146,146,0,1,0,1,0
10417,1543,0,0,70,70,0,1,0,1,0
11597,1702,0,0,70,70,0,1,0,1,0
4475,183,15838,121,293,223,70,4,0,3,1
8305,1562,0,0,148,148,0,1,0,1,0
2903,1562,0,0,83,83,0,1,0,1,0
341,1163,0,0,143,143,0,1,0,1,0
1237,3095,0,0,139,139,0,1,0,1,0
1656,183,6080,121,293,223,70,4,0,3,1
1263,2992,0,0,139,139,0,1,0,1,0
4474,370,0,0,146,146,0,1,0,1,0
6760,2139,0,0,89,89,0,1,0,1,0
1335,206,4086,112,283,217,65,3,0,2,0
7332,2966,0,0,66,66,0,1,0,1,0
9990,1425,0,0,92,92,0,1,0,1,0
868,3095,0,0,139,139,0,1,0,1,0
4868,183,16380,121,293,223,70,4,1,3,1
2685,502,0,0,98,98,0,1,0,1,0
4926,183,16452,121,293,223,70,4,1,3,1
2912,1283,0,0,130,130,0,1,0,1,0
1357,3095,0,0,142,142,0,1,0,1,0
545,839,1213,41,193,170,23,2,0,1,0
8107,1975,0,0,128,128,0,1,0,1,0
7363,2921,0,0,69,69,0,1,0,1,0
1558,1176,0,0,140,140,0,1,0,1,0
453,1830,0,0,150,150,0,1,0,1,0
327,1156,0,0,144,144,0,1,0,1,0
5439,333,0,0,146,146,0,1,0,1,0
257,2384,0,0,144,144,0,1,0,1,0
1598,183,5817,121,293,223,70,4,0,3,1
1451,183,5096,121,293,223,70,4,1,3,1
1779,1176,0,0,141,141,0,1,0,1,0
1341,183,4534,121,293,223,70,4,1,3,1
1285,361,1731,58,218,184,33,2,0,1,0
2197,183,8925,121,293,223,70,4,0,3,1
2212,1654,0,0,67,67,0,1,0,1,0
1687,3095,0,0,149,149,0,1,0,1,0
47,1017,0,0,155,155,0,1,0,1,0
13844,490,0,0,131,131,0,1,0,1,0
870,3095,0,0,140,140,0,1,0,1,0
3296,183,11922,121,293,223,70,4,0,3,1
2914,1220,0,0,140,140,0,1,0,1,0
2925,1694,0,0,62,62,0,1,0,1,0
7987,2028,0,0,118,118,0,1,0,1,0
1243,183,5034,121,293,223,70,4,0,3,1
10625,1543,0,0,66,66,0,1,0,1,0
2814,1258,0,0,134,134,0,1,0,1,0
2917,1675,0,0,63,63,0,1,0,1,0
17439,2884,0,0,132,132,0,1,0,1,0
1417,183,4911,121,293,223,70,4,1,3,1
2437,1694,0,0,62,62,0,1,0,1,0
9467,1609,0,0,104,104,0,1,0,1,0
5675,250,0,0,146,146,0,1,0,1,0
2032,1039,0,0,62,62,0,1,0,1,0
1686,1176,0,0,141,141,0,1,0,1,0
2940,1276,0,0,131,131,0,1,0,1,0
8049,1939,0,0,123,123,0,1,0,1,0
7361,2923,0,0,68,68,0,1,0,1,0
7804,2022,0,0,114,114,0,1,0,1,0
2176,1541,0,0,85,85,0,1,0,1,0
9103,1325,0,0,122,122,0,1,0,1,0
11970,1113,0,0,89,89,0,1,0,1,0
21363,422,23457,99,252,194,57,3,0,2,0
1861,901,0,0,76,76,0,1,0,1,0
2165,1524,0,0,88,88,0,1,0,1,0
4184,183,14906,121,293,223,70,4,0,3,1
8000,2114,0,0,119,119,0,1,0,1,0
1169,1176,0,0,146,146,0,1,0,1,0
2944,1694,0,0,62,62,0,1,0,1,0
2904,1540,0,0,87,87,0,1,0,1,0
1677,1176,0,0,140,140,0,1,0,1,0
2049,940,0,0,126,126,0,1,0,1,0
9142,1543,0,0,116,116,0,1,0,1,0
8327,1576,0,0,146,146,0,1,0,1,0
120,1748,0,0,150,150,0,1,0,1,0
1652,528,0,0,147,147,0,1,0,1,0
17251,2256,0,0,145,145,0,1,0,1,0
1978,1083,0,0,136,136,0,1,0,1,0
1520,183,5409,121,293,223,70,4,0,3,1
8605,2399,0,0,66,66,0,1,0,1,0
4220,395,0,0,146,146,0,1,0,1,0
10342,1539,0,0,72,72,0,1,0,1,0
1548,183,6125,121,293,223,70,4,0,3,1
2103,1228,0,0,62,62,0,1,0,1,0
2931,183,10901,121,293,223,70,4,0,3,1
1458,183,5656,121,293,223,70,4,0,3,1
1635,183,6033,121,293,223,70,4,0,3,1
9791,183,20061,121,293,223,70,4,0,3,1
10436,1543,0,0,70,70,0,1,0,1,0
2072,183,8191,121,293,223,70,4,0,3,1
2195,183,8917,121,293,223,70,4,0,3,1
1353,183,4593,121,293,223,70,4,1,3,1
1915,183,7340,121,293,223,70,4,0,3,1
854,503,2425,81,249,201,47,3,0,2,0
1916,1138,0,0,143,143,0,1,0,1,0
2078,183,8256,121,293,223,70,4,0,3,1
1228,1176,0,0,139,139,0,1,0,1,0
7864,1315,0,0,146,146,0,1,0,1,0
1904,2312,0,0,95,95,0,1,0,1,0
2628,337,0,0,86,86,0,1,0,1,0
8251,1212,0,0,155,155,0,1,0,1,0
1636,1176,0,0,146,146,0,1,0,1,0
7073,750,0,0,151,151,0,1,0,1,0
8277,1325,0,0,152,152,0,1,0,1,0
1725,183,6416,121,293,223,70,4,0,3,1
1518,183,5405,121,293,223,70,4,0,3,1
11001,1624,0,0,66,66,0,1,0,1,0
12836,792,0,0,110,110,0,1,0,1,0
2059,1110,0,0,62,62,0,1,0,1,0
2899,1689,0,0,62,62,0,1,0,1,0
1755,3095,0,0,146,146,0,1,0,1,0
1017,712,0,0,151,151,0,1,0,1,0
1206,3095,0,0,139,139,0,1,0,1,0
11233,1630,0,0,62,62,0,1,0,1,0
680,3055,0,0,139,139,0,1,0,1,0
628,2606,0,0,142,142,0,1,0,1,0
4257,392,0,0,146,146,0,1,0,1,0
11774,183,21356,121,293,223,70,4,0,3,1
1188,2996,0,0,143,143,0,1,0,1,0
1520,394,1702,46,204,177,27,2,0,1,0
3083,141,0,0,91,91,0,1,0,1,0
2495,1517,0,0,91,91,0,1,0,1,0
6749,2119,0,0,89,89,0,1,0,1,0
2449,1555,0,0,85,85,0,1,0,1,0
2921,1694,0,0,62,62,0,1,0,1,0
397,1090,0,0,157,157,0,1,0,1,0
16095,2612,0,0,116,116,0,1,0,1,0
2936,1694,0,0,62,62,0,1,0,1,0
3436,183,12034,121,293,223,70,4,0,3,1
2299,2977,0,0,150,150,0,1,0,1,0
2091,1196,0,0,62,62,0,1,0,1,0
1504,379,1897,52,210,180,30,2,0,1,0
1125,3095,0,0,139,139,0,1,0,1,0
2705,1590,0,0,78,78,0,1,0,1,0
1942,1047,0,0,112,112,0,1,0,1,0
1557,2886,0,0,127,127,0,1,0,1,0
16353,183,23236,121,293,223,70,4,0,3,1
2550,1377,0,0,62,62,0,1,0,1,0
11019,1586,0,0,62,62,0,1,0,1,0
2010,760,0,0,62,62,0,1,0,1,0
2111,1248,0,0,62,62,0,1,0,1,0
2093,183,8315,121,293,223,70,4,0,3,1
2166,183,8738,121,293,223,70,4,0,3,1
8327,1583,0,0,146,146,0,1,0,1,0
1784,183,6806,121,293,223,70,4,0,3,1
2067,1378,0,0,111,111,0,1,0,1,0
3810,614,0,0,146,146,0,1,0,1,0
1113,922,0,0,153,153,0,1,0,1,0
193,1090,0,0,149,149,0,1,0,1,0
3579,183,12972,121,293,223,70,4,0,3,1
8660,1669,0,0,133,133,0,1,0,1,0
2817,1515,0,0,62,62,0,1,0,1,0
2387,1176,0,0,145,145,0,1,0,1,0
1725,698,0,0,146,146,0,1,0,1,0
1719,683,0,0,146,146,0,1,0,1,0
14419,2273,0,0,101,101,0,1,0,1,0
162,1074,0,0,151,151,0,1,0,1,0
1384,3095,0,0,139,139,0,1,0,1,0
10664,1543,0,0,66,66,0,1,0,1,0
2058,3095,0,0,155,155,0,1,0,1,0
1373,3095,0,0,141,141,0,1,0,1,0
1275,183,4617,121,293,223,70,4,1,3,1
1477,656,0,0,149,149,0,1,0,1,0
1505,183,5336,121,293,223,70,4,0,3,1
527,1176,0,0,142,142,0,1,0,1,0
11207,1624,0,0,62,62,0,1,0,1,0
2573,2391,0,0,110,110,0,1,0,1,0
7963,1716,0,0,129,129,0,1,0,1,0
2472,2607,0,0,125,125,0,1,0,1,0
503,2793,0,0,141,141,0,1,0,1,0
2914,1230,0,0,139,139,0,1,0,1,0
1325,183,4454,121,293,223,70,4,1,3,1
1508,949,0,0,142,142,0,1,0,1,0
2146,183,8642,121,293,223,70,4,0,3,1
1680,557,0,0,140,140,0,1,0,1,0
103,1618,0,0,151,151,0,1,0,1,0
9078,1694,0,0,126,126,0,1,0,1,0
9338,1694,0,0,119,119,0,1,0,1,0
1180,183,4133,121,293,223,70,4,1,3,1
9705,1607,0,0,110,110,0,1,0,1,0
1801,1176,0,0,141,141,0,1,0,1,0
10885,1558,0,0,62,62,0,1,0,1,0
10090,1675,0,0,71,71,0,1,0,1,0
772,3095,0,0,139,139,0,1,0,1,0
1935,183,7497,121,293,223,70,4,0,3,1
1447,321,2636,72,235,193,42,2,0,2,0
1543,846,0,0,143,143,0,1,0,1,0
2915,1176,0,0,147,147,0,1,0,1,0
12982,942,0,0,105,105,0,1,0,1,0
1786,183,6711,121,293,223,70,4,0,3,1
2073,183,8200,121,293,223,70,4,0,3,1
730,2342,0,0,146,146,0,1,0,1,0
1805,435,0,0,132,132,0,1,0,1,0
1829,1176,0,0,142,142,0,1,0,1,0
2231,1054,0,0,62,62,0,1,0,1,0
433,882,0,0,154,154,0,1,0,1,0
3508,183,12239,121,293,223,70,4,0,3,1
131,1822,0,0,149,149,0,1,0,1,0
1435,1176,0,0,139,139,0,1,0,1,0
385,2459,0,0,144,144,0,1,0,1,0
1399,1176,0,0,139,139,0,1,0,1,0
3014,1694,0,0,62,62,0,1,0,1,0
11087,1600,0,0,62,62,0,1,0,1,0
3022,1694,0,0,62,62,0,1,0,1,0
1907,183,7360,121,293,223,70,4,0,3,1
8521,1543,0,0,138,138,0,1,0,1,0
1927,183,7404,121,293,223,70,4,0,3,1
1629,183,5971,121,293,223,70,4,0,3,1
1803,3095,0,0,148,148,0,1,0,1,0
8327,1685,0,0,146,146,0,1,0,1,0
2566,1694,0,0,62,62,0,1,0,1,0
2389,1420,0,0,104,104,0,1,0,1,0
1023,241,2970,100,268,210,58,3,0,2,0
2447,1284,0,0,62,62,0,1,0,1,0
2343,1641,0,0,70,70,0,1,0,1,0
5077,183,12110,121,293,223,70,4,0,3,1
2013,756,0,0,62,62,0,1,0,1,0
10146,1543,0,0,84,84,0,1,0,1,0
1075,1176,0,0,148,148,0,1,0,1,0
8315,1491,0,0,147,147,0,1,0,1,0
3581,1065,0,0,102,102,0,1,0,1,0
373,1176,0,0,142,142,0,1,0,1,0
8311,1475,0,0,148,148,0,1,0,1,0
15160,2460,0,0,115,115,0,1,0,1,0
1867,1024,0,0,144,144,0,1,0,1,0
2165,3095,0,0,157,157,0,1,0,1,0
1863,183,7137,121,293,223,70,4,0,3,1
2360,1375,0,0,111,111,0,1,0,1,0
1396,603,0,0,149,149,0,1,0,1,0
2931,1694,0,0,62,62,0,1,0,1,0
11829,1061,0,0,99,99,0,1,0,1,0
1379,3095,0,0,139,139,0,1,0,1,0
3541,1030,0,0,105,105,0,1,0,1,0
7982,2137,0,0,118,118,0,1,0,1,0
893,1176,0,0,141,141,0,1,0,1,0
18867,2908,0,0,135,135,0,1,0,1,0
156,2008,0,0,148,148,0,1,0,1,0
9602,1543,0,0,99,99,0,1,0,1,0
1947,1491,0,0,92,92,0,1,0,1,0
9285,1635,0,0,113,113,0,1,0,1,0
10704,1543,0,0,64,64,0,1,0,1,0
2501,1332,0,0,62,62,0,1,0,1,0
8327,1640,0,0,146,146,0,1,0,1,0
9431,1694,0,0,117,117,0,1,0,1,0
1147,1176,0,0,146,146,0,1,0,1,0
1593,183,5767,121,293,223,70,4,0,3,1
9027,1311,0,0,125,125,0,1,0,1,0
8327,1591,0,0,146,146,0,1,0,1,0
1852,3095,0,0,153,153,0,1,0,1,0
726,499,2437,82,245,197,47,3,0,2,0
1083,183,4313,121,293,223,70,4,0,3,1
11196,1622,0,0,62,62,0,1,0,1,0
763,3095,0,0,139,139,0,1,0,1,0
2906,1468,0,0,99,99,0,1,0,1,0
1619,1055,0,0,111,111,0,1,0,1,0
135,1853,0,0,149,149,0,1,0,1,0
1472,3095,0,0,145,145,0,1,0,1,0
3450,183,11891,121,293,223,70,4,0,3,1
1651,183,6117,121,293,223,70,4,0,3,1
805,954,0,0,144,144,0,1,0,1,0
1889,183,7267,121,293,223,70,4,0,3,1
1392,3095,0,0,140,140,0,1,0,1,0
310,1070,0,0,157,157,0,1,0,1,0
4032,183,14420,121,293,223,70,4,0,3,1
1420,3095,0,0,139,139,0,1,0,1,0
900,183,3591,121,293,223,70,4,1,3,1
9630,1543,0,0,98,98,0,1,0,1,0
1980,183,7724,121,293,223,70,4,0,3,1
1428,3095,0,0,139,139,0,1,0,1,0
2264,377,0,0,62,62,0,1,0,1,0
1227,1176,0,0,151,151,0,1,0,1,0
1949,845,0,0,63,63,0,1,0,1,0
1035,707,0,0,151,151,0,1,0,1,0
4512,183,15938,121,293,223,70,4,1,3,1
2969,1392,0,0,112,112,0,1,0,1,0
2495,1517,0,0,91,91,0,1,0,1,0
1935,817,0,0,68,68,0,1,0,1,0
16826,183,25200,121,293,223,70,4,0,3,1
8282,1421,0,0,151,151,0,1,0,1,0
8303,1546,0,0,149,149,0,1,0,1,0
1224,3095,0,0,142,142,0,1,0,1,0
1999,183,7792,121,293,223,70,4,0,3,1
3541,183,12160,121,293,223,70,4,0,3,1
1285,183,4643,121,293,223,70,4,1,3,1
4362,183,15507,121,293,223,70,4,0,3,1
2200,1487,0,0,62,62,0,1,0,1,0
2420,2719,0,0,133,133,0,1,0,1,0
1985,183,7734,121,293,223,70,4,0,3,1
1431,183,4978,121,293,223,70,4,1,3,1
6379,498,0,0,148,148,0,1,0,1,0
2251,2807,0,0,139,139,0,1,0,1,0
937,202,3379,114,284,218,66,3,0,2,0
1357,3095,0,0,142,142,0,1,0,1,0
990,1176,0,0,154,154,0,1,0,1,0
2921,1199,0,0,144,144,0,1,0,1,0
1684,183,6243,121,293,223,70,4,0,3,1
2165,183,8415,121,293,223,70,4,0,3,1
233,2368,0,0,144,144,0,1,0,1,0
1388,3095,0,0,140,140,0,1,0,1,0
9641,1596,0,0,98,98,0,1,0,1,0
1959,340,0,0,117,117,0,1,0,1,0
1342,183,4547,121,293,223,70,4,0,3,1
9633,1897,0,0,69,69,0,1,0,1,0
1344,183,4554,121,293,223,70,4,0,3,1
9392,1543,0,0,109,109,0,1,0,1,0
1717,680,0,0,146,146,0,1,0,1,0
7193,2905,0,0,66,66,0,1,0,1,0
5795,428,0,0,140,140,0,1,0,1,0
1878,1176,0,0,142,142,0,1,0,1,0
11293,1661,0,0,64,64,0,1,0,1,0
910,183,3621,121,293,223,70,4,1,3,1
2216,1043,0,0,62,62,0,1,0,1,0
1331,203,4130,113,284,218,65,3,0,2,0
8692,1543,0,0,132,132,0,1,0,1,0
10677,1543,0,0,64,64,0,1,0,1,0
96,1041,0,0,153,153,0,1,0,1,0
2223,3095,0,0,158,158,0,1,0,1,0
4811,183,16309,121,293,223,70,4,1,3,1
1343,3095,0,0,142,142,0,1,0,1,0
9192,1629,0,0,114,114,0,1,0,1,0
1696,183,6271,121,293,223,70,4,0,3,1
1317,376,1582,53,212,181,30,2,0,1,0
2429,52,0,0,70,70,0,1,0,1,0
8427,1543,0,0,142,142,0,1,0,1,0
17731,2583,0,0,145,145,0,1,0,1,0
186,2225,0,0,146,146,0,1,0,1,0
1758,2469,0,0,106,106,0,1,0,1,0
10622,1576,0,0,69,69,0,1,0,1,0
2915,1190,0,0,145,145,0,1,0,1,0
1847,727,0,0,93,93,0,1,0,1,0
2171,517,0,0,62,62,0,1,0,1,0
2192,183,8899,121,293,223,70,4,0,3,1
81,1465,0,0,152,152,0,1,0,1,0
9160,1335,0,0,120,120,0,1,0,1,0
927,3095,0,0,140,140,0,1,0,1,0
1062,3095,0,0,141,141,0,1,0,1,0
1410,650,0,0,147,147,0,1,0,1,0
1458,3095,0,0,145,145,0,1,0,1,0
1446,1165,0,0,136,136,0,1,0,1,0
1477,1040,0,0,140,140,0,1,0,1,0
2401,1394,0,0,108,108,0,1,0,1,0
2321,1694,0,0,62,62,0,1,0,1,0
634,1176,0,0,152,152,0,1,0,1,0
8327,1587,0,0,146,146,0,1,0,1,0
1757,1375,0,0,109,109,0,1,0,1,0
6995,888,0,0,146,146,0,1,0,1,0
1170,183,4114,121,293,223,70,4,1,3,1
1538,183,5495,121,293,223,70,4,0,3,1
1720,487,0,0,141,141,0,1,0,1,0
13467,687,0,0,119,119,0,1,0,1,0
2834,1694,0,0,62,62,0,1,0,1,0
2022,183,7694,121,293,223,70,4,0,3,1
13127,865,0,0,109,109,0,1,0,1,0
7785,2317,0,0,102,102,0,1,0,1,0
8327,1593,0,0,146,146,0,1,0,1,0
15419,1636,0,0,62,62,0,1,0,1,0
9649,1595,0,0,97,97,0,1,0,1,0
1369,241,3641,100,268,210,58,3,0,2,0
9252,1320,0,0,119,119,0,1,0,1,0
1955,878,0,0,71,71,0,1,0,1,0
8271,1353,0,0,153,153,0,1,0,1,0
7640,956,0,0,154,154,0,1,0,1,0
5019,474,0,0,146,146,0,1,0,1,0
2252,528,0,0,98,98,0,1,0,1,0
16341,1636,0,0,145,145,0,1,0,1,0
1852,1176,0,0,143,143,0,1,0,1,0
8327,1548,0,0,146,146,0,1,0,1,0
1804,684,0,0,105,105,0,1,0,1,0
1539,183,5520,121,293,223,70,4,0,3,1
15138,2419,0,0,104,104,0,1,0,1,0
7946,2720,0,0,64,64,0,1,0,1,0
1330,183,5277,121,293,223,70,4,0,3,1
9555,1602,0,0,101,101,0,1,0,1,0
10351,1477,0,0,78,78,0,1,0,1,0
1625,183,5982,121,293,223,70,4,0,3,1
1532,563,0,0,148,148,0,1,0,1,0
1858,183,7192,121,293,223,70,4,0,3,1
1597,183,5835,121,293,223,70,4,0,3,1
1797,942,0,0,85,85,0,1,0,1,0
58,1023,0,0,155,155,0,1,0,1,0
1801,3095,0,0,148,148,0,1,0,1,0
1946,995,0,0,99,99,0,1,0,1,0
939,183,3666,121,293,223,70,4,1,3,1
2353,99,0,0,77,77,0,1,0,1,0
11782,1570,0,0,69,69,0,1,0,1,0
1700,1176,0,0,141,141,0,1,0,1,0
8492,1683,0,0,140,140,0,1,0,1,0
5158,302,0,0,146,146,0,1,0,1,0
1354,3095,0,0,142,142,0,1,0,1,0
1267,3095,0,0,142,142,0,1,0,1,0
7977,2042,0,0,118,118,0,1,0,1,0
3009,1694,0,0,62,62,0,1,0,1,0
683,3060,0,0,139,139,0,1,0,1,0
20107,2311,0,0,103,103,0,1,0,1,0
1513,183,5380,121,293,223,70,4,0,3,1
1652,183,6738,121,293,223,70,4,0,3,1
1932,3095,0,0,154,154,0,1,0,1,0
4953,183,16486,121,293,223,70,4,1,3,1
849,1176,0,0,141,141,0,1,0,1,0
16189,183,23315,121,293,223,70,4,0,3,1
2671,1694,0,0,62,62,0,1,0,1,0
409,2653,0,0,142,142,0,1,0,1,0
2125,239,0,0,100,100,0,1,0,1,0
18997,2846,0,0,131,131,0,1,0,1,0
2883,91,0,0,80,80,0,1,0,1,0
1132,2959,0,0,143,143,0,1,0,1,0
4109,183,14148,121,293,223,70,4,0,3,1
48,1018,0,0,155,155,0,1,0,1,0
895,3095,0,0,141,141,0,1,0,1,0
8327,1645,0,0,146,146,0,1,0,1,0
611,1500,0,0,153,153,0,1,0,1,0
2976,1694,0,0,62,62,0,1,0,1,0
4596,183,16042,121,293,223,70,4,1,3,1
121,1755,0,0,150,150,0,1,0,1,0
13187,662,0,0,118,118,0,1,0,1,0
14541,409,0,0,145,145,0,1,0,1,0
14567,427,0,0,145,145,0,1,0,1,0
1193,1176,0,0,151,151,0,1,0,1,0
8246,1191,0,0,156,156,0,1,0,1,0
3535,183,12487,121,293,223,70,4,1,3,1
1582,497,328,11,161,154,6,1,0,1,0
2757,1565,0,0,62,62,0,1,0,1,0
912,183,3614,121,293,223,70,4,1,3,1
764,3095,0,0,139,139,0,1,0,1,0
10898,1561,0,0,62,62,0,1,0,1,0
19956,2384,0,0,106,106,0,1,0,1,0
2139,230,0,0,99,99,0,1,0,1,0
2900,1636,0,0,71,71,0,1,0,1,0
1995,3095,0,0,152,152,0,1,0,1,0
7662,2297,0,0,100,100,0,1,0,1,0
20743,2004,0,0,86,86,0,1,0,1,0
10513,1543,0,0,68,68,0,1,0,1,0
1513,183,5390,121,293,223,70,4,0,3,1
10902,1562,0,0,62,62,0,1,0,1,0
10154,1543,0,0,79,79,0,1,0,1,0
439,2698,0,0,142,142,0,1,0,1,0
17541,2915,0,0,136,136,0,1,0,1,0
8663,1543,0,0,134,134,0,1,0,1,0
1498,183,6097,121,293,223,70,4,0,3,1
1692,183,6252,121,293,223,70,4,0,3,1
8243,1180,0,0,156,156,0,1,0,1,0
9332,1543,0,0,111,111,0,1,0,1,0
635,2611,0,0,142,142,0,1,0,1,0
3366,1210,0,0,93,93,0,1,0,1,0
8235,1673,0,0,138,138,0,1,0,1,0
2507,2531,0,0,119,119,0,1,0,1,0
1265,183,4946,121,293,223,70,4,0,3,1
1819,3095,0,0,151,151,0,1,0,1,0
19582,2564,0,0,116,116,0,1,0,1,0
1391,1176,0,0,139,139,0,1,0,1,0
611,2953,0,0,140,140,0,1,0,1,0
2307,312,0,0,62,62,0,1,0,1,0
971,3095,0,0,142,142,0,1,0,1,0
841,599,2080,70,236,195,40,2,0,2,0
10747,1694,0,0,82,82,0,1,0,1,0
1748,973,0,0,92,92,0,1,0,1,0
1731,183,6839,121,293,223,70,4,0,3,1
11119,1294,0,0,86,86,0,1,0,1,0
184,1085,0,0,150,150,0,1,0,1,0
2928,183,10893,121,293,223,70,4,0,3,1
1491,183,5778,121,293,223,70,4,0,3,1
7698,2503,0,0,95,95,0,1,0,1,0
218,2358,0,0,144,144,0,1,0,1,0
1796,1399,0,0,105,105,0,1,0,1,0
2000,873,0,0,62,62,0,1,0,1,0
2043,1550,0,0,83,83,0,1,0,1,0
1365,183,4652,121,293,223,70,4,1,3,1
1557,183,5654,121,293,223,70,4,0,3,1
8327,1588,0,0,146,146,0,1,0,1,0
189,1088,0,0,150,150,0,1,0,1,0
1454,1106,0,0,139,139,0,1,0,1,0
592,1176,0,0,150,150,0,1,0,1,0
9942,1470,0,0,88,88,0,1,0,1,0
2236,3095,0,0,158,158,0,1,0,1,0
16885,2007,0,0,145,145,0,1,0,1,0
5123,439,0,0,146,146,0,1,0,1,0
4712,183,15632,121,293,223,70,4,0,3,1
1722,990,0,0,96,96,0,1,0,1,0
17162,2195,0,0,145,145,0,1,0,1,0
1909,183,7812,121,293,223,70,4,0,3,1
1434,183,4994,121,293,223,70,4,1,3,1
15780,2548,0,0,115,115,0,1,0,1,0
650,1080,0,0,148,148,0,1,0,1,0
9250,1625,0,0,112,112,0,1,0,1,0
11014,1626,0,0,66,66,0,1,0,1,0
1948,183,7519,121,293,223,70,4,0,3,1
4507,183,15022,121,293,223,70,4,0,3,1
8327,1670,0,0,146,146,0,1,0,1,0
8327,1662,0,0,146,146,0,1,0,1,0
1447,1176,0,0,139,139,0,1,0,1,0
13718,556,0,0,127,127,0,1,0,1,0
1461,1194,0,0,136,136,0,1,0,1,0
2162,1521,0,0,89,89,0,1,0,1,0
2878,1206,0,0,142,142,0,1,0,1,0
2465,1694,0,0,62,62,0,1,0,1,0
1325,196,4214,116,287,220,67,3,0,2,0
773,1131,161,5,163,159,3,1,0,1,0
8327,1657,0,0,146,146,0,1,0,1,0
2197,183,8953,121,293,223,70,4,0,3,1
977,1176,0,0,151,151,0,1,0,1,0
2648,1559,0,0,82,82,0,1,0,1,0
1732,1176,0,0,141,141,0,1,0,1,0
1722,692,0,0,146,146,0,1,0,1,0
1121,795,0,0,145,145,0,1,0,1,0
1425,3095,0,0,148,148,0,1,0,1,0
1689,1176,0,0,141,141,0,1,0,1,0
2976,1420,0,0,107,107,0,1,0,1,0
1755,183,6561,121,293,223,70,4,0,3,1
2251,1176,0,0,144,144,0,1,0,1,0
1812,183,6962,121,293,223,70,4,0,3,1
2698,541,0,0,101,101,0,1,0,1,0
2712,2093,0,0,89,89,0,1,0,1,0
184,954,0,0,156,156,0,1,0,1,0
2212,1791,0,0,67,67,0,1,0,1,0
11371,1671,0,0,63,63,0,1,0,1,0
7957,2070,0,0,116,116,0,1,0,1,0
1457,1099,0,0,140,140,0,1,0,1,0
2123,590,0,0,62,62,0,1,0,1,0
2997,1694,0,0,62,62,0,1,0,1,0
2812,1259,0,0,134,134,0,1,0,1,0
2055,692,0,0,62,62,0,1,0,1,0
590,1545,0,0,153,153,0,1,0,1,0
1903,183,7339,121,293,223,70,4,0,3,1
1447,435,965,32,187,168,18,1,0,1,0
9737,1434,0,0,97,97,0,1,0,1,0
1361,3095,0,0,142,142,0,1,0,1,0
3999,366,0,0,138,138,0,1,0,1,0
1956,183,7560,121,293,223,70,4,0,3,1
8159,1337,0,0,148,148,0,1,0,1,0
2906,1476,0,0,98,98,0,1,0,1,0
1565,183,5648,121,293,223,70,4,0,3,1
11501,1688,0,0,62,62,0,1,0,1,0
2967,1694,0,0,62,62,0,1,0,1,0
1345,183,4553,121,293,223,70,4,1,3,1
4853,332,0,0,146,146,0,1,0,1,0
2634,1176,0,0,146,146,0,1,0,1,0
4169,183,14740,121,293,223,70,4,1,3,1
10638,1518,0,0,68,68,0,1,0,1,0
1428,3095,0,0,139,139,0,1,0,1,0
1583,730,0,0,145,145,0,1,0,1,0
1095,3095,0,0,141,141,0,1,0,1,0
1777,3095,0,0,147,147,0,1,0,1,0
1875,3095,0,0,152,152,0,1,0,1,0
12363,886,0,0,109,109,0,1,0,1,0
1555,1096,0,0,120,120,0,1,0,1,0
2726,622,0,0,107,107,0,1,0,1,0
2000,3095,0,0,154,154,0,1,0,1,0
8223,1691,0,0,137,137,0,1,0,1,0
2744,673,0,0,111,111,0,1,0,1,0
1315,183,4406,121,293,223,70,4,1,3,1
9081,1638,0,0,118,118,0,1,0,1,0
14372,2309,0,0,108,108,0,1,0,1,0
9593,1409,0,0,102,102,0,1,0,1,0
4936,183,16465,121,293,223,70,4,1,3,1
1487,183,5292,121,293,223,70,4,0,3,1
896,1082,0,0,155,155,0,1,0,1,0
5589,283,0,0,146,146,0,1,0,1,0
7199,1075,0,0,146,146,0,1,0,1,0
10915,1694,0,0,78,78,0,1,0,1,0
993,3095,0,0,139,139,0,1,0,1,0
1956,866,0,0,68,68,0,1,0,1,0
3010,1694,0,0,62,62,0,1,0,1,0
2444,1281,0,0,62,62,0,1,0,1,0
1808,183,6864,121,293,223,70,4,0,3,1
11313,1645,0,0,67,67,0,1,0,1,0
2100,183,8610,121,293,223,70,4,0,3,1
2876,1061,0,0,139,139,0,1,0,1,0
2211,183,9072,121,293,223,70,4,0,3,1
1647,941,0,0,123,123,0,1,0,1,0
277,1819,0,0,144,144,0,1,0,1,0
11363,1656,0,0,62,62,0,1,0,1,0
2199,3095,0,0,157,157,0,1,0,1,0
1517,3095,0,0,149,149,0,1,0,1,0
12539,1173,0,0,91,91,0,1,0,1,0
17396,789,0,0,110,110,0,1,0,1,0
4334,384,0,0,146,146,0,1,0,1,0
12952,957,0,0,104,104,0,1,0,1,0
8327,1606,0,0,146,146,0,1,0,1,0
1415,183,4998,121,293,223,70,4,1,3,1
1271,183,4967,121,293,223,70,4,0,3,1
10662,1581,0,0,69,69,0,1,0,1,0
11047,1670,0,0,75,75,0,1,0,1,0
1986,796,0,0,62,62,0,1,0,1,0
1952,1186,0,0,141,141,0,1,0,1,0
140,1888,0,0,149,149,0,1,0,1,0
2114,183,8439,121,293,223,70,4,0,3,1
429,2683,0,0,142,142,0,1,0,1,0
299,1142,0,0,145,145,0,1,0,1,0
18702,2988,0,0,139,139,0,1,0,1,0
1324,3095,0,0,147,147,0,1,0,1,0
10474,1505,0,0,74,74,0,1,0,1,0
1146,183,4067,121,293,223,70,4,1,3,1
869,1102,0,0,155,155,0,1,0,1,0
1459,1093,0,0,140,140,0,1,0,1,0
9581,1407,0,0,103,103,0,1,0,1,0
1879,183,7217,121,293,223,70,4,0,3,1
1909,790,0,0,75,75,0,1,0,1,0
8720,1457,0,0,145,145,0,1,0,1,0
1291,183,4348,121,293,223,70,4,1,3,1
9367,1616,0,0,108,108,0,1,0,1,0
637,1145,0,0,157,157,0,1,0,1,0
1786,183,6865,121,293,223,70,4,0,3,1
4819,336,0,0,146,146,0,1,0,1,0
2270,494,0,0,96,96,0,1,0,1,0
4396,681,0,0,146,146,0,1,0,1,0
2606,183,9671,121,293,223,70,4,0,3,1
1847,979,0,0,144,144,0,1,0,1,0
3315,1042,0,0,147,147,0,1,0,1,0
1987,1257,0,0,130,130,0,1,0,1,0
2020,183,8034,121,293,223,70,4,0,3,1
1860,1176,0,0,142,142,0,1,0,1,0
1995,183,7579,121,293,223,70,4,0,3,1
1424,183,4938,121,293,223,70,4,0,3,1
13560,410,0,0,145,145,0,1,0,1,0
1002,855,0,0,145,145,0,1,0,1,0
9563,1543,0,0,100,100,0,1,0,1,0
18597,1589,0,0,62,62,0,1,0,1,0
979,1176,0,0,151,151,0,1,0,1,0
353,1269,0,0,143,143,0,1,0,1,0
2810,1694,0,0,62,62,0,1,0,1,0
1067,3095,0,0,141,141,0,1,0,1,0
2035,1176,0,0,143,143,0,1,0,1,0
1264,183,4585,121,293,223,70,4,1,3,1
2461,1459,0,0,98,98,0,1,0,1,0
1281,183,4329,121,293,223,70,4,1,3,1
1568,183,5645,121,293,223,70,4,0,3,1
11263,1636,0,0,62,62,0,1,0,1,0
2171,183,8778,121,293,223,70,4,0,3,1
2246,164,0,0,88,88,0,1,0,1,0
1957,841,0,0,62,62,0,1,0,1,0
2197,1479,0,0,62,62,0,1,0,1,0
1590,183,5776,121,293,223,70,4,0,3,1
10898,1561,0,0,62,62,0,1,0,1,0
2352,99,0,0,78,78,0,1,0,1,0
1071,183,4231,121,293,223,70,4,0,3,1
4063,455,0,0,146,146,0,1,0,1,0
1511,1176,0,0,148,148,0,1,0,1,0
9050,1640,0,0,119,119,0,1,0,1,0
2826,1694,0,0,62,62,0,1,0,1,0
10945,1617,0,0,67,67,0,1,0,1,0
9625,1694,0,0,112,112,0,1,0,1,0
790,3095,0,0,139,139,0,1,0,1,0
4061,381,0,0,141,141,0,1,0,1,0
292,2165,0,0,146,146,0,1,0,1,0
1510,3095,0,0,146,146,0,1,0,1,0
1875,892,0,0,74,74,0,1,0,1,0
2077,183,8249,121,293,223,70,4,0,3,1
19027,1543,0,0,62,62,0,1,0,1,0
3496,183,12941,121,293,223,70,4,0,3,1
1537,3095,0,0,141,141,0,1,0,1,0
2243,1601,0,0,62,62,0,1,0,1,0
1797,676,0,0,107,107,0,1,0,1,0
1716,183,7008,121,293,223,70,4,0,3,1
1718,183,6785,121,293,223,70,4,0,3,1
12464,1212,0,0,89,89,0,1,0,1,0
236,2368,0,0,144,144,0,1,0,1,0
8249,1202,0,0,156,156,0,1,0,1,0
355,2574,0,0,143,143,0,1,0,1,0
603,1056,0,0,143,143,0,1,0,1,0
17204,2224,0,0,145,145,0,1,0,1,0
1344,3095,0,0,143,143,0,1,0,1,0
289,2476,0,0,143,143,0,1,0,1,0
1764,1176,0,0,145,145,0,1,0,1,0
8280,1339,0,0,152,152,0,1,0,1,0
2045,908,0,0,62,62,0,1,0,1,0
9830,1582,0,0,91,91,0,1,0,1,0
1909,183,7368,121,293,223,70,4,0,3,1
1797,3095,0,0,151,151,0,1,0,1,0
1202,3095,0,0,145,145,0,1,0,1,0
2260,2445,0,0,114,114,0,1,0,1,0
2058,280,0,0,107,107,0,1,0,1,0
4618,183,16070,121,293,223,70,4,1,3,1
721,3095,0,0,139,139,0,1,0,1,0
6064,183,17339,121,293,223,70,4,0,3,1
7744,2443,0,0,99,99,0,1,0,1,0
1385,258,3433,94,261,206,54,3,0,2,0
338,1374,0,0,143,143,0,1,0,1,0
9188,1694,0,0,123,123,0,1,0,1,0
7088,934,0,0,146,146,0,1,0,1,0
7679,2527,0,0,94,94,0,1,0,1,0
2386,193,0,0,62,62,0,1,0,1,0
1303,3095,0,0,142,142,0,1,0,1,0
1377,3095,0,0,139,139,0,1,0,1,0
3811,183,10833,121,293,223,70,4,0,3,1
1576,1176,0,0,140,140,0,1,0,1,0
1738,727,0,0,146,146,0,1,0,1,0
1547,481,494,16,168,158,9,1,0,1,0
160,1035,0,0,157,157,0,1,0,1,0
1578,183,5717,121,293,223,70,4,0,3,1
8322,1525,0,0,146,146,0,1,0,1,0
10582,1543,0,0,67,67,0,1,0,1,0
2365,1694,0,0,62,62,0,1,0,1,0
8327,1650,0,0,146,146,0,1,0,1,0
2387,191,0,0,62,62,0,1,0,1,0
10901,1561,0,0,62,62,0,1,0,1,0
1458,183,5113,121,293,223,70,4,1,3,1
7866,2286,0,0,109,109,0,1,0,1,0
3291,192,0,0,101,101,0,1,0,1,0
1504,1176,0,0,139,139,0,1,0,1,0
1355,3070,0,0,141,141,0,1,0,1,0
12349,973,0,0,98,98,0,1,0,1,0
1265,641,0,0,150,150,0,1,0,1,0
10165,1629,0,0,98,98,0,1,0,1,0
1545,841,0,0,143,143,0,1,0,1,0
7623,1307,0,0,146,146,0,1,0,1,0
145,1066,0,0,151,151,0,1,0,1,0
17514,2435,0,0,145,145,0,1,0,1,0
3263,183,11542,121,293,223,70,4,0,3,1
1986,183,7738,121,293,223,70,4,0,3,1
20099,183,27259,121,293,223,70,4,0,3,1
7864,2203,0,0,109,109,0,1,0,1,0
9326,1633,0,0,112,112,0,1,0,1,0
2591,1694,0,0,62,62,0,1,0,1,0
1289,183,4653,121,293,223,70,4,1,3,1
16991,1543,0,0,62,62,0,1,0,1,0
7883,2264,0,0,110,110,0,1,0,1,0
2240,1638,0,0,70,70,0,1,0,1,0
1925,183,7395,121,293,223,70,4,0,3,1
1627,602,0,0,146,146,0,1,0,1,0
1365,738,0,0,150,150,0,1,0,1,0
6380,1466,0,0,109,109,0,1,0,1,0
1451,183,5094,121,293,223,70,4,1,3,1
842,763,0,0,152,152,0,1,0,1,0
9500,1393,0,0,106,106,0,1,0,1,0
1980,327,0,0,115,115,0,1,0,1,0
21280,1745,0,0,72,72,0,1,0,1,0
844,575,2163,73,239,196,42,2,0,2,0
4828,183,15973,121,293,223,70,4,0,3,1
1016,848,0,0,145,145,0,1,0,1,0
1373,3095,0,0,147,147,0,1,0,1,0
981,183,3816,121,293,223,70,4,1,3,1
1458,1176,0,0,139,139,0,1,0,1,0
1114,3095,0,0,139,139,0,1,0,1,0
2244,183,9190,121,293,223,70,4,0,3,1
2111,1444,0,0,101,101,0,1,0,1,0
10611,1460,0,0,76,76,0,1,0,1,0
4879,183,16089,121,293,223,70,4,1,3,1
730,2340,0,0,146,146,0,1,0,1,0
12152,1045,0,0,93,93,0,1,0,1,0
735,3095,0,0,139,139,0,1,0,1,0
10149,1543,0,0,79,79,0,1,0,1,0
8990,1543,0,0,121,121,0,1,0,1,0
9511,1395,0,0,106,106,0,1,0,1,0
10445,1543,0,0,70,70,0,1,0,1,0
10347,1476,0,0,79,79,0,1,0,1,0
1446,1129,0,0,139,139,0,1,0,1,0
8822,1258,0,0,135,135,0,1,0,1,0
2395,240,0,0,78,78,0,1,0,1,0
2573,1694,0,0,62,62,0,1,0,1,0
3814,747,0,0,123,123,0,1,0,1,0
1182,872,0,0,152,152,0,1,0,1,0
2611,287,0,0,82,82,0,1,0,1,0
1720,686,0,0,146,146,0,1,0,1,0
1595,693,0,0,145,145,0,1,0,1,0
12181,1361,0,0,81,81,0,1,0,1,0
4670,351,0,0,146,146,0,1,0,1,0
8295,1502,0,0,150,150,0,1,0,1,0
1667,1176,0,0,140,140,0,1,0,1,0
6778,844,0,0,146,146,0,1,0,1,0
2940,1273,0,0,131,131,0,1,0,1,0
425,1176,0,0,145,145,0,1,0,1,0
2778,1287,0,0,129,129,0,1,0,1,0
2072,3095,0,0,154,154,0,1,0,1,0
5434,274,0,0,146,146,0,1,0,1,0
1586,722,0,0,145,145,0,1,0,1,0
2988,1470,0,0,99,99,0,1,0,1,0
16384,2694,0,0,126,126,0,1,0,1,0
8036,2067,0,0,122,122,0,1,0,1,0
1668,183,6138,121,293,223,70,4,0,3,1
1297,3095,0,0,139,139,0,1,0,1,0
14151,183,23246,121,293,223,70,4,0,3,1
5941,688,0,0,132,132,0,1,0,1,0
1955,873,0,0,69,69,0,1,0,1,0
1670,183,6140,121,293,223,70,4,0,3,1
1681,597,0,0,147,147,0,1,0,1,0
8319,1649,0,0,146,146,0,1,0,1,0
1653,2728,0,0,118,118,0,1,0,1,0
2839,183,9544,121,293,223,70,4,1,3,1
1973,1236,0,0,133,133,0,1,0,1,0
2237,183,9153,121,293,223,70,4,0,3,1
4873,183,16386,121,293,223,70,4,1,3,1
8689,1671,0,0,133,133,0,1,0,1,0
2359,980,0,0,98,98,0,1,0,1,0
4275,183,15197,121,293,223,70,4,0,3,1
9465,1979,0,0,69,69,0,1,0,1,0
1822,920,0,0,144,144,0,1,0,1,0
10931,1651,0,0,77,77,0,1,0,1,0
2731,1325,0,0,123,123,0,1,0,1,0
2901,1614,0,0,75,75,0,1,0,1,0
11064,1595,0,0,62,62,0,1,0,1,0
1487,1010,0,0,141,141,0,1,0,1,0
986,3095,0,0,140,140,0,1,0,1,0
1225,1176,0,0,151,151,0,1,0,1,0
2694,2132,0,0,92,92,0,1,0,1,0
1859,183,7068,121,293,223,70,4,0,3,1
1431,3095,0,0,139,139,0,1,0,1,0
1418,183,4908,121,293,223,70,4,0,3,1
2300,2976,0,0,150,150,0,1,0,1,0
769,1160,54,1,159,158,1,1,0,1,0
10521,1563,0,0,70,70,0,1,0,1,0
1953,901,0,0,76,76,0,1,0,1,0
2900,1639,0,0,71,71,0,1,0,1,0
2567,1458,0,0,101,101,0,1,0,1,0
248,1117,0,0,147,147,0,1,0,1,0
1019,183,4064,121,293,223,70,4,0,3,1
1527,894,0,0,142,142,0,1,0,1,0
760,1191,0,0,156,156,0,1,0,1,0
1524,1233,0,0,130,130,0,1,0,1,0
2076,1391,0,0,109,109,0,1,0,1,0
1584,183,5728,121,293,223,70,4,0,3,1
10723,1548,0,0,64,64,0,1,0,1,0
7532,2549,0,0,87,87,0,1,0,1,0
1739,183,6870,121,293,223,70,4,0,3,1
1670,570,0,0,147,147,0,1,0,1,0
1866,183,7231,121,293,223,70,4,0,3,1
264,1125,0,0,147,147,0,1,0,1,0
10450,1560,0,0,72,72,0,1,0,1,0
2747,1116,0,0,132,132,0,1,0,1,0
9163,1582,0,0,124,124,0,1,0,1,0
1983,183,7839,121,293,223,70,4,0,3,1
3686,183,13033,121,293,223,70,4,0,3,1
8510,1543,0,0,139,139,0,1,0,1,0
14301,250,0,0,144,144,0,1,0,1,0
7231,1093,0,0,146,146,0,1,0,1,0
538,2569,0,0,144,144,0,1,0,1,0
2232,183,9120,121,293,223,70,4,0,3,1
12936,965,0,0,103,103,0,1,0,1,0
8462,1683,0,0,141,141,0,1,0,1,0
3280,947,0,0,147,147,0,1,0,1,0
17889,1543,0,0,62,62,0,1,0,1,0
8878,1286,0,0,131,131,0,1,0,1,0
3427,855,0,0,147,147,0,1,0,1,0
4829,183,16332,121,293,223,70,4,1,3,1
6247,1229,0,0,116,116,0,1,0,1,0
2214,183,9014,121,293,223,70,4,0,3,1
17736,1601,0,0,62,62,0,1,0,1,0
1915,183,7502,121,293,223,70,4,0,3,1
2944,1289,0,0,129,129,0,1,0,1,0
14091,361,0,0,138,138,0,1,0,1,0
979,183,3744,121,293,223,70,4,1,3,1
7427,2830,0,0,74,74,0,1,0,1,0
9647,1257,0,0,145,145,0,1,0,1,0
2359,233,0,0,62,62,0,1,0,1,0
543,2852,0,0,140,140,0,1,0,1,0
2156,183,7594,121,293,223,70,4,1,3,1
1221,1176,0,0,144,144,0,1,0,1,0
2454,37,0,0,67,67,0,1,0,1,0
9853,1455,0,0,92,92,0,1,0,1,0
10868,1607,0,0,67,67,0,1,0,1,0
1379,3095,0,0,141,141,0,1,0,1,0
2995,1694,0,0,62,62,0,1,0,1,0
20521,183,27647,121,293,223,70,4,0,3,1
11075,1597,0,0,62,62,0,1,0,1,0
1980,900,0,0,62,62,0,1,0,1,0
9254,1543,0,0,112,112,0,1,0,1,0
4156,402,0,0,146,146,0,1,0,1,0
253,2378,0,0,144,144,0,1,0,1,0
9275,1623,0,0,111,111,0,1,0,1,0
780,3095,0,0,139,139,0,1,0,1,0
1680,183,6194,121,293,223,70,4,0,3,1
1237,183,4244,121,293,223,70,4,1,3,1
4152,402,0,0,146,146,0,1,0,1,0
9396,1543,0,0,109,109,0,1,0,1,0
7654,2863,0,0,63,63,0,1,0,1,0
3360,183,11868,121,293,223,70,4,1,3,1
718,1164,0,0,157,157,0,1,0,1,0
1938,353,0,0,119,119,0,1,0,1,0
2446,74,0,0,66,66,0,1,0,1,0
10597,1649,0,0,86,86,0,1,0,1,0
757,1176,0,0,156,156,0,1,0,1,0
8281,1415,0,0,151,151,0,1,0,1,0
1458,183,5105,121,293,223,70,4,0,3,1
7716,2194,0,0,105,105,0,1,0,1,0
8708,1543,0,0,133,133,0,1,0,1,0
9690,1543,0,0,96,96,0,1,0,1,0
92,1539,0,0,152,152,0,1,0,1,0
6195,1136,0,0,119,119,0,1,0,1,0
12295,992,0,0,97,97,0,1,0,1,0
1940,1071,0,0,117,117,0,1,0,1,0
7359,2939,0,0,68,68,0,1,0,1,0
86,1496,0,0,152,152,0,1,0,1,0
8190,1618,0,0,146,146,0,1,0,1,0
2740,183,9784,121,293,223,70,4,0,3,1
2911,1179,0,0,147,147,0,1,0,1,0
1974,3095,0,0,152,152,0,1,0,1,0
2402,1593,0,0,78,78,0,1,0,1,0
1598,183,5791,121,293,223,70,4,0,3,1
8466,1214,0,0,148,148,0,1,0,1,0
3091,1494,0,0,74,74,0,1,0,1,0
1683,183,6237,121,293,223,70,4,0,3,1
2856,1224,0,0,139,139,0,1,0,1,0
1432,183,5043,121,293,223,70,4,1,3,1
6189,492,0,0,146,146,0,1,0,1,0
353,1264,0,0,143,143,0,1,0,1,0
3499,1161,0,0,96,96,0,1,0,1,0
1042,183,3865,121,293,223,70,4,1,3,1
1972,183,7683,121,293,223,70,4,0,3,1
8952,1572,0,0,129,129,0,1,0,1,0
4939,183,16468,121,293,223,70,4,1,3,1
8780,1543,0,0,129,129,0,1,0,1,0
1439,183,5022,121,293,223,70,4,0,3,1
1992,1519,0,0,87,87,0,1,0,1,0
2552,1048,0,0,115,115,0,1,0,1,0
7309,2997,0,0,64,64,0,1,0,1,0
883,1176,0,0,155,155,0,1,0,1,0
1382,3095,0,0,141,141,0,1,0,1,0
2994,1694,0,0,62,62,0,1,0,1,0
8327,1584,0,0,146,146,0,1,0,1,0
757,1176,0,0,156,156,0,1,0,1,0
18440,183,26332,121,293,223,70,4,0,3,1
2532,1694,0,0,62,62,0,1,0,1,0
7763,2419,0,0,101,101,0,1,0,1,0
1717,1176,0,0,141,141,0,1,0,1,0
3493,183,11641,121,293,223,70,4,1,3,1
1255,1176,0,0,151,151,0,1,0,1,0
374,2461,0,0,144,144,0,1,0,1,0
8258,1274,0,0,154,154,0,1,0,1,0
3606,183,12519,121,293,223,70,4,0,3,1
2481,1176,0,0,145,145,0,1,0,1,0
2178,183,8817,121,293,223,70,4,0,3,1
7646,2329,0,0,98,98,0,1,0,1,0
11128,1291,0,0,86,86,0,1,0,1,0
2092,1199,0,0,62,62,0,1,0,1,0
2997,1507,0,0,92,92,0,1,0,1,0
9407,1377,0,0,110,110,0,1,0,1,0
1355,3095,0,0,142,142,0,1,0,1,0
2887,1683,0,0,62,62,0,1,0,1,0
4679,183,16145,121,293,223,70,4,1,3,1
729,3095,0,0,139,139,0,1,0,1,0
3231,183,11240,121,293,223,70,4,0,3,1
19509,2599,0,0,118,118,0,1,0,1,0
8291,1389,0,0,150,150,0,1,0,1,0
2235,1629,0,0,72,72,0,1,0,1,0
1673,183,6156,121,293,223,70,4,0,3,1
734,1176,0,0,155,155,0,1,0,1,0
8756,1543,0,0,130,130,0,1,0,1,0
11820,1550,0,0,70,70,0,1,0,1,0
1627,962,0,0,125,125,0,1,0,1,0
11374,1694,0,0,66,66,0,1,0,1,0
16972,715,0,0,115,115,0,1,0,1,0
2605,1694,0,0,62,62,0,1,0,1,0
2152,183,8658,121,293,223,70,4,0,3,1
2253,183,9241,121,293,223,70,4,0,3,1
7689,2245,0,0,102,102,0,1,0,1,0
1926,183,7400,121,293,223,70,4,0,3,1
10257,1525,0,0,76,76,0,1,0,1,0
4782,183,15921,121,293,223,70,4,0,3,1
2046,183,8050,121,293,223,70,4,0,3,1
2116,3095,0,0,157,157,0,1,0,1,0
568,2889,0,0,140,140,0,1,0,1,0
1095,3095,0,0,141,141,0,1,0,1,0
9249,1319,0,0,119,119,0,1,0,1,0
1141,1176,0,0,146,146,0,1,0,1,0
13826,500,0,0,130,130,0,1,0,1,0
8327,1604,0,0,146,146,0,1,0,1,0
1002,1004,0,0,154,154,0,1,0,1,0
2430,1176,0,0,145,145,0,1,0,1,0
9213,1314,0,0,121,121,0,1,0,1,0
1695,183,6266,121,293,223,70,4,0,3,1
8164,1903,0,0,133,133,0,1,0,1,0
869,3095,0,0,139,139,0,1,0,1,0
3469,183,12495,121,293,223,70,4,0,3,1
2278,355,0,0,62,62,0,1,0,1,0
5586,284,0,0,146,146,0,1,0,1,0
2227,183,9090,121,293,223,70,4,0,3,1
17452,2887,0,0,132,132,0,1,0,1,0
1787,183,6821,121,293,223,70,4,0,3,1
4956,183,16490,121,293,223,70,4,1,3,1
1642,183,6035,121,293,223,70,4,0,3,1
16102,2640,0,0,123,123,0,1,0,1,0
1630,519,99,3,152,150,1,1,0,1,0
2084,1246,0,0,131,131,0,1,0,1,0
2045,183,8040,121,293,223,70,4,0,3,1
2580,2376,0,0,109,109,0,1,0,1,0
802,909,960,32,193,174,18,1,0,1,0
56,1022,0,0,155,155,0,1,0,1,0
1737,183,6505,121,293,223,70,4,0,3,1
2832,1243,0,0,136,136,0,1,0,1,0
3802,183,13077,121,293,223,70,4,0,3,1
1549,829,0,0,143,143,0,1,0,1,0
2705,1694,0,0,62,62,0,1,0,1,0
8884,1660,0,0,127,127,0,1,0,1,0
259,1945,0,0,144,144,0,1,0,1,0
8327,1629,0,0,146,146,0,1,0,1,0
1983,183,7736,121,293,223,70,4,0,3,1
1602,183,5833,121,293,223,70,4,0,3,1
2223,183,9071,121,293,223,70,4,0,3,1
1136,1176,0,0,140,140,0,1,0,1,0
10654,1543,0,0,65,65,0,1,0,1,0
2953,1327,0,0,122,122,0,1,0,1,0
852,3095,0,0,139,139,0,1,0,1,0
1565,183,5696,121,293,223,70,4,0,3,1
8299,1524,0,0,149,149,0,1,0,1,0
221,2219,0,0,144,144,0,1,0,1,0
1596,183,5831,121,293,223,70,4,0,3,1
9578,1407,0,0,103,103,0,1,0,1,0
2020,183,7924,121,293,223,70,4,0,3,1
1895,183,7265,121,293,223,70,4,0,3,1
4674,183,16139,121,293,223,70,4,1,3,1
374,2461,0,0,144,144,0,1,0,1,0
1720,686,0,0,146,146,0,1,0,1,0
11680,1623,0,0,66,66,0,1,0,1,0
2245,3070,0,0,157,157,0,1,0,1,0
149,1954,0,0,148,148,0,1,0,1,0
2244,183,9189,121,293,223,70,4,0,3,1
8295,1501,0,0,150,150,0,1,0,1,0
20356,2191,0,0,96,96,0,1,0,1,0
2974,1411,0,0,108,108,0,1,0,1,0
7004,725,0,0,151,151,0,1,0,1,0
707,3095,0,0,139,139,0,1,0,1,0
193,2269,0,0,145,145,0,1,0,1,0
11158,1543,0,0,71,71,0,1,0,1,0
2055,693,0,0,62,62,0,1,0,1,0
11143,1694,0,0,72,72,0,1,0,1,0
13418,441,0,0,145,145,0,1,0,1,0
284,1135,0,0,146,146,0,1,0,1,0
1746,471,0,0,138,138,0,1,0,1,0
1834,3095,0,0,151,151,0,1,0,1,0
879,307,3130,105,275,214,61,3,0,2,0
7777,2075,0,0,111,111,0,1,0,1,0
13155,1543,0,0,69,69,0,1,0,1,0
9866,183,19931,121,293,223,70,4,0,3,1
2914,1234,0,0,138,138,0,1,0,1,0
8281,1181,0,0,155,155,0,1,0,1,0
1975,183,7808,121,293,223,70,4,0,3,1
10839,1603,0,0,67,67,0,1,0,1,0
2234,183,9167,121,293,223,70,4,0,3,1
44,1191,0,0,155,155,0,1,0,1,0
2410,64,0,0,72,72,0,1,0,1,0
141,1064,0,0,152,152,0,1,0,1,0
893,197,3528,119,291,222,68,3,0,2,0
1558,801,0,0,144,144,0,1,0,1,0
1837,956,0,0,144,144,0,1,0,1,0
1549,829,0,0,143,143,0,1,0,1,0
8249,1214,0,0,156,156,0,1,0,1,0
19015,2837,0,0,131,131,0,1,0,1,0
953,183,3806,121,293,223,70,4,0,3,1
7725,2468,0,0,97,97,0,1,0,1,0
1851,988,0,0,144,144,0,1,0,1,0
742,3095,0,0,139,139,0,1,0,1,0
974,3095,0,0,140,140,0,1,0,1,0
43,1008,0,0,157,157,0,1,0,1,0
1496,982,0,0,141,141,0,1,0,1,0
10278,1543,0,0,79,79,0,1,0,1,0
8246,1196,0,0,156,156,0,1,0,1,0
2123,183,8572,121,293,223,70,4,0,3,1
1434,1166,0,0,139,139,0,1,0,1,0
2906,1462,0,0,100,100,0,1,0,1,0
1668,566,0,0,147,147,0,1,0,1,0
1187,762,0,0,146,146,0,1,0,1,0
1015,2882,0,0,143,143,0,1,0,1,0
8286,1441,0,0,151,151,0,1,0,1,0
1110,3095,0,0,141,141,0,1,0,1,0
16330,1622,0,0,62,62,0,1,0,1,0
14782,332,0,0,139,139,0,1,0,1,0
2959,1694,0,0,62,62,0,1,0,1,0
2412,205,0,0,76,76,0,1,0,1,0
570,1585,0,0,152,152,0,1,0,1,0
8904,1270,0,0,132,132,0,1,0,1,0
2954,1694,0,0,62,62,0,1,0,1,0
10685,1032,0,0,145,145,0,1,0,1,0
8504,1680,0,0,139,139,0,1,0,1,0
8276,1379,0,0,152,152,0,1,0,1,0
11099,1602,0,0,62,62,0,1,0,1,0
8312,1480,0,0,147,147,0,1,0,1,0
2147,1497,0,0,92,92,0,1,0,1,0
1960,183,7584,121,293,223,70,4,0,3,1
1952,918,0,0,80,80,0,1,0,1,0
2265,1661,0,0,62,62,0,1,0,1,0
8258,1271,0,0,154,154,0,1,0,1,0
15241,1543,0,0,62,62,0,1,0,1,0
2329,201,0,0,75,75,0,1,0,1,0
13786,419,0,0,135,135,0,1,0,1,0
2111,1443,0,0,101,101,0,1,0,1,0
5503,267,0,0,146,146,0,1,0,1,0
10571,1543,0,0,67,67,0,1,0,1,0
1649,2631,0,0,116,116,0,1,0,1,0
514,897,1002,33,185,165,19,1,0,1,0
19683,2515,0,0,114,114,0,1,0,1,0
2120,3095,0,0,156,156,0,1,0,1,0
11159,1614,0,0,62,62,0,1,0,1,0
1496,183,5304,121,293,223,70,4,0,3,1
1246,3095,0,0,142,142,0,1,0,1,0
4109,426,0,0,146,146,0,1,0,1,0
944,3095,0,0,140,140,0,1,0,1,0
2148,3095,0,0,157,157,0,1,0,1,0
1446,1130,0,0,139,139,0,1,0,1,0
353,1169,0,0,143,143,0,1,0,1,0
2903,183,10243,121,293,223,70,4,1,3,1
10576,1584,0,0,73,73,0,1,0,1,0
1235,183,4240,121,293,223,70,4,1,3,1
306,1069,0,0,157,157,0,1,0,1,0
11851,183,21413,121,293,223,70,4,0,3,1
294,1690,0,0,143,143,0,1,0,1,0
1617,494,442,12,162,155,7,1,0,1,0
3016,1681,0,0,64,64,0,1,0,1,0
3036,1663,0,0,66,66,0,1,0,1,0
651,1176,0,0,152,152,0,1,0,1,0
2196,345,0,0,84,84,0,1,0,1,0
2170,1303,0,0,123,123,0,1,0,1,0
2900,1634,0,0,71,71,0,1,0,1,0
2224,183,9071,121,293,223,70,4,0,3,1
1287,183,4341,121,293,223,70,4,1,3,1
3004,1675,0,0,64,64,0,1,0,1,0
3364,183,11882,121,293,223,70,4,1,3,1
1922,2224,0,0,92,92,0,1,0,1,0
13334,183,20042,121,293,223,70,4,0,3,1
1307,1176,0,0,150,150,0,1,0,1,0
2312,408,0,0,90,90,0,1,0,1,0
3642,183,13070,121,293,223,70,4,0,3,1
8476,1543,0,0,140,140,0,1,0,1,0
21128,1551,0,0,62,62,0,1,0,1,0
4226,183,15103,121,293,223,70,4,0,3,1
1945,2190,0,0,90,90,0,1,0,1,0
1922,183,7379,121,293,223,70,4,0,3,1
2735,1694,0,0,62,62,0,1,0,1,0
3300,183,12014,121,293,223,70,4,0,3,1
10751,1543,0,0,63,63,0,1,0,1,0
2240,1176,0,0,144,144,0,1,0,1,0
10369,1543,0,0,71,71,0,1,0,1,0
8992,2210,0,0,67,67,0,1,0,1,0
1081,268,2698,91,257,204,52,3,0,2,0
10831,1694,0,0,80,80,0,1,0,1,0
4075,448,0,0,146,146,0,1,0,1,0
1686,183,6252,121,293,223,70,4,0,3,1
1621,183,5930,121,293,223,70,4,0,3,1
2521,1694,0,0,62,62,0,1,0,1,0
2006,970,0,0,62,62,0,1,0,1,0
495,864,0,0,154,154,0,1,0,1,0
1080,1176,0,0,148,148,0,1,0,1,0
8127,1828,0,0,130,130,0,1,0,1,0
947,183,3786,121,293,223,70,4,0,3,1
1336,183,4509,121,293,223,70,4,0,3,1
9600,1599,0,0,99,99,0,1,0,1,0
168,1077,0,0,150,150,0,1,0,1,0
8539,1227,0,0,145,145,0,1,0,1,0
7630,953,0,0,154,154,0,1,0,1,0
10075,1625,0,0,100,100,0,1,0,1,0
1884,386,0,0,124,124,0,1,0,1,0
2496,35,0,0,64,64,0,1,0,1,0
3018,183,9126,121,293,223,70,4,0,3,1
11120,1674,0,0,73,73,0,1,0,1,0
1917,798,0,0,73,73,0,1,0,1,0
10009,183,20220,121,293,223,70,4,0,3,1
2073,1386,0,0,110,110,0,1,0,1,0
1383,725,0,0,150,150,0,1,0,1,0
309,1584,0,0,143,143,0,1,0,1,0
1179,183,4130,121,293,223,70,4,1,3,1
1991,1264,0,0,129,129,0,1,0,1,0
1567,3095,0,0,142,142,0,1,0,1,0
2069,1239,0,0,133,133,0,1,0,1,0
2849,981,0,0,133,133,0,1,0,1,0
10531,1694,0,0,88,88,0,1,0,1,0
1462,183,5134,121,293,223,70,4,0,3,1
991,183,3981,121,293,223,70,4,0,3,1
2075,3095,0,0,156,156,0,1,0,1,0
3744,899,0,0,147,147,0,1,0,1,0
2894,1176,0,0,147,147,0,1,0,1,0
675,1367,0,0,155,155,0,1,0,1,0
8327,1645,0,0,146,146,0,1,0,1,0
2425,134,0,0,62,62,0,1,0,1,0
2175,183,8790,121,293,223,70,4,0,3,1
8294,1490,0,0,150,150,0,1,0,1,0
1571,1023,0,0,129,129,0,1,0,1,0
2544,183,9663,121,293,223,70,4,0,3,1
9887,1543,0,0,93,93,0,1,0,1,0
1320,183,4427,121,293,223,70,4,1,3,1
9787,1396,0,0,99,99,0,1,0,1,0
11542,183,21183,121,293,223,70,4,0,3,1
877,3095,0,0,141,141,0,1,0,1,0
1811,431,0,0,132,132,0,1,0,1,0
8694,1671,0,0,133,133,0,1,0,1,0
2436,1176,0,0,145,145,0,1,0,1,0
8315,1491,0,0,147,147,0,1,0,1,0
14679,314,0,0,140,140,0,1,0,1,0
1808,2393,0,0,102,102,0,1,0,1,0
240,938,0,0,155,155,0,1,0,1,0
9466,1609,0,0,104,104,0,1,0,1,0
1748,1176,0,0,145,145,0,1,0,1,0
2901,1629,0,0,72,72,0,1,0,1,0
8629,1243,0,0,141,141,0,1,0,1,0
7872,1892,0,0,120,120,0,1,0,1,0
1679,593,0,0,147,147,0,1,0,1,0
2102,1225,0,0,62,62,0,1,0,1,0
1854,996,0,0,144,144,0,1,0,1,0
8589,1235,0,0,143,143,0,1,0,1,0
4861,183,16372,121,293,223,70,4,1,3,1
1949,957,0,0,90,90,0,1,0,1,0
1635,3095,0,0,143,143,0,1,0,1,0
1947,183,7514,121,293,223,70,4,0,3,1
1906,183,7351,121,293,223,70,4,0,3,1
1747,625,0,0,121,121,0,1,0,1,0
1134,1176,0,0,152,152,0,1,0,1,0
10808,1599,0,0,68,68,0,1,0,1,0
1237,2976,0,0,139,139,0,1,0,1,0
10001,1569,0,0,85,85,0,1,0,1,0
8062,2034,0,0,124,124,0,1,0,1,0
15140,817,0,0,145,145,0,1,0,1,0
932,183,3652,121,293,223,70,4,1,3,1
8317,1706,0,0,145,145,0,1,0,1,0
1146,1176,0,0,146,146,0,1,0,1,0
2825,911,0,0,128,128,0,1,0,1,0
1501,1176,0,0,139,139,0,1,0,1,0
1772,183,6684,121,293,223,70,4,0,3,1
1856,1176,0,0,142,142,0,1,0,1,0
1551,183,5581,121,293,223,70,4,0,3,1
9001,1284,0,0,128,128,0,1,0,1,0
733,3095,0,0,139,139,0,1,0,1,0
9631,1597,0,0,98,98,0,1,0,1,0
8327,1565,0,0,146,146,0,1,0,1,0
1030,1176,0,0,149,149,0,1,0,1,0
1774,811,0,0,145,145,0,1,0,1,0
10018,1568,0,0,84,84,0,1,0,1,0
2093,183,8314,121,293,223,70,4,0,3,1
2305,1671,0,0,65,65,0,1,0,1,0
9338,1365,0,0,113,113,0,1,0,1,0
1815,183,6901,121,293,223,70,4,0,3,1
2900,1170,0,0,146,146,0,1,0,1,0
1625,2774,0,0,121,121,0,1,0,1,0
2835,1241,0,0,137,137,0,1,0,1,0
2050,3095,0,0,155,155,0,1,0,1,0
2132,183,8541,121,293,223,70,4,0,3,1
1461,183,5133,121,293,223,70,4,0,3,1
2984,1694,0,0,62,62,0,1,0,1,0
1908,789,0,0,75,75,0,1,0,1,0
10271,1549,0,0,75,75,0,1,0,1,0
898,183,3594,121,293,223,70,4,0,3,1
12172,1365,0,0,80,80,0,1,0,1,0
1090,183,4113,121,293,223,70,4,1,3,1
1371,734,0,0,150,150,0,1,0,1,0
9441,1626,0,0,108,108,0,1,0,1,0
1827,183,6912,121,293,223,70,4,0,3,1
8109,1127,0,0,156,156,0,1,0,1,0
1745,3095,0,0,152,152,0,1,0,1,0
837,3095,0,0,139,139,0,1,0,1,0
1848,909,0,0,77,77,0,1,0,1,0
5655,252,0,0,146,146,0,1,0,1,0
1500,183,5318,121,293,223,70,4,0,3,1
8485,2457,0,0,65,65,0,1,0,1,0
2343,258,0,0,62,62,0,1,0,1,0
1341,3095,0,0,143,143,0,1,0,1,0
1469,445,861,29,182,166,16,1,0,1,0
2295,1370,0,0,112,112,0,1,0,1,0
4662,183,16125,121,293,223,70,4,1,3,1
2451,2652,0,0,128,128,0,1,0,1,0
9650,1889,0,0,69,69,0,1,0,1,0
2562,143,0,0,72,72,0,1,0,1,0
1751,183,6577,121,293,223,70,4,0,3,1
1921,1475,0,0,94,94,0,1,0,1,0
2060,278,0,0,107,107,0,1,0,1,0
8279,1400,0,0,152,152,0,1,0,1,0
1854,3095,0,0,149,149,0,1,0,1,0
1695,1176,0,0,141,141,0,1,0,1,0
1739,730,0,0,146,146,0,1,0,1,0
8243,1176,0,0,156,156,0,1,0,1,0
13656,1543,0,0,62,62,0,1,0,1,0
8862,1283,0,0,132,132,0,1,0,1,0
20986,1417,0,0,70,70,0,1,0,1,0
1012,1176,0,0,140,140,0,1,0,1,0
319,1072,0,0,157,157,0,1,0,1,0
17401,2358,0,0,145,145,0,1,0,1,0
8336,183,15397,121,293,223,70,4,0,3,1
1832,183,6986,121,293,223,70,4,0,3,1
1572,760,0,0,144,144,0,1,0,1,0
1934,1151,0,0,137,137,0,1,0,1,0
2810,1176,0,0,147,147,0,1,0,1,0
2990,1477,0,0,97,97,0,1,0,1,0
710,1176,0,0,155,155,0,1,0,1,0
3274,1306,0,0,87,87,0,1,0,1,0
12862,1004,0,0,101,101,0,1,0,1,0
9631,1597,0,0,98,98,0,1,0,1,0
11381,1672,0,0,63,63,0,1,0,1,0
1349,3078,0,0,142,142,0,1,0,1,0
1395,183,4943,121,293,223,70,4,1,3,1
2100,1220,0,0,62,62,0,1,0,1,0
841,600,2073,70,235,195,40,2,0,2,0
2141,1328,0,0,62,62,0,1,0,1,0
20970,1895,0,0,80,80,0,1,0,1,0
2495,1328,0,0,62,62,0,1,0,1,0
2086,3095,0,0,156,156,0,1,0,1,0
1735,981,0,0,94,94,0,1,0,1,0
233,2133,0,0,144,144,0,1,0,1,0
5370,281,0,0,146,146,0,1,0,1,0
960,183,3706,121,293,223,70,4,1,3,1
1469,620,0,0,147,147,0,1,0,1,0
1013,2880,0,0,143,143,0,1,0,1,0
12982,2043,0,0,95,95,0,1,0,1,0
2957,1694,0,0,62,62,0,1,0,1,0
1302,1176,0,0,150,150,0,1,0,1,0
1310,627,0,0,149,149,0,1,0,1,0
1717,183,6406,121,293,223,70,4,0,3,1
2448,1694,0,0,62,62,0,1,0,1,0
1971,183,7646,121,293,223,70,4,0,3,1
1931,632,0,0,103,103,0,1,0,1,0
6143,495,0,0,146,146,0,1,0,1,0
449,1102,0,0,157,157,0,1,0,1,0
8552,1680,0,0,138,138,0,1,0,1,0
2232,183,9134,121,293,223,70,4,0,3,1
1943,183,7433,121,293,223,70,4,0,3,1
1584,183,5749,121,293,223,70,4,0,3,1
15973,183,24576,121,293,223,70,4,0,3,1
8327,1611,0,0,146,146,0,1,0,1,0
1725,1176,0,0,141,141,0,1,0,1,0
486,1176,0,0,147,147,0,1,0,1,0
42,1180,0,0,155,155,0,1,0,1,0
16765,1925,0,0,145,145,0,1,0,1,0
2783,1942,0,0,79,79,0,1,0,1,0
1952,183,7539,121,293,223,70,4,0,3,1
2214,1525,0,0,62,62,0,1,0,1,0
2950,1694,0,0,62,62,0,1,0,1,0
1875,892,0,0,74,74,0,1,0,1,0
1582,732,0,0,145,145,0,1,0,1,0
3426,1247,0,0,91,91,0,1,0,1,0
2554,2431,0,0,113,113,0,1,0,1,0
2169,1302,0,0,123,123,0,1,0,1,0
4486,652,0,0,146,146,0,1,0,1,0
4504,183,15928,121,293,223,70,4,1,3,1
8327,1662,0,0,146,146,0,1,0,1,0
8290,1381,0,0,150,150,0,1,0,1,0
8893,1269,0,0,132,132,0,1,0,1,0
5575,288,0,0,146,146,0,1,0,1,0
2959,1694,0,0,62,62,0,1,0,1,0
2139,1922,0,0,74,74,0,1,0,1,0
2494,31,0,0,62,62,0,1,0,1,0
2924,1694,0,0,62,62,0,1,0,1,0
9906,1597,0,0,92,92,0,1,0,1,0
1256,818,0,0,152,152,0,1,0,1,0
9087,1322,0,0,123,123,0,1,0,1,0
1976,889,0,0,62,62,0,1,0,1,0
984,183,3753,121,293,223,70,4,1,3,1
16871,697,0,0,116,116,0,1,0,1,0
9579,1601,0,0,100,100,0,1,0,1,0
5857,329,0,0,146,146,0,1,0,1,0
15458,2483,0,0,112,112,0,1,0,1,0
3104,183,11455,121,293,223,70,4,0,3,1
1721,183,6432,121,293,223,70,4,0,3,1
2059,183,8244,121,293,223,70,4,0,3,1
11092,1601,0,0,62,62,0,1,0,1,0
3301,183,11650,121,293,223,70,4,0,3,1
4411,183,14942,121,293,223,70,4,0,3,1
3434,183,12367,121,293,223,70,4,0,3,1
9404,1543,0,0,109,109,0,1,0,1,0
241,2403,0,0,144,144,0,1,0,1,0
21564,1608,0,0,65,65,0,1,0,1,0
2087,644,0,0,62,62,0,1,0,1,0
478,1176,0,0,146,146,0,1,0,1,0
3047,183,11097,121,293,223,70,4,0,3,1
8287,1447,0,0,151,151,0,1,0,1,0
8327,1556,0,0,146,146,0,1,0,1,0
8140,1374,0,0,146,146,0,1,0,1,0
1641,1176,0,0,146,146,0,1,0,1,0
3219,183,12119,121,293,223,70,4,0,3,1
1426,3095,0,0,139,139,0,1,0,1,0
1376,3095,0,0,141,141,0,1,0,1,0
1242,183,4252,121,293,223,70,4,1,3,1
1038,183,3858,121,293,223,70,4,1,3,1
2031,1036,0,0,62,62,0,1,0,1,0
2913,1255,0,0,134,134,0,1,0,1,0
1925,1478,0,0,94,94,0,1,0,1,0
2986,1694,0,0,62,62,0,1,0,1,0
9373,1592,0,0,118,118,0,1,0,1,0
118,1052,0,0,152,152,0,1,0,1,0
1959,845,0,0,62,62,0,1,0,1,0
2936,1259,0,0,134,134,0,1,0,1,0
1520,3095,0,0,141,141,0,1,0,1,0
7895,2248,0,0,111,111,0,1,0,1,0
14799,335,0,0,139,139,0,1,0,1,0
1398,3095,0,0,139,139,0,1,0,1,0
5117,306,0,0,146,146,0,1,0,1,0
3032,1694,0,0,62,62,0,1,0,1,0
439,2698,0,0,142,142,0,1,0,1,0
11028,1628,0,0,66,66,0,1,0,1,0
2664,1380,0,0,114,114,0,1,0,1,0
2905,1486,0,0,96,96,0,1,0,1,0
7733,2457,0,0,98,98,0,1,0,1,0
2431,183,8234,121,293,223,70,4,1,3,1
4067,383,0,0,141,141,0,1,0,1,0
1910,183,7323,121,293,223,70,4,0,3,1
1744,472,0,0,138,138,0,1,0,1,0
9402,1543,0,0,106,106,0,1,0,1,0
9425,1627,0,0,108,108,0,1,0,1,0
9730,1543,0,0,94,94,0,1,0,1,0
2933,1694,0,0,62,62,0,1,0,1,0
11063,1595,0,0,62,62,0,1,0,1,0
11296,1642,0,0,62,62,0,1,0,1,0
1077,1176,0,0,148,148,0,1,0,1,0
714,2659,0,0,142,142,0,1,0,1,0
2223,183,8580,121,293,223,70,4,0,3,1
567,2887,0,0,140,140,0,1,0,1,0
25,1006,0,0,156,156,0,1,0,1,0
620,1142,0,0,157,157,0,1,0,1,0
9686,1611,0,0,99,99,0,1,0,1,0
2164,3095,0,0,157,157,0,1,0,1,0
2227,1559,0,0,62,62,0,1,0,1,0
1443,183,5073,121,293,223,70,4,1,3,1
8269,1180,0,0,155,155,0,1,0,1,0
1702,183,6333,121,293,223,70,4,0,3,1
4412,376,0,0,146,146,0,1,0,1,0
697,1323,0,0,155,155,0,1,0,1,0
528,871,1098,37,189,167,21,1,0,1,0
418,2490,0,0,144,144,0,1,0,1,0
2052,183,8112,121,293,223,70,4,0,3,1
1429,183,5035,121,293,223,70,4,1,3,1
5121,306,0,0,146,146,0,1,0,1,0
1474,3095,0,0,145,145,0,1,0,1,0
7336,2928,0,0,68,68,0,1,0,1,0
2596,1419,0,0,62,62,0,1,0,1,0
2715,183,10623,121,293,223,70,4,0,3,1
4117,434,0,0,143,143,0,1,0,1,0
3128,1594,0,0,68,68,0,1,0,1,0
8254,1248,0,0,155,155,0,1,0,1,0
1882,3095,0,0,150,150,0,1,0,1,0
467,1176,0,0,146,146,0,1,0,1,0
2394,183,8929,121,293,223,70,4,0,3,1
2530,183,10073,121,293,223,70,4,0,3,1
3008,1551,0,0,85,85,0,1,0,1,0
241,2078,0,0,144,144,0,1,0,1,0
8271,1299,0,0,153,153,0,1,0,1,0
8327,1664,0,0,146,146,0,1,0,1,0
3023,1694,0,0,62,62,0,1,0,1,0
8327,1598,0,0,146,146,0,1,0,1,0
129,1058,0,0,152,152,0,1,0,1,0
5709,276,0,0,145,145,0,1,0,1,0
17651,2529,0,0,145,145,0,1,0,1,0
374,1994,0,0,148,148,0,1,0,1,0
9593,1410,0,0,102,102,0,1,0,1,0
7284,1030,0,0,146,146,0,1,0,1,0
2776,1694,0,0,62,62,0,1,0,1,0
8327,1600,0,0,146,146,0,1,0,1,0
10057,1624,0,0,100,100,0,1,0,1,0
14476,183,23373,121,293,223,70,4,0,3,1
10713,1587,0,0,69,69,0,1,0,1,0
9370,1543,0,0,110,110,0,1,0,1,0
3599,947,0,0,147,147,0,1,0,1,0
1434,183,5048,121,293,223,70,4,1,3,1
1626,603,0,0,146,146,0,1,0,1,0
1147,183,4266,121,293,223,70,4,1,3,1
12999,933,0,0,105,105,0,1,0,1,0
1318,183,4733,121,293,223,70,4,1,3,1
9063,1293,0,0,126,126,0,1,0,1,0
2970,1397,0,0,111,111,0,1,0,1,0
2381,1694,0,0,62,62,0,1,0,1,0
5398,347,0,0,146,146,0,1,0,1,0
7104,183,14154,121,293,223,70,4,0,3,1
2914,1220,0,0,140,140,0,1,0,1,0
1794,856,0,0,145,145,0,1,0,1,0
9107,1543,0,0,117,117,0,1,0,1,0
851,1176,0,0,154,154,0,1,0,1,0
1626,604,0,0,146,146,0,1,0,1,0
69,1009,0,0,156,156,0,1,0,1,0
1422,3095,0,0,139,139,0,1,0,1,0
4045,183,14567,121,293,223,70,4,0,3,1
1175,3095,0,0,141,141,0,1,0,1,0
1676,586,0,0,147,147,0,1,0,1,0
10623,1650,0,0,86,86,0,1,0,1,0
7503,2721,0,0,80,80,0,1,0,1,0
2106,1176,0,0,143,143,0,1,0,1,0
12352,1271,0,0,86,86,0,1,0,1,0
1433,183,4984,121,293,223,70,4,0,3,1
1442,1142,0,0,139,139,0,1,0,1,0
11425,1694,0,0,65,65,0,1,0,1,0
1962,183,7593,121,293,223,70,4,0,3,1
501,2790,0,0,141,141,0,1,0,1,0
2259,1643,0,0,62,62,0,1,0,1,0
10544,1543,0,0,67,67,0,1,0,1,0
554,2562,0,0,143,143,0,1,0,1,0
2723,614,0,0,106,106,0,1,0,1,0
1754,764,0,0,146,146,0,1,0,1,0
325,1469,0,0,143,143,0,1,0,1,0
2566,153,0,0,73,73,0,1,0,1,0
145,1925,0,0,148,148,0,1,0,1,0
2913,1260,0,0,133,133,0,1,0,1,0
421,2671,0,0,142,142,0,1,0,1,0
1814,3095,0,0,148,148,0,1,0,1,0
1846,183,7129,121,293,223,70,4,0,3,1
637,2991,0,0,139,139,0,1,0,1,0
6491,538,0,0,149,149,0,1,0,1,0
835,3095,0,0,139,139,0,1,0,1,0
954,183,3695,121,293,223,70,4,1,3,1
2621,2288,0,0,103,103,0,1,0,1,0
2314,2945,0,0,148,148,0,1,0,1,0
1719,1176,0,0,141,141,0,1,0,1,0
1813,183,6888,121,293,223,70,4,0,3,1
2293,1694,0,0,62,62,0,1,0,1,0
2899,1685,0,0,63,63,0,1,0,1,0
1363,183,4854,121,293,223,70,4,1,3,1
1036,838,0,0,145,145,0,1,0,1,0
1611,3095,0,0,147,147,0,1,0,1,0
10149,1448,0,0,86,86,0,1,0,1,0
7925,1789,0,0,125,125,0,1,0,1,0
2908,1405,0,0,109,109,0,1,0,1,0
1563,787,0,0,144,144,0,1,0,1,0
502,2791,0,0,141,141,0,1,0,1,0
773,2723,0,0,143,143,0,1,0,1,0
1730,183,6544,121,293,223,70,4,0,3,1
1667,183,6426,121,293,223,70,4,0,3,1
2897,95,0,0,81,81,0,1,0,1,0
101,1609,0,0,151,151,0,1,0,1,0
13223,815,0,0,112,112,0,1,0,1,0
1026,3095,0,0,141,141,0,1,0,1,0
13092,646,0,0,122,122,0,1,0,1,0
4095,183,11119,121,293,223,70,4,0,3,1
1740,1365,0,0,110,110,0,1,0,1,0
1077,3095,0,0,139,139,0,1,0,1,0
872,1099,0,0,155,155,0,1,0,1,0
1611,183,5930,121,293,223,70,4,0,3,1
5705,183,17077,121,293,223,70,4,0,3,1
5251,396,0,0,146,146,0,1,0,1,0
1877,183,7302,121,293,223,70,4,0,3,1
19583,183,27186,121,293,223,70,4,0,3,1
231,2291,0,0,145,145,0,1,0,1,0
1950,941,0,0,86,86,0,1,0,1,0
3310,183,11054,121,293,223,70,4,1,3,1
1811,896,0,0,145,145,0,1,0,1,0
1603,183,5821,121,293,223,70,4,0,3,1
2822,1694,0,0,62,62,0,1,0,1,0
1792,183,6740,121,293,223,70,4,0,3,1
161,2039,0,0,147,147,0,1,0,1,0
16791,183,25174,121,293,223,70,4,0,3,1
15696,2532,0,0,111,111,0,1,0,1,0
1618,494,434,11,162,155,6,1,0,1,0
9553,1403,0,0,104,104,0,1,0,1,0
2946,1694,0,0,62,62,0,1,0,1,0
1940,3095,0,0,155,155,0,1,0,1,0
950,1042,0,0,155,155,0,1,0,1,0
296,1680,0,0,143,143,0,1,0,1,0
1522,183,5434,121,293,223,70,4,0,3,1
1550,183,5579,121,293,223,70,4,0,3,1
10589,1543,0,0,66,66,0,1,0,1,0
8329,183,18784,121,293,223,70,4,0,3,1
19284,1578,0,0,62,62,0,1,0,1,0
1382,183,4735,121,293,223,70,4,1,3,1
14398,312,0,0,145,145,0,1,0,1,0
1603,3095,0,0,143,143,0,1,0,1,0
1384,183,4749,121,293,223,70,4,1,3,1
311,1572,0,0,143,143,0,1,0,1,0
1421,183,4928,121,293,223,70,4,1,3,1
9594,1410,0,0,102,102,0,1,0,1,0
1326,183,4460,121,293,223,70,4,1,3,1
386,2468,0,0,144,144,0,1,0,1,0
1769,799,0,0,145,145,0,1,0,1,0
1740,2583,0,0,110,110,0,1,0,1,0
21191,183,28356,121,293,223,70,4,0,3,1
7940,2095,0,0,115,115,0,1,0,1,0
2624,2281,0,0,102,102,0,1,0,1,0
1135,1176,0,0,147,147,0,1,0,1,0
960,729,0,0,151,151,0,1,0,1,0
1009,183,3893,121,293,223,70,4,1,3,1
626,1176,0,0,152,152,0,1,0,1,0
9395,1543,0,0,109,109,0,1,0,1,0
23,1042,0,0,156,156,0,1,0,1,0
8327,1656,0,0,146,146,0,1,0,1,0
1629,183,6285,121,293,223,70,4,0,3,1
1605,183,5829,121,293,223,70,4,0,3,1
869,231,3406,115,285,219,66,3,0,2,0
7672,2479,0,0,93,93,0,1,0,1,0
4842,183,16078,121,293,223,70,4,0,3,1
2805,1265,0,0,133,133,0,1,0,1,0
5086,309,0,0,146,146,0,1,0,1,0
1769,960,0,0,89,89,0,1,0,1,0
1955,879,0,0,71,71,0,1,0,1,0
2915,1198,0,0,144,144,0,1,0,1,0
2054,1358,0,0,114,114,0,1,0,1,0
19519,183,27138,121,293,223,70,4,0,3,1
2467,1694,0,0,62,62,0,1,0,1,0
230,1108,0,0,148,148,0,1,0,1,0
1813,932,0,0,83,83,0,1,0,1,0
1195,3095,0,0,139,139,0,1,0,1,0
10518,1563,0,0,70,70,0,1,0,1,0
1919,183,7363,121,293,223,70,4,0,3,1
1572,183,5661,121,293,223,70,4,0,3,1
2100,1427,0,0,103,103,0,1,0,1,0
1241,183,4251,121,293,223,70,4,1,3,1
8247,1205,0,0,156,156,0,1,0,1,0
2923,1694,0,0,62,62,0,1,0,1,0
1641,183,6029,121,293,223,70,4,0,3,1
1139,183,4053,121,293,223,70,4,1,3,1
8861,1654,0,0,126,126,0,1,0,1,0
1764,963,0,0,90,90,0,1,0,1,0
737,1168,0,0,157,157,0,1,0,1,0
9558,1602,0,0,101,101,0,1,0,1,0
2914,1230,0,0,138,138,0,1,0,1,0
7804,2366,0,0,104,104,0,1,0,1,0
2701,1100,0,0,128,128,0,1,0,1,0
11515,1687,0,0,62,62,0,1,0,1,0
10551,1558,0,0,70,70,0,1,0,1,0
6727,756,0,0,146,146,0,1,0,1,0
1211,183,4900,121,293,223,70,4,0,3,1
721,2649,0,0,143,143,0,1,0,1,0
21648,1367,3670,15,91,82,9,1,0,1,0
3034,1653,0,0,68,68,0,1,0,1,0
2245,1176,0,0,144,144,0,1,0,1,0
9346,1367,0,0,112,112,0,1,0,1,0
8176,1303,0,0,150,150,0,1,0,1,0
8768,1267,0,0,135,135,0,1,0,1,0
18247,2935,0,0,145,145,0,1,0,1,0
8263,1265,0,0,154,154,0,1,0,1,0
1997,1522,0,0,87,87,0,1,0,1,0
2989,1474,0,0,98,98,0,1,0,1,0
8996,1306,0,0,126,126,0,1,0,1,0
181,2186,0,0,146,146,0,1,0,1,0
10845,1604,0,0,67,67,0,1,0,1,0
836,3095,0,0,139,139,0,1,0,1,0
2958,1347,0,0,119,119,0,1,0,1,0
1184,1176,0,0,139,139,0,1,0,1,0
20746,183,28054,121,293,223,70,4,0,3,1
2463,1543,0,0,86,86,0,1,0,1,0
715,2834,0,0,141,141,0,1,0,1,0
9048,1315,0,0,124,124,0,1,0,1,0
1418,183,4914,121,293,223,70,4,1,3,1
1769,1383,0,0,108,108,0,1,0,1,0
10848,1551,0,0,62,62,0,1,0,1,0
1195,183,4398,121,293,223,70,4,1,3,1
1516,925,0,0,142,142,0,1,0,1,0
1269,2996,0,0,139,139,0,1,0,1,0
2050,1238,0,0,133,133,0,1,0,1,0
1938,1105,0,0,125,125,0,1,0,1,0
1435,183,5003,121,293,223,70,4,0,3,1
2327,183,9450,121,293,223,70,4,0,3,1
2423,1262,0,0,62,62,0,1,0,1,0
8276,1324,0,0,152,152,0,1,0,1,0
371,1166,34,1,144,143,0,1,0,1,0
1534,1109,0,0,123,123,0,1,0,1,0
283,2466,0,0,144,144,0,1,0,1,0
2131,1303,0,0,62,62,0,1,0,1,0
2306,1376,0,0,111,111,0,1,0,1,0
14480,1543,0,0,62,62,0,1,0,1,0
2714,1694,0,0,62,62,0,1,0,1,0
292,2480,0,0,143,143,0,1,0,1,0
823,745,1553,52,216,185,30,2,0,1,0
3969,183,14154,121,293,223,70,4,0,3,1
2496,11,0,0,63,63,0,1,0,1,0
8878,1543,0,0,125,125,0,1,0,1,0
1360,395,1377,46,203,176,26,2,0,1,0
8455,1543,0,0,141,141,0,1,0,1,0
18925,183,26733,121,293,223,70,4,0,3,1
11095,1601,0,0,62,62,0,1,0,1,0
11362,1656,0,0,62,62,0,1,0,1,0
11004,1583,0,0,62,62,0,1,0,1,0
8655,1558,0,0,137,137,0,1,0,1,0
2189,199,0,0,94,94,0,1,0,1,0
1553,1097,0,0,121,121,0,1,0,1,0
9245,1638,0,0,114,114,0,1,0,1,0
1036,183,3853,121,293,223,70,4,1,3,1
2979,183,10734,121,293,223,70,4,0,3,1
16844,1979,0,0,145,145,0,1,0,1,0
2038,1334,0,0,118,118,0,1,0,1,0
13783,442,0,0,132,132,0,1,0,1,0
235,2284,0,0,145,145,0,1,0,1,0
1048,183,3878,121,293,223,70,4,1,3,1
13860,482,0,0,131,131,0,1,0,1,0
2314,123,0,0,81,81,0,1,0,1,0
8397,1202,0,0,150,150,0,1,0,1,0
1614,3095,0,0,147,147,0,1,0,1,0
1285,3059,0,0,143,143,0,1,0,1,0
7739,2383,0,0,99,99,0,1,0,1,0
1386,183,4754,121,293,223,70,4,1,3,1
2016,1007,0,0,131,131,0,1,0,1,0
2909,1694,0,0,62,62,0,1,0,1,0
6782,2178,0,0,88,88,0,1,0,1,0
18391,3033,0,0,145,145,0,1,0,1,0
728,2417,0,0,145,145,0,1,0,1,0
7999,1087,0,0,155,155,0,1,0,1,0
8327,1565,0,0,146,146,0,1,0,1,0
1933,1174,0,0,142,142,0,1,0,1,0
16005,1627,0,0,62,62,0,1,0,1,0
1438,183,5013,121,293,223,70,4,1,3,1
1606,3095,0,0,143,143,0,1,0,1,0
17583,2482,0,0,145,145,0,1,0,1,0
1942,824,0,0,66,66,0,1,0,1,0
644,1176,0,0,152,152,0,1,0,1,0
1963,832,0,0,62,62,0,1,0,1,0
1697,3095,0,0,145,145,0,1,0,1,0
12399,1246,0,0,87,87,0,1,0,1,0
1780,660,0,0,111,111,0,1,0,1,0
1463,183,5138,121,293,223,70,4,0,3,1
114,1050,0,0,153,153,0,1,0,1,0
10316,1572,0,0,78,78,0,1,0,1,0
734,3095,0,0,139,139,0,1,0,1,0
591,1135,0,0,157,157,0,1,0,1,0
729,1176,0,0,155,155,0,1,0,1,0
2908,1389,0,0,112,112,0,1,0,1,0
4491,183,15890,121,293,223,70,4,0,3,1
1179,183,4131,121,293,223,70,4,1,3,1
888,233,3397,114,286,219,66,3,0,2,0
1893,1176,0,0,142,142,0,1,0,1,0
2445,1557,0,0,84,84,0,1,0,1,0
9650,1543,0,0,97,97,0,1,0,1,0
157,1072,0,0,151,151,0,1,0,1,0
20070,2329,0,0,104,104,0,1,0,1,0
1550,1176,0,0,139,139,0,1,0,1,0
7362,2921,0,0,69,69,0,1,0,1,0
1868,183,7162,121,293,223,70,4,0,3,1
1955,878,0,0,71,71,0,1,0,1,0
1366,3095,0,0,141,141,0,1,0,1,0
2195,183,8914,121,293,223,70,4,0,3,1
685,2641,0,0,142,142,0,1,0,1,0
9727,1388,0,0,102,102,0,1,0,1,0
8831,1656,0,0,127,127,0,1,0,1,0
1519,1176,0,0,147,147,0,1,0,1,0
8959,1543,0,0,122,122,0,1,0,1,0
8261,1257,0,0,154,154,0,1,0,1,0
1648,527,15,0,148,148,0,1,0,1,0
2172,3095,0,0,158,158,0,1,0,1,0
1512,937,0,0,142,142,0,1,0,1,0
315,1071,0,0,157,157,0,1,0,1,0
1874,1176,0,0,143,143,0,1,0,1,0
3043,1693,0,0,62,62,0,1,0,1,0
20762,183,27928,121,293,223,70,4,0,3,1
3740,824,0,0,118,118,0,1,0,1,0
320,1504,0,0,143,143,0,1,0,1,0
1768,183,6666,121,293,223,70,4,0,3,1
1880,183,7170,121,293,223,70,4,0,3,1
5327,285,0,0,146,146,0,1,0,1,0
2501,1694,0,0,62,62,0,1,0,1,0
15957,1543,0,0,67,67,0,1,0,1,0
8286,1442,0,0,151,151,0,1,0,1,0
1521,911,0,0,142,142,0,1,0,1,0
2870,1755,0,0,66,66,0,1,0,1,0
9595,1616,0,0,103,103,0,1,0,1,0
2169,183,8755,121,293,223,70,4,0,3,1
3473,237,0,0,111,111,0,1,0,1,0
1301,3095,0,0,142,142,0,1,0,1,0
1316,3024,0,0,139,139,0,1,0,1,0
1446,183,5053,121,293,223,70,4,1,3,1
1649,1176,0,0,140,140,0,1,0,1,0
10458,1543,0,0,69,69,0,1,0,1,0
2082,183,8281,121,293,223,70,4,0,3,1
1528,183,5505,121,293,223,70,4,0,3,1
2802,1605,0,0,62,62,0,1,0,1,0
631,1144,0,0,157,157,0,1,0,1,0
1893,183,7388,121,293,223,70,4,0,3,1
2749,1694,0,0,62,62,0,1,0,1,0
1940,1072,0,0,118,118,0,1,0,1,0
20781,1543,0,0,62,62,0,1,0,1,0
1218,183,4207,121,293,223,70,4,1,3,1
16529,183,23422,121,293,223,70,4,0,3,1
2166,1395,0,0,62,62,0,1,0,1,0
3093,1116,0,0,147,147,0,1,0,1,0
10462,1543,0,0,69,69,0,1,0,1,0
39,1013,0,0,156,156,0,1,0,1,0
483,1110,0,0,157,157,0,1,0,1,0
1472,183,5991,121,293,223,70,4,0,3,1
2053,183,8086,121,293,223,70,4,0,3,1
1403,183,4861,121,293,223,70,4,0,3,1
12225,1338,0,0,82,82,0,1,0,1,0
19668,183,27249,121,293,223,70,4,0,3,1
610,2951,0,0,140,140,0,1,0,1,0
1618,183,5910,121,293,223,70,4,0,3,1
19612,1574,0,0,62,62,0,1,0,1,0
3404,1272,0,0,89,89,0,1,0,1,0
8269,1340,0,0,153,153,0,1,0,1,0
138,1875,0,0,149,149,0,1,0,1,0
2283,1689,0,0,62,62,0,1,0,1,0
7506,2600,0,0,84,84,0,1,0,1,0
1327,183,4463,121,293,223,70,4,1,3,1
3338,1349,0,0,84,84,0,1,0,1,0
4770,183,16258,121,293,223,70,4,1,3,1
2204,3095,0,0,157,157,0,1,0,1,0
10268,1543,0,0,80,80,0,1,0,1,0
2029,1321,0,0,120,120,0,1,0,1,0
7935,1769,0,0,126,126,0,1,0,1,0
1463,183,5127,121,293,223,70,4,0,3,1
5733,270,0,0,146,146,0,1,0,1,0
1431,1175,0,0,139,139,0,1,0,1,0
1957,183,7567,121,293,223,70,4,0,3,1
7882,1873,0,0,121,121,0,1,0,1,0
2867,1761,0,0,66,66,0,1,0,1,0
10748,1592,0,0,68,68,0,1,0,1,0
1948,183,7527,121,293,223,70,4,0,3,1
3009,1694,0,0,62,62,0,1,0,1,0
9957,1572,0,0,86,86,0,1,0,1,0
2161,183,8766,121,293,223,70,4,0,3,1
8320,1513,0,0,146,146,0,1,0,1,0
1764,963,0,0,90,90,0,1,0,1,0
2722,52,0,0,72,72,0,1,0,1,0
10694,1543,0,0,64,64,0,1,0,1,0
1418,183,4917,121,293,223,70,4,1,3,1
20866,1543,0,0,62,62,0,1,0,1,0
9264,1543,0,0,114,114,0,1,0,1,0
13441,701,0,0,119,119,0,1,0,1,0
661,2649,0,0,144,144,0,1,0,1,0
328,1447,0,0,143,143,0,1,0,1,0
2106,250,0,0,102,102,0,1,0,1,0
242,937,0,0,155,155,0,1,0,1,0
4804,183,16301,121,293,223,70,4,1,3,1
1355,1176,0,0,139,139,0,1,0,1,0
986,721,0,0,151,151,0,1,0,1,0
2105,827,0,0,118,118,0,1,0,1,0
2532,1694,0,0,62,62,0,1,0,1,0
9845,1405,0,0,97,97,0,1,0,1,0
2220,183,8630,121,293,223,70,4,0,3,1
164,1076,0,0,151,151,0,1,0,1,0
1069,262,2753,93,259,205,53,3,0,2,0
2809,1694,0,0,62,62,0,1,0,1,0
1062,3095,0,0,139,139,0,1,0,1,0
1709,183,6339,121,293,223,70,4,0,3,1
2023,183,7922,121,293,223,70,4,0,3,1
2908,1694,0,0,62,62,0,1,0,1,0
2314,2945,0,0,148,148,0,1,0,1,0
2617,1495,0,0,93,93,0,1,0,1,0
2107,1589,0,0,77,77,0,1,0,1,0
2922,1694,0,0,62,62,0,1,0,1,0
9904,1694,0,0,104,104,0,1,0,1,0
2079,1163,0,0,62,62,0,1,0,1,0
8298,1517,0,0,149,149,0,1,0,1,0
2071,183,8490,121,293,223,70,4,0,3,1
9687,1382,0,0,103,103,0,1,0,1,0
1555,811,0,0,144,144,0,1,0,1,0
1412,3095,0,0,139,139,0,1,0,1,0
2153,1361,0,0,62,62,0,1,0,1,0
78,985,0,0,156,156,0,1,0,1,0
2302,320,0,0,62,62,0,1,0,1,0
952,183,3735,121,293,223,70,4,1,3,1
1792,183,6889,121,293,223,70,4,0,3,1
2998,1694,0,0,62,62,0,1,0,1,0
1540,183,5522,121,293,223,70,4,0,3,1
4079,483,0,0,140,140,0,1,0,1,0
2059,183,7819,121,293,223,70,4,0,3,1
1678,1018,0,0,102,102,0,1,0,1,0
2199,1484,0,0,62,62,0,1,0,1,0
1989,183,7768,121,293,223,70,4,0,3,1
810,845,1192,40,202,178,23,1,0,1,0
20450,2146,0,0,94,94,0,1,0,1,0
1846,183,7004,121,293,223,70,4,0,3,1
2591,1694,0,0,62,62,0,1,0,1,0
338,2547,0,0,143,143,0,1,0,1,0
12263,690,0,0,145,145,0,1,0,1,0
2075,183,8242,121,293,223,70,4,0,3,1
1758,1376,0,0,109,109,0,1,0,1,0
4787,183,16280,121,293,223,70,4,1,3,1
1670,183,6149,121,293,223,70,4,0,3,1
8450,1684,0,0,141,141,0,1,0,1,0
4369,183,14691,121,293,223,70,4,0,3,1
8916,1292,0,0,129,129,0,1,0,1,0
2105,1268,0,0,128,128,0,1,0,1,0
455,1176,0,0,146,146,0,1,0,1,0
443,1176,0,0,145,145,0,1,0,1,0
2903,1569,0,0,82,82,0,1,0,1,0
6271,532,0,0,146,146,0,1,0,1,0
10148,1628,0,0,98,98,0,1,0,1,0
2904,1520,0,0,90,90,0,1,0,1,0
216,1101,0,0,149,149,0,1,0,1,0
4560,183,15997,121,293,223,70,4,1,3,1
877,3095,0,0,141,141,0,1,0,1,0
1578,183,5691,121,293,223,70,4,0,3,1
9853,1406,0,0,97,97,0,1,0,1,0
4857,332,0,0,146,146,0,1,0,1,0
706,2654,0,0,142,142,0,1,0,1,0
8426,1687,0,0,142,142,0,1,0,1,0
949,882,0,0,145,145,0,1,0,1,0
2675,471,0,0,96,96,0,1,0,1,0
1513,1176,0,0,139,139,0,1,0,1,0
8273,1309,0,0,152,152,0,1,0,1,0
8934,1571,0,0,130,130,0,1,0,1,0
2091,638,0,0,62,62,0,1,0,1,0
8544,1543,0,0,138,138,0,1,0,1,0
244,2058,0,0,144,144,0,1,0,1,0
109,1666,0,0,151,151,0,1,0,1,0
772,3095,0,0,139,139,0,1,0,1,0
2919,183,11229,121,293,223,70,4,0,3,1
16430,183,23559,121,293,223,70,4,0,3,1
2948,183,9963,121,293,223,70,4,0,3,1
773,1131,158,5,163,159,3,1,0,1,0
21487,832,14878,63,182,146,36,2,0,2,0
4786,183,16278,121,293,223,70,4,1,3,1
124,1770,0,0,150,150,0,1,0,1,0
2505,183,10001,121,293,223,70,4,0,3,1
1246,183,4260,121,293,223,70,4,1,3,1
1738,183,6512,121,293,223,70,4,0,3,1
743,1176,0,0,141,141,0,1,0,1,0
2020,1216,0,0,136,136,0,1,0,1,0
2247,2969,0,0,150,150,0,1,0,1,0
2127,183,8532,121,293,223,70,4,0,3,1
1024,183,3830,121,293,223,70,4,1,3,1
479,1176,0,0,146,146,0,1,0,1,0
4568,183,15091,121,293,223,70,4,1,3,1
1022,1176,0,0,150,150,0,1,0,1,0
1712,3095,0,0,145,145,0,1,0,1,0
2650,183,10431,121,293,223,70,4,0,3,1
732,2282,0,0,146,146,0,1,0,1,0
1921,1176,0,0,143,143,0,1,0,1,0
1684,183,6247,121,293,223,70,4,0,3,1
1952,918,0,0,80,80,0,1,0,1,0
8302,1543,0,0,149,149,0,1,0,1,0
9167,1694,0,0,124,124,0,1,0,1,0
14851,2360,0,0,105,105,0,1,0,1,0
127,1798,0,0,149,149,0,1,0,1,0
1590,183,5775,121,293,223,70,4,0,3,1
2983,1449,0,0,102,102,0,1,0,1,0
1372,183,4685,121,293,223,70,4,1,3,1
1664,1176,0,0,140,140,0,1,0,1,0
1954,1496,0,0,91,91,0,1,0,1,0
1358,3095,0,0,142,142,0,1,0,1,0
2481,1176,0,0,145,145,0,1,0,1,0
2950,1313,0,0,125,125,0,1,0,1,0
15637,1156,0,0,145,145,0,1,0,1,0
1517,627,0,0,149,149,0,1,0,1,0
62,1025,0,0,155,155,0,1,0,1,0
10117,1444,0,0,87,87,0,1,0,1,0
2655,1387,0,0,112,112,0,1,0,1,0
12819,1027,0,0,100,100,0,1,0,1,0
1756,3095,0,0,146,146,0,1,0,1,0
8298,1519,0,0,149,149,0,1,0,1,0
2174,208,0,0,95,95,0,1,0,1,0
2692,1097,0,0,127,127,0,1,0,1,0
1956,859,0,0,66,66,0,1,0,1,0
1471,1058,0,0,140,140,0,1,0,1,0
8708,1694,0,0,136,136,0,1,0,1,0
1995,183,7774,121,293,223,70,4,0,3,1
7377,2915,0,0,70,70,0,1,0,1,0
2108,1242,0,0,62,62,0,1,0,1,0
8842,1543,0,0,127,127,0,1,0,1,0
2861,1773,0,0,67,67,0,1,0,1,0
10550,1567,0,0,70,70,0,1,0,1,0
292,2480,0,0,143,143,0,1,0,1,0
6529,1730,0,0,101,101,0,1,0,1,0
16145,1543,0,0,66,66,0,1,0,1,0
2203,1302,0,0,123,123,0,1,0,1,0
8327,1627,0,0,146,146,0,1,0,1,0
5018,316,0,0,146,146,0,1,0,1,0
2233,1176,0,0,144,144,0,1,0,1,0
1400,3095,0,0,140,140,0,1,0,1,0
582,2910,0,0,140,140,0,1,0,1,0
3729,665,0,0,146,146,0,1,0,1,0
18674,1543,0,0,64,64,0,1,0,1,0
2488,40,0,0,62,62,0,1,0,1,0
1934,1152,0,0,137,137,0,1,0,1,0
217,2254,0,0,144,144,0,1,0,1,0
4934,183,16462,121,293,223,70,4,1,3,1
1534,3095,0,0,141,141,0,1,0,1,0
4908,183,16430,121,293,223,70,4,1,3,1
151,964,0,0,156,156,0,1,0,1,0
1169,1143,0,0,142,142,0,1,0,1,0
95,1012,0,0,156,156,0,1,0,1,0
9611,1543,0,0,102,102,0,1,0,1,0
2215,3095,0,0,158,158,0,1,0,1,0
9517,1598,0,0,114,114,0,1,0,1,0
1337,620,0,0,149,149,0,1,0,1,0
1852,732,0,0,91,91,0,1,0,1,0
73,1403,0,0,153,153,0,1,0,1,0
835,3095,0,0,139,139,0,1,0,1,0
2310,308,0,0,62,62,0,1,0,1,0
1408,280,3146,86,251,201,50,3,0,2,0
10368,1543,0,0,71,71,0,1,0,1,0
960,3095,0,0,142,142,0,1,0,1,0
2168,183,8803,121,293,223,70,4,0,3,1
9194,1543,0,0,116,116,0,1,0,1,0
9449,1543,0,0,105,105,0,1,0,1,0
10190,1139,0,0,145,145,0,1,0,1,0
2198,183,8558,121,293,223,70,4,0,3,1
17882,1543,0,0,62,62,0,1,0,1,0
1433,1174,0,0,138,138,0,1,0,1,0
1992,183,7780,121,293,223,70,4,0,3,1
2621,1694,0,0,62,62,0,1,0,1,0
3384,183,12237,121,293,223,70,4,0,3,1
2124,1947,0,0,75,75,0,1,0,1,0
2506,183,9388,121,293,223,70,4,0,3,1
1754,632,0,0,119,119,0,1,0,1,0
771,1095,0,0,147,147,0,1,0,1,0
5976,183,12255,121,293,223,70,4,0,3,1
647,1176,0,0,141,141,0,1,0,1,0
8327,1630,0,0,146,146,0,1,0,1,0
4454,372,0,0,146,146,0,1,0,1,0
9697,1610,0,0,99,99,0,1,0,1,0
2767,1694,0,0,62,62,0,1,0,1,0
1937,183,7465,121,293,223,70,4,0,3,1
2031,183,7977,121,293,223,70,4,0,3,1
3030,1638,0,0,71,71,0,1,0,1,0
1479,450,817,27,181,165,15,1,0,1,0
9207,1352,0,0,145,145,0,1,0,1,0
9224,1346,0,0,117,117,0,1,0,1,0
2250,1346,0,0,116,116,0,1,0,1,0
4987,183,16451,121,293,223,70,4,0,3,1
1667,564,0,0,147,147,0,1,0,1,0
2063,276,0,0,106,106,0,1,0,1,0
237,1112,0,0,148,148,0,1,0,1,0
1611,183,5853,121,293,223,70,4,0,3,1
17154,2826,0,0,130,130,0,1,0,1,0
1974,331,0,0,115,115,0,1,0,1,0
2099,183,8374,121,293,223,70,4,0,3,1
503,2545,0,0,144,144,0,1,0,1,0
19867,2427,0,0,109,109,0,1,0,1,0
435,1054,0,0,151,151,0,1,0,1,0
13502,546,0,0,125,125,0,1,0,1,0
2160,183,8700,121,293,223,70,4,0,3,1
1885,682,0,0,106,106,0,1,0,1,0
9659,1694,0,0,111,111,0,1,0,1,0
1912,1129,0,0,143,143,0,1,0,1,0
7370,2863,0,0,71,71,0,1,0,1,0
2090,183,8567,121,293,223,70,4,0,3,1
702,1176,0,0,154,154,0,1,0,1,0
2865,1176,0,0,147,147,0,1,0,1,0
1618,513,156,5,154,151,3,1,0,1,0
1613,1287,0,0,122,122,0,1,0,1,0
2194,1471,0,0,62,62,0,1,0,1,0
70,1015,0,0,157,157,0,1,0,1,0
4632,183,16087,121,293,223,70,4,1,3,1
2038,1054,0,0,62,62,0,1,0,1,0
19272,2713,0,0,124,124,0,1,0,1,0
2579,1057,0,0,117,117,0,1,0,1,0
1023,3095,0,0,139,139,0,1,0,1,0
1859,3095,0,0,152,152,0,1,0,1,0
1874,183,7140,121,293,223,70,4,0,3,1
645,2639,0,0,144,144,0,1,0,1,0
1573,448,1016,28,181,165,16,1,0,1,0
13533,2094,0,0,91,91,0,1,0,1,0
2058,1176,0,0,143,143,0,1,0,1,0
21337,334,25294,107,267,205,62,3,0,2,0
8327,1603,0,0,146,146,0,1,0,1,0
2130,183,8530,121,293,223,70,4,0,3,1
696,806,0,0,153,153,0,1,0,1,0
2114,183,8520,121,293,223,70,4,0,3,1
2972,1405,0,0,109,109,0,1,0,1,0
11494,1683,0,0,62,62,0,1,0,1,0
2239,938,0,0,87,87,0,1,0,1,0
10837,1543,0,0,62,62,0,1,0,1,0
4523,183,15952,121,293,223,70,4,1,3,1
2566,1694,0,0,62,62,0,1,0,1,0
776,3095,0,0,139,139,0,1,0,1,0
964,2849,0,0,143,143,0,1,0,1,0
10629,1543,0,0,66,66,0,1,0,1,0
2083,183,8287,121,293,223,70,4,0,3,1
8257,1641,0,0,140,140,0,1,0,1,0
2841,1663,0,0,66,66,0,1,0,1,0
1965,859,0,0,62,62,0,1,0,1,0
231,2389,0,0,144,144,0,1,0,1,0
1513,1123,0,0,126,126,0,1,0,1,0
1322,183,4441,121,293,223,70,4,1,3,1
813,821,1278,43,205,180,25,2,0,1,0
1715,593,0,0,130,130,0,1,0,1,0
1732,3095,0,0,146,146,0,1,0,1,0
4438,668,0,0,146,146,0,1,0,1,0
736,1090,0,0,147,147,0,1,0,1,0
10701,1543,0,0,71,71,0,1,0,1,0
1496,3095,0,0,145,145,0,1,0,1,0
10467,1563,0,0,73,73,0,1,0,1,0
994,3095,0,0,140,140,0,1,0,1,0
3837,766,0,0,122,122,0,1,0,1,0
11081,1543,0,0,71,71,0,1,0,1,0
13390,447,0,0,145,145,0,1,0,1,0
2044,183,6992,121,293,223,70,4,1,3,1
1485,183,5280,121,293,223,70,4,0,3,1
944,3095,0,0,139,139,0,1,0,1,0
2024,183,8051,121,293,223,70,4,0,3,1
917,1113,0,0,145,145,0,1,0,1,0
2903,1694,0,0,62,62,0,1,0,1,0
21671,1557,0,0,62,62,0,1,0,1,0
1885,3095,0,0,152,152,0,1,0,1,0
4115,423,0,0,146,146,0,1,0,1,0
2200,183,8967,121,293,223,70,4,0,3,1
3003,1531,0,0,88,88,0,1,0,1,0
8327,1687,0,0,146,146,0,1,0,1,0
10565,1569,0,0,70,70,0,1,0,1,0
5716,288,0,0,144,144,0,1,0,1,0
8259,1247,0,0,154,154,0,1,0,1,0
2561,1694,0,0,62,62,0,1,0,1,0
2306,962,0,0,93,93,0,1,0,1,0
1839,183,7060,121,293,223,70,4,0,3,1
1914,1133,0,0,143,143,0,1,0,1,0
1190,1176,0,0,145,145,0,1,0,1,0
1683,183,6208,121,293,223,70,4,0,3,1
2307,183,8639,121,293,223,70,4,0,3,1
1681,183,6193,121,293,223,70,4,0,3,1
3777,311,0,0,126,126,0,1,0,1,0
2183,1442,0,0,62,62,0,1,0,1,0
7682,2522,0,0,94,94,0,1,0,1,0
9079,1320,0,0,123,123,0,1,0,1,0
2086,183,7344,121,293,223,70,4,1,3,1
1905,183,7517,121,293,223,70,4,0,3,1
8146,1926,0,0,131,131,0,1,0,1,0
1418,3095,0,0,139,139,0,1,0,1,0
902,3095,0,0,139,139,0,1,0,1,0
1028,183,3944,121,293,223,70,4,1,3,1
2024,183,7942,121,293,223,70,4,0,3,1
1590,710,0,0,145,145,0,1,0,1,0
1662,183,6138,121,293,223,70,4,0,3,1
1057,1130,0,0,143,143,0,1,0,1,0
4808,183,16305,121,293,223,70,4,1,3,1
2745,1694,0,0,62,62,0,1,0,1,0
4548,183,15982,121,293,223,70,4,1,3,1
2012,183,7864,121,293,223,70,4,0,3,1
4932,183,16459,121,293,223,70,4,1,3,1
2899,1688,0,0,62,62,0,1,0,1,0
3751,812,0,0,119,119,0,1,0,1,0
2407,1176,0,0,145,145,0,1,0,1,0
437,1099,0,0,157,157,0,1,0,1,0
605,2612,0,0,144,144,0,1,0,1,0
9207,183,19634,121,293,223,70,4,0,3,1
8242,1177,0,0,156,156,0,1,0,1,0
2759,1303,0,0,126,126,0,1,0,1,0
2683,1364,0,0,116,116,0,1,0,1,0
2238,1318,0,0,120,120,0,1,0,1,0
1345,3095,0,0,143,143,0,1,0,1,0
2462,183,8680,121,293,223,70,4,1,3,1
2255,159,0,0,87,87,0,1,0,1,0
1860,183,7124,121,293,223,70,4,0,3,1
6769,777,0,0,146,146,0,1,0,1,0
10634,1651,0,0,85,85,0,1,0,1,0
2270,2021,0,0,84,84,0,1,0,1,0
7308,2982,0,0,65,65,0,1,0,1,0
5894,183,16965,121,293,223,70,4,0,3,1
997,1176,0,0,154,154,0,1,0,1,0
1652,2627,0,0,115,115,0,1,0,1,0
1726,605,0,0,126,126,0,1,0,1,0
499,1176,0,0,147,147,0,1,0,1,0
2173,183,8777,121,293,223,70,4,0,3,1
1394,717,0,0,150,150,0,1,0,1,0
9367,1543,0,0,110,110,0,1,0,1,0
2899,1667,0,0,66,66,0,1,0,1,0
19405,2649,0,0,121,121,0,1,0,1,0
1041,1176,0,0,153,153,0,1,0,1,0
2869,183,10168,121,293,223,70,4,0,3,1
10449,1554,0,0,71,71,0,1,0,1,0
2101,183,8387,121,293,223,70,4,0,3,1
1692,621,0,0,147,147,0,1,0,1,0
2181,183,8822,121,293,223,70,4,0,3,1
1647,183,6028,121,293,223,70,4,0,3,1
10269,1549,0,0,75,75,0,1,0,1,0
1994,183,7793,121,293,223,70,4,0,3,1
2775,1176,0,0,147,147,0,1,0,1,0
2537,1694,0,0,62,62,0,1,0,1,0
1652,1034,0,0,106,106,0,1,0,1,0
1060,1176,0,0,140,140,0,1,0,1,0
1665,1026,0,0,104,104,0,1,0,1,0
9585,183,19910,121,293,223,70,4,0,3,1
7826,1981,0,0,116,116,0,1,0,1,0
2921,1197,0,0,144,144,0,1,0,1,0
10745,1543,0,0,64,64,0,1,0,1,0
8371,1545,0,0,144,144,0,1,0,1,0
9359,1631,0,0,111,111,0,1,0,1,0
1342,183,5323,121,293,223,70,4,0,3,1
3259,183,11325,121,293,223,70,4,0,3,1
2775,766,0,0,118,118,0,1,0,1,0
4074,449,0,0,146,146,0,1,0,1,0
2908,1419,0,0,107,107,0,1,0,1,0
3435,1235,0,0,91,91,0,1,0,1,0
2705,48,0,0,71,71,0,1,0,1,0
666,3034,0,0,139,139,0,1,0,1,0
7802,1406,0,0,146,146,0,1,0,1,0
10403,1548,0,0,71,71,0,1,0,1,0
7108,2756,0,0,70,70,0,1,0,1,0
1621,616,0,0,146,146,0,1,0,1,0
2887,1687,0,0,62,62,0,1,0,1,0
10384,1568,0,0,76,76,0,1,0,1,0
10864,1607,0,0,67,67,0,1,0,1,0
2013,986,0,0,62,62,0,1,0,1,0
918,183,3626,121,293,223,70,4,1,3,1
1529,404,1579,43,200,174,25,2,0,1,0
1906,183,7297,121,293,223,70,4,0,3,1
4667,351,0,0,146,146,0,1,0,1,0
2106,1437,0,0,102,102,0,1,0,1,0
21123,1551,0,0,62,62,0,1,0,1,0
4395,378,0,0,146,146,0,1,0,1,0
223,1105,0,0,148,148,0,1,0,1,0
5229,295,0,0,146,146,0,1,0,1,0
11376,1659,0,0,62,62,0,1,0,1,0
1077,3095,0,0,141,141,0,1,0,1,0
702,1160,0,0,157,157,0,1,0,1,0
2912,1694,0,0,62,62,0,1,0,1,0
1652,529,0,0,147,147,0,1,0,1,0
1020,183,3920,121,293,223,70,4,1,3,1
8327,1677,0,0,146,146,0,1,0,1,0
3593,183,10613,121,293,223,70,4,0,3,1
1864,1017,0,0,144,144,0,1,0,1,0
10563,1568,0,0,70,70,0,1,0,1,0
77,1435,0,0,153,153,0,1,0,1,0
1078,183,4079,121,293,223,70,4,1,3,1
2704,183,9538,121,293,223,70,4,1,3,1
1241,3095,0,0,142,142,0,1,0,1,0
11109,1431,0,0,69,69,0,1,0,1,0
13466,2080,0,0,90,90,0,1,0,1,0
1469,662,0,0,149,149,0,1,0,1,0
1864,183,7220,121,293,223,70,4,0,3,1
1372,3095,0,0,141,141,0,1,0,1,0
1504,183,5330,121,293,223,70,4,0,3,1
9194,1543,0,0,116,116,0,1,0,1,0
923,2821,0,0,143,143,0,1,0,1,0
2648,1694,0,0,62,62,0,1,0,1,0
2009,183,7848,121,293,223,70,4,0,3,1
347,1311,0,0,143,143,0,1,0,1,0
1585,723,0,0,145,145,0,1,0,1,0
17525,2442,0,0,145,145,0,1,0,1,0
8263,1264,0,0,154,154,0,1,0,1,0
18035,1543,0,0,65,65,0,1,0,1,0
2218,446,0,0,62,62,0,1,0,1,0
4463,183,15079,121,293,223,70,4,0,3,1
1388,183,5640,121,293,223,70,4,0,3,1
4695,183,16165,121,293,223,70,4,1,3,1
2909,1378,0,0,114,114,0,1,0,1,0
10508,1543,0,0,68,68,0,1,0,1,0
1435,183,4997,121,293,223,70,4,1,3,1
8327,1599,0,0,146,146,0,1,0,1,0
4360,183,15502,121,293,223,70,4,0,3,1
1987,183,7731,121,293,223,70,4,0,3,1
21161,1802,0,0,75,75,0,1,0,1,0
1730,183,6434,121,293,223,70,4,0,3,1
2828,1844,0,0,72,72,0,1,0,1,0
8693,1666,0,0,132,132,0,1,0,1,0
1594,183,5775,121,293,223,70,4,0,3,1
436,1176,0,0,145,145,0,1,0,1,0
1506,183,5355,121,293,223,70,4,0,3,1
12310,1293,0,0,85,85,0,1,0,1,0
2126,1176,0,0,143,143,0,1,0,1,0
157,1072,0,0,151,151,0,1,0,1,0
2957,1694,0,0,62,62,0,1,0,1,0
8617,1240,0,0,141,141,0,1,0,1,0
12646,183,22146,121,293,223,70,4,0,3,1
13543,1664,0,0,62,62,0,1,0,1,0
2211,183,9023,121,293,223,70,4,0,3,1
2443,1010,0,0,105,105,0,1,0,1,0
1530,1068,0,0,131,131,0,1,0,1,0
936,183,3694,121,293,223,70,4,1,3,1
2903,1561,0,0,84,84,0,1,0,1,0
9305,1327,0,0,117,117,0,1,0,1,0
4017,183,14314,121,293,223,70,4,0,3,1
9295,1622,0,0,110,110,0,1,0,1,0
2252,2797,0,0,138,138,0,1,0,1,0
2694,1694,0,0,62,62,0,1,0,1,0
1984,183,7715,121,293,223,70,4,0,3,1
4675,183,16056,121,293,223,70,4,0,3,1
4630,183,15388,121,293,223,70,4,0,3,1
4823,335,0,0,146,146,0,1,0,1,0
20823,1966,0,0,84,84,0,1,0,1,0
3111,183,11515,121,293,223,70,4,0,3,1
14304,249,0,0,145,145,0,1,0,1,0
1446,3071,0,0,137,137,0,1,0,1,0
2411,1694,0,0,62,62,0,1,0,1,0
20830,1962,0,0,84,84,0,1,0,1,0
1833,417,0,0,129,129,0,1,0,1,0
8327,1676,0,0,146,146,0,1,0,1,0
10795,1598,0,0,68,68,0,1,0,1,0
10831,1534,0,0,62,62,0,1,0,1,0
2221,183,9054,121,293,223,70,4,0,3,1
7955,1731,0,0,128,128,0,1,0,1,0
9778,1543,0,0,93,93,0,1,0,1,0
12069,733,0,0,145,145,0,1,0,1,0
3875,183,13530,121,293,223,70,4,0,3,1
4521,183,15949,121,293,223,70,4,1,3,1
2912,1694,0,0,62,62,0,1,0,1,0
2018,749,0,0,62,62,0,1,0,1,0
863,757,0,0,152,152,0,1,0,1,0
2288,138,0,0,84,84,0,1,0,1,0
2379,273,0,0,80,80,0,1,0,1,0
1916,1176,0,0,142,142,0,1,0,1,0
9604,1602,0,0,112,112,0,1,0,1,0
2680,1694,0,0,62,62,0,1,0,1,0
15731,183,22578,121,293,223,70,4,0,3,1
3685,183,13212,121,293,223,70,4,0,3,1
3591,1053,0,0,103,103,0,1,0,1,0
12629,799,0,0,113,113,0,1,0,1,0
15309,2488,0,0,116,116,0,1,0,1,0
167,1077,0,0,150,150,0,1,0,1,0
13040,717,0,0,114,114,0,1,0,1,0
1291,3095,0,0,139,139,0,1,0,1,0
634,1176,0,0,152,152,0,1,0,1,0
13231,811,0,0,112,112,0,1,0,1,0
10433,1552,0,0,71,71,0,1,0,1,0
686,1157,0,0,157,157,0,1,0,1,0
1935,1147,0,0,136,136,0,1,0,1,0
18936,2875,0,0,133,133,0,1,0,1,0
5517,266,0,0,146,146,0,1,0,1,0
1445,3095,0,0,139,139,0,1,0,1,0
2487,17,0,0,64,64,0,1,0,1,0
1927,3095,0,0,151,151,0,1,0,1,0
8108,1974,0,0,128,128,0,1,0,1,0
1398,183,4809,121,293,223,70,4,0,3,1
1096,183,3971,121,293,223,70,4,1,3,1
8313,1481,0,0,147,147,0,1,0,1,0
16982,183,25244,121,293,223,70,4,0,3,1
1529,183,5468,121,293,223,70,4,0,3,1
1482,183,5269,121,293,223,70,4,0,3,1
1002,2834,0,0,141,141,0,1,0,1,0
1364,3095,0,0,141,141,0,1,0,1,0
7293,3039,0,0,62,62,0,1,0,1,0
2046,183,8048,121,293,223,70,4,0,3,1
322,2524,0,0,143,143,0,1,0,1,0
2729,54,0,0,73,73,0,1,0,1,0
1646,183,6089,121,293,223,70,4,0,3,1
4757,342,0,0,146,146,0,1,0,1,0
2773,1963,0,0,80,80,0,1,0,1,0
1483,451,797,26,180,164,15,1,0,1,0
2000,1276,0,0,127,127,0,1,0,1,0
2901,1623,0,0,73,73,0,1,0,1,0
1452,3061,0,0,137,137,0,1,0,1,0
8290,1466,0,0,150,150,0,1,0,1,0
1011,3095,0,0,142,142,0,1,0,1,0
20732,2010,0,0,86,86,0,1,0,1,0
317,1527,0,0,143,143,0,1,0,1,0
14227,274,0,0,143,143,0,1,0,1,0
5019,183,16312,121,293,223,70,4,0,3,1
1925,3095,0,0,151,151,0,1,0,1,0
1050,3095,0,0,143,143,0,1,0,1,0
95,1563,0,0,151,151,0,1,0,1,0
2953,1694,0,0,62,62,0,1,0,1,0
1212,1176,0,0,139,139,0,1,0,1,0
1549,183,5557,121,293,223,70,4,0,3,1
8315,1623,0,0,147,147,0,1,0,1,0
2581,1176,0,0,146,146,0,1,0,1,0
2062,183,8137,121,293,223,70,4,0,3,1
2021,183,7913,121,293,223,70,4,0,3,1
9713,1609,0,0,99,99,0,1,0,1,0
655,1409,0,0,154,154,0,1,0,1,0
2040,291,0,0,109,109,0,1,0,1,0
45,1016,0,0,155,155,0,1,0,1,0
2170,183,8903,121,293,223,70,4,0,3,1
12664,1108,0,0,95,95,0,1,0,1,0
1120,3095,0,0,141,141,0,1,0,1,0
1947,3095,0,0,151,151,0,1,0,1,0
1969,183,7633,121,293,223,70,4,0,3,1
2166,703,0,0,110,110,0,1,0,1,0
2893,1167,0,0,145,145,0,1,0,1,0
8247,1206,0,0,156,156,0,1,0,1,0
2327,2918,0,0,146,146,0,1,0,1,0
1394,183,4813,121,293,223,70,4,0,3,1
2009,1176,0,0,143,143,0,1,0,1,0
9965,1474,0,0,87,87,0,1,0,1,0
8267,1283,0,0,153,153,0,1,0,1,0
7623,2372,0,0,96,96,0,1,0,1,0
1324,3095,0,0,139,139,0,1,0,1,0
1097,275,2620,88,254,202,51,3,0,2,0
1499,3095,0,0,145,145,0,1,0,1,0
8261,1258,0,0,154,154,0,1,0,1,0
1836,183,7000,121,293,223,70,4,0,3,1
2330,372,0,0,87,87,0,1,0,1,0
1867,3095,0,0,149,149,0,1,0,1,0
1496,983,0,0,141,141,0,1,0,1,0
11247,1632,0,0,62,62,0,1,0,1,0
711,2968,0,0,140,140,0,1,0,1,0
1873,183,7138,121,293,223,70,4,0,3,1
589,2920,0,0,140,140,0,1,0,1,0
3079,1653,0,0,64,64,0,1,0,1,0
1938,183,7514,121,293,223,70,4,0,3,1
8753,1662,0,0,130,130,0,1,0,1,0
1737,183,6505,121,293,223,70,4,0,3,1
8099,1452,0,0,142,142,0,1,0,1,0
1207,325,2100,70,233,192,41,2,0,2,0
8286,1443,0,0,151,151,0,1,0,1,0
2732,1694,0,0,62,62,0,1,0,1,0
2047,183,8052,121,293,223,70,4,0,3,1
8525,1543,0,0,138,138,0,1,0,1,0
17411,183,25565,121,293,223,70,4,0,3,1
16795,1945,0,0,145,145,0,1,0,1,0
1446,183,5726,121,293,223,70,4,0,3,1
3372,1204,0,0,93,93,0,1,0,1,0
12526,1180,0,0,91,91,0,1,0,1,0
1602,183,5836,121,293,223,70,4,0,3,1
10370,1544,0,0,72,72,0,1,0,1,0
3218,1490,0,0,75,75,0,1,0,1,0
284,1769,0,0,144,144,0,1,0,1,0
8327,1586,0,0,146,146,0,1,0,1,0
2902,1592,0,0,78,78,0,1,0,1,0
2078,1243,0,0,132,132,0,1,0,1,0
1942,1042,0,0,110,110,0,1,0,1,0
8561,1543,0,0,138,138,0,1,0,1,0
8264,1272,0,0,154,154,0,1,0,1,0
1938,1105,0,0,126,126,0,1,0,1,0
20860,183,28146,121,293,223,70,4,0,3,1
2733,1694,0,0,62,62,0,1,0,1,0
4886,183,16163,121,293,223,70,4,0,3,1
8999,1284,0,0,128,128,0,1,0,1,0
433,1871,0,0,149,149,0,1,0,1,0
2897,1176,0,0,147,147,0,1,0,1,0
2041,183,8028,121,293,223,70,4,0,3,1
10182,1543,0,0,83,83,0,1,0,1,0
2854,1694,0,0,62,62,0,1,0,1,0
1352,3095,0,0,143,143,0,1,0,1,0
1188,183,4722,121,293,223,70,4,0,3,1
2678,1694,0,0,62,62,0,1,0,1,0
1603,670,0,0,146,146,0,1,0,1,0
2748,183,9252,121,293,223,70,4,1,3,1
2032,1326,0,0,119,119,0,1,0,1,0
2175,183,8836,121,293,223,70,4,0,3,1
1882,183,7180,121,293,223,70,4,0,3,1
2303,1694,0,0,62,62,0,1,0,1,0
1717,183,6409,121,293,223,70,4,0,3,1
18870,2907,0,0,134,134,0,1,0,1,0
2270,2010,0,0,83,83,0,1,0,1,0
1371,183,4681,121,293,223,70,4,1,3,1
13287,2044,0,0,88,88,0,1,0,1,0
2909,1371,0,0,115,115,0,1,0,1,0
1382,3095,0,0,141,141,0,1,0,1,0
9102,1636,0,0,117,117,0,1,0,1,0
7517,2701,0,0,81,81,0,1,0,1,0
1102,183,4444,121,293,223,70,4,0,3,1
952,183,3805,121,293,223,70,4,0,3,1
1342,3095,0,0,142,142,0,1,0,1,0
1848,183,7063,121,293,223,70,4,0,3,1
9099,1636,0,0,117,117,0,1,0,1,0
3032,1694,0,0,62,62,0,1,0,1,0
1951,932,0,0,84,84,0,1,0,1,0
7558,2642,0,0,84,84,0,1,0,1,0
10038,1543,0,0,83,83,0,1,0,1,0
2089,1410,0,0,106,106,0,1,0,1,0
1332,183,4489,121,293,223,70,4,1,3,1
197,1044,0,0,157,157,0,1,0,1,0
19164,183,26210,121,293,223,70,4,0,3,1
1347,3095,0,0,142,142,0,1,0,1,0
7714,2196,0,0,105,105,0,1,0,1,0
8172,1609,0,0,146,146,0,1,0,1,0
2758,1694,0,0,62,62,0,1,0,1,0
8428,1543,0,0,142,142,0,1,0,1,0
1162,183,4098,121,293,223,70,4,1,3,1
2772,1579,0,0,62,62,0,1,0,1,0
1350,221,3895,107,276,214,62,3,0,2,0
84,1035,0,0,154,154,0,1,0,1,0
2544,1694,0,0,62,62,0,1,0,1,0
2143,1334,0,0,62,62,0,1,0,1,0
7353,2946,0,0,68,68,0,1,0,1,0
2644,1694,0,0,62,62,0,1,0,1,0
843,3095,0,0,139,139,0,1,0,1,0
2521,1694,0,0,62,62,0,1,0,1,0
15032,183,21838,121,293,223,70,4,0,3,1
3801,183,13074,121,293,223,70,4,0,3,1
11542,1693,0,0,62,62,0,1,0,1,0
327,1157,0,0,144,144,0,1,0,1,0
10332,1637,0,0,93,93,0,1,0,1,0
11479,1680,0,0,62,62,0,1,0,1,0
1093,3095,0,0,141,141,0,1,0,1,0
2978,1694,0,0,62,62,0,1,0,1,0
588,1134,0,0,157,157,0,1,0,1,0
1186,2994,0,0,143,143,0,1,0,1,0
1835,183,7071,121,293,223,70,4,0,3,1
20713,2019,0,0,87,87,0,1,0,1,0
4180,183,14334,121,293,223,70,4,0,3,1
2912,1270,0,0,132,132,0,1,0,1,0
326,2429,0,0,144,144,0,1,0,1,0
8246,1194,0,0,156,156,0,1,0,1,0
1431,183,4970,121,293,223,70,4,0,3,1
8846,1662,0,0,128,128,0,1,0,1,0
1102,2939,0,0,143,143,0,1,0,1,0
306,2136,0,0,147,147,0,1,0,1,0
1422,183,5522,121,293,223,70,4,0,3,1
9185,1630,0,0,114,114,0,1,0,1,0
10519,1563,0,0,70,70,0,1,0,1,0
9026,2194,0,0,67,67,0,1,0,1,0
1220,183,4780,121,293,223,70,4,0,3,1
19791,2463,0,0,111,111,0,1,0,1,0
7339,2955,0,0,67,67,0,1,0,1,0
1588,183,5747,121,293,223,70,4,0,3,1
2972,1403,0,0,110,110,0,1,0,1,0
1799,867,0,0,145,145,0,1,0,1,0
15912,1343,0,0,145,145,0,1,0,1,0
1006,1001,0,0,154,154,0,1,0,1,0
10714,1588,0,0,69,69,0,1,0,1,0
2433,183,9443,121,293,223,70,4,0,3,1
915,183,3620,121,293,223,70,4,1,3,1
731,490,2470,83,246,198,48,3,0,2,0
1291,183,4661,121,293,223,70,4,1,3,1
1362,3095,0,0,141,141,0,1,0,1,0
2586,1694,0,0,62,62,0,1,0,1,0
11760,1737,0,0,64,64,0,1,0,1,0
1314,183,4401,121,293,223,70,4,0,3,1
707,3076,0,0,139,139,0,1,0,1,0
516,1176,0,0,148,148,0,1,0,1,0
1424,3095,0,0,139,139,0,1,0,1,0
1884,386,0,0,124,124,0,1,0,1,0
1012,1176,0,0,154,154,0,1,0,1,0
6265,562,0,0,146,146,0,1,0,1,0
2965,1375,0,0,114,114,0,1,0,1,0
1419,3095,0,0,139,139,0,1,0,1,0
1721,689,0,0,146,146,0,1,0,1,0
1918,183,7357,121,293,223,70,4,0,3,1
3281,1053,0,0,147,147,0,1,0,1,0
11491,1682,0,0,62,62,0,1,0,1,0
2076,3095,0,0,156,156,0,1,0,1,0
2264,153,0,0,86,86,0,1,0,1,0
952,183,3790,121,293,223,70,4,0,3,1
257,1960,0,0,144,144,0,1,0,1,0
2749,688,0,0,112,112,0,1,0,1,0
3653,713,0,0,146,146,0,1,0,1,0
11991,1461,0,0,75,75,0,1,0,1,0
11528,1690,0,0,62,62,0,1,0,1,0
4157,183,14901,121,293,223,70,4,0,3,1
8293,1489,0,0,150,150,0,1,0,1,0
1524,1176,0,0,139,139,0,1,0,1,0
1507,183,5364,121,293,223,70,4,0,3,1
6371,495,0,0,148,148,0,1,0,1,0
607,1176,0,0,151,151,0,1,0,1,0
2149,1615,0,0,73,73,0,1,0,1,0
13846,489,0,0,131,131,0,1,0,1,0
5030,183,16581,121,293,223,70,4,1,3,1
8327,1565,0,0,146,146,0,1,0,1,0
8327,1581,0,0,146,146,0,1,0,1,0
11509,1686,0,0,62,62,0,1,0,1,0
1995,1049,0,0,134,134,0,1,0,1,0
1031,183,3844,121,293,223,70,4,1,3,1
2249,183,9220,121,293,223,70,4,0,3,1
3344,907,0,0,147,147,0,1,0,1,0
12899,985,0,0,102,102,0,1,0,1,0
1749,183,6572,121,293,223,70,4,0,3,1
2317,1176,0,0,144,144,0,1,0,1,0
6291,576,0,0,146,146,0,1,0,1,0
1008,2837,0,0,141,141,0,1,0,1,0
21535,992,11521,48,155,127,28,2,0,1,0
8137,1937,0,0,130,130,0,1,0,1,0
242,1054,0,0,157,157,0,1,0,1,0
3001,1520,0,0,90,90,0,1,0,1,0
2771,1125,0,0,135,135,0,1,0,1,0
11303,1644,0,0,62,62,0,1,0,1,0
7667,2287,0,0,100,100,0,1,0,1,0
1957,2225,0,0,91,91,0,1,0,1,0
697,2673,0,0,144,144,0,1,0,1,0
1706,2547,0,0,111,111,0,1,0,1,0
2897,1698,0,0,62,62,0,1,0,1,0
2211,1594,0,0,77,77,0,1,0,1,0
1262,3095,0,0,139,139,0,1,0,1,0
12067,183,21574,121,293,223,70,4,0,3,1
1313,184,4370,120,292,222,69,3,0,2,0
2877,1694,0,0,62,62,0,1,0,1,0
2500,1694,0,0,62,62,0,1,0,1,0
1291,183,4659,121,293,223,70,4,1,3,1
1406,183,4849,121,293,223,70,4,0,3,1
7911,2228,0,0,112,112,0,1,0,1,0
2268,2115,0,0,91,91,0,1,0,1,0
2645,1694,0,0,62,62,0,1,0,1,0
1718,597,0,0,129,129,0,1,0,1,0
2393,243,0,0,78,78,0,1,0,1,0
2928,183,9830,121,293,223,70,4,1,3,1
10361,1543,0,0,71,71,0,1,0,1,0
11213,1651,0,0,64,64,0,1,0,1,0
2234,422,0,0,62,62,0,1,0,1,0
1763,3095,0,0,150,150,0,1,0,1,0
10559,1507,0,0,71,71,0,1,0,1,0
3579,263,0,0,116,116,0,1,0,1,0
1686,183,6496,121,293,223,70,4,0,3,1
5223,295,0,0,146,146,0,1,0,1,0
2048,183,8056,121,293,223,70,4,0,3,1
2360,1375,0,0,111,111,0,1,0,1,0
1400,3095,0,0,140,140,0,1,0,1,0
2068,902,0,0,124,124,0,1,0,1,0
2913,1248,0,0,135,135,0,1,0,1,0
2907,1433,0,0,105,105,0,1,0,1,0
8261,1289,0,0,154,154,0,1,0,1,0
1693,183,6289,121,293,223,70,4,0,3,1
9768,1586,0,0,93,93,0,1,0,1,0
3027,1694,0,0,62,62,0,1,0,1,0
788,779,0,0,152,152,0,1,0,1,0
4696,183,16166,121,293,223,70,4,1,3,1
1990,183,7747,121,293,223,70,4,0,3,1
2078,1162,0,0,62,62,0,1,0,1,0
2351,1400,0,0,107,107,0,1,0,1,0
2052,1176,0,0,143,143,0,1,0,1,0
1560,436,1175,32,186,168,18,1,0,1,0
372,2598,0,0,142,142,0,1,0,1,0
7964,2062,0,0,117,117,0,1,0,1,0
2252,183,9237,121,293,223,70,4,0,3,1
1001,1005,0,0,154,154,0,1,0,1,0
1637,572,0,0,147,147,0,1,0,1,0
616,1176,0,0,142,142,0,1,0,1,0
10795,1543,0,0,62,62,0,1,0,1,0
393,1123,189,6,150,147,3,1,0,1,0
19704,1543,0,0,63,63,0,1,0,1,0
2166,183,8754,121,293,223,70,4,0,3,1
2184,1444,0,0,62,62,0,1,0,1,0
2066,183,8161,121,293,223,70,4,0,3,1
2155,183,8732,121,293,223,70,4,0,3,1
8088,1884,0,0,126,126,0,1,0,1,0
1757,1176,0,0,141,141,0,1,0,1,0
2933,1694,0,0,62,62,0,1,0,1,0
9624,1597,0,0,98,98,0,1,0,1,0
2145,3095,0,0,156,156,0,1,0,1,0
1507,381,1866,51,209,179,29,2,0,1,0
2939,1694,0,0,62,62,0,1,0,1,0
8022,1978,0,0,121,121,0,1,0,1,0
751,1176,0,0,141,141,0,1,0,1,0
2229,1086,0,0,62,62,0,1,0,1,0
2974,1694,0,0,62,62,0,1,0,1,0
1872,183,7183,121,293,223,70,4,0,3,1
658,1176,0,0,153,153,0,1,0,1,0
10563,1543,0,0,67,67,0,1,0,1,0
1352,183,4597,121,293,223,70,4,0,3,1
9567,1694,0,0,113,113,0,1,0,1,0
6486,684,0,0,146,146,0,1,0,1,0
943,183,3674,121,293,223,70,4,1,3,1
2354,1631,0,0,72,72,0,1,0,1,0
2337,109,0,0,79,79,0,1,0,1,0
1918,799,0,0,73,73,0,1,0,1,0
516,2812,0,0,141,141,0,1,0,1,0
158,2018,0,0,147,147,0,1,0,1,0
921,183,3682,121,293,223,70,4,0,3,1
3729,183,12399,121,293,223,70,4,1,3,1
1526,401,1622,44,201,175,25,2,0,1,0
14894,649,0,0,145,145,0,1,0,1,0
8895,1651,0,0,125,125,0,1,0,1,0
2032,1038,0,0,62,62,0,1,0,1,0
12576,888,0,0,103,103,0,1,0,1,0
9497,1607,0,0,103,103,0,1,0,1,0
1612,1176,0,0,140,140,0,1,0,1,0
3445,1129,0,0,98,98,0,1,0,1,0
1382,183,4908,121,293,223,70,4,1,3,1
11856,1543,0,0,70,70,0,1,0,1,0
368,2593,0,0,143,143,0,1,0,1,0
2960,1354,0,0,118,118,0,1,0,1,0
407,1155,0,0,143,143,0,1,0,1,0
2212,1653,0,0,67,67,0,1,0,1,0
305,1613,0,0,143,143,0,1,0,1,0
2998,1508,0,0,92,92,0,1,0,1,0
2888,1198,0,0,144,144,0,1,0,1,0
1005,233,3058,103,271,212,59,3,0,2,0
1515,928,0,0,142,142,0,1,0,1,0
1874,755,0,0,85,85,0,1,0,1,0
12281,1308,0,0,84,84,0,1,0,1,0
4698,183,16169,121,293,223,70,4,1,3,1
294,1695,0,0,143,143,0,1,0,1,0
9470,1609,0,0,104,104,0,1,0,1,0
2204,183,8989,121,293,223,70,4,0,3,1
2123,3095,0,0,156,156,0,1,0,1,0
10486,1496,0,0,73,73,0,1,0,1,0
2626,2278,0,0,102,102,0,1,0,1,0
499,1176,0,0,142,142,0,1,0,1,0
1487,362,2117,58,217,184,33,2,0,1,0
2884,1176,0,0,147,147,0,1,0,1,0
8834,1433,0,0,145,145,0,1,0,1,0
2340,1643,0,0,70,70,0,1,0,1,0
2619,1440,0,0,62,62,0,1,0,1,0
1420,293,2987,82,246,199,47,3,0,2,0
11305,1233,0,0,89,89,0,1,0,1,0
3810,183,13358,121,293,223,70,4,0,3,1
563,1176,0,0,142,142,0,1,0,1,0
1393,183,4790,121,293,223,70,4,1,3,1
1773,183,7000,121,293,223,70,4,0,3,1
16560,1619,0,0,62,62,0,1,0,1,0
11526,1689,0,0,62,62,0,1,0,1,0
932,183,3652,121,293,223,70,4,1,3,1
2321,391,0,0,88,88,0,1,0,1,0
2778,1694,0,0,62,62,0,1,0,1,0
1697,183,6274,121,293,223,70,4,0,3,1
1329,183,4475,121,293,223,70,4,1,3,1
956,1176,0,0,151,151,0,1,0,1,0
1419,1176,0,0,149,149,0,1,0,1,0
569,2890,0,0,140,140,0,1,0,1,0
1942,183,7486,121,293,223,70,4,0,3,1
1076,3095,0,0,139,139,0,1,0,1,0
1243,183,4255,121,293,223,70,4,1,3,1
2471,1694,0,0,62,62,0,1,0,1,0
2049,183,8184,121,293,223,70,4,0,3,1
2043,869,0,0,69,69,0,1,0,1,0
4619,183,16070,121,293,223,70,4,1,3,1
1779,1388,0,0,107,107,0,1,0,1,0
4609,183,16058,121,293,223,70,4,1,3,1
2089,1190,0,0,62,62,0,1,0,1,0
2630,1176,0,0,146,146,0,1,0,1,0
100,1596,0,0,151,151,0,1,0,1,0
2042,183,8023,121,293,223,70,4,0,3,1
1677,1176,0,0,140,140,0,1,0,1,0
1540,856,0,0,143,143,0,1,0,1,0
739,2074,0,0,148,148,0,1,0,1,0
2456,1694,0,0,62,62,0,1,0,1,0
1363,3095,0,0,139,139,0,1,0,1,0
2646,387,0,0,90,90,0,1,0,1,0
178,2166,0,0,146,146,0,1,0,1,0
1432,3093,0,0,138,138,0,1,0,1,0
789,1160,0,0,156,156,0,1,0,1,0
1658,183,6115,121,293,223,70,4,0,3,1
3560,183,12215,121,293,223,70,4,0,3,1
10059,1543,0,0,82,82,0,1,0,1,0
2121,183,8499,121,293,223,70,4,0,3,1
1387,3095,0,0,147,147,0,1,0,1,0
2454,37,0,0,67,67,0,1,0,1,0
329,1157,0,0,144,144,0,1,0,1,0
922,1176,0,0,152,152,0,1,0,1,0
1065,183,4044,121,293,223,70,4,1,3,1
10618,1543,0,0,66,66,0,1,0,1,0
806,875,1083,36,198,176,21,1,0,1,0
12362,1543,0,0,70,70,0,1,0,1,0
1032,183,3846,121,293,223,70,4,1,3,1
720,2669,0,0,142,142,0,1,0,1,0
1792,671,0,0,108,108,0,1,0,1,0
2051,913,0,0,62,62,0,1,0,1,0
1298,1159,0,0,140,140,0,1,0,1,0
2914,1217,0,0,141,141,0,1,0,1,0
6876,2345,0,0,83,83,0,1,0,1,0
8678,1543,0,0,134,134,0,1,0,1,0
921,2820,0,0,143,143,0,1,0,1,0
9696,1592,0,0,96,96,0,1,0,1,0
9942,1543,0,0,91,91,0,1,0,1,0
10362,1543,0,0,71,71,0,1,0,1,0
8311,1713,0,0,144,144,0,1,0,1,0
1469,1151,0,0,133,133,0,1,0,1,0
8438,1203,0,0,149,149,0,1,0,1,0
3875,335,0,0,131,131,0,1,0,1,0
1410,183,4874,121,293,223,70,4,1,3,1
4437,374,0,0,146,146,0,1,0,1,0
1940,1081,0,0,120,120,0,1,0,1,0
258,1122,0,0,147,147,0,1,0,1,0
12094,974,0,0,104,104,0,1,0,1,0
10656,1543,0,0,65,65,0,1,0,1,0
2355,1631,0,0,72,72,0,1,0,1,0
1754,466,0,0,137,137,0,1,0,1,0
10433,1565,0,0,74,74,0,1,0,1,0
1409,3095,0,0,139,139,0,1,0,1,0
4468,183,10661,121,293,223,70,4,0,3,1
2809,1262,0,0,133,133,0,1,0,1,0
1839,183,6466,121,293,223,70,4,1,3,1
7939,1762,0,0,127,127,0,1,0,1,0
2909,1365,0,0,116,116,0,1,0,1,0
2440,112,0,0,62,62,0,1,0,1,0
1902,183,7278,121,293,223,70,4,0,3,1
3616,183,12982,121,293,223,70,4,0,3,1
4062,183,13817,121,293,223,70,4,0,3,1
1152,894,0,0,153,153,0,1,0,1,0
927,3095,0,0,139,139,0,1,0,1,0
674,812,0,0,153,153,0,1,0,1,0
8524,1543,0,0,139,139,0,1,0,1,0
9159,1643,0,0,117,117,0,1,0,1,0
842,595,2092,70,236,195,40,2,0,2,0
8268,1286,0,0,153,153,0,1,0,1,0
2496,1694,0,0,62,62,0,1,0,1,0
238,2102,0,0,144,144,0,1,0,1,0
717,2752,0,0,142,142,0,1,0,1,0
2408,1588,0,0,79,79,0,1,0,1,0
8864,1283,0,0,132,132,0,1,0,1,0
5789,417,0,0,140,140,0,1,0,1,0
845,3095,0,0,139,139,0,1,0,1,0
2175,1421,0,0,62,62,0,1,0,1,0
15962,183,23087,121,293,223,70,4,0,3,1
980,3095,0,0,139,139,0,1,0,1,0
4749,183,16232,121,293,223,70,4,1,3,1
8184,1288,0,0,151,151,0,1,0,1,0
168,1077,0,0,150,150,0,1,0,1,0
1620,2782,0,0,121,121,0,1,0,1,0
445,2707,0,0,142,142,0,1,0,1,0
979,183,3744,121,293,223,70,4,1,3,1
7259,1018,0,0,146,146,0,1,0,1,0
2033,183,7976,121,293,223,70,4,0,3,1
16253,2644,0,0,120,120,0,1,0,1,0
4382,183,14867,121,293,223,70,4,0,3,1
1093,183,3965,121,293,223,70,4,1,3,1
5699,258,0,0,145,145,0,1,0,1,0
2144,748,0,0,113,113,0,1,0,1,0
15606,2514,0,0,110,110,0,1,0,1,0
1530,1112,0,0,124,124,0,1,0,1,0
2815,1587,0,0,78,78,0,1,0,1,0
1411,183,4881,121,293,223,70,4,1,3,1
402,1050,0,0,152,152,0,1,0,1,0
9016,1309,0,0,125,125,0,1,0,1,0
863,1106,0,0,156,156,0,1,0,1,0
10698,1585,0,0,69,69,0,1,0,1,0
1353,3047,0,0,139,139,0,1,0,1,0
1758,1176,0,0,145,145,0,1,0,1,0
3802,880,0,0,147,147,0,1,0,1,0
1983,183,7710,121,293,223,70,4,0,3,1
13056,902,0,0,107,107,0,1,0,1,0
19202,2747,0,0,126,126,0,1,0,1,0
8911,1543,0,0,126,126,0,1,0,1,0
1339,3095,0,0,142,142,0,1,0,1,0
10687,1543,0,0,64,64,0,1,0,1,0
11479,1680,0,0,62,62,0,1,0,1,0
2164,527,0,0,62,62,0,1,0,1,0
11387,1673,0,0,63,63,0,1,0,1,0
1753,632,0,0,119,119,0,1,0,1,0
1684,561,0,0,138,138,0,1,0,1,0
2891,183,11144,121,293,223,70,4,0,3,1
1674,552,0,0,141,141,0,1,0,1,0
2114,183,8437,121,293,223,70,4,0,3,1
2416,197,0,0,75,75,0,1,0,1,0
1135,183,4467,121,293,223,70,4,0,3,1
7355,2932,0,0,68,68,0,1,0,1,0
1966,183,7615,121,293,223,70,4,0,3,1
2266,1676,0,0,64,64,0,1,0,1,0
1945,1014,0,0,103,103,0,1,0,1,0
1212,2961,0,0,140,140,0,1,0,1,0
1533,183,5479,121,293,223,70,4,0,3,1
3023,1694,0,0,62,62,0,1,0,1,0
780,1078,351,11,170,163,6,1,0,1,0
21447,701,17615,74,204,161,43,2,0,2,0
1754,183,6554,121,293,223,70,4,0,3,1
2120,183,8491,121,293,223,70,4,0,3,1
1914,183,7337,121,293,223,70,4,0,3,1
1760,778,0,0,146,146,0,1,0,1,0
11672,1692,0,0,62,62,0,1,0,1,0
1832,3095,0,0,153,153,0,1,0,1,0
1584,725,0,0,145,145,0,1,0,1,0
2785,183,10831,121,293,223,70,4,0,3,1
834,1127,0,0,156,156,0,1,0,1,0
1215,329,2063,69,231,191,40,2,0,2,0
19569,1543,0,0,62,62,0,1,0,1,0
977,183,3740,121,293,223,70,4,1,3,1
1230,183,4229,121,293,223,70,4,1,3,1
327,1156,0,0,144,144,0,1,0,1,0
8318,1506,0,0,147,147,0,1,0,1,0
1753,3095,0,0,146,146,0,1,0,1,0
3790,884,0,0,147,147,0,1,0,1,0
216,2261,0,0,144,144,0,1,0,1,0
1935,1176,0,0,143,143,0,1,0,1,0
376,2462,0,0,144,144,0,1,0,1,0
1009,3095,0,0,139,139,0,1,0,1,0
1401,3095,0,0,140,140,0,1,0,1,0
1530,183,5457,121,293,223,70,4,0,3,1
2076,1391,0,0,109,109,0,1,0,1,0
2664,183,9837,121,293,223,70,4,0,3,1
3037,1694,0,0,62,62,0,1,0,1,0
8909,1694,0,0,130,130,0,1,0,1,0
361,2582,0,0,143,143,0,1,0,1,0
9955,1190,0,0,145,145,0,1,0,1,0
376,1990,0,0,148,148,0,1,0,1,0
9066,1639,0,0,119,119,0,1,0,1,0
2202,1580,0,0,79,79,0,1,0,1,0
7883,1871,0,0,121,121,0,1,0,1,0
2821,1859,0,0,73,73,0,1,0,1,0
13734,183,20840,121,293,223,70,4,0,3,1
157,2015,0,0,147,147,0,1,0,1,0
84,1036,0,0,154,154,0,1,0,1,0
2918,1694,0,0,62,62,0,1,0,1,0
9734,1543,0,0,94,94,0,1,0,1,0
2629,183,9738,121,293,223,70,4,0,3,1
2095,846,0,0,120,120,0,1,0,1,0
8269,1625,0,0,141,141,0,1,0,1,0
2053,183,8084,121,293,223,70,4,0,3,1
1967,183,7622,121,293,223,70,4,0,3,1
2801,1268,0,0,132,132,0,1,0,1,0
8327,1649,0,0,146,146,0,1,0,1,0
2107,1437,0,0,102,102,0,1,0,1,0
2107,250,0,0,102,102,0,1,0,1,0
1689,3095,0,0,151,151,0,1,0,1,0
12668,854,0,0,106,106,0,1,0,1,0
18314,2980,0,0,145,145,0,1,0,1,0
20982,1889,0,0,80,80,0,1,0,1,0
2313,1380,0,0,111,111,0,1,0,1,0
1591,183,5762,121,293,223,70,4,0,3,1
2916,183,11220,121,293,223,70,4,0,3,1
8433,1208,0,0,149,149,0,1,0,1,0
2107,183,8251,121,293,223,70,4,0,3,1
11391,879,0,0,145,145,0,1,0,1,0
1758,636,0,0,118,118,0,1,0,1,0
196,2292,0,0,145,145,0,1,0,1,0
2044,1071,0,0,62,62,0,1,0,1,0
2318,213,0,0,75,75,0,1,0,1,0
9953,1619,0,0,103,103,0,1,0,1,0
500,1731,0,0,151,151,0,1,0,1,0
2264,153,0,0,86,86,0,1,0,1,0
4686,349,0,0,146,146,0,1,0,1,0
3640,278,0,0,119,119,0,1,0,1,0
1511,940,0,0,142,142,0,1,0,1,0
10611,1543,0,0,66,66,0,1,0,1,0
1656,540,0,0,147,147,0,1,0,1,0
7890,1454,0,0,146,146,0,1,0,1,0
783,1053,440,14,173,165,8,1,0,1,0
1727,987,0,0,95,95,0,1,0,1,0
6287,1300,0,0,114,114,0,1,0,1,0
1042,183,3865,121,293,223,70,4,1,3,1
1205,1176,0,0,145,145,0,1,0,1,0
2926,1694,0,0,62,62,0,1,0,1,0
2011,1017,0,0,132,132,0,1,0,1,0
10508,1543,0,0,72,72,0,1,0,1,0
1496,1176,0,0,139,139,0,1,0,1,0
323,914,0,0,155,155,0,1,0,1,0
243,2063,0,0,144,144,0,1,0,1,0
17606,1543,0,0,62,62,0,1,0,1,0
2745,1694,0,0,62,62,0,1,0,1,0
204,2344,0,0,144,144,0,1,0,1,0
21262,1549,0,0,62,62,0,1,0,1,0
1946,828,0,0,65,65,0,1,0,1,0
5585,285,0,0,146,146,0,1,0,1,0
7948,2181,0,0,115,115,0,1,0,1,0
16470,1724,0,0,145,145,0,1,0,1,0
9992,1570,0,0,85,85,0,1,0,1,0
11536,1692,0,0,62,62,0,1,0,1,0
133,1060,0,0,152,152,0,1,0,1,0
2909,1376,0,0,114,114,0,1,0,1,0
2083,264,0,0,104,104,0,1,0,1,0
1871,183,7179,121,293,223,70,4,0,3,1
3381,1299,0,0,87,87,0,1,0,1,0
1996,562,0,0,98,98,0,1,0,1,0
496,1110,0,0,143,143,0,1,0,1,0
2670,457,0,0,95,95,0,1,0,1,0
1310,183,4385,121,293,223,70,4,1,3,1
8298,1416,0,0,149,149,0,1,0,1,0
1555,812,0,0,144,144,0,1,0,1,0
216,1048,0,0,157,157,0,1,0,1,0
1391,183,5514,121,293,223,70,4,0,3,1
1375,3095,0,0,141,141,0,1,0,1,0
1528,2935,0,0,130,130,0,1,0,1,0
2170,1532,0,0,87,87,0,1,0,1,0
8283,1750,0,0,142,142,0,1,0,1,0
1316,183,4410,121,293,223,70,4,1,3,1
1926,807,0,0,70,70,0,1,0,1,0
10540,1504,0,0,71,71,0,1,0,1,0
1959,340,0,0,117,117,0,1,0,1,0
2932,1243,0,0,136,136,0,1,0,1,0
2263,1654,0,0,62,62,0,1,0,1,0
450,1133,0,0,143,143,0,1,0,1,0
394,1176,0,0,143,143,0,1,0,1,0
1131,2958,0,0,143,143,0,1,0,1,0
1411,419,1137,38,194,171,22,1,0,1,0
1781,183,6811,121,293,223,70,4,0,3,1
2230,183,9126,121,293,223,70,4,0,3,1
3261,1318,0,0,86,86,0,1,0,1,0
1211,183,4194,121,293,223,70,4,1,3,1
4030,476,0,0,146,146,0,1,0,1,0
7958,1726,0,0,129,129,0,1,0,1,0
1818,1412,0,0,103,103,0,1,0,1,0
2057,183,8107,121,293,223,70,4,0,3,1
864,3095,0,0,141,141,0,1,0,1,0
2187,1843,0,0,70,70,0,1,0,1,0
11472,1678,0,0,62,62,0,1,0,1,0
2965,183,10453,121,293,223,70,4,0,3,1
8327,1594,0,0,146,146,0,1,0,1,0
8291,1476,0,0,150,150,0,1,0,1,0
1537,183,6259,121,293,223,70,4,0,3,1
4841,183,16346,121,293,223,70,4,1,3,1
10815,1004,0,0,145,145,0,1,0,1,0
1646,545,0,0,147,147,0,1,0,1,0
1700,183,6321,121,293,223,70,4,0,3,1
2626,331,0,0,86,86,0,1,0,1,0
379,1086,0,0,157,157,0,1,0,1,0
10208,1516,0,0,78,78,0,1,0,1,0
2374,1615,0,0,75,75,0,1,0,1,0
1480,1144,0,0,131,131,0,1,0,1,0
4150,183,14256,121,293,223,70,4,0,3,1
1383,406,1270,42,199,174,24,2,0,1,0
1104,3095,0,0,139,139,0,1,0,1,0
20636,2056,0,0,89,89,0,1,0,1,0
8426,1521,0,0,145,145,0,1,0,1,0
7435,2737,0,0,77,77,0,1,0,1,0
7462,2779,0,0,77,77,0,1,0,1,0
1000,1176,0,0,140,140,0,1,0,1,0
9939,1543,0,0,87,87,0,1,0,1,0
2090,1413,0,0,105,105,0,1,0,1,0
2198,3095,0,0,157,157,0,1,0,1,0
208,2351,0,0,144,144,0,1,0,1,0
1644,1306,0,0,119,119,0,1,0,1,0
2370,1213,0,0,62,62,0,1,0,1,0
1365,183,4652,121,293,223,70,4,0,3,1
1912,183,7324,121,293,223,70,4,0,3,1
1428,301,2887,79,243,197,46,2,0,2,0
2587,183,9571,121,293,223,70,4,0,3,1
777,3095,0,0,139,139,0,1,0,1,0
1301,3070,0,0,143,143,0,1,0,1,0
1947,183,7559,121,293,223,70,4,0,3,1
12894,1966,0,0,78,78,0,1,0,1,0
956,3095,0,0,139,139,0,1,0,1,0
17606,2927,0,0,137,137,0,1,0,1,0
2493,1519,0,0,90,90,0,1,0,1,0
17499,2425,0,0,145,145,0,1,0,1,0
1460,183,5784,121,293,223,70,4,0,3,1
17802,2957,0,0,136,136,0,1,0,1,0
11362,1656,0,0,62,62,0,1,0,1,0
2826,77,0,0,78,78,0,1,0,1,0
7713,2419,0,0,97,97,0,1,0,1,0
1361,3095,0,0,142,142,0,1,0,1,0
9843,1404,0,0,97,97,0,1,0,1,0
2895,183,9724,121,293,223,70,4,1,3,1
939,1176,0,0,152,152,0,1,0,1,0
848,3095,0,0,139,139,0,1,0,1,0
907,183,3604,121,293,223,70,4,1,3,1
6307,1335,0,0,113,113,0,1,0,1,0
1424,3095,0,0,139,139,0,1,0,1,0
8064,1414,0,0,146,146,0,1,0,1,0
11871,1047,0,0,99,99,0,1,0,1,0
1450,183,5093,121,293,223,70,4,1,3,1
1901,376,0,0,123,123,0,1,0,1,0
1945,1008,0,0,102,102,0,1,0,1,0
242,2406,0,0,144,144,0,1,0,1,0
2256,1661,0,0,67,67,0,1,0,1,0
1692,1176,0,0,141,141,0,1,0,1,0
1676,3095,0,0,151,151,0,1,0,1,0
3089,183,11046,121,293,223,70,4,0,3,1
7284,3044,0,0,62,62,0,1,0,1,0
1932,183,7439,121,293,223,70,4,0,3,1
754,1176,0,0,141,141,0,1,0,1,0
3020,1694,0,0,62,62,0,1,0,1,0
3011,1694,0,0,62,62,0,1,0,1,0
16084,560,0,0,125,125,0,1,0,1,0
1936,1131,0,0,132,132,0,1,0,1,0
1877,3095,0,0,154,154,0,1,0,1,0
18107,2839,0,0,145,145,0,1,0,1,0
1174,183,4120,121,293,223,70,4,1,3,1
370,2595,0,0,143,143,0,1,0,1,0
1662,3095,0,0,148,148,0,1,0,1,0
1330,183,4480,121,293,223,70,4,1,3,1
299,1659,0,0,143,143,0,1,0,1,0
19298,2701,0,0,123,123,0,1,0,1,0
2124,183,8493,121,293,223,70,4,0,3,1
2808,1694,0,0,62,62,0,1,0,1,0
1949,183,7526,121,293,223,70,4,0,3,1
7380,183,18075,121,293,223,70,4,0,3,1
385,2468,0,0,144,144,0,1,0,1,0
2449,1694,0,0,62,62,0,1,0,1,0
11079,1634,0,0,65,65,0,1,0,1,0
2396,1597,0,0,78,78,0,1,0,1,0
4570,183,16010,121,293,223,70,4,1,3,1
3629,183,12077,121,293,223,70,4,1,3,1
2899,1685,0,0,63,63,0,1,0,1,0
2220,443,0,0,62,62,0,1,0,1,0
1576,1176,0,0,140,140,0,1,0,1,0
2967,1383,0,0,113,113,0,1,0,1,0
1667,2705,0,0,117,117,0,1,0,1,0
1015,3095,0,0,143,143,0,1,0,1,0
10655,1543,0,0,65,65,0,1,0,1,0
1385,406,1262,42,199,174,24,2,0,1,0
1652,529,0,0,147,147,0,1,0,1,0
576,2594,0,0,144,144,0,1,0,1,0
2126,1290,0,0,62,62,0,1,0,1,0
4385,379,0,0,146,146,0,1,0,1,0
1848,728,0,0,92,92,0,1,0,1,0
7751,2125,0,0,108,108,0,1,0,1,0
2325,183,8194,121,293,223,70,4,1,3,1
1937,1118,0,0,129,129,0,1,0,1,0
2131,183,8532,121,293,223,70,4,0,3,1
1755,465,0,0,137,137,0,1,0,1,0
4796,183,15822,121,293,223,70,4,1,3,1
1720,2617,0,0,112,112,0,1,0,1,0
943,885,0,0,145,145,0,1,0,1,0
3022,125,0,0,88,88,0,1,0,1,0
1677,183,6463,121,293,223,70,4,0,3,1
2773,1694,0,0,62,62,0,1,0,1,0
2373,1694,0,0,62,62,0,1,0,1,0
2555,1694,0,0,62,62,0,1,0,1,0
1982,1176,0,0,143,143,0,1,0,1,0
2116,183,8447,121,293,223,70,4,0,3,1
797,3095,0,0,139,139,0,1,0,1,0
1594,183,5771,121,293,223,70,4,0,3,1
1175,3095,0,0,145,145,0,1,0,1,0
2085,3095,0,0,156,156,0,1,0,1,0
1988,1259,0,0,129,129,0,1,0,1,0
1860,183,7125,121,293,223,70,4,0,3,1
3424,1150,0,0,97,97,0,1,0,1,0
480,1176,0,0,146,146,0,1,0,1,0
1878,183,7211,121,293,223,70,4,0,3,1
11358,1670,0,0,63,63,0,1,0,1,0
56,1011,0,0,157,157,0,1,0,1,0
9210,1543,0,0,113,113,0,1,0,1,0
10460,1493,0,0,74,74,0,1,0,1,0
3015,1578,0,0,81,81,0,1,0,1,0
3036,1687,0,0,62,62,0,1,0,1,0
1738,183,6513,121,293,223,70,4,0,3,1
3696,869,0,0,115,115,0,1,0,1,0
307,1598,0,0,143,143,0,1,0,1,0
307,1596,0,0,143,143,0,1,0,1,0
8281,183,18958,121,293,223,70,4,0,3,1
13961,361,0,0,138,138,0,1,0,1,0
4720,183,15577,121,293,223,70,4,1,3,1
1960,3095,0,0,155,155,0,1,0,1,0
20031,2347,0,0,105,105,0,1,0,1,0
607,2947,0,0,140,140,0,1,0,1,0
18678,183,26510,121,293,223,70,4,0,3,1
8318,1506,0,0,147,147,0,1,0,1,0
2217,1533,0,0,62,62,0,1,0,1,0
4147,403,0,0,145,145,0,1,0,1,0
1962,183,7594,121,293,223,70,4,0,3,1
3130,183,11566,121,293,223,70,4,0,3,1
52,1255,0,0,154,154,0,1,0,1,0
2814,878,0,0,126,126,0,1,0,1,0
8654,1669,0,0,134,134,0,1,0,1,0
16801,2755,0,0,124,124,0,1,0,1,0
2034,183,7981,121,293,223,70,4,0,3,1
8499,1543,0,0,140,140,0,1,0,1,0
969,183,3782,121,293,223,70,4,1,3,1
2260,382,0,0,62,62,0,1,0,1,0
1889,1176,0,0,143,143,0,1,0,1,0
2909,1694,0,0,62,62,0,1,0,1,0
3007,1694,0,0,62,62,0,1,0,1,0
1903,662,0,0,105,105,0,1,0,1,0
2088,2007,0,0,79,79,0,1,0,1,0
1462,1082,0,0,140,140,0,1,0,1,0
1959,183,7717,121,293,223,70,4,0,3,1
2276,1696,0,0,62,62,0,1,0,1,0
13669,582,0,0,125,125,0,1,0,1,0
8302,1434,0,0,149,149,0,1,0,1,0
1937,1119,0,0,129,129,0,1,0,1,0
12341,1543,0,0,62,62,0,1,0,1,0
2277,1336,0,0,117,117,0,1,0,1,0
4902,327,0,0,146,146,0,1,0,1,0
1297,1176,0,0,139,139,0,1,0,1,0
2458,1694,0,0,62,62,0,1,0,1,0
10190,1555,0,0,78,78,0,1,0,1,0
2255,1633,0,0,62,62,0,1,0,1,0
4578,183,15233,121,293,223,70,4,0,3,1
1469,1176,0,0,139,139,0,1,0,1,0
892,187,3563,120,292,222,69,3,0,2,0
197,2298,0,0,145,145,0,1,0,1,0
1035,3095,0,0,141,141,0,1,0,1,0
2187,200,0,0,94,94,0,1,0,1,0
2350,1635,0,0,71,71,0,1,0,1,0
1145,1176,0,0,146,146,0,1,0,1,0
469,872,0,0,154,154,0,1,0,1,0
2992,1484,0,0,96,96,0,1,0,1,0
1350,680,0,0,146,146,0,1,0,1,0
7450,2821,0,0,76,76,0,1,0,1,0
458,1002,623,21,169,156,12,1,0,1,0
3491,241,0,0,112,112,0,1,0,1,0
1367,3095,0,0,141,141,0,1,0,1,0
10507,1694,0,0,89,89,0,1,0,1,0
12647,1916,0,0,75,75,0,1,0,1,0
1755,3095,0,0,150,150,0,1,0,1,0
10665,1543,0,0,65,65,0,1,0,1,0
727,2667,0,0,142,142,0,1,0,1,0
9748,1391,0,0,101,101,0,1,0,1,0
18966,183,26763,121,293,223,70,4,0,3,1
10448,1554,0,0,71,71,0,1,0,1,0
4351,697,0,0,146,146,0,1,0,1,0
10506,1543,0,0,68,68,0,1,0,1,0
3037,1694,0,0,62,62,0,1,0,1,0
1707,585,0,0,132,132,0,1,0,1,0
2227,1618,0,0,73,73,0,1,0,1,0
11098,1637,0,0,65,65,0,1,0,1,0
2017,183,7680,121,293,223,70,4,0,3,1
1164,183,4315,121,293,223,70,4,1,3,1
10507,1543,0,0,68,68,0,1,0,1,0
2911,1325,0,0,123,123,0,1,0,1,0
1563,1176,0,0,140,140,0,1,0,1,0
10801,1543,0,0,62,62,0,1,0,1,0
1433,183,4992,121,293,223,70,4,0,3,1
3108,183,11508,121,293,223,70,4,0,3,1
2049,183,8067,121,293,223,70,4,0,3,1
1201,1176,0,0,145,145,0,1,0,1,0
10552,1543,0,0,67,67,0,1,0,1,0
1194,1176,0,0,145,145,0,1,0,1,0
7261,1019,0,0,146,146,0,1,0,1,0
20441,2150,0,0,94,94,0,1,0,1,0
227,2182,0,0,144,144,0,1,0,1,0
2610,1694,0,0,62,62,0,1,0,1,0
2401,1593,0,0,78,78,0,1,0,1,0
2162,183,8769,121,293,223,70,4,0,3,1
21367,435,23173,98,250,193,56,3,0,2,0
701,1176,0,0,154,154,0,1,0,1,0
854,497,2446,82,249,202,47,3,0,2,0
2756,1560,0,0,82,82,0,1,0,1,0
2255,159,0,0,87,87,0,1,0,1,0
1357,183,4612,121,293,223,70,4,1,3,1
2349,1694,0,0,62,62,0,1,0,1,0
10820,1630,0,0,76,76,0,1,0,1,0
537,854,1160,39,191,168,22,1,0,1,0
721,2663,0,0,142,142,0,1,0,1,0
9256,1637,0,0,114,114,0,1,0,1,0
1299,3095,0,0,142,142,0,1,0,1,0
2756,183,10342,121,293,223,70,4,0,3,1
3492,183,12195,121,293,223,70,4,0,3,1
1609,485,547,15,166,157,8,1,0,1,0
2693,1418,0,0,62,62,0,1,0,1,0
8294,1399,0,0,150,150,0,1,0,1,0
18385,3029,0,0,145,145,0,1,0,1,0
724,1166,0,0,157,157,0,1,0,1,0
1732,183,6667,121,293,223,70,4,0,3,1
2061,183,8246,121,293,223,70,4,0,3,1
771,415,2740,92,257,204,53,3,0,2,0
13325,762,0,0,115,115,0,1,0,1,0
1332,183,4488,121,293,223,70,4,1,3,1
4221,395,0,0,146,146,0,1,0,1,0
2078,183,8259,121,293,223,70,4,0,3,1
2173,183,8779,121,293,223,70,4,0,3,1
2347,181,0,0,73,73,0,1,0,1,0
7078,929,0,0,146,146,0,1,0,1,0
7394,2876,0,0,71,71,0,1,0,1,0
2213,183,8223,121,293,223,70,4,0,3,1
1596,183,5809,121,293,223,70,4,0,3,1
998,3095,0,0,140,140,0,1,0,1,0
445,1101,0,0,157,157,0,1,0,1,0
10431,1543,0,0,70,70,0,1,0,1,0
600,1058,0,0,143,143,0,1,0,1,0
1423,3095,0,0,139,139,0,1,0,1,0
10457,1555,0,0,71,71,0,1,0,1,0
9133,1543,0,0,118,118,0,1,0,1,0
564,2884,0,0,140,140,0,1,0,1,0
244,2375,0,0,144,144,0,1,0,1,0
20205,1543,0,0,63,63,0,1,0,1,0
1220,3016,0,0,143,143,0,1,0,1,0
518,1694,0,0,151,151,0,1,0,1,0
884,915,0,0,145,145,0,1,0,1,0
265,1060,0,0,157,157,0,1,0,1,0
1584,459,875,24,176,162,13,1,0,1,0
571,2572,0,0,143,143,0,1,0,1,0
11210,1625,0,0,62,62,0,1,0,1,0
11054,1631,0,0,66,66,0,1,0,1,0
8327,1590,0,0,146,146,0,1,0,1,0
1418,183,4917,121,293,223,70,4,1,3,1
1844,2412,0,0,101,101,0,1,0,1,0
1424,183,4939,121,293,223,70,4,0,3,1
11295,183,20998,121,293,223,70,4,0,3,1
2477,183,9305,121,293,223,70,4,0,3,1
4570,360,0,0,146,146,0,1,0,1,0
11538,1692,0,0,62,62,0,1,0,1,0
2368,1176,0,0,145,145,0,1,0,1,0
1953,904,0,0,77,77,0,1,0,1,0
1657,534,0,0,146,146,0,1,0,1,0
5358,282,0,0,146,146,0,1,0,1,0
316,2515,0,0,143,143,0,1,0,1,0
8327,1544,0,0,146,146,0,1,0,1,0
368,1083,0,0,157,157,0,1,0,1,0
3687,183,13220,121,293,223,70,4,0,3,1
12649,607,0,0,145,145,0,1,0,1,0
1599,183,5818,121,293,223,70,4,0,3,1
1874,183,7140,121,293,223,70,4,0,3,1
15762,2544,0,0,115,115,0,1,0,1,0
1746,746,0,0,146,146,0,1,0,1,0
10035,1543,0,0,83,83,0,1,0,1,0
10363,1543,0,0,77,77,0,1,0,1,0
1108,183,3993,121,293,223,70,4,1,3,1
1151,780,0,0,146,146,0,1,0,1,0
7549,183,14603,121,293,223,70,4,0,3,1
11502,1685,0,0,62,62,0,1,0,1,0
2948,1694,0,0,62,62,0,1,0,1,0
2841,1534,0,0,62,62,0,1,0,1,0
7965,1495,0,0,146,146,0,1,0,1,0
1901,183,7270,121,293,223,70,4,0,3,1
351,2042,0,0,148,148,0,1,0,1,0
8276,1384,0,0,152,152,0,1,0,1,0
1460,1176,0,0,148,148,0,1,0,1,0
11854,1053,0,0,99,99,0,1,0,1,0
10291,1548,0,0,74,74,0,1,0,1,0
7658,1327,0,0,146,146,0,1,0,1,0
1914,3095,0,0,154,154,0,1,0,1,0
74,1009,0,0,156,156,0,1,0,1,0
1045,3095,0,0,141,141,0,1,0,1,0
8484,1684,0,0,140,140,0,1,0,1,0
8327,1587,0,0,146,146,0,1,0,1,0
8557,1543,0,0,138,138,0,1,0,1,0
257,1962,0,0,144,144,0,1,0,1,0
8288,1453,0,0,151,151,0,1,0,1,0
183,1085,0,0,150,150,0,1,0,1,0
10510,1561,0,0,72,72,0,1,0,1,0
841,1176,0,0,155,155,0,1,0,1,0
1629,183,6002,121,293,223,70,4,0,3,1
18474,3089,0,0,145,145,0,1,0,1,0
9193,1311,0,0,121,121,0,1,0,1,0
864,1176,0,0,141,141,0,1,0,1,0
307,1600,0,0,143,143,0,1,0,1,0
8279,1335,0,0,152,152,0,1,0,1,0
2262,2353,0,0,107,107,0,1,0,1,0
16378,183,24872,121,293,223,70,4,0,3,1
1585,2727,0,0,121,121,0,1,0,1,0
11443,1673,0,0,62,62,0,1,0,1,0
982,183,3819,121,293,223,70,4,1,3,1
566,1176,0,0,149,149,0,1,0,1,0
9363,1617,0,0,108,108,0,1,0,1,0
2656,1386,0,0,113,113,0,1,0,1,0
8327,1598,0,0,146,146,0,1,0,1,0
1579,1176,0,0,140,140,0,1,0,1,0
1767,1176,0,0,141,141,0,1,0,1,0
2603,1429,0,0,105,105,0,1,0,1,0
2057,874,0,0,70,70,0,1,0,1,0
14573,431,0,0,145,145,0,1,0,1,0
91,1532,0,0,152,152,0,1,0,1,0
1845,974,0,0,144,144,0,1,0,1,0
1404,183,4846,121,293,223,70,4,1,3,1
2063,183,8140,121,293,223,70,4,0,3,1
2083,3095,0,0,156,156,0,1,0,1,0
696,2672,0,0,144,144,0,1,0,1,0
14918,666,0,0,145,145,0,1,0,1,0
2113,894,0,0,75,75,0,1,0,1,0
9960,1738,0,0,70,70,0,1,0,1,0
1100,1176,0,0,147,147,0,1,0,1,0
2917,183,10664,121,293,223,70,4,0,3,1
1179,183,4354,121,293,223,70,4,1,3,1
2795,823,0,0,122,122,0,1,0,1,0
1990,321,0,0,114,114,0,1,0,1,0
2640,1694,0,0,62,62,0,1,0,1,0
2051,183,8079,121,293,223,70,4,0,3,1
2980,1694,0,0,62,62,0,1,0,1,0
7853,2219,0,0,108,108,0,1,0,1,0
2070,183,8181,121,293,223,70,4,0,3,1
3076,1656,0,0,64,64,0,1,0,1,0
2918,1694,0,0,62,62,0,1,0,1,0
1671,1022,0,0,103,103,0,1,0,1,0
2417,1694,0,0,62,62,0,1,0,1,0
591,1543,0,0,153,153,0,1,0,1,0
9385,1615,0,0,107,107,0,1,0,1,0
1366,183,4671,121,293,223,70,4,0,3,1
130,1058,0,0,152,152,0,1,0,1,0
3872,725,0,0,125,125,0,1,0,1,0
1126,3095,0,0,141,141,0,1,0,1,0
4108,183,14522,121,293,223,70,4,1,3,1
5585,259,0,0,146,146,0,1,0,1,0
1867,183,7107,121,293,223,70,4,0,3,1
446,2508,0,0,144,144,0,1,0,1,0
7774,2332,0,0,101,101,0,1,0,1,0
244,2052,0,0,144,144,0,1,0,1,0
1938,1099,0,0,124,124,0,1,0,1,0
9562,1602,0,0,101,101,0,1,0,1,0
1671,1022,0,0,103,103,0,1,0,1,0
1203,183,4780,121,293,223,70,4,0,3,1
1435,1173,0,0,138,138,0,1,0,1,0
954,183,3694,121,293,223,70,4,1,3,1
3961,520,0,0,146,146,0,1,0,1,0
5903,363,0,0,146,146,0,1,0,1,0
1757,3095,0,0,147,147,0,1,0,1,0
1759,1176,0,0,141,141,0,1,0,1,0
3256,1324,0,0,86,86,0,1,0,1,0
147,1937,0,0,148,148,0,1,0,1,0
7609,2400,0,0,94,94,0,1,0,1,0
1428,3095,0,0,139,139,0,1,0,1,0
2167,183,8742,121,293,223,70,4,0,3,1
760,1190,0,0,156,156,0,1,0,1,0
1746,3095,0,0,146,146,0,1,0,1,0
9119,1580,0,0,125,125,0,1,0,1,0
3141,155,0,0,94,94,0,1,0,1,0
3367,1315,0,0,86,86,0,1,0,1,0
7550,2653,0,0,84,84,0,1,0,1,0
11169,1616,0,0,62,62,0,1,0,1,0
11846,1055,0,0,99,99,0,1,0,1,0
2130,183,8341,121,293,223,70,4,0,3,1
2677,1694,0,0,62,62,0,1,0,1,0
1730,608,0,0,126,126,0,1,0,1,0
2016,183,7883,121,293,223,70,4,0,3,1
1700,1176,0,0,145,145,0,1,0,1,0
1749,1176,0,0,145,145,0,1,0,1,0
1938,1097,0,0,124,124,0,1,0,1,0
2616,1694,0,0,62,62,0,1,0,1,0
8320,1655,0,0,146,146,0,1,0,1,0
1722,601,0,0,128,128,0,1,0,1,0
4288,389,0,0,146,146,0,1,0,1,0
1682,183,6199,121,293,223,70,4,0,3,1
355,1251,0,0,143,143,0,1,0,1,0
467,984,690,23,171,158,13,1,0,1,0
1724,183,6494,121,293,223,70,4,0,3,1
10161,183,20331,121,293,223,70,4,0,3,1
5005,183,16550,121,293,223,70,4,1,3,1
2393,74,0,0,74,74,0,1,0,1,0
9414,1613,0,0,106,106,0,1,0,1,0
1560,796,0,0,144,144,0,1,0,1,0
2594,1694,0,0,62,62,0,1,0,1,0
17059,2125,0,0,145,145,0,1,0,1,0
8151,1919,0,0,131,131,0,1,0,1,0
4933,183,16262,121,293,223,70,4,1,3,1
1367,183,4662,121,293,223,70,4,1,3,1
2513,1503,0,0,93,93,0,1,0,1,0
9736,1389,0,0,101,101,0,1,0,1,0
2796,1694,0,0,62,62,0,1,0,1,0
751,1697,0,0,152,152,0,1,0,1,0
10771,1694,0,0,82,82,0,1,0,1,0
2270,2008,0,0,83,83,0,1,0,1,0
14319,258,0,0,145,145,0,1,0,1,0
781,1166,0,0,156,156,0,1,0,1,0
17996,894,0,0,103,103,0,1,0,1,0
1127,183,4213,121,293,223,70,4,1,3,1
11189,1701,0,0,79,79,0,1,0,1,0
702,1176,0,0,154,154,0,1,0,1,0
1386,3095,0,0,147,147,0,1,0,1,0
1498,1133,0,0,129,129,0,1,0,1,0
1731,3095,0,0,146,146,0,1,0,1,0
148,1947,0,0,148,148,0,1,0,1,0
2158,183,8709,121,293,223,70,4,0,3,1
2647,1509,0,0,90,90,0,1,0,1,0
8267,1324,0,0,153,153,0,1,0,1,0
12239,1013,0,0,95,95,0,1,0,1,0
2638,364,0,0,88,88,0,1,0,1,0
2737,1452,0,0,62,62,0,1,0,1,0
1764,1176,0,0,141,141,0,1,0,1,0
4072,183,14397,121,293,223,70,4,1,3,1
17360,2330,0,0,145,145,0,1,0,1,0
4993,183,16465,121,293,223,70,4,0,3,1
1574,585,0,0,148,148,0,1,0,1,0
1842,183,7032,121,293,223,70,4,0,3,1
5180,300,0,0,146,146,0,1,0,1,0
2697,183,10569,121,293,223,70,4,0,3,1
1381,183,4732,121,293,223,70,4,1,3,1
7822,2781,0,0,63,63,0,1,0,1,0
1646,183,6350,121,293,223,70,4,0,3,1
4957,183,16491,121,293,223,70,4,1,3,1
1819,3095,0,0,148,148,0,1,0,1,0
1946,3095,0,0,153,153,0,1,0,1,0
4727,183,16205,121,293,223,70,4,1,3,1
3981,575,0,0,134,134,0,1,0,1,0
9120,1543,0,0,119,119,0,1,0,1,0
1681,183,6202,121,293,223,70,4,0,3,1
2020,1007,0,0,62,62,0,1,0,1,0
9475,1543,0,0,104,104,0,1,0,1,0
2193,922,0,0,83,83,0,1,0,1,0
19251,1114,0,0,89,89,0,1,0,1,0
708,2655,0,0,142,142,0,1,0,1,0
1457,183,5109,121,293,223,70,4,1,3,1
11277,1638,0,0,62,62,0,1,0,1,0
2394,1694,0,0,62,62,0,1,0,1,0
2545,1046,0,0,114,114,0,1,0,1,0
573,2591,0,0,144,144,0,1,0,1,0
1341,183,4532,121,293,223,70,4,1,3,1
2500,1694,0,0,62,62,0,1,0,1,0
8236,1187,0,0,156,156,0,1,0,1,0
10624,1576,0,0,69,69,0,1,0,1,0
759,1447,0,0,154,154,0,1,0,1,0
2638,1176,0,0,146,146,0,1,0,1,0
2021,1308,0,0,122,122,0,1,0,1,0
2242,550,0,0,99,99,0,1,0,1,0
1992,183,7757,121,293,223,70,4,0,3,1
2109,1244,0,0,62,62,0,1,0,1,0
467,1176,0,0,146,146,0,1,0,1,0
586,1134,0,0,157,157,0,1,0,1,0
1889,1176,0,0,142,142,0,1,0,1,0
1627,183,5955,121,293,223,70,4,0,3,1
2094,1203,0,0,62,62,0,1,0,1,0
295,1140,0,0,145,145,0,1,0,1,0
8260,1252,0,0,154,154,0,1,0,1,0
2037,183,8129,121,293,223,70,4,0,3,1
1358,183,4841,121,293,223,70,4,1,3,1
2041,957,0,0,127,127,0,1,0,1,0
11385,1661,0,0,62,62,0,1,0,1,0
1239,831,0,0,152,152,0,1,0,1,0
10201,1543,0,0,77,77,0,1,0,1,0
1540,3095,0,0,141,141,0,1,0,1,0
1592,2717,0,0,121,121,0,1,0,1,0
6025,183,12308,121,293,223,70,4,0,3,1
1314,1176,0,0,139,139,0,1,0,1,0
8289,1462,0,0,150,150,0,1,0,1,0
6263,1258,0,0,115,115,0,1,0,1,0
1509,183,5352,121,293,223,70,4,0,3,1
1462,1083,0,0,140,140,0,1,0,1,0
914,1176,0,0,153,153,0,1,0,1,0
11199,1694,0,0,71,71,0,1,0,1,0
1418,3095,0,0,139,139,0,1,0,1,0
6488,639,0,0,146,146,0,1,0,1,0
1542,183,5547,121,293,223,70,4,0,3,1
1707,585,0,0,132,132,0,1,0,1,0
1075,183,4070,121,293,223,70,4,1,3,1
8277,1325,0,0,152,152,0,1,0,1,0
8266,1320,0,0,153,153,0,1,0,1,0
1779,183,6674,121,293,223,70,4,0,3,1
1836,716,0,0,96,96,0,1,0,1,0
1349,183,4574,121,293,223,70,4,1,3,1
1952,908,0,0,78,78,0,1,0,1,0
8599,1237,0,0,142,142,0,1,0,1,0
265,2389,0,0,144,144,0,1,0,1,0
2169,3095,0,0,157,157,0,1,0,1,0
8302,1435,0,0,149,149,0,1,0,1,0
2065,183,8274,121,293,223,70,4,0,3,1
14136,337,0,0,139,139,0,1,0,1,0
5382,279,0,0,146,146,0,1,0,1,0
8595,1543,0,0,136,136,0,1,0,1,0
8327,1654,0,0,146,146,0,1,0,1,0
607,721,1637,55,211,179,32,2,0,1,0
4395,378,0,0,146,146,0,1,0,1,0
1978,1244,0,0,132,132,0,1,0,1,0
11265,1374,0,0,72,72,0,1,0,1,0
18196,2900,0,0,145,145,0,1,0,1,0
2912,1283,0,0,130,130,0,1,0,1,0
598,2934,0,0,140,140,0,1,0,1,0
1989,322,0,0,114,114,0,1,0,1,0
1344,215,3971,109,279,215,63,3,0,2,0
1673,1324,0,0,116,116,0,1,0,1,0
2412,153,0,0,62,62,0,1,0,1,0
1694,572,0,0,136,136,0,1,0,1,0
20949,1543,0,0,62,62,0,1,0,1,0
8612,2396,0,0,66,66,0,1,0,1,0
1555,183,6013,121,293,223,70,4,0,3,1
20667,1543,0,0,62,62,0,1,0,1,0
709,3019,0,0,139,139,0,1,0,1,0
1853,2327,0,0,98,98,0,1,0,1,0
2054,1358,0,0,114,114,0,1,0,1,0
7379,2913,0,0,70,70,0,1,0,1,0
2201,1578,0,0,80,80,0,1,0,1,0
2097,183,8433,121,293,223,70,4,0,3,1
1376,3095,0,0,139,139,0,1,0,1,0
1581,735,0,0,145,145,0,1,0,1,0
1584,460,865,23,176,162,13,1,0,1,0
1282,3095,0,0,142,142,0,1,0,1,0
2157,1513,0,0,90,90,0,1,0,1,0
2189,183,8872,121,293,223,70,4,0,3,1
1415,183,4902,121,293,223,70,4,1,3,1
11290,1641,0,0,62,62,0,1,0,1,0
11137,1694,0,0,72,72,0,1,0,1,0
966,3095,0,0,140,140,0,1,0,1,0
437,1099,0,0,157,157,0,1,0,1,0
7811,2357,0,0,104,104,0,1,0,1,0
9194,1312,0,0,121,121,0,1,0,1,0
6871,894,0,0,146,146,0,1,0,1,0
12918,975,0,0,103,103,0,1,0,1,0
3092,1065,0,0,147,147,0,1,0,1,0
3954,355,0,0,136,136,0,1,0,1,0
1062,960,0,0,154,154,0,1,0,1,0
9916,1543,0,0,92,92,0,1,0,1,0
1538,183,5513,121,293,223,70,4,0,3,1
1162,183,4309,121,293,223,70,4,1,3,1
1622,183,5963,121,293,223,70,4,0,3,1
8053,2045,0,0,124,124,0,1,0,1,0
17981,2753,0,0,145,145,0,1,0,1,0
297,2410,0,0,144,144,0,1,0,1,0
1390,183,4777,121,293,223,70,4,1,3,1
8327,1544,0,0,146,146,0,1,0,1,0
1937,1115,0,0,128,128,0,1,0,1,0
1791,1396,0,0,106,106,0,1,0,1,0
1538,860,0,0,143,143,0,1,0,1,0
1178,3095,0,0,139,139,0,1,0,1,0
2663,1480,0,0,62,62,0,1,0,1,0
2106,183,8392,121,293,223,70,4,0,3,1
884,914,0,0,145,145,0,1,0,1,0
1862,1014,0,0,144,144,0,1,0,1,0
260,1941,0,0,144,144,0,1,0,1,0
2322,1171,0,0,62,62,0,1,0,1,0
1778,954,0,0,88,88,0,1,0,1,0
977,183,3805,121,293,223,70,4,1,3,1
8281,1342,0,0,151,151,0,1,0,1,0
9236,1318,0,0,120,120,0,1,0,1,0
785,1162,0,0,156,156,0,1,0,1,0
1432,183,4976,121,293,223,70,4,0,3,1
1213,1176,0,0,144,144,0,1,0,1,0
338,1372,0,0,143,143,0,1,0,1,0
1382,3095,0,0,141,141,0,1,0,1,0
9541,1620,0,0,104,104,0,1,0,1,0
13446,699,0,0,119,119,0,1,0,1,0
9327,1633,0,0,112,112,0,1,0,1,0
1496,370,2006,55,214,182,32,2,0,1,0
21510,1634,0,0,66,66,0,1,0,1,0
10353,1541,0,0,72,72,0,1,0,1,0
2067,1378,0,0,111,111,0,1,0,1,0
2969,1694,0,0,62,62,0,1,0,1,0
400,1176,0,0,144,144,0,1,0,1,0
737,2146,0,0,147,147,0,1,0,1,0
9258,1694,0,0,121,121,0,1,0,1,0
2170,3095,0,0,157,157,0,1,0,1,0
289,1730,0,0,143,143,0,1,0,1,0
572,1130,0,0,157,157,0,1,0,1,0
1375,183,4701,121,293,223,70,4,1,3,1
1321,183,4434,121,293,223,70,4,0,3,1
1748,3095,0,0,150,150,0,1,0,1,0
8317,1633,0,0,147,147,0,1,0,1,0
1562,438,1151,31,186,167,18,1,0,1,0
2823,1520,0,0,62,62,0,1,0,1,0
2023,2114,0,0,85,85,0,1,0,1,0
21336,1718,0,0,71,71,0,1,0,1,0
737,3095,0,0,139,139,0,1,0,1,0
2427,131,0,0,62,62,0,1,0,1,0
1422,3095,0,0,139,139,0,1,0,1,0
3030,1694,0,0,62,62,0,1,0,1,0
11567,1682,0,0,62,62,0,1,0,1,0
17920,2712,0,0,145,145,0,1,0,1,0
2289,244,0,0,77,77,0,1,0,1,0
1787,1176,0,0,141,141,0,1,0,1,0
8334,1543,0,0,145,145,0,1,0,1,0
21564,1088,9501,40,139,115,23,2,0,1,0
1818,183,7002,121,293,223,70,4,0,3,1
2396,2769,0,0,136,136,0,1,0,1,0
2396,1694,0,0,62,62,0,1,0,1,0
1337,183,4514,121,293,223,70,4,1,3,1
1989,792,0,0,62,62,0,1,0,1,0
837,3095,0,0,139,139,0,1,0,1,0
2461,1694,0,0,62,62,0,1,0,1,0
4108,183,14522,121,293,223,70,4,1,3,1
526,2560,0,0,144,144,0,1,0,1,0
2196,1475,0,0,62,62,0,1,0,1,0
1060,1176,0,0,153,153,0,1,0,1,0
1361,183,4645,121,293,223,70,4,0,3,1
19180,2758,0,0,126,126,0,1,0,1,0
396,1090,0,0,157,157,0,1,0,1,0
21637,1333,4390,18,97,86,10,1,0,1,0
7671,2481,0,0,93,93,0,1,0,1,0
10530,1543,0,0,68,68,0,1,0,1,0
8326,1540,0,0,146,146,0,1,0,1,0
2140,183,8607,121,293,223,70,4,0,3,1
262,1059,0,0,157,157,0,1,0,1,0
275,1131,0,0,146,146,0,1,0,1,0
1139,1176,0,0,146,146,0,1,0,1,0
8248,1199,0,0,156,156,0,1,0,1,0
3013,1114,0,0,147,147,0,1,0,1,0
1846,725,0,0,109,109,0,1,0,1,0
1459,183,5123,121,293,223,70,4,0,3,1
990,183,3765,121,293,223,70,4,1,3,1
8315,1492,0,0,147,147,0,1,0,1,0
2959,183,11117,121,293,223,70,4,0,3,1
7286,3032,0,0,62,62,0,1,0,1,0
740,1176,0,0,141,141,0,1,0,1,0
31,1102,0,0,156,156,0,1,0,1,0
1452,325,2578,71,233,192,41,2,0,2,0
3900,183,13997,121,293,223,70,4,0,3,1
15578,1543,0,0,67,67,0,1,0,1,0
1873,183,7135,121,293,223,70,4,0,3,1
4624,183,15419,121,293,223,70,4,0,3,1
1521,1176,0,0,139,139,0,1,0,1,0
216,1101,0,0,149,149,0,1,0,1,0
8014,2687,0,0,64,64,0,1,0,1,0
885,256,3316,112,282,218,64,3,0,2,0
20495,1543,0,0,62,62,0,1,0,1,0
2433,1176,0,0,145,145,0,1,0,1,0
9182,1357,0,0,145,145,0,1,0,1,0
1169,183,4650,121,293,223,70,4,0,3,1
12289,910,0,0,107,107,0,1,0,1,0
2391,2782,0,0,137,137,0,1,0,1,0
767,1197,0,0,156,156,0,1,0,1,0
1631,589,0,0,147,147,0,1,0,1,0
4273,390,0,0,146,146,0,1,0,1,0
182,2194,0,0,146,146,0,1,0,1,0
8977,1303,0,0,127,127,0,1,0,1,0
3251,183,11301,121,293,223,70,4,0,3,1
17397,2875,0,0,132,132,0,1,0,1,0
9273,1636,0,0,113,113,0,1,0,1,0
1803,877,0,0,145,145,0,1,0,1,0
1394,1176,0,0,139,139,0,1,0,1,0
2006,183,7852,121,293,223,70,4,0,3,1
16592,1807,0,0,145,145,0,1,0,1,0
1686,183,6226,121,293,223,70,4,0,3,1
1326,197,4200,115,286,219,67,3,0,2,0
1566,779,0,0,144,144,0,1,0,1,0
11096,1601,0,0,62,62,0,1,0,1,0
2096,3095,0,0,155,155,0,1,0,1,0
1799,3095,0,0,151,151,0,1,0,1,0
912,183,3614,121,293,223,70,4,1,3,1
1017,1176,0,0,150,150,0,1,0,1,0
18640,3018,0,0,140,140,0,1,0,1,0
10993,1623,0,0,66,66,0,1,0,1,0
8667,1236,0,0,141,141,0,1,0,1,0
8278,1332,0,0,152,152,0,1,0,1,0
290,1138,0,0,146,146,0,1,0,1,0
17443,2387,0,0,145,145,0,1,0,1,0
6980,955,0,0,146,146,0,1,0,1,0
2646,2233,0,0,99,99,0,1,0,1,0
2339,1694,0,0,62,62,0,1,0,1,0
18310,183,25455,121,293,223,70,4,0,3,1
787,2703,0,0,142,142,0,1,0,1,0
10581,1543,0,0,67,67,0,1,0,1,0
11751,1586,0,0,68,68,0,1,0,1,0
1796,183,6804,121,293,223,70,4,0,3,1
1996,942,0,0,62,62,0,1,0,1,0
2666,1518,0,0,89,89,0,1,0,1,0
668,2654,0,0,144,144,0,1,0,1,0
1390,183,4774,121,293,223,70,4,1,3,1
13477,428,0,0,145,145,0,1,0,1,0
1724,3095,0,0,149,149,0,1,0,1,0
2172,1176,0,0,144,144,0,1,0,1,0
2899,1692,0,0,62,62,0,1,0,1,0
982,1176,0,0,151,151,0,1,0,1,0
2461,1694,0,0,62,62,0,1,0,1,0
4195,748,0,0,147,147,0,1,0,1,0
1646,183,6025,121,293,223,70,4,0,3,1
6699,183,17567,121,293,223,70,4,0,3,1
1754,2561,0,0,109,109,0,1,0,1,0
7669,2483,0,0,93,93,0,1,0,1,0
1336,183,4783,121,293,223,70,4,1,3,1
4217,741,0,0,147,147,0,1,0,1,0
9651,1420,0,0,100,100,0,1,0,1,0
8010,1625,0,0,134,134,0,1,0,1,0
1434,1176,0,0,139,139,0,1,0,1,0
269,1875,0,0,144,144,0,1,0,1,0
1475,183,5197,121,293,223,70,4,0,3,1
10653,1552,0,0,67,67,0,1,0,1,0
2060,1235,0,0,133,133,0,1,0,1,0
3403,1172,0,0,95,95,0,1,0,1,0
2424,183,8212,121,293,223,70,4,1,3,1
1959,183,7579,121,293,223,70,4,0,3,1
3019,1694,0,0,62,62,0,1,0,1,0
1497,3095,0,0,149,149,0,1,0,1,0
9988,1478,0,0,86,86,0,1,0,1,0
13588,1543,0,0,69,69,0,1,0,1,0
1266,3095,0,0,139,139,0,1,0,1,0
1576,750,0,0,144,144,0,1,0,1,0
1339,3095,0,0,142,142,0,1,0,1,0
2353,183,9550,121,293,223,70,4,0,3,1
455,2722,0,0,141,141,0,1,0,1,0
1488,183,5250,121,293,223,70,4,0,3,1
1458,183,5105,121,293,223,70,4,0,3,1
1058,183,3897,121,293,223,70,4,1,3,1
466,1106,0,0,157,157,0,1,0,1,0
6683,2002,0,0,93,93,0,1,0,1,0
1972,818,0,0,62,62,0,1,0,1,0
770,1095,0,0,147,147,0,1,0,1,0
2718,599,0,0,105,105,0,1,0,1,0
8754,1662,0,0,130,130,0,1,0,1,0
4528,183,10724,121,293,223,70,4,0,3,1
1598,475,684,18,170,159,10,1,0,1,0
9522,1694,0,0,114,114,0,1,0,1,0
1116,2948,0,0,143,143,0,1,0,1,0
1974,183,7673,121,293,223,70,4,0,3,1
11060,1543,0,0,71,71,0,1,0,1,0
2823,183,10757,121,293,223,70,4,0,3,1
1888,2339,0,0,97,97,0,1,0,1,0
4095,782,0,0,147,147,0,1,0,1,0
2951,1694,0,0,62,62,0,1,0,1,0
2578,1450,0,0,102,102,0,1,0,1,0
5435,274,0,0,146,146,0,1,0,1,0
18230,1594,0,0,62,62,0,1,0,1,0
1299,368,1664,56,215,182,32,2,0,1,0
11465,183,21284,121,293,223,70,4,0,3,1
275,2392,0,0,144,144,0,1,0,1,0
1542,2790,0,0,125,125,0,1,0,1,0
2203,183,8951,121,293,223,70,4,0,3,1
7036,985,0,0,146,146,0,1,0,1,0
10677,1543,0,0,64,64,0,1,0,1,0
6014,365,0,0,147,147,0,1,0,1,0
10757,1618,0,0,75,75,0,1,0,1,0
1376,1169,0,0,139,139,0,1,0,1,0
1654,534,0,0,147,147,0,1,0,1,0
397,1159,0,0,143,143,0,1,0,1,0
1324,183,4447,121,293,223,70,4,0,3,1
2590,225,0,0,78,78,0,1,0,1,0
8276,1322,0,0,152,152,0,1,0,1,0
1501,183,5314,121,293,223,70,4,0,3,1
8285,1183,0,0,155,155,0,1,0,1,0
7858,183,14915,121,293,223,70,4,0,3,1
269,1877,0,0,144,144,0,1,0,1,0
7560,2679,0,0,84,84,0,1,0,1,0
8761,1250,0,0,137,137,0,1,0,1,0
3274,183,11574,121,293,223,70,4,0,3,1
11807,1173,0,0,85,85,0,1,0,1,0
949,3095,0,0,140,140,0,1,0,1,0
2608,1694,0,0,62,62,0,1,0,1,0
1706,183,5910,121,293,223,70,4,1,3,1
8327,1593,0,0,146,146,0,1,0,1,0
9135,1303,0,0,123,123,0,1,0,1,0
824,1176,0,0,156,156,0,1,0,1,0
10734,1543,0,0,63,63,0,1,0,1,0
10456,1555,0,0,71,71,0,1,0,1,0
1133,183,4229,121,293,223,70,4,1,3,1
229,2165,0,0,144,144,0,1,0,1,0
1953,898,0,0,76,76,0,1,0,1,0
3551,256,0,0,115,115,0,1,0,1,0
18481,3094,0,0,144,144,0,1,0,1,0
11031,1628,0,0,66,66,0,1,0,1,0
1460,1089,0,0,140,140,0,1,0,1,0
1494,989,0,0,141,141,0,1,0,1,0
4046,183,13980,121,293,223,70,4,0,3,1
1456,1100,0,0,140,140,0,1,0,1,0
5631,255,0,0,146,146,0,1,0,1,0
8421,1206,0,0,149,149,0,1,0,1,0
1573,758,0,0,144,144,0,1,0,1,0
8327,1555,0,0,146,146,0,1,0,1,0
589,1073,0,0,149,149,0,1,0,1,0
4087,440,0,0,146,146,0,1,0,1,0
8289,1380,0,0,150,150,0,1,0,1,0
632,1458,0,0,154,154,0,1,0,1,0
1260,3095,0,0,139,139,0,1,0,1,0
1528,183,5452,121,293,223,70,4,0,3,1
212,2286,0,0,144,144,0,1,0,1,0
8327,1647,0,0,146,146,0,1,0,1,0
2025,183,8070,121,293,223,70,4,0,3,1
3464,1202,0,0,93,93,0,1,0,1,0
7326,2973,0,0,66,66,0,1,0,1,0
5017,183,16540,121,293,223,70,4,0,3,1
1370,3095,0,0,141,141,0,1,0,1,0
1505,379,1893,52,210,180,30,2,0,1,0
10694,1543,0,0,65,65,0,1,0,1,0
1572,1176,0,0,147,147,0,1,0,1,0
2228,1768,0,0,66,66,0,1,0,1,0
1078,3095,0,0,141,141,0,1,0,1,0
1803,183,6793,121,293,223,70,4,0,3,1
887,241,3368,113,284,219,65,3,0,2,0
803,3095,0,0,139,139,0,1,0,1,0
1814,183,7417,121,293,223,70,4,0,3,1
453,1011,593,20,167,156,11,1,0,1,0
888,1176,0,0,141,141,0,1,0,1,0
1455,1104,0,0,139,139,0,1,0,1,0
10481,1558,0,0,70,70,0,1,0,1,0
10820,1003,0,0,145,145,0,1,0,1,0
4248,731,0,0,147,147,0,1,0,1,0
1134,3095,0,0,139,139,0,1,0,1,0
1339,183,4532,121,293,223,70,4,0,3,1
10499,1543,0,0,68,68,0,1,0,1,0
1953,183,7587,121,293,223,70,4,0,3,1
21617,1583,0,0,64,64,0,1,0,1,0
1200,183,4171,121,293,223,70,4,1,3,1
2178,183,8819,121,293,223,70,4,0,3,1
792,2735,0,0,143,143,0,1,0,1,0
10997,1624,0,0,66,66,0,1,0,1,0
4587,183,16031,121,293,223,70,4,1,3,1
841,603,2063,69,235,195,40,2,0,2,0
168,1077,0,0,150,150,0,1,0,1,0
1612,183,5911,121,293,223,70,4,0,3,1
1315,183,4405,121,293,223,70,4,0,3,1
4881,329,0,0,146,146,0,1,0,1,0
585,2915,0,0,140,140,0,1,0,1,0
8313,1610,0,0,147,147,0,1,0,1,0
1822,926,0,0,81,81,0,1,0,1,0
17560,2467,0,0,145,145,0,1,0,1,0
6043,376,0,0,147,147,0,1,0,1,0
1761,3095,0,0,150,150,0,1,0,1,0
1620,496,409,11,161,154,6,1,0,1,0
1857,1002,0,0,144,144,0,1,0,1,0
786,964,0,0,144,144,0,1,0,1,0
1537,1240,0,0,129,129,0,1,0,1,0
7749,2368,0,0,99,99,0,1,0,1,0
2053,183,8088,121,293,223,70,4,0,3,1
982,183,3919,121,293,223,70,4,0,3,1
747,1815,0,0,150,150,0,1,0,1,0
3947,636,0,0,130,130,0,1,0,1,0
2934,1250,0,0,135,135,0,1,0,1,0
2186,183,8522,121,293,223,70,4,0,3,1
729,1167,0,0,157,157,0,1,0,1,0
1824,183,6945,121,293,223,70,4,0,3,1
1994,1520,0,0,87,87,0,1,0,1,0
1686,1332,0,0,115,115,0,1,0,1,0
1857,1176,0,0,142,142,0,1,0,1,0
7953,1736,0,0,128,128,0,1,0,1,0
453,1103,0,0,157,157,0,1,0,1,0
2976,1694,0,0,62,62,0,1,0,1,0
2298,2981,0,0,151,151,0,1,0,1,0
2070,183,8183,121,293,223,70,4,0,3,1
939,3095,0,0,139,139,0,1,0,1,0
2059,920,0,0,125,125,0,1,0,1,0
1517,921,0,0,142,142,0,1,0,1,0
1666,183,6156,121,293,223,70,4,0,3,1
1439,1151,0,0,139,139,0,1,0,1,0
448,2509,0,0,144,144,0,1,0,1,0
11142,1642,0,0,65,65,0,1,0,1,0
1956,183,7564,121,293,223,70,4,0,3,1
19660,2526,0,0,114,114,0,1,0,1,0
1443,183,5046,121,293,223,70,4,0,3,1
1945,183,7501,121,293,223,70,4,0,3,1
2890,1689,0,0,62,62,0,1,0,1,0
8285,1438,0,0,151,151,0,1,0,1,0
2791,1276,0,0,131,131,0,1,0,1,0
2908,1413,0,0,108,108,0,1,0,1,0
1621,2780,0,0,121,121,0,1,0,1,0
11313,1683,0,0,68,68,0,1,0,1,0
1201,183,4174,121,293,223,70,4,1,3,1
1946,1001,0,0,100,100,0,1,0,1,0
574,2898,0,0,140,140,0,1,0,1,0
1253,2986,0,0,139,139,0,1,0,1,0
3893,665,0,0,128,128,0,1,0,1,0
633,2986,0,0,139,139,0,1,0,1,0
1573,183,5708,121,293,223,70,4,0,3,1
1355,183,4602,121,293,223,70,4,1,3,1
1356,3095,0,0,147,147,0,1,0,1,0
4368,183,15494,121,293,223,70,4,0,3,1
2208,183,9059,121,293,223,70,4,0,3,1
2108,183,8488,121,293,223,70,4,0,3,1
848,549,2258,76,242,198,44,2,0,2,0
10649,1543,0,0,65,65,0,1,0,1,0
1999,3095,0,0,152,152,0,1,0,1,0
889,2799,0,0,143,143,0,1,0,1,0
21579,1137,8487,36,130,110,20,1,0,1,0
1600,477,658,18,169,159,10,1,0,1,0
20635,2056,0,0,89,89,0,1,0,1,0
2012,308,0,0,112,112,0,1,0,1,0
2023,183,7937,121,293,223,70,4,0,3,1
8277,1325,0,0,152,152,0,1,0,1,0
2755,1694,0,0,62,62,0,1,0,1,0
11743,1197,0,0,84,84,0,1,0,1,0
786,1030,522,17,176,166,10,1,0,1,0
938,1051,0,0,155,155,0,1,0,1,0
9677,1593,0,0,96,96,0,1,0,1,0
2091,1195,0,0,62,62,0,1,0,1,0
10156,1694,0,0,98,98,0,1,0,1,0
9681,1611,0,0,100,100,0,1,0,1,0
2261,1650,0,0,62,62,0,1,0,1,0
3000,1516,0,0,91,91,0,1,0,1,0
4434,183,14806,121,293,223,70,4,0,3,1
2802,183,10702,121,293,223,70,4,0,3,1
418,2666,0,0,142,142,0,1,0,1,0
1303,3095,0,0,139,139,0,1,0,1,0
9286,1543,0,0,111,111,0,1,0,1,0
2899,1685,0,0,63,63,0,1,0,1,0
2096,1263,0,0,129,129,0,1,0,1,0
10644,1543,0,0,65,65,0,1,0,1,0
1915,183,7341,121,293,223,70,4,0,3,1
1455,1149,0,0,137,137,0,1,0,1,0
9008,1543,0,0,121,121,0,1,0,1,0
1492,183,5273,121,293,223,70,4,0,3,1
2084,1178,0,0,62,62,0,1,0,1,0
2839,1237,0,0,137,137,0,1,0,1,0
12302,990,0,0,97,97,0,1,0,1,0
1234,183,4832,121,293,223,70,4,0,3,1
15967,1381,0,0,145,145,0,1,0,1,0
452,1103,0,0,157,157,0,1,0,1,0
1217,1176,0,0,144,144,0,1,0,1,0
2221,180,0,0,91,91,0,1,0,1,0
1434,688,0,0,150,150,0,1,0,1,0
10775,1543,0,0,62,62,0,1,0,1,0
6187,491,0,0,146,146,0,1,0,1,0
894,1083,0,0,155,155,0,1,0,1,0
10107,1442,0,0,87,87,0,1,0,1,0
1942,1050,0,0,112,112,0,1,0,1,0
8280,1520,0,0,146,146,0,1,0,1,0
10824,1602,0,0,68,68,0,1,0,1,0
9649,1595,0,0,97,97,0,1,0,1,0
128,1016,0,0,155,155,0,1,0,1,0
2584,1694,0,0,62,62,0,1,0,1,0
665,3033,0,0,139,139,0,1,0,1,0
2090,183,8296,121,293,223,70,4,0,3,1
16997,2795,0,0,127,127,0,1,0,1,0
2176,1861,0,0,71,71,0,1,0,1,0
1340,685,0,0,146,146,0,1,0,1,0
7504,1242,0,0,146,146,0,1,0,1,0
2198,1481,0,0,62,62,0,1,0,1,0
2347,1694,0,0,62,62,0,1,0,1,0
1949,949,0,0,88,88,0,1,0,1,0
4386,183,14741,121,293,223,70,4,0,3,1
570,792,1382,46,200,173,27,2,0,1,0
1391,183,4783,121,293,223,70,4,1,3,1
2834,1635,0,0,62,62,0,1,0,1,0
10572,1543,0,0,67,67,0,1,0,1,0
7660,964,0,0,154,154,0,1,0,1,0
11753,1735,0,0,64,64,0,1,0,1,0
815,1141,0,0,156,156,0,1,0,1,0
1363,3095,0,0,141,141,0,1,0,1,0
18215,3041,0,0,142,142,0,1,0,1,0
2653,183,10309,121,293,223,70,4,0,3,1
2056,183,8102,121,293,223,70,4,0,3,1
1754,183,6592,121,293,223,70,4,0,3,1
2576,1057,0,0,117,117,0,1,0,1,0
2401,1242,0,0,62,62,0,1,0,1,0
2955,1694,0,0,62,62,0,1,0,1,0
2813,1176,0,0,147,147,0,1,0,1,0
4620,183,16014,121,293,223,70,4,0,3,1
981,3095,0,0,139,139,0,1,0,1,0
8554,2424,0,0,66,66,0,1,0,1,0
877,323,3074,103,273,213,60,3,0,2,0
1017,1176,0,0,150,150,0,1,0,1,0
9059,1639,0,0,119,119,0,1,0,1,0
2206,183,8969,121,293,223,70,4,0,3,1
1607,1176,0,0,140,140,0,1,0,1,0
1322,3095,0,0,139,139,0,1,0,1,0
3020,1694,0,0,62,62,0,1,0,1,0
10230,1460,0,0,83,83,0,1,0,1,0
9347,1367,0,0,112,112,0,1,0,1,0
20954,1412,0,0,70,70,0,1,0,1,0
20727,1543,0,0,62,62,0,1,0,1,0
4103,183,13934,121,293,223,70,4,0,3,1
2139,1323,0,0,62,62,0,1,0,1,0
2895,1694,0,0,62,62,0,1,0,1,0
13572,632,0,0,122,122,0,1,0,1,0
9609,1543,0,0,99,99,0,1,0,1,0
1255,183,4561,121,293,223,70,4,1,3,1
2646,183,10290,121,293,223,70,4,0,3,1
1409,3095,0,0,139,139,0,1,0,1,0
8981,1573,0,0,128,128,0,1,0,1,0
2907,1446,0,0,103,103,0,1,0,1,0
1532,1176,0,0,139,139,0,1,0,1,0
1565,1090,0,0,119,119,0,1,0,1,0
21302,1548,0,0,62,62,0,1,0,1,0
9278,1324,0,0,118,118,0,1,0,1,0
1877,183,7154,121,293,223,70,4,0,3,1
1442,3095,0,0,139,139,0,1,0,1,0
5639,254,0,0,146,146,0,1,0,1,0
24,1001,0,0,156,156,0,1,0,1,0
1999,183,7815,121,293,223,70,4,0,3,1
10901,1611,0,0,67,67,0,1,0,1,0
1519,183,5408,121,293,223,70,4,0,3,1
1010,1176,0,0,150,150,0,1,0,1,0
1550,824,0,0,143,143,0,1,0,1,0
5258,394,0,0,146,146,0,1,0,1,0
12576,183,22095,121,293,223,70,4,0,3,1
1118,285,2522,85,250,200,49,3,0,2,0
1839,183,7258,121,293,223,70,4,0,3,1
221,1104,0,0,148,148,0,1,0,1,0
1068,2917,0,0,143,143,0,1,0,1,0
1950,935,0,0,84,84,0,1,0,1,0
1727,183,6423,121,293,223,70,4,0,3,1
299,1142,0,0,145,145,0,1,0,1,0
2257,1662,0,0,66,66,0,1,0,1,0
2230,174,0,0,90,90,0,1,0,1,0
20456,2142,0,0,94,94,0,1,0,1,0
8010,183,18545,121,293,223,70,4,0,3,1
219,2234,0,0,144,144,0,1,0,1,0
1449,677,0,0,150,150,0,1,0,1,0
3363,183,11631,121,293,223,70,4,0,3,1
10832,1603,0,0,68,68,0,1,0,1,0
1815,906,0,0,145,145,0,1,0,1,0
1447,1127,0,0,139,139,0,1,0,1,0
2544,1176,0,0,146,146,0,1,0,1,0
1249,3095,0,0,146,146,0,1,0,1,0
8870,1660,0,0,127,127,0,1,0,1,0
1945,183,7504,121,293,223,70,4,0,3,1
11447,1673,0,0,62,62,0,1,0,1,0
664,1176,0,0,153,153,0,1,0,1,0
4418,674,0,0,146,146,0,1,0,1,0
2981,1694,0,0,62,62,0,1,0,1,0
2767,1564,0,0,82,82,0,1,0,1,0
15082,2407,0,0,108,108,0,1,0,1,0
186,2222,0,0,146,146,0,1,0,1,0
2037,183,8001,121,293,223,70,4,0,3,1
713,2886,0,0,140,140,0,1,0,1,0
2000,1038,0,0,133,133,0,1,0,1,0
2221,1543,0,0,62,62,0,1,0,1,0
1761,2464,0,0,106,106,0,1,0,1,0
1036,1176,0,0,149,149,0,1,0,1,0
9721,1387,0,0,102,102,0,1,0,1,0
1180,183,4772,121,293,223,70,4,0,3,1
7993,1658,0,0,132,132,0,1,0,1,0
2366,183,8676,121,293,223,70,4,0,3,1
8327,1584,0,0,146,146,0,1,0,1,0
1292,183,4662,121,293,223,70,4,1,3,1
1646,183,6059,121,293,223,70,4,0,3,1
9377,1338,0,0,115,115,0,1,0,1,0
1492,997,0,0,141,141,0,1,0,1,0
8251,1214,0,0,155,155,0,1,0,1,0
733,1176,0,0,155,155,0,1,0,1,0
687,1176,0,0,154,154,0,1,0,1,0
1722,3095,0,0,152,152,0,1,0,1,0
2209,1807,0,0,68,68,0,1,0,1,0
1829,183,6920,121,293,223,70,4,0,3,1
304,1145,0,0,145,145,0,1,0,1,0
2063,911,0,0,124,124,0,1,0,1,0
8098,1455,0,0,142,142,0,1,0,1,0
1066,2915,0,0,143,143,0,1,0,1,0
792,3095,0,0,139,139,0,1,0,1,0
2259,1328,0,0,119,119,0,1,0,1,0
1223,183,4951,121,293,223,70,4,0,3,1
1638,1043,0,0,108,108,0,1,0,1,0
956,1038,0,0,155,155,0,1,0,1,0
3079,1507,0,0,74,74,0,1,0,1,0
9748,183,19843,121,293,223,70,4,0,3,1
2136,1270,0,0,128,128,0,1,0,1,0
2804,1694,0,0,62,62,0,1,0,1,0
1947,183,7656,121,293,223,70,4,0,3,1
17069,2132,0,0,145,145,0,1,0,1,0
1109,1176,0,0,140,140,0,1,0,1,0
2243,166,0,0,88,88,0,1,0,1,0
1935,1136,0,0,133,133,0,1,0,1,0
1335,183,4505,121,293,223,70,4,1,3,1
8466,1512,0,0,145,145,0,1,0,1,0
9723,1387,0,0,102,102,0,1,0,1,0
9904,1576,0,0,88,88,0,1,0,1,0
1980,1247,0,0,131,131,0,1,0,1,0
7556,2685,0,0,84,84,0,1,0,1,0
1011,997,0,0,154,154,0,1,0,1,0
7213,995,0,0,146,146,0,1,0,1,0
1691,183,6324,121,293,223,70,4,0,3,1
1779,3095,0,0,152,152,0,1,0,1,0
4573,183,15371,121,293,223,70,4,0,3,1
8286,1445,0,0,151,151,0,1,0,1,0
3037,1665,0,0,66,66,0,1,0,1,0
8805,1658,0,0,128,128,0,1,0,1,0
5319,286,0,0,146,146,0,1,0,1,0
5923,655,0,0,133,133,0,1,0,1,0
2781,1487,0,0,62,62,0,1,0,1,0
1177,1176,0,0,152,152,0,1,0,1,0
4839,183,16344,121,293,223,70,4,1,3,1
8145,1364,0,0,147,147,0,1,0,1,0
1665,183,6145,121,293,223,70,4,0,3,1
2086,864,0,0,121,121,0,1,0,1,0
2140,183,8589,121,293,223,70,4,0,3,1
12231,1335,0,0,82,82,0,1,0,1,0
2031,183,7979,121,293,223,70,4,0,3,1
17758,2948,0,0,136,136,0,1,0,1,0
1994,1268,0,0,128,128,0,1,0,1,0
2964,1370,0,0,115,115,0,1,0,1,0
3029,1682,0,0,62,62,0,1,0,1,0
21666,1428,2395,10,81,75,5,1,0,1,0
2928,183,9943,121,293,223,70,4,0,3,1
6357,613,0,0,146,146,0,1,0,1,0
9406,1543,0,0,109,109,0,1,0,1,0
8787,1270,0,0,135,135,0,1,0,1,0
2249,183,9219,121,293,223,70,4,0,3,1
10185,1512,0,0,79,79,0,1,0,1,0
1656,539,0,0,147,147,0,1,0,1,0
10628,1517,0,0,68,68,0,1,0,1,0
2261,2396,0,0,110,110,0,1,0,1,0
2222,183,9062,121,293,223,70,4,0,3,1
10478,1543,0,0,69,69,0,1,0,1,0
10665,1543,0,0,65,65,0,1,0,1,0
8447,1205,0,0,149,149,0,1,0,1,0
10364,1543,0,0,71,71,0,1,0,1,0
5301,288,0,0,146,146,0,1,0,1,0
750,453,2604,88,252,201,50,3,0,2,0
8944,1276,0,0,131,131,0,1,0,1,0
17293,2854,0,0,130,130,0,1,0,1,0
1377,183,4727,121,293,223,70,4,0,3,1
356,2575,0,0,143,143,0,1,0,1,0
1096,183,3970,121,293,223,70,4,1,3,1
2217,1603,0,0,76,76,0,1,0,1,0
1461,1156,0,0,134,134,0,1,0,1,0
2921,1199,0,0,144,144,0,1,0,1,0
13355,2057,0,0,89,89,0,1,0,1,0
2302,320,0,0,62,62,0,1,0,1,0
4507,183,15022,121,293,223,70,4,0,3,1
17140,2180,0,0,145,145,0,1,0,1,0
1998,183,7811,121,293,223,70,4,0,3,1
2912,1285,0,0,129,129,0,1,0,1,0
3391,183,12253,121,293,223,70,4,0,3,1
15321,2455,0,0,110,110,0,1,0,1,0
8883,1652,0,0,125,125,0,1,0,1,0
2390,183,9616,121,293,223,70,4,0,3,1
1977,183,7810,121,293,223,70,4,0,3,1
1760,183,6620,121,293,223,70,4,0,3,1
6297,580,0,0,146,146,0,1,0,1,0
8047,2053,0,0,123,123,0,1,0,1,0
8779,1694,0,0,134,134,0,1,0,1,0
3014,1572,0,0,82,82,0,1,0,1,0
19347,183,27041,121,293,223,70,4,0,3,1
650,1176,0,0,152,152,0,1,0,1,0
2715,590,0,0,105,105,0,1,0,1,0
11366,1657,0,0,62,62,0,1,0,1,0
3161,1422,0,0,79,79,0,1,0,1,0
7451,2795,0,0,76,76,0,1,0,1,0
1492,1136,0,0,130,130,0,1,0,1,0
11439,1680,0,0,62,62,0,1,0,1,0
1188,868,0,0,152,152,0,1,0,1,0
20443,2149,0,0,94,94,0,1,0,1,0
8327,1613,0,0,146,146,0,1,0,1,0
1739,183,7104,121,293,223,70,4,0,3,1
148,1947,0,0,148,148,0,1,0,1,0
2269,1672,0,0,62,62,0,1,0,1,0
1474,183,5193,121,293,223,70,4,0,3,1
13297,579,0,0,126,126,0,1,0,1,0
16695,183,23597,121,293,223,70,4,0,3,1
1383,3095,0,0,141,141,0,1,0,1,0
2900,1656,0,0,68,68,0,1,0,1,0
457,1176,0,0,146,146,0,1,0,1,0
2027,3095,0,0,153,153,0,1,0,1,0
21459,740,16791,71,198,156,41,2,0,2,0
8232,1642,0,0,146,146,0,1,0,1,0
2531,1176,0,0,146,146,0,1,0,1,0
1679,183,6191,121,293,223,70,4,0,3,1
1082,1133,0,0,143,143,0,1,0,1,0
3097,183,10372,121,293,223,70,4,1,3,1
8406,1694,0,0,143,143,0,1,0,1,0
2841,1694,0,0,62,62,0,1,0,1,0
248,2415,0,0,144,144,0,1,0,1,0
3085,183,10807,121,293,223,70,4,0,3,1
5994,358,0,0,147,147,0,1,0,1,0
9435,1346,0,0,112,112,0,1,0,1,0
2005,856,0,0,66,66,0,1,0,1,0
2194,183,8938,121,293,223,70,4,0,3,1
3115,1050,0,0,147,147,0,1,0,1,0
3584,264,0,0,117,117,0,1,0,1,0
2905,1480,0,0,97,97,0,1,0,1,0
2054,183,8093,121,293,223,70,4,0,3,1
1281,183,4633,121,293,223,70,4,1,3,1
7720,2409,0,0,97,97,0,1,0,1,0
1651,183,6049,121,293,223,70,4,0,3,1
1427,1176,0,0,139,139,0,1,0,1,0
471,978,712,24,172,158,13,1,0,1,0
21161,1803,0,0,75,75,0,1,0,1,0
1933,183,7436,121,293,223,70,4,0,3,1
1642,524,44,1,149,148,0,1,0,1,0
4914,326,0,0,146,146,0,1,0,1,0
9041,1543,0,0,120,120,0,1,0,1,0
2911,1314,0,0,125,125,0,1,0,1,0
9850,1405,0,0,97,97,0,1,0,1,0
4692,183,16161,121,293,223,70,4,1,3,1
1370,3095,0,0,141,141,0,1,0,1,0
11532,1691,0,0,62,62,0,1,0,1,0
8327,1613,0,0,146,146,0,1,0,1,0
2971,1619,0,0,66,66,0,1,0,1,0
5199,413,0,0,146,146,0,1,0,1,0
1946,997,0,0,99,99,0,1,0,1,0
1970,3095,0,0,152,152,0,1,0,1,0
744,2704,0,0,144,144,0,1,0,1,0
926,3095,0,0,140,140,0,1,0,1,0
1945,183,7653,121,293,223,70,4,0,3,1
1756,1176,0,0,141,141,0,1,0,1,0
3644,718,0,0,146,146,0,1,0,1,0
2210,615,0,0,104,104,0,1,0,1,0
496,1113,0,0,157,157,0,1,0,1,0
7940,2191,0,0,115,115,0,1,0,1,0
1161,183,4095,121,293,223,70,4,1,3,1
4679,350,0,0,146,146,0,1,0,1,0
4919,183,16257,121,293,223,70,4,0,3,1
10615,1543,0,0,68,68,0,1,0,1,0
3374,183,11917,121,293,223,70,4,1,3,1
9628,1597,0,0,98,98,0,1,0,1,0
16431,620,0,0,121,121,0,1,0,1,0
3021,1694,0,0,62,62,0,1,0,1,0
15752,2542,0,0,115,115,0,1,0,1,0
2677,1523,0,0,88,88,0,1,0,1,0
1669,1176,0,0,146,146,0,1,0,1,0
2767,1694,0,0,62,62,0,1,0,1,0
1630,183,5950,121,293,223,70,4,0,3,1
10863,1607,0,0,67,67,0,1,0,1,0
277,1814,0,0,144,144,0,1,0,1,0
2823,183,10288,121,293,223,70,4,0,3,1
10658,1543,0,0,65,65,0,1,0,1,0
10521,1543,0,0,71,71,0,1,0,1,0
1826,183,6954,121,293,223,70,4,0,3,1
1586,183,5776,121,293,223,70,4,0,3,1
2342,183,8253,121,293,223,70,4,1,3,1
725,3095,0,0,139,139,0,1,0,1,0
11151,1613,0,0,62,62,0,1,0,1,0
4533,183,11562,121,293,223,70,4,0,3,1
395,1089,0,0,157,157,0,1,0,1,0
2248,2949,0,0,148,148,0,1,0,1,0
1290,3095,0,0,139,139,0,1,0,1,0
1675,1020,0,0,103,103,0,1,0,1,0
1885,386,0,0,124,124,0,1,0,1,0
1080,947,0,0,153,153,0,1,0,1,0
2099,838,0,0,119,119,0,1,0,1,0
2102,970,0,0,62,62,0,1,0,1,0
21373,1700,0,0,70,70,0,1,0,1,0
355,1255,0,0,143,143,0,1,0,1,0
258,1954,0,0,144,144,0,1,0,1,0
1212,183,4195,121,293,223,70,4,1,3,1
461,2730,0,0,141,141,0,1,0,1,0
2506,1508,0,0,92,92,0,1,0,1,0
2203,183,8949,121,293,223,70,4,0,3,1
4497,183,15907,121,293,223,70,4,0,3,1
1887,3095,0,0,150,150,0,1,0,1,0
2424,55,0,0,70,70,0,1,0,1,0
1726,183,6451,121,293,223,70,4,0,3,1
720,2683,0,0,142,142,0,1,0,1,0
1363,183,4637,121,293,223,70,4,0,3,1
1717,595,0,0,129,129,0,1,0,1,0
1944,3095,0,0,151,151,0,1,0,1,0
1484,651,0,0,149,149,0,1,0,1,0
1465,183,5146,121,293,223,70,4,0,3,1
705,3092,0,0,139,139,0,1,0,1,0
1718,183,6382,121,293,223,70,4,0,3,1
1291,3009,0,0,139,139,0,1,0,1,0
12152,1376,0,0,80,80,0,1,0,1,0
2602,258,0,0,80,80,0,1,0,1,0
11142,1642,0,0,65,65,0,1,0,1,0
14227,274,0,0,143,143,0,1,0,1,0
1645,183,6027,121,293,223,70,4,0,3,1
1790,183,7068,121,293,223,70,4,0,3,1
7666,2488,0,0,93,93,0,1,0,1,0
4820,336,0,0,146,146,0,1,0,1,0
977,183,3740,121,293,223,70,4,1,3,1
2660,430,0,0,93,93,0,1,0,1,0
17606,1543,0,0,65,65,0,1,0,1,0
1833,183,7078,121,293,223,70,4,0,3,1
8290,1469,0,0,150,150,0,1,0,1,0
2015,183,7902,121,293,223,70,4,0,3,1
18802,2940,0,0,136,136,0,1,0,1,0
237,1111,0,0,148,148,0,1,0,1,0
2902,1583,0,0,80,80,0,1,0,1,0
2157,183,8687,121,293,223,70,4,0,3,1
10745,1543,0,0,64,64,0,1,0,1,0
1816,696,0,0,101,101,0,1,0,1,0
1992,788,0,0,62,62,0,1,0,1,0
8785,1666,0,0,130,130,0,1,0,1,0
1481,1121,0,0,135,135,0,1,0,1,0
12585,1149,0,0,93,93,0,1,0,1,0
1315,3095,0,0,142,142,0,1,0,1,0
9967,1594,0,0,90,90,0,1,0,1,0
2887,183,10188,121,293,223,70,4,1,3,1
664,1176,0,0,153,153,0,1,0,1,0
2050,3095,0,0,156,156,0,1,0,1,0
3958,624,0,0,131,131,0,1,0,1,0
15391,988,0,0,145,145,0,1,0,1,0
13905,2220,0,0,103,103,0,1,0,1,0
2287,1341,0,0,117,117,0,1,0,1,0
1107,1176,0,0,140,140,0,1,0,1,0
85,1491,0,0,152,152,0,1,0,1,0
710,1176,0,0,155,155,0,1,0,1,0
2142,1896,0,0,73,73,0,1,0,1,0
9303,1327,0,0,117,117,0,1,0,1,0
1461,1194,0,0,136,136,0,1,0,1,0
1993,934,0,0,62,62,0,1,0,1,0
1501,3095,0,0,140,140,0,1,0,1,0
8947,1543,0,0,123,123,0,1,0,1,0
1769,183,6630,121,293,223,70,4,0,3,1
3016,1580,0,0,80,80,0,1,0,1,0
1946,995,0,0,99,99,0,1,0,1,0
1647,183,6120,121,293,223,70,4,0,3,1
5032,183,16584,121,293,223,70,4,1,3,1
8252,1790,0,0,140,140,0,1,0,1,0
1388,1176,0,0,140,140,0,1,0,1,0
2222,183,9083,121,293,223,70,4,0,3,1
11818,1543,0,0,62,62,0,1,0,1,0
10388,1543,0,0,71,71,0,1,0,1,0
4368,183,15445,121,293,223,70,4,1,3,1
387,1088,0,0,157,157,0,1,0,1,0
10587,1571,0,0,70,70,0,1,0,1,0
19209,2744,0,0,126,126,0,1,0,1,0
1191,3095,0,0,139,139,0,1,0,1,0
54,1269,0,0,154,154,0,1,0,1,0
11238,1654,0,0,64,64,0,1,0,1,0
8879,2265,0,0,67,67,0,1,0,1,0
2246,1608,0,0,62,62,0,1,0,1,0
1837,183,7007,121,293,223,70,4,0,3,1
21533,1545,0,0,62,62,0,1,0,1,0
1730,183,6434,121,293,223,70,4,0,3,1
2240,1593,0,0,62,62,0,1,0,1,0
8710,1256,0,0,138,138,0,1,0,1,0
7370,2924,0,0,69,69,0,1,0,1,0
725,1176,0,0,155,155,0,1,0,1,0
10046,1543,0,0,83,83,0,1,0,1,0
1569,2866,0,0,126,126,0,1,0,1,0
19760,1571,0,0,62,62,0,1,0,1,0
11291,1661,0,0,64,64,0,1,0,1,0
2032,183,7973,121,293,223,70,4,0,3,1
1901,183,7271,121,293,223,70,4,0,3,1
753,1640,0,0,152,152,0,1,0,1,0
1954,886,0,0,73,73,0,1,0,1,0
66,1351,0,0,153,153,0,1,0,1,0
2040,1336,0,0,117,117,0,1,0,1,0
525,1680,0,0,151,151,0,1,0,1,0
12061,1543,0,0,62,62,0,1,0,1,0
4062,183,14515,121,293,223,70,4,0,3,1
707,1176,0,0,141,141,0,1,0,1,0
9008,1285,0,0,128,128,0,1,0,1,0
1914,183,7395,121,293,223,70,4,0,3,1
9942,1574,0,0,87,87,0,1,0,1,0
881,208,3486,117,289,220,68,3,0,2,0
13552,1664,0,0,62,62,0,1,0,1,0
9827,1402,0,0,98,98,0,1,0,1,0
8135,1383,0,0,146,146,0,1,0,1,0
2257,2557,0,0,121,121,0,1,0,1,0
1337,208,4059,111,282,217,64,3,0,2,0
2122,1279,0,0,62,62,0,1,0,1,0
8792,1543,0,0,130,130,0,1,0,1,0
2247,183,9209,121,293,223,70,4,0,3,1
7701,2498,0,0,96,96,0,1,0,1,0
898,2805,0,0,143,143,0,1,0,1,0
2713,1176,0,0,146,146,0,1,0,1,0
1117,183,4445,121,293,223,70,4,0,3,1
1314,183,4398,121,293,223,70,4,1,3,1
1349,3095,0,0,142,142,0,1,0,1,0
9240,1638,0,0,115,115,0,1,0,1,0
5290,289,0,0,146,146,0,1,0,1,0
1550,183,5554,121,293,223,70,4,0,3,1
8478,1543,0,0,140,140,0,1,0,1,0
4843,183,16349,121,293,223,70,4,1,3,1
2999,120,0,0,86,86,0,1,0,1,0
1342,183,4535,121,293,223,70,4,0,3,1
903,3095,0,0,140,140,0,1,0,1,0
10527,1543,0,0,71,71,0,1,0,1,0
20711,2020,0,0,87,87,0,1,0,1,0
1481,355,2197,60,220,185,35,2,0,2,0
8776,1252,0,0,137,137,0,1,0,1,0
7523,2692,0,0,81,81,0,1,0,1,0
9706,1694,0,0,110,110,0,1,0,1,0
491,2523,0,0,143,143,0,1,0,1,0
1509,183,5367,121,293,223,70,4,0,3,1
15460,1036,0,0,145,145,0,1,0,1,0
4044,183,14294,121,293,223,70,4,1,3,1
17963,2995,0,0,140,140,0,1,0,1,0
1830,419,0,0,130,130,0,1,0,1,0
1639,1176,0,0,140,140,0,1,0,1,0
1007,1176,0,0,150,150,0,1,0,1,0
1295,183,4670,121,293,223,70,4,1,3,1
4997,183,16540,121,293,223,70,4,1,3,1
2246,1609,0,0,62,62,0,1,0,1,0
1266,352,1824,61,221,186,35,2,0,2,0
1766,183,6712,121,293,223,70,4,0,3,1
18357,3071,0,0,143,143,0,1,0,1,0
2202,183,8291,121,293,223,70,4,0,3,1
2516,1694,0,0,62,62,0,1,0,1,0
1991,1264,0,0,129,129,0,1,0,1,0
8388,1545,0,0,144,144,0,1,0,1,0
2008,183,8225,121,293,223,70,4,0,3,1
3886,338,0,0,132,132,0,1,0,1,0
2914,1225,0,0,139,139,0,1,0,1,0
4114,438,0,0,143,143,0,1,0,1,0
193,2272,0,0,145,145,0,1,0,1,0
1808,183,6821,121,293,223,70,4,0,3,1
8260,1253,0,0,154,154,0,1,0,1,0
2653,183,9355,121,293,223,70,4,1,3,1
963,3095,0,0,139,139,0,1,0,1,0
9357,1631,0,0,111,111,0,1,0,1,0
2070,183,8214,121,293,223,70,4,0,3,1
10447,1543,0,0,70,70,0,1,0,1,0
1772,455,0,0,136,136,0,1,0,1,0
3619,949,0,0,110,110,0,1,0,1,0
2376,1694,0,0,62,62,0,1,0,1,0
16235,1564,0,0,145,145,0,1,0,1,0
9788,1611,0,0,107,107,0,1,0,1,0
2169,183,8805,121,293,223,70,4,0,3,1
159,2025,0,0,147,147,0,1,0,1,0
945,1045,0,0,155,155,0,1,0,1,0
35,1130,0,0,155,155,0,1,0,1,0
6989,2544,0,0,77,77,0,1,0,1,0
12940,964,0,0,103,103,0,1,0,1,0
1582,183,5739,121,293,223,70,4,0,3,1
1957,839,0,0,62,62,0,1,0,1,0
856,3095,0,0,139,139,0,1,0,1,0
18642,183,26526,121,293,223,70,4,0,3,1
132,1029,0,0,157,157,0,1,0,1,0
2181,183,8838,121,293,223,70,4,0,3,1
1664,541,0,0,144,144,0,1,0,1,0
561,1604,0,0,152,152,0,1,0,1,0
9144,1644,0,0,118,118,0,1,0,1,0
8327,1686,0,0,146,146,0,1,0,1,0
2823,1251,0,0,135,135,0,1,0,1,0
20249,1543,0,0,62,62,0,1,0,1,0
15268,2445,0,0,110,110,0,1,0,1,0
8312,1712,0,0,144,144,0,1,0,1,0
7281,3039,0,0,62,62,0,1,0,1,0
1958,341,0,0,117,117,0,1,0,1,0
1527,2936,0,0,130,130,0,1,0,1,0
2857,1607,0,0,75,75,0,1,0,1,0
11066,1595,0,0,62,62,0,1,0,1,0
8230,1199,0,0,155,155,0,1,0,1,0
1837,3095,0,0,151,151,0,1,0,1,0
13540,2095,0,0,91,91,0,1,0,1,0
11012,1625,0,0,66,66,0,1,0,1,0
2510,183,9313,121,293,223,70,4,0,3,1
1798,439,0,0,133,133,0,1,0,1,0
3284,183,10973,121,293,223,70,4,1,3,1
1876,183,7150,121,293,223,70,4,0,3,1
1823,183,6890,121,293,223,70,4,0,3,1
2100,1254,0,0,130,130,0,1,0,1,0
3408,221,0,0,108,108,0,1,0,1,0
8448,1543,0,0,141,141,0,1,0,1,0
2614,1694,0,0,62,62,0,1,0,1,0
1700,641,0,0,147,147,0,1,0,1,0
1638,2647,0,0,117,117,0,1,0,1,0
1926,183,7398,121,293,223,70,4,0,3,1
1782,183,6797,121,293,223,70,4,0,3,1
7329,2941,0,0,67,67,0,1,0,1,0
2901,1629,0,0,72,72,0,1,0,1,0
3654,979,0,0,108,108,0,1,0,1,0
2949,1310,0,0,125,125,0,1,0,1,0
1110,2944,0,0,143,143,0,1,0,1,0
1124,183,4205,121,293,223,70,4,1,3,1
1248,183,4264,121,293,223,70,4,1,3,1
2252,943,0,0,88,88,0,1,0,1,0
714,2684,0,0,144,144,0,1,0,1,0
701,546,2268,76,238,193,44,2,0,2,0
8236,1672,0,0,138,138,0,1,0,1,0
8327,1588,0,0,146,146,0,1,0,1,0
2392,75,0,0,74,74,0,1,0,1,0
2825,1591,0,0,77,77,0,1,0,1,0
1900,183,7269,121,293,223,70,4,0,3,1
8276,1323,0,0,152,152,0,1,0,1,0
935,201,3388,114,285,218,66,3,0,2,0
1057,3095,0,0,139,139,0,1,0,1,0
9851,1601,0,0,94,94,0,1,0,1,0
13790,183,20524,121,293,223,70,4,0,3,1
2150,1354,0,0,62,62,0,1,0,1,0
8277,1386,0,0,152,152,0,1,0,1,0
1812,898,0,0,145,145,0,1,0,1,0
2173,3095,0,0,157,157,0,1,0,1,0
1050,1176,0,0,149,149,0,1,0,1,0
2089,3095,0,0,156,156,0,1,0,1,0
8732,1543,0,0,131,131,0,1,0,1,0
3158,1560,0,0,70,70,0,1,0,1,0
3714,296,0,0,123,123,0,1,0,1,0
2504,183,9085,121,293,223,70,4,0,3,1
2989,1694,0,0,62,62,0,1,0,1,0
1025,183,3832,121,293,223,70,4,1,3,1
1461,1176,0,0,139,139,0,1,0,1,0
2088,183,8388,121,293,223,70,4,0,3,1
555,1176,0,0,149,149,0,1,0,1,0
3509,1062,0,0,103,103,0,1,0,1,0
587,2917,0,0,140,140,0,1,0,1,0
2472,1244,0,0,62,62,0,1,0,1,0
2424,55,0,0,70,70,0,1,0,1,0
8462,1207,0,0,148,148,0,1,0,1,0
2019,183,7904,121,293,223,70,4,0,3,1
1949,3095,0,0,153,153,0,1,0,1,0
8306,1569,0,0,148,148,0,1,0,1,0
1456,183,5109,121,293,223,70,4,1,3,1
528,1673,0,0,151,151,0,1,0,1,0
15304,2487,0,0,116,116,0,1,0,1,0
4625,183,16078,121,293,223,70,4,1,3,1
1778,1176,0,0,141,141,0,1,0,1,0
1845,183,7000,121,293,223,70,4,0,3,1
7698,2227,0,0,103,103,0,1,0,1,0
12033,1439,0,0,76,76,0,1,0,1,0
133,1060,0,0,152,152,0,1,0,1,0
47,1219,0,0,155,155,0,1,0,1,0
878,315,3101,104,274,214,60,3,0,2,0
4569,183,16008,121,293,223,70,4,1,3,1
775,783,0,0,152,152,0,1,0,1,0
140,1064,0,0,152,152,0,1,0,1,0
21595,1193,7318,31,121,103,18,1,0,1,0
13113,873,0,0,109,109,0,1,0,1,0
6513,547,0,0,149,149,0,1,0,1,0
1466,2904,0,0,132,132,0,1,0,1,0
2052,697,0,0,62,62,0,1,0,1,0
1805,1176,0,0,141,141,0,1,0,1,0
3700,292,0,0,122,122,0,1,0,1,0
2026,736,0,0,62,62,0,1,0,1,0
2021,183,8037,121,293,223,70,4,0,3,1
10223,1609,0,0,71,71,0,1,0,1,0
3021,1604,0,0,76,76,0,1,0,1,0
3192,183,10209,121,293,223,70,4,0,3,1
9138,1633,0,0,116,116,0,1,0,1,0
4178,183,14330,121,293,223,70,4,0,3,1
2049,3095,0,0,154,154,0,1,0,1,0
1149,183,4072,121,293,223,70,4,1,3,1
2872,1211,0,0,142,142,0,1,0,1,0
1404,1176,0,0,139,139,0,1,0,1,0
8411,1200,0,0,150,150,0,1,0,1,0
10251,1596,0,0,71,71,0,1,0,1,0
10875,183,20685,121,293,223,70,4,0,3,1
4985,183,16525,121,293,223,70,4,1,3,1
10171,1451,0,0,85,85,0,1,0,1,0
9197,1341,0,0,118,118,0,1,0,1,0
2904,1694,0,0,62,62,0,1,0,1,0
4645,183,16103,121,293,223,70,4,1,3,1
17022,2799,0,0,129,129,0,1,0,1,0
2336,109,0,0,79,79,0,1,0,1,0
8327,1687,0,0,146,146,0,1,0,1,0
10537,1565,0,0,70,70,0,1,0,1,0
8008,2690,0,0,64,64,0,1,0,1,0
2689,1176,0,0,146,146,0,1,0,1,0
2018,3095,0,0,153,153,0,1,0,1,0
13087,700,0,0,116,116,0,1,0,1,0
3792,183,10814,121,293,223,70,4,0,3,1
1294,1176,0,0,142,142,0,1,0,1,0
10718,1543,0,0,64,64,0,1,0,1,0
645,820,0,0,153,153,0,1,0,1,0
7946,2183,0,0,115,115,0,1,0,1,0
14289,257,0,0,144,144,0,1,0,1,0
5684,249,0,0,146,146,0,1,0,1,0
1909,371,0,0,122,122,0,1,0,1,0
3990,183,13489,121,293,223,70,4,0,3,1
330,1434,0,0,143,143,0,1,0,1,0
8742,1247,0,0,138,138,0,1,0,1,0
3019,1674,0,0,62,62,0,1,0,1,0
2904,1141,0,0,145,145,0,1,0,1,0
15058,183,21866,121,293,223,70,4,0,3,1
12993,935,0,0,105,105,0,1,0,1,0
1300,786,0,0,151,151,0,1,0,1,0
505,914,942,31,182,164,18,1,0,1,0
1501,2979,0,0,132,132,0,1,0,1,0
1935,3095,0,0,153,153,0,1,0,1,0
2229,1620,0,0,73,73,0,1,0,1,0
1382,3095,0,0,139,139,0,1,0,1,0
4430,183,14865,121,293,223,70,4,0,3,1
8714,1561,0,0,135,135,0,1,0,1,0
881,290,3193,107,278,215,62,3,0,2,0
10699,1586,0,0,69,69,0,1,0,1,0
4121,183,14792,121,293,223,70,4,0,3,1
1901,1104,0,0,143,143,0,1,0,1,0
2237,183,9151,121,293,223,70,4,0,3,1
2091,1196,0,0,62,62,0,1,0,1,0
1405,3095,0,0,140,140,0,1,0,1,0
654,1149,0,0,157,157,0,1,0,1,0
1412,183,4884,121,293,223,70,4,1,3,1
1488,183,5252,121,293,223,70,4,0,3,1
3916,183,14050,121,293,223,70,4,0,3,1
1185,1176,0,0,145,145,0,1,0,1,0
15541,2533,0,0,118,118,0,1,0,1,0
3030,1638,0,0,71,71,0,1,0,1,0
1760,183,6627,121,293,223,70,4,0,3,1
21636,1327,4500,19,98,87,11,1,0,1,0
12992,533,0,0,145,145,0,1,0,1,0
2222,179,0,0,91,91,0,1,0,1,0
981,183,3747,121,293,223,70,4,1,3,1
18735,2972,0,0,138,138,0,1,0,1,0
2679,1576,0,0,80,80,0,1,0,1,0
2481,1694,0,0,62,62,0,1,0,1,0
1404,710,0,0,150,150,0,1,0,1,0
1668,183,6430,121,293,223,70,4,0,3,1
810,3095,0,0,139,139,0,1,0,1,0
2037,183,8008,121,293,223,70,4,0,3,1
7447,2825,0,0,75,75,0,1,0,1,0
8327,1586,0,0,146,146,0,1,0,1,0
1469,183,5695,121,293,223,70,4,0,3,1
8199,1259,0,0,152,152,0,1,0,1,0
10363,1543,0,0,71,71,0,1,0,1,0
2869,1213,0,0,141,141,0,1,0,1,0
730,2363,0,0,145,145,0,1,0,1,0
13216,183,20317,121,293,223,70,4,0,3,1
1793,855,0,0,145,145,0,1,0,1,0
1552,427,1283,35,190,169,20,1,0,1,0
342,1343,0,0,143,143,0,1,0,1,0
7643,2520,0,0,91,91,0,1,0,1,0
2837,1694,0,0,62,62,0,1,0,1,0
11256,1657,0,0,64,64,0,1,0,1,0
1952,917,0,0,80,80,0,1,0,1,0
14502,1543,0,0,68,68,0,1,0,1,0
11207,1624,0,0,62,62,0,1,0,1,0
708,3095,0,0,139,139,0,1,0,1,0
2262,1116,0,0,62,62,0,1,0,1,0
7524,2564,0,0,86,86,0,1,0,1,0
4366,183,15521,121,293,223,70,4,0,3,1
2269,2036,0,0,85,85,0,1,0,1,0
9761,1606,0,0,97,97,0,1,0,1,0
1296,1176,0,0,142,142,0,1,0,1,0
1469,183,5696,121,293,223,70,4,0,3,1
14051,382,0,0,137,137,0,1,0,1,0
2390,991,0,0,100,100,0,1,0,1,0
1017,848,0,0,145,145,0,1,0,1,0
952,1176,0,0,151,151,0,1,0,1,0
1601,183,5803,121,293,223,70,4,0,3,1
8730,1669,0,0,132,132,0,1,0,1,0
9207,1543,0,0,113,113,0,1,0,1,0
1391,3095,0,0,139,139,0,1,0,1,0
1940,1078,0,0,119,119,0,1,0,1,0
1760,638,0,0,117,117,0,1,0,1,0
7474,2762,0,0,78,78,0,1,0,1,0
983,2861,0,0,143,143,0,1,0,1,0
2793,1637,0,0,70,70,0,1,0,1,0
10702,1654,0,0,83,83,0,1,0,1,0
1669,183,6434,121,293,223,70,4,0,3,1
1225,183,4868,121,293,223,70,4,0,3,1
1985,3095,0,0,154,154,0,1,0,1,0
2404,1694,0,0,62,62,0,1,0,1,0
161,2039,0,0,147,147,0,1,0,1,0
1815,183,6853,121,293,223,70,4,0,3,1
1938,183,7466,121,293,223,70,4,0,3,1
2251,2810,0,0,139,139,0,1,0,1,0
8474,1216,0,0,147,147,0,1,0,1,0
9656,1595,0,0,97,97,0,1,0,1,0
1727,605,0,0,126,126,0,1,0,1,0
2945,1296,0,0,128,128,0,1,0,1,0
2691,44,0,0,71,71,0,1,0,1,0
18616,1588,0,0,62,62,0,1,0,1,0
1873,183,7271,121,293,223,70,4,0,3,1
1846,3095,0,0,149,149,0,1,0,1,0
1956,865,0,0,68,68,0,1,0,1,0
1575,183,5488,121,293,223,70,4,1,3,1
987,183,3939,121,293,223,70,4,0,3,1
12274,688,0,0,145,145,0,1,0,1,0
1414,3095,0,0,139,139,0,1,0,1,0
2773,1694,0,0,62,62,0,1,0,1,0
323,1483,0,0,143,143,0,1,0,1,0
4504,367,0,0,146,146,0,1,0,1,0
8989,1574,0,0,128,128,0,1,0,1,0
894,3095,0,0,139,139,0,1,0,1,0
1718,596,0,0,129,129,0,1,0,1,0
1439,1151,0,0,139,139,0,1,0,1,0
1493,1214,0,0,133,133,0,1,0,1,0
3001,1694,0,0,62,62,0,1,0,1,0
225,2381,0,0,144,144,0,1,0,1,0
763,1318,0,0,155,155,0,1,0,1,0
2021,862,0,0,67,67,0,1,0,1,0
8246,1196,0,0,156,156,0,1,0,1,0
20836,1959,0,0,84,84,0,1,0,1,0
1366,398,1351,45,202,176,26,2,0,1,0
11257,1694,0,0,69,69,0,1,0,1,0
1952,916,0,0,80,80,0,1,0,1,0
13852,486,0,0,131,131,0,1,0,1,0
8253,1220,0,0,155,155,0,1,0,1,0
350,1168,0,0,143,143,0,1,0,1,0
2909,1368,0,0,116,116,0,1,0,1,0
682,3059,0,0,139,139,0,1,0,1,0
7786,1009,0,0,155,155,0,1,0,1,0
1995,183,7794,121,293,223,70,4,0,3,1
2129,779,0,0,115,115,0,1,0,1,0
8767,1667,0,0,131,131,0,1,0,1,0
2087,3095,0,0,156,156,0,1,0,1,0
2056,929,0,0,62,62,0,1,0,1,0
2845,1694,0,0,62,62,0,1,0,1,0
1089,272,2658,89,255,203,51,3,0,2,0
1712,668,0,0,146,146,0,1,0,1,0
2109,610,0,0,62,62,0,1,0,1,0
10711,1543,0,0,64,64,0,1,0,1,0
367,1176,0,0,143,143,0,1,0,1,0
1448,183,5620,121,293,223,70,4,0,3,1
16539,1771,0,0,145,145,0,1,0,1,0
12652,1917,0,0,75,75,0,1,0,1,0
2018,1222,0,0,135,135,0,1,0,1,0
3477,1186,0,0,95,95,0,1,0,1,0
2164,1391,0,0,62,62,0,1,0,1,0
1659,1030,0,0,105,105,0,1,0,1,0
10750,1543,0,0,63,63,0,1,0,1,0
1347,183,4565,121,293,223,70,4,1,3,1
17543,2905,0,0,134,134,0,1,0,1,0
1135,183,4233,121,293,223,70,4,1,3,1
1763,642,0,0,116,116,0,1,0,1,0
2588,2359,0,0,108,108,0,1,0,1,0
2131,183,8535,121,293,223,70,4,0,3,1
1602,672,0,0,146,146,0,1,0,1,0
10553,1543,0,0,67,67,0,1,0,1,0
10694,1543,0,0,64,64,0,1,0,1,0
1898,779,0,0,78,78,0,1,0,1,0
2578,1694,0,0,62,62,0,1,0,1,0
2658,1391,0,0,62,62,0,1,0,1,0
2042,869,0,0,69,69,0,1,0,1,0
9129,183,19381,121,293,223,70,4,0,3,1
10736,1590,0,0,68,68,0,1,0,1,0
2452,1288,0,0,62,62,0,1,0,1,0
2908,1412,0,0,108,108,0,1,0,1,0
293,2163,0,0,146,146,0,1,0,1,0
594,2927,0,0,140,140,0,1,0,1,0
702,544,2277,76,238,193,44,2,0,2,0
1303,183,5086,121,293,223,70,4,0,3,1
1688,183,6668,121,293,223,70,4,0,3,1
2020,1176,0,0,143,143,0,1,0,1,0
10046,1543,0,0,87,87,0,1,0,1,0
6856,820,0,0,146,146,0,1,0,1,0
2999,1694,0,0,62,62,0,1,0,1,0
3333,183,12185,121,293,223,70,4,0,3,1
797,945,830,28,188,172,16,1,0,1,0
1414,183,5605,121,293,223,70,4,0,3,1
2014,754,0,0,62,62,0,1,0,1,0
1793,854,0,0,145,145,0,1,0,1,0
2010,1530,0,0,86,86,0,1,0,1,0
633,1176,0,0,152,152,0,1,0,1,0
471,977,715,24,172,158,13,1,0,1,0
513,2537,0,0,143,143,0,1,0,1,0
1576,183,5687,121,293,223,70,4,0,3,1
1590,183,5753,121,293,223,70,4,0,3,1
3336,183,11749,121,293,223,70,4,0,3,1
87,1019,0,0,157,157,0,1,0,1,0
3686,183,12590,121,293,223,70,4,0,3,1
2009,183,7867,121,293,223,70,4,0,3,1
13414,578,0,0,123,123,0,1,0,1,0
1348,1165,0,0,140,140,0,1,0,1,0
2066,3095,0,0,154,154,0,1,0,1,0
10279,1528,0,0,75,75,0,1,0,1,0
2907,1448,0,0,102,102,0,1,0,1,0
2274,1688,0,0,62,62,0,1,0,1,0
11332,1666,0,0,63,63,0,1,0,1,0
2597,1434,0,0,105,105,0,1,0,1,0
1520,914,0,0,142,142,0,1,0,1,0
8327,1641,0,0,146,146,0,1,0,1,0
1288,1176,0,0,150,150,0,1,0,1,0
1346,183,4560,121,293,223,70,4,1,3,1
10406,1528,0,0,72,72,0,1,0,1,0
2338,108,0,0,79,79,0,1,0,1,0
3492,1080,0,0,101,101,0,1,0,1,0
1720,183,6386,121,293,223,70,4,0,3,1
3474,989,0,0,147,147,0,1,0,1,0
7649,2866,0,0,63,63,0,1,0,1,0
7376,860,0,0,153,153,0,1,0,1,0
1947,983,0,0,96,96,0,1,0,1,0
1119,183,4192,121,293,223,70,4,1,3,1
2212,183,9003,121,293,223,70,4,0,3,1
1769,1176,0,0,141,141,0,1,0,1,0
2052,1355,0,0,114,114,0,1,0,1,0
1668,918,0,0,122,122,0,1,0,1,0
1943,1031,0,0,108,108,0,1,0,1,0
723,1176,0,0,155,155,0,1,0,1,0
1333,3095,0,0,147,147,0,1,0,1,0
2194,1176,0,0,144,144,0,1,0,1,0
969,3095,0,0,139,139,0,1,0,1,0
15105,793,0,0,145,145,0,1,0,1,0
2993,1489,0,0,95,95,0,1,0,1,0
12700,1990,0,0,93,93,0,1,0,1,0
7854,1926,0,0,118,118,0,1,0,1,0
8194,1268,0,0,152,152,0,1,0,1,0
2803,1267,0,0,132,132,0,1,0,1,0
1742,737,0,0,146,146,0,1,0,1,0
4260,183,14545,121,293,223,70,4,0,3,1
2900,1662,0,0,67,67,0,1,0,1,0
14975,705,0,0,145,145,0,1,0,1,0
1452,183,5098,121,293,223,70,4,1,3,1
156,1035,0,0,157,157,0,1,0,1,0
1939,1161,0,0,142,142,0,1,0,1,0
2930,1694,0,0,62,62,0,1,0,1,0
1161,183,4617,121,293,223,70,4,0,3,1
1941,1064,0,0,116,116,0,1,0,1,0
1946,988,0,0,97,97,0,1,0,1,0
1941,1057,0,0,114,114,0,1,0,1,0
2702,1694,0,0,62,62,0,1,0,1,0
14101,183,23093,121,293,223,70,4,0,3,1
20065,1567,0,0,62,62,0,1,0,1,0
9502,1606,0,0,103,103,0,1,0,1,0
2825,1694,0,0,62,62,0,1,0,1,0
1491,646,0,0,149,149,0,1,0,1,0
2907,1430,0,0,105,105,0,1,0,1,0
2256,183,9257,121,293,223,70,4,0,3,1
4668,183,16131,121,293,223,70,4,1,3,1
109,1664,0,0,151,151,0,1,0,1,0
1759,183,6617,121,293,223,70,4,0,3,1
1649,537,0,0,147,147,0,1,0,1,0
7728,2169,0,0,106,106,0,1,0,1,0
1386,662,0,0,146,146,0,1,0,1,0
2517,2511,0,0,118,118,0,1,0,1,0
858,252,3330,112,282,217,65,3,0,2,0
2203,183,8951,121,293,223,70,4,0,3,1
746,1856,0,0,150,150,0,1,0,1,0
1414,286,3071,84,249,200,48,3,0,2,0
2977,1423,0,0,106,106,0,1,0,1,0
1777,656,0,0,112,112,0,1,0,1,0
10385,1568,0,0,76,76,0,1,0,1,0
1643,525,40,1,149,148,0,1,0,1,0
3123,151,0,0,93,93,0,1,0,1,0
2706,1519,0,0,62,62,0,1,0,1,0
149,1033,0,0,157,157,0,1,0,1,0
10523,1543,0,0,68,68,0,1,0,1,0
2377,2810,0,0,139,139,0,1,0,1,0
1377,729,0,0,150,150,0,1,0,1,0
2290,183,9352,121,293,223,70,4,0,3,1
14177,296,0,0,141,141,0,1,0,1,0
10158,1543,0,0,79,79,0,1,0,1,0
2132,183,8538,121,293,223,70,4,0,3,1
1999,183,7924,121,293,223,70,4,0,3,1
1894,183,7265,121,293,223,70,4,0,3,1
1572,586,0,0,148,148,0,1,0,1,0
1560,3095,0,0,150,150,0,1,0,1,0
2703,556,0,0,102,102,0,1,0,1,0
1007,3095,0,0,139,139,0,1,0,1,0
12457,855,0,0,110,110,0,1,0,1,0
1446,1131,0,0,139,139,0,1,0,1,0
11469,1678,0,0,62,62,0,1,0,1,0
2016,752,0,0,62,62,0,1,0,1,0
2373,1176,0,0,145,145,0,1,0,1,0
1897,1461,0,0,96,96,0,1,0,1,0
15772,183,24341,121,293,223,70,4,0,3,1
7517,2735,0,0,81,81,0,1,0,1,0
608,2949,0,0,140,140,0,1,0,1,0
2467,51,0,0,65,65,0,1,0,1,0
1577,745,0,0,144,144,0,1,0,1,0
1174,3095,0,0,141,141,0,1,0,1,0
11345,1668,0,0,63,63,0,1,0,1,0
1586,462,843,23,175,162,13,1,0,1,0
1444,183,5038,121,293,223,70,4,0,3,1
3350,903,0,0,147,147,0,1,0,1,0
11293,1661,0,0,64,64,0,1,0,1,0
366,1176,0,0,143,143,0,1,0,1,0
5831,493,0,0,138,138,0,1,0,1,0
8327,1547,0,0,146,146,0,1,0,1,0
11314,1646,0,0,62,62,0,1,0,1,0
15009,183,21814,121,293,223,70,4,0,3,1
1284,1176,0,0,142,142,0,1,0,1,0
1496,183,6090,121,293,223,70,4,0,3,1
8929,1543,0,0,124,124,0,1,0,1,0
1130,1176,0,0,152,152,0,1,0,1,0
2291,1682,0,0,63,63,0,1,0,1,0
15252,894,0,0,145,145,0,1,0,1,0
1696,183,6373,121,293,223,70,4,0,3,1
581,2908,0,0,140,140,0,1,0,1,0
19818,2450,0,0,110,110,0,1,0,1,0
3081,1505,0,0,74,74,0,1,0,1,0
7482,2645,0,0,82,82,0,1,0,1,0
2272,1678,0,0,62,62,0,1,0,1,0
135,1061,0,0,152,152,0,1,0,1,0
879,1094,0,0,155,155,0,1,0,1,0
7575,2661,0,0,86,86,0,1,0,1,0
2090,1176,0,0,143,143,0,1,0,1,0
1731,1176,0,0,141,141,0,1,0,1,0
17418,793,0,0,110,110,0,1,0,1,0
746,1849,0,0,150,150,0,1,0,1,0
7696,2232,0,0,103,103,0,1,0,1,0
8430,1520,0,0,145,145,0,1,0,1,0
6854,819,0,0,146,146,0,1,0,1,0
2802,71,0,0,76,76,0,1,0,1,0
7200,2918,0,0,65,65,0,1,0,1,0
1672,183,6154,121,293,223,70,4,0,3,1
17990,1543,0,0,62,62,0,1,0,1,0
1125,914,0,0,153,153,0,1,0,1,0
1767,646,0,0,115,115,0,1,0,1,0
2049,1084,0,0,62,62,0,1,0,1,0
4962,321,0,0,146,146,0,1,0,1,0
2992,1486,0,0,96,96,0,1,0,1,0
4901,183,16421,121,293,223,70,4,1,3,1
7351,1063,0,0,146,146,0,1,0,1,0
744,1225,0,0,156,156,0,1,0,1,0
8156,1344,0,0,148,148,0,1,0,1,0
1204,3095,0,0,142,142,0,1,0,1,0
1008,1176,0,0,150,150,0,1,0,1,0
12628,1543,0,0,70,70,0,1,0,1,0
10062,1436,0,0,89,89,0,1,0,1,0
1132,3095,0,0,141,141,0,1,0,1,0
3066,136,0,0,90,90,0,1,0,1,0
15344,1637,0,0,62,62,0,1,0,1,0
1766,1176,0,0,141,141,0,1,0,1,0
4467,371,0,0,146,146,0,1,0,1,0
9907,1543,0,0,92,92,0,1,0,1,0
2651,1694,0,0,62,62,0,1,0,1,0
2905,1483,0,0,96,96,0,1,0,1,0
6514,699,0,0,146,146,0,1,0,1,0
4674,183,15429,121,293,223,70,4,1,3,1
9125,1645,0,0,118,118,0,1,0,1,0
4767,341,0,0,146,146,0,1,0,1,0
16717,183,25046,121,293,223,70,4,0,3,1
1480,183,5230,121,293,223,70,4,0,3,1
1105,1176,0,0,147,147,0,1,0,1,0
2897,1694,0,0,62,62,0,1,0,1,0
8268,1288,0,0,153,153,0,1,0,1,0
2912,1291,0,0,128,128,0,1,0,1,0
8243,1176,0,0,156,156,0,1,0,1,0
21363,420,23497,99,252,194,57,3,0,2,0
613,1051,0,0,143,143,0,1,0,1,0
2900,1640,0,0,70,70,0,1,0,1,0
12104,970,0,0,104,104,0,1,0,1,0
1118,183,4511,121,293,223,70,4,0,3,1
16469,1723,0,0,145,145,0,1,0,1,0
10591,183,20645,121,293,223,70,4,0,3,1
9677,1606,0,0,110,110,0,1,0,1,0
2354,240,0,0,62,62,0,1,0,1,0
18525,3073,0,0,143,143,0,1,0,1,0
2029,731,0,0,62,62,0,1,0,1,0
11082,1634,0,0,65,65,0,1,0,1,0
2403,223,0,0,77,77,0,1,0,1,0
10707,1528,0,0,65,65,0,1,0,1,0
742,1229,0,0,156,156,0,1,0,1,0
3041,1694,0,0,62,62,0,1,0,1,0
1453,183,5638,121,293,223,70,4,0,3,1
2949,1312,0,0,125,125,0,1,0,1,0
8758,1563,0,0,134,134,0,1,0,1,0
1345,3095,0,0,142,142,0,1,0,1,0
141,1895,0,0,149,149,0,1,0,1,0
1616,183,5936,121,293,223,70,4,0,3,1
2464,1694,0,0,62,62,0,1,0,1,0
8481,1210,0,0,148,148,0,1,0,1,0
10402,1548,0,0,71,71,0,1,0,1,0
2744,2024,0,0,84,84,0,1,0,1,0
2048,1082,0,0,62,62,0,1,0,1,0
2355,2858,0,0,142,142,0,1,0,1,0
2126,183,8506,121,293,223,70,4,0,3,1
8264,1305,0,0,154,154,0,1,0,1,0
16874,698,0,0,116,116,0,1,0,1,0
2017,183,7917,121,293,223,70,4,0,3,1
1327,766,0,0,151,151,0,1,0,1,0
678,1018,0,0,144,144,0,1,0,1,0
4393,183,14685,121,293,223,70,4,0,3,1
9610,1543,0,0,99,99,0,1,0,1,0
1930,183,7421,121,293,223,70,4,0,3,1
21080,1842,0,0,78,78,0,1,0,1,0
18935,1584,0,0,62,62,0,1,0,1,0
961,183,3761,121,293,223,70,4,1,3,1
4717,183,15569,121,293,223,70,4,1,3,1
8264,1307,0,0,154,154,0,1,0,1,0
1303,1176,0,0,150,150,0,1,0,1,0
6543,666,0,0,146,146,0,1,0,1,0
1259,726,0,0,146,146,0,1,0,1,0
1942,1044,0,0,111,111,0,1,0,1,0
14625,466,0,0,145,145,0,1,0,1,0
1169,3095,0,0,141,141,0,1,0,1,0
21204,183,28373,121,293,223,70,4,0,3,1
2161,532,0,0,62,62,0,1,0,1,0
1995,183,7793,121,293,223,70,4,0,3,1
577,2903,0,0,140,140,0,1,0,1,0
2164,1523,0,0,88,88,0,1,0,1,0
7970,2052,0,0,117,117,0,1,0,1,0
1352,3095,0,0,142,142,0,1,0,1,0
11165,1615,0,0,62,62,0,1,0,1,0
1998,946,0,0,62,62,0,1,0,1,0
1904,183,7288,121,293,223,70,4,0,3,1
1523,903,0,0,142,142,0,1,0,1,0
854,1176,0,0,154,154,0,1,0,1,0
9479,1390,0,0,107,107,0,1,0,1,0
1147,1176,0,0,146,146,0,1,0,1,0
8291,1472,0,0,150,150,0,1,0,1,0
718,3095,0,0,139,139,0,1,0,1,0
509,1063,0,0,150,150,0,1,0,1,0
2890,1101,0,0,142,142,0,1,0,1,0
1519,1176,0,0,139,139,0,1,0,1,0
2191,1564,0,0,82,82,0,1,0,1,0
2178,183,8804,121,293,223,70,4,0,3,1
3581,263,0,0,116,116,0,1,0,1,0
10469,1494,0,0,74,74,0,1,0,1,0
9624,1603,0,0,112,112,0,1,0,1,0
8327,1626,0,0,146,146,0,1,0,1,0
1411,183,4878,121,293,223,70,4,1,3,1
4106,392,0,0,143,143,0,1,0,1,0
1433,183,4995,121,293,223,70,4,0,3,1
4189,183,14179,121,293,223,70,4,0,3,1
2438,47,0,0,69,69,0,1,0,1,0
1533,875,0,0,143,143,0,1,0,1,0
4583,359,0,0,146,146,0,1,0,1,0
1957,850,0,0,64,64,0,1,0,1,0
17090,2146,0,0,145,145,0,1,0,1,0
19771,183,27327,121,293,223,70,4,0,3,1
897,1176,0,0,153,153,0,1,0,1,0
1440,183,5028,121,293,223,70,4,0,3,1
7503,183,18167,121,293,223,70,4,0,3,1
14330,183,23264,121,293,223,70,4,0,3,1
3031,1688,0,0,62,62,0,1,0,1,0
3027,1106,0,0,147,147,0,1,0,1,0
2766,63,0,0,74,74,0,1,0,1,0
8352,1543,0,0,145,145,0,1,0,1,0
8244,1184,0,0,156,156,0,1,0,1,0
353,2447,0,0,144,144,0,1,0,1,0
18850,2917,0,0,135,135,0,1,0,1,0
1884,183,7242,121,293,223,70,4,0,3,1
267,1887,0,0,144,144,0,1,0,1,0
1625,1176,0,0,140,140,0,1,0,1,0
6691,796,0,0,146,146,0,1,0,1,0
2087,3095,0,0,155,155,0,1,0,1,0
2917,1180,0,0,147,147,0,1,0,1,0
7460,2782,0,0,76,76,0,1,0,1,0
1455,1103,0,0,140,140,0,1,0,1,0
21411,581,20130,85,225,175,49,3,0,2,0
1127,183,4438,121,293,223,70,4,0,3,1
1302,3095,0,0,139,139,0,1,0,1,0
7303,3011,0,0,64,64,0,1,0,1,0
291,1717,0,0,143,143,0,1,0,1,0
2011,183,7859,121,293,223,70,4,0,3,1
1023,1126,0,0,144,144,0,1,0,1,0
2259,1644,0,0,62,62,0,1,0,1,0
1143,3095,0,0,139,139,0,1,0,1,0
8975,1543,0,0,124,124,0,1,0,1,0
1283,183,4638,121,293,223,70,4,1,3,1
2242,295,0,0,81,81,0,1,0,1,0
1889,183,7270,121,293,223,70,4,0,3,1
1629,183,5946,121,293,223,70,4,0,3,1
8282,1346,0,0,151,151,0,1,0,1,0
2011,183,8238,121,293,223,70,4,0,3,1
735,2201,0,0,147,147,0,1,0,1,0
2758,1304,0,0,126,126,0,1,0,1,0
8853,1694,0,0,132,132,0,1,0,1,0
7345,2957,0,0,67,67,0,1,0,1,0
1406,1176,0,0,139,139,0,1,0,1,0
8223,1214,0,0,155,155,0,1,0,1,0
8185,1286,0,0,151,151,0,1,0,1,0
10455,1543,0,0,69,69,0,1,0,1,0
949,882,0,0,145,145,0,1,0,1,0
1431,183,4974,121,293,223,70,4,0,3,1
1068,3095,0,0,141,141,0,1,0,1,0
1941,1068,0,0,117,117,0,1,0,1,0
2930,1694,0,0,62,62,0,1,0,1,0
1949,951,0,0,88,88,0,1,0,1,0
1236,183,4911,121,293,223,70,4,0,3,1
262,1124,0,0,147,147,0,1,0,1,0
264,1907,0,0,144,144,0,1,0,1,0
2122,1277,0,0,127,127,0,1,0,1,0
2964,1694,0,0,62,62,0,1,0,1,0
1946,1148,0,0,141,141,0,1,0,1,0
2157,1373,0,0,62,62,0,1,0,1,0
3010,1558,0,0,84,84,0,1,0,1,0
12135,1052,0,0,93,93,0,1,0,1,0
1932,183,7573,121,293,223,70,4,0,3,1
2649,1392,0,0,112,112,0,1,0,1,0
2906,1467,0,0,99,99,0,1,0,1,0
2114,1176,0,0,143,143,0,1,0,1,0
1345,183,4552,121,293,223,70,4,0,3,1
658,3023,0,0,139,139,0,1,0,1,0
1358,183,4620,121,293,223,70,4,1,3,1
1173,310,2263,76,239,195,44,2,0,2,0
651,2643,0,0,144,144,0,1,0,1,0
2189,3095,0,0,158,158,0,1,0,1,0
13688,572,0,0,126,126,0,1,0,1,0
13933,443,0,0,133,133,0,1,0,1,0
19023,1543,0,0,62,62,0,1,0,1,0
2001,183,7829,121,293,223,70,4,0,3,1
2675,2172,0,0,95,95,0,1,0,1,0
10931,1665,0,0,78,78,0,1,0,1,0
1425,3095,0,0,144,144,0,1,0,1,0
1974,3095,0,0,152,152,0,1,0,1,0
1779,183,6780,121,293,223,70,4,0,3,1
2903,1560,0,0,84,84,0,1,0,1,0
147,1942,0,0,148,148,0,1,0,1,0
16539,1771,0,0,145,145,0,1,0,1,0
6320,476,0,0,148,148,0,1,0,1,0
1038,3095,0,0,139,139,0,1,0,1,0
2761,183,10148,121,293,223,70,4,0,3,1
2328,1387,0,0,109,109,0,1,0,1,0
1797,864,0,0,145,145,0,1,0,1,0
1454,183,5099,121,293,223,70,4,0,3,1
951,1041,0,0,155,155,0,1,0,1,0
11295,1682,0,0,68,68,0,1,0,1,0
2259,157,0,0,87,87,0,1,0,1,0
334,2434,0,0,144,144,0,1,0,1,0
1380,183,4724,121,293,223,70,4,1,3,1
13213,820,0,0,112,112,0,1,0,1,0
1016,3095,0,0,139,139,0,1,0,1,0
19555,183,27193,121,293,223,70,4,0,3,1
10858,1661,0,0,79,79,0,1,0,1,0
848,3095,0,0,139,139,0,1,0,1,0
7774,2082,0,0,111,111,0,1,0,1,0
11336,1651,0,0,62,62,0,1,0,1,0
1937,183,7462,121,293,223,70,4,0,3,1
2691,1358,0,0,117,117,0,1,0,1,0
1568,183,6060,121,293,223,70,4,0,3,1
1275,183,4983,121,293,223,70,4,0,3,1
4817,336,0,0,146,146,0,1,0,1,0
1028,183,4098,121,293,223,70,4,0,3,1
2574,183,9075,121,293,223,70,4,1,3,1
1776,1176,0,0,141,141,0,1,0,1,0
2595,1063,0,0,119,119,0,1,0,1,0
1901,875,0,0,70,70,0,1,0,1,0
10963,1619,0,0,66,66,0,1,0,1,0
9668,1880,0,0,69,69,0,1,0,1,0
2670,1375,0,0,114,114,0,1,0,1,0
3610,740,0,0,146,146,0,1,0,1,0
1566,2755,0,0,123,123,0,1,0,1,0
8327,1689,0,0,146,146,0,1,0,1,0
1935,3095,0,0,154,154,0,1,0,1,0
7446,2802,0,0,75,75,0,1,0,1,0
934,183,3656,121,293,223,70,4,1,3,1
59,1023,0,0,155,155,0,1,0,1,0
1183,872,0,0,152,152,0,1,0,1,0
4447,183,15725,121,293,223,70,4,1,3,1
2903,1568,0,0,82,82,0,1,0,1,0
2993,1489,0,0,96,96,0,1,0,1,0
2211,612,0,0,104,104,0,1,0,1,0
10122,1543,0,0,80,80,0,1,0,1,0
11187,1620,0,0,62,62,0,1,0,1,0
732,2291,0,0,146,146,0,1,0,1,0
21644,1570,0,0,63,63,0,1,0,1,0
10637,1553,0,0,67,67,0,1,0,1,0
8332,1191,0,0,153,153,0,1,0,1,0
8469,1683,0,0,140,140,0,1,0,1,0
307,1600,0,0,143,143,0,1,0,1,0
9787,1585,0,0,92,92,0,1,0,1,0
10622,1543,0,0,66,66,0,1,0,1,0
261,1931,0,0,144,144,0,1,0,1,0
1139,786,0,0,146,146,0,1,0,1,0
848,549,2259,76,242,198,44,2,0,2,0
2664,1379,0,0,114,114,0,1,0,1,0
3414,183,12314,121,293,223,70,4,0,3,1
1522,1117,0,0,125,125,0,1,0,1,0
1237,1176,0,0,139,139,0,1,0,1,0
19487,2610,0,0,119,119,0,1,0,1,0
4783,183,16274,121,293,223,70,4,1,3,1
8327,1627,0,0,146,146,0,1,0,1,0
2619,1694,0,0,62,62,0,1,0,1,0
14153,299,0,0,142,142,0,1,0,1,0
1899,1176,0,0,142,142,0,1,0,1,0
865,3095,0,0,141,141,0,1,0,1,0
11020,1586,0,0,62,62,0,1,0,1,0
731,2338,0,0,146,146,0,1,0,1,0
18193,3036,0,0,141,141,0,1,0,1,0
1532,878,0,0,143,143,0,1,0,1,0
2778,774,0,0,118,118,0,1,0,1,0
1448,3095,0,0,148,148,0,1,0,1,0
2696,183,10423,121,293,223,70,4,0,3,1
10371,1544,0,0,71,71,0,1,0,1,0
1296,1176,0,0,139,139,0,1,0,1,0
1167,1176,0,0,146,146,0,1,0,1,0
9526,1543,0,0,102,102,0,1,0,1,0
2225,183,9081,121,293,223,70,4,0,3,1
11236,1654,0,0,64,64,0,1,0,1,0
2264,183,8497,121,293,223,70,4,0,3,1
3056,1679,0,0,62,62,0,1,0,1,0
1906,872,0,0,69,69,0,1,0,1,0
2622,1073,0,0,121,121,0,1,0,1,0
2164,1176,0,0,144,144,0,1,0,1,0
8108,2641,0,0,64,64,0,1,0,1,0
1135,292,2444,82,246,199,47,3,0,2,0
9057,1543,0,0,121,121,0,1,0,1,0
1530,885,0,0,143,143,0,1,0,1,0
1892,183,7283,121,293,223,70,4,0,3,1
797,3095,0,0,140,140,0,1,0,1,0
2902,1694,0,0,62,62,0,1,0,1,0
1818,3095,0,0,148,148,0,1,0,1,0
10092,1440,0,0,88,88,0,1,0,1,0
1778,819,0,0,145,145,0,1,0,1,0
1335,183,4503,121,293,223,70,4,1,3,1
8062,1921,0,0,124,124,0,1,0,1,0
208,2355,0,0,144,144,0,1,0,1,0
8327,1548,0,0,146,146,0,1,0,1,0
3535,252,0,0,114,114,0,1,0,1,0
1975,813,0,0,62,62,0,1,0,1,0
4951,183,16483,121,293,223,70,4,1,3,1
2199,1576,0,0,80,80,0,1,0,1,0
1951,183,7672,121,293,223,70,4,0,3,1
1826,1176,0,0,142,142,0,1,0,1,0
11111,1431,0,0,69,69,0,1,0,1,0
1538,183,5514,121,293,223,70,4,0,3,1
8742,1668,0,0,131,131,0,1,0,1,0
1443,681,0,0,150,150,0,1,0,1,0
15029,2435,0,0,113,113,0,1,0,1,0
8273,1361,0,0,153,153,0,1,0,1,0
2513,1,0,0,62,62,0,1,0,1,0
6518,548,0,0,149,149,0,1,0,1,0
1225,183,4956,121,293,223,70,4,0,3,1
1936,1129,0,0,131,131,0,1,0,1,0
1076,1132,0,0,143,143,0,1,0,1,0
974,183,3797,121,293,223,70,4,1,3,1
2524,1694,0,0,62,62,0,1,0,1,0
103,1624,0,0,151,151,0,1,0,1,0
1712,1176,0,0,145,145,0,1,0,1,0
1438,183,5012,121,293,223,70,4,1,3,1
3759,857,0,0,116,116,0,1,0,1,0
1267,183,4300,121,293,223,70,4,1,3,1
3288,183,11409,121,293,223,70,4,0,3,1
9648,1604,0,0,111,111,0,1,0,1,0
1597,473,701,19,171,159,11,1,0,1,0
10151,1558,0,0,79,79,0,1,0,1,0
10750,1534,0,0,64,64,0,1,0,1,0
8521,1224,0,0,145,145,0,1,0,1,0
2036,1049,0,0,62,62,0,1,0,1,0
1717,183,6374,121,293,223,70,4,0,3,1
1850,730,0,0,92,92,0,1,0,1,0
13282,584,0,0,126,126,0,1,0,1,0
8720,1670,0,0,132,132,0,1,0,1,0
3132,1039,0,0,147,147,0,1,0,1,0
321,1496,0,0,143,143,0,1,0,1,0
1750,972,0,0,92,92,0,1,0,1,0
115,1705,0,0,150,150,0,1,0,1,0
10922,1694,0,0,78,78,0,1,0,1,0
395,1121,197,6,151,147,3,1,0,1,0
1955,837,0,0,62,62,0,1,0,1,0
1956,857,0,0,66,66,0,1,0,1,0
1690,183,6242,121,293,223,70,4,0,3,1
1612,3095,0,0,147,147,0,1,0,1,0
8571,1675,0,0,137,137,0,1,0,1,0
2532,1361,0,0,62,62,0,1,0,1,0
2113,183,8522,121,293,223,70,4,0,3,1
2227,183,9091,121,293,223,70,4,0,3,1
4123,431,0,0,144,144,0,1,0,1,0
10283,1529,0,0,75,75,0,1,0,1,0
1354,3095,0,0,142,142,0,1,0,1,0
8320,1651,0,0,146,146,0,1,0,1,0
547,1176,0,0,149,149,0,1,0,1,0
2187,183,8860,121,293,223,70,4,0,3,1
394,2631,0,0,142,142,0,1,0,1,0
2977,1694,0,0,62,62,0,1,0,1,0
10480,1543,0,0,69,69,0,1,0,1,0
1810,183,6876,121,293,223,70,4,0,3,1
1945,1002,0,0,101,101,0,1,0,1,0
6506,544,0,0,149,149,0,1,0,1,0
2263,154,0,0,86,86,0,1,0,1,0
1449,183,5072,121,293,223,70,4,0,3,1
1279,183,4325,121,293,223,70,4,1,3,1
2249,2891,0,0,144,144,0,1,0,1,0
13016,183,22283,121,293,223,70,4,0,3,1
812,828,1253,42,204,180,24,2,0,1,0
12371,883,0,0,109,109,0,1,0,1,0
1746,183,6717,121,293,223,70,4,0,3,1
1356,3095,0,0,142,142,0,1,0,1,0
2139,3095,0,0,156,156,0,1,0,1,0
1799,1176,0,0,141,141,0,1,0,1,0
11929,1028,0,0,101,101,0,1,0,1,0
1160,183,4303,121,293,223,70,4,1,3,1
1045,183,3871,121,293,223,70,4,1,3,1
1956,183,6880,121,293,223,70,4,1,3,1
9055,1649,0,0,121,121,0,1,0,1,0
2579,183,9591,121,293,223,70,4,0,3,1
1937,819,0,0,67,67,0,1,0,1,0
1917,799,0,0,73,73,0,1,0,1,0
9514,1543,0,0,102,102,0,1,0,1,0
237,2104,0,0,144,144,0,1,0,1,0
14389,263,0,0,144,144,0,1,0,1,0
626,1143,0,0,157,157,0,1,0,1,0
4165,401,0,0,146,146,0,1,0,1,0
8327,1592,0,0,146,146,0,1,0,1,0
9702,1543,0,0,99,99,0,1,0,1,0
1929,1176,0,0,143,143,0,1,0,1,0
2164,183,8727,121,293,223,70,4,0,3,1
1337,3093,0,0,143,143,0,1,0,1,0
1666,1026,0,0,104,104,0,1,0,1,0
1064,3095,0,0,141,141,0,1,0,1,0
10065,1543,0,0,82,82,0,1,0,1,0
5026,183,16576,121,293,223,70,4,1,3,1
4646,183,15340,121,293,223,70,4,1,3,1
1751,183,6633,121,293,223,70,4,0,3,1
8458,1543,0,0,141,141,0,1,0,1,0
2120,241,0,0,101,101,0,1,0,1,0
3562,183,12704,121,293,223,70,4,0,3,1
3187,183,10661,121,293,223,70,4,1,3,1
2618,1176,0,0,146,146,0,1,0,1,0
2038,183,8033,121,293,223,70,4,0,3,1
16567,2729,0,0,127,127,0,1,0,1,0
4023,531,0,0,137,137,0,1,0,1,0
84,1011,0,0,156,156,0,1,0,1,0
1031,183,3844,121,293,223,70,4,1,3,1
1940,821,0,0,67,67,0,1,0,1,0
4483,183,15855,121,293,223,70,4,1,3,1
1761,2464,0,0,106,106,0,1,0,1,0
8655,1543,0,0,134,134,0,1,0,1,0
892,198,3522,119,290,221,68,3,0,2,0
1935,817,0,0,68,68,0,1,0,1,0
2207,183,8977,121,293,223,70,4,0,3,1
1561,792,0,0,144,144,0,1,0,1,0
4997,318,0,0,146,146,0,1,0,1,0
8242,1176,0,0,156,156,0,1,0,1,0
755,1568,0,0,153,153,0,1,0,1,0
571,789,1393,47,201,174,27,2,0,1,0
18182,3037,0,0,142,142,0,1,0,1,0
3607,183,13270,121,293,223,70,4,0,3,1
8320,1540,0,0,146,146,0,1,0,1,0
1421,697,0,0,150,150,0,1,0,1,0
7537,2710,0,0,82,82,0,1,0,1,0
1467,183,5688,121,293,223,70,4,0,3,1
1967,183,7623,121,293,223,70,4,0,3,1
6424,608,0,0,146,146,0,1,0,1,0
943,3095,0,0,142,142,0,1,0,1,0
1600,3095,0,0,143,143,0,1,0,1,0
2190,183,8878,121,293,223,70,4,0,3,1
4095,782,0,0,147,147,0,1,0,1,0
2708,183,9122,121,293,223,70,4,1,3,1
2768,1974,0,0,81,81,0,1,0,1,0
2532,1694,0,0,62,62,0,1,0,1,0
1920,183,7370,121,293,223,70,4,0,3,1
253,1057,0,0,157,157,0,1,0,1,0
2307,312,0,0,62,62,0,1,0,1,0
2084,1403,0,0,107,107,0,1,0,1,0
17701,2937,0,0,136,136,0,1,0,1,0
13170,621,0,0,123,123,0,1,0,1,0
2210,183,8993,121,293,223,70,4,0,3,1
2178,206,0,0,95,95,0,1,0,1,0
2914,1694,0,0,62,62,0,1,0,1,0
17216,2232,0,0,145,145,0,1,0,1,0
7999,1647,0,0,133,133,0,1,0,1,0
2093,183,8414,121,293,223,70,4,0,3,1
2002,183,7833,121,293,223,70,4,0,3,1
7299,1037,0,0,146,146,0,1,0,1,0
4578,183,16019,121,293,223,70,4,1,3,1
1656,183,6075,121,293,223,70,4,0,3,1
1406,2994,0,0,137,137,0,1,0,1,0
188,1087,0,0,150,150,0,1,0,1,0
1045,3095,0,0,141,141,0,1,0,1,0
603,1176,0,0,151,151,0,1,0,1,0
8327,1667,0,0,146,146,0,1,0,1,0
2371,1410,0,0,106,106,0,1,0,1,0
1381,726,0,0,150,150,0,1,0,1,0
1910,869,0,0,68,68,0,1,0,1,0
2863,1157,0,0,143,143,0,1,0,1,0
1838,916,0,0,79,79,0,1,0,1,0
1427,183,4962,121,293,223,70,4,0,3,1
361,1173,0,0,143,143,0,1,0,1,0
1650,183,6077,121,293,223,70,4,0,3,1
1807,3095,0,0,151,151,0,1,0,1,0
9029,1543,0,0,122,122,0,1,0,1,0
4030,183,13363,121,293,223,70,4,1,3,1
1718,2620,0,0,112,112,0,1,0,1,0
4517,183,15112,121,293,223,70,4,0,3,1
1575,183,6086,121,293,223,70,4,0,3,1
2072,183,8196,121,293,223,70,4,0,3,1
1599,183,5798,121,293,223,70,4,0,3,1
21564,1608,0,0,65,65,0,1,0,1,0
1762,1176,0,0,141,141,0,1,0,1,0
2899,1674,0,0,65,65,0,1,0,1,0
2085,1981,0,0,78,78,0,1,0,1,0
227,2175,0,0,144,144,0,1,0,1,0
21671,1537,0,0,62,62,0,1,0,1,0
1560,183,5670,121,293,223,70,4,0,3,1
1947,183,7513,121,293,223,70,4,0,3,1
1025,3095,0,0,141,141,0,1,0,1,0
8324,1531,0,0,146,146,0,1,0,1,0
116,1051,0,0,153,153,0,1,0,1,0
21520,1630,0,0,66,66,0,1,0,1,0
9017,1286,0,0,128,128,0,1,0,1,0
2271,1986,0,0,82,82,0,1,0,1,0
1617,630,0,0,146,146,0,1,0,1,0
1775,3095,0,0,150,150,0,1,0,1,0
1726,604,0,0,127,127,0,1,0,1,0
4714,183,16085,121,293,223,70,4,0,3,1
1737,476,0,0,139,139,0,1,0,1,0
1722,601,0,0,128,128,0,1,0,1,0
1017,3095,0,0,140,140,0,1,0,1,0
4205,183,14938,121,293,223,70,4,0,3,1
12284,1683,0,0,62,62,0,1,0,1,0
1039,249,2895,97,265,208,56,3,0,2,0
1798,183,6909,121,293,223,70,4,0,3,1
1205,324,2110,71,233,192,41,2,0,2,0
291,1712,0,0,143,143,0,1,0,1,0
2950,1313,0,0,125,125,0,1,0,1,0
1018,847,0,0,145,145,0,1,0,1,0
2036,183,7994,121,293,223,70,4,0,3,1
1655,3095,0,0,148,148,0,1,0,1,0
1385,3095,0,0,140,140,0,1,0,1,0
11102,183,18186,121,293,223,70,4,0,3,1
1615,183,6236,121,293,223,70,4,0,3,1
7302,3012,0,0,64,64,0,1,0,1,0
3328,1250,0,0,90,90,0,1,0,1,0
1773,652,0,0,113,113,0,1,0,1,0
9687,1606,0,0,110,110,0,1,0,1,0
8741,1543,0,0,130,130,0,1,0,1,0
2897,1191,0,0,145,145,0,1,0,1,0
20,1021,0,0,156,156,0,1,0,1,0
147,965,0,0,156,156,0,1,0,1,0
4728,345,0,0,146,146,0,1,0,1,0
1421,294,2969,81,246,198,47,3,0,2,0
1569,183,5646,121,293,223,70,4,0,3,1
1012,183,3808,121,293,223,70,4,1,3,1
3294,193,0,0,102,102,0,1,0,1,0
9644,1543,0,0,98,98,0,1,0,1,0
1352,3095,0,0,142,142,0,1,0,1,0
121,1026,0,0,157,157,0,1,0,1,0
924,1176,0,0,140,140,0,1,0,1,0
263,2388,0,0,144,144,0,1,0,1,0
8516,1694,0,0,141,141,0,1,0,1,0
10902,1646,0,0,76,76,0,1,0,1,0
2139,1005,0,0,62,62,0,1,0,1,0
8210,1709,0,0,136,136,0,1,0,1,0
2125,238,0,0,100,100,0,1,0,1,0
10282,1467,0,0,81,81,0,1,0,1,0
7975,2146,0,0,117,117,0,1,0,1,0
1401,183,4959,121,293,223,70,4,1,3,1
1716,489,0,0,141,141,0,1,0,1,0
2908,1694,0,0,62,62,0,1,0,1,0
4839,183,16344,121,293,223,70,4,1,3,1
852,3095,0,0,139,139,0,1,0,1,0
1063,3095,0,0,141,141,0,1,0,1,0
4594,358,0,0,146,146,0,1,0,1,0
1173,1144,0,0,142,142,0,1,0,1,0
8131,1945,0,0,130,130,0,1,0,1,0
438,2696,0,0,142,142,0,1,0,1,0
840,1176,0,0,155,155,0,1,0,1,0
2097,255,0,0,103,103,0,1,0,1,0
945,1176,0,0,154,154,0,1,0,1,0
1159,3095,0,0,141,141,0,1,0,1,0
2193,183,8892,121,293,223,70,4,0,3,1
1931,812,0,0,69,69,0,1,0,1,0
1338,3095,0,0,139,139,0,1,0,1,0
3003,1694,0,0,62,62,0,1,0,1,0
7715,2481,0,0,97,97,0,1,0,1,0
420,1095,0,0,157,157,0,1,0,1,0
1195,183,4398,121,293,223,70,4,1,3,1
1897,669,0,0,105,105,0,1,0,1,0
457,1822,0,0,150,150,0,1,0,1,0
2248,1649,0,0,69,69,0,1,0,1,0
73,1015,0,0,157,157,0,1,0,1,0
2224,437,0,0,62,62,0,1,0,1,0
7204,2925,0,0,65,65,0,1,0,1,0
1368,3095,0,0,141,141,0,1,0,1,0
1414,183,4896,121,293,223,70,4,0,3,1
1466,183,5687,121,293,223,70,4,0,3,1
1450,183,5094,121,293,223,70,4,1,3,1
11171,1617,0,0,62,62,0,1,0,1,0
1355,183,4613,121,293,223,70,4,0,3,1
826,3095,0,0,139,139,0,1,0,1,0
8496,1219,0,0,146,146,0,1,0,1,0
57,1022,0,0,155,155,0,1,0,1,0
2898,1693,0,0,62,62,0,1,0,1,0
765,1180,0,0,156,156,0,1,0,1,0
11950,1481,0,0,74,74,0,1,0,1,0
1918,1142,0,0,143,143,0,1,0,1,0
6892,2372,0,0,82,82,0,1,0,1,0
684,1156,0,0,157,157,0,1,0,1,0
401,1937,0,0,149,149,0,1,0,1,0
20492,1331,0,0,75,75,0,1,0,1,0
8299,1526,0,0,149,149,0,1,0,1,0
2904,1528,0,0,89,89,0,1,0,1,0
16530,1619,0,0,62,62,0,1,0,1,0
298,1663,0,0,143,143,0,1,0,1,0
72,1397,0,0,153,153,0,1,0,1,0
2830,1694,0,0,62,62,0,1,0,1,0
836,3095,0,0,139,139,0,1,0,1,0
958,1176,0,0,151,151,0,1,0,1,0
10239,1577,0,0,81,81,0,1,0,1,0
10647,1579,0,0,69,69,0,1,0,1,0
1437,591,0,0,149,149,0,1,0,1,0
1743,1367,0,0,110,110,0,1,0,1,0
1527,402,1601,44,200,175,25,2,0,1,0
1968,183,8058,121,293,223,70,4,0,3,1
788,1161,0,0,156,156,0,1,0,1,0
1358,183,5287,121,293,223,70,4,0,3,1
1793,183,6787,121,293,223,70,4,0,3,1
2667,1694,0,0,62,62,0,1,0,1,0
1509,183,5352,121,293,223,70,4,0,3,1
5773,277,0,0,146,146,0,1,0,1,0
1956,863,0,0,67,67,0,1,0,1,0
1792,183,6741,121,293,223,70,4,0,3,1
2926,1694,0,0,62,62,0,1,0,1,0
2966,1694,0,0,62,62,0,1,0,1,0
9822,1543,0,0,91,91,0,1,0,1,0
2007,183,7836,121,293,223,70,4,0,3,1
1312,183,4392,121,293,223,70,4,0,3,1
3166,183,11960,121,293,223,70,4,0,3,1
1386,3095,0,0,140,140,0,1,0,1,0
3143,183,11579,121,293,223,70,4,0,3,1
335,1394,0,0,143,143,0,1,0,1,0
2570,1473,0,0,96,96,0,1,0,1,0
11781,1076,0,0,98,98,0,1,0,1,0
11273,1638,0,0,62,62,0,1,0,1,0
285,2470,0,0,144,144,0,1,0,1,0
2781,781,0,0,119,119,0,1,0,1,0
8725,1694,0,0,135,135,0,1,0,1,0
1480,183,5230,121,293,223,70,4,0,3,1
4167,183,14015,121,293,223,70,4,0,3,1
2231,1770,0,0,66,66,0,1,0,1,0
3673,893,0,0,114,114,0,1,0,1,0
10648,1543,0,0,65,65,0,1,0,1,0
1841,3095,0,0,153,153,0,1,0,1,0
1912,3095,0,0,150,150,0,1,0,1,0
18240,2930,0,0,145,145,0,1,0,1,0
707,3092,0,0,139,139,0,1,0,1,0
2904,1519,0,0,91,91,0,1,0,1,0
930,199,3410,115,286,219,66,3,0,2,0
8327,1640,0,0,146,146,0,1,0,1,0
1595,183,5776,121,293,223,70,4,0,3,1
1581,3095,0,0,147,147,0,1,0,1,0
10743,1591,0,0,68,68,0,1,0,1,0
8122,1409,0,0,145,145,0,1,0,1,0
3954,355,0,0,136,136,0,1,0,1,0
1551,183,5564,121,293,223,70,4,0,3,1
1536,411,1484,40,197,173,23,2,0,1,0
1140,3095,0,0,141,141,0,1,0,1,0
4532,636,0,0,146,146,0,1,0,1,0
2910,1356,0,0,118,118,0,1,0,1,0
8781,1564,0,0,134,134,0,1,0,1,0
3638,183,10659,121,293,223,70,4,0,3,1
7487,2773,0,0,79,79,0,1,0,1,0
15064,765,0,0,145,145,0,1,0,1,0
2082,183,8249,121,293,223,70,4,0,3,1
10367,1543,0,0,71,71,0,1,0,1,0
2336,268,0,0,62,62,0,1,0,1,0
9268,1322,0,0,119,119,0,1,0,1,0
14088,320,0,0,140,140,0,1,0,1,0
4787,551,0,0,146,146,0,1,0,1,0
2135,183,8559,121,293,223,70,4,0,3,1
340,1042,0,0,152,152,0,1,0,1,0
1952,909,0,0,78,78,0,1,0,1,0
8300,1528,0,0,149,149,0,1,0,1,0
2266,1676,0,0,64,64,0,1,0,1,0
13845,2157,0,0,94,94,0,1,0,1,0
2367,296,0,0,82,82,0,1,0,1,0
2473,1245,0,0,62,62,0,1,0,1,0
10814,1540,0,0,62,62,0,1,0,1,0
1722,485,0,0,140,140,0,1,0,1,0
4647,353,0,0,146,146,0,1,0,1,0
8283,1427,0,0,151,151,0,1,0,1,0
1725,183,7046,121,293,223,70,4,0,3,1
4724,183,16201,121,293,223,70,4,1,3,1
9644,1604,0,0,111,111,0,1,0,1,0
5572,261,0,0,146,146,0,1,0,1,0
2164,1624,0,0,72,72,0,1,0,1,0
679,811,0,0,153,153,0,1,0,1,0
4196,183,14944,121,293,223,70,4,0,3,1
11230,1653,0,0,64,64,0,1,0,1,0
16651,1618,0,0,62,62,0,1,0,1,0
8327,1630,0,0,146,146,0,1,0,1,0
10719,1543,0,0,63,63,0,1,0,1,0
1182,3095,0,0,139,139,0,1,0,1,0
4262,726,0,0,147,147,0,1,0,1,0
38,1013,0,0,156,156,0,1,0,1,0
1515,183,5395,121,293,223,70,4,0,3,1
849,541,2285,77,243,199,44,2,0,2,0
8318,1504,0,0,147,147,0,1,0,1,0
5452,273,0,0,146,146,0,1,0,1,0
1364,183,4857,121,293,223,70,4,1,3,1
10271,1575,0,0,80,80,0,1,0,1,0
2171,3095,0,0,157,157,0,1,0,1,0
9321,1330,0,0,117,117,0,1,0,1,0
2269,2055,0,0,87,87,0,1,0,1,0
1654,183,6096,121,293,223,70,4,0,3,1
2116,3095,0,0,155,155,0,1,0,1,0
17947,886,0,0,104,104,0,1,0,1,0
8307,1456,0,0,148,148,0,1,0,1,0
1777,818,0,0,145,145,0,1,0,1,0
4719,183,16194,121,293,223,70,4,1,3,1
2214,1327,0,0,119,119,0,1,0,1,0
2968,1658,0,0,67,67,0,1,0,1,0
13834,495,0,0,130,130,0,1,0,1,0
2903,1547,0,0,86,86,0,1,0,1,0
14699,517,0,0,145,145,0,1,0,1,0
18041,3010,0,0,141,141,0,1,0,1,0
1687,1333,0,0,115,115,0,1,0,1,0
4848,333,0,0,146,146,0,1,0,1,0
8377,1199,0,0,151,151,0,1,0,1,0
1837,916,0,0,79,79,0,1,0,1,0
3032,1649,0,0,69,69,0,1,0,1,0
2240,183,8419,121,293,223,70,4,0,3,1
10529,1503,0,0,72,72,0,1,0,1,0
1095,3095,0,0,139,139,0,1,0,1,0
2434,1694,0,0,62,62,0,1,0,1,0
1264,641,0,0,150,150,0,1,0,1,0
1317,183,4412,121,293,223,70,4,1,3,1
2208,1176,0,0,144,144,0,1,0,1,0
1743,183,6885,121,293,223,70,4,0,3,1
3468,1104,0,0,100,100,0,1,0,1,0
2224,178,0,0,90,90,0,1,0,1,0
2115,1449,0,0,100,100,0,1,0,1,0
3661,905,0,0,113,113,0,1,0,1,0
2057,1234,0,0,133,133,0,1,0,1,0
8884,1287,0,0,131,131,0,1,0,1,0
2915,1182,0,0,146,146,0,1,0,1,0
379,2464,0,0,144,144,0,1,0,1,0
1423,3095,0,0,139,139,0,1,0,1,0
1174,1176,0,0,139,139,0,1,0,1,0
1841,3095,0,0,153,153,0,1,0,1,0
477,1176,0,0,146,146,0,1,0,1,0
7746,2373,0,0,99,99,0,1,0,1,0
2999,1511,0,0,92,92,0,1,0,1,0
3004,1694,0,0,62,62,0,1,0,1,0
10162,1543,0,0,83,83,0,1,0,1,0
1471,1150,0,0,133,133,0,1,0,1,0
1258,183,4569,121,293,223,70,4,1,3,1
604,2612,0,0,144,144,0,1,0,1,0
1602,183,5885,121,293,223,70,4,0,3,1
2952,1694,0,0,62,62,0,1,0,1,0
612,1075,0,0,149,149,0,1,0,1,0
2214,183,9022,121,293,223,70,4,0,3,1
2973,1694,0,0,62,62,0,1,0,1,0
1813,1176,0,0,142,142,0,1,0,1,0
19544,2582,0,0,117,117,0,1,0,1,0
481,959,778,26,175,160,15,1,0,1,0
2954,1332,0,0,121,121,0,1,0,1,0
1684,1176,0,0,145,145,0,1,0,1,0
4604,183,16053,121,293,223,70,4,1,3,1
1157,1176,0,0,146,146,0,1,0,1,0
10971,1576,0,0,62,62,0,1,0,1,0
1884,183,7326,121,293,223,70,4,0,3,1
1708,183,6975,121,293,223,70,4,0,3,1
1945,826,0,0,65,65,0,1,0,1,0
6867,2329,0,0,83,83,0,1,0,1,0
8280,1409,0,0,152,152,0,1,0,1,0
1957,183,7609,121,293,223,70,4,0,3,1
4603,183,16051,121,293,223,70,4,1,3,1
4602,357,0,0,146,146,0,1,0,1,0
2452,1454,0,0,99,99,0,1,0,1,0
78,1441,0,0,153,153,0,1,0,1,0
2032,3095,0,0,153,153,0,1,0,1,0
1599,682,0,0,145,145,0,1,0,1,0
1848,183,7156,121,293,223,70,4,0,3,1
2435,1410,0,0,106,106,0,1,0,1,0
1666,1176,0,0,146,146,0,1,0,1,0
2883,1694,0,0,62,62,0,1,0,1,0
2008,183,7845,121,293,223,70,4,0,3,1
777,1168,0,0,156,156,0,1,0,1,0
1140,183,4537,121,293,223,70,4,0,3,1
36,1012,0,0,156,156,0,1,0,1,0
9611,1543,0,0,99,99,0,1,0,1,0
2318,1694,0,0,62,62,0,1,0,1,0
9979,1476,0,0,87,87,0,1,0,1,0
8327,1612,0,0,146,146,0,1,0,1,0
2584,1694,0,0,62,62,0,1,0,1,0
3991,183,13836,121,293,223,70,4,0,3,1
2490,2569,0,0,122,122,0,1,0,1,0
860,1176,0,0,154,154,0,1,0,1,0
1637,183,5985,121,293,223,70,4,0,3,1
151,1069,0,0,151,151,0,1,0,1,0
1049,969,0,0,154,154,0,1,0,1,0
1756,183,6753,121,293,223,70,4,0,3,1
7733,1251,0,0,146,146,0,1,0,1,0
3919,183,13989,121,293,223,70,4,0,3,1
11144,1611,0,0,62,62,0,1,0,1,0
1691,1335,0,0,115,115,0,1,0,1,0
1861,3095,0,0,154,154,0,1,0,1,0
11172,1617,0,0,62,62,0,1,0,1,0
1558,434,1204,33,187,168,19,1,0,1,0
459,1176,0,0,146,146,0,1,0,1,0
10652,1543,0,0,67,67,0,1,0,1,0
10628,1543,0,0,66,66,0,1,0,1,0
11420,1316,0,0,76,76,0,1,0,1,0
14239,273,0,0,143,143,0,1,0,1,0
2913,1238,0,0,137,137,0,1,0,1,0
7726,2175,0,0,106,106,0,1,0,1,0
3254,1326,0,0,85,85,0,1,0,1,0
9124,1543,0,0,119,119,0,1,0,1,0
624,2625,0,0,144,144,0,1,0,1,0
4841,183,16346,121,293,223,70,4,1,3,1
1862,1176,0,0,142,142,0,1,0,1,0
9128,1543,0,0,116,116,0,1,0,1,0
61,1318,0,0,154,154,0,1,0,1,0
8746,1452,0,0,145,145,0,1,0,1,0
17628,2922,0,0,134,134,0,1,0,1,0
1600,3095,0,0,150,150,0,1,0,1,0
2915,1188,0,0,145,145,0,1,0,1,0
1814,694,0,0,102,102,0,1,0,1,0
8220,183,18914,121,293,223,70,4,0,3,1
2133,1476,0,0,96,96,0,1,0,1,0
2099,1218,0,0,62,62,0,1,0,1,0
7326,2981,0,0,66,66,0,1,0,1,0
2237,183,9146,121,293,223,70,4,0,3,1
1402,3095,0,0,140,140,0,1,0,1,0
2324,117,0,0,80,80,0,1,0,1,0
1728,1358,0,0,111,111,0,1,0,1,0
6508,649,0,0,146,146,0,1,0,1,0
4729,570,0,0,146,146,0,1,0,1,0
885,1089,0,0,155,155,0,1,0,1,0
3781,633,0,0,146,146,0,1,0,1,0
2045,2078,0,0,83,83,0,1,0,1,0
1242,3031,0,0,143,143,0,1,0,1,0
1358,3095,0,0,142,142,0,1,0,1,0
2101,1585,0,0,78,78,0,1,0,1,0
7912,2227,0,0,112,112,0,1,0,1,0
2615,1694,0,0,62,62,0,1,0,1,0
63,1332,0,0,154,154,0,1,0,1,0
891,1176,0,0,141,141,0,1,0,1,0
3734,830,0,0,118,118,0,1,0,1,0
8327,1677,0,0,146,146,0,1,0,1,0
965,2849,0,0,143,143,0,1,0,1,0
2036,183,7996,121,293,223,70,4,0,3,1
4828,537,0,0,146,146,0,1,0,1,0
1264,3095,0,0,142,142,0,1,0,1,0
16589,1805,0,0,145,145,0,1,0,1,0
17517,2910,0,0,136,136,0,1,0,1,0
1340,3095,0,0,142,142,0,1,0,1,0
14277,258,0,0,144,144,0,1,0,1,0
11439,1670,0,0,68,68,0,1,0,1,0
10399,1543,0,0,71,71,0,1,0,1,0
2686,2149,0,0,93,93,0,1,0,1,0
2108,1439,0,0,101,101,0,1,0,1,0
2907,1433,0,0,105,105,0,1,0,1,0
1143,3095,0,0,144,144,0,1,0,1,0
1426,3095,0,0,139,139,0,1,0,1,0
8864,1543,0,0,126,126,0,1,0,1,0
667,1024,0,0,144,144,0,1,0,1,0
1705,1176,0,0,141,141,0,1,0,1,0
2138,183,8574,121,293,223,70,4,0,3,1
2372,214,0,0,62,62,0,1,0,1,0
2249,536,0,0,98,98,0,1,0,1,0
14236,274,0,0,143,143,0,1,0,1,0
2030,183,7962,121,293,223,70,4,0,3,1
1591,1176,0,0,140,140,0,1,0,1,0
8317,1637,0,0,147,147,0,1,0,1,0
345,2559,0,0,143,143,0,1,0,1,0
580,2907,0,0,140,140,0,1,0,1,0
849,537,2300,77,244,199,44,2,0,2,0
15781,507,0,0,128,128,0,1,0,1,0
10203,1619,0,0,71,71,0,1,0,1,0
8327,1581,0,0,146,146,0,1,0,1,0
11925,1495,0,0,73,73,0,1,0,1,0
2100,183,8353,121,293,223,70,4,0,3,1
1905,373,0,0,122,122,0,1,0,1,0
10567,1543,0,0,67,67,0,1,0,1,0
15593,1126,0,0,145,145,0,1,0,1,0
1238,3095,0,0,139,139,0,1,0,1,0
1700,183,5891,121,293,223,70,4,1,3,1
1604,480,614,16,168,158,9,1,0,1,0
1704,648,0,0,147,147,0,1,0,1,0
884,2762,0,0,141,141,0,1,0,1,0
2088,643,0,0,62,62,0,1,0,1,0
12649,1116,0,0,95,95,0,1,0,1,0
1027,3095,0,0,143,143,0,1,0,1,0
7644,2572,0,0,91,91,0,1,0,1,0
723,2664,0,0,142,142,0,1,0,1,0
10974,1576,0,0,62,62,0,1,0,1,0
903,186,3541,119,291,222,69,3,0,2,0
2781,1694,0,0,62,62,0,1,0,1,0
1095,3095,0,0,139,139,0,1,0,1,0
8684,1239,0,0,140,140,0,1,0,1,0
1748,183,6567,121,293,223,70,4,0,3,1
1197,183,4403,121,293,223,70,4,1,3,1
1582,731,0,0,145,145,0,1,0,1,0
1937,183,7509,121,293,223,70,4,0,3,1
3018,1694,0,0,62,62,0,1,0,1,0
9252,1543,0,0,114,114,0,1,0,1,0
7401,2803,0,0,74,74,0,1,0,1,0
8155,183,14562,121,293,223,70,4,0,3,1
1130,183,4036,121,293,223,70,4,1,3,1
2046,3095,0,0,155,155,0,1,0,1,0
17469,183,25669,121,293,223,70,4,0,3,1
21452,715,17326,73,202,160,42,2,0,2,0
4609,183,16058,121,293,223,70,4,1,3,1
1958,1189,0,0,140,140,0,1,0,1,0
1611,540,0,0,148,148,0,1,0,1,0
1857,3095,0,0,152,152,0,1,0,1,0
470,2744,0,0,141,141,0,1,0,1,0
2638,1694,0,0,62,62,0,1,0,1,0
12599,880,0,0,104,104,0,1,0,1,0
9281,1543,0,0,113,113,0,1,0,1,0
3723,183,12700,121,293,223,70,4,0,3,1
4822,183,16323,121,293,223,70,4,1,3,1
1823,423,0,0,130,130,0,1,0,1,0
16040,2628,0,0,123,123,0,1,0,1,0
8736,1261,0,0,137,137,0,1,0,1,0
5218,183,16461,121,293,223,70,4,0,3,1
1655,537,0,0,147,147,0,1,0,1,0
1743,739,0,0,146,146,0,1,0,1,0
2297,1371,0,0,112,112,0,1,0,1,0
1818,183,6866,121,293,223,70,4,0,3,1
1773,3095,0,0,147,147,0,1,0,1,0
508,2800,0,0,141,141,0,1,0,1,0
2514,183,9327,121,293,223,70,4,0,3,1
1286,3060,0,0,143,143,0,1,0,1,0
2087,885,0,0,73,73,0,1,0,1,0
1409,3095,0,0,139,139,0,1,0,1,0
5357,361,0,0,146,146,0,1,0,1,0
31,1009,0,0,156,156,0,1,0,1,0
20823,1965,0,0,84,84,0,1,0,1,0
1344,3095,0,0,142,142,0,1,0,1,0
16114,2616,0,0,116,116,0,1,0,1,0
859,1108,0,0,156,156,0,1,0,1,0
9504,1961,0,0,69,69,0,1,0,1,0
8518,1543,0,0,139,139,0,1,0,1,0
567,1176,0,0,142,142,0,1,0,1,0
1955,880,0,0,71,71,0,1,0,1,0
2571,167,0,0,74,74,0,1,0,1,0
8484,1543,0,0,140,140,0,1,0,1,0
7696,2232,0,0,103,103,0,1,0,1,0
9037,1543,0,0,121,121,0,1,0,1,0
444,2495,0,0,143,143,0,1,0,1,0
7909,2231,0,0,112,112,0,1,0,1,0
1401,3095,0,0,140,140,0,1,0,1,0
3712,295,0,0,123,123,0,1,0,1,0
1522,3095,0,0,146,146,0,1,0,1,0
1554,813,0,0,144,144,0,1,0,1,0
2807,859,0,0,124,124,0,1,0,1,0
4905,183,16426,121,293,223,70,4,1,3,1
12551,628,0,0,145,145,0,1,0,1,0
13172,1669,0,0,62,62,0,1,0,1,0
17816,183,25923,121,293,223,70,4,0,3,1
1085,183,3949,121,293,223,70,4,1,3,1
2947,1694,0,0,62,62,0,1,0,1,0
2042,3095,0,0,154,154,0,1,0,1,0
4737,183,16217,121,293,223,70,4,1,3,1
1391,183,4783,121,293,223,70,4,1,3,1
1326,3095,0,0,142,142,0,1,0,1,0
1528,183,5466,121,293,223,70,4,0,3,1
14299,250,0,0,145,145,0,1,0,1,0
10330,1558,0,0,71,71,0,1,0,1,0
123,1763,0,0,150,150,0,1,0,1,0
3886,673,0,0,128,128,0,1,0,1,0
2032,727,0,0,62,62,0,1,0,1,0
13667,458,0,0,133,133,0,1,0,1,0
1097,1176,0,0,148,148,0,1,0,1,0
1348,3095,0,0,142,142,0,1,0,1,0
8312,1603,0,0,147,147,0,1,0,1,0
1776,655,0,0,113,113,0,1,0,1,0
2010,1291,0,0,124,124,0,1,0,1,0
7814,2003,0,0,115,115,0,1,0,1,0
809,1176,0,0,155,155,0,1,0,1,0
3470,183,11949,121,293,223,70,4,0,3,1
589,2920,0,0,140,140,0,1,0,1,0
3010,1557,0,0,84,84,0,1,0,1,0
3115,1609,0,0,67,67,0,1,0,1,0
590,753,1522,51,206,177,29,2,0,1,0
7393,2895,0,0,71,71,0,1,0,1,0
1162,183,4308,121,293,223,70,4,1,3,1
3272,952,0,0,147,147,0,1,0,1,0
1164,3095,0,0,139,139,0,1,0,1,0
10579,1510,0,0,70,70,0,1,0,1,0
2225,1082,0,0,62,62,0,1,0,1,0
2034,970,0,0,128,128,0,1,0,1,0
8327,1564,0,0,146,146,0,1,0,1,0
1939,183,7939,121,293,223,70,4,0,3,1
8080,1896,0,0,126,126,0,1,0,1,0
3155,1563,0,0,70,70,0,1,0,1,0
8327,1632,0,0,146,146,0,1,0,1,0
1522,183,5444,121,293,223,70,4,0,3,1
1623,613,0,0,146,146,0,1,0,1,0
1467,183,5147,121,293,223,70,4,0,3,1
3652,713,0,0,146,146,0,1,0,1,0
5482,319,0,0,146,146,0,1,0,1,0
1986,183,7724,121,293,223,70,4,0,3,1
1912,793,0,0,74,74,0,1,0,1,0
2285,183,8437,121,293,223,70,4,0,3,1
2120,1928,0,0,75,75,0,1,0,1,0
2722,1694,0,0,62,62,0,1,0,1,0
10233,1543,0,0,81,81,0,1,0,1,0
1620,183,5922,121,293,223,70,4,0,3,1
1089,271,2661,89,255,203,52,3,0,2,0
1270,808,0,0,151,151,0,1,0,1,0
1451,675,0,0,150,150,0,1,0,1,0
523,1176,0,0,148,148,0,1,0,1,0
1424,3095,0,0,139,139,0,1,0,1,0
8663,1543,0,0,133,133,0,1,0,1,0
9227,1543,0,0,115,115,0,1,0,1,0
2814,1694,0,0,62,62,0,1,0,1,0
1934,816,0,0,68,68,0,1,0,1,0
20756,1377,0,0,72,72,0,1,0,1,0
618,1176,0,0,151,151,0,1,0,1,0
1053,183,3887,121,293,223,70,4,1,3,1
2825,1249,0,0,135,135,0,1,0,1,0
13399,584,0,0,123,123,0,1,0,1,0
8316,1627,0,0,147,147,0,1,0,1,0
1268,3095,0,0,142,142,0,1,0,1,0
3664,183,13437,121,293,223,70,4,0,3,1
11382,1660,0,0,62,62,0,1,0,1,0
10065,1436,0,0,89,89,0,1,0,1,0
1888,183,7240,121,293,223,70,4,0,3,1
11363,1655,0,0,68,68,0,1,0,1,0
3209,183,12089,121,293,223,70,4,0,3,1
7765,2099,0,0,110,110,0,1,0,1,0
11396,1674,0,0,63,63,0,1,0,1,0
10178,1631,0,0,71,71,0,1,0,1,0
4597,358,0,0,146,146,0,1,0,1,0
1322,3095,0,0,142,142,0,1,0,1,0
5617,256,0,0,146,146,0,1,0,1,0
463,1176,0,0,146,146,0,1,0,1,0
2490,1259,0,0,62,62,0,1,0,1,0
16908,2022,0,0,145,145,0,1,0,1,0
4759,183,16244,121,293,223,70,4,1,3,1
21630,1576,0,0,63,63,0,1,0,1,0
2435,1273,0,0,62,62,0,1,0,1,0
2048,183,8088,121,293,223,70,4,0,3,1
3550,183,12673,121,293,223,70,4,0,3,1
15804,183,22655,121,293,223,70,4,0,3,1
2059,183,8119,121,293,223,70,4,0,3,1
6396,634,0,0,146,146,0,1,0,1,0
2550,1463,0,0,98,98,0,1,0,1,0
1534,409,1515,41,198,173,24,2,0,1,0
1971,877,0,0,62,62,0,1,0,1,0
624,1176,0,0,152,152,0,1,0,1,0
1478,183,5208,121,293,223,70,4,0,3,1
20131,1543,0,0,62,62,0,1,0,1,0
1523,183,5442,121,293,223,70,4,0,3,1
6500,183,17418,121,293,223,70,4,0,3,1
2333,1176,0,0,145,145,0,1,0,1,0
8264,1307,0,0,154,154,0,1,0,1,0
2966,1380,0,0,114,114,0,1,0,1,0
2112,3095,0,0,156,156,0,1,0,1,0
11251,1694,0,0,69,69,0,1,0,1,0
2744,1610,0,0,74,74,0,1,0,1,0
7896,2158,0,0,111,111,0,1,0,1,0
4018,807,0,0,147,147,0,1,0,1,0
8301,1578,0,0,144,144,0,1,0,1,0
1357,183,4610,121,293,223,70,4,0,3,1
2627,1694,0,0,62,62,0,1,0,1,0
1384,183,4747,121,293,223,70,4,1,3,1
18564,183,26425,121,293,223,70,4,0,3,1
1783,831,0,0,145,145,0,1,0,1,0
15906,529,0,0,127,127,0,1,0,1,0
1980,183,7836,121,293,223,70,4,0,3,1
1936,1126,0,0,131,131,0,1,0,1,0
802,908,965,32,193,174,18,1,0,1,0
2688,1176,0,0,146,146,0,1,0,1,0
663,1151,0,0,157,157,0,1,0,1,0
1397,183,4947,121,293,223,70,4,1,3,1
11525,183,18613,121,293,223,70,4,0,3,1
835,2764,0,0,143,143,0,1,0,1,0
3005,1663,0,0,62,62,0,1,0,1,0
5139,304,0,0,146,146,0,1,0,1,0
11194,1400,0,0,71,71,0,1,0,1,0
1339,3095,0,0,142,142,0,1,0,1,0
9152,1632,0,0,115,115,0,1,0,1,0
1890,3095,0,0,150,150,0,1,0,1,0
2015,885,0,0,62,62,0,1,0,1,0
1931,183,7426,121,293,223,70,4,0,3,1
1516,924,0,0,142,142,0,1,0,1,0
9073,1319,0,0,123,123,0,1,0,1,0
11071,1445,0,0,68,68,0,1,0,1,0
1604,2698,0,0,120,120,0,1,0,1,0
1863,3095,0,0,152,152,0,1,0,1,0
8052,2047,0,0,124,124,0,1,0,1,0
1963,183,7601,121,293,223,70,4,0,3,1
448,2711,0,0,142,142,0,1,0,1,0
1340,3095,0,0,139,139,0,1,0,1,0
2904,1514,0,0,91,91,0,1,0,1,0
1566,183,5640,121,293,223,70,4,0,3,1
1554,183,5595,121,293,223,70,4,0,3,1
9603,1370,0,0,106,106,0,1,0,1,0
9902,1598,0,0,92,92,0,1,0,1,0
683,579,2149,72,233,191,42,2,0,2,0
188,2236,0,0,146,146,0,1,0,1,0
2136,1002,0,0,62,62,0,1,0,1,0
2147,1614,0,0,73,73,0,1,0,1,0
1939,1094,0,0,123,123,0,1,0,1,0
2235,1317,0,0,120,120,0,1,0,1,0
1755,2473,0,0,107,107,0,1,0,1,0
2161,183,8771,121,293,223,70,4,0,3,1
14930,2377,0,0,102,102,0,1,0,1,0
21337,334,25295,107,267,205,62,3,0,2,0
1815,183,6899,121,293,223,70,4,0,3,1
16531,1543,0,0,66,66,0,1,0,1,0
1872,1176,0,0,142,142,0,1,0,1,0
2071,879,0,0,72,72,0,1,0,1,0
2258,1664,0,0,66,66,0,1,0,1,0
1803,183,6838,121,293,223,70,4,0,3,1
2061,183,8160,121,293,223,70,4,0,3,1
10566,1694,0,0,87,87,0,1,0,1,0
808,1176,0,0,155,155,0,1,0,1,0
335,2544,0,0,143,143,0,1,0,1,0
1847,183,7091,121,293,223,70,4,0,3,1
449,1176,0,0,145,145,0,1,0,1,0
2040,1061,0,0,62,62,0,1,0,1,0
1203,3005,0,0,143,143,0,1,0,1,0
630,2981,0,0,139,139,0,1,0,1,0
2828,1176,0,0,147,147,0,1,0,1,0
2741,1317,0,0,124,124,0,1,0,1,0
942,3095,0,0,139,139,0,1,0,1,0
372,1997,0,0,148,148,0,1,0,1,0
1870,183,7123,121,293,223,70,4,0,3,1
1765,1380,0,0,108,108,0,1,0,1,0
5469,271,0,0,146,146,0,1,0,1,0
1684,1014,0,0,101,101,0,1,0,1,0
3735,183,13470,121,293,223,70,4,0,3,1
11670,1717,0,0,71,71,0,1,0,1,0
9333,1543,0,0,111,111,0,1,0,1,0
8260,1178,0,0,156,156,0,1,0,1,0
1127,912,0,0,153,153,0,1,0,1,0
10974,1576,0,0,62,62,0,1,0,1,0
2017,183,7890,121,293,223,70,4,0,3,1
4942,323,0,0,146,146,0,1,0,1,0
1683,3095,0,0,149,149,0,1,0,1,0
2945,1295,0,0,128,128,0,1,0,1,0
2960,1357,0,0,117,117,0,1,0,1,0
1664,541,0,0,144,144,0,1,0,1,0
2982,1444,0,0,103,103,0,1,0,1,0
1948,961,0,0,91,91,0,1,0,1,0
1510,944,0,0,142,142,0,1,0,1,0
8203,1719,0,0,136,136,0,1,0,1,0
1327,183,4466,121,293,223,70,4,1,3,1
2638,1694,0,0,62,62,0,1,0,1,0
2881,1204,0,0,143,143,0,1,0,1,0
1173,878,0,0,152,152,0,1,0,1,0
12811,572,0,0,145,145,0,1,0,1,0
2772,1694,0,0,62,62,0,1,0,1,0
1426,3095,0,0,139,139,0,1,0,1,0
835,765,0,0,152,152,0,1,0,1,0
15506,183,24235,121,293,223,70,4,0,3,1
10168,1581,0,0,83,83,0,1,0,1,0
1035,183,3852,121,293,223,70,4,1,3,1
9439,1626,0,0,108,108,0,1,0,1,0
17667,1602,0,0,62,62,0,1,0,1,0
512,1708,0,0,151,151,0,1,0,1,0
2926,1218,0,0,140,140,0,1,0,1,0
1899,183,7261,121,293,223,70,4,0,3,1
2068,1133,0,0,62,62,0,1,0,1,0
19658,183,26733,121,293,223,70,4,0,3,1
2904,1512,0,0,92,92,0,1,0,1,0
1424,183,5021,121,293,223,70,4,1,3,1
711,2940,0,0,140,140,0,1,0,1,0
2372,183,8857,121,293,223,70,4,0,3,1
2395,1391,0,0,109,109,0,1,0,1,0
11367,1657,0,0,62,62,0,1,0,1,0
8286,1445,0,0,151,151,0,1,0,1,0
1687,183,6231,121,293,223,70,4,0,3,1
2257,183,9261,121,293,223,70,4,0,3,1
10871,1555,0,0,62,62,0,1,0,1,0
7443,2807,0,0,75,75,0,1,0,1,0
2293,1369,0,0,112,112,0,1,0,1,0
502,2530,0,0,143,143,0,1,0,1,0
1421,183,4930,121,293,223,70,4,1,3,1
13294,580,0,0,126,126,0,1,0,1,0
9269,1543,0,0,114,114,0,1,0,1,0
1613,1176,0,0,146,146,0,1,0,1,0
2301,321,0,0,62,62,0,1,0,1,0
1706,1000,0,0,98,98,0,1,0,1,0
1653,531,0,0,147,147,0,1,0,1,0
1970,183,7670,121,293,223,70,4,0,3,1
26,1007,0,0,156,156,0,1,0,1,0
8327,1692,0,0,146,146,0,1,0,1,0
1107,2942,0,0,143,143,0,1,0,1,0
8272,1303,0,0,153,153,0,1,0,1,0
717,2780,0,0,141,141,0,1,0,1,0
2024,3095,0,0,153,153,0,1,0,1,0
10969,1575,0,0,62,62,0,1,0,1,0
7776,2077,0,0,111,111,0,1,0,1,0
10737,1547,0,0,64,64,0,1,0,1,0
10296,1574,0,0,71,71,0,1,0,1,0
13103,693,0,0,116,116,0,1,0,1,0
2087,183,7849,121,293,223,70,4,0,3,1
1492,996,0,0,141,141,0,1,0,1,0
14076,183,23074,121,293,223,70,4,0,3,1
2115,1260,0,0,62,62,0,1,0,1,0
2191,1463,0,0,62,62,0,1,0,1,0
912,1176,0,0,140,140,0,1,0,1,0
1694,626,0,0,147,147,0,1,0,1,0
12018,744,0,0,145,145,0,1,0,1,0
604,1176,0,0,151,151,0,1,0,1,0
1426,183,4954,121,293,223,70,4,1,3,1
1608,509,205,6,156,152,4,1,0,1,0
569,1070,0,0,149,149,0,1,0,1,0
922,1176,0,0,152,152,0,1,0,1,0
2017,997,0,0,62,62,0,1,0,1,0
8210,1843,0,0,136,136,0,1,0,1,0
2525,2494,0,0,117,117,0,1,0,1,0
10844,1550,0,0,62,62,0,1,0,1,0
2031,728,0,0,62,62,0,1,0,1,0
511,1176,0,0,148,148,0,1,0,1,0
2903,1555,0,0,85,85,0,1,0,1,0
1959,1122,0,0,139,139,0,1,0,1,0
1845,183,7141,121,293,223,70,4,0,3,1
16733,1543,0,0,62,62,0,1,0,1,0
8659,1669,0,0,133,133,0,1,0,1,0
2148,224,0,0,98,98,0,1,0,1,0
1642,556,0,0,147,147,0,1,0,1,0
11109,1604,0,0,62,62,0,1,0,1,0
3448,183,12069,121,293,223,70,4,0,3,1
9193,1311,0,0,121,121,0,1,0,1,0
9579,1543,0,0,103,103,0,1,0,1,0
625,689,1754,59,216,182,34,2,0,1,0
1694,572,0,0,136,136,0,1,0,1,0
2254,1348,0,0,116,116,0,1,0,1,0
1963,183,7598,121,293,223,70,4,0,3,1
1904,183,7289,121,293,223,70,4,0,3,1
2237,183,9159,121,293,223,70,4,0,3,1
2124,183,8519,121,293,223,70,4,0,3,1
1362,3095,0,0,142,142,0,1,0,1,0
2936,1609,0,0,62,62,0,1,0,1,0
3904,555,0,0,146,146,0,1,0,1,0
10832,1603,0,0,68,68,0,1,0,1,0
107,1651,0,0,151,151,0,1,0,1,0
2246,3046,0,0,155,155,0,1,0,1,0
616,1176,0,0,142,142,0,1,0,1,0
3509,183,12242,121,293,223,70,4,0,3,1
1787,948,0,0,86,86,0,1,0,1,0
646,2618,0,0,142,142,0,1,0,1,0
2441,1278,0,0,62,62,0,1,0,1,0
337,1380,0,0,143,143,0,1,0,1,0
2882,1694,0,0,62,62,0,1,0,1,0
7441,2967,0,0,62,62,0,1,0,1,0
2646,1395,0,0,111,111,0,1,0,1,0
2429,1407,0,0,106,106,0,1,0,1,0
2005,1527,0,0,86,86,0,1,0,1,0
976,3095,0,0,140,140,0,1,0,1,0
1741,183,6487,121,293,223,70,4,0,3,1
1875,1176,0,0,143,143,0,1,0,1,0
1593,1176,0,0,140,140,0,1,0,1,0
2330,1651,0,0,69,69,0,1,0,1,0
730,2354,0,0,145,145,0,1,0,1,0
1233,3095,0,0,139,139,0,1,0,1,0
1941,1066,0,0,116,116,0,1,0,1,0
4293,183,14208,121,293,223,70,4,1,3,1
1591,183,6484,121,293,223,70,4,0,3,1
2054,183,8094,121,293,223,70,4,0,3,1
8327,1592,0,0,146,146,0,1,0,1,0
8373,1194,0,0,152,152,0,1,0,1,0
8536,1226,0,0,145,145,0,1,0,1,0
1939,1091,0,0,122,122,0,1,0,1,0
13211,654,0,0,119,119,0,1,0,1,0
1277,3095,0,0,142,142,0,1,0,1,0
1877,183,7205,121,293,223,70,4,0,3,1
9207,1628,0,0,113,113,0,1,0,1,0
2934,1250,0,0,135,135,0,1,0,1,0
1838,958,0,0,144,144,0,1,0,1,0
4055,510,0,0,138,138,0,1,0,1,0
10651,1694,0,0,85,85,0,1,0,1,0
4044,523,0,0,138,138,0,1,0,1,0
10676,1551,0,0,66,66,0,1,0,1,0
9151,1333,0,0,120,120,0,1,0,1,0
4763,183,16249,121,293,223,70,4,1,3,1
1342,1176,0,0,141,141,0,1,0,1,0
2004,183,7843,121,293,223,70,4,0,3,1
2184,667,0,0,107,107,0,1,0,1,0
1176,1144,0,0,142,142,0,1,0,1,0
1366,3095,0,0,141,141,0,1,0,1,0
10709,1587,0,0,69,69,0,1,0,1,0
2073,3095,0,0,156,156,0,1,0,1,0
1603,183,5864,121,293,223,70,4,0,3,1
2939,183,10619,121,293,223,70,4,0,3,1
2414,1434,0,0,102,102,0,1,0,1,0
1560,575,0,0,147,147,0,1,0,1,0
8300,1426,0,0,149,149,0,1,0,1,0
7652,2562,0,0,92,92,0,1,0,1,0
8881,1652,0,0,125,125,0,1,0,1,0
1905,786,0,0,76,76,0,1,0,1,0
10813,1600,0,0,68,68,0,1,0,1,0
673,1083,0,0,148,148,0,1,0,1,0
2234,183,9133,121,293,223,70,4,0,3,1
2899,1690,0,0,62,62,0,1,0,1,0
581,1176,0,0,150,150,0,1,0,1,0
1538,413,1467,40,196,173,23,2,0,1,0
17315,2300,0,0,145,145,0,1,0,1,0
2236,183,9143,121,293,223,70,4,0,3,1
1401,3095,0,0,140,140,0,1,0,1,0
7781,2323,0,0,102,102,0,1,0,1,0
2268,2102,0,0,90,90,0,1,0,1,0
716,2780,0,0,141,141,0,1,0,1,0
1298,1176,0,0,142,142,0,1,0,1,0
1872,752,0,0,86,86,0,1,0,1,0
1933,1173,0,0,142,142,0,1,0,1,0
1246,825,0,0,152,152,0,1,0,1,0
1457,183,5106,121,293,223,70,4,1,3,1
1800,870,0,0,145,145,0,1,0,1,0
15790,2580,0,0,120,120,0,1,0,1,0
9499,1355,0,0,110,110,0,1,0,1,0
4288,183,14373,121,293,223,70,4,0,3,1
17140,1543,0,0,66,66,0,1,0,1,0
2263,379,0,0,62,62,0,1,0,1,0
8302,1540,0,0,149,149,0,1,0,1,0
20894,1931,0,0,82,82,0,1,0,1,0
2284,3010,0,0,153,153,0,1,0,1,0
1815,905,0,0,145,145,0,1,0,1,0
10482,1543,0,0,69,69,0,1,0,1,0
1922,183,7378,121,293,223,70,4,0,3,1
2995,1656,0,0,62,62,0,1,0,1,0
20870,1943,0,0,83,83,0,1,0,1,0
1531,880,0,0,143,143,0,1,0,1,0
2073,666,0,0,62,62,0,1,0,1,0
1719,3095,0,0,149,149,0,1,0,1,0
5823,295,0,0,146,146,0,1,0,1,0
16943,1543,0,0,66,66,0,1,0,1,0
1883,2282,0,0,96,96,0,1,0,1,0
19036,2827,0,0,130,130,0,1,0,1,0
2715,1527,0,0,62,62,0,1,0,1,0
983,2861,0,0,143,143,0,1,0,1,0
2057,183,7759,121,293,223,70,4,0,3,1
2385,2794,0,0,138,138,0,1,0,1,0
2902,1590,0,0,79,79,0,1,0,1,0
1325,768,0,0,151,151,0,1,0,1,0
1857,3095,0,0,152,152,0,1,0,1,0
421,1895,0,0,149,149,0,1,0,1,0
1161,2978,0,0,143,143,0,1,0,1,0
10620,1543,0,0,66,66,0,1,0,1,0
1473,3095,0,0,148,148,0,1,0,1,0
2250,1652,0,0,68,68,0,1,0,1,0
858,1109,0,0,156,156,0,1,0,1,0
9592,1617,0,0,103,103,0,1,0,1,0
2220,183,9057,121,293,223,70,4,0,3,1
146,1032,0,0,157,157,0,1,0,1,0
1941,1064,0,0,116,116,0,1,0,1,0
359,2025,0,0,148,148,0,1,0,1,0
2787,1593,0,0,62,62,0,1,0,1,0
10819,1601,0,0,68,68,0,1,0,1,0
9279,1543,0,0,111,111,0,1,0,1,0
1488,362,2110,58,217,184,33,2,0,1,0
1554,577,0,0,147,147,0,1,0,1,0
13174,620,0,0,124,124,0,1,0,1,0
1492,994,0,0,141,141,0,1,0,1,0
242,2067,0,0,144,144,0,1,0,1,0
2131,183,8607,121,293,223,70,4,0,3,1
17777,1601,0,0,62,62,0,1,0,1,0
9807,1603,0,0,95,95,0,1,0,1,0
4565,183,15195,121,293,223,70,4,0,3,1
2992,1694,0,0,62,62,0,1,0,1,0
924,183,3659,121,293,223,70,4,1,3,1
11968,1473,0,0,74,74,0,1,0,1,0
10114,1443,0,0,87,87,0,1,0,1,0
238,2278,0,0,145,145,0,1,0,1,0
2027,894,0,0,62,62,0,1,0,1,0
9096,1636,0,0,118,118,0,1,0,1,0
10174,1452,0,0,85,85,0,1,0,1,0
10262,1526,0,0,75,75,0,1,0,1,0
13679,576,0,0,126,126,0,1,0,1,0
1515,2956,0,0,131,131,0,1,0,1,0
14098,325,0,0,140,140,0,1,0,1,0
10425,1543,0,0,70,70,0,1,0,1,0
1944,1021,0,0,105,105,0,1,0,1,0
20854,1950,0,0,83,83,0,1,0,1,0
2829,1841,0,0,72,72,0,1,0,1,0
7571,2623,0,0,85,85,0,1,0,1,0
2902,1582,0,0,80,80,0,1,0,1,0
2926,1694,0,0,62,62,0,1,0,1,0
2355,979,0,0,97,97,0,1,0,1,0
2039,183,8011,121,293,223,70,4,0,3,1
4017,183,14484,121,293,223,70,4,0,3,1
2055,183,8094,121,293,223,70,4,0,3,1
10274,1466,0,0,81,81,0,1,0,1,0
250,2252,0,0,145,145,0,1,0,1,0
1937,1121,0,0,129,129,0,1,0,1,0
4949,183,16481,121,293,223,70,4,1,3,1
1899,1099,0,0,143,143,0,1,0,1,0
6338,602,0,0,146,146,0,1,0,1,0
671,1377,0,0,154,154,0,1,0,1,0
49,1233,0,0,154,154,0,1,0,1,0
11138,1609,0,0,65,65,0,1,0,1,0
1951,927,0,0,83,83,0,1,0,1,0
1531,183,5374,121,293,223,70,4,1,3,1
1342,755,0,0,151,151,0,1,0,1,0
3597,267,0,0,117,117,0,1,0,1,0
2654,1472,0,0,62,62,0,1,0,1,0
654,1411,0,0,154,154,0,1,0,1,0
2001,183,7802,121,293,223,70,4,0,3,1
9070,1294,0,0,126,126,0,1,0,1,0
12670,602,0,0,145,145,0,1,0,1,0
8530,1217,0,0,146,146,0,1,0,1,0
2861,1694,0,0,62,62,0,1,0,1,0
1238,3028,0,0,143,143,0,1,0,1,0
2003,183,7814,121,293,223,70,4,0,3,1
1394,183,4796,121,293,223,70,4,1,3,1
1404,3095,0,0,140,140,0,1,0,1,0
644,821,0,0,153,153,0,1,0,1,0
4525,183,15954,121,293,223,70,4,1,3,1
3873,723,0,0,125,125,0,1,0,1,0
8327,1548,0,0,146,146,0,1,0,1,0
10491,1543,0,0,72,72,0,1,0,1,0
7933,1775,0,0,126,126,0,1,0,1,0
9765,1393,0,0,100,100,0,1,0,1,0
7316,2967,0,0,66,66,0,1,0,1,0
12457,1216,0,0,89,89,0,1,0,1,0
8997,1644,0,0,121,121,0,1,0,1,0
1607,483,579,15,167,157,9,1,0,1,0
2085,884,0,0,73,73,0,1,0,1,0
1954,890,0,0,74,74,0,1,0,1,0
189,1042,0,0,157,157,0,1,0,1,0
959,183,3756,121,293,223,70,4,1,3,1
330,2086,0,0,147,147,0,1,0,1,0
1470,1200,0,0,135,135,0,1,0,1,0
896,3095,0,0,139,139,0,1,0,1,0
3001,1522,0,0,90,90,0,1,0,1,0
2828,1246,0,0,136,136,0,1,0,1,0
8227,1685,0,0,138,138,0,1,0,1,0
1604,183,6342,121,293,223,70,4,0,3,1
5660,252,0,0,146,146,0,1,0,1,0
1387,1176,0,0,149,149,0,1,0,1,0
4723,183,16200,121,293,223,70,4,1,3,1
2900,1649,0,0,69,69,0,1,0,1,0
8717,1694,0,0,135,135,0,1,0,1,0
1399,3095,0,0,140,140,0,1,0,1,0
7290,3025,0,0,63,63,0,1,0,1,0
333,1408,0,0,143,143,0,1,0,1,0
2222,1176,0,0,144,144,0,1,0,1,0
1605,183,5851,121,293,223,70,4,0,3,1
1469,1151,0,0,133,133,0,1,0,1,0
1288,795,0,0,151,151,0,1,0,1,0
822,1176,0,0,156,156,0,1,0,1,0
10613,1575,0,0,69,69,0,1,0,1,0
2033,1230,0,0,134,134,0,1,0,1,0
873,3095,0,0,140,140,0,1,0,1,0
1947,983,0,0,96,96,0,1,0,1,0
11016,1585,0,0,62,62,0,1,0,1,0
365,1176,0,0,143,143,0,1,0,1,0
2914,1230,0,0,138,138,0,1,0,1,0
1622,2672,0,0,118,118,0,1,0,1,0
21398,536,21058,89,232,181,51,3,0,2,0
21592,1181,7556,32,123,104,18,1,0,1,0
1963,855,0,0,62,62,0,1,0,1,0
1697,183,6312,121,293,223,70,4,0,3,1
1206,325,2108,71,233,192,41,2,0,2,0
1414,183,5604,121,293,223,70,4,0,3,1
20346,2195,0,0,96,96,0,1,0,1,0
19346,2678,0,0,122,122,0,1,0,1,0
2490,2568,0,0,122,122,0,1,0,1,0
2154,1279,0,0,126,126,0,1,0,1,0
2186,183,8970,121,293,223,70,4,0,3,1
1781,827,0,0,145,145,0,1,0,1,0
2900,1655,0,0,68,68,0,1,0,1,0
2915,1183,0,0,146,146,0,1,0,1,0
8731,1663,0,0,131,131,0,1,0,1,0
2893,1690,0,0,62,62,0,1,0,1,0
9954,1543,0,0,86,86,0,1,0,1,0
4653,183,16113,121,293,223,70,4,1,3,1
17073,2135,0,0,145,145,0,1,0,1,0
42,1180,0,0,155,155,0,1,0,1,0
5023,183,16572,121,293,223,70,4,1,3,1
10596,1543,0,0,66,66,0,1,0,1,0
3040,1681,0,0,64,64,0,1,0,1,0
666,2653,0,0,144,144,0,1,0,1,0
3596,183,13027,121,293,223,70,4,0,3,1
11521,1689,0,0,62,62,0,1,0,1,0
11041,1590,0,0,62,62,0,1,0,1,0
10108,1543,0,0,81,81,0,1,0,1,0
2812,1259,0,0,134,134,0,1,0,1,0
2161,1867,0,0,72,72,0,1,0,1,0
10772,1543,0,0,62,62,0,1,0,1,0
1944,1016,0,0,104,104,0,1,0,1,0
3990,587,0,0,133,133,0,1,0,1,0
1623,183,5910,121,293,223,70,4,0,3,1
890,214,3465,117,288,220,67,3,0,2,0
9567,1405,0,0,103,103,0,1,0,1,0
1978,183,7679,121,293,223,70,4,0,3,1
697,3080,0,0,139,139,0,1,0,1,0
424,1176,0,0,145,145,0,1,0,1,0
911,183,3612,121,293,223,70,4,1,3,1
730,491,2467,83,246,198,48,3,0,2,0
2915,1198,0,0,144,144,0,1,0,1,0
1698,576,0,0,134,134,0,1,0,1,0
10792,1543,0,0,62,62,0,1,0,1,0
576,780,1425,48,202,174,27,2,0,1,0
3996,365,0,0,138,138,0,1,0,1,0
8449,1694,0,0,142,142,0,1,0,1,0
1996,183,7798,121,293,223,70,4,0,3,1
17785,183,25900,121,293,223,70,4,0,3,1
2925,1694,0,0,62,62,0,1,0,1,0
2218,183,8345,121,293,223,70,4,0,3,1
2746,1694,0,0,62,62,0,1,0,1,0
1904,183,7444,121,293,223,70,4,0,3,1
363,1174,0,0,143,143,0,1,0,1,0
8818,1566,0,0,133,133,0,1,0,1,0
2144,183,8611,121,293,223,70,4,0,3,1
8830,1543,0,0,127,127,0,1,0,1,0
1286,1176,0,0,142,142,0,1,0,1,0
1347,183,4565,121,293,223,70,4,1,3,1
7964,2061,0,0,117,117,0,1,0,1,0
2363,1694,0,0,62,62,0,1,0,1,0
8367,1543,0,0,144,144,0,1,0,1,0
8255,1230,0,0,155,155,0,1,0,1,0
742,1176,0,0,156,156,0,1,0,1,0
1584,1176,0,0,140,140,0,1,0,1,0
1908,1119,0,0,143,143,0,1,0,1,0
707,3063,0,0,139,139,0,1,0,1,0
19022,1543,0,0,64,64,0,1,0,1,0
1879,760,0,0,84,84,0,1,0,1,0
2545,1694,0,0,62,62,0,1,0,1,0
2908,1404,0,0,110,110,0,1,0,1,0
7977,2043,0,0,118,118,0,1,0,1,0
1997,183,7802,121,293,223,70,4,0,3,1
1690,183,6242,121,293,223,70,4,0,3,1
1643,553,0,0,147,147,0,1,0,1,0
19429,2638,0,0,120,120,0,1,0,1,0
1952,183,7548,121,293,223,70,4,0,3,1
2948,1694,0,0,62,62,0,1,0,1,0
3313,1265,0,0,89,89,0,1,0,1,0
1941,1158,0,0,141,141,0,1,0,1,0
1077,949,0,0,153,153,0,1,0,1,0
2073,3095,0,0,155,155,0,1,0,1,0
10944,1694,0,0,77,77,0,1,0,1,0
1996,1176,0,0,143,143,0,1,0,1,0
2173,183,8779,121,293,223,70,4,0,3,1
555,1176,0,0,149,149,0,1,0,1,0
214,2274,0,0,144,144,0,1,0,1,0
1370,183,4674,121,293,223,70,4,0,3,1
2664,441,0,0,94,94,0,1,0,1,0
4539,634,0,0,146,146,0,1,0,1,0
2896,1694,0,0,62,62,0,1,0,1,0
1187,2995,0,0,143,143,0,1,0,1,0
2461,108,0,0,69,69,0,1,0,1,0
1064,1131,0,0,143,143,0,1,0,1,0
1584,726,0,0,145,145,0,1,0,1,0
8291,1472,0,0,150,150,0,1,0,1,0
4745,183,16227,121,293,223,70,4,1,3,1
7926,2115,0,0,114,114,0,1,0,1,0
1417,700,0,0,150,150,0,1,0,1,0
416,1094,0,0,157,157,0,1,0,1,0
2082,1256,0,0,130,130,0,1,0,1,0
8327,1658,0,0,146,146,0,1,0,1,0
2482,48,0,0,62,62,0,1,0,1,0
8619,1672,0,0,135,135,0,1,0,1,0
19567,2571,0,0,117,117,0,1,0,1,0
1498,3095,0,0,145,145,0,1,0,1,0
20025,1543,0,0,62,62,0,1,0,1,0
9313,1620,0,0,110,110,0,1,0,1,0
1266,811,0,0,151,151,0,1,0,1,0
2186,201,0,0,94,94,0,1,0,1,0
93,1040,0,0,153,153,0,1,0,1,0
1947,1197,0,0,139,139,0,1,0,1,0
2910,1340,0,0,120,120,0,1,0,1,0
191,1043,0,0,157,157,0,1,0,1,0
1527,183,6042,121,293,223,70,4,0,3,1
8308,1463,0,0,148,148,0,1,0,1,0
8528,1216,0,0,146,146,0,1,0,1,0
2808,861,0,0,124,124,0,1,0,1,0
1385,3095,0,0,141,141,0,1,0,1,0
4113,183,14631,121,293,223,70,4,0,3,1
6887,2363,0,0,82,82,0,1,0,1,0
1048,183,3999,121,293,223,70,4,1,3,1
5987,410,0,0,146,146,0,1,0,1,0
1984,3095,0,0,155,155,0,1,0,1,0
1558,183,5619,121,293,223,70,4,0,3,1
129,1808,0,0,149,149,0,1,0,1,0
1723,1176,0,0,141,141,0,1,0,1,0
5744,273,0,0,146,146,0,1,0,1,0
15359,966,0,0,145,145,0,1,0,1,0
8594,1236,0,0,142,142,0,1,0,1,0
21620,1276,5584,23,107,93,13,1,0,1,0
20272,1543,0,0,62,62,0,1,0,1,0
8327,1588,0,0,146,146,0,1,0,1,0
10177,1629,0,0,97,97,0,1,0,1,0
8305,1558,0,0,148,148,0,1,0,1,0
1614,490,485,13,164,156,7,1,0,1,0
2308,417,0,0,90,90,0,1,0,1,0
722,2618,0,0,143,143,0,1,0,1,0
146,1931,0,0,148,148,0,1,0,1,0
2100,968,0,0,62,62,0,1,0,1,0
3810,183,13464,121,293,223,70,4,1,3,1
1516,1176,0,0,139,139,0,1,0,1,0
1970,334,0,0,116,116,0,1,0,1,0
2021,897,0,0,62,62,0,1,0,1,0
1196,183,4401,121,293,223,70,4,1,3,1
1921,183,7375,121,293,223,70,4,0,3,1
1358,183,4620,121,293,223,70,4,0,3,1
11182,183,21077,121,293,223,70,4,0,3,1
3088,183,10818,121,293,223,70,4,0,3,1
3533,1121,0,0,99,99,0,1,0,1,0
1723,1176,0,0,141,141,0,1,0,1,0
11632,183,21250,121,293,223,70,4,0,3,1
8462,1207,0,0,148,148,0,1,0,1,0
1103,183,3984,121,293,223,70,4,1,3,1
9598,1602,0,0,112,112,0,1,0,1,0
1500,1100,0,0,134,134,0,1,0,1,0
21647,1365,3720,15,92,83,9,1,0,1,0
981,1120,0,0,144,144,0,1,0,1,0
16908,2794,0,0,130,130,0,1,0,1,0
4165,183,14925,121,293,223,70,4,0,3,1
2721,1440,0,0,62,62,0,1,0,1,0
4369,380,0,0,146,146,0,1,0,1,0
8317,1500,0,0,147,147,0,1,0,1,0
10863,1554,0,0,62,62,0,1,0,1,0
10028,1543,0,0,88,88,0,1,0,1,0
2095,631,0,0,62,62,0,1,0,1,0
198,1092,0,0,149,149,0,1,0,1,0
1458,3095,0,0,139,139,0,1,0,1,0
2470,67,0,0,62,62,0,1,0,1,0
10194,1543,0,0,78,78,0,1,0,1,0
20861,1947,0,0,83,83,0,1,0,1,0
2070,1239,0,0,133,133,0,1,0,1,0
19067,2812,0,0,129,129,0,1,0,1,0
1636,575,0,0,147,147,0,1,0,1,0
1950,183,7571,121,293,223,70,4,0,3,1
11468,1678,0,0,62,62,0,1,0,1,0
2312,408,0,0,90,90,0,1,0,1,0
977,3095,0,0,140,140,0,1,0,1,0
8327,1647,0,0,146,146,0,1,0,1,0
2167,523,0,0,62,62,0,1,0,1,0
1903,183,7426,121,293,223,70,4,0,3,1
1336,207,4075,112,282,217,65,3,0,2,0
250,2418,0,0,144,144,0,1,0,1,0
1319,183,4423,121,293,223,70,4,1,3,1
1378,3095,0,0,141,141,0,1,0,1,0
10046,1543,0,0,87,87,0,1,0,1,0
8318,1640,0,0,147,147,0,1,0,1,0
7732,2459,0,0,98,98,0,1,0,1,0
8682,1672,0,0,133,133,0,1,0,1,0
1220,1176,0,0,144,144,0,1,0,1,0
13761,533,0,0,128,128,0,1,0,1,0
4065,183,14371,121,293,223,70,4,1,3,1
816,1176,0,0,156,156,0,1,0,1,0
6190,521,0,0,146,146,0,1,0,1,0
3009,1694,0,0,62,62,0,1,0,1,0
11546,1692,0,0,69,69,0,1,0,1,0
2913,1242,0,0,136,136,0,1,0,1,0
1303,783,0,0,151,151,0,1,0,1,0
11382,881,0,0,145,145,0,1,0,1,0
7896,2158,0,0,111,111,0,1,0,1,0
8144,1365,0,0,147,147,0,1,0,1,0
44,1195,0,0,155,155,0,1,0,1,0
1383,3095,0,0,139,139,0,1,0,1,0
616,705,1695,57,214,180,33,2,0,1,0
17749,1543,0,0,62,62,0,1,0,1,0
868,390,2830,95,264,209,55,3,0,2,0
8309,1467,0,0,148,148,0,1,0,1,0
3004,1533,0,0,88,88,0,1,0,1,0
2078,183,7882,121,293,223,70,4,0,3,1
4737,183,16217,121,293,223,70,4,1,3,1
1898,183,7399,121,293,223,70,4,0,3,1
8299,1678,0,0,146,146,0,1,0,1,0
9682,1593,0,0,96,96,0,1,0,1,0
754,3095,0,0,139,139,0,1,0,1,0
2155,1877,0,0,72,72,0,1,0,1,0
1011,183,3897,121,293,223,70,4,1,3,1
2332,971,0,0,95,95,0,1,0,1,0
1941,850,0,0,64,64,0,1,0,1,0
3020,183,11185,121,293,223,70,4,0,3,1
11198,1622,0,0,62,62,0,1,0,1,0
846,3095,0,0,139,139,0,1,0,1,0
8327,1591,0,0,146,146,0,1,0,1,0
1946,183,7550,121,293,223,70,4,0,3,1
8258,1641,0,0,140,140,0,1,0,1,0
1772,1176,0,0,141,141,0,1,0,1,0
709,1162,0,0,157,157,0,1,0,1,0
4554,183,15990,121,293,223,70,4,1,3,1
1861,1176,0,0,142,142,0,1,0,1,0
1434,183,4994,121,293,223,70,4,1,3,1
8795,2306,0,0,66,66,0,1,0,1,0
19992,183,27151,121,293,223,70,4,0,3,1
1362,613,0,0,149,149,0,1,0,1,0
8768,1251,0,0,137,137,0,1,0,1,0
2109,183,7424,121,293,223,70,4,1,3,1
4509,183,10704,121,293,223,70,4,0,3,1
252,2420,0,0,144,144,0,1,0,1,0
1367,183,4866,121,293,223,70,4,1,3,1
2034,183,7982,121,293,223,70,4,0,3,1
16837,1974,0,0,145,145,0,1,0,1,0
7870,1895,0,0,120,120,0,1,0,1,0
1889,3095,0,0,152,152,0,1,0,1,0
452,1176,0,0,146,146,0,1,0,1,0
2807,1694,0,0,62,62,0,1,0,1,0
1165,773,0,0,146,146,0,1,0,1,0
1752,183,6586,121,293,223,70,4,0,3,1
10282,1467,0,0,81,81,0,1,0,1,0
11003,1582,0,0,64,64,0,1,0,1,0
983,183,3820,121,293,223,70,4,1,3,1
8632,1543,0,0,135,135,0,1,0,1,0
1775,183,6761,121,293,223,70,4,0,3,1
1974,882,0,0,62,62,0,1,0,1,0
4449,372,0,0,146,146,0,1,0,1,0
2247,3008,0,0,153,153,0,1,0,1,0
1944,1026,0,0,106,106,0,1,0,1,0
10959,1573,0,0,62,62,0,1,0,1,0
969,183,3855,121,293,223,70,4,0,3,1
1691,2569,0,0,112,112,0,1,0,1,0
2912,1273,0,0,131,131,0,1,0,1,0
7636,2582,0,0,90,90,0,1,0,1,0
1324,3095,0,0,147,147,0,1,0,1,0
1602,3095,0,0,143,143,0,1,0,1,0
1827,1176,0,0,142,142,0,1,0,1,0
8248,1209,0,0,156,156,0,1,0,1,0
2185,497,0,0,62,62,0,1,0,1,0
5323,285,0,0,146,146,0,1,0,1,0
7910,1818,0,0,124,124,0,1,0,1,0
843,2769,0,0,143,143,0,1,0,1,0
971,2815,0,0,141,141,0,1,0,1,0
11154,183,21056,121,293,223,70,4,0,3,1
1372,183,4688,121,293,223,70,4,0,3,1
1384,183,4748,121,293,223,70,4,1,3,1
2030,1228,0,0,134,134,0,1,0,1,0
4378,183,15554,121,293,223,70,4,0,3,1
8247,1196,0,0,156,156,0,1,0,1,0
2329,1176,0,0,145,145,0,1,0,1,0
17663,2537,0,0,145,145,0,1,0,1,0
7859,2295,0,0,108,108,0,1,0,1,0
7214,183,14265,121,293,223,70,4,0,3,1
2888,1095,0,0,142,142,0,1,0,1,0
2199,183,8938,121,293,223,70,4,0,3,1
1782,183,6794,121,293,223,70,4,0,3,1
1818,183,6916,121,293,223,70,4,0,3,1
1165,885,0,0,152,152,0,1,0,1,0
19873,2424,0,0,109,109,0,1,0,1,0
2900,1640,0,0,70,70,0,1,0,1,0
2569,1054,0,0,116,116,0,1,0,1,0
1560,183,5609,121,293,223,70,4,0,3,1
14613,458,0,0,145,145,0,1,0,1,0
10155,1507,0,0,80,80,0,1,0,1,0
1910,1123,0,0,143,143,0,1,0,1,0
8274,1312,0,0,152,152,0,1,0,1,0
3547,183,12869,121,293,223,70,4,0,3,1
3027,1627,0,0,73,73,0,1,0,1,0
1615,183,5927,121,293,223,70,4,0,3,1
2065,1247,0,0,131,131,0,1,0,1,0
798,933,873,29,190,173,17,1,0,1,0
1819,3095,0,0,148,148,0,1,0,1,0
9080,2167,0,0,67,67,0,1,0,1,0
19844,2437,0,0,109,109,0,1,0,1,0
8472,1215,0,0,147,147,0,1,0,1,0
1816,930,0,0,82,82,0,1,0,1,0
1942,183,7630,121,293,223,70,4,0,3,1
1479,3095,0,0,140,140,0,1,0,1,0
4372,183,15536,121,293,223,70,4,0,3,1
1779,658,0,0,112,112,0,1,0,1,0
175,1039,0,0,157,157,0,1,0,1,0
1706,655,0,0,147,147,0,1,0,1,0
1637,1176,0,0,140,140,0,1,0,1,0
2692,523,0,0,100,100,0,1,0,1,0
482,1110,0,0,157,157,0,1,0,1,0
1075,2922,0,0,143,143,0,1,0,1,0
3043,1694,0,0,62,62,0,1,0,1,0
4574,183,15221,121,293,223,70,4,0,3,1
12515,836,0,0,111,111,0,1,0,1,0
2816,183,10270,121,293,223,70,4,0,3,1
2901,1605,0,0,76,76,0,1,0,1,0
21468,768,16199,68,193,153,39,2,0,2,0
4525,183,15955,121,293,223,70,4,1,3,1
1441,3095,0,0,148,148,0,1,0,1,0
11701,183,21301,121,293,223,70,4,0,3,1
3029,1694,0,0,62,62,0,1,0,1,0
1997,183,7924,121,293,223,70,4,0,3,1
9954,1420,0,0,93,93,0,1,0,1,0
2542,1176,0,0,146,146,0,1,0,1,0
21420,610,19520,82,220,172,48,3,0,2,0
19416,2644,0,0,120,120,0,1,0,1,0
7331,2974,0,0,66,66,0,1,0,1,0
2518,183,9422,121,293,223,70,4,0,3,1
3020,1675,0,0,62,62,0,1,0,1,0
1723,183,6442,121,293,223,70,4,0,3,1
1841,964,0,0,144,144,0,1,0,1,0
9095,1543,0,0,118,118,0,1,0,1,0
8327,1561,0,0,146,146,0,1,0,1,0
1957,839,0,0,62,62,0,1,0,1,0
475,1108,0,0,157,157,0,1,0,1,0
8207,1244,0,0,153,153,0,1,0,1,0
2656,1513,0,0,90,90,0,1,0,1,0
1169,183,4327,121,293,223,70,4,1,3,1
1873,1039,0,0,144,144,0,1,0,1,0
2878,1176,0,0,147,147,0,1,0,1,0
18139,1543,0,0,62,62,0,1,0,1,0
10832,1547,0,0,62,62,0,1,0,1,0
955,3095,0,0,139,139,0,1,0,1,0
143,1065,0,0,151,151,0,1,0,1,0
9645,1596,0,0,98,98,0,1,0,1,0
8327,1681,0,0,146,146,0,1,0,1,0
414,1151,0,0,143,143,0,1,0,1,0
3977,602,0,0,133,133,0,1,0,1,0
3533,788,0,0,146,146,0,1,0,1,0
7864,1038,0,0,155,155,0,1,0,1,0
1851,988,0,0,144,144,0,1,0,1,0
8292,1393,0,0,150,150,0,1,0,1,0
2123,791,0,0,116,116,0,1,0,1,0
1875,391,0,0,125,125,0,1,0,1,0
548,1125,0,0,157,157,0,1,0,1,0
8321,1518,0,0,146,146,0,1,0,1,0
9430,1626,0,0,108,108,0,1,0,1,0
1724,1176,0,0,141,141,0,1,0,1,0
8099,1452,0,0,142,142,0,1,0,1,0
6635,591,0,0,150,150,0,1,0,1,0
1346,183,4809,121,293,223,70,4,1,3,1
11861,1528,0,0,71,71,0,1,0,1,0
92,1541,0,0,152,152,0,1,0,1,0
9325,1619,0,0,109,109,0,1,0,1,0
5432,183,11680,121,293,223,70,4,0,3,1
2485,18,0,0,64,64,0,1,0,1,0
557,1612,0,0,152,152,0,1,0,1,0
2283,1694,0,0,62,62,0,1,0,1,0
11627,1651,0,0,64,64,0,1,0,1,0
1436,183,5008,121,293,223,70,4,0,3,1
1183,3095,0,0,142,142,0,1,0,1,0
2044,1343,0,0,116,116,0,1,0,1,0
394,1176,0,0,143,143,0,1,0,1,0
5876,183,17201,121,293,223,70,4,0,3,1
2146,3095,0,0,157,157,0,1,0,1,0
13912,377,0,0,137,137,0,1,0,1,0
8193,1866,0,0,135,135,0,1,0,1,0
777,402,2786,94,259,205,54,3,0,2,0
2843,1234,0,0,138,138,0,1,0,1,0
10823,1545,0,0,62,62,0,1,0,1,0
16831,1970,0,0,145,145,0,1,0,1,0
6052,379,0,0,147,147,0,1,0,1,0
7931,2108,0,0,114,114,0,1,0,1,0
9676,1543,0,0,96,96,0,1,0,1,0
7365,2871,0,0,70,70,0,1,0,1,0
2012,758,0,0,62,62,0,1,0,1,0
1766,1176,0,0,141,141,0,1,0,1,0
803,3095,0,0,139,139,0,1,0,1,0
8615,1676,0,0,136,136,0,1,0,1,0
912,3095,0,0,140,140,0,1,0,1,0
2572,2393,0,0,110,110,0,1,0,1,0
1737,615,0,0,124,124,0,1,0,1,0
2007,884,0,0,62,62,0,1,0,1,0
955,1039,0,0,155,155,0,1,0,1,0
1174,183,4340,121,293,223,70,4,1,3,1
98,1584,0,0,151,151,0,1,0,1,0
9511,1543,0,0,102,102,0,1,0,1,0
2244,183,9190,121,293,223,70,4,0,3,1
19150,183,26897,121,293,223,70,4,0,3,1
2870,1043,0,0,138,138,0,1,0,1,0
1461,1087,0,0,140,140,0,1,0,1,0
1135,1176,0,0,147,147,0,1,0,1,0
2153,1360,0,0,62,62,0,1,0,1,0
695,1176,0,0,154,154,0,1,0,1,0
2554,1469,0,0,99,99,0,1,0,1,0
1381,183,4904,121,293,223,70,4,1,3,1
8008,1628,0,0,134,134,0,1,0,1,0
2119,183,8017,121,293,223,70,4,0,3,1
2717,1336,0,0,121,121,0,1,0,1,0
156,1072,0,0,151,151,0,1,0,1,0
1379,183,4722,121,293,223,70,4,1,3,1
2934,1694,0,0,62,62,0,1,0,1,0
15922,1350,0,0,145,145,0,1,0,1,0
15205,861,0,0,145,145,0,1,0,1,0
6971,713,0,0,151,151,0,1,0,1,0
1201,3095,0,0,142,142,0,1,0,1,0
4517,183,15944,121,293,223,70,4,1,3,1
2196,183,8947,121,293,223,70,4,0,3,1
2175,208,0,0,95,95,0,1,0,1,0
4561,183,15182,121,293,223,70,4,0,3,1
1233,3095,0,0,142,142,0,1,0,1,0
1620,183,5956,121,293,223,70,4,0,3,1
1645,522,77,2,150,149,1,1,0,1,0
2452,1418,0,0,105,105,0,1,0,1,0
4743,183,15818,121,293,223,70,4,0,3,1
11323,1648,0,0,62,62,0,1,0,1,0
1810,183,6829,121,293,223,70,4,0,3,1
10575,1543,0,0,67,67,0,1,0,1,0
6076,387,0,0,147,147,0,1,0,1,0
1191,183,4387,121,293,223,70,4,1,3,1
2208,3095,0,0,158,158,0,1,0,1,0
3338,183,12060,121,293,223,70,4,0,3,1
21366,430,23289,99,251,193,57,3,0,2,0
8599,1543,0,0,136,136,0,1,0,1,0
1864,899,0,0,75,75,0,1,0,1,0
1493,1176,0,0,139,139,0,1,0,1,0
13497,548,0,0,125,125,0,1,0,1,0
9957,1572,0,0,86,86,0,1,0,1,0
10691,1543,0,0,64,64,0,1,0,1,0
2054,183,8097,121,293,223,70,4,0,3,1
2978,1429,0,0,105,105,0,1,0,1,0
2903,1550,0,0,85,85,0,1,0,1,0
1948,962,0,0,91,91,0,1,0,1,0
2389,1420,0,0,104,104,0,1,0,1,0
357,2575,0,0,143,143,0,1,0,1,0
1787,183,6757,121,293,223,70,4,0,3,1
18011,1597,0,0,62,62,0,1,0,1,0
15668,487,0,0,129,129,0,1,0,1,0
9675,1611,0,0,100,100,0,1,0,1,0
939,1176,0,0,152,152,0,1,0,1,0
8251,1177,0,0,156,156,0,1,0,1,0
5399,278,0,0,146,146,0,1,0,1,0
8468,1215,0,0,147,147,0,1,0,1,0
1042,974,0,0,154,154,0,1,0,1,0
2265,375,0,0,62,62,0,1,0,1,0
1583,1176,0,0,140,140,0,1,0,1,0
2993,1491,0,0,95,95,0,1,0,1,0
1477,449,826,27,181,165,16,1,0,1,0
2161,1518,0,0,89,89,0,1,0,1,0
474,1786,0,0,150,150,0,1,0,1,0
1385,1176,0,0,139,139,0,1,0,1,0
3446,1222,0,0,92,92,0,1,0,1,0
2442,109,0,0,62,62,0,1,0,1,0
9695,1543,0,0,96,96,0,1,0,1,0
12929,1673,0,0,62,62,0,1,0,1,0
8099,1987,0,0,127,127,0,1,0,1,0
17178,2206,0,0,145,145,0,1,0,1,0
2284,1688,0,0,62,62,0,1,0,1,0
12276,1311,0,0,83,83,0,1,0,1,0
242,2073,0,0,144,144,0,1,0,1,0
10774,1543,0,0,62,62,0,1,0,1,0
4813,183,16311,121,293,223,70,4,1,3,1
2049,183,8067,121,293,223,70,4,0,3,1
17637,2519,0,0,145,145,0,1,0,1,0
11072,1633,0,0,65,65,0,1,0,1,0
2910,1694,0,0,62,62,0,1,0,1,0
992,1176,0,0,150,150,0,1,0,1,0
4112,183,14765,121,293,223,70,4,0,3,1
14132,339,0,0,139,139,0,1,0,1,0
1699,183,6367,121,293,223,70,4,0,3,1
13172,842,0,0,110,110,0,1,0,1,0
1405,183,4971,121,293,223,70,4,1,3,1
18230,3044,0,0,142,142,0,1,0,1,0
1067,3095,0,0,141,141,0,1,0,1,0
8248,1504,0,0,146,146,0,1,0,1,0
3013,1694,0,0,62,62,0,1,0,1,0
1176,3095,0,0,145,145,0,1,0,1,0
10009,1569,0,0,84,84,0,1,0,1,0
1865,1021,0,0,144,144,0,1,0,1,0
7128,2791,0,0,69,69,0,1,0,1,0
1320,183,4431,121,293,223,70,4,0,3,1
10449,1543,0,0,70,70,0,1,0,1,0
1025,2889,0,0,143,143,0,1,0,1,0
2900,1660,0,0,67,67,0,1,0,1,0
1741,620,0,0,122,122,0,1,0,1,0
2877,90,0,0,80,80,0,1,0,1,0
1775,814,0,0,145,145,0,1,0,1,0
7625,2596,0,0,90,90,0,1,0,1,0
2915,1201,0,0,143,143,0,1,0,1,0
2660,1383,0,0,113,113,0,1,0,1,0
2687,183,9055,121,293,223,70,4,1,3,1
2927,1172,0,0,147,147,0,1,0,1,0
11338,1729,0,0,80,80,0,1,0,1,0
10397,1094,0,0,145,145,0,1,0,1,0
479,963,767,25,175,160,15,1,0,1,0
355,1170,0,0,143,143,0,1,0,1,0
255,1057,0,0,157,157,0,1,0,1,0
2062,876,0,0,71,71,0,1,0,1,0
692,1332,0,0,155,155,0,1,0,1,0
10507,1561,0,0,70,70,0,1,0,1,0
1760,183,6626,121,293,223,70,4,0,3,1
2862,1176,0,0,147,147,0,1,0,1,0
12656,1543,0,0,62,62,0,1,0,1,0
10631,1543,0,0,65,65,0,1,0,1,0
9810,1543,0,0,92,92,0,1,0,1,0
2548,1375,0,0,62,62,0,1,0,1,0
1799,183,6772,121,293,223,70,4,0,3,1
1907,1467,0,0,95,95,0,1,0,1,0
1713,183,6456,121,293,223,70,4,0,3,1
2784,183,10828,121,293,223,70,4,0,3,1
1264,1176,0,0,143,143,0,1,0,1,0
9852,1454,0,0,92,92,0,1,0,1,0
2785,1281,0,0,130,130,0,1,0,1,0
1599,183,5819,121,293,223,70,4,0,3,1
2108,1257,0,0,130,130,0,1,0,1,0
597,1176,0,0,151,151,0,1,0,1,0
1737,183,6475,121,293,223,70,4,0,3,1
12254,1322,0,0,83,83,0,1,0,1,0
2894,1193,0,0,145,145,0,1,0,1,0
730,2341,0,0,146,146,0,1,0,1,0
1820,183,6880,121,293,223,70,4,0,3,1
72,1015,0,0,157,157,0,1,0,1,0
1502,1098,0,0,133,133,0,1,0,1,0
9264,1543,0,0,114,114,0,1,0,1,0
18742,2969,0,0,138,138,0,1,0,1,0
11574,1679,0,0,62,62,0,1,0,1,0
2268,2078,0,0,88,88,0,1,0,1,0
5905,623,0,0,134,134,0,1,0,1,0
1533,3095,0,0,146,146,0,1,0,1,0
20852,1543,0,0,62,62,0,1,0,1,0
1172,3095,0,0,139,139,0,1,0,1,0
10838,1549,0,0,62,62,0,1,0,1,0
1917,865,0,0,67,67,0,1,0,1,0
10871,1608,0,0,67,67,0,1,0,1,0
1061,3095,0,0,143,143,0,1,0,1,0
2894,1694,0,0,62,62,0,1,0,1,0
2808,1176,0,0,147,147,0,1,0,1,0
2844,1644,0,0,62,62,0,1,0,1,0
2848,1231,0,0,138,138,0,1,0,1,0
5643,254,0,0,146,146,0,1,0,1,0
1584,1176,0,0,140,140,0,1,0,1,0
5456,272,0,0,146,146,0,1,0,1,0
19969,1543,0,0,62,62,0,1,0,1,0
395,1176,0,0,144,144,0,1,0,1,0
10959,1619,0,0,66,66,0,1,0,1,0
8298,1418,0,0,149,149,0,1,0,1,0
1933,1176,0,0,143,143,0,1,0,1,0
2913,1247,0,0,136,136,0,1,0,1,0
2511,4,0,0,62,62,0,1,0,1,0
1421,3095,0,0,139,139,0,1,0,1,0
7788,2054,0,0,112,112,0,1,0,1,0
2337,1694,0,0,62,62,0,1,0,1,0
9618,1414,0,0,101,101,0,1,0,1,0
1207,3095,0,0,142,142,0,1,0,1,0
3329,916,0,0,147,147,0,1,0,1,0
2122,591,0,0,62,62,0,1,0,1,0
1423,183,5019,121,293,223,70,4,1,3,1
21495,861,14267,60,177,142,35,2,0,2,0
1953,3095,0,0,151,151,0,1,0,1,0
12261,1005,0,0,96,96,0,1,0,1,0
1794,2494,0,0,106,106,0,1,0,1,0
1075,183,4246,121,293,223,70,4,0,3,1
10414,1543,0,0,70,70,0,1,0,1,0
18077,1596,0,0,62,62,0,1,0,1,0
2331,276,0,0,62,62,0,1,0,1,0
1814,183,6848,121,293,223,70,4,0,3,1
340,1163,0,0,144,144,0,1,0,1,0
7474,2951,0,0,62,62,0,1,0,1,0
346,2435,0,0,144,144,0,1,0,1,0
5252,293,0,0,146,146,0,1,0,1,0
21488,1546,0,0,62,62,0,1,0,1,0
1860,183,7123,121,293,223,70,4,0,3,1
9718,1608,0,0,109,109,0,1,0,1,0
7993,1658,0,0,132,132,0,1,0,1,0
2310,307,0,0,62,62,0,1,0,1,0
9707,1694,0,0,109,109,0,1,0,1,0
2682,2156,0,0,94,94,0,1,0,1,0
993,3095,0,0,140,140,0,1,0,1,0
1792,2419,0,0,103,103,0,1,0,1,0
21474,790,15739,66,189,151,38,2,0,2,0
1392,183,4788,121,293,223,70,4,0,3,1
356,1081,0,0,157,157,0,1,0,1,0
8840,1543,0,0,128,128,0,1,0,1,0
836,1125,0,0,156,156,0,1,0,1,0
1427,1176,0,0,149,149,0,1,0,1,0
13189,2024,0,0,87,87,0,1,0,1,0
1045,3095,0,0,141,141,0,1,0,1,0
1942,1050,0,0,112,112,0,1,0,1,0
19931,2396,0,0,107,107,0,1,0,1,0
1062,3095,0,0,141,141,0,1,0,1,0
8296,1508,0,0,149,149,0,1,0,1,0
1588,714,0,0,145,145,0,1,0,1,0
4140,183,14849,121,293,223,70,4,0,3,1
8322,1521,0,0,146,146,0,1,0,1,0
1601,3095,0,0,147,147,0,1,0,1,0
6983,2534,0,0,77,77,0,1,0,1,0
4774,183,16263,121,293,223,70,4,1,3,1
1495,183,5285,121,293,223,70,4,0,3,1
3045,183,11088,121,293,223,70,4,0,3,1
2554,1694,0,0,62,62,0,1,0,1,0
2021,535,0,0,97,97,0,1,0,1,0
89,1038,0,0,154,154,0,1,0,1,0
2329,201,0,0,75,75,0,1,0,1,0
11447,1673,0,0,62,62,0,1,0,1,0
299,1659,0,0,143,143,0,1,0,1,0
8327,1664,0,0,146,146,0,1,0,1,0
2211,183,9000,121,293,223,70,4,0,3,1
4846,183,16353,121,293,223,70,4,1,3,1
15399,183,24157,121,293,223,70,4,0,3,1
8225,1210,0,0,155,155,0,1,0,1,0
2614,1694,0,0,62,62,0,1,0,1,0
229,2162,0,0,144,144,0,1,0,1,0
1632,183,5985,121,293,223,70,4,0,3,1
1595,183,5783,121,293,223,70,4,0,3,1
1623,612,0,0,146,146,0,1,0,1,0
8292,1392,0,0,150,150,0,1,0,1,0
1382,255,3471,95,262,207,55,3,0,2,0
129,1028,0,0,157,157,0,1,0,1,0
1772,183,7243,121,293,223,70,4,0,3,1
679,3054,0,0,139,139,0,1,0,1,0
8515,1543,0,0,139,139,0,1,0,1,0
846,560,2218,74,241,197,43,2,0,2,0
1836,953,0,0,144,144,0,1,0,1,0
1783,832,0,0,145,145,0,1,0,1,0
2010,183,7981,121,293,223,70,4,0,3,1
840,3095,0,0,139,139,0,1,0,1,0
1307,3095,0,0,139,139,0,1,0,1,0
1889,183,7266,121,293,223,70,4,0,3,1
686,1176,0,0,154,154,0,1,0,1,0
2102,183,8391,121,293,223,70,4,0,3,1
21075,1433,0,0,69,69,0,1,0,1,0
50,1019,0,0,155,155,0,1,0,1,0
1687,183,6225,121,293,223,70,4,0,3,1
1282,3095,0,0,142,142,0,1,0,1,0
1646,545,0,0,147,147,0,1,0,1,0
18696,2991,0,0,139,139,0,1,0,1,0
1749,754,0,0,146,146,0,1,0,1,0
2026,1316,0,0,120,120,0,1,0,1,0
1102,930,0,0,153,153,0,1,0,1,0
1074,3095,0,0,139,139,0,1,0,1,0
1399,1176,0,0,139,139,0,1,0,1,0
66,1353,0,0,153,153,0,1,0,1,0
20593,2076,0,0,90,90,0,1,0,1,0
7977,1371,0,0,146,146,0,1,0,1,0
929,183,3674,121,293,223,70,4,1,3,1
2157,183,8687,121,293,223,70,4,0,3,1
1433,183,4988,121,293,223,70,4,1,3,1
1828,936,0,0,144,144,0,1,0,1,0
1292,3095,0,0,139,139,0,1,0,1,0
2032,183,8000,121,293,223,70,4,0,3,1
1434,307,2812,77,240,196,44,2,0,2,0
5965,730,0,0,131,131,0,1,0,1,0
2035,1045,0,0,62,62,0,1,0,1,0
13110,691,0,0,116,116,0,1,0,1,0
16334,1631,0,0,145,145,0,1,0,1,0
2842,183,10414,121,293,223,70,4,0,3,1
3006,122,0,0,87,87,0,1,0,1,0
713,1176,0,0,155,155,0,1,0,1,0
17298,2855,0,0,132,132,0,1,0,1,0
8266,1280,0,0,153,153,0,1,0,1,0
11157,1614,0,0,62,62,0,1,0,1,0
2060,183,8123,121,293,223,70,4,0,3,1
747,459,2582,87,251,200,50,3,0,2,0
11049,1630,0,0,66,66,0,1,0,1,0
7635,2532,0,0,90,90,0,1,0,1,0
1154,3095,0,0,144,144,0,1,0,1,0
19385,1543,0,0,64,64,0,1,0,1,0
2990,1479,0,0,97,97,0,1,0,1,0
8327,1581,0,0,146,146,0,1,0,1,0
11404,1675,0,0,63,63,0,1,0,1,0
2575,179,0,0,75,75,0,1,0,1,0
4898,183,16417,121,293,223,70,4,1,3,1
10537,1485,0,0,75,75,0,1,0,1,0
1547,1101,0,0,121,121,0,1,0,1,0
1857,183,7199,121,293,223,70,4,0,3,1
2365,1694,0,0,62,62,0,1,0,1,0
214,2327,0,0,145,145,0,1,0,1,0
2777,1484,0,0,62,62,0,1,0,1,0
2257,1640,0,0,62,62,0,1,0,1,0
2902,1694,0,0,62,62,0,1,0,1,0
10400,1694,0,0,91,91,0,1,0,1,0
2514,1694,0,0,62,62,0,1,0,1,0
10470,1694,0,0,90,90,0,1,0,1,0
8274,1372,0,0,152,152,0,1,0,1,0
585,1176,0,0,150,150,0,1,0,1,0
17911,183,25937,121,293,223,70,4,0,3,1
2013,183,7867,121,293,223,70,4,0,3,1
1737,1176,0,0,141,141,0,1,0,1,0
9889,1598,0,0,93,93,0,1,0,1,0
9041,1314,0,0,124,124,0,1,0,1,0
1108,183,4470,121,293,223,70,4,0,3,1
364,1185,0,0,143,143,0,1,0,1,0
11563,1263,0,0,79,79,0,1,0,1,0
2911,1315,0,0,124,124,0,1,0,1,0
9580,1367,0,0,107,107,0,1,0,1,0
913,183,3652,121,293,223,70,4,0,3,1
518,1176,0,0,148,148,0,1,0,1,0
493,1061,0,0,150,150,0,1,0,1,0
10559,1507,0,0,71,71,0,1,0,1,0
16543,1773,0,0,145,145,0,1,0,1,0
588,1176,0,0,150,150,0,1,0,1,0
1913,183,7331,121,293,223,70,4,0,3,1
2848,1694,0,0,62,62,0,1,0,1,0
11138,1610,0,0,62,62,0,1,0,1,0
8182,1614,0,0,146,146,0,1,0,1,0
1354,3095,0,0,142,142,0,1,0,1,0
1038,1127,0,0,144,144,0,1,0,1,0
2671,183,10355,121,293,223,70,4,0,3,1
1208,2959,0,0,140,140,0,1,0,1,0
1995,183,7578,121,293,223,70,4,0,3,1
11497,1684,0,0,62,62,0,1,0,1,0
1041,183,4193,121,293,223,70,4,0,3,1
7250,814,0,0,152,152,0,1,0,1,0
524,1119,0,0,157,157,0,1,0,1,0
2912,1269,0,0,132,132,0,1,0,1,0
1849,983,0,0,144,144,0,1,0,1,0
2831,79,0,0,78,78,0,1,0,1,0
2625,1694,0,0,62,62,0,1,0,1,0
865,1176,0,0,155,155,0,1,0,1,0
1986,183,7725,121,293,223,70,4,0,3,1
1977,891,0,0,62,62,0,1,0,1,0
1971,183,7641,121,293,223,70,4,0,3,1
2010,1292,0,0,124,124,0,1,0,1,0
8139,1811,0,0,131,131,0,1,0,1,0
1642,183,6036,121,293,223,70,4,0,3,1
1719,183,6619,121,293,223,70,4,0,3,1
9289,1635,0,0,113,113,0,1,0,1,0
1610,2799,0,0,122,122,0,1,0,1,0
3489,1083,0,0,101,101,0,1,0,1,0
2024,300,0,0,110,110,0,1,0,1,0
7849,1936,0,0,118,118,0,1,0,1,0
1408,183,4860,121,293,223,70,4,0,3,1
10296,1543,0,0,79,79,0,1,0,1,0
1850,183,7149,121,293,223,70,4,0,3,1
1935,854,0,0,65,65,0,1,0,1,0
2092,183,8407,121,293,223,70,4,0,3,1
956,730,0,0,151,151,0,1,0,1,0
1055,183,4016,121,293,223,70,4,1,3,1
2034,183,7994,121,293,223,70,4,0,3,1
642,2637,0,0,144,144,0,1,0,1,0
2385,1176,0,0,145,145,0,1,0,1,0
3855,586,0,0,146,146,0,1,0,1,0
9454,1595,0,0,116,116,0,1,0,1,0
7635,2532,0,0,90,90,0,1,0,1,0
1601,183,5805,121,293,223,70,4,0,3,1
1121,3095,0,0,141,141,0,1,0,1,0
10197,1543,0,0,77,77,0,1,0,1,0
2557,1176,0,0,146,146,0,1,0,1,0
7026,980,0,0,146,146,0,1,0,1,0
3021,1601,0,0,77,77,0,1,0,1,0
14008,404,0,0,136,136,0,1,0,1,0
2983,1450,0,0,102,102,0,1,0,1,0
10709,1543,0,0,64,64,0,1,0,1,0
7619,2554,0,0,89,89,0,1,0,1,0
10628,1543,0,0,68,68,0,1,0,1,0
1941,183,7479,121,293,223,70,4,0,3,1
1636,1176,0,0,140,140,0,1,0,1,0
2966,1694,0,0,62,62,0,1,0,1,0
2130,1268,0,0,128,128,0,1,0,1,0
11290,1661,0,0,64,64,0,1,0,1,0
12545,183,19641,121,293,223,70,4,0,3,1
1305,1176,0,0,150,150,0,1,0,1,0
81,1465,0,0,152,152,0,1,0,1,0
74,1410,0,0,153,153,0,1,0,1,0
2190,1563,0,0,82,82,0,1,0,1,0
9796,1398,0,0,99,99,0,1,0,1,0
17399,2876,0,0,132,132,0,1,0,1,0
14111,350,0,0,139,139,0,1,0,1,0
1949,958,0,0,90,90,0,1,0,1,0
10035,1701,0,0,70,70,0,1,0,1,0
2902,1694,0,0,62,62,0,1,0,1,0
796,3095,0,0,139,139,0,1,0,1,0
1324,3085,0,0,143,143,0,1,0,1,0
1988,183,7751,121,293,223,70,4,0,3,1
14766,562,0,0,145,145,0,1,0,1,0
19038,2826,0,0,130,130,0,1,0,1,0
2038,3095,0,0,153,153,0,1,0,1,0
2060,183,8241,121,293,223,70,4,0,3,1
12633,1912,0,0,81,81,0,1,0,1,0
10485,1543,0,0,69,69,0,1,0,1,0
739,2072,0,0,148,148,0,1,0,1,0
3281,183,11390,121,293,223,70,4,0,3,1
1103,2940,0,0,143,143,0,1,0,1,0
19078,1543,0,0,62,62,0,1,0,1,0
246,2044,0,0,144,144,0,1,0,1,0
4550,362,0,0,146,146,0,1,0,1,0
1030,183,3841,121,293,223,70,4,1,3,1
7470,2796,0,0,77,77,0,1,0,1,0
794,372,2897,97,264,207,56,3,0,2,0
435,1046,467,15,162,153,9,1,0,1,0
21397,534,21107,89,233,181,51,3,0,2,0
1423,183,4940,121,293,223,70,4,1,3,1
3789,183,12895,121,293,223,70,4,0,3,1
8908,1658,0,0,126,126,0,1,0,1,0
320,2521,0,0,143,143,0,1,0,1,0
8361,2518,0,0,65,65,0,1,0,1,0
4226,183,14189,121,293,223,70,4,0,3,1
1882,183,7424,121,293,223,70,4,0,3,1
8774,1446,0,0,145,145,0,1,0,1,0
4869,183,16381,121,293,223,70,4,1,3,1
1762,183,6776,121,293,223,70,4,0,3,1
1917,1473,0,0,94,94,0,1,0,1,0
1743,739,0,0,146,146,0,1,0,1,0
13872,2163,0,0,89,89,0,1,0,1,0
8327,1562,0,0,146,146,0,1,0,1,0
10731,1543,0,0,63,63,0,1,0,1,0
1901,183,7331,121,293,223,70,4,0,3,1
2849,1229,0,0,139,139,0,1,0,1,0
8249,1217,0,0,156,156,0,1,0,1,0
10298,1532,0,0,74,74,0,1,0,1,0
2035,1329,0,0,119,119,0,1,0,1,0
10492,1694,0,0,89,89,0,1,0,1,0
8828,1543,0,0,129,129,0,1,0,1,0
721,3095,0,0,139,139,0,1,0,1,0
11353,1694,0,0,67,67,0,1,0,1,0
2054,1241,0,0,132,132,0,1,0,1,0
135,1061,0,0,152,152,0,1,0,1,0
10081,1494,0,0,83,83,0,1,0,1,0
2142,404,0,0,88,88,0,1,0,1,0
1657,1031,0,0,105,105,0,1,0,1,0
7497,2617,0,0,83,83,0,1,0,1,0
2825,1694,0,0,62,62,0,1,0,1,0
2263,947,0,0,89,89,0,1,0,1,0
19945,2389,0,0,107,107,0,1,0,1,0
748,3095,0,0,139,139,0,1,0,1,0
3567,260,0,0,116,116,0,1,0,1,0
2913,1694,0,0,62,62,0,1,0,1,0
1114,183,4004,121,293,223,70,4,1,3,1
13066,898,0,0,107,107,0,1,0,1,0
2398,175,0,0,62,62,0,1,0,1,0
1976,1240,0,0,132,132,0,1,0,1,0
1354,3095,0,0,143,143,0,1,0,1,0
1784,663,0,0,110,110,0,1,0,1,0
1587,183,5810,121,293,223,70,4,0,3,1
1716,3095,0,0,149,149,0,1,0,1,0
928,2789,0,0,141,141,0,1,0,1,0
1669,568,0,0,147,147,0,1,0,1,0
1953,183,7586,121,293,223,70,4,0,3,1
430,2497,0,0,144,144,0,1,0,1,0
8623,1230,0,0,142,142,0,1,0,1,0
8134,1941,0,0,130,130,0,1,0,1,0
7953,1735,0,0,128,128,0,1,0,1,0
11025,1587,0,0,62,62,0,1,0,1,0
4555,183,15992,121,293,223,70,4,1,3,1
8243,1662,0,0,139,139,0,1,0,1,0
492,1112,0,0,157,157,0,1,0,1,0
2589,1694,0,0,62,62,0,1,0,1,0
999,3095,0,0,139,139,0,1,0,1,0
1761,1176,0,0,141,141,0,1,0,1,0
2414,1254,0,0,62,62,0,1,0,1,0
2031,1221,0,0,135,135,0,1,0,1,0
2173,1850,0,0,71,71,0,1,0,1,0
2433,1006,0,0,104,104,0,1,0,1,0
10660,1652,0,0,85,85,0,1,0,1,0
2273,1873,0,0,74,74,0,1,0,1,0
3099,1629,0,0,66,66,0,1,0,1,0
1525,1116,0,0,125,125,0,1,0,1,0
1461,441,902,30,184,166,17,1,0,1,0
4529,183,15959,121,293,223,70,4,1,3,1
10071,1437,0,0,89,89,0,1,0,1,0
2219,1605,0,0,75,75,0,1,0,1,0
2387,78,0,0,74,74,0,1,0,1,0
4308,387,0,0,146,146,0,1,0,1,0
10709,1528,0,0,65,65,0,1,0,1,0
3554,257,0,0,115,115,0,1,0,1,0
1671,1022,0,0,103,103,0,1,0,1,0
1606,1176,0,0,140,140,0,1,0,1,0
150,1068,0,0,151,151,0,1,0,1,0
1685,563,0,0,138,138,0,1,0,1,0
1452,183,5099,121,293,223,70,4,1,3,1
1881,1056,0,0,143,143,0,1,0,1,0
2027,1024,0,0,62,62,0,1,0,1,0
1968,183,7761,121,293,223,70,4,0,3,1
2915,1186,0,0,146,146,0,1,0,1,0
8381,1690,0,0,144,144,0,1,0,1,0
2018,1000,0,0,62,62,0,1,0,1,0
1457,671,0,0,149,149,0,1,0,1,0
7203,797,0,0,152,152,0,1,0,1,0
19369,2667,0,0,122,122,0,1,0,1,0
1922,3095,0,0,153,153,0,1,0,1,0
1776,183,6665,121,293,223,70,4,0,3,1
1570,767,0,0,144,144,0,1,0,1,0
1474,183,5191,121,293,223,70,4,0,3,1
3272,183,11941,121,293,223,70,4,0,3,1
858,467,2552,86,253,204,49,3,0,2,0
8424,1543,0,0,142,142,0,1,0,1,0
2420,2719,0,0,132,132,0,1,0,1,0
1937,1119,0,0,129,129,0,1,0,1,0
519,2817,0,0,141,141,0,1,0,1,0
1396,183,4804,121,293,223,70,4,1,3,1
2007,972,0,0,62,62,0,1,0,1,0
106,1047,0,0,153,153,0,1,0,1,0
3007,1694,0,0,62,62,0,1,0,1,0
9317,1620,0,0,109,109,0,1,0,1,0
1996,782,0,0,62,62,0,1,0,1,0
2939,1651,0,0,64,64,0,1,0,1,0
1581,183,5753,121,293,223,70,4,0,3,1
1809,183,6936,121,293,223,70,4,0,3,1
16865,1993,0,0,145,145,0,1,0,1,0
1779,3095,0,0,152,152,0,1,0,1,0
240,2083,0,0,144,144,0,1,0,1,0
2948,1619,0,0,62,62,0,1,0,1,0
16413,183,24898,121,293,223,70,4,0,3,1
173,2130,0,0,146,146,0,1,0,1,0
19,1015,0,0,156,156,0,1,0,1,0
2740,1114,0,0,132,132,0,1,0,1,0
1357,3095,0,0,142,142,0,1,0,1,0
1704,183,6411,121,293,223,70,4,0,3,1
6345,1404,0,0,111,111,0,1,0,1,0
947,3095,0,0,140,140,0,1,0,1,0
12894,1964,0,0,84,84,0,1,0,1,0
758,2713,0,0,144,144,0,1,0,1,0
8153,1143,0,0,156,156,0,1,0,1,0
10442,1543,0,0,70,70,0,1,0,1,0
5545,263,0,0,146,146,0,1,0,1,0
4118,437,0,0,143,143,0,1,0,1,0
1520,183,5414,121,293,223,70,4,0,3,1
1135,678,0,0,150,150,0,1,0,1,0
1842,913,0,0,78,78,0,1,0,1,0
7486,2638,0,0,82,82,0,1,0,1,0
6359,1429,0,0,110,110,0,1,0,1,0
10280,1549,0,0,74,74,0,1,0,1,0
1987,183,7728,121,293,223,70,4,0,3,1
2787,1933,0,0,78,78,0,1,0,1,0
1377,183,4715,121,293,223,70,4,0,3,1
4774,183,16264,121,293,223,70,4,1,3,1
10988,1667,0,0,76,76,0,1,0,1,0
282,2464,0,0,144,144,0,1,0,1,0
13704,471,0,0,130,130,0,1,0,1,0
8559,1553,0,0,139,139,0,1,0,1,0
1351,183,4584,121,293,223,70,4,1,3,1
8764,1563,0,0,134,134,0,1,0,1,0
1852,3095,0,0,153,153,0,1,0,1,0
3014,1694,0,0,62,62,0,1,0,1,0
1517,923,0,0,142,142,0,1,0,1,0
4912,183,16434,121,293,223,70,4,1,3,1
14165,322,0,0,140,140,0,1,0,1,0
1908,1120,0,0,143,143,0,1,0,1,0
19867,1543,0,0,62,62,0,1,0,1,0
1604,668,0,0,146,146,0,1,0,1,0
1529,183,5460,121,293,223,70,4,0,3,1
2484,183,9229,121,293,223,70,4,0,3,1
9359,1631,0,0,111,111,0,1,0,1,0
2700,1176,0,0,146,146,0,1,0,1,0
1765,183,6969,121,293,223,70,4,0,3,1
10715,1025,0,0,145,145,0,1,0,1,0
8327,1669,0,0,146,146,0,1,0,1,0
2917,1181,0,0,147,147,0,1,0,1,0
17582,1543,0,0,62,62,0,1,0,1,0
4136,183,14838,121,293,223,70,4,0,3,1
1502,183,5339,121,293,223,70,4,0,3,1
1529,1113,0,0,124,124,0,1,0,1,0
600,1074,0,0,149,149,0,1,0,1,0
3882,337,0,0,132,132,0,1,0,1,0
1605,183,5851,121,293,223,70,4,0,3,1
2510,1176,0,0,145,145,0,1,0,1,0
1084,1176,0,0,148,148,0,1,0,1,0
1949,950,0,0,88,88,0,1,0,1,0
4547,183,15024,121,293,223,70,4,1,3,1
17616,2919,0,0,135,135,0,1,0,1,0
12310,1293,0,0,84,84,0,1,0,1,0
9447,1384,0,0,108,108,0,1,0,1,0
1724,3095,0,0,149,149,0,1,0,1,0
2878,1675,0,0,62,62,0,1,0,1,0
742,1170,0,0,157,157,0,1,0,1,0
1449,183,5068,121,293,223,70,4,1,3,1
15543,183,24169,121,293,223,70,4,0,3,1
2958,1694,0,0,62,62,0,1,0,1,0
1634,3095,0,0,143,143,0,1,0,1,0
620,1076,0,0,149,149,0,1,0,1,0
2665,1694,0,0,62,62,0,1,0,1,0
2413,1433,0,0,102,102,0,1,0,1,0
1486,1176,0,0,139,139,0,1,0,1,0
1165,3095,0,0,141,141,0,1,0,1,0
18370,960,0,0,99,99,0,1,0,1,0
1556,183,6016,121,293,223,70,4,0,3,1
1242,3095,0,0,142,142,0,1,0,1,0
10770,1543,0,0,62,62,0,1,0,1,0
615,2960,0,0,140,140,0,1,0,1,0
8327,1652,0,0,146,146,0,1,0,1,0
1977,891,0,0,62,62,0,1,0,1,0
3461,833,0,0,147,147,0,1,0,1,0
2518,183,8513,121,293,223,70,4,1,3,1
10952,1543,0,0,71,71,0,1,0,1,0
10677,1439,0,0,77,77,0,1,0,1,0
4937,183,16465,121,293,223,70,4,1,3,1
10349,1477,0,0,79,79,0,1,0,1,0
7218,183,14269,121,293,223,70,4,0,3,1
6747,2116,0,0,89,89,0,1,0,1,0
1589,1176,0,0,140,140,0,1,0,1,0
2224,3095,0,0,158,158,0,1,0,1,0
463,993,657,22,170,157,12,1,0,1,0
2561,1387,0,0,62,62,0,1,0,1,0
10479,1543,0,0,73,73,0,1,0,1,0
6207,435,0,0,148,148,0,1,0,1,0
6707,2044,0,0,92,92,0,1,0,1,0
19050,2820,0,0,130,130,0,1,0,1,0
2771,754,0,0,117,117,0,1,0,1,0
33,998,0,0,156,156,0,1,0,1,0
18806,183,25955,121,293,223,70,4,0,3,1
8313,1608,0,0,147,147,0,1,0,1,0
9075,1638,0,0,118,118,0,1,0,1,0
2523,1694,0,0,62,62,0,1,0,1,0
837,634,1953,66,231,193,38,2,0,2,0
2118,183,7456,121,293,223,70,4,1,3,1
14248,278,0,0,143,143,0,1,0,1,0
3252,1328,0,0,85,85,0,1,0,1,0
17907,2978,0,0,138,138,0,1,0,1,0
4997,318,0,0,146,146,0,1,0,1,0
1680,183,6222,121,293,223,70,4,0,3,1
8976,1280,0,0,129,129,0,1,0,1,0
13647,183,20373,121,293,223,70,4,0,3,1
2568,1457,0,0,101,101,0,1,0,1,0
1554,183,5592,121,293,223,70,4,0,3,1
1766,183,6654,121,293,223,70,4,0,3,1
1099,3095,0,0,139,139,0,1,0,1,0
2849,1540,0,0,62,62,0,1,0,1,0
1760,183,6621,121,293,223,70,4,0,3,1
1101,1176,0,0,147,147,0,1,0,1,0
13078,891,0,0,108,108,0,1,0,1,0
1991,183,7775,121,293,223,70,4,0,3,1
1984,3095,0,0,152,152,0,1,0,1,0
963,728,0,0,151,151,0,1,0,1,0
8327,1677,0,0,146,146,0,1,0,1,0
1387,3095,0,0,140,140,0,1,0,1,0
766,3095,0,0,139,139,0,1,0,1,0
4718,183,16194,121,293,223,70,4,1,3,1
3846,714,0,0,125,125,0,1,0,1,0
18964,2862,0,0,132,132,0,1,0,1,0
1013,1176,0,0,140,140,0,1,0,1,0
2704,1694,0,0,62,62,0,1,0,1,0
504,2795,0,0,141,141,0,1,0,1,0
2034,183,7991,121,293,223,70,4,0,3,1
274,2453,0,0,144,144,0,1,0,1,0
2534,1362,0,0,62,62,0,1,0,1,0
2267,1687,0,0,62,62,0,1,0,1,0
2929,1694,0,0,62,62,0,1,0,1,0
2805,1694,0,0,62,62,0,1,0,1,0
13124,686,0,0,116,116,0,1,0,1,0
4851,530,0,0,146,146,0,1,0,1,0
1254,3095,0,0,139,139,0,1,0,1,0
2157,183,8701,121,293,223,70,4,0,3,1
18224,183,25215,121,293,223,70,4,0,3,1
1936,853,0,0,65,65,0,1,0,1,0
9406,183,19780,121,293,223,70,4,0,3,1
7212,2940,0,0,65,65,0,1,0,1,0
421,1071,377,12,158,151,7,1,0,1,0
14063,375,0,0,137,137,0,1,0,1,0
4888,183,16405,121,293,223,70,4,1,3,1
8103,1981,0,0,128,128,0,1,0,1,0
1700,183,6324,121,293,223,70,4,0,3,1
1244,183,4530,121,293,223,70,4,1,3,1
4764,559,0,0,146,146,0,1,0,1,0
1979,183,7686,121,293,223,70,4,0,3,1
1542,850,0,0,143,143,0,1,0,1,0
5731,269,0,0,146,146,0,1,0,1,0
3003,1528,0,0,89,89,0,1,0,1,0
1606,183,5859,121,293,223,70,4,0,3,1
712,525,2345,79,241,195,45,2,0,2,0
2251,396,0,0,62,62,0,1,0,1,0
2673,2176,0,0,95,95,0,1,0,1,0
1959,1215,0,0,136,136,0,1,0,1,0
2001,2151,0,0,87,87,0,1,0,1,0
1453,183,5089,121,293,223,70,4,1,3,1
2464,1694,0,0,62,62,0,1,0,1,0
13869,477,0,0,131,131,0,1,0,1,0
1623,183,6265,121,293,223,70,4,0,3,1
2003,2148,0,0,86,86,0,1,0,1,0
2148,1500,0,0,92,92,0,1,0,1,0
296,1141,0,0,145,145,0,1,0,1,0
2027,183,7956,121,293,223,70,4,0,3,1
2676,183,9864,121,293,223,70,4,0,3,1
1724,2519,0,0,109,109,0,1,0,1,0
142,1906,0,0,148,148,0,1,0,1,0
14002,183,21110,121,293,223,70,4,0,3,1
11280,1368,0,0,73,73,0,1,0,1,0
413,1085,324,10,156,150,6,1,0,1,0
2482,64,0,0,66,66,0,1,0,1,0
11021,1586,0,0,62,62,0,1,0,1,0
1800,183,6780,121,293,223,70,4,0,3,1
1946,998,0,0,100,100,0,1,0,1,0
1910,183,7535,121,293,223,70,4,0,3,1
532,1665,0,0,151,151,0,1,0,1,0
8017,2092,0,0,121,121,0,1,0,1,0
2829,1694,0,0,62,62,0,1,0,1,0
10434,1489,0,0,75,75,0,1,0,1,0
1570,1261,0,0,126,126,0,1,0,1,0
11982,1108,0,0,89,89,0,1,0,1,0
2720,1439,0,0,62,62,0,1,0,1,0
4917,183,16440,121,293,223,70,4,1,3,1
8302,1725,0,0,144,144,0,1,0,1,0
5220,296,0,0,146,146,0,1,0,1,0
1808,183,6861,121,293,223,70,4,0,3,1
718,2744,0,0,142,142,0,1,0,1,0
2286,461,0,0,93,93,0,1,0,1,0
506,1176,0,0,147,147,0,1,0,1,0
377,1085,0,0,157,157,0,1,0,1,0
1553,3095,0,0,141,141,0,1,0,1,0
19749,183,27335,121,293,223,70,4,0,3,1
1969,183,7765,121,293,223,70,4,0,3,1
1520,1176,0,0,139,139,0,1,0,1,0
55,1272,0,0,154,154,0,1,0,1,0
10436,1543,0,0,70,70,0,1,0,1,0
4742,343,0,0,146,146,0,1,0,1,0
1601,676,0,0,145,145,0,1,0,1,0
1493,1135,0,0,129,129,0,1,0,1,0
1137,3095,0,0,139,139,0,1,0,1,0
1833,183,6942,121,293,223,70,4,0,3,1
2900,1640,0,0,70,70,0,1,0,1,0
1215,1176,0,0,144,144,0,1,0,1,0
1514,2833,0,0,127,127,0,1,0,1,0
3825,183,13678,121,293,223,70,4,0,3,1
8288,1453,0,0,151,151,0,1,0,1,0
2312,1694,0,0,62,62,0,1,0,1,0
19649,2531,0,0,114,114,0,1,0,1,0
7500,2757,0,0,80,80,0,1,0,1,0
1684,561,0,0,138,138,0,1,0,1,0
5921,183,12198,121,293,223,70,4,0,3,1
8284,1355,0,0,151,151,0,1,0,1,0
2002,183,7830,121,293,223,70,4,0,3,1
1676,183,6204,121,293,223,70,4,0,3,1
1459,183,5109,121,293,223,70,4,0,3,1
1394,183,4797,121,293,223,70,4,1,3,1
8327,1543,0,0,146,146,0,1,0,1,0
1622,183,5935,121,293,223,70,4,0,3,1
2234,172,0,0,89,89,0,1,0,1,0
4230,737,0,0,147,147,0,1,0,1,0
3909,682,0,0,127,127,0,1,0,1,0
10722,1543,0,0,63,63,0,1,0,1,0
3253,964,0,0,147,147,0,1,0,1,0
11497,1687,0,0,62,62,0,1,0,1,0
844,3095,0,0,139,139,0,1,0,1,0
1525,183,6037,121,293,223,70,4,0,3,1
2508,1272,0,0,62,62,0,1,0,1,0
6666,726,0,0,146,146,0,1,0,1,0
2275,1819,0,0,70,70,0,1,0,1,0
1319,183,4426,121,293,223,70,4,1,3,1
1618,2677,0,0,118,118,0,1,0,1,0
10395,1543,0,0,71,71,0,1,0,1,0
1646,3095,0,0,144,144,0,1,0,1,0
833,1176,0,0,155,155,0,1,0,1,0
20334,2201,0,0,97,97,0,1,0,1,0
2934,1252,0,0,135,135,0,1,0,1,0
4135,417,0,0,145,145,0,1,0,1,0
379,1176,0,0,143,143,0,1,0,1,0
2678,1694,0,0,62,62,0,1,0,1,0
2906,1458,0,0,101,101,0,1,0,1,0
4194,183,14828,121,293,223,70,4,1,3,1
1943,1029,0,0,107,107,0,1,0,1,0
2076,3095,0,0,154,154,0,1,0,1,0
825,1176,0,0,155,155,0,1,0,1,0
1449,183,5059,121,293,223,70,4,0,3,1
10325,1545,0,0,73,73,0,1,0,1,0
11818,787,0,0,145,145,0,1,0,1,0
2099,1216,0,0,62,62,0,1,0,1,0
16344,2686,0,0,125,125,0,1,0,1,0
8327,1614,0,0,146,146,0,1,0,1,0
5957,393,0,0,146,146,0,1,0,1,0
2485,2580,0,0,123,123,0,1,0,1,0
1377,183,5458,121,293,223,70,4,0,3,1
9318,1543,0,0,112,112,0,1,0,1,0
2909,1387,0,0,112,112,0,1,0,1,0
4466,183,14969,121,293,223,70,4,0,3,1
1844,912,0,0,78,78,0,1,0,1,0
7982,2136,0,0,118,118,0,1,0,1,0
16513,2697,0,0,121,121,0,1,0,1,0
1911,1176,0,0,142,142,0,1,0,1,0
1763,183,6718,121,293,223,70,4,0,3,1
3264,1059,0,0,147,147,0,1,0,1,0
1499,3095,0,0,140,140,0,1,0,1,0
1722,3095,0,0,149,149,0,1,0,1,0
9656,1543,0,0,101,101,0,1,0,1,0
62,1013,0,0,157,157,0,1,0,1,0
3453,1121,0,0,99,99,0,1,0,1,0
8832,1543,0,0,127,127,0,1,0,1,0
7323,2953,0,0,66,66,0,1,0,1,0
2728,1694,0,0,62,62,0,1,0,1,0
2287,1694,0,0,62,62,0,1,0,1,0
2181,918,0,0,82,82,0,1,0,1,0
2373,1694,0,0,62,62,0,1,0,1,0
1120,183,4410,121,293,223,70,4,0,3,1
3501,808,0,0,147,147,0,1,0,1,0
2283,1694,0,0,62,62,0,1,0,1,0
1848,183,7061,121,293,223,70,4,0,3,1
2107,1257,0,0,130,130,0,1,0,1,0
1960,2219,0,0,90,90,0,1,0,1,0
1190,183,4385,121,293,223,70,4,1,3,1
1513,935,0,0,142,142,0,1,0,1,0
672,1154,0,0,157,157,0,1,0,1,0
8304,1446,0,0,148,148,0,1,0,1,0
1336,183,4508,121,293,223,70,4,1,3,1
3866,183,13813,121,293,223,70,4,0,3,1
8984,1304,0,0,127,127,0,1,0,1,0
4092,183,14708,121,293,223,70,4,0,3,1
926,2823,0,0,143,143,0,1,0,1,0
2587,1060,0,0,118,118,0,1,0,1,0
1269,3095,0,0,142,142,0,1,0,1,0
1586,3095,0,0,142,142,0,1,0,1,0
1655,183,6076,121,293,223,70,4,0,3,1
1684,3095,0,0,149,149,0,1,0,1,0
1688,1012,0,0,101,101,0,1,0,1,0
705,1161,0,0,157,157,0,1,0,1,0
301,1640,0,0,143,143,0,1,0,1,0
154,1990,0,0,148,148,0,1,0,1,0
17741,2590,0,0,145,145,0,1,0,1,0
9881,1578,0,0,89,89,0,1,0,1,0
8327,1631,0,0,146,146,0,1,0,1,0
10002,1592,0,0,89,89,0,1,0,1,0
1712,590,0,0,130,130,0,1,0,1,0
10704,1543,0,0,65,65,0,1,0,1,0
3007,1694,0,0,62,62,0,1,0,1,0
556,1176,0,0,149,149,0,1,0,1,0
9522,1543,0,0,105,105,0,1,0,1,0
2945,1694,0,0,62,62,0,1,0,1,0
1967,183,7623,121,293,223,70,4,0,3,1
2542,1694,0,0,62,62,0,1,0,1,0
9270,1587,0,0,121,121,0,1,0,1,0
2981,1694,0,0,62,62,0,1,0,1,0
2733,1111,0,0,131,131,0,1,0,1,0
1691,183,6250,121,293,223,70,4,0,3,1
1561,793,0,0,144,144,0,1,0,1,0
9780,1543,0,0,93,93,0,1,0,1,0
8790,1543,0,0,130,130,0,1,0,1,0
4933,183,16460,121,293,223,70,4,1,3,1
161,2041,0,0,147,147,0,1,0,1,0
1227,3095,0,0,142,142,0,1,0,1,0
2247,2971,0,0,150,150,0,1,0,1,0
2067,1133,0,0,62,62,0,1,0,1,0
1703,183,6306,121,293,223,70,4,0,3,1
1608,183,5919,121,293,223,70,4,0,3,1
1115,684,0,0,150,150,0,1,0,1,0
7922,2121,0,0,113,113,0,1,0,1,0
2274,1856,0,0,73,73,0,1,0,1,0
1627,599,0,0,147,147,0,1,0,1,0
1387,183,4762,121,293,223,70,4,1,3,1
1944,1025,0,0,106,106,0,1,0,1,0
10888,1610,0,0,67,67,0,1,0,1,0
491,1176,0,0,147,147,0,1,0,1,0
1297,3095,0,0,139,139,0,1,0,1,0
654,1176,0,0,153,153,0,1,0,1,0
4055,511,0,0,138,138,0,1,0,1,0
1858,183,7115,121,293,223,70,4,0,3,1
2216,1074,0,0,62,62,0,1,0,1,0
4138,183,14843,121,293,223,70,4,0,3,1
1566,489,405,13,164,156,7,1,0,1,0
1987,183,7579,121,293,223,70,4,0,3,1
759,1432,0,0,154,154,0,1,0,1,0
2991,1481,0,0,97,97,0,1,0,1,0
1421,183,5521,121,293,223,70,4,0,3,1
8280,1338,0,0,152,152,0,1,0,1,0
1784,833,0,0,145,145,0,1,0,1,0
909,3095,0,0,140,140,0,1,0,1,0
1349,183,5477,121,293,223,70,4,0,3,1
1917,3095,0,0,154,154,0,1,0,1,0
56,1280,0,0,154,154,0,1,0,1,0
2718,598,0,0,105,105,0,1,0,1,0
2257,183,9266,121,293,223,70,4,0,3,1
1405,709,0,0,150,150,0,1,0,1,0
10555,1543,0,0,67,67,0,1,0,1,0
4740,183,16222,121,293,223,70,4,1,3,1
2037,183,8008,121,293,223,70,4,0,3,1
3029,1635,0,0,71,71,0,1,0,1,0
34,1006,0,0,157,157,0,1,0,1,0
17175,2830,0,0,130,130,0,1,0,1,0
7154,2836,0,0,68,68,0,1,0,1,0
8753,2327,0,0,66,66,0,1,0,1,0
15316,937,0,0,145,145,0,1,0,1,0
5723,265,0,0,146,146,0,1,0,1,0
1594,183,5776,121,293,223,70,4,0,3,1
1906,787,0,0,76,76,0,1,0,1,0
2782,1129,0,0,135,135,0,1,0,1,0
8698,1543,0,0,133,133,0,1,0,1,0
1564,593,0,0,148,148,0,1,0,1,0
1941,1061,0,0,115,115,0,1,0,1,0
10890,1559,0,0,62,62,0,1,0,1,0
4097,781,0,0,147,147,0,1,0,1,0
2113,1446,0,0,100,100,0,1,0,1,0
2064,183,8264,121,293,223,70,4,0,3,1
2205,1500,0,0,62,62,0,1,0,1,0
50,1241,0,0,154,154,0,1,0,1,0
2479,1530,0,0,89,89,0,1,0,1,0
4989,183,16530,121,293,223,70,4,1,3,1
677,2636,0,0,142,142,0,1,0,1,0
3986,504,0,0,146,146,0,1,0,1,0
5912,637,0,0,134,134,0,1,0,1,0
8300,1425,0,0,149,149,0,1,0,1,0
11754,1584,0,0,68,68,0,1,0,1,0
2136,1271,0,0,128,128,0,1,0,1,0
212,2289,0,0,144,144,0,1,0,1,0
11788,1567,0,0,69,69,0,1,0,1,0
1682,560,0,0,139,139,0,1,0,1,0
1723,183,6407,121,293,223,70,4,0,3,1
3686,183,12748,121,293,223,70,4,0,3,1
11357,1733,0,0,80,80,0,1,0,1,0
2679,485,0,0,97,97,0,1,0,1,0
10238,183,20387,121,293,223,70,4,0,3,1
2809,73,0,0,77,77,0,1,0,1,0
10526,1543,0,0,71,71,0,1,0,1,0
13304,183,22498,121,293,223,70,4,0,3,1
7976,2145,0,0,118,118,0,1,0,1,0
765,1176,0,0,156,156,0,1,0,1,0
1632,183,6454,121,293,223,70,4,0,3,1
3037,1694,0,0,62,62,0,1,0,1,0
877,1096,0,0,155,155,0,1,0,1,0
464,1057,0,0,151,151,0,1,0,1,0
2509,1273,0,0,62,62,0,1,0,1,0
14495,378,0,0,145,145,0,1,0,1,0
2077,1158,0,0,62,62,0,1,0,1,0
2085,3095,0,0,156,156,0,1,0,1,0
473,1788,0,0,150,150,0,1,0,1,0
1654,1176,0,0,140,140,0,1,0,1,0
1321,1176,0,0,141,141,0,1,0,1,0
14111,2259,0,0,105,105,0,1,0,1,0
7992,2698,0,0,64,64,0,1,0,1,0
5803,309,0,0,146,146,0,1,0,1,0
8904,1651,0,0,124,124,0,1,0,1,0
11234,1256,0,0,88,88,0,1,0,1,0
2172,183,8785,121,293,223,70,4,0,3,1
9684,1543,0,0,96,96,0,1,0,1,0
11201,1623,0,0,62,62,0,1,0,1,0
1384,3095,0,0,141,141,0,1,0,1,0
1172,2985,0,0,143,143,0,1,0,1,0
1563,183,5486,121,293,223,70,4,1,3,1
14011,345,0,0,139,139,0,1,0,1,0
2093,1176,0,0,143,143,0,1,0,1,0
1818,1176,0,0,144,144,0,1,0,1,0
1401,3095,0,0,140,140,0,1,0,1,0
1244,1176,0,0,144,144,0,1,0,1,0
5721,262,0,0,146,146,0,1,0,1,0
8327,1571,0,0,146,146,0,1,0,1,0
785,1040,487,16,175,165,9,1,0,1,0
1134,183,4231,121,293,223,70,4,1,3,1
916,3095,0,0,139,139,0,1,0,1,0
204,2345,0,0,144,144,0,1,0,1,0
9645,1419,0,0,100,100,0,1,0,1,0
1353,183,4593,121,293,223,70,4,1,3,1
599,1176,0,0,151,151,0,1,0,1,0
2010,2093,0,0,85,85,0,1,0,1,0
1826,422,0,0,130,130,0,1,0,1,0
1950,346,0,0,118,118,0,1,0,1,0
8292,1738,0,0,143,143,0,1,0,1,0
1845,725,0,0,93,93,0,1,0,1,0
4008,183,14167,121,293,223,70,4,1,3,1
1745,183,6893,121,293,223,70,4,0,3,1
1211,183,4813,121,293,223,70,4,0,3,1
10852,1551,0,0,62,62,0,1,0,1,0
1453,183,5095,121,293,223,70,4,0,3,1
2729,1539,0,0,62,62,0,1,0,1,0
2355,1176,0,0,145,145,0,1,0,1,0
2108,183,7981,121,293,223,70,4,0,3,1
10063,1588,0,0,87,87,0,1,0,1,0
2936,1694,0,0,62,62,0,1,0,1,0
8302,1530,0,0,146,146,0,1,0,1,0
17278,2274,0,0,145,145,0,1,0,1,0
823,740,1569,53,216,185,30,2,0,1,0
1599,1176,0,0,140,140,0,1,0,1,0
410,2655,0,0,142,142,0,1,0,1,0
2783,1283,0,0,130,130,0,1,0,1,0
2201,3095,0,0,158,158,0,1,0,1,0
13371,738,0,0,116,116,0,1,0,1,0
5691,249,0,0,146,146,0,1,0,1,0
715,2820,0,0,141,141,0,1,0,1,0
2007,183,7963,121,293,223,70,4,0,3,1
8306,1454,0,0,148,148,0,1,0,1,0
9951,1595,0,0,91,91,0,1,0,1,0
1932,183,7435,121,293,223,70,4,0,3,1
7405,2861,0,0,72,72,0,1,0,1,0
21397,532,21143,89,233,181,52,3,0,2,0
1795,674,0,0,107,107,0,1,0,1,0
9126,1302,0,0,124,124,0,1,0,1,0
15004,2430,0,0,113,113,0,1,0,1,0
2349,1694,0,0,62,62,0,1,0,1,0
7193,794,0,0,152,152,0,1,0,1,0
8523,1216,0,0,146,146,0,1,0,1,0
8002,2693,0,0,64,64,0,1,0,1,0
4300,183,15254,121,293,223,70,4,0,3,1
3180,183,11229,121,293,223,70,4,1,3,1
7575,2902,0,0,62,62,0,1,0,1,0
7738,2151,0,0,107,107,0,1,0,1,0
7404,2796,0,0,74,74,0,1,0,1,0
10677,1583,0,0,69,69,0,1,0,1,0
4554,362,0,0,146,146,0,1,0,1,0
707,3095,0,0,139,139,0,1,0,1,0
2116,183,8471,121,293,223,70,4,0,3,1
5281,290,0,0,146,146,0,1,0,1,0
1651,2731,0,0,119,119,0,1,0,1,0
7547,2657,0,0,83,83,0,1,0,1,0
1688,183,6267,121,293,223,70,4,0,3,1
2531,183,9987,121,293,223,70,4,0,3,1
3912,183,14175,121,293,223,70,4,0,3,1
18389,3032,0,0,145,145,0,1,0,1,0
2912,1272,0,0,131,131,0,1,0,1,0
1887,183,7205,121,293,223,70,4,0,3,1
1854,183,7040,121,293,223,70,4,0,3,1
1555,1176,0,0,139,139,0,1,0,1,0
11512,1692,0,0,62,62,0,1,0,1,0
7424,2833,0,0,73,73,0,1,0,1,0
2408,1397,0,0,108,108,0,1,0,1,0
2165,1394,0,0,62,62,0,1,0,1,0
2233,1575,0,0,62,62,0,1,0,1,0
518,1695,0,0,151,151,0,1,0,1,0
10604,183,20482,121,293,223,70,4,0,3,1
2806,183,10892,121,293,223,70,4,0,3,1
2875,1694,0,0,62,62,0,1,0,1,0
1420,3095,0,0,139,139,0,1,0,1,0
1028,1126,0,0,144,144,0,1,0,1,0
872,357,2950,99,269,211,57,3,0,2,0
8134,1386,0,0,146,146,0,1,0,1,0
7669,2539,0,0,93,93,0,1,0,1,0
1933,1169,0,0,141,141,0,1,0,1,0
2524,1354,0,0,62,62,0,1,0,1,0
1428,1176,0,0,139,139,0,1,0,1,0
15719,2536,0,0,115,115,0,1,0,1,0
15768,2576,0,0,120,120,0,1,0,1,0
13461,1665,0,0,62,62,0,1,0,1,0
3674,286,0,0,121,121,0,1,0,1,0
1238,3095,0,0,139,139,0,1,0,1,0
2127,1292,0,0,62,62,0,1,0,1,0
2100,183,8355,121,293,223,70,4,0,3,1
4409,376,0,0,146,146,0,1,0,1,0
1947,977,0,0,95,95,0,1,0,1,0
87,1505,0,0,152,152,0,1,0,1,0
9834,1543,0,0,91,91,0,1,0,1,0
2001,183,7808,121,293,223,70,4,0,3,1
4166,183,14926,121,293,223,70,4,0,3,1
9514,1605,0,0,102,102,0,1,0,1,0
410,1093,0,0,157,157,0,1,0,1,0
991,2827,0,0,141,141,0,1,0,1,0
986,183,3757,121,293,223,70,4,1,3,1
3359,1027,0,0,147,147,0,1,0,1,0
8246,1197,0,0,156,156,0,1,0,1,0
2121,1176,0,0,143,143,0,1,0,1,0
1627,183,5961,121,293,223,70,4,0,3,1
1429,183,4970,121,293,223,70,4,1,3,1
11193,1621,0,0,62,62,0,1,0,1,0
1759,777,0,0,146,146,0,1,0,1,0
7383,2995,0,0,62,62,0,1,0,1,0
2312,1694,0,0,62,62,0,1,0,1,0
19272,183,26954,121,293,223,70,4,0,3,1
711,2964,0,0,140,140,0,1,0,1,0
10517,1543,0,0,68,68,0,1,0,1,0
15240,885,0,0,145,145,0,1,0,1,0
2142,1333,0,0,62,62,0,1,0,1,0
2270,2025,0,0,84,84,0,1,0,1,0
4080,787,0,0,147,147,0,1,0,1,0
2200,473,0,0,62,62,0,1,0,1,0
10164,1543,0,0,83,83,0,1,0,1,0
9991,183,20025,121,293,223,70,4,0,3,1
1900,1176,0,0,143,143,0,1,0,1,0
700,1176,0,0,154,154,0,1,0,1,0
405,2481,0,0,144,144,0,1,0,1,0
2025,3095,0,0,155,155,0,1,0,1,0
8265,1276,0,0,153,153,0,1,0,1,0
1620,3095,0,0,143,143,0,1,0,1,0
4993,183,16536,121,293,223,70,4,1,3,1
2682,1694,0,0,62,62,0,1,0,1,0
14399,312,0,0,145,145,0,1,0,1,0
8630,1557,0,0,138,138,0,1,0,1,0
2258,2538,0,0,120,120,0,1,0,1,0
768,1172,12,0,157,157,0,1,0,1,0
2479,1530,0,0,89,89,0,1,0,1,0
18642,1543,0,0,62,62,0,1,0,1,0
1877,3095,0,0,152,152,0,1,0,1,0
8729,1245,0,0,138,138,0,1,0,1,0
3030,1694,0,0,62,62,0,1,0,1,0
3461,183,11921,121,293,223,70,4,0,3,1
8857,1282,0,0,132,132,0,1,0,1,0
2638,1694,0,0,62,62,0,1,0,1,0
2975,1694,0,0,62,62,0,1,0,1,0
21622,1280,5489,23,106,93,13,1,0,1,0
392,1125,181,6,150,147,3,1,0,1,0
1189,183,4151,121,293,223,70,4,1,3,1
2742,1553,0,0,84,84,0,1,0,1,0
13197,829,0,0,111,111,0,1,0,1,0
17336,2863,0,0,131,131,0,1,0,1,0
968,3095,0,0,139,139,0,1,0,1,0
1664,541,0,0,144,144,0,1,0,1,0
1680,183,6225,121,293,223,70,4,0,3,1
99,1590,0,0,151,151,0,1,0,1,0
523,2558,0,0,144,144,0,1,0,1,0
9020,183,19498,121,293,223,70,4,0,3,1
973,1025,0,0,154,154,0,1,0,1,0
8173,1309,0,0,150,150,0,1,0,1,0
2981,183,11060,121,293,223,70,4,0,3,1
2246,404,0,0,62,62,0,1,0,1,0
20266,2234,0,0,98,98,0,1,0,1,0
2483,1176,0,0,145,145,0,1,0,1,0
8426,1687,0,0,142,142,0,1,0,1,0
212,2361,0,0,144,144,0,1,0,1,0
1936,183,7597,121,293,223,70,4,0,3,1
4721,183,16198,121,293,223,70,4,1,3,1
2858,1694,0,0,62,62,0,1,0,1,0
1444,1176,0,0,139,139,0,1,0,1,0
1423,3095,0,0,139,139,0,1,0,1,0
2438,47,0,0,69,69,0,1,0,1,0
1682,903,0,0,121,121,0,1,0,1,0
19691,2512,0,0,113,113,0,1,0,1,0
1677,513,0,0,145,145,0,1,0,1,0
1842,966,0,0,144,144,0,1,0,1,0
436,2501,0,0,144,144,0,1,0,1,0
767,3095,0,0,139,139,0,1,0,1,0
2727,1445,0,0,62,62,0,1,0,1,0
2617,1176,0,0,146,146,0,1,0,1,0
312,2420,0,0,144,144,0,1,0,1,0
989,226,3131,105,274,213,61,3,0,2,0
8153,1598,0,0,146,146,0,1,0,1,0
7834,2247,0,0,106,106,0,1,0,1,0
15437,2479,0,0,112,112,0,1,0,1,0
4074,183,13739,121,293,223,70,4,0,3,1
1848,183,7138,121,293,223,70,4,0,3,1
1362,3095,0,0,141,141,0,1,0,1,0
10084,1563,0,0,82,82,0,1,0,1,0
1397,3095,0,0,140,140,0,1,0,1,0
2253,183,9242,121,293,223,70,4,0,3,1
2126,183,8305,121,293,223,70,4,0,3,1
7835,1964,0,0,117,117,0,1,0,1,0
8327,1581,0,0,146,146,0,1,0,1,0
17469,2890,0,0,132,132,0,1,0,1,0
1377,183,4706,121,293,223,70,4,0,3,1
2381,82,0,0,75,75,0,1,0,1,0
3480,1183,0,0,95,95,0,1,0,1,0
657,1406,0,0,154,154,0,1,0,1,0
1031,708,0,0,151,151,0,1,0,1,0
9903,1543,0,0,88,88,0,1,0,1,0
10450,1543,0,0,69,69,0,1,0,1,0
1359,183,4622,121,293,223,70,4,1,3,1
1313,3095,0,0,142,142,0,1,0,1,0
1953,3095,0,0,153,153,0,1,0,1,0
9817,1808,0,0,70,70,0,1,0,1,0
2412,1694,0,0,62,62,0,1,0,1,0
2793,1496,0,0,62,62,0,1,0,1,0
1114,1176,0,0,152,152,0,1,0,1,0
2382,183,8889,121,293,223,70,4,0,3,1
9590,1543,0,0,103,103,0,1,0,1,0
20535,1543,0,0,63,63,0,1,0,1,0
11144,1611,0,0,62,62,0,1,0,1,0
1049,253,2847,96,263,207,55,3,0,2,0
2044,183,8037,121,293,223,70,4,0,3,1
1771,1176,0,0,141,141,0,1,0,1,0
1194,3095,0,0,139,139,0,1,0,1,0
2574,1453,0,0,101,101,0,1,0,1,0
471,2524,0,0,144,144,0,1,0,1,0
1925,3095,0,0,151,151,0,1,0,1,0
316,1071,0,0,157,157,0,1,0,1,0
2086,1183,0,0,62,62,0,1,0,1,0
9480,1608,0,0,104,104,0,1,0,1,0
